,time_between,service_time,arrival_time,start_time,end_time,wait_time,system_time,idle_time
0,0,2,0,0,2,0,2,0
1,4,3,4,4,7,0,3,2
2,1,2,5,7,9,2,4,0
3,1,1,6,9,10,3,4,0
4,4,1,10,10,11,0,1,0
5,5,2,15,15,17,0,2,4
6,6,3,21,21,24,0,3,4
7,2,2,23,24,26,1,3,0
8,5,2,28,28,30,0,2,2
9,3,2,31,31,33,0,2,1
10,6,1,37,37,38,0,1,4
11,4,1,41,41,42,0,1,3
12,1,2,42,42,44,0,2,0
13,1,2,43,44,46,1,3,0
14,3,2,46,46,48,0,2,0
15,4,1,50,50,51,0,1,2
16,5,2,55,55,57,0,2,4
17,3,1,58,58,59,0,1,1
18,3,1,61,61,62,0,1,2
19,3,2,64,64,66,0,2,2
20,5,2,69,69,71,0,2,3
21,5,1,74,74,75,0,1,3
22,1,3,75,75,78,0,3,0
23,1,3,76,78,81,2,5,0
24,6,1,82,82,83,0,1,1
25,2,2,84,84,86,0,2,1
26,5,3,89,89,92,0,3,3
27,1,1,90,92,93,2,3,0
28,5,3,95,95,98,0,3,2
29,6,2,101,101,103,0,2,3
30,2,1,103,103,104,0,1,0
31,1,3,104,104,107,0,3,0
32,6,2,110,110,112,0,2,3
33,6,2,116,116,118,0,2,4
34,2,2,118,118,120,0,2,0
35,1,3,119,120,123,1,4,0
36,4,3,123,123,126,0,3,0
37,3,3,126,126,129,0,3,0
38,1,1,127,129,130,2,3,0
39,1,2,128,130,132,2,4,0
40,2,2,130,132,134,2,4,0
41,2,3,132,134,137,2,5,0
42,4,3,136,137,140,1,4,0
43,5,2,141,141,143,0,2,1
44,6,3,147,147,150,0,3,4
45,3,2,150,150,152,0,2,0
46,3,1,153,153,154,0,1,1
47,6,2,159,159,161,0,2,5
48,6,2,165,165,167,0,2,4
49,4,3,169,169,172,0,3,2
50,5,2,174,174,176,0,2,2
51,4,2,178,178,180,0,2,2
52,6,3,184,184,187,0,3,4
53,5,2,189,189,191,0,2,2
54,5,2,194,194,196,0,2,3
55,6,3,200,200,203,0,3,4
56,5,1,205,205,206,0,1,2
57,5,2,210,210,212,0,2,4
58,5,2,215,215,217,0,2,3
59,3,2,218,218,220,0,2,1
60,6,2,224,224,226,0,2,4
61,5,1,229,229,230,0,1,3
62,3,3,232,232,235,0,3,2
63,4,2,236,236,238,0,2,1
64,2,2,238,238,240,0,2,0
65,1,1,239,240,241,1,2,0
66,2,1,241,241,242,0,1,0
67,2,3,243,243,246,0,3,1
68,4,3,247,247,250,0,3,1
69,4,3,251,251,254,0,3,1
70,4,1,255,255,256,0,1,1
71,6,1,261,261,262,0,1,5
72,2,1,263,263,264,0,1,1
73,5,1,268,268,269,0,1,4
74,3,3,271,271,274,0,3,2
75,3,3,274,274,277,0,3,0
76,1,3,275,277,280,2,5,0
77,2,3,277,280,283,3,6,0
78,2,2,279,283,285,4,6,0
79,6,3,285,285,288,0,3,0
80,1,3,286,288,291,2,5,0
81,3,2,289,291,293,2,4,0
82,6,1,295,295,296,0,1,2
83,5,1,300,300,301,0,1,4
84,2,3,302,302,305,0,3,1
85,1,3,303,305,308,2,5,0
86,6,1,309,309,310,0,1,1
87,5,1,314,314,315,0,1,4
88,2,2,316,316,318,0,2,1
89,1,3,317,318,321,1,4,0
90,2,3,319,321,324,2,5,0
91,1,2,320,324,326,4,6,0
92,6,1,326,326,327,0,1,0
93,5,1,331,331,332,0,1,4
94,4,1,335,335,336,0,1,3
95,2,3,337,337,340,0,3,1
96,4,2,341,341,343,0,2,1
97,4,1,345,345,346,0,1,2
98,1,1,346,346,347,0,1,0
99,3,1,349,349,350,0,1,2
100,6,2,355,355,357,0,2,5
101,5,3,360,360,363,0,3,3
102,4,2,364,364,366,0,2,1
103,6,1,370,370,371,0,1,4
104,3,1,373,373,374,0,1,2
105,5,1,378,378,379,0,1,4
106,5,2,383,383,385,0,2,4
107,5,1,388,388,389,0,1,3
108,2,3,390,390,393,0,3,1
109,3,2,393,393,395,0,2,0
110,2,1,395,395,396,0,1,0
111,1,2,396,396,398,0,2,0
112,3,1,399,399,400,0,1,1
113,4,3,403,403,406,0,3,3
114,1,2,404,406,408,2,4,0
115,5,2,409,409,411,0,2,1
116,5,1,414,414,415,0,1,3
117,4,2,418,418,420,0,2,3
118,4,3,422,422,425,0,3,2
119,2,1,424,425,426,1,2,0
120,6,2,430,430,432,0,2,4
121,5,1,435,435,436,0,1,3
122,4,1,439,439,440,0,1,3
123,5,2,444,444,446,0,2,4
124,1,2,445,446,448,1,3,0
125,3,1,448,448,449,0,1,0
126,4,3,452,452,455,0,3,3
127,4,2,456,456,458,0,2,1
128,5,2,461,461,463,0,2,3
129,3,2,464,464,466,0,2,1
130,5,1,469,469,470,0,1,3
131,4,1,473,473,474,0,1,3
132,6,3,479,479,482,0,3,5
133,4,2,483,483,485,0,2,1
134,2,2,485,485,487,0,2,0
135,6,2,491,491,493,0,2,4
136,3,2,494,494,496,0,2,1
137,5,3,499,499,502,0,3,3
138,4,3,503,503,506,0,3,1
139,2,2,505,506,508,1,3,0
140,5,1,510,510,511,0,1,2
141,3,2,513,513,515,0,2,2
142,2,2,515,515,517,0,2,0
143,4,3,519,519,522,0,3,2
144,3,3,522,522,525,0,3,0
145,5,2,527,527,529,0,2,2
146,3,2,530,530,532,0,2,1
147,1,2,531,532,534,1,3,0
148,1,2,532,534,536,2,4,0
149,4,1,536,536,537,0,1,0
150,3,3,539,539,542,0,3,2
151,6,1,545,545,546,0,1,3
152,3,1,548,548,549,0,1,2
153,3,3,551,551,554,0,3,2
154,2,2,553,554,556,1,3,0
155,4,2,557,557,559,0,2,1
156,6,2,563,563,565,0,2,4
157,5,1,568,568,569,0,1,3
158,4,1,572,572,573,0,1,3
159,3,2,575,575,577,0,2,2
160,6,3,581,581,584,0,3,4
161,2,3,583,584,587,1,4,0
162,3,3,586,587,590,1,4,0
163,3,1,589,590,591,1,2,0
164,3,1,592,592,593,0,1,1
165,2,2,594,594,596,0,2,1
166,3,1,597,597,598,0,1,1
167,3,1,600,600,601,0,1,2
168,3,3,603,603,606,0,3,2
169,5,2,608,608,610,0,2,2
170,3,3,611,611,614,0,3,1
171,6,2,617,617,619,0,2,3
172,3,2,620,620,622,0,2,1
173,1,1,621,622,623,1,2,0
174,3,1,624,624,625,0,1,1
175,1,2,625,625,627,0,2,0
176,6,3,631,631,634,0,3,4
177,2,2,633,634,636,1,3,0
178,3,3,636,636,639,0,3,0
179,4,3,640,640,643,0,3,1
180,6,3,646,646,649,0,3,3
181,3,1,649,649,650,0,1,0
182,3,1,652,652,653,0,1,2
183,2,2,654,654,656,0,2,1
184,5,3,659,659,662,0,3,3
185,1,2,660,662,664,2,4,0
186,2,3,662,664,667,2,5,0
187,3,1,665,667,668,2,3,0
188,5,1,670,670,671,0,1,2
189,4,1,674,674,675,0,1,3
190,2,2,676,676,678,0,2,1
191,6,1,682,682,683,0,1,4
192,5,1,687,687,688,0,1,4
193,6,3,693,693,696,0,3,5
194,2,1,695,696,697,1,2,0
195,2,2,697,697,699,0,2,0
196,6,3,703,703,706,0,3,4
197,2,1,705,706,707,1,2,0
198,2,3,707,707,710,0,3,0
199,2,2,709,710,712,1,3,0
200,2,1,711,712,713,1,2,0
201,2,3,713,713,716,0,3,0
202,2,2,715,716,718,1,3,0
203,4,1,719,719,720,0,1,1
204,1,1,720,720,721,0,1,0
205,4,1,724,724,725,0,1,3
206,5,3,729,729,732,0,3,4
207,4,1,733,733,734,0,1,1
208,4,1,737,737,738,0,1,3
209,3,1,740,740,741,0,1,2
210,3,2,743,743,745,0,2,2
211,1,1,744,745,746,1,2,0
212,1,2,745,746,748,1,3,0
213,6,2,751,751,753,0,2,3
214,4,3,755,755,758,0,3,2
215,4,3,759,759,762,0,3,1
216,1,2,760,762,764,2,4,0
217,2,1,762,764,765,2,3,0
218,6,1,768,768,769,0,1,3
219,3,3,771,771,774,0,3,2
220,2,2,773,774,776,1,3,0
221,6,3,779,779,782,0,3,3
222,6,1,785,785,786,0,1,3
223,5,1,790,790,791,0,1,4
224,4,1,794,794,795,0,1,3
225,2,3,796,796,799,0,3,1
226,3,2,799,799,801,0,2,0
227,5,3,804,804,807,0,3,3
228,3,3,807,807,810,0,3,0
229,1,2,808,810,812,2,4,0
230,1,3,809,812,815,3,6,0
231,6,2,815,815,817,0,2,0
232,6,1,821,821,822,0,1,4
233,4,1,825,825,826,0,1,3
234,3,3,828,828,831,0,3,2
235,5,1,833,833,834,0,1,2
236,2,1,835,835,836,0,1,1
237,4,1,839,839,840,0,1,3
238,2,3,841,841,844,0,3,1
239,4,2,845,845,847,0,2,1
240,3,2,848,848,850,0,2,1
241,1,1,849,850,851,1,2,0
242,4,1,853,853,854,0,1,2
243,3,2,856,856,858,0,2,2
244,6,2,862,862,864,0,2,4
245,1,2,863,864,866,1,3,0
246,6,1,869,869,870,0,1,3
247,4,3,873,873,876,0,3,3
248,4,3,877,877,880,0,3,1
249,6,3,883,883,886,0,3,3
250,2,2,885,886,888,1,3,0
251,6,3,891,891,894,0,3,3
252,1,2,892,894,896,2,4,0
253,6,2,898,898,900,0,2,2
254,1,2,899,900,902,1,3,0
255,5,1,904,904,905,0,1,2
256,5,2,909,909,911,0,2,4
257,3,3,912,912,915,0,3,1
258,2,3,914,915,918,1,4,0
259,1,2,915,918,920,3,5,0
260,5,2,920,920,922,0,2,0
261,6,3,926,926,929,0,3,4
262,2,1,928,929,930,1,2,0
263,3,3,931,931,934,0,3,1
264,3,3,934,934,937,0,3,0
265,6,2,940,940,942,0,2,3
266,4,2,944,944,946,0,2,2
267,5,2,949,949,951,0,2,3
268,6,1,955,955,956,0,1,4
269,1,3,956,956,959,0,3,0
270,2,3,958,959,962,1,4,0
271,4,1,962,962,963,0,1,0
272,2,3,964,964,967,0,3,1
273,2,2,966,967,969,1,3,0
274,1,1,967,969,970,2,3,0
275,4,1,971,971,972,0,1,1
276,4,3,975,975,978,0,3,3
277,2,3,977,978,981,1,4,0
278,4,1,981,981,982,0,1,0
279,1,1,982,982,983,0,1,0
280,4,1,986,986,987,0,1,3
281,1,1,987,987,988,0,1,0
282,2,1,989,989,990,0,1,1
283,6,1,995,995,996,0,1,5
284,1,1,996,996,997,0,1,0
285,6,2,1002,1002,1004,0,2,5
286,3,2,1005,1005,1007,0,2,1
287,1,3,1006,1007,1010,1,4,0
288,5,3,1011,1011,1014,0,3,1
289,3,3,1014,1014,1017,0,3,0
290,4,2,1018,1018,1020,0,2,1
291,2,2,1020,1020,1022,0,2,0
292,4,1,1024,1024,1025,0,1,2
293,4,2,1028,1028,1030,0,2,3
294,4,3,1032,1032,1035,0,3,2
295,1,2,1033,1035,1037,2,4,0
296,4,3,1037,1037,1040,0,3,0
297,2,1,1039,1040,1041,1,2,0
298,4,3,1043,1043,1046,0,3,2
299,2,2,1045,1046,1048,1,3,0
300,5,1,1050,1050,1051,0,1,2
301,1,2,1051,1051,1053,0,2,0
302,5,1,1056,1056,1057,0,1,3
303,6,3,1062,1062,1065,0,3,5
304,3,3,1065,1065,1068,0,3,0
305,6,1,1071,1071,1072,0,1,3
306,2,2,1073,1073,1075,0,2,1
307,3,2,1076,1076,1078,0,2,1
308,1,3,1077,1078,1081,1,4,0
309,4,1,1081,1081,1082,0,1,0
310,3,2,1084,1084,1086,0,2,2
311,6,3,1090,1090,1093,0,3,4
312,1,2,1091,1093,1095,2,4,0
313,4,3,1095,1095,1098,0,3,0
314,3,2,1098,1098,1100,0,2,0
315,2,3,1100,1100,1103,0,3,0
316,1,2,1101,1103,1105,2,4,0
317,5,1,1106,1106,1107,0,1,1
318,1,1,1107,1107,1108,0,1,0
319,2,1,1109,1109,1110,0,1,1
320,4,1,1113,1113,1114,0,1,3
321,4,3,1117,1117,1120,0,3,3
322,3,3,1120,1120,1123,0,3,0
323,5,3,1125,1125,1128,0,3,2
324,5,2,1130,1130,1132,0,2,2
325,6,1,1136,1136,1137,0,1,4
326,1,1,1137,1137,1138,0,1,0
327,6,1,1143,1143,1144,0,1,5
328,5,3,1148,1148,1151,0,3,4
329,5,2,1153,1153,1155,0,2,2
330,3,3,1156,1156,1159,0,3,1
331,3,1,1159,1159,1160,0,1,0
332,4,2,1163,1163,1165,0,2,3
333,5,2,1168,1168,1170,0,2,3
334,2,1,1170,1170,1171,0,1,0
335,4,1,1174,1174,1175,0,1,3
336,1,3,1175,1175,1178,0,3,0
337,6,3,1181,1181,1184,0,3,3
338,3,2,1184,1184,1186,0,2,0
339,1,1,1185,1186,1187,1,2,0
340,2,3,1187,1187,1190,0,3,0
341,2,1,1189,1190,1191,1,2,0
342,1,2,1190,1191,1193,1,3,0
343,2,1,1192,1193,1194,1,2,0
344,5,1,1197,1197,1198,0,1,3
345,6,3,1203,1203,1206,0,3,5
346,1,3,1204,1206,1209,2,5,0
347,1,2,1205,1209,1211,4,6,0
348,5,2,1210,1211,1213,1,3,0
349,2,1,1212,1213,1214,1,2,0
350,5,1,1217,1217,1218,0,1,3
351,1,1,1218,1218,1219,0,1,0
352,4,1,1222,1222,1223,0,1,3
353,2,3,1224,1224,1227,0,3,1
354,3,1,1227,1227,1228,0,1,0
355,2,3,1229,1229,1232,0,3,1
356,2,1,1231,1232,1233,1,2,0
357,6,2,1237,1237,1239,0,2,4
358,4,1,1241,1241,1242,0,1,2
359,4,2,1245,1245,1247,0,2,3
360,6,1,1251,1251,1252,0,1,4
361,3,1,1254,1254,1255,0,1,2
362,2,3,1256,1256,1259,0,3,1
363,5,1,1261,1261,1262,0,1,2
364,5,1,1266,1266,1267,0,1,4
365,6,1,1272,1272,1273,0,1,5
366,4,2,1276,1276,1278,0,2,3
367,4,2,1280,1280,1282,0,2,2
368,5,3,1285,1285,1288,0,3,3
369,6,2,1291,1291,1293,0,2,3
370,1,2,1292,1293,1295,1,3,0
371,5,1,1297,1297,1298,0,1,2
372,4,3,1301,1301,1304,0,3,3
373,2,3,1303,1304,1307,1,4,0
374,4,3,1307,1307,1310,0,3,0
375,5,2,1312,1312,1314,0,2,2
376,6,2,1318,1318,1320,0,2,4
377,4,1,1322,1322,1323,0,1,2
378,3,1,1325,1325,1326,0,1,2
379,6,3,1331,1331,1334,0,3,5
380,6,2,1337,1337,1339,0,2,3
381,2,2,1339,1339,1341,0,2,0
382,4,1,1343,1343,1344,0,1,2
383,2,2,1345,1345,1347,0,2,1
384,1,3,1346,1347,1350,1,4,0
385,2,3,1348,1350,1353,2,5,0
386,2,3,1350,1353,1356,3,6,0
387,1,1,1351,1356,1357,5,6,0
388,2,3,1353,1357,1360,4,7,0
389,2,3,1355,1360,1363,5,8,0
390,6,1,1361,1363,1364,2,3,0
391,2,1,1363,1364,1365,1,2,0
392,1,1,1364,1365,1366,1,2,0
393,5,2,1369,1369,1371,0,2,3
394,2,3,1371,1371,1374,0,3,0
395,2,2,1373,1374,1376,1,3,0
396,1,3,1374,1376,1379,2,5,0
397,5,2,1379,1379,1381,0,2,0
398,3,3,1382,1382,1385,0,3,1
399,4,3,1386,1386,1389,0,3,1
400,6,2,1392,1392,1394,0,2,3
401,3,1,1395,1395,1396,0,1,1
402,6,2,1401,1401,1403,0,2,5
403,4,3,1405,1405,1408,0,3,2
404,4,2,1409,1409,1411,0,2,1
405,2,1,1411,1411,1412,0,1,0
406,1,3,1412,1412,1415,0,3,0
407,3,2,1415,1415,1417,0,2,0
408,4,1,1419,1419,1420,0,1,2
409,4,1,1423,1423,1424,0,1,3
410,2,1,1425,1425,1426,0,1,1
411,6,1,1431,1431,1432,0,1,5
412,1,1,1432,1432,1433,0,1,0
413,1,1,1433,1433,1434,0,1,0
414,3,2,1436,1436,1438,0,2,2
415,2,1,1438,1438,1439,0,1,0
416,6,3,1444,1444,1447,0,3,5
417,5,1,1449,1449,1450,0,1,2
418,5,2,1454,1454,1456,0,2,4
419,4,3,1458,1458,1461,0,3,2
420,6,3,1464,1464,1467,0,3,3
421,3,3,1467,1467,1470,0,3,0
422,4,2,1471,1471,1473,0,2,1
423,2,1,1473,1473,1474,0,1,0
424,4,3,1477,1477,1480,0,3,3
425,5,1,1482,1482,1483,0,1,2
426,2,3,1484,1484,1487,0,3,1
427,4,2,1488,1488,1490,0,2,1
428,1,1,1489,1490,1491,1,2,0
429,4,3,1493,1493,1496,0,3,2
430,2,1,1495,1496,1497,1,2,0
431,5,1,1500,1500,1501,0,1,3
432,3,2,1503,1503,1505,0,2,2
433,5,2,1508,1508,1510,0,2,3
434,6,3,1514,1514,1517,0,3,4
435,1,3,1515,1517,1520,2,5,0
436,5,1,1520,1520,1521,0,1,0
437,1,3,1521,1521,1524,0,3,0
438,3,3,1524,1524,1527,0,3,0
439,2,3,1526,1527,1530,1,4,0
440,2,3,1528,1530,1533,2,5,0
441,1,2,1529,1533,1535,4,6,0
442,1,3,1530,1535,1538,5,8,0
443,2,3,1532,1538,1541,6,9,0
444,6,2,1538,1541,1543,3,5,0
445,4,1,1542,1543,1544,1,2,0
446,4,2,1546,1546,1548,0,2,2
447,1,3,1547,1548,1551,1,4,0
448,6,1,1553,1553,1554,0,1,2
449,2,2,1555,1555,1557,0,2,1
450,3,1,1558,1558,1559,0,1,1
451,2,2,1560,1560,1562,0,2,1
452,6,2,1566,1566,1568,0,2,4
453,6,1,1572,1572,1573,0,1,4
454,4,2,1576,1576,1578,0,2,3
455,6,1,1582,1582,1583,0,1,4
456,5,2,1587,1587,1589,0,2,4
457,4,1,1591,1591,1592,0,1,2
458,2,3,1593,1593,1596,0,3,1
459,3,1,1596,1596,1597,0,1,0
460,2,1,1598,1598,1599,0,1,1
461,5,1,1603,1603,1604,0,1,4
462,4,3,1607,1607,1610,0,3,3
463,6,3,1613,1613,1616,0,3,3
464,1,1,1614,1616,1617,2,3,0
465,3,1,1617,1617,1618,0,1,0
466,5,1,1622,1622,1623,0,1,4
467,3,3,1625,1625,1628,0,3,2
468,5,3,1630,1630,1633,0,3,2
469,5,3,1635,1635,1638,0,3,2
470,6,2,1641,1641,1643,0,2,3
471,1,1,1642,1643,1644,1,2,0
472,1,1,1643,1644,1645,1,2,0
473,4,1,1647,1647,1648,0,1,2
474,5,1,1652,1652,1653,0,1,4
475,6,3,1658,1658,1661,0,3,5
476,3,3,1661,1661,1664,0,3,0
477,5,2,1666,1666,1668,0,2,2
478,6,1,1672,1672,1673,0,1,4
479,4,2,1676,1676,1678,0,2,3
480,1,2,1677,1678,1680,1,3,0
481,1,1,1678,1680,1681,2,3,0
482,4,3,1682,1682,1685,0,3,1
483,1,2,1683,1685,1687,2,4,0
484,3,3,1686,1687,1690,1,4,0
485,6,2,1692,1692,1694,0,2,2
486,6,3,1698,1698,1701,0,3,4
487,2,3,1700,1701,1704,1,4,0
488,6,2,1706,1706,1708,0,2,2
489,2,1,1708,1708,1709,0,1,0
490,6,3,1714,1714,1717,0,3,5
491,1,1,1715,1717,1718,2,3,0
492,2,3,1717,1718,1721,1,4,0
493,5,2,1722,1722,1724,0,2,1
494,4,1,1726,1726,1727,0,1,2
495,2,1,1728,1728,1729,0,1,1
496,5,2,1733,1733,1735,0,2,4
497,5,3,1738,1738,1741,0,3,3
498,2,3,1740,1741,1744,1,4,0
499,6,1,1746,1746,1747,0,1,2
500,2,2,1748,1748,1750,0,2,1
501,5,2,1753,1753,1755,0,2,3
502,1,1,1754,1755,1756,1,2,0
503,6,3,1760,1760,1763,0,3,4
504,1,2,1761,1763,1765,2,4,0
505,6,3,1767,1767,1770,0,3,2
506,5,3,1772,1772,1775,0,3,2
507,1,3,1773,1775,1778,2,5,0
508,1,2,1774,1778,1780,4,6,0
509,2,2,1776,1780,1782,4,6,0
510,3,3,1779,1782,1785,3,6,0
511,1,2,1780,1785,1787,5,7,0
512,2,1,1782,1787,1788,5,6,0
513,4,2,1786,1788,1790,2,4,0
514,5,2,1791,1791,1793,0,2,1
515,1,1,1792,1793,1794,1,2,0
516,5,2,1797,1797,1799,0,2,3
517,5,2,1802,1802,1804,0,2,3
518,4,3,1806,1806,1809,0,3,2
519,4,1,1810,1810,1811,0,1,1
520,3,2,1813,1813,1815,0,2,2
521,3,3,1816,1816,1819,0,3,1
522,3,3,1819,1819,1822,0,3,0
523,4,3,1823,1823,1826,0,3,1
524,4,3,1827,1827,1830,0,3,1
525,2,2,1829,1830,1832,1,3,0
526,2,3,1831,1832,1835,1,4,0
527,1,3,1832,1835,1838,3,6,0
528,3,3,1835,1838,1841,3,6,0
529,5,1,1840,1841,1842,1,2,0
530,5,2,1845,1845,1847,0,2,3
531,5,3,1850,1850,1853,0,3,3
532,4,3,1854,1854,1857,0,3,1
533,6,1,1860,1860,1861,0,1,3
534,4,3,1864,1864,1867,0,3,3
535,5,1,1869,1869,1870,0,1,2
536,3,1,1872,1872,1873,0,1,2
537,3,2,1875,1875,1877,0,2,2
538,1,2,1876,1877,1879,1,3,0
539,1,2,1877,1879,1881,2,4,0
540,2,3,1879,1881,1884,2,5,0
541,3,2,1882,1884,1886,2,4,0
542,2,3,1884,1886,1889,2,5,0
543,2,3,1886,1889,1892,3,6,0
544,2,1,1888,1892,1893,4,5,0
545,2,3,1890,1893,1896,3,6,0
546,6,1,1896,1896,1897,0,1,0
547,1,3,1897,1897,1900,0,3,0
548,4,3,1901,1901,1904,0,3,1
549,4,3,1905,1905,1908,0,3,1
550,2,3,1907,1908,1911,1,4,0
551,1,2,1908,1911,1913,3,5,0
552,3,3,1911,1913,1916,2,5,0
553,2,1,1913,1916,1917,3,4,0
554,5,1,1918,1918,1919,0,1,1
555,3,3,1921,1921,1924,0,3,2
556,6,2,1927,1927,1929,0,2,3
557,1,3,1928,1929,1932,1,4,0
558,6,3,1934,1934,1937,0,3,2
559,6,3,1940,1940,1943,0,3,3
560,4,2,1944,1944,1946,0,2,1
561,4,1,1948,1948,1949,0,1,2
562,5,1,1953,1953,1954,0,1,4
563,1,1,1954,1954,1955,0,1,0
564,6,2,1960,1960,1962,0,2,5
565,2,2,1962,1962,1964,0,2,0
566,1,3,1963,1964,1967,1,4,0
567,5,2,1968,1968,1970,0,2,1
568,6,1,1974,1974,1975,0,1,4
569,6,2,1980,1980,1982,0,2,5
570,1,1,1981,1982,1983,1,2,0
571,2,1,1983,1983,1984,0,1,0
572,6,2,1989,1989,1991,0,2,5
573,1,3,1990,1991,1994,1,4,0
574,3,3,1993,1994,1997,1,4,0
575,2,3,1995,1997,2000,2,5,0
576,4,3,1999,2000,2003,1,4,0
577,3,3,2002,2003,2006,1,4,0
578,2,2,2004,2006,2008,2,4,0
579,2,2,2006,2008,2010,2,4,0
580,5,3,2011,2011,2014,0,3,1
581,5,1,2016,2016,2017,0,1,2
582,6,2,2022,2022,2024,0,2,5
583,5,3,2027,2027,2030,0,3,3
584,6,2,2033,2033,2035,0,2,3
585,3,3,2036,2036,2039,0,3,1
586,5,1,2041,2041,2042,0,1,2
587,3,2,2044,2044,2046,0,2,2
588,4,2,2048,2048,2050,0,2,2
589,5,1,2053,2053,2054,0,1,3
590,2,3,2055,2055,2058,0,3,1
591,2,1,2057,2058,2059,1,2,0
592,1,2,2058,2059,2061,1,3,0
593,2,1,2060,2061,2062,1,2,0
594,2,2,2062,2062,2064,0,2,0
595,4,3,2066,2066,2069,0,3,2
596,5,1,2071,2071,2072,0,1,2
597,3,2,2074,2074,2076,0,2,2
598,5,1,2079,2079,2080,0,1,3
599,5,3,2084,2084,2087,0,3,4
600,4,2,2088,2088,2090,0,2,1
601,3,1,2091,2091,2092,0,1,1
602,6,3,2097,2097,2100,0,3,5
603,1,3,2098,2100,2103,2,5,0
604,4,1,2102,2103,2104,1,2,0
605,3,3,2105,2105,2108,0,3,1
606,3,1,2108,2108,2109,0,1,0
607,3,2,2111,2111,2113,0,2,2
608,5,1,2116,2116,2117,0,1,3
609,4,2,2120,2120,2122,0,2,3
610,4,1,2124,2124,2125,0,1,2
611,2,1,2126,2126,2127,0,1,1
612,3,3,2129,2129,2132,0,3,2
613,3,3,2132,2132,2135,0,3,0
614,2,3,2134,2135,2138,1,4,0
615,1,3,2135,2138,2141,3,6,0
616,3,1,2138,2141,2142,3,4,0
617,2,3,2140,2142,2145,2,5,0
618,6,2,2146,2146,2148,0,2,1
619,3,2,2149,2149,2151,0,2,1
620,6,1,2155,2155,2156,0,1,4
621,3,2,2158,2158,2160,0,2,2
622,5,1,2163,2163,2164,0,1,3
623,2,3,2165,2165,2168,0,3,1
624,2,3,2167,2168,2171,1,4,0
625,1,1,2168,2171,2172,3,4,0
626,6,2,2174,2174,2176,0,2,2
627,3,3,2177,2177,2180,0,3,1
628,3,2,2180,2180,2182,0,2,0
629,2,2,2182,2182,2184,0,2,0
630,3,2,2185,2185,2187,0,2,1
631,5,1,2190,2190,2191,0,1,3
632,4,3,2194,2194,2197,0,3,3
633,2,3,2196,2197,2200,1,4,0
634,2,1,2198,2200,2201,2,3,0
635,1,1,2199,2201,2202,2,3,0
636,3,1,2202,2202,2203,0,1,0
637,6,2,2208,2208,2210,0,2,5
638,5,2,2213,2213,2215,0,2,3
639,6,3,2219,2219,2222,0,3,4
640,4,2,2223,2223,2225,0,2,1
641,4,3,2227,2227,2230,0,3,2
642,5,1,2232,2232,2233,0,1,2
643,3,3,2235,2235,2238,0,3,2
644,2,3,2237,2238,2241,1,4,0
645,4,3,2241,2241,2244,0,3,0
646,4,3,2245,2245,2248,0,3,1
647,6,1,2251,2251,2252,0,1,3
648,4,3,2255,2255,2258,0,3,3
649,5,2,2260,2260,2262,0,2,2
650,1,2,2261,2262,2264,1,3,0
651,3,1,2264,2264,2265,0,1,0
652,6,2,2270,2270,2272,0,2,5
653,4,3,2274,2274,2277,0,3,2
654,6,1,2280,2280,2281,0,1,3
655,6,1,2286,2286,2287,0,1,5
656,2,1,2288,2288,2289,0,1,1
657,1,2,2289,2289,2291,0,2,0
658,4,2,2293,2293,2295,0,2,2
659,2,2,2295,2295,2297,0,2,0
660,3,1,2298,2298,2299,0,1,1
661,6,3,2304,2304,2307,0,3,5
662,3,3,2307,2307,2310,0,3,0
663,1,2,2308,2310,2312,2,4,0
664,4,1,2312,2312,2313,0,1,0
665,2,1,2314,2314,2315,0,1,1
666,6,2,2320,2320,2322,0,2,5
667,4,2,2324,2324,2326,0,2,2
668,2,3,2326,2326,2329,0,3,0
669,5,3,2331,2331,2334,0,3,2
670,4,3,2335,2335,2338,0,3,1
671,3,3,2338,2338,2341,0,3,0
672,3,3,2341,2341,2344,0,3,0
673,3,1,2344,2344,2345,0,1,0
674,4,2,2348,2348,2350,0,2,3
675,6,2,2354,2354,2356,0,2,4
676,5,2,2359,2359,2361,0,2,3
677,6,1,2365,2365,2366,0,1,4
678,4,2,2369,2369,2371,0,2,3
679,3,1,2372,2372,2373,0,1,1
680,6,2,2378,2378,2380,0,2,5
681,6,3,2384,2384,2387,0,3,4
682,6,2,2390,2390,2392,0,2,3
683,6,1,2396,2396,2397,0,1,4
684,5,3,2401,2401,2404,0,3,4
685,1,1,2402,2404,2405,2,3,0
686,5,2,2407,2407,2409,0,2,2
687,5,2,2412,2412,2414,0,2,3
688,1,1,2413,2414,2415,1,2,0
689,3,2,2416,2416,2418,0,2,1
690,2,1,2418,2418,2419,0,1,0
691,4,2,2422,2422,2424,0,2,3
692,1,2,2423,2424,2426,1,3,0
693,5,3,2428,2428,2431,0,3,2
694,5,2,2433,2433,2435,0,2,2
695,4,1,2437,2437,2438,0,1,2
696,1,3,2438,2438,2441,0,3,0
697,4,1,2442,2442,2443,0,1,1
698,4,2,2446,2446,2448,0,2,3
699,3,2,2449,2449,2451,0,2,1
700,2,3,2451,2451,2454,0,3,0
701,5,3,2456,2456,2459,0,3,2
702,4,1,2460,2460,2461,0,1,1
703,3,3,2463,2463,2466,0,3,2
704,4,1,2467,2467,2468,0,1,1
705,6,2,2473,2473,2475,0,2,5
706,6,2,2479,2479,2481,0,2,4
707,1,1,2480,2481,2482,1,2,0
708,1,3,2481,2482,2485,1,4,0
709,5,2,2486,2486,2488,0,2,1
710,2,1,2488,2488,2489,0,1,0
711,4,3,2492,2492,2495,0,3,3
712,5,3,2497,2497,2500,0,3,2
713,5,2,2502,2502,2504,0,2,2
714,4,2,2506,2506,2508,0,2,2
715,3,1,2509,2509,2510,0,1,1
716,4,3,2513,2513,2516,0,3,3
717,1,1,2514,2516,2517,2,3,0
718,6,2,2520,2520,2522,0,2,3
719,3,3,2523,2523,2526,0,3,1
720,6,2,2529,2529,2531,0,2,3
721,1,2,2530,2531,2533,1,3,0
722,6,2,2536,2536,2538,0,2,3
723,1,3,2537,2538,2541,1,4,0
724,5,2,2542,2542,2544,0,2,1
725,1,3,2543,2544,2547,1,4,0
726,3,1,2546,2547,2548,1,2,0
727,3,1,2549,2549,2550,0,1,1
728,2,3,2551,2551,2554,0,3,1
729,3,3,2554,2554,2557,0,3,0
730,6,2,2560,2560,2562,0,2,3
731,1,2,2561,2562,2564,1,3,0
732,5,2,2566,2566,2568,0,2,2
733,6,1,2572,2572,2573,0,1,4
734,6,3,2578,2578,2581,0,3,5
735,4,1,2582,2582,2583,0,1,1
736,5,2,2587,2587,2589,0,2,4
737,5,2,2592,2592,2594,0,2,3
738,1,2,2593,2594,2596,1,3,0
739,6,2,2599,2599,2601,0,2,3
740,2,2,2601,2601,2603,0,2,0
741,1,2,2602,2603,2605,1,3,0
742,2,1,2604,2605,2606,1,2,0
743,5,2,2609,2609,2611,0,2,3
744,1,1,2610,2611,2612,1,2,0
745,2,2,2612,2612,2614,0,2,0
746,1,2,2613,2614,2616,1,3,0
747,3,1,2616,2616,2617,0,1,0
748,6,2,2622,2622,2624,0,2,5
749,6,1,2628,2628,2629,0,1,4
750,1,3,2629,2629,2632,0,3,0
751,5,2,2634,2634,2636,0,2,2
752,5,2,2639,2639,2641,0,2,3
753,6,1,2645,2645,2646,0,1,4
754,5,3,2650,2650,2653,0,3,4
755,3,2,2653,2653,2655,0,2,0
756,3,2,2656,2656,2658,0,2,1
757,6,1,2662,2662,2663,0,1,4
758,5,1,2667,2667,2668,0,1,4
759,6,1,2673,2673,2674,0,1,5
760,4,1,2677,2677,2678,0,1,3
761,6,3,2683,2683,2686,0,3,5
762,5,3,2688,2688,2691,0,3,2
763,6,1,2694,2694,2695,0,1,3
764,6,1,2700,2700,2701,0,1,5
765,6,3,2706,2706,2709,0,3,5
766,1,3,2707,2709,2712,2,5,0
767,5,2,2712,2712,2714,0,2,0
768,2,3,2714,2714,2717,0,3,0
769,2,2,2716,2717,2719,1,3,0
770,4,2,2720,2720,2722,0,2,1
771,3,3,2723,2723,2726,0,3,1
772,3,3,2726,2726,2729,0,3,0
773,3,2,2729,2729,2731,0,2,0
774,6,2,2735,2735,2737,0,2,4
775,4,2,2739,2739,2741,0,2,2
776,3,3,2742,2742,2745,0,3,1
777,2,3,2744,2745,2748,1,4,0
778,3,1,2747,2748,2749,1,2,0
779,3,1,2750,2750,2751,0,1,1
780,3,3,2753,2753,2756,0,3,2
781,1,1,2754,2756,2757,2,3,0
782,3,1,2757,2757,2758,0,1,0
783,2,1,2759,2759,2760,0,1,1
784,2,3,2761,2761,2764,0,3,1
785,5,2,2766,2766,2768,0,2,2
786,4,2,2770,2770,2772,0,2,2
787,2,3,2772,2772,2775,0,3,0
788,6,2,2778,2778,2780,0,2,3
789,1,1,2779,2780,2781,1,2,0
790,2,2,2781,2781,2783,0,2,0
791,3,1,2784,2784,2785,0,1,1
792,5,1,2789,2789,2790,0,1,4
793,3,3,2792,2792,2795,0,3,2
794,1,2,2793,2795,2797,2,4,0
795,1,3,2794,2797,2800,3,6,0
796,4,3,2798,2800,2803,2,5,0
797,6,1,2804,2804,2805,0,1,1
798,3,3,2807,2807,2810,0,3,2
799,1,3,2808,2810,2813,2,5,0
800,2,3,2810,2813,2816,3,6,0
801,5,2,2815,2816,2818,1,3,0
802,2,2,2817,2818,2820,1,3,0
803,1,2,2818,2820,2822,2,4,0
804,4,2,2822,2822,2824,0,2,0
805,6,2,2828,2828,2830,0,2,4
806,4,2,2832,2832,2834,0,2,2
807,5,1,2837,2837,2838,0,1,3
808,6,2,2843,2843,2845,0,2,5
809,5,1,2848,2848,2849,0,1,3
810,6,1,2854,2854,2855,0,1,5
811,5,3,2859,2859,2862,0,3,4
812,5,3,2864,2864,2867,0,3,2
813,5,2,2869,2869,2871,0,2,2
814,2,2,2871,2871,2873,0,2,0
815,4,3,2875,2875,2878,0,3,2
816,3,3,2878,2878,2881,0,3,0
817,3,1,2881,2881,2882,0,1,0
818,5,2,2886,2886,2888,0,2,4
819,3,2,2889,2889,2891,0,2,1
820,5,2,2894,2894,2896,0,2,3
821,2,2,2896,2896,2898,0,2,0
822,5,3,2901,2901,2904,0,3,3
823,6,2,2907,2907,2909,0,2,3
824,4,1,2911,2911,2912,0,1,2
825,1,1,2912,2912,2913,0,1,0
826,2,3,2914,2914,2917,0,3,1
827,5,1,2919,2919,2920,0,1,2
828,1,3,2920,2920,2923,0,3,0
829,4,1,2924,2924,2925,0,1,1
830,4,1,2928,2928,2929,0,1,3
831,3,3,2931,2931,2934,0,3,2
832,1,3,2932,2934,2937,2,5,0
833,4,1,2936,2937,2938,1,2,0
834,6,2,2942,2942,2944,0,2,4
835,6,1,2948,2948,2949,0,1,4
836,4,1,2952,2952,2953,0,1,3
837,2,1,2954,2954,2955,0,1,1
838,5,3,2959,2959,2962,0,3,4
839,3,1,2962,2962,2963,0,1,0
840,1,3,2963,2963,2966,0,3,0
841,6,1,2969,2969,2970,0,1,3
842,5,3,2974,2974,2977,0,3,4
843,1,1,2975,2977,2978,2,3,0
844,6,1,2981,2981,2982,0,1,3
845,6,1,2987,2987,2988,0,1,5
846,5,1,2992,2992,2993,0,1,4
847,5,3,2997,2997,3000,0,3,4
848,3,1,3000,3000,3001,0,1,0
849,4,2,3004,3004,3006,0,2,3
850,5,1,3009,3009,3010,0,1,3
851,6,1,3015,3015,3016,0,1,5
852,1,3,3016,3016,3019,0,3,0
853,3,3,3019,3019,3022,0,3,0
854,4,1,3023,3023,3024,0,1,1
855,4,3,3027,3027,3030,0,3,3
856,2,1,3029,3030,3031,1,2,0
857,5,2,3034,3034,3036,0,2,3
858,3,3,3037,3037,3040,0,3,1
859,2,2,3039,3040,3042,1,3,0
860,4,2,3043,3043,3045,0,2,1
861,5,1,3048,3048,3049,0,1,3
862,2,3,3050,3050,3053,0,3,1
863,1,2,3051,3053,3055,2,4,0
864,4,3,3055,3055,3058,0,3,0
865,2,2,3057,3058,3060,1,3,0
866,4,3,3061,3061,3064,0,3,1
867,5,3,3066,3066,3069,0,3,2
868,1,2,3067,3069,3071,2,4,0
869,2,1,3069,3071,3072,2,3,0
870,2,2,3071,3072,3074,1,3,0
871,4,1,3075,3075,3076,0,1,1
872,3,1,3078,3078,3079,0,1,2
873,4,2,3082,3082,3084,0,2,3
874,3,2,3085,3085,3087,0,2,1
875,5,1,3090,3090,3091,0,1,3
876,4,1,3094,3094,3095,0,1,3
877,6,2,3100,3100,3102,0,2,5
878,1,3,3101,3102,3105,1,4,0
879,3,1,3104,3105,3106,1,2,0
880,6,1,3110,3110,3111,0,1,4
881,6,2,3116,3116,3118,0,2,5
882,5,1,3121,3121,3122,0,1,3
883,6,3,3127,3127,3130,0,3,5
884,1,2,3128,3130,3132,2,4,0
885,5,1,3133,3133,3134,0,1,1
886,4,1,3137,3137,3138,0,1,3
887,3,3,3140,3140,3143,0,3,2
888,5,2,3145,3145,3147,0,2,2
889,4,3,3149,3149,3152,0,3,2
890,5,1,3154,3154,3155,0,1,2
891,4,3,3158,3158,3161,0,3,3
892,5,2,3163,3163,3165,0,2,2
893,1,2,3164,3165,3167,1,3,0
894,1,3,3165,3167,3170,2,5,0
895,5,1,3170,3170,3171,0,1,0
896,5,3,3175,3175,3178,0,3,4
897,2,2,3177,3178,3180,1,3,0
898,6,3,3183,3183,3186,0,3,3
899,2,3,3185,3186,3189,1,4,0
900,1,3,3186,3189,3192,3,6,0
901,3,2,3189,3192,3194,3,5,0
902,1,2,3190,3194,3196,4,6,0
903,2,1,3192,3196,3197,4,5,0
904,1,1,3193,3197,3198,4,5,0
905,2,3,3195,3198,3201,3,6,0
906,6,1,3201,3201,3202,0,1,0
907,6,3,3207,3207,3210,0,3,5
908,1,1,3208,3210,3211,2,3,0
909,5,2,3213,3213,3215,0,2,2
910,5,1,3218,3218,3219,0,1,3
911,4,3,3222,3222,3225,0,3,3
912,6,1,3228,3228,3229,0,1,3
913,6,1,3234,3234,3235,0,1,5
914,5,3,3239,3239,3242,0,3,4
915,2,1,3241,3242,3243,1,2,0
916,2,3,3243,3243,3246,0,3,0
917,5,2,3248,3248,3250,0,2,2
918,3,1,3251,3251,3252,0,1,1
919,5,3,3256,3256,3259,0,3,4
920,1,2,3257,3259,3261,2,4,0
921,4,3,3261,3261,3264,0,3,0
922,6,2,3267,3267,3269,0,2,3
923,5,2,3272,3272,3274,0,2,3
924,4,2,3276,3276,3278,0,2,2
925,1,3,3277,3278,3281,1,4,0
926,4,1,3281,3281,3282,0,1,0
927,3,3,3284,3284,3287,0,3,2
928,4,1,3288,3288,3289,0,1,1
929,2,1,3290,3290,3291,0,1,1
930,6,2,3296,3296,3298,0,2,5
931,2,1,3298,3298,3299,0,1,0
932,2,2,3300,3300,3302,0,2,1
933,3,1,3303,3303,3304,0,1,1
934,5,3,3308,3308,3311,0,3,4
935,1,3,3309,3311,3314,2,5,0
936,1,2,3310,3314,3316,4,6,0
937,4,3,3314,3316,3319,2,5,0
938,6,1,3320,3320,3321,0,1,1
939,1,3,3321,3321,3324,0,3,0
940,4,1,3325,3325,3326,0,1,1
941,4,3,3329,3329,3332,0,3,3
942,3,1,3332,3332,3333,0,1,0
943,2,1,3334,3334,3335,0,1,1
944,2,3,3336,3336,3339,0,3,1
945,4,3,3340,3340,3343,0,3,1
946,5,1,3345,3345,3346,0,1,2
947,3,1,3348,3348,3349,0,1,2
948,6,3,3354,3354,3357,0,3,5
949,4,1,3358,3358,3359,0,1,1
950,4,2,3362,3362,3364,0,2,3
951,3,3,3365,3365,3368,0,3,1
952,1,2,3366,3368,3370,2,4,0
953,3,3,3369,3370,3373,1,4,0
954,1,1,3370,3373,3374,3,4,0
955,2,3,3372,3374,3377,2,5,0
956,1,1,3373,3377,3378,4,5,0
957,4,1,3377,3378,3379,1,2,0
958,5,1,3382,3382,3383,0,1,3
959,2,1,3384,3384,3385,0,1,1
960,2,2,3386,3386,3388,0,2,1
961,2,3,3388,3388,3391,0,3,0
962,3,1,3391,3391,3392,0,1,0
963,2,1,3393,3393,3394,0,1,1
964,2,1,3395,3395,3396,0,1,1
965,4,1,3399,3399,3400,0,1,3
966,3,3,3402,3402,3405,0,3,2
967,3,1,3405,3405,3406,0,1,0
968,6,3,3411,3411,3414,0,3,5
969,4,2,3415,3415,3417,0,2,1
970,2,3,3417,3417,3420,0,3,0
971,6,1,3423,3423,3424,0,1,3
972,4,2,3427,3427,3429,0,2,3
973,5,1,3432,3432,3433,0,1,3
974,6,3,3438,3438,3441,0,3,5
975,3,2,3441,3441,3443,0,2,0
976,1,3,3442,3443,3446,1,4,0
977,4,1,3446,3446,3447,0,1,0
978,3,3,3449,3449,3452,0,3,2
979,6,1,3455,3455,3456,0,1,3
980,3,1,3458,3458,3459,0,1,2
981,3,1,3461,3461,3462,0,1,2
982,3,1,3464,3464,3465,0,1,2
983,4,2,3468,3468,3470,0,2,3
984,3,2,3471,3471,3473,0,2,1
985,4,3,3475,3475,3478,0,3,2
986,6,2,3481,3481,3483,0,2,3
987,6,1,3487,3487,3488,0,1,4
988,4,2,3491,3491,3493,0,2,3
989,1,2,3492,3493,3495,1,3,0
990,4,2,3496,3496,3498,0,2,1
991,1,3,3497,3498,3501,1,4,0
992,4,2,3501,3501,3503,0,2,0
993,6,2,3507,3507,3509,0,2,4
994,6,3,3513,3513,3516,0,3,4
995,3,1,3516,3516,3517,0,1,0
996,1,3,3517,3517,3520,0,3,0
997,3,3,3520,3520,3523,0,3,0
998,5,2,3525,3525,3527,0,2,2
999,1,3,3526,3527,3530,1,4,0
1000,4,1,3530,3530,3531,0,1,0
1001,3,1,3533,3533,3534,0,1,2
1002,5,1,3538,3538,3539,0,1,4
1003,4,1,3542,3542,3543,0,1,3
1004,4,1,3546,3546,3547,0,1,3
1005,2,1,3548,3548,3549,0,1,1
1006,1,2,3549,3549,3551,0,2,0
1007,4,3,3553,3553,3556,0,3,2
1008,1,1,3554,3556,3557,2,3,0
1009,6,1,3560,3560,3561,0,1,3
1010,3,2,3563,3563,3565,0,2,2
1011,1,2,3564,3565,3567,1,3,0
1012,2,2,3566,3567,3569,1,3,0
1013,1,1,3567,3569,3570,2,3,0
1014,2,3,3569,3570,3573,1,4,0
1015,6,3,3575,3575,3578,0,3,2
1016,6,3,3581,3581,3584,0,3,3
1017,6,1,3587,3587,3588,0,1,3
1018,2,2,3589,3589,3591,0,2,1
1019,3,1,3592,3592,3593,0,1,1
1020,2,3,3594,3594,3597,0,3,1
1021,1,2,3595,3597,3599,2,4,0
1022,4,3,3599,3599,3602,0,3,0
1023,3,1,3602,3602,3603,0,1,0
1024,4,1,3606,3606,3607,0,1,3
1025,6,1,3612,3612,3613,0,1,5
1026,6,3,3618,3618,3621,0,3,5
1027,3,1,3621,3621,3622,0,1,0
1028,2,2,3623,3623,3625,0,2,1
1029,4,2,3627,3627,3629,0,2,2
1030,6,1,3633,3633,3634,0,1,4
1031,4,2,3637,3637,3639,0,2,3
1032,1,1,3638,3639,3640,1,2,0
1033,5,3,3643,3643,3646,0,3,3
1034,1,3,3644,3646,3649,2,5,0
1035,3,1,3647,3649,3650,2,3,0
1036,3,1,3650,3650,3651,0,1,0
1037,4,3,3654,3654,3657,0,3,3
1038,2,2,3656,3657,3659,1,3,0
1039,1,2,3657,3659,3661,2,4,0
1040,2,3,3659,3661,3664,2,5,0
1041,6,1,3665,3665,3666,0,1,1
1042,1,3,3666,3666,3669,0,3,0
1043,2,2,3668,3669,3671,1,3,0
1044,1,3,3669,3671,3674,2,5,0
1045,3,3,3672,3674,3677,2,5,0
1046,5,3,3677,3677,3680,0,3,0
1047,1,3,3678,3680,3683,2,5,0
1048,2,1,3680,3683,3684,3,4,0
1049,6,3,3686,3686,3689,0,3,2
1050,6,2,3692,3692,3694,0,2,3
1051,1,3,3693,3694,3697,1,4,0
1052,4,1,3697,3697,3698,0,1,0
1053,5,1,3702,3702,3703,0,1,4
1054,4,1,3706,3706,3707,0,1,3
1055,3,2,3709,3709,3711,0,2,2
1056,1,1,3710,3711,3712,1,2,0
1057,6,1,3716,3716,3717,0,1,4
1058,5,2,3721,3721,3723,0,2,4
1059,3,1,3724,3724,3725,0,1,1
1060,3,1,3727,3727,3728,0,1,2
1061,4,1,3731,3731,3732,0,1,3
1062,1,1,3732,3732,3733,0,1,0
1063,5,3,3737,3737,3740,0,3,4
1064,3,1,3740,3740,3741,0,1,0
1065,1,3,3741,3741,3744,0,3,0
1066,6,2,3747,3747,3749,0,2,3
1067,1,3,3748,3749,3752,1,4,0
1068,6,3,3754,3754,3757,0,3,2
1069,5,1,3759,3759,3760,0,1,2
1070,4,3,3763,3763,3766,0,3,3
1071,1,2,3764,3766,3768,2,4,0
1072,6,2,3770,3770,3772,0,2,2
1073,4,2,3774,3774,3776,0,2,2
1074,5,2,3779,3779,3781,0,2,3
1075,6,3,3785,3785,3788,0,3,4
1076,4,3,3789,3789,3792,0,3,1
1077,3,3,3792,3792,3795,0,3,0
1078,3,1,3795,3795,3796,0,1,0
1079,1,3,3796,3796,3799,0,3,0
1080,6,2,3802,3802,3804,0,2,3
1081,5,2,3807,3807,3809,0,2,3
1082,2,1,3809,3809,3810,0,1,0
1083,5,3,3814,3814,3817,0,3,4
1084,1,3,3815,3817,3820,2,5,0
1085,1,1,3816,3820,3821,4,5,0
1086,2,2,3818,3821,3823,3,5,0
1087,6,3,3824,3824,3827,0,3,1
1088,1,2,3825,3827,3829,2,4,0
1089,3,2,3828,3829,3831,1,3,0
1090,3,1,3831,3831,3832,0,1,0
1091,3,2,3834,3834,3836,0,2,2
1092,6,3,3840,3840,3843,0,3,4
1093,6,2,3846,3846,3848,0,2,3
1094,1,2,3847,3848,3850,1,3,0
1095,6,1,3853,3853,3854,0,1,3
1096,6,3,3859,3859,3862,0,3,5
1097,3,3,3862,3862,3865,0,3,0
1098,6,2,3868,3868,3870,0,2,3
1099,4,1,3872,3872,3873,0,1,2
1100,3,2,3875,3875,3877,0,2,2
1101,4,1,3879,3879,3880,0,1,2
1102,4,3,3883,3883,3886,0,3,3
1103,2,1,3885,3886,3887,1,2,0
1104,2,1,3887,3887,3888,0,1,0
1105,5,3,3892,3892,3895,0,3,4
1106,3,2,3895,3895,3897,0,2,0
1107,2,3,3897,3897,3900,0,3,0
1108,5,2,3902,3902,3904,0,2,2
1109,3,1,3905,3905,3906,0,1,1
1110,2,1,3907,3907,3908,0,1,1
1111,6,2,3913,3913,3915,0,2,5
1112,3,1,3916,3916,3917,0,1,1
1113,4,2,3920,3920,3922,0,2,3
1114,5,2,3925,3925,3927,0,2,3
1115,3,2,3928,3928,3930,0,2,1
1116,4,1,3932,3932,3933,0,1,2
1117,5,3,3937,3937,3940,0,3,4
1118,2,1,3939,3940,3941,1,2,0
1119,1,1,3940,3941,3942,1,2,0
1120,2,2,3942,3942,3944,0,2,0
1121,1,1,3943,3944,3945,1,2,0
1122,2,2,3945,3945,3947,0,2,0
1123,1,2,3946,3947,3949,1,3,0
1124,2,1,3948,3949,3950,1,2,0
1125,3,3,3951,3951,3954,0,3,1
1126,3,1,3954,3954,3955,0,1,0
1127,2,1,3956,3956,3957,0,1,1
1128,5,2,3961,3961,3963,0,2,4
1129,4,2,3965,3965,3967,0,2,2
1130,4,2,3969,3969,3971,0,2,2
1131,4,2,3973,3973,3975,0,2,2
1132,6,2,3979,3979,3981,0,2,4
1133,2,2,3981,3981,3983,0,2,0
1134,2,1,3983,3983,3984,0,1,0
1135,1,1,3984,3984,3985,0,1,0
1136,2,3,3986,3986,3989,0,3,1
1137,3,1,3989,3989,3990,0,1,0
1138,1,1,3990,3990,3991,0,1,0
1139,3,3,3993,3993,3996,0,3,2
1140,5,3,3998,3998,4001,0,3,2
1141,6,1,4004,4004,4005,0,1,3
1142,2,3,4006,4006,4009,0,3,1
1143,4,3,4010,4010,4013,0,3,1
1144,2,1,4012,4013,4014,1,2,0
1145,4,1,4016,4016,4017,0,1,2
1146,6,2,4022,4022,4024,0,2,5
1147,2,1,4024,4024,4025,0,1,0
1148,5,2,4029,4029,4031,0,2,4
1149,4,1,4033,4033,4034,0,1,2
1150,3,1,4036,4036,4037,0,1,2
1151,2,3,4038,4038,4041,0,3,1
1152,5,1,4043,4043,4044,0,1,2
1153,6,3,4049,4049,4052,0,3,5
1154,3,1,4052,4052,4053,0,1,0
1155,2,1,4054,4054,4055,0,1,1
1156,2,1,4056,4056,4057,0,1,1
1157,1,3,4057,4057,4060,0,3,0
1158,5,2,4062,4062,4064,0,2,2
1159,6,3,4068,4068,4071,0,3,4
1160,4,2,4072,4072,4074,0,2,1
1161,4,3,4076,4076,4079,0,3,2
1162,4,3,4080,4080,4083,0,3,1
1163,2,3,4082,4083,4086,1,4,0
1164,1,3,4083,4086,4089,3,6,0
1165,4,3,4087,4089,4092,2,5,0
1166,2,1,4089,4092,4093,3,4,0
1167,3,3,4092,4093,4096,1,4,0
1168,5,1,4097,4097,4098,0,1,1
1169,6,1,4103,4103,4104,0,1,5
1170,5,2,4108,4108,4110,0,2,4
1171,1,1,4109,4110,4111,1,2,0
1172,5,2,4114,4114,4116,0,2,3
1173,4,2,4118,4118,4120,0,2,2
1174,2,2,4120,4120,4122,0,2,0
1175,5,3,4125,4125,4128,0,3,3
1176,6,2,4131,4131,4133,0,2,3
1177,6,1,4137,4137,4138,0,1,4
1178,6,2,4143,4143,4145,0,2,5
1179,4,2,4147,4147,4149,0,2,2
1180,4,3,4151,4151,4154,0,3,2
1181,2,2,4153,4154,4156,1,3,0
1182,5,3,4158,4158,4161,0,3,2
1183,2,1,4160,4161,4162,1,2,0
1184,4,2,4164,4164,4166,0,2,2
1185,3,3,4167,4167,4170,0,3,1
1186,5,2,4172,4172,4174,0,2,2
1187,1,1,4173,4174,4175,1,2,0
1188,1,1,4174,4175,4176,1,2,0
1189,6,2,4180,4180,4182,0,2,4
1190,4,3,4184,4184,4187,0,3,2
1191,3,1,4187,4187,4188,0,1,0
1192,3,2,4190,4190,4192,0,2,2
1193,5,1,4195,4195,4196,0,1,3
1194,5,2,4200,4200,4202,0,2,4
1195,2,2,4202,4202,4204,0,2,0
1196,4,3,4206,4206,4209,0,3,2
1197,2,2,4208,4209,4211,1,3,0
1198,6,1,4214,4214,4215,0,1,3
1199,3,1,4217,4217,4218,0,1,2
1200,4,3,4221,4221,4224,0,3,3
1201,6,1,4227,4227,4228,0,1,3
1202,2,3,4229,4229,4232,0,3,1
1203,6,1,4235,4235,4236,0,1,3
1204,2,3,4237,4237,4240,0,3,1
1205,1,1,4238,4240,4241,2,3,0
1206,2,2,4240,4241,4243,1,3,0
1207,4,1,4244,4244,4245,0,1,1
1208,6,1,4250,4250,4251,0,1,5
1209,4,3,4254,4254,4257,0,3,3
1210,4,3,4258,4258,4261,0,3,1
1211,4,3,4262,4262,4265,0,3,1
1212,1,1,4263,4265,4266,2,3,0
1213,2,3,4265,4266,4269,1,4,0
1214,1,1,4266,4269,4270,3,4,0
1215,3,1,4269,4270,4271,1,2,0
1216,6,1,4275,4275,4276,0,1,4
1217,1,2,4276,4276,4278,0,2,0
1218,5,2,4281,4281,4283,0,2,3
1219,6,3,4287,4287,4290,0,3,4
1220,6,2,4293,4293,4295,0,2,3
1221,1,2,4294,4295,4297,1,3,0
1222,4,2,4298,4298,4300,0,2,1
1223,6,1,4304,4304,4305,0,1,4
1224,1,2,4305,4305,4307,0,2,0
1225,4,1,4309,4309,4310,0,1,2
1226,5,3,4314,4314,4317,0,3,4
1227,6,3,4320,4320,4323,0,3,3
1228,3,2,4323,4323,4325,0,2,0
1229,3,2,4326,4326,4328,0,2,1
1230,2,1,4328,4328,4329,0,1,0
1231,1,3,4329,4329,4332,0,3,0
1232,4,2,4333,4333,4335,0,2,1
1233,4,3,4337,4337,4340,0,3,2
1234,6,3,4343,4343,4346,0,3,3
1235,3,1,4346,4346,4347,0,1,0
1236,3,1,4349,4349,4350,0,1,2
1237,3,2,4352,4352,4354,0,2,2
1238,6,2,4358,4358,4360,0,2,4
1239,3,1,4361,4361,4362,0,1,1
1240,5,2,4366,4366,4368,0,2,4
1241,2,2,4368,4368,4370,0,2,0
1242,6,1,4374,4374,4375,0,1,4
1243,5,3,4379,4379,4382,0,3,4
1244,4,1,4383,4383,4384,0,1,1
1245,2,2,4385,4385,4387,0,2,1
1246,6,1,4391,4391,4392,0,1,4
1247,4,3,4395,4395,4398,0,3,3
1248,4,3,4399,4399,4402,0,3,1
1249,6,1,4405,4405,4406,0,1,3
1250,2,1,4407,4407,4408,0,1,1
1251,3,1,4410,4410,4411,0,1,2
1252,5,3,4415,4415,4418,0,3,4
1253,3,3,4418,4418,4421,0,3,0
1254,3,2,4421,4421,4423,0,2,0
1255,5,1,4426,4426,4427,0,1,3
1256,6,2,4432,4432,4434,0,2,5
1257,2,3,4434,4434,4437,0,3,0
1258,5,3,4439,4439,4442,0,3,2
1259,6,2,4445,4445,4447,0,2,3
1260,6,3,4451,4451,4454,0,3,4
1261,3,1,4454,4454,4455,0,1,0
1262,3,1,4457,4457,4458,0,1,2
1263,1,2,4458,4458,4460,0,2,0
1264,5,2,4463,4463,4465,0,2,3
1265,1,1,4464,4465,4466,1,2,0
1266,1,1,4465,4466,4467,1,2,0
1267,3,3,4468,4468,4471,0,3,1
1268,2,2,4470,4471,4473,1,3,0
1269,2,3,4472,4473,4476,1,4,0
1270,2,1,4474,4476,4477,2,3,0
1271,6,3,4480,4480,4483,0,3,3
1272,2,3,4482,4483,4486,1,4,0
1273,2,2,4484,4486,4488,2,4,0
1274,6,1,4490,4490,4491,0,1,2
1275,3,3,4493,4493,4496,0,3,2
1276,6,3,4499,4499,4502,0,3,3
1277,1,1,4500,4502,4503,2,3,0
1278,2,3,4502,4503,4506,1,4,0
1279,1,2,4503,4506,4508,3,5,0
1280,4,3,4507,4508,4511,1,4,0
1281,3,3,4510,4511,4514,1,4,0
1282,2,2,4512,4514,4516,2,4,0
1283,2,2,4514,4516,4518,2,4,0
1284,4,3,4518,4518,4521,0,3,0
1285,2,2,4520,4521,4523,1,3,0
1286,4,1,4524,4524,4525,0,1,1
1287,1,1,4525,4525,4526,0,1,0
1288,6,2,4531,4531,4533,0,2,5
1289,6,1,4537,4537,4538,0,1,4
1290,6,2,4543,4543,4545,0,2,5
1291,1,3,4544,4545,4548,1,4,0
1292,4,2,4548,4548,4550,0,2,0
1293,5,2,4553,4553,4555,0,2,3
1294,4,1,4557,4557,4558,0,1,2
1295,1,1,4558,4558,4559,0,1,0
1296,5,1,4563,4563,4564,0,1,4
1297,4,1,4567,4567,4568,0,1,3
1298,1,1,4568,4568,4569,0,1,0
1299,2,3,4570,4570,4573,0,3,1
1300,3,2,4573,4573,4575,0,2,0
1301,1,1,4574,4575,4576,1,2,0
1302,4,2,4578,4578,4580,0,2,2
1303,6,1,4584,4584,4585,0,1,4
1304,1,3,4585,4585,4588,0,3,0
1305,1,1,4586,4588,4589,2,3,0
1306,3,3,4589,4589,4592,0,3,0
1307,3,3,4592,4592,4595,0,3,0
1308,6,2,4598,4598,4600,0,2,3
1309,5,1,4603,4603,4604,0,1,3
1310,6,3,4609,4609,4612,0,3,5
1311,6,2,4615,4615,4617,0,2,3
1312,3,1,4618,4618,4619,0,1,1
1313,3,3,4621,4621,4624,0,3,2
1314,6,3,4627,4627,4630,0,3,3
1315,6,2,4633,4633,4635,0,2,3
1316,6,2,4639,4639,4641,0,2,4
1317,5,1,4644,4644,4645,0,1,3
1318,3,1,4647,4647,4648,0,1,2
1319,3,1,4650,4650,4651,0,1,2
1320,5,2,4655,4655,4657,0,2,4
1321,5,3,4660,4660,4663,0,3,3
1322,2,1,4662,4663,4664,1,2,0
1323,1,3,4663,4664,4667,1,4,0
1324,3,1,4666,4667,4668,1,2,0
1325,2,2,4668,4668,4670,0,2,0
1326,4,1,4672,4672,4673,0,1,2
1327,3,2,4675,4675,4677,0,2,2
1328,4,2,4679,4679,4681,0,2,2
1329,5,1,4684,4684,4685,0,1,3
1330,4,3,4688,4688,4691,0,3,3
1331,5,2,4693,4693,4695,0,2,2
1332,6,1,4699,4699,4700,0,1,4
1333,1,1,4700,4700,4701,0,1,0
1334,3,3,4703,4703,4706,0,3,2
1335,2,1,4705,4706,4707,1,2,0
1336,1,3,4706,4707,4710,1,4,0
1337,1,3,4707,4710,4713,3,6,0
1338,2,1,4709,4713,4714,4,5,0
1339,2,3,4711,4714,4717,3,6,0
1340,1,2,4712,4717,4719,5,7,0
1341,1,1,4713,4719,4720,6,7,0
1342,4,3,4717,4720,4723,3,6,0
1343,1,3,4718,4723,4726,5,8,0
1344,3,2,4721,4726,4728,5,7,0
1345,3,2,4724,4728,4730,4,6,0
1346,2,2,4726,4730,4732,4,6,0
1347,4,2,4730,4732,4734,2,4,0
1348,4,3,4734,4734,4737,0,3,0
1349,5,3,4739,4739,4742,0,3,2
1350,2,1,4741,4742,4743,1,2,0
1351,4,3,4745,4745,4748,0,3,2
1352,6,3,4751,4751,4754,0,3,3
1353,3,1,4754,4754,4755,0,1,0
1354,4,2,4758,4758,4760,0,2,3
1355,6,3,4764,4764,4767,0,3,4
1356,2,3,4766,4767,4770,1,4,0
1357,3,2,4769,4770,4772,1,3,0
1358,4,3,4773,4773,4776,0,3,1
1359,2,2,4775,4776,4778,1,3,0
1360,2,1,4777,4778,4779,1,2,0
1361,2,1,4779,4779,4780,0,1,0
1362,5,2,4784,4784,4786,0,2,4
1363,5,1,4789,4789,4790,0,1,3
1364,6,3,4795,4795,4798,0,3,5
1365,1,3,4796,4798,4801,2,5,0
1366,3,1,4799,4801,4802,2,3,0
1367,1,2,4800,4802,4804,2,4,0
1368,1,2,4801,4804,4806,3,5,0
1369,5,3,4806,4806,4809,0,3,0
1370,1,1,4807,4809,4810,2,3,0
1371,5,2,4812,4812,4814,0,2,2
1372,6,3,4818,4818,4821,0,3,4
1373,4,1,4822,4822,4823,0,1,1
1374,6,2,4828,4828,4830,0,2,5
1375,6,1,4834,4834,4835,0,1,4
1376,3,1,4837,4837,4838,0,1,2
1377,4,2,4841,4841,4843,0,2,3
1378,1,3,4842,4843,4846,1,4,0
1379,1,2,4843,4846,4848,3,5,0
1380,3,1,4846,4848,4849,2,3,0
1381,3,3,4849,4849,4852,0,3,0
1382,5,3,4854,4854,4857,0,3,2
1383,3,3,4857,4857,4860,0,3,0
1384,5,2,4862,4862,4864,0,2,2
1385,6,3,4868,4868,4871,0,3,4
1386,5,3,4873,4873,4876,0,3,2
1387,3,2,4876,4876,4878,0,2,0
1388,5,3,4881,4881,4884,0,3,3
1389,5,3,4886,4886,4889,0,3,2
1390,3,3,4889,4889,4892,0,3,0
1391,5,2,4894,4894,4896,0,2,2
1392,1,2,4895,4896,4898,1,3,0
1393,3,1,4898,4898,4899,0,1,0
1394,4,1,4902,4902,4903,0,1,3
1395,3,2,4905,4905,4907,0,2,2
1396,1,3,4906,4907,4910,1,4,0
1397,4,2,4910,4910,4912,0,2,0
1398,5,2,4915,4915,4917,0,2,3
1399,1,3,4916,4917,4920,1,4,0
1400,1,2,4917,4920,4922,3,5,0
1401,5,2,4922,4922,4924,0,2,0
1402,5,3,4927,4927,4930,0,3,3
1403,4,2,4931,4931,4933,0,2,1
1404,1,2,4932,4933,4935,1,3,0
1405,4,2,4936,4936,4938,0,2,1
1406,2,2,4938,4938,4940,0,2,0
1407,1,3,4939,4940,4943,1,4,0
1408,2,3,4941,4943,4946,2,5,0
1409,2,3,4943,4946,4949,3,6,0
1410,3,1,4946,4949,4950,3,4,0
1411,4,2,4950,4950,4952,0,2,0
1412,6,3,4956,4956,4959,0,3,4
1413,6,3,4962,4962,4965,0,3,3
1414,2,1,4964,4965,4966,1,2,0
1415,3,1,4967,4967,4968,0,1,1
1416,2,2,4969,4969,4971,0,2,1
1417,5,1,4974,4974,4975,0,1,3
1418,6,2,4980,4980,4982,0,2,5
1419,3,3,4983,4983,4986,0,3,1
1420,4,1,4987,4987,4988,0,1,1
1421,6,2,4993,4993,4995,0,2,5
1422,2,3,4995,4995,4998,0,3,0
1423,1,1,4996,4998,4999,2,3,0
1424,2,2,4998,4999,5001,1,3,0
1425,1,2,4999,5001,5003,2,4,0
1426,2,1,5001,5003,5004,2,3,0
1427,6,2,5007,5007,5009,0,2,3
1428,5,2,5012,5012,5014,0,2,3
1429,5,2,5017,5017,5019,0,2,3
1430,1,3,5018,5019,5022,1,4,0
1431,3,3,5021,5022,5025,1,4,0
1432,1,1,5022,5025,5026,3,4,0
1433,1,1,5023,5026,5027,3,4,0
1434,6,3,5029,5029,5032,0,3,2
1435,2,3,5031,5032,5035,1,4,0
1436,1,2,5032,5035,5037,3,5,0
1437,4,3,5036,5037,5040,1,4,0
1438,4,1,5040,5040,5041,0,1,0
1439,2,1,5042,5042,5043,0,1,1
1440,6,1,5048,5048,5049,0,1,5
1441,6,3,5054,5054,5057,0,3,5
1442,4,3,5058,5058,5061,0,3,1
1443,4,3,5062,5062,5065,0,3,1
1444,3,2,5065,5065,5067,0,2,0
1445,6,1,5071,5071,5072,0,1,4
1446,3,2,5074,5074,5076,0,2,2
1447,3,2,5077,5077,5079,0,2,1
1448,6,1,5083,5083,5084,0,1,4
1449,4,2,5087,5087,5089,0,2,3
1450,2,3,5089,5089,5092,0,3,0
1451,1,2,5090,5092,5094,2,4,0
1452,2,2,5092,5094,5096,2,4,0
1453,2,3,5094,5096,5099,2,5,0
1454,4,2,5098,5099,5101,1,3,0
1455,4,3,5102,5102,5105,0,3,1
1456,5,1,5107,5107,5108,0,1,2
1457,5,2,5112,5112,5114,0,2,4
1458,4,3,5116,5116,5119,0,3,2
1459,6,3,5122,5122,5125,0,3,3
1460,4,3,5126,5126,5129,0,3,1
1461,4,2,5130,5130,5132,0,2,1
1462,6,1,5136,5136,5137,0,1,4
1463,4,1,5140,5140,5141,0,1,3
1464,6,3,5146,5146,5149,0,3,5
1465,1,1,5147,5149,5150,2,3,0
1466,4,3,5151,5151,5154,0,3,1
1467,1,2,5152,5154,5156,2,4,0
1468,6,2,5158,5158,5160,0,2,2
1469,5,2,5163,5163,5165,0,2,3
1470,6,2,5169,5169,5171,0,2,4
1471,6,3,5175,5175,5178,0,3,4
1472,4,2,5179,5179,5181,0,2,1
1473,4,3,5183,5183,5186,0,3,2
1474,2,2,5185,5186,5188,1,3,0
1475,5,2,5190,5190,5192,0,2,2
1476,6,1,5196,5196,5197,0,1,4
1477,2,3,5198,5198,5201,0,3,1
1478,6,1,5204,5204,5205,0,1,3
1479,3,1,5207,5207,5208,0,1,2
1480,6,2,5213,5213,5215,0,2,5
1481,2,3,5215,5215,5218,0,3,0
1482,4,1,5219,5219,5220,0,1,1
1483,1,1,5220,5220,5221,0,1,0
1484,1,1,5221,5221,5222,0,1,0
1485,5,3,5226,5226,5229,0,3,4
1486,2,2,5228,5229,5231,1,3,0
1487,6,2,5234,5234,5236,0,2,3
1488,4,2,5238,5238,5240,0,2,2
1489,3,2,5241,5241,5243,0,2,1
1490,3,3,5244,5244,5247,0,3,1
1491,4,1,5248,5248,5249,0,1,1
1492,1,2,5249,5249,5251,0,2,0
1493,1,1,5250,5251,5252,1,2,0
1494,4,1,5254,5254,5255,0,1,2
1495,2,2,5256,5256,5258,0,2,1
1496,1,3,5257,5258,5261,1,4,0
1497,6,2,5263,5263,5265,0,2,2
1498,5,3,5268,5268,5271,0,3,3
1499,2,1,5270,5271,5272,1,2,0
1500,4,2,5274,5274,5276,0,2,2
1501,6,1,5280,5280,5281,0,1,4
1502,1,3,5281,5281,5284,0,3,0
1503,5,2,5286,5286,5288,0,2,2
1504,1,3,5287,5288,5291,1,4,0
1505,2,3,5289,5291,5294,2,5,0
1506,2,2,5291,5294,5296,3,5,0
1507,6,1,5297,5297,5298,0,1,1
1508,4,2,5301,5301,5303,0,2,3
1509,5,1,5306,5306,5307,0,1,3
1510,4,3,5310,5310,5313,0,3,3
1511,4,1,5314,5314,5315,0,1,1
1512,5,1,5319,5319,5320,0,1,4
1513,3,1,5322,5322,5323,0,1,2
1514,1,3,5323,5323,5326,0,3,0
1515,4,3,5327,5327,5330,0,3,1
1516,2,1,5329,5330,5331,1,2,0
1517,6,3,5335,5335,5338,0,3,4
1518,5,1,5340,5340,5341,0,1,2
1519,5,1,5345,5345,5346,0,1,4
1520,6,1,5351,5351,5352,0,1,5
1521,3,1,5354,5354,5355,0,1,2
1522,2,1,5356,5356,5357,0,1,1
1523,4,1,5360,5360,5361,0,1,3
1524,1,3,5361,5361,5364,0,3,0
1525,5,2,5366,5366,5368,0,2,2
1526,3,3,5369,5369,5372,0,3,1
1527,5,2,5374,5374,5376,0,2,2
1528,5,1,5379,5379,5380,0,1,3
1529,2,1,5381,5381,5382,0,1,1
1530,4,2,5385,5385,5387,0,2,3
1531,5,2,5390,5390,5392,0,2,3
1532,4,3,5394,5394,5397,0,3,2
1533,3,3,5397,5397,5400,0,3,0
1534,1,2,5398,5400,5402,2,4,0
1535,1,1,5399,5402,5403,3,4,0
1536,5,2,5404,5404,5406,0,2,1
1537,2,2,5406,5406,5408,0,2,0
1538,5,3,5411,5411,5414,0,3,3
1539,3,2,5414,5414,5416,0,2,0
1540,6,1,5420,5420,5421,0,1,4
1541,6,2,5426,5426,5428,0,2,5
1542,2,2,5428,5428,5430,0,2,0
1543,1,2,5429,5430,5432,1,3,0
1544,3,2,5432,5432,5434,0,2,0
1545,6,3,5438,5438,5441,0,3,4
1546,2,3,5440,5441,5444,1,4,0
1547,3,1,5443,5444,5445,1,2,0
1548,6,3,5449,5449,5452,0,3,4
1549,4,1,5453,5453,5454,0,1,1
1550,3,3,5456,5456,5459,0,3,2
1551,5,1,5461,5461,5462,0,1,2
1552,3,1,5464,5464,5465,0,1,2
1553,6,1,5470,5470,5471,0,1,5
1554,6,3,5476,5476,5479,0,3,5
1555,3,3,5479,5479,5482,0,3,0
1556,1,3,5480,5482,5485,2,5,0
1557,3,2,5483,5485,5487,2,4,0
1558,3,1,5486,5487,5488,1,2,0
1559,2,3,5488,5488,5491,0,3,0
1560,6,3,5494,5494,5497,0,3,3
1561,1,2,5495,5497,5499,2,4,0
1562,2,3,5497,5499,5502,2,5,0
1563,6,2,5503,5503,5505,0,2,1
1564,2,2,5505,5505,5507,0,2,0
1565,2,3,5507,5507,5510,0,3,0
1566,2,1,5509,5510,5511,1,2,0
1567,3,1,5512,5512,5513,0,1,1
1568,2,3,5514,5514,5517,0,3,1
1569,3,2,5517,5517,5519,0,2,0
1570,4,3,5521,5521,5524,0,3,2
1571,4,2,5525,5525,5527,0,2,1
1572,5,3,5530,5530,5533,0,3,3
1573,6,2,5536,5536,5538,0,2,3
1574,6,1,5542,5542,5543,0,1,4
1575,1,1,5543,5543,5544,0,1,0
1576,4,1,5547,5547,5548,0,1,3
1577,5,1,5552,5552,5553,0,1,4
1578,1,3,5553,5553,5556,0,3,0
1579,2,3,5555,5556,5559,1,4,0
1580,1,2,5556,5559,5561,3,5,0
1581,6,1,5562,5562,5563,0,1,1
1582,4,3,5566,5566,5569,0,3,3
1583,1,1,5567,5569,5570,2,3,0
1584,3,2,5570,5570,5572,0,2,0
1585,5,3,5575,5575,5578,0,3,3
1586,3,1,5578,5578,5579,0,1,0
1587,3,2,5581,5581,5583,0,2,2
1588,1,3,5582,5583,5586,1,4,0
1589,1,2,5583,5586,5588,3,5,0
1590,3,1,5586,5588,5589,2,3,0
1591,3,2,5589,5589,5591,0,2,0
1592,6,1,5595,5595,5596,0,1,4
1593,2,2,5597,5597,5599,0,2,1
1594,3,2,5600,5600,5602,0,2,1
1595,3,2,5603,5603,5605,0,2,1
1596,1,3,5604,5605,5608,1,4,0
1597,5,1,5609,5609,5610,0,1,1
1598,2,3,5611,5611,5614,0,3,1
1599,4,2,5615,5615,5617,0,2,1
1600,3,3,5618,5618,5621,0,3,1
1601,1,1,5619,5621,5622,2,3,0
1602,5,1,5624,5624,5625,0,1,2
1603,1,2,5625,5625,5627,0,2,0
1604,3,1,5628,5628,5629,0,1,1
1605,2,3,5630,5630,5633,0,3,1
1606,3,3,5633,5633,5636,0,3,0
1607,1,2,5634,5636,5638,2,4,0
1608,5,3,5639,5639,5642,0,3,1
1609,2,3,5641,5642,5645,1,4,0
1610,3,3,5644,5645,5648,1,4,0
1611,1,3,5645,5648,5651,3,6,0
1612,4,1,5649,5651,5652,2,3,0
1613,5,2,5654,5654,5656,0,2,2
1614,1,1,5655,5656,5657,1,2,0
1615,5,1,5660,5660,5661,0,1,3
1616,3,2,5663,5663,5665,0,2,2
1617,3,2,5666,5666,5668,0,2,1
1618,5,2,5671,5671,5673,0,2,3
1619,6,3,5677,5677,5680,0,3,4
1620,4,3,5681,5681,5684,0,3,1
1621,1,1,5682,5684,5685,2,3,0
1622,5,3,5687,5687,5690,0,3,2
1623,1,2,5688,5690,5692,2,4,0
1624,4,2,5692,5692,5694,0,2,0
1625,3,2,5695,5695,5697,0,2,1
1626,2,3,5697,5697,5700,0,3,0
1627,2,2,5699,5700,5702,1,3,0
1628,3,3,5702,5702,5705,0,3,0
1629,1,3,5703,5705,5708,2,5,0
1630,1,3,5704,5708,5711,4,7,0
1631,1,1,5705,5711,5712,6,7,0
1632,5,2,5710,5712,5714,2,4,0
1633,1,1,5711,5714,5715,3,4,0
1634,6,1,5717,5717,5718,0,1,2
1635,3,1,5720,5720,5721,0,1,2
1636,4,1,5724,5724,5725,0,1,3
1637,2,1,5726,5726,5727,0,1,1
1638,6,3,5732,5732,5735,0,3,5
1639,4,1,5736,5736,5737,0,1,1
1640,1,3,5737,5737,5740,0,3,0
1641,1,1,5738,5740,5741,2,3,0
1642,1,1,5739,5741,5742,2,3,0
1643,4,1,5743,5743,5744,0,1,1
1644,6,1,5749,5749,5750,0,1,5
1645,4,2,5753,5753,5755,0,2,3
1646,1,2,5754,5755,5757,1,3,0
1647,6,3,5760,5760,5763,0,3,3
1648,3,2,5763,5763,5765,0,2,0
1649,6,3,5769,5769,5772,0,3,4
1650,2,1,5771,5772,5773,1,2,0
1651,6,1,5777,5777,5778,0,1,4
1652,1,1,5778,5778,5779,0,1,0
1653,2,1,5780,5780,5781,0,1,1
1654,1,2,5781,5781,5783,0,2,0
1655,4,2,5785,5785,5787,0,2,2
1656,2,1,5787,5787,5788,0,1,0
1657,1,1,5788,5788,5789,0,1,0
1658,1,1,5789,5789,5790,0,1,0
1659,4,2,5793,5793,5795,0,2,3
1660,4,3,5797,5797,5800,0,3,2
1661,1,2,5798,5800,5802,2,4,0
1662,2,3,5800,5802,5805,2,5,0
1663,5,2,5805,5805,5807,0,2,0
1664,3,3,5808,5808,5811,0,3,1
1665,2,2,5810,5811,5813,1,3,0
1666,4,1,5814,5814,5815,0,1,1
1667,6,1,5820,5820,5821,0,1,5
1668,5,3,5825,5825,5828,0,3,4
1669,3,3,5828,5828,5831,0,3,0
1670,1,3,5829,5831,5834,2,5,0
1671,5,3,5834,5834,5837,0,3,0
1672,4,2,5838,5838,5840,0,2,1
1673,6,3,5844,5844,5847,0,3,4
1674,5,1,5849,5849,5850,0,1,2
1675,3,1,5852,5852,5853,0,1,2
1676,6,1,5858,5858,5859,0,1,5
1677,6,2,5864,5864,5866,0,2,5
1678,6,2,5870,5870,5872,0,2,4
1679,2,2,5872,5872,5874,0,2,0
1680,6,3,5878,5878,5881,0,3,4
1681,2,2,5880,5881,5883,1,3,0
1682,1,3,5881,5883,5886,2,5,0
1683,4,3,5885,5886,5889,1,4,0
1684,6,3,5891,5891,5894,0,3,2
1685,3,3,5894,5894,5897,0,3,0
1686,5,2,5899,5899,5901,0,2,2
1687,4,3,5903,5903,5906,0,3,2
1688,5,3,5908,5908,5911,0,3,2
1689,3,1,5911,5911,5912,0,1,0
1690,1,3,5912,5912,5915,0,3,0
1691,5,3,5917,5917,5920,0,3,2
1692,2,2,5919,5920,5922,1,3,0
1693,1,2,5920,5922,5924,2,4,0
1694,4,1,5924,5924,5925,0,1,0
1695,1,3,5925,5925,5928,0,3,0
1696,1,3,5926,5928,5931,2,5,0
1697,2,2,5928,5931,5933,3,5,0
1698,5,2,5933,5933,5935,0,2,0
1699,1,3,5934,5935,5938,1,4,0
1700,2,3,5936,5938,5941,2,5,0
1701,1,1,5937,5941,5942,4,5,0
1702,1,1,5938,5942,5943,4,5,0
1703,5,1,5943,5943,5944,0,1,0
1704,2,3,5945,5945,5948,0,3,1
1705,6,2,5951,5951,5953,0,2,3
1706,4,1,5955,5955,5956,0,1,2
1707,1,1,5956,5956,5957,0,1,0
1708,6,1,5962,5962,5963,0,1,5
1709,6,3,5968,5968,5971,0,3,5
1710,3,1,5971,5971,5972,0,1,0
1711,6,2,5977,5977,5979,0,2,5
1712,6,1,5983,5983,5984,0,1,4
1713,4,1,5987,5987,5988,0,1,3
1714,2,3,5989,5989,5992,0,3,1
1715,1,1,5990,5992,5993,2,3,0
1716,2,1,5992,5993,5994,1,2,0
1717,3,1,5995,5995,5996,0,1,1
1718,5,3,6000,6000,6003,0,3,4
1719,6,2,6006,6006,6008,0,2,3
1720,6,3,6012,6012,6015,0,3,4
1721,5,1,6017,6017,6018,0,1,2
1722,6,2,6023,6023,6025,0,2,5
1723,5,1,6028,6028,6029,0,1,3
1724,1,3,6029,6029,6032,0,3,0
1725,1,1,6030,6032,6033,2,3,0
1726,3,1,6033,6033,6034,0,1,0
1727,3,2,6036,6036,6038,0,2,2
1728,1,3,6037,6038,6041,1,4,0
1729,4,2,6041,6041,6043,0,2,0
1730,5,3,6046,6046,6049,0,3,3
1731,5,2,6051,6051,6053,0,2,2
1732,1,1,6052,6053,6054,1,2,0
1733,1,2,6053,6054,6056,1,3,0
1734,6,3,6059,6059,6062,0,3,3
1735,4,3,6063,6063,6066,0,3,1
1736,1,3,6064,6066,6069,2,5,0
1737,1,3,6065,6069,6072,4,7,0
1738,3,3,6068,6072,6075,4,7,0
1739,4,1,6072,6075,6076,3,4,0
1740,4,1,6076,6076,6077,0,1,0
1741,2,3,6078,6078,6081,0,3,1
1742,3,1,6081,6081,6082,0,1,0
1743,5,1,6086,6086,6087,0,1,4
1744,3,1,6089,6089,6090,0,1,2
1745,2,3,6091,6091,6094,0,3,1
1746,1,2,6092,6094,6096,2,4,0
1747,6,2,6098,6098,6100,0,2,2
1748,4,2,6102,6102,6104,0,2,2
1749,2,2,6104,6104,6106,0,2,0
1750,6,3,6110,6110,6113,0,3,4
1751,4,1,6114,6114,6115,0,1,1
1752,6,3,6120,6120,6123,0,3,5
1753,5,3,6125,6125,6128,0,3,2
1754,2,2,6127,6128,6130,1,3,0
1755,3,2,6130,6130,6132,0,2,0
1756,1,3,6131,6132,6135,1,4,0
1757,4,2,6135,6135,6137,0,2,0
1758,2,3,6137,6137,6140,0,3,0
1759,3,2,6140,6140,6142,0,2,0
1760,2,3,6142,6142,6145,0,3,0
1761,3,3,6145,6145,6148,0,3,0
1762,1,1,6146,6148,6149,2,3,0
1763,2,2,6148,6149,6151,1,3,0
1764,6,3,6154,6154,6157,0,3,3
1765,5,2,6159,6159,6161,0,2,2
1766,1,3,6160,6161,6164,1,4,0
1767,6,2,6166,6166,6168,0,2,2
1768,3,2,6169,6169,6171,0,2,1
1769,5,2,6174,6174,6176,0,2,3
1770,6,3,6180,6180,6183,0,3,4
1771,3,2,6183,6183,6185,0,2,0
1772,5,1,6188,6188,6189,0,1,3
1773,2,1,6190,6190,6191,0,1,1
1774,4,1,6194,6194,6195,0,1,3
1775,1,2,6195,6195,6197,0,2,0
1776,3,3,6198,6198,6201,0,3,1
1777,2,2,6200,6201,6203,1,3,0
1778,6,3,6206,6206,6209,0,3,3
1779,4,2,6210,6210,6212,0,2,1
1780,1,3,6211,6212,6215,1,4,0
1781,1,1,6212,6215,6216,3,4,0
1782,5,3,6217,6217,6220,0,3,1
1783,3,1,6220,6220,6221,0,1,0
1784,2,2,6222,6222,6224,0,2,1
1785,6,3,6228,6228,6231,0,3,4
1786,5,2,6233,6233,6235,0,2,2
1787,6,2,6239,6239,6241,0,2,4
1788,6,3,6245,6245,6248,0,3,4
1789,1,1,6246,6248,6249,2,3,0
1790,3,3,6249,6249,6252,0,3,0
1791,2,1,6251,6252,6253,1,2,0
1792,6,2,6257,6257,6259,0,2,4
1793,4,2,6261,6261,6263,0,2,2
1794,1,1,6262,6263,6264,1,2,0
1795,3,2,6265,6265,6267,0,2,1
1796,5,2,6270,6270,6272,0,2,3
1797,3,1,6273,6273,6274,0,1,1
1798,2,1,6275,6275,6276,0,1,1
1799,1,1,6276,6276,6277,0,1,0
1800,1,1,6277,6277,6278,0,1,0
1801,5,2,6282,6282,6284,0,2,4
1802,2,1,6284,6284,6285,0,1,0
1803,2,2,6286,6286,6288,0,2,1
1804,1,3,6287,6288,6291,1,4,0
1805,5,1,6292,6292,6293,0,1,1
1806,4,1,6296,6296,6297,0,1,3
1807,6,1,6302,6302,6303,0,1,5
1808,5,1,6307,6307,6308,0,1,4
1809,5,3,6312,6312,6315,0,3,4
1810,2,2,6314,6315,6317,1,3,0
1811,5,3,6319,6319,6322,0,3,2
1812,6,3,6325,6325,6328,0,3,3
1813,5,2,6330,6330,6332,0,2,2
1814,3,1,6333,6333,6334,0,1,1
1815,1,1,6334,6334,6335,0,1,0
1816,6,1,6340,6340,6341,0,1,5
1817,6,2,6346,6346,6348,0,2,5
1818,3,2,6349,6349,6351,0,2,1
1819,5,2,6354,6354,6356,0,2,3
1820,6,2,6360,6360,6362,0,2,4
1821,4,3,6364,6364,6367,0,3,2
1822,5,1,6369,6369,6370,0,1,2
1823,3,3,6372,6372,6375,0,3,2
1824,2,1,6374,6375,6376,1,2,0
1825,5,2,6379,6379,6381,0,2,3
1826,5,3,6384,6384,6387,0,3,3
1827,3,3,6387,6387,6390,0,3,0
1828,2,1,6389,6390,6391,1,2,0
1829,1,1,6390,6391,6392,1,2,0
1830,4,1,6394,6394,6395,0,1,2
1831,2,1,6396,6396,6397,0,1,1
1832,5,2,6401,6401,6403,0,2,4
1833,1,2,6402,6403,6405,1,3,0
1834,2,2,6404,6405,6407,1,3,0
1835,5,3,6409,6409,6412,0,3,2
1836,2,2,6411,6412,6414,1,3,0
1837,1,3,6412,6414,6417,2,5,0
1838,2,2,6414,6417,6419,3,5,0
1839,1,1,6415,6419,6420,4,5,0
1840,1,2,6416,6420,6422,4,6,0
1841,5,3,6421,6422,6425,1,4,0
1842,2,1,6423,6425,6426,2,3,0
1843,3,1,6426,6426,6427,0,1,0
1844,5,2,6431,6431,6433,0,2,4
1845,1,1,6432,6433,6434,1,2,0
1846,4,1,6436,6436,6437,0,1,2
1847,1,3,6437,6437,6440,0,3,0
1848,2,2,6439,6440,6442,1,3,0
1849,1,2,6440,6442,6444,2,4,0
1850,1,3,6441,6444,6447,3,6,0
1851,5,3,6446,6447,6450,1,4,0
1852,2,3,6448,6450,6453,2,5,0
1853,5,1,6453,6453,6454,0,1,0
1854,1,2,6454,6454,6456,0,2,0
1855,6,1,6460,6460,6461,0,1,4
1856,2,2,6462,6462,6464,0,2,1
1857,4,1,6466,6466,6467,0,1,2
1858,2,1,6468,6468,6469,0,1,1
1859,6,2,6474,6474,6476,0,2,5
1860,3,1,6477,6477,6478,0,1,1
1861,4,2,6481,6481,6483,0,2,3
1862,5,1,6486,6486,6487,0,1,3
1863,6,3,6492,6492,6495,0,3,5
1864,6,1,6498,6498,6499,0,1,3
1865,6,1,6504,6504,6505,0,1,5
1866,2,1,6506,6506,6507,0,1,1
1867,6,3,6512,6512,6515,0,3,5
1868,1,2,6513,6515,6517,2,4,0
1869,1,1,6514,6517,6518,3,4,0
1870,5,3,6519,6519,6522,0,3,1
1871,3,2,6522,6522,6524,0,2,0
1872,3,1,6525,6525,6526,0,1,1
1873,4,1,6529,6529,6530,0,1,3
1874,6,1,6535,6535,6536,0,1,5
1875,4,1,6539,6539,6540,0,1,3
1876,5,2,6544,6544,6546,0,2,4
1877,3,2,6547,6547,6549,0,2,1
1878,1,3,6548,6549,6552,1,4,0
1879,3,1,6551,6552,6553,1,2,0
1880,4,2,6555,6555,6557,0,2,2
1881,3,3,6558,6558,6561,0,3,1
1882,6,3,6564,6564,6567,0,3,3
1883,3,2,6567,6567,6569,0,2,0
1884,4,2,6571,6571,6573,0,2,2
1885,6,1,6577,6577,6578,0,1,4
1886,3,3,6580,6580,6583,0,3,2
1887,3,3,6583,6583,6586,0,3,0
1888,6,2,6589,6589,6591,0,2,3
1889,1,3,6590,6591,6594,1,4,0
1890,5,1,6595,6595,6596,0,1,1
1891,6,1,6601,6601,6602,0,1,5
1892,2,1,6603,6603,6604,0,1,1
1893,6,3,6609,6609,6612,0,3,5
1894,5,1,6614,6614,6615,0,1,2
1895,2,3,6616,6616,6619,0,3,1
1896,5,3,6621,6621,6624,0,3,2
1897,3,1,6624,6624,6625,0,1,0
1898,6,2,6630,6630,6632,0,2,5
1899,3,3,6633,6633,6636,0,3,1
1900,3,3,6636,6636,6639,0,3,0
1901,6,3,6642,6642,6645,0,3,3
1902,6,3,6648,6648,6651,0,3,3
1903,6,3,6654,6654,6657,0,3,3
1904,5,1,6659,6659,6660,0,1,2
1905,5,1,6664,6664,6665,0,1,4
1906,5,1,6669,6669,6670,0,1,4
1907,4,3,6673,6673,6676,0,3,3
1908,1,2,6674,6676,6678,2,4,0
1909,6,1,6680,6680,6681,0,1,2
1910,1,3,6681,6681,6684,0,3,0
1911,5,3,6686,6686,6689,0,3,2
1912,5,3,6691,6691,6694,0,3,2
1913,5,3,6696,6696,6699,0,3,2
1914,6,1,6702,6702,6703,0,1,3
1915,4,2,6706,6706,6708,0,2,3
1916,4,2,6710,6710,6712,0,2,2
1917,6,2,6716,6716,6718,0,2,4
1918,2,1,6718,6718,6719,0,1,0
1919,5,1,6723,6723,6724,0,1,4
1920,6,1,6729,6729,6730,0,1,5
1921,4,3,6733,6733,6736,0,3,3
1922,5,1,6738,6738,6739,0,1,2
1923,2,1,6740,6740,6741,0,1,1
1924,5,3,6745,6745,6748,0,3,4
1925,3,1,6748,6748,6749,0,1,0
1926,2,3,6750,6750,6753,0,3,1
1927,1,3,6751,6753,6756,2,5,0
1928,4,2,6755,6756,6758,1,3,0
1929,6,3,6761,6761,6764,0,3,3
1930,2,1,6763,6764,6765,1,2,0
1931,3,3,6766,6766,6769,0,3,1
1932,2,3,6768,6769,6772,1,4,0
1933,3,3,6771,6772,6775,1,4,0
1934,6,1,6777,6777,6778,0,1,2
1935,4,1,6781,6781,6782,0,1,3
1936,3,3,6784,6784,6787,0,3,2
1937,5,1,6789,6789,6790,0,1,2
1938,5,1,6794,6794,6795,0,1,4
1939,5,2,6799,6799,6801,0,2,4
1940,2,2,6801,6801,6803,0,2,0
1941,2,2,6803,6803,6805,0,2,0
1942,6,3,6809,6809,6812,0,3,4
1943,5,3,6814,6814,6817,0,3,2
1944,2,3,6816,6817,6820,1,4,0
1945,1,2,6817,6820,6822,3,5,0
1946,6,3,6823,6823,6826,0,3,1
1947,1,2,6824,6826,6828,2,4,0
1948,2,3,6826,6828,6831,2,5,0
1949,4,3,6830,6831,6834,1,4,0
1950,2,2,6832,6834,6836,2,4,0
1951,6,1,6838,6838,6839,0,1,2
1952,3,2,6841,6841,6843,0,2,2
1953,2,1,6843,6843,6844,0,1,0
1954,2,1,6845,6845,6846,0,1,1
1955,5,2,6850,6850,6852,0,2,4
1956,3,1,6853,6853,6854,0,1,1
1957,1,3,6854,6854,6857,0,3,0
1958,3,2,6857,6857,6859,0,2,0
1959,1,3,6858,6859,6862,1,4,0
1960,5,3,6863,6863,6866,0,3,1
1961,1,3,6864,6866,6869,2,5,0
1962,6,2,6870,6870,6872,0,2,1
1963,4,1,6874,6874,6875,0,1,2
1964,3,1,6877,6877,6878,0,1,2
1965,1,2,6878,6878,6880,0,2,0
1966,4,1,6882,6882,6883,0,1,2
1967,3,3,6885,6885,6888,0,3,2
1968,3,1,6888,6888,6889,0,1,0
1969,1,3,6889,6889,6892,0,3,0
1970,6,1,6895,6895,6896,0,1,3
1971,1,2,6896,6896,6898,0,2,0
1972,3,2,6899,6899,6901,0,2,1
1973,4,2,6903,6903,6905,0,2,2
1974,5,1,6908,6908,6909,0,1,3
1975,5,1,6913,6913,6914,0,1,4
1976,4,1,6917,6917,6918,0,1,3
1977,4,3,6921,6921,6924,0,3,3
1978,3,3,6924,6924,6927,0,3,0
1979,5,1,6929,6929,6930,0,1,2
1980,4,1,6933,6933,6934,0,1,3
1981,1,3,6934,6934,6937,0,3,0
1982,1,3,6935,6937,6940,2,5,0
1983,5,2,6940,6940,6942,0,2,0
1984,3,1,6943,6943,6944,0,1,1
1985,6,2,6949,6949,6951,0,2,5
1986,6,2,6955,6955,6957,0,2,4
1987,6,2,6961,6961,6963,0,2,4
1988,6,1,6967,6967,6968,0,1,4
1989,2,2,6969,6969,6971,0,2,1
1990,5,2,6974,6974,6976,0,2,3
1991,2,1,6976,6976,6977,0,1,0
1992,4,1,6980,6980,6981,0,1,3
1993,1,2,6981,6981,6983,0,2,0
1994,6,3,6987,6987,6990,0,3,4
1995,4,3,6991,6991,6994,0,3,1
1996,3,1,6994,6994,6995,0,1,0
1997,2,3,6996,6996,6999,0,3,1
1998,2,2,6998,6999,7001,1,3,0
1999,3,3,7001,7001,7004,0,3,0
2000,5,1,7006,7006,7007,0,1,2
2001,6,1,7012,7012,7013,0,1,5
2002,2,1,7014,7014,7015,0,1,1
2003,6,3,7020,7020,7023,0,3,5
2004,3,1,7023,7023,7024,0,1,0
2005,2,3,7025,7025,7028,0,3,1
2006,4,3,7029,7029,7032,0,3,1
2007,1,3,7030,7032,7035,2,5,0
2008,1,2,7031,7035,7037,4,6,0
2009,1,3,7032,7037,7040,5,8,0
2010,2,3,7034,7040,7043,6,9,0
2011,6,1,7040,7043,7044,3,4,0
2012,2,1,7042,7044,7045,2,3,0
2013,2,2,7044,7045,7047,1,3,0
2014,2,1,7046,7047,7048,1,2,0
2015,6,1,7052,7052,7053,0,1,4
2016,6,3,7058,7058,7061,0,3,5
2017,2,1,7060,7061,7062,1,2,0
2018,2,2,7062,7062,7064,0,2,0
2019,5,2,7067,7067,7069,0,2,3
2020,5,3,7072,7072,7075,0,3,3
2021,5,1,7077,7077,7078,0,1,2
2022,6,3,7083,7083,7086,0,3,5
2023,3,3,7086,7086,7089,0,3,0
2024,4,3,7090,7090,7093,0,3,1
2025,1,2,7091,7093,7095,2,4,0
2026,3,3,7094,7095,7098,1,4,0
2027,5,3,7099,7099,7102,0,3,1
2028,2,3,7101,7102,7105,1,4,0
2029,4,1,7105,7105,7106,0,1,0
2030,4,1,7109,7109,7110,0,1,3
2031,6,3,7115,7115,7118,0,3,5
2032,3,2,7118,7118,7120,0,2,0
2033,2,2,7120,7120,7122,0,2,0
2034,4,1,7124,7124,7125,0,1,2
2035,5,2,7129,7129,7131,0,2,4
2036,4,3,7133,7133,7136,0,3,2
2037,1,1,7134,7136,7137,2,3,0
2038,5,3,7139,7139,7142,0,3,2
2039,4,1,7143,7143,7144,0,1,1
2040,5,3,7148,7148,7151,0,3,4
2041,2,2,7150,7151,7153,1,3,0
2042,5,1,7155,7155,7156,0,1,2
2043,1,1,7156,7156,7157,0,1,0
2044,3,2,7159,7159,7161,0,2,2
2045,1,2,7160,7161,7163,1,3,0
2046,6,3,7166,7166,7169,0,3,3
2047,6,2,7172,7172,7174,0,2,3
2048,5,1,7177,7177,7178,0,1,3
2049,5,2,7182,7182,7184,0,2,4
2050,2,1,7184,7184,7185,0,1,0
2051,3,2,7187,7187,7189,0,2,2
2052,1,1,7188,7189,7190,1,2,0
2053,3,3,7191,7191,7194,0,3,1
2054,3,2,7194,7194,7196,0,2,0
2055,6,3,7200,7200,7203,0,3,4
2056,6,1,7206,7206,7207,0,1,3
2057,2,2,7208,7208,7210,0,2,1
2058,4,2,7212,7212,7214,0,2,2
2059,5,1,7217,7217,7218,0,1,3
2060,2,2,7219,7219,7221,0,2,1
2061,2,3,7221,7221,7224,0,3,0
2062,4,2,7225,7225,7227,0,2,1
2063,6,1,7231,7231,7232,0,1,4
2064,1,3,7232,7232,7235,0,3,0
2065,2,3,7234,7235,7238,1,4,0
2066,3,3,7237,7238,7241,1,4,0
2067,3,2,7240,7241,7243,1,3,0
2068,4,2,7244,7244,7246,0,2,1
2069,1,3,7245,7246,7249,1,4,0
2070,4,2,7249,7249,7251,0,2,0
2071,5,2,7254,7254,7256,0,2,3
2072,1,3,7255,7256,7259,1,4,0
2073,5,2,7260,7260,7262,0,2,1
2074,1,3,7261,7262,7265,1,4,0
2075,6,3,7267,7267,7270,0,3,2
2076,4,3,7271,7271,7274,0,3,1
2077,2,1,7273,7274,7275,1,2,0
2078,5,2,7278,7278,7280,0,2,3
2079,6,1,7284,7284,7285,0,1,4
2080,6,1,7290,7290,7291,0,1,5
2081,1,2,7291,7291,7293,0,2,0
2082,2,3,7293,7293,7296,0,3,0
2083,3,1,7296,7296,7297,0,1,0
2084,5,1,7301,7301,7302,0,1,4
2085,3,3,7304,7304,7307,0,3,2
2086,3,2,7307,7307,7309,0,2,0
2087,2,3,7309,7309,7312,0,3,0
2088,3,3,7312,7312,7315,0,3,0
2089,3,1,7315,7315,7316,0,1,0
2090,2,2,7317,7317,7319,0,2,1
2091,4,3,7321,7321,7324,0,3,2
2092,4,1,7325,7325,7326,0,1,1
2093,1,1,7326,7326,7327,0,1,0
2094,2,3,7328,7328,7331,0,3,1
2095,1,3,7329,7331,7334,2,5,0
2096,6,2,7335,7335,7337,0,2,1
2097,6,3,7341,7341,7344,0,3,4
2098,1,1,7342,7344,7345,2,3,0
2099,1,3,7343,7345,7348,2,5,0
2100,6,3,7349,7349,7352,0,3,1
2101,4,1,7353,7353,7354,0,1,1
2102,2,2,7355,7355,7357,0,2,1
2103,2,3,7357,7357,7360,0,3,0
2104,4,1,7361,7361,7362,0,1,1
2105,6,2,7367,7367,7369,0,2,5
2106,4,3,7371,7371,7374,0,3,2
2107,1,2,7372,7374,7376,2,4,0
2108,6,2,7378,7378,7380,0,2,2
2109,3,1,7381,7381,7382,0,1,1
2110,6,1,7387,7387,7388,0,1,5
2111,4,2,7391,7391,7393,0,2,3
2112,2,1,7393,7393,7394,0,1,0
2113,3,1,7396,7396,7397,0,1,2
2114,2,1,7398,7398,7399,0,1,1
2115,1,3,7399,7399,7402,0,3,0
2116,5,1,7404,7404,7405,0,1,2
2117,6,1,7410,7410,7411,0,1,5
2118,5,3,7415,7415,7418,0,3,4
2119,2,2,7417,7418,7420,1,3,0
2120,6,3,7423,7423,7426,0,3,3
2121,6,3,7429,7429,7432,0,3,3
2122,6,2,7435,7435,7437,0,2,3
2123,6,2,7441,7441,7443,0,2,4
2124,3,2,7444,7444,7446,0,2,1
2125,1,2,7445,7446,7448,1,3,0
2126,6,2,7451,7451,7453,0,2,3
2127,1,1,7452,7453,7454,1,2,0
2128,3,3,7455,7455,7458,0,3,1
2129,4,3,7459,7459,7462,0,3,1
2130,4,3,7463,7463,7466,0,3,1
2131,4,2,7467,7467,7469,0,2,1
2132,2,1,7469,7469,7470,0,1,0
2133,5,1,7474,7474,7475,0,1,4
2134,3,1,7477,7477,7478,0,1,2
2135,2,1,7479,7479,7480,0,1,1
2136,5,1,7484,7484,7485,0,1,4
2137,3,2,7487,7487,7489,0,2,2
2138,3,2,7490,7490,7492,0,2,1
2139,3,1,7493,7493,7494,0,1,1
2140,1,2,7494,7494,7496,0,2,0
2141,6,3,7500,7500,7503,0,3,4
2142,2,1,7502,7503,7504,1,2,0
2143,2,1,7504,7504,7505,0,1,0
2144,4,1,7508,7508,7509,0,1,3
2145,6,2,7514,7514,7516,0,2,5
2146,3,3,7517,7517,7520,0,3,1
2147,5,1,7522,7522,7523,0,1,2
2148,3,2,7525,7525,7527,0,2,2
2149,3,2,7528,7528,7530,0,2,1
2150,3,2,7531,7531,7533,0,2,1
2151,6,1,7537,7537,7538,0,1,4
2152,4,1,7541,7541,7542,0,1,3
2153,3,3,7544,7544,7547,0,3,2
2154,5,1,7549,7549,7550,0,1,2
2155,1,1,7550,7550,7551,0,1,0
2156,2,3,7552,7552,7555,0,3,1
2157,1,2,7553,7555,7557,2,4,0
2158,1,2,7554,7557,7559,3,5,0
2159,6,1,7560,7560,7561,0,1,1
2160,4,1,7564,7564,7565,0,1,3
2161,1,3,7565,7565,7568,0,3,0
2162,5,1,7570,7570,7571,0,1,2
2163,2,3,7572,7572,7575,0,3,1
2164,5,1,7577,7577,7578,0,1,2
2165,6,3,7583,7583,7586,0,3,5
2166,1,3,7584,7586,7589,2,5,0
2167,5,2,7589,7589,7591,0,2,0
2168,1,1,7590,7591,7592,1,2,0
2169,2,2,7592,7592,7594,0,2,0
2170,2,2,7594,7594,7596,0,2,0
2171,3,1,7597,7597,7598,0,1,1
2172,5,1,7602,7602,7603,0,1,4
2173,6,2,7608,7608,7610,0,2,5
2174,1,1,7609,7610,7611,1,2,0
2175,4,1,7613,7613,7614,0,1,2
2176,2,3,7615,7615,7618,0,3,1
2177,6,3,7621,7621,7624,0,3,3
2178,2,3,7623,7624,7627,1,4,0
2179,6,1,7629,7629,7630,0,1,2
2180,2,2,7631,7631,7633,0,2,1
2181,2,3,7633,7633,7636,0,3,0
2182,4,3,7637,7637,7640,0,3,1
2183,4,2,7641,7641,7643,0,2,1
2184,2,2,7643,7643,7645,0,2,0
2185,4,1,7647,7647,7648,0,1,2
2186,6,2,7653,7653,7655,0,2,5
2187,2,1,7655,7655,7656,0,1,0
2188,6,1,7661,7661,7662,0,1,5
2189,2,3,7663,7663,7666,0,3,1
2190,4,2,7667,7667,7669,0,2,1
2191,4,3,7671,7671,7674,0,3,2
2192,2,1,7673,7674,7675,1,2,0
2193,2,2,7675,7675,7677,0,2,0
2194,5,3,7680,7680,7683,0,3,3
2195,5,2,7685,7685,7687,0,2,2
2196,1,1,7686,7687,7688,1,2,0
2197,4,2,7690,7690,7692,0,2,2
2198,6,3,7696,7696,7699,0,3,4
2199,3,1,7699,7699,7700,0,1,0
2200,6,3,7705,7705,7708,0,3,5
2201,1,1,7706,7708,7709,2,3,0
2202,5,2,7711,7711,7713,0,2,2
2203,3,2,7714,7714,7716,0,2,1
2204,3,3,7717,7717,7720,0,3,1
2205,2,3,7719,7720,7723,1,4,0
2206,2,1,7721,7723,7724,2,3,0
2207,6,1,7727,7727,7728,0,1,3
2208,3,1,7730,7730,7731,0,1,2
2209,4,2,7734,7734,7736,0,2,3
2210,4,3,7738,7738,7741,0,3,2
2211,6,2,7744,7744,7746,0,2,3
2212,6,3,7750,7750,7753,0,3,4
2213,4,3,7754,7754,7757,0,3,1
2214,4,3,7758,7758,7761,0,3,1
2215,4,2,7762,7762,7764,0,2,1
2216,1,3,7763,7764,7767,1,4,0
2217,4,3,7767,7767,7770,0,3,0
2218,4,1,7771,7771,7772,0,1,1
2219,3,3,7774,7774,7777,0,3,2
2220,4,3,7778,7778,7781,0,3,1
2221,4,1,7782,7782,7783,0,1,1
2222,3,1,7785,7785,7786,0,1,2
2223,5,2,7790,7790,7792,0,2,4
2224,3,3,7793,7793,7796,0,3,1
2225,2,3,7795,7796,7799,1,4,0
2226,6,3,7801,7801,7804,0,3,2
2227,2,3,7803,7804,7807,1,4,0
2228,3,3,7806,7807,7810,1,4,0
2229,5,2,7811,7811,7813,0,2,1
2230,6,3,7817,7817,7820,0,3,4
2231,6,2,7823,7823,7825,0,2,3
2232,3,2,7826,7826,7828,0,2,1
2233,6,3,7832,7832,7835,0,3,4
2234,1,2,7833,7835,7837,2,4,0
2235,5,1,7838,7838,7839,0,1,1
2236,3,3,7841,7841,7844,0,3,2
2237,3,2,7844,7844,7846,0,2,0
2238,5,3,7849,7849,7852,0,3,3
2239,5,3,7854,7854,7857,0,3,2
2240,3,3,7857,7857,7860,0,3,0
2241,4,1,7861,7861,7862,0,1,1
2242,4,2,7865,7865,7867,0,2,3
2243,4,3,7869,7869,7872,0,3,2
2244,4,1,7873,7873,7874,0,1,1
2245,4,1,7877,7877,7878,0,1,3
2246,6,2,7883,7883,7885,0,2,5
2247,5,3,7888,7888,7891,0,3,3
2248,5,1,7893,7893,7894,0,1,2
2249,1,2,7894,7894,7896,0,2,0
2250,1,3,7895,7896,7899,1,4,0
2251,6,2,7901,7901,7903,0,2,2
2252,5,3,7906,7906,7909,0,3,3
2253,5,1,7911,7911,7912,0,1,2
2254,2,1,7913,7913,7914,0,1,1
2255,6,3,7919,7919,7922,0,3,5
2256,3,3,7922,7922,7925,0,3,0
2257,3,1,7925,7925,7926,0,1,0
2258,1,2,7926,7926,7928,0,2,0
2259,4,2,7930,7930,7932,0,2,2
2260,2,3,7932,7932,7935,0,3,0
2261,6,2,7938,7938,7940,0,2,3
2262,2,1,7940,7940,7941,0,1,0
2263,1,1,7941,7941,7942,0,1,0
2264,6,2,7947,7947,7949,0,2,5
2265,1,2,7948,7949,7951,1,3,0
2266,4,1,7952,7952,7953,0,1,1
2267,1,3,7953,7953,7956,0,3,0
2268,3,1,7956,7956,7957,0,1,0
2269,4,2,7960,7960,7962,0,2,3
2270,6,1,7966,7966,7967,0,1,4
2271,1,2,7967,7967,7969,0,2,0
2272,2,2,7969,7969,7971,0,2,0
2273,4,2,7973,7973,7975,0,2,2
2274,1,2,7974,7975,7977,1,3,0
2275,2,2,7976,7977,7979,1,3,0
2276,1,1,7977,7979,7980,2,3,0
2277,6,1,7983,7983,7984,0,1,3
2278,6,1,7989,7989,7990,0,1,5
2279,6,2,7995,7995,7997,0,2,5
2280,2,3,7997,7997,8000,0,3,0
2281,6,2,8003,8003,8005,0,2,3
2282,6,2,8009,8009,8011,0,2,4
2283,6,1,8015,8015,8016,0,1,4
2284,5,1,8020,8020,8021,0,1,4
2285,6,1,8026,8026,8027,0,1,5
2286,5,3,8031,8031,8034,0,3,4
2287,4,2,8035,8035,8037,0,2,1
2288,5,2,8040,8040,8042,0,2,3
2289,4,2,8044,8044,8046,0,2,2
2290,5,2,8049,8049,8051,0,2,3
2291,4,1,8053,8053,8054,0,1,2
2292,3,3,8056,8056,8059,0,3,2
2293,5,2,8061,8061,8063,0,2,2
2294,2,2,8063,8063,8065,0,2,0
2295,6,1,8069,8069,8070,0,1,4
2296,6,1,8075,8075,8076,0,1,5
2297,2,2,8077,8077,8079,0,2,1
2298,6,2,8083,8083,8085,0,2,4
2299,4,1,8087,8087,8088,0,1,2
2300,5,1,8092,8092,8093,0,1,4
2301,6,2,8098,8098,8100,0,2,5
2302,1,3,8099,8100,8103,1,4,0
2303,3,3,8102,8103,8106,1,4,0
2304,4,1,8106,8106,8107,0,1,0
2305,1,1,8107,8107,8108,0,1,0
2306,6,3,8113,8113,8116,0,3,5
2307,3,1,8116,8116,8117,0,1,0
2308,1,1,8117,8117,8118,0,1,0
2309,2,2,8119,8119,8121,0,2,1
2310,4,1,8123,8123,8124,0,1,2
2311,3,2,8126,8126,8128,0,2,2
2312,1,3,8127,8128,8131,1,4,0
2313,6,2,8133,8133,8135,0,2,2
2314,5,1,8138,8138,8139,0,1,3
2315,5,1,8143,8143,8144,0,1,4
2316,4,3,8147,8147,8150,0,3,3
2317,4,2,8151,8151,8153,0,2,1
2318,1,2,8152,8153,8155,1,3,0
2319,3,2,8155,8155,8157,0,2,0
2320,5,2,8160,8160,8162,0,2,3
2321,5,1,8165,8165,8166,0,1,3
2322,6,2,8171,8171,8173,0,2,5
2323,1,2,8172,8173,8175,1,3,0
2324,5,2,8177,8177,8179,0,2,2
2325,1,1,8178,8179,8180,1,2,0
2326,3,3,8181,8181,8184,0,3,1
2327,1,1,8182,8184,8185,2,3,0
2328,4,2,8186,8186,8188,0,2,1
2329,6,2,8192,8192,8194,0,2,4
2330,5,3,8197,8197,8200,0,3,3
2331,3,3,8200,8200,8203,0,3,0
2332,1,3,8201,8203,8206,2,5,0
2333,2,1,8203,8206,8207,3,4,0
2334,1,1,8204,8207,8208,3,4,0
2335,6,1,8210,8210,8211,0,1,2
2336,1,3,8211,8211,8214,0,3,0
2337,1,1,8212,8214,8215,2,3,0
2338,4,2,8216,8216,8218,0,2,1
2339,6,1,8222,8222,8223,0,1,4
2340,1,1,8223,8223,8224,0,1,0
2341,5,2,8228,8228,8230,0,2,4
2342,1,3,8229,8230,8233,1,4,0
2343,3,1,8232,8233,8234,1,2,0
2344,5,1,8237,8237,8238,0,1,3
2345,3,3,8240,8240,8243,0,3,2
2346,2,3,8242,8243,8246,1,4,0
2347,5,3,8247,8247,8250,0,3,1
2348,6,2,8253,8253,8255,0,2,3
2349,3,1,8256,8256,8257,0,1,1
2350,2,1,8258,8258,8259,0,1,1
2351,5,3,8263,8263,8266,0,3,4
2352,4,1,8267,8267,8268,0,1,1
2353,4,3,8271,8271,8274,0,3,3
2354,6,3,8277,8277,8280,0,3,3
2355,5,1,8282,8282,8283,0,1,2
2356,6,3,8288,8288,8291,0,3,5
2357,1,3,8289,8291,8294,2,5,0
2358,6,1,8295,8295,8296,0,1,1
2359,4,2,8299,8299,8301,0,2,3
2360,3,2,8302,8302,8304,0,2,1
2361,1,2,8303,8304,8306,1,3,0
2362,4,3,8307,8307,8310,0,3,1
2363,1,2,8308,8310,8312,2,4,0
2364,2,1,8310,8312,8313,2,3,0
2365,3,2,8313,8313,8315,0,2,0
2366,1,3,8314,8315,8318,1,4,0
2367,4,2,8318,8318,8320,0,2,0
2368,4,2,8322,8322,8324,0,2,2
2369,5,2,8327,8327,8329,0,2,3
2370,5,3,8332,8332,8335,0,3,3
2371,3,3,8335,8335,8338,0,3,0
2372,2,3,8337,8338,8341,1,4,0
2373,5,1,8342,8342,8343,0,1,1
2374,3,1,8345,8345,8346,0,1,2
2375,4,3,8349,8349,8352,0,3,3
2376,6,3,8355,8355,8358,0,3,3
2377,4,2,8359,8359,8361,0,2,1
2378,2,2,8361,8361,8363,0,2,0
2379,3,2,8364,8364,8366,0,2,1
2380,4,2,8368,8368,8370,0,2,2
2381,4,1,8372,8372,8373,0,1,2
2382,5,3,8377,8377,8380,0,3,4
2383,1,2,8378,8380,8382,2,4,0
2384,4,1,8382,8382,8383,0,1,0
2385,2,1,8384,8384,8385,0,1,1
2386,1,2,8385,8385,8387,0,2,0
2387,5,2,8390,8390,8392,0,2,3
2388,3,1,8393,8393,8394,0,1,1
2389,6,1,8399,8399,8400,0,1,5
2390,4,2,8403,8403,8405,0,2,3
2391,5,2,8408,8408,8410,0,2,3
2392,5,3,8413,8413,8416,0,3,3
2393,1,2,8414,8416,8418,2,4,0
2394,2,1,8416,8418,8419,2,3,0
2395,6,1,8422,8422,8423,0,1,3
2396,2,3,8424,8424,8427,0,3,1
2397,4,3,8428,8428,8431,0,3,1
2398,1,2,8429,8431,8433,2,4,0
2399,2,3,8431,8433,8436,2,5,0
2400,3,1,8434,8436,8437,2,3,0
2401,6,2,8440,8440,8442,0,2,3
2402,6,1,8446,8446,8447,0,1,4
2403,4,3,8450,8450,8453,0,3,3
2404,3,2,8453,8453,8455,0,2,0
2405,5,2,8458,8458,8460,0,2,3
2406,5,1,8463,8463,8464,0,1,3
2407,3,3,8466,8466,8469,0,3,2
2408,5,2,8471,8471,8473,0,2,2
2409,5,1,8476,8476,8477,0,1,3
2410,2,3,8478,8478,8481,0,3,1
2411,5,2,8483,8483,8485,0,2,2
2412,4,1,8487,8487,8488,0,1,2
2413,3,3,8490,8490,8493,0,3,2
2414,1,3,8491,8493,8496,2,5,0
2415,6,3,8497,8497,8500,0,3,1
2416,6,2,8503,8503,8505,0,2,3
2417,2,2,8505,8505,8507,0,2,0
2418,6,3,8511,8511,8514,0,3,4
2419,2,3,8513,8514,8517,1,4,0
2420,5,3,8518,8518,8521,0,3,1
2421,3,2,8521,8521,8523,0,2,0
2422,2,2,8523,8523,8525,0,2,0
2423,6,3,8529,8529,8532,0,3,4
2424,1,3,8530,8532,8535,2,5,0
2425,6,2,8536,8536,8538,0,2,1
2426,3,1,8539,8539,8540,0,1,1
2427,5,1,8544,8544,8545,0,1,4
2428,2,2,8546,8546,8548,0,2,1
2429,6,2,8552,8552,8554,0,2,4
2430,4,3,8556,8556,8559,0,3,2
2431,5,3,8561,8561,8564,0,3,2
2432,6,1,8567,8567,8568,0,1,3
2433,2,3,8569,8569,8572,0,3,1
2434,6,2,8575,8575,8577,0,2,3
2435,1,2,8576,8577,8579,1,3,0
2436,2,3,8578,8579,8582,1,4,0
2437,2,1,8580,8582,8583,2,3,0
2438,2,3,8582,8583,8586,1,4,0
2439,5,2,8587,8587,8589,0,2,1
2440,6,2,8593,8593,8595,0,2,4
2441,1,2,8594,8595,8597,1,3,0
2442,1,2,8595,8597,8599,2,4,0
2443,3,2,8598,8599,8601,1,3,0
2444,3,1,8601,8601,8602,0,1,0
2445,3,1,8604,8604,8605,0,1,2
2446,4,1,8608,8608,8609,0,1,3
2447,1,1,8609,8609,8610,0,1,0
2448,4,3,8613,8613,8616,0,3,3
2449,2,2,8615,8616,8618,1,3,0
2450,4,3,8619,8619,8622,0,3,1
2451,3,1,8622,8622,8623,0,1,0
2452,4,3,8626,8626,8629,0,3,3
2453,6,3,8632,8632,8635,0,3,3
2454,5,2,8637,8637,8639,0,2,2
2455,2,3,8639,8639,8642,0,3,0
2456,2,3,8641,8642,8645,1,4,0
2457,3,3,8644,8645,8648,1,4,0
2458,1,2,8645,8648,8650,3,5,0
2459,1,2,8646,8650,8652,4,6,0
2460,6,1,8652,8652,8653,0,1,0
2461,1,2,8653,8653,8655,0,2,0
2462,1,3,8654,8655,8658,1,4,0
2463,2,2,8656,8658,8660,2,4,0
2464,1,1,8657,8660,8661,3,4,0
2465,2,1,8659,8661,8662,2,3,0
2466,5,2,8664,8664,8666,0,2,2
2467,2,2,8666,8666,8668,0,2,0
2468,1,3,8667,8668,8671,1,4,0
2469,4,1,8671,8671,8672,0,1,0
2470,6,1,8677,8677,8678,0,1,5
2471,4,2,8681,8681,8683,0,2,3
2472,5,1,8686,8686,8687,0,1,3
2473,2,2,8688,8688,8690,0,2,1
2474,6,2,8694,8694,8696,0,2,4
2475,4,2,8698,8698,8700,0,2,2
2476,2,3,8700,8700,8703,0,3,0
2477,1,3,8701,8703,8706,2,5,0
2478,3,1,8704,8706,8707,2,3,0
2479,5,1,8709,8709,8710,0,1,2
2480,3,3,8712,8712,8715,0,3,2
2481,4,3,8716,8716,8719,0,3,1
2482,3,3,8719,8719,8722,0,3,0
2483,1,2,8720,8722,8724,2,4,0
2484,5,1,8725,8725,8726,0,1,1
2485,3,2,8728,8728,8730,0,2,2
2486,5,1,8733,8733,8734,0,1,3
2487,5,3,8738,8738,8741,0,3,4
2488,2,1,8740,8741,8742,1,2,0
2489,2,3,8742,8742,8745,0,3,0
2490,6,3,8748,8748,8751,0,3,3
2491,1,1,8749,8751,8752,2,3,0
2492,6,2,8755,8755,8757,0,2,3
2493,3,2,8758,8758,8760,0,2,1
2494,5,3,8763,8763,8766,0,3,3
2495,6,2,8769,8769,8771,0,2,3
2496,3,2,8772,8772,8774,0,2,1
2497,6,1,8778,8778,8779,0,1,4
2498,1,3,8779,8779,8782,0,3,0
2499,2,1,8781,8782,8783,1,2,0
2500,1,3,8782,8783,8786,1,4,0
2501,2,1,8784,8786,8787,2,3,0
2502,1,3,8785,8787,8790,2,5,0
2503,4,3,8789,8790,8793,1,4,0
2504,1,2,8790,8793,8795,3,5,0
2505,6,2,8796,8796,8798,0,2,1
2506,6,1,8802,8802,8803,0,1,4
2507,5,3,8807,8807,8810,0,3,4
2508,4,2,8811,8811,8813,0,2,1
2509,5,1,8816,8816,8817,0,1,3
2510,3,3,8819,8819,8822,0,3,2
2511,2,2,8821,8822,8824,1,3,0
2512,2,2,8823,8824,8826,1,3,0
2513,3,3,8826,8826,8829,0,3,0
2514,5,2,8831,8831,8833,0,2,2
2515,6,2,8837,8837,8839,0,2,4
2516,6,2,8843,8843,8845,0,2,4
2517,5,1,8848,8848,8849,0,1,3
2518,1,2,8849,8849,8851,0,2,0
2519,6,2,8855,8855,8857,0,2,4
2520,3,3,8858,8858,8861,0,3,1
2521,1,2,8859,8861,8863,2,4,0
2522,2,1,8861,8863,8864,2,3,0
2523,1,2,8862,8864,8866,2,4,0
2524,5,1,8867,8867,8868,0,1,1
2525,2,3,8869,8869,8872,0,3,1
2526,1,1,8870,8872,8873,2,3,0
2527,1,2,8871,8873,8875,2,4,0
2528,6,3,8877,8877,8880,0,3,2
2529,2,1,8879,8880,8881,1,2,0
2530,2,2,8881,8881,8883,0,2,0
2531,3,2,8884,8884,8886,0,2,1
2532,4,1,8888,8888,8889,0,1,2
2533,4,2,8892,8892,8894,0,2,3
2534,1,2,8893,8894,8896,1,3,0
2535,2,2,8895,8896,8898,1,3,0
2536,5,2,8900,8900,8902,0,2,2
2537,1,1,8901,8902,8903,1,2,0
2538,4,2,8905,8905,8907,0,2,2
2539,4,3,8909,8909,8912,0,3,2
2540,1,1,8910,8912,8913,2,3,0
2541,2,2,8912,8913,8915,1,3,0
2542,4,2,8916,8916,8918,0,2,1
2543,1,1,8917,8918,8919,1,2,0
2544,6,3,8923,8923,8926,0,3,4
2545,3,3,8926,8926,8929,0,3,0
2546,3,3,8929,8929,8932,0,3,0
2547,3,3,8932,8932,8935,0,3,0
2548,2,1,8934,8935,8936,1,2,0
2549,3,1,8937,8937,8938,0,1,1
2550,3,3,8940,8940,8943,0,3,2
2551,1,3,8941,8943,8946,2,5,0
2552,6,1,8947,8947,8948,0,1,1
2553,1,2,8948,8948,8950,0,2,0
2554,4,2,8952,8952,8954,0,2,2
2555,6,1,8958,8958,8959,0,1,4
2556,2,3,8960,8960,8963,0,3,1
2557,4,1,8964,8964,8965,0,1,1
2558,5,1,8969,8969,8970,0,1,4
2559,6,2,8975,8975,8977,0,2,5
2560,2,2,8977,8977,8979,0,2,0
2561,5,2,8982,8982,8984,0,2,3
2562,3,2,8985,8985,8987,0,2,1
2563,4,1,8989,8989,8990,0,1,2
2564,2,2,8991,8991,8993,0,2,1
2565,1,2,8992,8993,8995,1,3,0
2566,2,2,8994,8995,8997,1,3,0
2567,5,2,8999,8999,9001,0,2,2
2568,6,1,9005,9005,9006,0,1,4
2569,6,2,9011,9011,9013,0,2,5
2570,3,1,9014,9014,9015,0,1,1
2571,2,1,9016,9016,9017,0,1,1
2572,4,2,9020,9020,9022,0,2,3
2573,6,3,9026,9026,9029,0,3,4
2574,5,2,9031,9031,9033,0,2,2
2575,4,1,9035,9035,9036,0,1,2
2576,5,3,9040,9040,9043,0,3,4
2577,2,2,9042,9043,9045,1,3,0
2578,2,1,9044,9045,9046,1,2,0
2579,5,1,9049,9049,9050,0,1,3
2580,3,2,9052,9052,9054,0,2,2
2581,6,1,9058,9058,9059,0,1,4
2582,6,1,9064,9064,9065,0,1,5
2583,2,3,9066,9066,9069,0,3,1
2584,6,1,9072,9072,9073,0,1,3
2585,4,3,9076,9076,9079,0,3,3
2586,1,3,9077,9079,9082,2,5,0
2587,2,1,9079,9082,9083,3,4,0
2588,3,1,9082,9083,9084,1,2,0
2589,5,3,9087,9087,9090,0,3,3
2590,6,2,9093,9093,9095,0,2,3
2591,4,2,9097,9097,9099,0,2,2
2592,1,3,9098,9099,9102,1,4,0
2593,4,2,9102,9102,9104,0,2,0
2594,6,1,9108,9108,9109,0,1,4
2595,5,2,9113,9113,9115,0,2,4
2596,4,2,9117,9117,9119,0,2,2
2597,2,1,9119,9119,9120,0,1,0
2598,2,2,9121,9121,9123,0,2,1
2599,2,3,9123,9123,9126,0,3,0
2600,2,2,9125,9126,9128,1,3,0
2601,6,2,9131,9131,9133,0,2,3
2602,4,1,9135,9135,9136,0,1,2
2603,1,3,9136,9136,9139,0,3,0
2604,4,1,9140,9140,9141,0,1,1
2605,2,1,9142,9142,9143,0,1,1
2606,2,3,9144,9144,9147,0,3,1
2607,6,2,9150,9150,9152,0,2,3
2608,4,1,9154,9154,9155,0,1,2
2609,4,3,9158,9158,9161,0,3,3
2610,1,2,9159,9161,9163,2,4,0
2611,1,3,9160,9163,9166,3,6,0
2612,3,1,9163,9166,9167,3,4,0
2613,5,3,9168,9168,9171,0,3,1
2614,2,2,9170,9171,9173,1,3,0
2615,5,2,9175,9175,9177,0,2,2
2616,2,2,9177,9177,9179,0,2,0
2617,6,2,9183,9183,9185,0,2,4
2618,1,2,9184,9185,9187,1,3,0
2619,2,3,9186,9187,9190,1,4,0
2620,5,3,9191,9191,9194,0,3,1
2621,3,2,9194,9194,9196,0,2,0
2622,3,2,9197,9197,9199,0,2,1
2623,3,1,9200,9200,9201,0,1,1
2624,4,1,9204,9204,9205,0,1,3
2625,1,1,9205,9205,9206,0,1,0
2626,5,2,9210,9210,9212,0,2,4
2627,5,1,9215,9215,9216,0,1,3
2628,5,1,9220,9220,9221,0,1,4
2629,5,1,9225,9225,9226,0,1,4
2630,4,2,9229,9229,9231,0,2,3
2631,3,1,9232,9232,9233,0,1,1
2632,5,1,9237,9237,9238,0,1,4
2633,6,3,9243,9243,9246,0,3,5
2634,1,2,9244,9246,9248,2,4,0
2635,6,3,9250,9250,9253,0,3,2
2636,1,3,9251,9253,9256,2,5,0
2637,6,2,9257,9257,9259,0,2,1
2638,2,1,9259,9259,9260,0,1,0
2639,5,2,9264,9264,9266,0,2,4
2640,1,3,9265,9266,9269,1,4,0
2641,5,3,9270,9270,9273,0,3,1
2642,5,1,9275,9275,9276,0,1,2
2643,6,2,9281,9281,9283,0,2,5
2644,6,3,9287,9287,9290,0,3,4
2645,6,2,9293,9293,9295,0,2,3
2646,2,3,9295,9295,9298,0,3,0
2647,2,2,9297,9298,9300,1,3,0
2648,2,3,9299,9300,9303,1,4,0
2649,3,2,9302,9303,9305,1,3,0
2650,5,2,9307,9307,9309,0,2,2
2651,5,1,9312,9312,9313,0,1,3
2652,6,1,9318,9318,9319,0,1,5
2653,4,2,9322,9322,9324,0,2,3
2654,5,2,9327,9327,9329,0,2,3
2655,4,2,9331,9331,9333,0,2,2
2656,4,3,9335,9335,9338,0,3,2
2657,5,2,9340,9340,9342,0,2,2
2658,1,2,9341,9342,9344,1,3,0
2659,6,1,9347,9347,9348,0,1,3
2660,4,2,9351,9351,9353,0,2,3
2661,1,2,9352,9353,9355,1,3,0
2662,5,1,9357,9357,9358,0,1,2
2663,6,3,9363,9363,9366,0,3,5
2664,1,1,9364,9366,9367,2,3,0
2665,1,3,9365,9367,9370,2,5,0
2666,5,2,9370,9370,9372,0,2,0
2667,4,3,9374,9374,9377,0,3,2
2668,3,3,9377,9377,9380,0,3,0
2669,3,2,9380,9380,9382,0,2,0
2670,5,3,9385,9385,9388,0,3,3
2671,2,1,9387,9388,9389,1,2,0
2672,5,1,9392,9392,9393,0,1,3
2673,3,3,9395,9395,9398,0,3,2
2674,2,3,9397,9398,9401,1,4,0
2675,1,3,9398,9401,9404,3,6,0
2676,3,3,9401,9404,9407,3,6,0
2677,6,1,9407,9407,9408,0,1,0
2678,6,2,9413,9413,9415,0,2,5
2679,5,1,9418,9418,9419,0,1,3
2680,1,1,9419,9419,9420,0,1,0
2681,4,1,9423,9423,9424,0,1,3
2682,3,3,9426,9426,9429,0,3,2
2683,1,3,9427,9429,9432,2,5,0
2684,6,1,9433,9433,9434,0,1,1
2685,3,1,9436,9436,9437,0,1,2
2686,4,3,9440,9440,9443,0,3,3
2687,2,2,9442,9443,9445,1,3,0
2688,1,1,9443,9445,9446,2,3,0
2689,2,1,9445,9446,9447,1,2,0
2690,2,3,9447,9447,9450,0,3,0
2691,1,3,9448,9450,9453,2,5,0
2692,1,2,9449,9453,9455,4,6,0
2693,5,2,9454,9455,9457,1,3,0
2694,1,3,9455,9457,9460,2,5,0
2695,2,3,9457,9460,9463,3,6,0
2696,4,3,9461,9463,9466,2,5,0
2697,6,1,9467,9467,9468,0,1,1
2698,6,3,9473,9473,9476,0,3,5
2699,6,2,9479,9479,9481,0,2,3
2700,4,3,9483,9483,9486,0,3,2
2701,5,3,9488,9488,9491,0,3,2
2702,6,3,9494,9494,9497,0,3,3
2703,2,1,9496,9497,9498,1,2,0
2704,6,3,9502,9502,9505,0,3,4
2705,5,3,9507,9507,9510,0,3,2
2706,5,2,9512,9512,9514,0,2,2
2707,1,2,9513,9514,9516,1,3,0
2708,2,2,9515,9516,9518,1,3,0
2709,2,2,9517,9518,9520,1,3,0
2710,6,1,9523,9523,9524,0,1,3
2711,3,2,9526,9526,9528,0,2,2
2712,4,2,9530,9530,9532,0,2,2
2713,3,3,9533,9533,9536,0,3,1
2714,2,1,9535,9536,9537,1,2,0
2715,3,3,9538,9538,9541,0,3,1
2716,3,2,9541,9541,9543,0,2,0
2717,2,3,9543,9543,9546,0,3,0
2718,1,2,9544,9546,9548,2,4,0
2719,5,3,9549,9549,9552,0,3,1
2720,6,3,9555,9555,9558,0,3,3
2721,2,2,9557,9558,9560,1,3,0
2722,5,1,9562,9562,9563,0,1,2
2723,5,1,9567,9567,9568,0,1,4
2724,1,3,9568,9568,9571,0,3,0
2725,4,3,9572,9572,9575,0,3,1
2726,5,1,9577,9577,9578,0,1,2
2727,2,2,9579,9579,9581,0,2,1
2728,3,2,9582,9582,9584,0,2,1
2729,1,2,9583,9584,9586,1,3,0
2730,1,3,9584,9586,9589,2,5,0
2731,3,3,9587,9589,9592,2,5,0
2732,4,3,9591,9592,9595,1,4,0
2733,2,2,9593,9595,9597,2,4,0
2734,3,2,9596,9597,9599,1,3,0
2735,5,2,9601,9601,9603,0,2,2
2736,3,3,9604,9604,9607,0,3,1
2737,2,2,9606,9607,9609,1,3,0
2738,6,2,9612,9612,9614,0,2,3
2739,2,3,9614,9614,9617,0,3,0
2740,1,2,9615,9617,9619,2,4,0
2741,3,1,9618,9619,9620,1,2,0
2742,2,3,9620,9620,9623,0,3,0
2743,4,3,9624,9624,9627,0,3,1
2744,4,1,9628,9628,9629,0,1,1
2745,4,1,9632,9632,9633,0,1,3
2746,2,3,9634,9634,9637,0,3,1
2747,1,3,9635,9637,9640,2,5,0
2748,6,2,9641,9641,9643,0,2,1
2749,6,2,9647,9647,9649,0,2,4
2750,2,1,9649,9649,9650,0,1,0
2751,6,1,9655,9655,9656,0,1,5
2752,1,1,9656,9656,9657,0,1,0
2753,4,1,9660,9660,9661,0,1,3
2754,5,2,9665,9665,9667,0,2,4
2755,5,3,9670,9670,9673,0,3,3
2756,5,1,9675,9675,9676,0,1,2
2757,4,2,9679,9679,9681,0,2,3
2758,1,2,9680,9681,9683,1,3,0
2759,6,2,9686,9686,9688,0,2,3
2760,1,3,9687,9688,9691,1,4,0
2761,3,2,9690,9691,9693,1,3,0
2762,3,2,9693,9693,9695,0,2,0
2763,1,1,9694,9695,9696,1,2,0
2764,1,2,9695,9696,9698,1,3,0
2765,1,1,9696,9698,9699,2,3,0
2766,4,2,9700,9700,9702,0,2,1
2767,4,3,9704,9704,9707,0,3,2
2768,3,2,9707,9707,9709,0,2,0
2769,1,1,9708,9709,9710,1,2,0
2770,3,3,9711,9711,9714,0,3,1
2771,1,2,9712,9714,9716,2,4,0
2772,5,1,9717,9717,9718,0,1,1
2773,6,1,9723,9723,9724,0,1,5
2774,2,3,9725,9725,9728,0,3,1
2775,1,2,9726,9728,9730,2,4,0
2776,3,2,9729,9730,9732,1,3,0
2777,1,2,9730,9732,9734,2,4,0
2778,2,3,9732,9734,9737,2,5,0
2779,2,1,9734,9737,9738,3,4,0
2780,3,2,9737,9738,9740,1,3,0
2781,2,2,9739,9740,9742,1,3,0
2782,5,1,9744,9744,9745,0,1,2
2783,1,1,9745,9745,9746,0,1,0
2784,1,1,9746,9746,9747,0,1,0
2785,3,3,9749,9749,9752,0,3,2
2786,6,1,9755,9755,9756,0,1,3
2787,2,1,9757,9757,9758,0,1,1
2788,2,1,9759,9759,9760,0,1,1
2789,3,2,9762,9762,9764,0,2,2
2790,4,3,9766,9766,9769,0,3,2
2791,2,1,9768,9769,9770,1,2,0
2792,6,1,9774,9774,9775,0,1,4
2793,1,3,9775,9775,9778,0,3,0
2794,4,3,9779,9779,9782,0,3,1
2795,4,3,9783,9783,9786,0,3,1
2796,4,3,9787,9787,9790,0,3,1
2797,6,3,9793,9793,9796,0,3,3
2798,6,3,9799,9799,9802,0,3,3
2799,3,2,9802,9802,9804,0,2,0
2800,3,3,9805,9805,9808,0,3,1
2801,6,3,9811,9811,9814,0,3,3
2802,5,3,9816,9816,9819,0,3,2
2803,5,3,9821,9821,9824,0,3,2
2804,2,3,9823,9824,9827,1,4,0
2805,5,2,9828,9828,9830,0,2,1
2806,5,3,9833,9833,9836,0,3,3
2807,6,3,9839,9839,9842,0,3,3
2808,2,1,9841,9842,9843,1,2,0
2809,3,2,9844,9844,9846,0,2,1
2810,4,2,9848,9848,9850,0,2,2
2811,5,3,9853,9853,9856,0,3,3
2812,5,3,9858,9858,9861,0,3,2
2813,6,2,9864,9864,9866,0,2,3
2814,1,3,9865,9866,9869,1,4,0
2815,3,1,9868,9869,9870,1,2,0
2816,1,2,9869,9870,9872,1,3,0
2817,6,3,9875,9875,9878,0,3,3
2818,1,1,9876,9878,9879,2,3,0
2819,2,1,9878,9879,9880,1,2,0
2820,1,1,9879,9880,9881,1,2,0
2821,2,2,9881,9881,9883,0,2,0
2822,4,3,9885,9885,9888,0,3,2
2823,3,1,9888,9888,9889,0,1,0
2824,5,2,9893,9893,9895,0,2,4
2825,2,3,9895,9895,9898,0,3,0
2826,3,2,9898,9898,9900,0,2,0
2827,1,1,9899,9900,9901,1,2,0
2828,1,1,9900,9901,9902,1,2,0
2829,3,3,9903,9903,9906,0,3,1
2830,4,1,9907,9907,9908,0,1,1
2831,3,2,9910,9910,9912,0,2,2
2832,2,1,9912,9912,9913,0,1,0
2833,4,1,9916,9916,9917,0,1,3
2834,3,1,9919,9919,9920,0,1,2
2835,3,3,9922,9922,9925,0,3,2
2836,5,2,9927,9927,9929,0,2,2
2837,5,3,9932,9932,9935,0,3,3
2838,2,1,9934,9935,9936,1,2,0
2839,5,3,9939,9939,9942,0,3,3
2840,3,3,9942,9942,9945,0,3,0
2841,2,2,9944,9945,9947,1,3,0
2842,4,2,9948,9948,9950,0,2,1
2843,2,3,9950,9950,9953,0,3,0
2844,4,1,9954,9954,9955,0,1,1
2845,2,1,9956,9956,9957,0,1,1
2846,4,3,9960,9960,9963,0,3,3
2847,4,1,9964,9964,9965,0,1,1
2848,6,3,9970,9970,9973,0,3,5
2849,5,2,9975,9975,9977,0,2,2
2850,3,1,9978,9978,9979,0,1,1
2851,4,2,9982,9982,9984,0,2,3
2852,4,1,9986,9986,9987,0,1,2
2853,5,1,9991,9991,9992,0,1,4
2854,5,2,9996,9996,9998,0,2,4
2855,6,3,10002,10002,10005,0,3,4
2856,6,2,10008,10008,10010,0,2,3
2857,6,3,10014,10014,10017,0,3,4
2858,6,3,10020,10020,10023,0,3,3
2859,1,3,10021,10023,10026,2,5,0
2860,4,2,10025,10026,10028,1,3,0
2861,5,3,10030,10030,10033,0,3,2
2862,4,2,10034,10034,10036,0,2,1
2863,5,3,10039,10039,10042,0,3,3
2864,6,2,10045,10045,10047,0,2,3
2865,1,2,10046,10047,10049,1,3,0
2866,1,1,10047,10049,10050,2,3,0
2867,1,3,10048,10050,10053,2,5,0
2868,4,2,10052,10053,10055,1,3,0
2869,2,1,10054,10055,10056,1,2,0
2870,6,3,10060,10060,10063,0,3,4
2871,1,2,10061,10063,10065,2,4,0
2872,4,2,10065,10065,10067,0,2,0
2873,1,3,10066,10067,10070,1,4,0
2874,2,3,10068,10070,10073,2,5,0
2875,4,1,10072,10073,10074,1,2,0
2876,5,1,10077,10077,10078,0,1,3
2877,2,1,10079,10079,10080,0,1,1
2878,1,1,10080,10080,10081,0,1,0
2879,5,1,10085,10085,10086,0,1,4
2880,6,3,10091,10091,10094,0,3,5
2881,6,1,10097,10097,10098,0,1,3
2882,4,3,10101,10101,10104,0,3,3
2883,2,1,10103,10104,10105,1,2,0
2884,1,1,10104,10105,10106,1,2,0
2885,3,3,10107,10107,10110,0,3,1
2886,6,3,10113,10113,10116,0,3,3
2887,2,1,10115,10116,10117,1,2,0
2888,3,3,10118,10118,10121,0,3,1
2889,2,3,10120,10121,10124,1,4,0
2890,4,1,10124,10124,10125,0,1,0
2891,3,1,10127,10127,10128,0,1,2
2892,5,1,10132,10132,10133,0,1,4
2893,2,1,10134,10134,10135,0,1,1
2894,6,3,10140,10140,10143,0,3,5
2895,3,1,10143,10143,10144,0,1,0
2896,2,3,10145,10145,10148,0,3,1
2897,1,1,10146,10148,10149,2,3,0
2898,1,3,10147,10149,10152,2,5,0
2899,5,3,10152,10152,10155,0,3,0
2900,6,3,10158,10158,10161,0,3,3
2901,2,2,10160,10161,10163,1,3,0
2902,4,1,10164,10164,10165,0,1,1
2903,1,1,10165,10165,10166,0,1,0
2904,2,3,10167,10167,10170,0,3,1
2905,4,1,10171,10171,10172,0,1,1
2906,3,1,10174,10174,10175,0,1,2
2907,4,2,10178,10178,10180,0,2,3
2908,3,2,10181,10181,10183,0,2,1
2909,1,3,10182,10183,10186,1,4,0
2910,1,1,10183,10186,10187,3,4,0
2911,4,3,10187,10187,10190,0,3,0
2912,6,2,10193,10193,10195,0,2,3
2913,2,2,10195,10195,10197,0,2,0
2914,4,1,10199,10199,10200,0,1,2
2915,4,2,10203,10203,10205,0,2,3
2916,2,3,10205,10205,10208,0,3,0
2917,1,1,10206,10208,10209,2,3,0
2918,1,1,10207,10209,10210,2,3,0
2919,1,3,10208,10210,10213,2,5,0
2920,1,3,10209,10213,10216,4,7,0
2921,5,3,10214,10216,10219,2,5,0
2922,6,1,10220,10220,10221,0,1,1
2923,1,1,10221,10221,10222,0,1,0
2924,2,3,10223,10223,10226,0,3,1
2925,1,1,10224,10226,10227,2,3,0
2926,6,1,10230,10230,10231,0,1,3
2927,6,3,10236,10236,10239,0,3,5
2928,1,1,10237,10239,10240,2,3,0
2929,2,3,10239,10240,10243,1,4,0
2930,2,2,10241,10243,10245,2,4,0
2931,6,2,10247,10247,10249,0,2,2
2932,6,2,10253,10253,10255,0,2,4
2933,1,2,10254,10255,10257,1,3,0
2934,4,3,10258,10258,10261,0,3,1
2935,5,1,10263,10263,10264,0,1,2
2936,6,1,10269,10269,10270,0,1,5
2937,4,3,10273,10273,10276,0,3,3
2938,5,1,10278,10278,10279,0,1,2
2939,6,3,10284,10284,10287,0,3,5
2940,3,2,10287,10287,10289,0,2,0
2941,3,1,10290,10290,10291,0,1,1
2942,3,3,10293,10293,10296,0,3,2
2943,4,1,10297,10297,10298,0,1,1
2944,2,2,10299,10299,10301,0,2,1
2945,4,2,10303,10303,10305,0,2,2
2946,4,1,10307,10307,10308,0,1,2
2947,4,1,10311,10311,10312,0,1,3
2948,4,3,10315,10315,10318,0,3,3
2949,3,1,10318,10318,10319,0,1,0
2950,4,3,10322,10322,10325,0,3,3
2951,5,3,10327,10327,10330,0,3,2
2952,3,1,10330,10330,10331,0,1,0
2953,6,3,10336,10336,10339,0,3,5
2954,4,1,10340,10340,10341,0,1,1
2955,6,3,10346,10346,10349,0,3,5
2956,6,1,10352,10352,10353,0,1,3
2957,3,1,10355,10355,10356,0,1,2
2958,2,2,10357,10357,10359,0,2,1
2959,5,1,10362,10362,10363,0,1,3
2960,1,2,10363,10363,10365,0,2,0
2961,3,1,10366,10366,10367,0,1,1
2962,3,1,10369,10369,10370,0,1,2
2963,2,3,10371,10371,10374,0,3,1
2964,4,1,10375,10375,10376,0,1,1
2965,5,1,10380,10380,10381,0,1,4
2966,1,2,10381,10381,10383,0,2,0
2967,4,3,10385,10385,10388,0,3,2
2968,1,3,10386,10388,10391,2,5,0
2969,4,3,10390,10391,10394,1,4,0
2970,1,3,10391,10394,10397,3,6,0
2971,1,2,10392,10397,10399,5,7,0
2972,3,2,10395,10399,10401,4,6,0
2973,3,2,10398,10401,10403,3,5,0
2974,2,1,10400,10403,10404,3,4,0
2975,3,1,10403,10404,10405,1,2,0
2976,3,1,10406,10406,10407,0,1,1
2977,4,1,10410,10410,10411,0,1,3
2978,5,1,10415,10415,10416,0,1,4
2979,4,1,10419,10419,10420,0,1,3
2980,6,3,10425,10425,10428,0,3,5
2981,5,3,10430,10430,10433,0,3,2
2982,3,3,10433,10433,10436,0,3,0
2983,4,3,10437,10437,10440,0,3,1
2984,6,3,10443,10443,10446,0,3,3
2985,4,2,10447,10447,10449,0,2,1
2986,6,1,10453,10453,10454,0,1,4
2987,5,2,10458,10458,10460,0,2,4
2988,5,1,10463,10463,10464,0,1,3
2989,5,1,10468,10468,10469,0,1,4
2990,6,2,10474,10474,10476,0,2,5
2991,5,2,10479,10479,10481,0,2,3
2992,3,3,10482,10482,10485,0,3,1
2993,2,2,10484,10485,10487,1,3,0
2994,6,3,10490,10490,10493,0,3,3
2995,5,2,10495,10495,10497,0,2,2
2996,4,3,10499,10499,10502,0,3,2
2997,6,2,10505,10505,10507,0,2,3
2998,1,3,10506,10507,10510,1,4,0
2999,5,1,10511,10511,10512,0,1,1
3000,5,3,10516,10516,10519,0,3,4
3001,4,3,10520,10520,10523,0,3,1
3002,1,3,10521,10523,10526,2,5,0
3003,2,1,10523,10526,10527,3,4,0
3004,6,1,10529,10529,10530,0,1,2
3005,3,2,10532,10532,10534,0,2,2
3006,4,3,10536,10536,10539,0,3,2
3007,6,2,10542,10542,10544,0,2,3
3008,4,1,10546,10546,10547,0,1,2
3009,1,2,10547,10547,10549,0,2,0
3010,5,1,10552,10552,10553,0,1,3
3011,4,2,10556,10556,10558,0,2,3
3012,3,2,10559,10559,10561,0,2,1
3013,3,1,10562,10562,10563,0,1,1
3014,4,1,10566,10566,10567,0,1,3
3015,2,2,10568,10568,10570,0,2,1
3016,1,1,10569,10570,10571,1,2,0
3017,2,3,10571,10571,10574,0,3,0
3018,1,1,10572,10574,10575,2,3,0
3019,1,2,10573,10575,10577,2,4,0
3020,1,1,10574,10577,10578,3,4,0
3021,1,3,10575,10578,10581,3,6,0
3022,6,2,10581,10581,10583,0,2,0
3023,1,2,10582,10583,10585,1,3,0
3024,2,2,10584,10585,10587,1,3,0
3025,3,2,10587,10587,10589,0,2,0
3026,1,2,10588,10589,10591,1,3,0
3027,5,1,10593,10593,10594,0,1,2
3028,2,3,10595,10595,10598,0,3,1
3029,3,1,10598,10598,10599,0,1,0
3030,4,1,10602,10602,10603,0,1,3
3031,1,2,10603,10603,10605,0,2,0
3032,3,2,10606,10606,10608,0,2,1
3033,3,1,10609,10609,10610,0,1,1
3034,4,2,10613,10613,10615,0,2,3
3035,1,3,10614,10615,10618,1,4,0
3036,6,2,10620,10620,10622,0,2,2
3037,2,2,10622,10622,10624,0,2,0
3038,4,1,10626,10626,10627,0,1,2
3039,6,1,10632,10632,10633,0,1,5
3040,2,3,10634,10634,10637,0,3,1
3041,3,1,10637,10637,10638,0,1,0
3042,2,3,10639,10639,10642,0,3,1
3043,1,1,10640,10642,10643,2,3,0
3044,6,3,10646,10646,10649,0,3,3
3045,1,3,10647,10649,10652,2,5,0
3046,1,2,10648,10652,10654,4,6,0
3047,2,3,10650,10654,10657,4,7,0
3048,3,2,10653,10657,10659,4,6,0
3049,4,2,10657,10659,10661,2,4,0
3050,2,1,10659,10661,10662,2,3,0
3051,4,2,10663,10663,10665,0,2,1
3052,3,1,10666,10666,10667,0,1,1
3053,3,1,10669,10669,10670,0,1,2
3054,2,1,10671,10671,10672,0,1,1
3055,1,1,10672,10672,10673,0,1,0
3056,5,2,10677,10677,10679,0,2,4
3057,4,2,10681,10681,10683,0,2,2
3058,1,1,10682,10683,10684,1,2,0
3059,4,1,10686,10686,10687,0,1,2
3060,5,2,10691,10691,10693,0,2,4
3061,5,1,10696,10696,10697,0,1,3
3062,5,3,10701,10701,10704,0,3,4
3063,6,3,10707,10707,10710,0,3,3
3064,2,2,10709,10710,10712,1,3,0
3065,6,2,10715,10715,10717,0,2,3
3066,4,1,10719,10719,10720,0,1,2
3067,6,1,10725,10725,10726,0,1,5
3068,2,2,10727,10727,10729,0,2,1
3069,4,1,10731,10731,10732,0,1,2
3070,5,1,10736,10736,10737,0,1,4
3071,3,2,10739,10739,10741,0,2,2
3072,1,2,10740,10741,10743,1,3,0
3073,6,2,10746,10746,10748,0,2,3
3074,1,2,10747,10748,10750,1,3,0
3075,5,2,10752,10752,10754,0,2,2
3076,6,2,10758,10758,10760,0,2,4
3077,6,1,10764,10764,10765,0,1,4
3078,5,1,10769,10769,10770,0,1,4
3079,4,2,10773,10773,10775,0,2,3
3080,5,1,10778,10778,10779,0,1,3
3081,1,3,10779,10779,10782,0,3,0
3082,5,1,10784,10784,10785,0,1,2
3083,2,1,10786,10786,10787,0,1,1
3084,5,2,10791,10791,10793,0,2,4
3085,1,3,10792,10793,10796,1,4,0
3086,4,1,10796,10796,10797,0,1,0
3087,3,1,10799,10799,10800,0,1,2
3088,5,1,10804,10804,10805,0,1,4
3089,3,2,10807,10807,10809,0,2,2
3090,1,1,10808,10809,10810,1,2,0
3091,5,2,10813,10813,10815,0,2,3
3092,1,1,10814,10815,10816,1,2,0
3093,4,2,10818,10818,10820,0,2,2
3094,4,3,10822,10822,10825,0,3,2
3095,4,1,10826,10826,10827,0,1,1
3096,4,3,10830,10830,10833,0,3,3
3097,1,2,10831,10833,10835,2,4,0
3098,4,3,10835,10835,10838,0,3,0
3099,6,2,10841,10841,10843,0,2,3
3100,2,2,10843,10843,10845,0,2,0
3101,1,2,10844,10845,10847,1,3,0
3102,4,2,10848,10848,10850,0,2,1
3103,1,3,10849,10850,10853,1,4,0
3104,3,2,10852,10853,10855,1,3,0
3105,4,3,10856,10856,10859,0,3,1
3106,4,3,10860,10860,10863,0,3,1
3107,1,3,10861,10863,10866,2,5,0
3108,6,2,10867,10867,10869,0,2,1
3109,2,1,10869,10869,10870,0,1,0
3110,4,3,10873,10873,10876,0,3,3
3111,6,2,10879,10879,10881,0,2,3
3112,4,3,10883,10883,10886,0,3,2
3113,4,2,10887,10887,10889,0,2,1
3114,6,1,10893,10893,10894,0,1,4
3115,4,2,10897,10897,10899,0,2,3
3116,5,3,10902,10902,10905,0,3,3
3117,2,3,10904,10905,10908,1,4,0
3118,3,3,10907,10908,10911,1,4,0
3119,6,1,10913,10913,10914,0,1,2
3120,2,1,10915,10915,10916,0,1,1
3121,3,1,10918,10918,10919,0,1,2
3122,1,3,10919,10919,10922,0,3,0
3123,5,1,10924,10924,10925,0,1,2
3124,1,1,10925,10925,10926,0,1,0
3125,5,2,10930,10930,10932,0,2,4
3126,5,1,10935,10935,10936,0,1,3
3127,2,3,10937,10937,10940,0,3,1
3128,1,2,10938,10940,10942,2,4,0
3129,3,1,10941,10942,10943,1,2,0
3130,3,3,10944,10944,10947,0,3,1
3131,6,2,10950,10950,10952,0,2,3
3132,1,3,10951,10952,10955,1,4,0
3133,5,1,10956,10956,10957,0,1,1
3134,4,1,10960,10960,10961,0,1,3
3135,3,1,10963,10963,10964,0,1,2
3136,3,3,10966,10966,10969,0,3,2
3137,5,1,10971,10971,10972,0,1,2
3138,5,3,10976,10976,10979,0,3,4
3139,4,3,10980,10980,10983,0,3,1
3140,3,3,10983,10983,10986,0,3,0
3141,1,2,10984,10986,10988,2,4,0
3142,4,3,10988,10988,10991,0,3,0
3143,4,2,10992,10992,10994,0,2,1
3144,6,2,10998,10998,11000,0,2,4
3145,2,3,11000,11000,11003,0,3,0
3146,1,2,11001,11003,11005,2,4,0
3147,3,2,11004,11005,11007,1,3,0
3148,1,1,11005,11007,11008,2,3,0
3149,3,3,11008,11008,11011,0,3,0
3150,4,3,11012,11012,11015,0,3,1
3151,5,1,11017,11017,11018,0,1,2
3152,6,1,11023,11023,11024,0,1,5
3153,2,1,11025,11025,11026,0,1,1
3154,1,2,11026,11026,11028,0,2,0
3155,5,2,11031,11031,11033,0,2,3
3156,1,3,11032,11033,11036,1,4,0
3157,6,2,11038,11038,11040,0,2,2
3158,5,3,11043,11043,11046,0,3,3
3159,1,1,11044,11046,11047,2,3,0
3160,5,2,11049,11049,11051,0,2,2
3161,4,1,11053,11053,11054,0,1,2
3162,3,2,11056,11056,11058,0,2,2
3163,4,3,11060,11060,11063,0,3,2
3164,1,2,11061,11063,11065,2,4,0
3165,2,1,11063,11065,11066,2,3,0
3166,6,3,11069,11069,11072,0,3,3
3167,3,3,11072,11072,11075,0,3,0
3168,3,3,11075,11075,11078,0,3,0
3169,2,2,11077,11078,11080,1,3,0
3170,1,3,11078,11080,11083,2,5,0
3171,3,1,11081,11083,11084,2,3,0
3172,3,3,11084,11084,11087,0,3,0
3173,4,3,11088,11088,11091,0,3,1
3174,5,1,11093,11093,11094,0,1,2
3175,2,3,11095,11095,11098,0,3,1
3176,3,3,11098,11098,11101,0,3,0
3177,3,2,11101,11101,11103,0,2,0
3178,5,3,11106,11106,11109,0,3,3
3179,4,1,11110,11110,11111,0,1,1
3180,6,1,11116,11116,11117,0,1,5
3181,5,2,11121,11121,11123,0,2,4
3182,6,3,11127,11127,11130,0,3,4
3183,5,3,11132,11132,11135,0,3,2
3184,3,3,11135,11135,11138,0,3,0
3185,3,2,11138,11138,11140,0,2,0
3186,2,2,11140,11140,11142,0,2,0
3187,6,3,11146,11146,11149,0,3,4
3188,5,3,11151,11151,11154,0,3,2
3189,1,3,11152,11154,11157,2,5,0
3190,2,1,11154,11157,11158,3,4,0
3191,2,2,11156,11158,11160,2,4,0
3192,2,2,11158,11160,11162,2,4,0
3193,2,2,11160,11162,11164,2,4,0
3194,5,3,11165,11165,11168,0,3,1
3195,4,1,11169,11169,11170,0,1,1
3196,4,1,11173,11173,11174,0,1,3
3197,3,1,11176,11176,11177,0,1,2
3198,5,1,11181,11181,11182,0,1,4
3199,5,2,11186,11186,11188,0,2,4
3200,1,2,11187,11188,11190,1,3,0
3201,4,3,11191,11191,11194,0,3,1
3202,1,3,11192,11194,11197,2,5,0
3203,4,3,11196,11197,11200,1,4,0
3204,6,2,11202,11202,11204,0,2,2
3205,1,2,11203,11204,11206,1,3,0
3206,1,1,11204,11206,11207,2,3,0
3207,2,2,11206,11207,11209,1,3,0
3208,6,2,11212,11212,11214,0,2,3
3209,1,1,11213,11214,11215,1,2,0
3210,3,3,11216,11216,11219,0,3,1
3211,4,2,11220,11220,11222,0,2,1
3212,2,1,11222,11222,11223,0,1,0
3213,3,3,11225,11225,11228,0,3,2
3214,5,1,11230,11230,11231,0,1,2
3215,3,1,11233,11233,11234,0,1,2
3216,5,3,11238,11238,11241,0,3,4
3217,2,1,11240,11241,11242,1,2,0
3218,1,3,11241,11242,11245,1,4,0
3219,1,3,11242,11245,11248,3,6,0
3220,3,1,11245,11248,11249,3,4,0
3221,6,3,11251,11251,11254,0,3,2
3222,6,1,11257,11257,11258,0,1,3
3223,1,3,11258,11258,11261,0,3,0
3224,5,3,11263,11263,11266,0,3,2
3225,4,2,11267,11267,11269,0,2,1
3226,1,2,11268,11269,11271,1,3,0
3227,6,2,11274,11274,11276,0,2,3
3228,6,1,11280,11280,11281,0,1,4
3229,4,1,11284,11284,11285,0,1,3
3230,6,3,11290,11290,11293,0,3,5
3231,1,2,11291,11293,11295,2,4,0
3232,3,1,11294,11295,11296,1,2,0
3233,2,3,11296,11296,11299,0,3,0
3234,6,2,11302,11302,11304,0,2,3
3235,6,2,11308,11308,11310,0,2,4
3236,1,1,11309,11310,11311,1,2,0
3237,4,2,11313,11313,11315,0,2,2
3238,2,1,11315,11315,11316,0,1,0
3239,6,2,11321,11321,11323,0,2,5
3240,2,1,11323,11323,11324,0,1,0
3241,3,2,11326,11326,11328,0,2,2
3242,4,1,11330,11330,11331,0,1,2
3243,2,3,11332,11332,11335,0,3,1
3244,3,1,11335,11335,11336,0,1,0
3245,1,2,11336,11336,11338,0,2,0
3246,1,1,11337,11338,11339,1,2,0
3247,2,2,11339,11339,11341,0,2,0
3248,3,2,11342,11342,11344,0,2,1
3249,2,2,11344,11344,11346,0,2,0
3250,4,3,11348,11348,11351,0,3,2
3251,4,3,11352,11352,11355,0,3,1
3252,1,2,11353,11355,11357,2,4,0
3253,4,3,11357,11357,11360,0,3,0
3254,2,2,11359,11360,11362,1,3,0
3255,2,3,11361,11362,11365,1,4,0
3256,2,2,11363,11365,11367,2,4,0
3257,6,3,11369,11369,11372,0,3,2
3258,5,2,11374,11374,11376,0,2,2
3259,5,3,11379,11379,11382,0,3,3
3260,4,1,11383,11383,11384,0,1,1
3261,5,3,11388,11388,11391,0,3,4
3262,2,1,11390,11391,11392,1,2,0
3263,6,3,11396,11396,11399,0,3,4
3264,3,3,11399,11399,11402,0,3,0
3265,2,3,11401,11402,11405,1,4,0
3266,2,3,11403,11405,11408,2,5,0
3267,3,2,11406,11408,11410,2,4,0
3268,5,1,11411,11411,11412,0,1,1
3269,4,3,11415,11415,11418,0,3,3
3270,3,1,11418,11418,11419,0,1,0
3271,1,3,11419,11419,11422,0,3,0
3272,2,1,11421,11422,11423,1,2,0
3273,1,2,11422,11423,11425,1,3,0
3274,4,2,11426,11426,11428,0,2,1
3275,2,3,11428,11428,11431,0,3,0
3276,1,3,11429,11431,11434,2,5,0
3277,3,3,11432,11434,11437,2,5,0
3278,4,3,11436,11437,11440,1,4,0
3279,2,3,11438,11440,11443,2,5,0
3280,5,2,11443,11443,11445,0,2,0
3281,3,2,11446,11446,11448,0,2,1
3282,4,3,11450,11450,11453,0,3,2
3283,4,1,11454,11454,11455,0,1,1
3284,3,1,11457,11457,11458,0,1,2
3285,6,3,11463,11463,11466,0,3,5
3286,1,2,11464,11466,11468,2,4,0
3287,1,2,11465,11468,11470,3,5,0
3288,6,1,11471,11471,11472,0,1,1
3289,6,1,11477,11477,11478,0,1,5
3290,3,2,11480,11480,11482,0,2,2
3291,2,1,11482,11482,11483,0,1,0
3292,1,3,11483,11483,11486,0,3,0
3293,6,2,11489,11489,11491,0,2,3
3294,5,2,11494,11494,11496,0,2,3
3295,6,2,11500,11500,11502,0,2,4
3296,6,3,11506,11506,11509,0,3,4
3297,2,2,11508,11509,11511,1,3,0
3298,2,1,11510,11511,11512,1,2,0
3299,5,1,11515,11515,11516,0,1,3
3300,2,2,11517,11517,11519,0,2,1
3301,6,1,11523,11523,11524,0,1,4
3302,3,2,11526,11526,11528,0,2,2
3303,4,1,11530,11530,11531,0,1,2
3304,4,1,11534,11534,11535,0,1,3
3305,2,3,11536,11536,11539,0,3,1
3306,1,1,11537,11539,11540,2,3,0
3307,5,1,11542,11542,11543,0,1,2
3308,5,1,11547,11547,11548,0,1,4
3309,3,1,11550,11550,11551,0,1,2
3310,3,2,11553,11553,11555,0,2,2
3311,6,3,11559,11559,11562,0,3,4
3312,2,2,11561,11562,11564,1,3,0
3313,3,2,11564,11564,11566,0,2,0
3314,1,1,11565,11566,11567,1,2,0
3315,1,3,11566,11567,11570,1,4,0
3316,4,3,11570,11570,11573,0,3,0
3317,6,3,11576,11576,11579,0,3,3
3318,5,1,11581,11581,11582,0,1,2
3319,2,3,11583,11583,11586,0,3,1
3320,6,3,11589,11589,11592,0,3,3
3321,1,2,11590,11592,11594,2,4,0
3322,5,2,11595,11595,11597,0,2,1
3323,6,2,11601,11601,11603,0,2,4
3324,4,1,11605,11605,11606,0,1,2
3325,5,1,11610,11610,11611,0,1,4
3326,6,1,11616,11616,11617,0,1,5
3327,4,1,11620,11620,11621,0,1,3
3328,5,1,11625,11625,11626,0,1,4
3329,5,2,11630,11630,11632,0,2,4
3330,5,2,11635,11635,11637,0,2,3
3331,6,2,11641,11641,11643,0,2,4
3332,5,2,11646,11646,11648,0,2,3
3333,2,2,11648,11648,11650,0,2,0
3334,6,3,11654,11654,11657,0,3,4
3335,4,3,11658,11658,11661,0,3,1
3336,2,2,11660,11661,11663,1,3,0
3337,1,2,11661,11663,11665,2,4,0
3338,3,2,11664,11665,11667,1,3,0
3339,6,2,11670,11670,11672,0,2,3
3340,6,2,11676,11676,11678,0,2,4
3341,3,3,11679,11679,11682,0,3,1
3342,5,3,11684,11684,11687,0,3,2
3343,5,3,11689,11689,11692,0,3,2
3344,6,1,11695,11695,11696,0,1,3
3345,1,3,11696,11696,11699,0,3,0
3346,6,2,11702,11702,11704,0,2,3
3347,1,1,11703,11704,11705,1,2,0
3348,5,1,11708,11708,11709,0,1,3
3349,3,2,11711,11711,11713,0,2,2
3350,5,2,11716,11716,11718,0,2,3
3351,1,3,11717,11718,11721,1,4,0
3352,1,1,11718,11721,11722,3,4,0
3353,5,1,11723,11723,11724,0,1,1
3354,1,3,11724,11724,11727,0,3,0
3355,5,1,11729,11729,11730,0,1,2
3356,5,1,11734,11734,11735,0,1,4
3357,2,3,11736,11736,11739,0,3,1
3358,2,2,11738,11739,11741,1,3,0
3359,1,3,11739,11741,11744,2,5,0
3360,6,1,11745,11745,11746,0,1,1
3361,4,1,11749,11749,11750,0,1,3
3362,5,3,11754,11754,11757,0,3,4
3363,5,2,11759,11759,11761,0,2,2
3364,2,1,11761,11761,11762,0,1,0
3365,5,2,11766,11766,11768,0,2,4
3366,3,3,11769,11769,11772,0,3,1
3367,2,1,11771,11772,11773,1,2,0
3368,3,2,11774,11774,11776,0,2,1
3369,5,3,11779,11779,11782,0,3,3
3370,5,2,11784,11784,11786,0,2,2
3371,4,3,11788,11788,11791,0,3,2
3372,3,2,11791,11791,11793,0,2,0
3373,2,2,11793,11793,11795,0,2,0
3374,6,2,11799,11799,11801,0,2,4
3375,5,2,11804,11804,11806,0,2,3
3376,3,1,11807,11807,11808,0,1,1
3377,5,3,11812,11812,11815,0,3,4
3378,5,2,11817,11817,11819,0,2,2
3379,4,1,11821,11821,11822,0,1,2
3380,2,1,11823,11823,11824,0,1,1
3381,6,3,11829,11829,11832,0,3,5
3382,1,1,11830,11832,11833,2,3,0
3383,6,3,11836,11836,11839,0,3,3
3384,3,1,11839,11839,11840,0,1,0
3385,1,1,11840,11840,11841,0,1,0
3386,1,3,11841,11841,11844,0,3,0
3387,6,2,11847,11847,11849,0,2,3
3388,4,2,11851,11851,11853,0,2,2
3389,5,2,11856,11856,11858,0,2,3
3390,6,1,11862,11862,11863,0,1,4
3391,5,2,11867,11867,11869,0,2,4
3392,1,3,11868,11869,11872,1,4,0
3393,3,2,11871,11872,11874,1,3,0
3394,2,3,11873,11874,11877,1,4,0
3395,2,1,11875,11877,11878,2,3,0
3396,5,3,11880,11880,11883,0,3,2
3397,4,2,11884,11884,11886,0,2,1
3398,6,2,11890,11890,11892,0,2,4
3399,3,2,11893,11893,11895,0,2,1
3400,4,2,11897,11897,11899,0,2,2
3401,6,2,11903,11903,11905,0,2,4
3402,3,1,11906,11906,11907,0,1,1
3403,1,3,11907,11907,11910,0,3,0
3404,3,1,11910,11910,11911,0,1,0
3405,4,1,11914,11914,11915,0,1,3
3406,6,3,11920,11920,11923,0,3,5
3407,3,1,11923,11923,11924,0,1,0
3408,6,3,11929,11929,11932,0,3,5
3409,1,3,11930,11932,11935,2,5,0
3410,6,3,11936,11936,11939,0,3,1
3411,1,1,11937,11939,11940,2,3,0
3412,2,1,11939,11940,11941,1,2,0
3413,5,1,11944,11944,11945,0,1,3
3414,4,3,11948,11948,11951,0,3,3
3415,4,2,11952,11952,11954,0,2,1
3416,6,1,11958,11958,11959,0,1,4
3417,2,1,11960,11960,11961,0,1,1
3418,4,3,11964,11964,11967,0,3,3
3419,3,3,11967,11967,11970,0,3,0
3420,4,3,11971,11971,11974,0,3,1
3421,2,1,11973,11974,11975,1,2,0
3422,6,1,11979,11979,11980,0,1,4
3423,6,2,11985,11985,11987,0,2,5
3424,3,3,11988,11988,11991,0,3,1
3425,2,3,11990,11991,11994,1,4,0
3426,5,3,11995,11995,11998,0,3,1
3427,3,3,11998,11998,12001,0,3,0
3428,1,1,11999,12001,12002,2,3,0
3429,1,1,12000,12002,12003,2,3,0
3430,6,2,12006,12006,12008,0,2,3
3431,1,3,12007,12008,12011,1,4,0
3432,6,3,12013,12013,12016,0,3,2
3433,5,3,12018,12018,12021,0,3,2
3434,2,2,12020,12021,12023,1,3,0
3435,1,3,12021,12023,12026,2,5,0
3436,2,3,12023,12026,12029,3,6,0
3437,5,2,12028,12029,12031,1,3,0
3438,6,1,12034,12034,12035,0,1,3
3439,3,1,12037,12037,12038,0,1,2
3440,5,1,12042,12042,12043,0,1,4
3441,3,3,12045,12045,12048,0,3,2
3442,2,2,12047,12048,12050,1,3,0
3443,4,2,12051,12051,12053,0,2,1
3444,4,3,12055,12055,12058,0,3,2
3445,2,3,12057,12058,12061,1,4,0
3446,1,1,12058,12061,12062,3,4,0
3447,1,1,12059,12062,12063,3,4,0
3448,5,3,12064,12064,12067,0,3,1
3449,6,2,12070,12070,12072,0,2,3
3450,4,2,12074,12074,12076,0,2,2
3451,2,2,12076,12076,12078,0,2,0
3452,6,3,12082,12082,12085,0,3,4
3453,3,3,12085,12085,12088,0,3,0
3454,1,2,12086,12088,12090,2,4,0
3455,5,3,12091,12091,12094,0,3,1
3456,2,2,12093,12094,12096,1,3,0
3457,2,1,12095,12096,12097,1,2,0
3458,5,3,12100,12100,12103,0,3,3
3459,2,3,12102,12103,12106,1,4,0
3460,1,2,12103,12106,12108,3,5,0
3461,3,2,12106,12108,12110,2,4,0
3462,5,3,12111,12111,12114,0,3,1
3463,5,3,12116,12116,12119,0,3,2
3464,5,1,12121,12121,12122,0,1,2
3465,6,1,12127,12127,12128,0,1,5
3466,3,3,12130,12130,12133,0,3,2
3467,5,3,12135,12135,12138,0,3,2
3468,4,1,12139,12139,12140,0,1,1
3469,2,2,12141,12141,12143,0,2,1
3470,1,2,12142,12143,12145,1,3,0
3471,2,1,12144,12145,12146,1,2,0
3472,2,3,12146,12146,12149,0,3,0
3473,5,3,12151,12151,12154,0,3,2
3474,1,3,12152,12154,12157,2,5,0
3475,6,3,12158,12158,12161,0,3,1
3476,2,3,12160,12161,12164,1,4,0
3477,5,1,12165,12165,12166,0,1,1
3478,3,3,12168,12168,12171,0,3,2
3479,2,1,12170,12171,12172,1,2,0
3480,6,3,12176,12176,12179,0,3,4
3481,1,2,12177,12179,12181,2,4,0
3482,2,2,12179,12181,12183,2,4,0
3483,4,3,12183,12183,12186,0,3,0
3484,2,3,12185,12186,12189,1,4,0
3485,4,1,12189,12189,12190,0,1,0
3486,2,1,12191,12191,12192,0,1,1
3487,6,3,12197,12197,12200,0,3,5
3488,3,1,12200,12200,12201,0,1,0
3489,1,3,12201,12201,12204,0,3,0
3490,2,1,12203,12204,12205,1,2,0
3491,4,3,12207,12207,12210,0,3,2
3492,4,1,12211,12211,12212,0,1,1
3493,1,3,12212,12212,12215,0,3,0
3494,6,1,12218,12218,12219,0,1,3
3495,3,2,12221,12221,12223,0,2,2
3496,4,3,12225,12225,12228,0,3,2
3497,4,3,12229,12229,12232,0,3,1
3498,4,3,12233,12233,12236,0,3,1
3499,6,1,12239,12239,12240,0,1,3
3500,4,2,12243,12243,12245,0,2,3
3501,4,1,12247,12247,12248,0,1,2
3502,5,3,12252,12252,12255,0,3,4
3503,4,1,12256,12256,12257,0,1,1
3504,1,3,12257,12257,12260,0,3,0
3505,6,2,12263,12263,12265,0,2,3
3506,1,2,12264,12265,12267,1,3,0
3507,5,3,12269,12269,12272,0,3,2
3508,4,1,12273,12273,12274,0,1,1
3509,3,1,12276,12276,12277,0,1,2
3510,2,3,12278,12278,12281,0,3,1
3511,2,1,12280,12281,12282,1,2,0
3512,1,2,12281,12282,12284,1,3,0
3513,5,2,12286,12286,12288,0,2,2
3514,5,2,12291,12291,12293,0,2,3
3515,1,2,12292,12293,12295,1,3,0
3516,3,1,12295,12295,12296,0,1,0
3517,6,3,12301,12301,12304,0,3,5
3518,4,1,12305,12305,12306,0,1,1
3519,2,2,12307,12307,12309,0,2,1
3520,2,2,12309,12309,12311,0,2,0
3521,3,3,12312,12312,12315,0,3,1
3522,1,1,12313,12315,12316,2,3,0
3523,5,1,12318,12318,12319,0,1,2
3524,3,2,12321,12321,12323,0,2,2
3525,3,3,12324,12324,12327,0,3,1
3526,5,2,12329,12329,12331,0,2,2
3527,3,1,12332,12332,12333,0,1,1
3528,6,2,12338,12338,12340,0,2,5
3529,4,2,12342,12342,12344,0,2,2
3530,5,1,12347,12347,12348,0,1,3
3531,1,2,12348,12348,12350,0,2,0
3532,1,2,12349,12350,12352,1,3,0
3533,2,1,12351,12352,12353,1,2,0
3534,5,1,12356,12356,12357,0,1,3
3535,1,2,12357,12357,12359,0,2,0
3536,2,2,12359,12359,12361,0,2,0
3537,4,1,12363,12363,12364,0,1,2
3538,6,1,12369,12369,12370,0,1,5
3539,2,1,12371,12371,12372,0,1,1
3540,2,3,12373,12373,12376,0,3,1
3541,1,3,12374,12376,12379,2,5,0
3542,1,1,12375,12379,12380,4,5,0
3543,4,2,12379,12380,12382,1,3,0
3544,4,2,12383,12383,12385,0,2,1
3545,6,2,12389,12389,12391,0,2,4
3546,1,2,12390,12391,12393,1,3,0
3547,3,2,12393,12393,12395,0,2,0
3548,1,3,12394,12395,12398,1,4,0
3549,5,3,12399,12399,12402,0,3,1
3550,2,1,12401,12402,12403,1,2,0
3551,5,1,12406,12406,12407,0,1,3
3552,3,3,12409,12409,12412,0,3,2
3553,5,2,12414,12414,12416,0,2,2
3554,2,2,12416,12416,12418,0,2,0
3555,3,2,12419,12419,12421,0,2,1
3556,4,1,12423,12423,12424,0,1,2
3557,4,2,12427,12427,12429,0,2,3
3558,6,3,12433,12433,12436,0,3,4
3559,6,2,12439,12439,12441,0,2,3
3560,6,2,12445,12445,12447,0,2,4
3561,1,2,12446,12447,12449,1,3,0
3562,6,3,12452,12452,12455,0,3,3
3563,6,3,12458,12458,12461,0,3,3
3564,1,3,12459,12461,12464,2,5,0
3565,1,2,12460,12464,12466,4,6,0
3566,2,2,12462,12466,12468,4,6,0
3567,4,2,12466,12468,12470,2,4,0
3568,1,2,12467,12470,12472,3,5,0
3569,5,2,12472,12472,12474,0,2,0
3570,6,3,12478,12478,12481,0,3,4
3571,5,2,12483,12483,12485,0,2,2
3572,2,2,12485,12485,12487,0,2,0
3573,2,2,12487,12487,12489,0,2,0
3574,3,1,12490,12490,12491,0,1,1
3575,4,1,12494,12494,12495,0,1,3
3576,3,3,12497,12497,12500,0,3,2
3577,6,1,12503,12503,12504,0,1,3
3578,3,3,12506,12506,12509,0,3,2
3579,4,2,12510,12510,12512,0,2,1
3580,3,1,12513,12513,12514,0,1,1
3581,5,2,12518,12518,12520,0,2,4
3582,3,2,12521,12521,12523,0,2,1
3583,1,1,12522,12523,12524,1,2,0
3584,6,2,12528,12528,12530,0,2,4
3585,2,3,12530,12530,12533,0,3,0
3586,6,2,12536,12536,12538,0,2,3
3587,1,3,12537,12538,12541,1,4,0
3588,4,1,12541,12541,12542,0,1,0
3589,3,2,12544,12544,12546,0,2,2
3590,2,3,12546,12546,12549,0,3,0
3591,2,1,12548,12549,12550,1,2,0
3592,1,1,12549,12550,12551,1,2,0
3593,4,1,12553,12553,12554,0,1,2
3594,5,2,12558,12558,12560,0,2,4
3595,3,3,12561,12561,12564,0,3,1
3596,3,2,12564,12564,12566,0,2,0
3597,3,1,12567,12567,12568,0,1,1
3598,2,2,12569,12569,12571,0,2,1
3599,1,2,12570,12571,12573,1,3,0
3600,3,2,12573,12573,12575,0,2,0
3601,2,2,12575,12575,12577,0,2,0
3602,6,2,12581,12581,12583,0,2,4
3603,1,1,12582,12583,12584,1,2,0
3604,3,2,12585,12585,12587,0,2,1
3605,6,2,12591,12591,12593,0,2,4
3606,3,1,12594,12594,12595,0,1,1
3607,5,1,12599,12599,12600,0,1,4
3608,2,3,12601,12601,12604,0,3,1
3609,2,2,12603,12604,12606,1,3,0
3610,4,2,12607,12607,12609,0,2,1
3611,2,2,12609,12609,12611,0,2,0
3612,1,2,12610,12611,12613,1,3,0
3613,6,1,12616,12616,12617,0,1,3
3614,6,2,12622,12622,12624,0,2,5
3615,5,3,12627,12627,12630,0,3,3
3616,2,2,12629,12630,12632,1,3,0
3617,6,1,12635,12635,12636,0,1,3
3618,5,2,12640,12640,12642,0,2,4
3619,4,2,12644,12644,12646,0,2,2
3620,1,3,12645,12646,12649,1,4,0
3621,3,2,12648,12649,12651,1,3,0
3622,6,2,12654,12654,12656,0,2,3
3623,1,1,12655,12656,12657,1,2,0
3624,1,1,12656,12657,12658,1,2,0
3625,4,1,12660,12660,12661,0,1,2
3626,6,2,12666,12666,12668,0,2,5
3627,5,2,12671,12671,12673,0,2,3
3628,2,1,12673,12673,12674,0,1,0
3629,3,3,12676,12676,12679,0,3,2
3630,5,3,12681,12681,12684,0,3,2
3631,2,1,12683,12684,12685,1,2,0
3632,3,1,12686,12686,12687,0,1,1
3633,3,1,12689,12689,12690,0,1,2
3634,1,1,12690,12690,12691,0,1,0
3635,1,2,12691,12691,12693,0,2,0
3636,4,3,12695,12695,12698,0,3,2
3637,2,1,12697,12698,12699,1,2,0
3638,6,2,12703,12703,12705,0,2,4
3639,2,1,12705,12705,12706,0,1,0
3640,3,2,12708,12708,12710,0,2,2
3641,4,1,12712,12712,12713,0,1,2
3642,2,2,12714,12714,12716,0,2,1
3643,1,3,12715,12716,12719,1,4,0
3644,3,1,12718,12719,12720,1,2,0
3645,2,2,12720,12720,12722,0,2,0
3646,6,2,12726,12726,12728,0,2,4
3647,6,1,12732,12732,12733,0,1,4
3648,5,3,12737,12737,12740,0,3,4
3649,3,1,12740,12740,12741,0,1,0
3650,3,3,12743,12743,12746,0,3,2
3651,2,1,12745,12746,12747,1,2,0
3652,1,2,12746,12747,12749,1,3,0
3653,6,3,12752,12752,12755,0,3,3
3654,3,3,12755,12755,12758,0,3,0
3655,4,1,12759,12759,12760,0,1,1
3656,2,1,12761,12761,12762,0,1,1
3657,5,3,12766,12766,12769,0,3,4
3658,2,1,12768,12769,12770,1,2,0
3659,2,1,12770,12770,12771,0,1,0
3660,3,2,12773,12773,12775,0,2,2
3661,2,1,12775,12775,12776,0,1,0
3662,3,1,12778,12778,12779,0,1,2
3663,4,2,12782,12782,12784,0,2,3
3664,2,3,12784,12784,12787,0,3,0
3665,1,2,12785,12787,12789,2,4,0
3666,5,1,12790,12790,12791,0,1,1
3667,5,2,12795,12795,12797,0,2,4
3668,6,3,12801,12801,12804,0,3,4
3669,2,1,12803,12804,12805,1,2,0
3670,3,3,12806,12806,12809,0,3,1
3671,4,2,12810,12810,12812,0,2,1
3672,4,3,12814,12814,12817,0,3,2
3673,5,3,12819,12819,12822,0,3,2
3674,5,1,12824,12824,12825,0,1,2
3675,5,2,12829,12829,12831,0,2,4
3676,2,2,12831,12831,12833,0,2,0
3677,6,2,12837,12837,12839,0,2,4
3678,1,3,12838,12839,12842,1,4,0
3679,4,3,12842,12842,12845,0,3,0
3680,1,1,12843,12845,12846,2,3,0
3681,3,1,12846,12846,12847,0,1,0
3682,5,1,12851,12851,12852,0,1,4
3683,1,2,12852,12852,12854,0,2,0
3684,5,1,12857,12857,12858,0,1,3
3685,5,2,12862,12862,12864,0,2,4
3686,3,3,12865,12865,12868,0,3,1
3687,3,2,12868,12868,12870,0,2,0
3688,6,1,12874,12874,12875,0,1,4
3689,6,1,12880,12880,12881,0,1,5
3690,2,2,12882,12882,12884,0,2,1
3691,3,1,12885,12885,12886,0,1,1
3692,1,3,12886,12886,12889,0,3,0
3693,4,2,12890,12890,12892,0,2,1
3694,1,3,12891,12892,12895,1,4,0
3695,3,2,12894,12895,12897,1,3,0
3696,6,1,12900,12900,12901,0,1,3
3697,6,2,12906,12906,12908,0,2,5
3698,4,1,12910,12910,12911,0,1,2
3699,4,3,12914,12914,12917,0,3,3
3700,3,1,12917,12917,12918,0,1,0
3701,1,1,12918,12918,12919,0,1,0
3702,1,2,12919,12919,12921,0,2,0
3703,4,3,12923,12923,12926,0,3,2
3704,6,2,12929,12929,12931,0,2,3
3705,2,3,12931,12931,12934,0,3,0
3706,1,3,12932,12934,12937,2,5,0
3707,4,1,12936,12937,12938,1,2,0
3708,3,2,12939,12939,12941,0,2,1
3709,5,1,12944,12944,12945,0,1,3
3710,5,2,12949,12949,12951,0,2,4
3711,1,3,12950,12951,12954,1,4,0
3712,1,1,12951,12954,12955,3,4,0
3713,1,2,12952,12955,12957,3,5,0
3714,5,1,12957,12957,12958,0,1,0
3715,6,2,12963,12963,12965,0,2,5
3716,3,1,12966,12966,12967,0,1,1
3717,2,3,12968,12968,12971,0,3,1
3718,1,2,12969,12971,12973,2,4,0
3719,4,2,12973,12973,12975,0,2,0
3720,1,2,12974,12975,12977,1,3,0
3721,1,3,12975,12977,12980,2,5,0
3722,1,2,12976,12980,12982,4,6,0
3723,6,3,12982,12982,12985,0,3,0
3724,6,1,12988,12988,12989,0,1,3
3725,1,3,12989,12989,12992,0,3,0
3726,1,2,12990,12992,12994,2,4,0
3727,3,2,12993,12994,12996,1,3,0
3728,5,1,12998,12998,12999,0,1,2
3729,2,3,13000,13000,13003,0,3,1
3730,2,1,13002,13003,13004,1,2,0
3731,6,1,13008,13008,13009,0,1,4
3732,2,3,13010,13010,13013,0,3,1
3733,1,3,13011,13013,13016,2,5,0
3734,3,1,13014,13016,13017,2,3,0
3735,1,3,13015,13017,13020,2,5,0
3736,4,1,13019,13020,13021,1,2,0
3737,5,2,13024,13024,13026,0,2,3
3738,3,1,13027,13027,13028,0,1,1
3739,2,1,13029,13029,13030,0,1,1
3740,5,2,13034,13034,13036,0,2,4
3741,5,2,13039,13039,13041,0,2,3
3742,1,2,13040,13041,13043,1,3,0
3743,3,2,13043,13043,13045,0,2,0
3744,3,1,13046,13046,13047,0,1,1
3745,2,2,13048,13048,13050,0,2,1
3746,2,1,13050,13050,13051,0,1,0
3747,5,2,13055,13055,13057,0,2,4
3748,1,3,13056,13057,13060,1,4,0
3749,5,1,13061,13061,13062,0,1,1
3750,3,1,13064,13064,13065,0,1,2
3751,2,2,13066,13066,13068,0,2,1
3752,6,2,13072,13072,13074,0,2,4
3753,2,3,13074,13074,13077,0,3,0
3754,5,3,13079,13079,13082,0,3,2
3755,1,3,13080,13082,13085,2,5,0
3756,6,1,13086,13086,13087,0,1,1
3757,4,3,13090,13090,13093,0,3,3
3758,4,2,13094,13094,13096,0,2,1
3759,3,3,13097,13097,13100,0,3,1
3760,1,1,13098,13100,13101,2,3,0
3761,3,3,13101,13101,13104,0,3,0
3762,4,2,13105,13105,13107,0,2,1
3763,5,3,13110,13110,13113,0,3,3
3764,5,2,13115,13115,13117,0,2,2
3765,4,3,13119,13119,13122,0,3,2
3766,4,2,13123,13123,13125,0,2,1
3767,3,2,13126,13126,13128,0,2,1
3768,6,1,13132,13132,13133,0,1,4
3769,6,3,13138,13138,13141,0,3,5
3770,3,1,13141,13141,13142,0,1,0
3771,3,1,13144,13144,13145,0,1,2
3772,4,2,13148,13148,13150,0,2,3
3773,1,2,13149,13150,13152,1,3,0
3774,3,1,13152,13152,13153,0,1,0
3775,5,1,13157,13157,13158,0,1,4
3776,2,2,13159,13159,13161,0,2,1
3777,4,2,13163,13163,13165,0,2,2
3778,2,2,13165,13165,13167,0,2,0
3779,1,1,13166,13167,13168,1,2,0
3780,6,3,13172,13172,13175,0,3,4
3781,2,3,13174,13175,13178,1,4,0
3782,3,2,13177,13178,13180,1,3,0
3783,3,2,13180,13180,13182,0,2,0
3784,3,2,13183,13183,13185,0,2,1
3785,6,1,13189,13189,13190,0,1,4
3786,6,2,13195,13195,13197,0,2,5
3787,3,1,13198,13198,13199,0,1,1
3788,1,3,13199,13199,13202,0,3,0
3789,3,3,13202,13202,13205,0,3,0
3790,5,2,13207,13207,13209,0,2,2
3791,5,2,13212,13212,13214,0,2,3
3792,3,3,13215,13215,13218,0,3,1
3793,1,3,13216,13218,13221,2,5,0
3794,6,3,13222,13222,13225,0,3,1
3795,6,3,13228,13228,13231,0,3,3
3796,6,1,13234,13234,13235,0,1,3
3797,6,3,13240,13240,13243,0,3,5
3798,1,2,13241,13243,13245,2,4,0
3799,1,1,13242,13245,13246,3,4,0
3800,5,2,13247,13247,13249,0,2,1
3801,2,1,13249,13249,13250,0,1,0
3802,2,1,13251,13251,13252,0,1,1
3803,2,2,13253,13253,13255,0,2,1
3804,6,1,13259,13259,13260,0,1,4
3805,6,2,13265,13265,13267,0,2,5
3806,2,3,13267,13267,13270,0,3,0
3807,1,3,13268,13270,13273,2,5,0
3808,3,3,13271,13273,13276,2,5,0
3809,5,1,13276,13276,13277,0,1,0
3810,5,3,13281,13281,13284,0,3,4
3811,2,2,13283,13284,13286,1,3,0
3812,4,3,13287,13287,13290,0,3,1
3813,5,1,13292,13292,13293,0,1,2
3814,6,2,13298,13298,13300,0,2,5
3815,6,1,13304,13304,13305,0,1,4
3816,1,3,13305,13305,13308,0,3,0
3817,2,2,13307,13308,13310,1,3,0
3818,2,3,13309,13310,13313,1,4,0
3819,4,2,13313,13313,13315,0,2,0
3820,6,2,13319,13319,13321,0,2,4
3821,3,1,13322,13322,13323,0,1,1
3822,1,3,13323,13323,13326,0,3,0
3823,1,1,13324,13326,13327,2,3,0
3824,2,3,13326,13327,13330,1,4,0
3825,3,3,13329,13330,13333,1,4,0
3826,6,2,13335,13335,13337,0,2,2
3827,5,2,13340,13340,13342,0,2,3
3828,1,3,13341,13342,13345,1,4,0
3829,3,2,13344,13345,13347,1,3,0
3830,3,1,13347,13347,13348,0,1,0
3831,6,1,13353,13353,13354,0,1,5
3832,2,3,13355,13355,13358,0,3,1
3833,5,1,13360,13360,13361,0,1,2
3834,4,2,13364,13364,13366,0,2,3
3835,1,1,13365,13366,13367,1,2,0
3836,6,3,13371,13371,13374,0,3,4
3837,6,2,13377,13377,13379,0,2,3
3838,4,1,13381,13381,13382,0,1,2
3839,4,3,13385,13385,13388,0,3,3
3840,1,2,13386,13388,13390,2,4,0
3841,4,1,13390,13390,13391,0,1,0
3842,6,2,13396,13396,13398,0,2,5
3843,1,3,13397,13398,13401,1,4,0
3844,6,3,13403,13403,13406,0,3,2
3845,6,2,13409,13409,13411,0,2,3
3846,1,3,13410,13411,13414,1,4,0
3847,2,2,13412,13414,13416,2,4,0
3848,3,1,13415,13416,13417,1,2,0
3849,6,3,13421,13421,13424,0,3,4
3850,5,2,13426,13426,13428,0,2,2
3851,2,3,13428,13428,13431,0,3,0
3852,6,1,13434,13434,13435,0,1,3
3853,2,2,13436,13436,13438,0,2,1
3854,2,1,13438,13438,13439,0,1,0
3855,2,2,13440,13440,13442,0,2,1
3856,3,2,13443,13443,13445,0,2,1
3857,1,2,13444,13445,13447,1,3,0
3858,5,1,13449,13449,13450,0,1,2
3859,6,3,13455,13455,13458,0,3,5
3860,4,1,13459,13459,13460,0,1,1
3861,2,1,13461,13461,13462,0,1,1
3862,1,1,13462,13462,13463,0,1,0
3863,1,3,13463,13463,13466,0,3,0
3864,6,2,13469,13469,13471,0,2,3
3865,3,1,13472,13472,13473,0,1,1
3866,1,1,13473,13473,13474,0,1,0
3867,4,2,13477,13477,13479,0,2,3
3868,3,3,13480,13480,13483,0,3,1
3869,1,2,13481,13483,13485,2,4,0
3870,6,2,13487,13487,13489,0,2,2
3871,1,1,13488,13489,13490,1,2,0
3872,5,2,13493,13493,13495,0,2,3
3873,2,1,13495,13495,13496,0,1,0
3874,1,1,13496,13496,13497,0,1,0
3875,4,3,13500,13500,13503,0,3,3
3876,4,3,13504,13504,13507,0,3,1
3877,6,2,13510,13510,13512,0,2,3
3878,2,1,13512,13512,13513,0,1,0
3879,5,1,13517,13517,13518,0,1,4
3880,6,1,13523,13523,13524,0,1,5
3881,2,3,13525,13525,13528,0,3,1
3882,4,2,13529,13529,13531,0,2,1
3883,6,2,13535,13535,13537,0,2,4
3884,1,2,13536,13537,13539,1,3,0
3885,5,3,13541,13541,13544,0,3,2
3886,5,2,13546,13546,13548,0,2,2
3887,5,1,13551,13551,13552,0,1,3
3888,4,1,13555,13555,13556,0,1,3
3889,4,2,13559,13559,13561,0,2,3
3890,1,2,13560,13561,13563,1,3,0
3891,4,1,13564,13564,13565,0,1,1
3892,3,1,13567,13567,13568,0,1,2
3893,1,3,13568,13568,13571,0,3,0
3894,3,2,13571,13571,13573,0,2,0
3895,6,3,13577,13577,13580,0,3,4
3896,5,1,13582,13582,13583,0,1,2
3897,2,1,13584,13584,13585,0,1,1
3898,6,3,13590,13590,13593,0,3,5
3899,4,1,13594,13594,13595,0,1,1
3900,3,3,13597,13597,13600,0,3,2
3901,1,1,13598,13600,13601,2,3,0
3902,3,2,13601,13601,13603,0,2,0
3903,5,3,13606,13606,13609,0,3,3
3904,6,2,13612,13612,13614,0,2,3
3905,2,1,13614,13614,13615,0,1,0
3906,4,3,13618,13618,13621,0,3,3
3907,1,2,13619,13621,13623,2,4,0
3908,4,3,13623,13623,13626,0,3,0
3909,2,1,13625,13626,13627,1,2,0
3910,6,3,13631,13631,13634,0,3,4
3911,1,2,13632,13634,13636,2,4,0
3912,1,2,13633,13636,13638,3,5,0
3913,2,1,13635,13638,13639,3,4,0
3914,4,1,13639,13639,13640,0,1,0
3915,6,3,13645,13645,13648,0,3,5
3916,6,3,13651,13651,13654,0,3,3
3917,2,2,13653,13654,13656,1,3,0
3918,6,3,13659,13659,13662,0,3,3
3919,5,1,13664,13664,13665,0,1,2
3920,4,3,13668,13668,13671,0,3,3
3921,4,2,13672,13672,13674,0,2,1
3922,6,2,13678,13678,13680,0,2,4
3923,6,1,13684,13684,13685,0,1,4
3924,1,1,13685,13685,13686,0,1,0
3925,6,3,13691,13691,13694,0,3,5
3926,6,1,13697,13697,13698,0,1,3
3927,4,2,13701,13701,13703,0,2,3
3928,4,1,13705,13705,13706,0,1,2
3929,1,1,13706,13706,13707,0,1,0
3930,3,2,13709,13709,13711,0,2,2
3931,6,2,13715,13715,13717,0,2,4
3932,1,3,13716,13717,13720,1,4,0
3933,2,2,13718,13720,13722,2,4,0
3934,4,1,13722,13722,13723,0,1,0
3935,1,3,13723,13723,13726,0,3,0
3936,1,1,13724,13726,13727,2,3,0
3937,5,1,13729,13729,13730,0,1,2
3938,3,3,13732,13732,13735,0,3,2
3939,1,3,13733,13735,13738,2,5,0
3940,5,1,13738,13738,13739,0,1,0
3941,6,1,13744,13744,13745,0,1,5
3942,6,2,13750,13750,13752,0,2,5
3943,5,3,13755,13755,13758,0,3,3
3944,5,3,13760,13760,13763,0,3,2
3945,6,3,13766,13766,13769,0,3,3
3946,4,3,13770,13770,13773,0,3,1
3947,4,3,13774,13774,13777,0,3,1
3948,2,1,13776,13777,13778,1,2,0
3949,1,1,13777,13778,13779,1,2,0
3950,5,1,13782,13782,13783,0,1,3
3951,2,1,13784,13784,13785,0,1,1
3952,5,3,13789,13789,13792,0,3,4
3953,4,1,13793,13793,13794,0,1,1
3954,2,2,13795,13795,13797,0,2,1
3955,1,1,13796,13797,13798,1,2,0
3956,5,2,13801,13801,13803,0,2,3
3957,4,1,13805,13805,13806,0,1,2
3958,5,3,13810,13810,13813,0,3,4
3959,1,3,13811,13813,13816,2,5,0
3960,3,3,13814,13816,13819,2,5,0
3961,6,1,13820,13820,13821,0,1,1
3962,2,1,13822,13822,13823,0,1,1
3963,2,2,13824,13824,13826,0,2,1
3964,2,2,13826,13826,13828,0,2,0
3965,2,1,13828,13828,13829,0,1,0
3966,2,3,13830,13830,13833,0,3,1
3967,2,3,13832,13833,13836,1,4,0
3968,2,1,13834,13836,13837,2,3,0
3969,2,3,13836,13837,13840,1,4,0
3970,3,1,13839,13840,13841,1,2,0
3971,4,3,13843,13843,13846,0,3,2
3972,1,3,13844,13846,13849,2,5,0
3973,3,3,13847,13849,13852,2,5,0
3974,1,2,13848,13852,13854,4,6,0
3975,1,3,13849,13854,13857,5,8,0
3976,1,2,13850,13857,13859,7,9,0
3977,1,3,13851,13859,13862,8,11,0
3978,5,3,13856,13862,13865,6,9,0
3979,3,3,13859,13865,13868,6,9,0
3980,2,2,13861,13868,13870,7,9,0
3981,5,2,13866,13870,13872,4,6,0
3982,2,1,13868,13872,13873,4,5,0
3983,3,2,13871,13873,13875,2,4,0
3984,3,2,13874,13875,13877,1,3,0
3985,4,3,13878,13878,13881,0,3,1
3986,4,2,13882,13882,13884,0,2,1
3987,5,3,13887,13887,13890,0,3,3
3988,3,2,13890,13890,13892,0,2,0
3989,1,1,13891,13892,13893,1,2,0
3990,1,2,13892,13893,13895,1,3,0
3991,1,1,13893,13895,13896,2,3,0
3992,1,3,13894,13896,13899,2,5,0
3993,5,1,13899,13899,13900,0,1,0
3994,2,1,13901,13901,13902,0,1,1
3995,1,1,13902,13902,13903,0,1,0
3996,2,1,13904,13904,13905,0,1,1
3997,5,1,13909,13909,13910,0,1,4
3998,1,1,13910,13910,13911,0,1,0
3999,5,3,13915,13915,13918,0,3,4
4000,5,3,13920,13920,13923,0,3,2
4001,2,2,13922,13923,13925,1,3,0
4002,1,1,13923,13925,13926,2,3,0
4003,4,2,13927,13927,13929,0,2,1
4004,4,3,13931,13931,13934,0,3,2
4005,1,3,13932,13934,13937,2,5,0
4006,5,1,13937,13937,13938,0,1,0
4007,3,1,13940,13940,13941,0,1,2
4008,1,3,13941,13941,13944,0,3,0
4009,1,3,13942,13944,13947,2,5,0
4010,1,3,13943,13947,13950,4,7,0
4011,1,1,13944,13950,13951,6,7,0
4012,5,3,13949,13951,13954,2,5,0
4013,5,3,13954,13954,13957,0,3,0
4014,5,2,13959,13959,13961,0,2,2
4015,6,2,13965,13965,13967,0,2,4
4016,4,2,13969,13969,13971,0,2,2
4017,5,1,13974,13974,13975,0,1,3
4018,2,1,13976,13976,13977,0,1,1
4019,5,2,13981,13981,13983,0,2,4
4020,6,2,13987,13987,13989,0,2,4
4021,1,1,13988,13989,13990,1,2,0
4022,5,1,13993,13993,13994,0,1,3
4023,3,3,13996,13996,13999,0,3,2
4024,3,2,13999,13999,14001,0,2,0
4025,2,1,14001,14001,14002,0,1,0
4026,6,1,14007,14007,14008,0,1,5
4027,3,1,14010,14010,14011,0,1,2
4028,1,2,14011,14011,14013,0,2,0
4029,1,3,14012,14013,14016,1,4,0
4030,3,2,14015,14016,14018,1,3,0
4031,1,2,14016,14018,14020,2,4,0
4032,2,1,14018,14020,14021,2,3,0
4033,1,1,14019,14021,14022,2,3,0
4034,2,1,14021,14022,14023,1,2,0
4035,2,3,14023,14023,14026,0,3,0
4036,4,1,14027,14027,14028,0,1,1
4037,6,2,14033,14033,14035,0,2,5
4038,4,1,14037,14037,14038,0,1,2
4039,6,2,14043,14043,14045,0,2,5
4040,1,3,14044,14045,14048,1,4,0
4041,1,3,14045,14048,14051,3,6,0
4042,2,1,14047,14051,14052,4,5,0
4043,2,3,14049,14052,14055,3,6,0
4044,4,2,14053,14055,14057,2,4,0
4045,4,1,14057,14057,14058,0,1,0
4046,6,1,14063,14063,14064,0,1,5
4047,3,2,14066,14066,14068,0,2,2
4048,4,1,14070,14070,14071,0,1,2
4049,5,1,14075,14075,14076,0,1,4
4050,4,1,14079,14079,14080,0,1,3
4051,6,2,14085,14085,14087,0,2,5
4052,6,3,14091,14091,14094,0,3,4
4053,1,1,14092,14094,14095,2,3,0
4054,5,2,14097,14097,14099,0,2,2
4055,6,3,14103,14103,14106,0,3,4
4056,4,3,14107,14107,14110,0,3,1
4057,6,2,14113,14113,14115,0,2,3
4058,3,1,14116,14116,14117,0,1,1
4059,6,1,14122,14122,14123,0,1,5
4060,5,2,14127,14127,14129,0,2,4
4061,5,2,14132,14132,14134,0,2,3
4062,4,1,14136,14136,14137,0,1,2
4063,4,3,14140,14140,14143,0,3,3
4064,1,1,14141,14143,14144,2,3,0
4065,5,1,14146,14146,14147,0,1,2
4066,5,3,14151,14151,14154,0,3,4
4067,5,3,14156,14156,14159,0,3,2
4068,1,1,14157,14159,14160,2,3,0
4069,4,2,14161,14161,14163,0,2,1
4070,2,2,14163,14163,14165,0,2,0
4071,5,3,14168,14168,14171,0,3,3
4072,4,3,14172,14172,14175,0,3,1
4073,1,3,14173,14175,14178,2,5,0
4074,6,2,14179,14179,14181,0,2,1
4075,5,1,14184,14184,14185,0,1,3
4076,1,2,14185,14185,14187,0,2,0
4077,6,3,14191,14191,14194,0,3,4
4078,1,3,14192,14194,14197,2,5,0
4079,2,3,14194,14197,14200,3,6,0
4080,5,1,14199,14200,14201,1,2,0
4081,3,3,14202,14202,14205,0,3,1
4082,6,1,14208,14208,14209,0,1,3
4083,2,3,14210,14210,14213,0,3,1
4084,3,3,14213,14213,14216,0,3,0
4085,1,2,14214,14216,14218,2,4,0
4086,2,1,14216,14218,14219,2,3,0
4087,1,2,14217,14219,14221,2,4,0
4088,2,1,14219,14221,14222,2,3,0
4089,1,2,14220,14222,14224,2,4,0
4090,1,2,14221,14224,14226,3,5,0
4091,2,2,14223,14226,14228,3,5,0
4092,5,3,14228,14228,14231,0,3,0
4093,2,2,14230,14231,14233,1,3,0
4094,3,3,14233,14233,14236,0,3,0
4095,5,1,14238,14238,14239,0,1,2
4096,6,1,14244,14244,14245,0,1,5
4097,3,3,14247,14247,14250,0,3,2
4098,1,1,14248,14250,14251,2,3,0
4099,6,1,14254,14254,14255,0,1,3
4100,2,2,14256,14256,14258,0,2,1
4101,6,2,14262,14262,14264,0,2,4
4102,3,3,14265,14265,14268,0,3,1
4103,3,1,14268,14268,14269,0,1,0
4104,6,1,14274,14274,14275,0,1,5
4105,2,2,14276,14276,14278,0,2,1
4106,5,2,14281,14281,14283,0,2,3
4107,1,2,14282,14283,14285,1,3,0
4108,5,1,14287,14287,14288,0,1,2
4109,4,3,14291,14291,14294,0,3,3
4110,4,1,14295,14295,14296,0,1,1
4111,3,3,14298,14298,14301,0,3,2
4112,4,3,14302,14302,14305,0,3,1
4113,3,3,14305,14305,14308,0,3,0
4114,2,2,14307,14308,14310,1,3,0
4115,4,1,14311,14311,14312,0,1,1
4116,1,3,14312,14312,14315,0,3,0
4117,4,1,14316,14316,14317,0,1,1
4118,5,3,14321,14321,14324,0,3,4
4119,1,2,14322,14324,14326,2,4,0
4120,5,1,14327,14327,14328,0,1,1
4121,1,1,14328,14328,14329,0,1,0
4122,5,1,14333,14333,14334,0,1,4
4123,4,3,14337,14337,14340,0,3,3
4124,2,1,14339,14340,14341,1,2,0
4125,5,1,14344,14344,14345,0,1,3
4126,2,1,14346,14346,14347,0,1,1
4127,4,1,14350,14350,14351,0,1,3
4128,5,2,14355,14355,14357,0,2,4
4129,4,3,14359,14359,14362,0,3,2
4130,2,2,14361,14362,14364,1,3,0
4131,6,3,14367,14367,14370,0,3,3
4132,2,3,14369,14370,14373,1,4,0
4133,4,2,14373,14373,14375,0,2,0
4134,6,3,14379,14379,14382,0,3,4
4135,4,1,14383,14383,14384,0,1,1
4136,5,3,14388,14388,14391,0,3,4
4137,2,1,14390,14391,14392,1,2,0
4138,3,1,14393,14393,14394,0,1,1
4139,1,1,14394,14394,14395,0,1,0
4140,2,1,14396,14396,14397,0,1,1
4141,4,2,14400,14400,14402,0,2,3
4142,5,1,14405,14405,14406,0,1,3
4143,2,1,14407,14407,14408,0,1,1
4144,4,3,14411,14411,14414,0,3,3
4145,3,2,14414,14414,14416,0,2,0
4146,4,1,14418,14418,14419,0,1,2
4147,3,2,14421,14421,14423,0,2,2
4148,3,3,14424,14424,14427,0,3,1
4149,1,1,14425,14427,14428,2,3,0
4150,4,1,14429,14429,14430,0,1,1
4151,2,1,14431,14431,14432,0,1,1
4152,2,3,14433,14433,14436,0,3,1
4153,1,2,14434,14436,14438,2,4,0
4154,1,3,14435,14438,14441,3,6,0
4155,3,2,14438,14441,14443,3,5,0
4156,4,3,14442,14443,14446,1,4,0
4157,6,1,14448,14448,14449,0,1,2
4158,6,2,14454,14454,14456,0,2,5
4159,1,1,14455,14456,14457,1,2,0
4160,3,3,14458,14458,14461,0,3,1
4161,1,1,14459,14461,14462,2,3,0
4162,5,3,14464,14464,14467,0,3,2
4163,5,3,14469,14469,14472,0,3,2
4164,6,1,14475,14475,14476,0,1,3
4165,3,1,14478,14478,14479,0,1,2
4166,5,1,14483,14483,14484,0,1,4
4167,5,3,14488,14488,14491,0,3,4
4168,2,2,14490,14491,14493,1,3,0
4169,4,2,14494,14494,14496,0,2,1
4170,3,3,14497,14497,14500,0,3,1
4171,1,3,14498,14500,14503,2,5,0
4172,4,3,14502,14503,14506,1,4,0
4173,3,3,14505,14506,14509,1,4,0
4174,3,2,14508,14509,14511,1,3,0
4175,4,1,14512,14512,14513,0,1,1
4176,2,3,14514,14514,14517,0,3,1
4177,2,2,14516,14517,14519,1,3,0
4178,5,2,14521,14521,14523,0,2,2
4179,1,1,14522,14523,14524,1,2,0
4180,2,3,14524,14524,14527,0,3,0
4181,1,3,14525,14527,14530,2,5,0
4182,1,1,14526,14530,14531,4,5,0
4183,5,2,14531,14531,14533,0,2,0
4184,2,3,14533,14533,14536,0,3,0
4185,2,3,14535,14536,14539,1,4,0
4186,4,3,14539,14539,14542,0,3,0
4187,4,3,14543,14543,14546,0,3,1
4188,5,3,14548,14548,14551,0,3,2
4189,5,3,14553,14553,14556,0,3,2
4190,3,1,14556,14556,14557,0,1,0
4191,6,3,14562,14562,14565,0,3,5
4192,3,2,14565,14565,14567,0,2,0
4193,1,3,14566,14567,14570,1,4,0
4194,1,2,14567,14570,14572,3,5,0
4195,4,2,14571,14572,14574,1,3,0
4196,2,1,14573,14574,14575,1,2,0
4197,1,1,14574,14575,14576,1,2,0
4198,1,3,14575,14576,14579,1,4,0
4199,4,3,14579,14579,14582,0,3,0
4200,3,1,14582,14582,14583,0,1,0
4201,3,1,14585,14585,14586,0,1,2
4202,6,3,14591,14591,14594,0,3,5
4203,1,1,14592,14594,14595,2,3,0
4204,3,2,14595,14595,14597,0,2,0
4205,2,3,14597,14597,14600,0,3,0
4206,6,1,14603,14603,14604,0,1,3
4207,1,3,14604,14604,14607,0,3,0
4208,3,1,14607,14607,14608,0,1,0
4209,1,2,14608,14608,14610,0,2,0
4210,4,3,14612,14612,14615,0,3,2
4211,3,3,14615,14615,14618,0,3,0
4212,2,1,14617,14618,14619,1,2,0
4213,3,1,14620,14620,14621,0,1,1
4214,3,1,14623,14623,14624,0,1,2
4215,2,3,14625,14625,14628,0,3,1
4216,5,2,14630,14630,14632,0,2,2
4217,5,1,14635,14635,14636,0,1,3
4218,2,3,14637,14637,14640,0,3,1
4219,3,2,14640,14640,14642,0,2,0
4220,5,2,14645,14645,14647,0,2,3
4221,5,2,14650,14650,14652,0,2,3
4222,3,3,14653,14653,14656,0,3,1
4223,6,1,14659,14659,14660,0,1,3
4224,1,3,14660,14660,14663,0,3,0
4225,6,3,14666,14666,14669,0,3,3
4226,6,3,14672,14672,14675,0,3,3
4227,2,2,14674,14675,14677,1,3,0
4228,6,1,14680,14680,14681,0,1,3
4229,6,2,14686,14686,14688,0,2,5
4230,1,3,14687,14688,14691,1,4,0
4231,1,3,14688,14691,14694,3,6,0
4232,2,2,14690,14694,14696,4,6,0
4233,3,1,14693,14696,14697,3,4,0
4234,5,1,14698,14698,14699,0,1,1
4235,6,1,14704,14704,14705,0,1,5
4236,3,1,14707,14707,14708,0,1,2
4237,5,2,14712,14712,14714,0,2,4
4238,5,3,14717,14717,14720,0,3,3
4239,2,1,14719,14720,14721,1,2,0
4240,1,2,14720,14721,14723,1,3,0
4241,6,3,14726,14726,14729,0,3,3
4242,5,3,14731,14731,14734,0,3,2
4243,1,3,14732,14734,14737,2,5,0
4244,3,1,14735,14737,14738,2,3,0
4245,5,1,14740,14740,14741,0,1,2
4246,2,2,14742,14742,14744,0,2,1
4247,3,2,14745,14745,14747,0,2,1
4248,3,1,14748,14748,14749,0,1,1
4249,3,2,14751,14751,14753,0,2,2
4250,4,2,14755,14755,14757,0,2,2
4251,4,2,14759,14759,14761,0,2,2
4252,3,3,14762,14762,14765,0,3,1
4253,3,3,14765,14765,14768,0,3,0
4254,5,3,14770,14770,14773,0,3,2
4255,1,2,14771,14773,14775,2,4,0
4256,6,2,14777,14777,14779,0,2,2
4257,4,2,14781,14781,14783,0,2,2
4258,4,2,14785,14785,14787,0,2,2
4259,2,1,14787,14787,14788,0,1,0
4260,5,3,14792,14792,14795,0,3,4
4261,4,3,14796,14796,14799,0,3,1
4262,4,1,14800,14800,14801,0,1,1
4263,2,3,14802,14802,14805,0,3,1
4264,5,1,14807,14807,14808,0,1,2
4265,1,3,14808,14808,14811,0,3,0
4266,6,3,14814,14814,14817,0,3,3
4267,2,3,14816,14817,14820,1,4,0
4268,2,2,14818,14820,14822,2,4,0
4269,2,3,14820,14822,14825,2,5,0
4270,4,3,14824,14825,14828,1,4,0
4271,3,2,14827,14828,14830,1,3,0
4272,2,2,14829,14830,14832,1,3,0
4273,5,3,14834,14834,14837,0,3,2
4274,6,1,14840,14840,14841,0,1,3
4275,5,3,14845,14845,14848,0,3,4
4276,6,1,14851,14851,14852,0,1,3
4277,6,2,14857,14857,14859,0,2,5
4278,2,2,14859,14859,14861,0,2,0
4279,6,2,14865,14865,14867,0,2,4
4280,6,3,14871,14871,14874,0,3,4
4281,5,2,14876,14876,14878,0,2,2
4282,2,1,14878,14878,14879,0,1,0
4283,3,2,14881,14881,14883,0,2,2
4284,1,1,14882,14883,14884,1,2,0
4285,4,1,14886,14886,14887,0,1,2
4286,4,2,14890,14890,14892,0,2,3
4287,3,1,14893,14893,14894,0,1,1
4288,2,3,14895,14895,14898,0,3,1
4289,4,3,14899,14899,14902,0,3,1
4290,5,2,14904,14904,14906,0,2,2
4291,1,3,14905,14906,14909,1,4,0
4292,5,3,14910,14910,14913,0,3,1
4293,4,3,14914,14914,14917,0,3,1
4294,6,3,14920,14920,14923,0,3,3
4295,2,1,14922,14923,14924,1,2,0
4296,2,3,14924,14924,14927,0,3,0
4297,2,1,14926,14927,14928,1,2,0
4298,1,2,14927,14928,14930,1,3,0
4299,4,1,14931,14931,14932,0,1,1
4300,3,2,14934,14934,14936,0,2,2
4301,5,2,14939,14939,14941,0,2,3
4302,4,1,14943,14943,14944,0,1,2
4303,4,1,14947,14947,14948,0,1,3
4304,6,3,14953,14953,14956,0,3,5
4305,3,2,14956,14956,14958,0,2,0
4306,3,1,14959,14959,14960,0,1,1
4307,3,1,14962,14962,14963,0,1,2
4308,3,3,14965,14965,14968,0,3,2
4309,5,3,14970,14970,14973,0,3,2
4310,4,3,14974,14974,14977,0,3,1
4311,5,3,14979,14979,14982,0,3,2
4312,3,2,14982,14982,14984,0,2,0
4313,2,2,14984,14984,14986,0,2,0
4314,2,3,14986,14986,14989,0,3,0
4315,4,1,14990,14990,14991,0,1,1
4316,6,2,14996,14996,14998,0,2,5
4317,3,1,14999,14999,15000,0,1,1
4318,4,3,15003,15003,15006,0,3,3
4319,6,2,15009,15009,15011,0,2,3
4320,4,2,15013,15013,15015,0,2,2
4321,4,3,15017,15017,15020,0,3,2
4322,2,3,15019,15020,15023,1,4,0
4323,6,2,15025,15025,15027,0,2,2
4324,5,3,15030,15030,15033,0,3,3
4325,5,1,15035,15035,15036,0,1,2
4326,3,1,15038,15038,15039,0,1,2
4327,2,2,15040,15040,15042,0,2,1
4328,3,3,15043,15043,15046,0,3,1
4329,1,1,15044,15046,15047,2,3,0
4330,2,1,15046,15047,15048,1,2,0
4331,4,3,15050,15050,15053,0,3,2
4332,5,3,15055,15055,15058,0,3,2
4333,1,3,15056,15058,15061,2,5,0
4334,2,3,15058,15061,15064,3,6,0
4335,6,1,15064,15064,15065,0,1,0
4336,2,1,15066,15066,15067,0,1,1
4337,1,2,15067,15067,15069,0,2,0
4338,2,1,15069,15069,15070,0,1,0
4339,4,3,15073,15073,15076,0,3,3
4340,6,2,15079,15079,15081,0,2,3
4341,1,1,15080,15081,15082,1,2,0
4342,6,2,15086,15086,15088,0,2,4
4343,4,2,15090,15090,15092,0,2,2
4344,3,3,15093,15093,15096,0,3,1
4345,6,2,15099,15099,15101,0,2,3
4346,5,3,15104,15104,15107,0,3,3
4347,6,2,15110,15110,15112,0,2,3
4348,3,1,15113,15113,15114,0,1,1
4349,3,2,15116,15116,15118,0,2,2
4350,3,2,15119,15119,15121,0,2,1
4351,4,2,15123,15123,15125,0,2,2
4352,1,2,15124,15125,15127,1,3,0
4353,4,3,15128,15128,15131,0,3,1
4354,6,2,15134,15134,15136,0,2,3
4355,6,2,15140,15140,15142,0,2,4
4356,3,3,15143,15143,15146,0,3,1
4357,6,2,15149,15149,15151,0,2,3
4358,1,3,15150,15151,15154,1,4,0
4359,5,2,15155,15155,15157,0,2,1
4360,6,1,15161,15161,15162,0,1,4
4361,2,2,15163,15163,15165,0,2,1
4362,2,3,15165,15165,15168,0,3,0
4363,4,2,15169,15169,15171,0,2,1
4364,5,3,15174,15174,15177,0,3,3
4365,6,3,15180,15180,15183,0,3,3
4366,1,1,15181,15183,15184,2,3,0
4367,5,3,15186,15186,15189,0,3,2
4368,5,2,15191,15191,15193,0,2,2
4369,2,3,15193,15193,15196,0,3,0
4370,6,3,15199,15199,15202,0,3,3
4371,4,3,15203,15203,15206,0,3,1
4372,5,3,15208,15208,15211,0,3,2
4373,4,3,15212,15212,15215,0,3,1
4374,1,3,15213,15215,15218,2,5,0
4375,2,1,15215,15218,15219,3,4,0
4376,6,3,15221,15221,15224,0,3,2
4377,4,3,15225,15225,15228,0,3,1
4378,4,2,15229,15229,15231,0,2,1
4379,1,3,15230,15231,15234,1,4,0
4380,2,1,15232,15234,15235,2,3,0
4381,2,1,15234,15235,15236,1,2,0
4382,2,1,15236,15236,15237,0,1,0
4383,4,3,15240,15240,15243,0,3,3
4384,1,3,15241,15243,15246,2,5,0
4385,6,3,15247,15247,15250,0,3,1
4386,2,2,15249,15250,15252,1,3,0
4387,5,2,15254,15254,15256,0,2,2
4388,1,2,15255,15256,15258,1,3,0
4389,5,3,15260,15260,15263,0,3,2
4390,6,1,15266,15266,15267,0,1,3
4391,2,1,15268,15268,15269,0,1,1
4392,2,1,15270,15270,15271,0,1,1
4393,5,3,15275,15275,15278,0,3,4
4394,4,3,15279,15279,15282,0,3,1
4395,4,2,15283,15283,15285,0,2,1
4396,2,3,15285,15285,15288,0,3,0
4397,6,2,15291,15291,15293,0,2,3
4398,6,1,15297,15297,15298,0,1,4
4399,3,2,15300,15300,15302,0,2,2
4400,4,2,15304,15304,15306,0,2,2
4401,2,2,15306,15306,15308,0,2,0
4402,4,3,15310,15310,15313,0,3,2
4403,6,3,15316,15316,15319,0,3,3
4404,2,2,15318,15319,15321,1,3,0
4405,6,2,15324,15324,15326,0,2,3
4406,3,1,15327,15327,15328,0,1,1
4407,2,3,15329,15329,15332,0,3,1
4408,1,1,15330,15332,15333,2,3,0
4409,2,1,15332,15333,15334,1,2,0
4410,2,1,15334,15334,15335,0,1,0
4411,1,1,15335,15335,15336,0,1,0
4412,3,2,15338,15338,15340,0,2,2
4413,5,3,15343,15343,15346,0,3,3
4414,4,2,15347,15347,15349,0,2,1
4415,2,1,15349,15349,15350,0,1,0
4416,2,1,15351,15351,15352,0,1,1
4417,2,3,15353,15353,15356,0,3,1
4418,5,3,15358,15358,15361,0,3,2
4419,5,2,15363,15363,15365,0,2,2
4420,1,1,15364,15365,15366,1,2,0
4421,1,2,15365,15366,15368,1,3,0
4422,5,1,15370,15370,15371,0,1,2
4423,4,2,15374,15374,15376,0,2,3
4424,4,2,15378,15378,15380,0,2,2
4425,5,3,15383,15383,15386,0,3,3
4426,4,1,15387,15387,15388,0,1,1
4427,5,1,15392,15392,15393,0,1,4
4428,5,2,15397,15397,15399,0,2,4
4429,5,1,15402,15402,15403,0,1,3
4430,2,1,15404,15404,15405,0,1,1
4431,5,3,15409,15409,15412,0,3,4
4432,2,1,15411,15412,15413,1,2,0
4433,4,3,15415,15415,15418,0,3,2
4434,3,3,15418,15418,15421,0,3,0
4435,2,3,15420,15421,15424,1,4,0
4436,3,2,15423,15424,15426,1,3,0
4437,4,1,15427,15427,15428,0,1,1
4438,1,3,15428,15428,15431,0,3,0
4439,6,2,15434,15434,15436,0,2,3
4440,2,1,15436,15436,15437,0,1,0
4441,1,3,15437,15437,15440,0,3,0
4442,6,2,15443,15443,15445,0,2,3
4443,6,1,15449,15449,15450,0,1,4
4444,5,1,15454,15454,15455,0,1,4
4445,5,2,15459,15459,15461,0,2,4
4446,5,1,15464,15464,15465,0,1,3
4447,1,2,15465,15465,15467,0,2,0
4448,3,2,15468,15468,15470,0,2,1
4449,4,1,15472,15472,15473,0,1,2
4450,6,3,15478,15478,15481,0,3,5
4451,2,2,15480,15481,15483,1,3,0
4452,5,2,15485,15485,15487,0,2,2
4453,2,2,15487,15487,15489,0,2,0
4454,1,3,15488,15489,15492,1,4,0
4455,1,3,15489,15492,15495,3,6,0
4456,2,3,15491,15495,15498,4,7,0
4457,2,1,15493,15498,15499,5,6,0
4458,3,3,15496,15499,15502,3,6,0
4459,4,1,15500,15502,15503,2,3,0
4460,1,1,15501,15503,15504,2,3,0
4461,1,1,15502,15504,15505,2,3,0
4462,5,3,15507,15507,15510,0,3,2
4463,3,1,15510,15510,15511,0,1,0
4464,1,3,15511,15511,15514,0,3,0
4465,6,3,15517,15517,15520,0,3,3
4466,1,3,15518,15520,15523,2,5,0
4467,1,1,15519,15523,15524,4,5,0
4468,1,3,15520,15524,15527,4,7,0
4469,1,3,15521,15527,15530,6,9,0
4470,5,1,15526,15530,15531,4,5,0
4471,5,3,15531,15531,15534,0,3,0
4472,2,2,15533,15534,15536,1,3,0
4473,1,3,15534,15536,15539,2,5,0
4474,2,2,15536,15539,15541,3,5,0
4475,4,2,15540,15541,15543,1,3,0
4476,5,2,15545,15545,15547,0,2,2
4477,6,2,15551,15551,15553,0,2,4
4478,2,2,15553,15553,15555,0,2,0
4479,3,1,15556,15556,15557,0,1,1
4480,3,2,15559,15559,15561,0,2,2
4481,5,1,15564,15564,15565,0,1,3
4482,6,2,15570,15570,15572,0,2,5
4483,6,3,15576,15576,15579,0,3,4
4484,6,1,15582,15582,15583,0,1,3
4485,1,1,15583,15583,15584,0,1,0
4486,6,2,15589,15589,15591,0,2,5
4487,1,2,15590,15591,15593,1,3,0
4488,1,1,15591,15593,15594,2,3,0
4489,3,2,15594,15594,15596,0,2,0
4490,6,3,15600,15600,15603,0,3,4
4491,4,2,15604,15604,15606,0,2,1
4492,2,3,15606,15606,15609,0,3,0
4493,6,2,15612,15612,15614,0,2,3
4494,5,1,15617,15617,15618,0,1,3
4495,4,3,15621,15621,15624,0,3,3
4496,2,3,15623,15624,15627,1,4,0
4497,5,3,15628,15628,15631,0,3,1
4498,3,3,15631,15631,15634,0,3,0
4499,5,2,15636,15636,15638,0,2,2
4500,3,3,15639,15639,15642,0,3,1
4501,4,2,15643,15643,15645,0,2,1
4502,2,1,15645,15645,15646,0,1,0
4503,4,2,15649,15649,15651,0,2,3
4504,5,2,15654,15654,15656,0,2,3
4505,5,3,15659,15659,15662,0,3,3
4506,6,1,15665,15665,15666,0,1,3
4507,5,3,15670,15670,15673,0,3,4
4508,1,1,15671,15673,15674,2,3,0
4509,1,2,15672,15674,15676,2,4,0
4510,4,3,15676,15676,15679,0,3,0
4511,2,3,15678,15679,15682,1,4,0
4512,3,1,15681,15682,15683,1,2,0
4513,6,2,15687,15687,15689,0,2,4
4514,2,3,15689,15689,15692,0,3,0
4515,2,2,15691,15692,15694,1,3,0
4516,1,2,15692,15694,15696,2,4,0
4517,6,3,15698,15698,15701,0,3,2
4518,2,1,15700,15701,15702,1,2,0
4519,1,3,15701,15702,15705,1,4,0
4520,6,2,15707,15707,15709,0,2,2
4521,5,3,15712,15712,15715,0,3,3
4522,3,1,15715,15715,15716,0,1,0
4523,3,3,15718,15718,15721,0,3,2
4524,6,2,15724,15724,15726,0,2,3
4525,3,3,15727,15727,15730,0,3,1
4526,4,3,15731,15731,15734,0,3,1
4527,4,1,15735,15735,15736,0,1,1
4528,4,2,15739,15739,15741,0,2,3
4529,5,2,15744,15744,15746,0,2,3
4530,2,1,15746,15746,15747,0,1,0
4531,5,3,15751,15751,15754,0,3,4
4532,2,3,15753,15754,15757,1,4,0
4533,5,3,15758,15758,15761,0,3,1
4534,5,1,15763,15763,15764,0,1,2
4535,3,2,15766,15766,15768,0,2,2
4536,2,1,15768,15768,15769,0,1,0
4537,3,1,15771,15771,15772,0,1,2
4538,5,1,15776,15776,15777,0,1,4
4539,5,2,15781,15781,15783,0,2,4
4540,4,1,15785,15785,15786,0,1,2
4541,6,3,15791,15791,15794,0,3,5
4542,4,3,15795,15795,15798,0,3,1
4543,4,2,15799,15799,15801,0,2,1
4544,4,2,15803,15803,15805,0,2,2
4545,6,2,15809,15809,15811,0,2,4
4546,2,3,15811,15811,15814,0,3,0
4547,3,2,15814,15814,15816,0,2,0
4548,6,1,15820,15820,15821,0,1,4
4549,2,2,15822,15822,15824,0,2,1
4550,5,3,15827,15827,15830,0,3,3
4551,6,1,15833,15833,15834,0,1,3
4552,4,1,15837,15837,15838,0,1,3
4553,2,2,15839,15839,15841,0,2,1
4554,3,1,15842,15842,15843,0,1,1
4555,6,3,15848,15848,15851,0,3,5
4556,5,3,15853,15853,15856,0,3,2
4557,2,1,15855,15856,15857,1,2,0
4558,2,2,15857,15857,15859,0,2,0
4559,3,1,15860,15860,15861,0,1,1
4560,6,2,15866,15866,15868,0,2,5
4561,2,2,15868,15868,15870,0,2,0
4562,2,1,15870,15870,15871,0,1,0
4563,3,1,15873,15873,15874,0,1,2
4564,1,2,15874,15874,15876,0,2,0
4565,3,2,15877,15877,15879,0,2,1
4566,3,1,15880,15880,15881,0,1,1
4567,6,1,15886,15886,15887,0,1,5
4568,2,2,15888,15888,15890,0,2,1
4569,3,2,15891,15891,15893,0,2,1
4570,3,2,15894,15894,15896,0,2,1
4571,1,3,15895,15896,15899,1,4,0
4572,2,2,15897,15899,15901,2,4,0
4573,2,2,15899,15901,15903,2,4,0
4574,4,3,15903,15903,15906,0,3,0
4575,2,3,15905,15906,15909,1,4,0
4576,6,3,15911,15911,15914,0,3,2
4577,1,2,15912,15914,15916,2,4,0
4578,2,3,15914,15916,15919,2,5,0
4579,1,3,15915,15919,15922,4,7,0
4580,4,1,15919,15922,15923,3,4,0
4581,5,2,15924,15924,15926,0,2,1
4582,4,3,15928,15928,15931,0,3,2
4583,5,1,15933,15933,15934,0,1,2
4584,6,1,15939,15939,15940,0,1,5
4585,4,2,15943,15943,15945,0,2,3
4586,3,2,15946,15946,15948,0,2,1
4587,3,1,15949,15949,15950,0,1,1
4588,4,1,15953,15953,15954,0,1,3
4589,2,1,15955,15955,15956,0,1,1
4590,6,1,15961,15961,15962,0,1,5
4591,2,2,15963,15963,15965,0,2,1
4592,6,1,15969,15969,15970,0,1,4
4593,1,3,15970,15970,15973,0,3,0
4594,5,3,15975,15975,15978,0,3,2
4595,4,2,15979,15979,15981,0,2,1
4596,2,2,15981,15981,15983,0,2,0
4597,1,3,15982,15983,15986,1,4,0
4598,1,3,15983,15986,15989,3,6,0
4599,3,1,15986,15989,15990,3,4,0
4600,2,3,15988,15990,15993,2,5,0
4601,2,2,15990,15993,15995,3,5,0
4602,2,1,15992,15995,15996,3,4,0
4603,2,1,15994,15996,15997,2,3,0
4604,1,1,15995,15997,15998,2,3,0
4605,3,3,15998,15998,16001,0,3,0
4606,5,2,16003,16003,16005,0,2,2
4607,2,3,16005,16005,16008,0,3,0
4608,1,1,16006,16008,16009,2,3,0
4609,6,2,16012,16012,16014,0,2,3
4610,5,1,16017,16017,16018,0,1,3
4611,2,1,16019,16019,16020,0,1,1
4612,1,1,16020,16020,16021,0,1,0
4613,2,2,16022,16022,16024,0,2,1
4614,2,2,16024,16024,16026,0,2,0
4615,5,2,16029,16029,16031,0,2,3
4616,3,2,16032,16032,16034,0,2,1
4617,1,2,16033,16034,16036,1,3,0
4618,3,1,16036,16036,16037,0,1,0
4619,1,3,16037,16037,16040,0,3,0
4620,4,3,16041,16041,16044,0,3,1
4621,1,1,16042,16044,16045,2,3,0
4622,1,2,16043,16045,16047,2,4,0
4623,2,2,16045,16047,16049,2,4,0
4624,1,2,16046,16049,16051,3,5,0
4625,2,1,16048,16051,16052,3,4,0
4626,2,3,16050,16052,16055,2,5,0
4627,4,1,16054,16055,16056,1,2,0
4628,3,1,16057,16057,16058,0,1,1
4629,5,3,16062,16062,16065,0,3,4
4630,5,3,16067,16067,16070,0,3,2
4631,2,2,16069,16070,16072,1,3,0
4632,4,2,16073,16073,16075,0,2,1
4633,5,3,16078,16078,16081,0,3,3
4634,3,2,16081,16081,16083,0,2,0
4635,5,2,16086,16086,16088,0,2,3
4636,3,3,16089,16089,16092,0,3,1
4637,6,2,16095,16095,16097,0,2,3
4638,3,3,16098,16098,16101,0,3,1
4639,1,2,16099,16101,16103,2,4,0
4640,1,3,16100,16103,16106,3,6,0
4641,1,3,16101,16106,16109,5,8,0
4642,1,2,16102,16109,16111,7,9,0
4643,3,3,16105,16111,16114,6,9,0
4644,5,3,16110,16114,16117,4,7,0
4645,5,1,16115,16117,16118,2,3,0
4646,5,3,16120,16120,16123,0,3,2
4647,5,2,16125,16125,16127,0,2,2
4648,2,2,16127,16127,16129,0,2,0
4649,5,3,16132,16132,16135,0,3,3
4650,5,1,16137,16137,16138,0,1,2
4651,5,3,16142,16142,16145,0,3,4
4652,4,2,16146,16146,16148,0,2,1
4653,2,3,16148,16148,16151,0,3,0
4654,5,1,16153,16153,16154,0,1,2
4655,1,1,16154,16154,16155,0,1,0
4656,6,3,16160,16160,16163,0,3,5
4657,1,1,16161,16163,16164,2,3,0
4658,6,1,16167,16167,16168,0,1,3
4659,4,3,16171,16171,16174,0,3,3
4660,1,2,16172,16174,16176,2,4,0
4661,2,2,16174,16176,16178,2,4,0
4662,5,1,16179,16179,16180,0,1,1
4663,5,2,16184,16184,16186,0,2,4
4664,3,2,16187,16187,16189,0,2,1
4665,3,1,16190,16190,16191,0,1,1
4666,5,2,16195,16195,16197,0,2,4
4667,5,3,16200,16200,16203,0,3,3
4668,4,1,16204,16204,16205,0,1,1
4669,2,2,16206,16206,16208,0,2,1
4670,6,2,16212,16212,16214,0,2,4
4671,4,3,16216,16216,16219,0,3,2
4672,2,1,16218,16219,16220,1,2,0
4673,2,3,16220,16220,16223,0,3,0
4674,3,2,16223,16223,16225,0,2,0
4675,2,2,16225,16225,16227,0,2,0
4676,3,2,16228,16228,16230,0,2,1
4677,5,2,16233,16233,16235,0,2,3
4678,4,1,16237,16237,16238,0,1,2
4679,3,3,16240,16240,16243,0,3,2
4680,3,1,16243,16243,16244,0,1,0
4681,3,2,16246,16246,16248,0,2,2
4682,5,3,16251,16251,16254,0,3,3
4683,3,3,16254,16254,16257,0,3,0
4684,4,1,16258,16258,16259,0,1,1
4685,6,2,16264,16264,16266,0,2,5
4686,4,1,16268,16268,16269,0,1,2
4687,5,2,16273,16273,16275,0,2,4
4688,1,2,16274,16275,16277,1,3,0
4689,1,1,16275,16277,16278,2,3,0
4690,3,1,16278,16278,16279,0,1,0
4691,5,1,16283,16283,16284,0,1,4
4692,5,2,16288,16288,16290,0,2,4
4693,1,1,16289,16290,16291,1,2,0
4694,1,1,16290,16291,16292,1,2,0
4695,6,2,16296,16296,16298,0,2,4
4696,3,1,16299,16299,16300,0,1,1
4697,6,2,16305,16305,16307,0,2,5
4698,5,2,16310,16310,16312,0,2,3
4699,4,2,16314,16314,16316,0,2,2
4700,5,1,16319,16319,16320,0,1,3
4701,6,3,16325,16325,16328,0,3,5
4702,4,1,16329,16329,16330,0,1,1
4703,3,1,16332,16332,16333,0,1,2
4704,4,2,16336,16336,16338,0,2,3
4705,6,2,16342,16342,16344,0,2,4
4706,1,1,16343,16344,16345,1,2,0
4707,3,2,16346,16346,16348,0,2,1
4708,2,3,16348,16348,16351,0,3,0
4709,4,1,16352,16352,16353,0,1,1
4710,3,2,16355,16355,16357,0,2,2
4711,1,2,16356,16357,16359,1,3,0
4712,3,1,16359,16359,16360,0,1,0
4713,1,2,16360,16360,16362,0,2,0
4714,2,1,16362,16362,16363,0,1,0
4715,4,2,16366,16366,16368,0,2,3
4716,2,1,16368,16368,16369,0,1,0
4717,2,3,16370,16370,16373,0,3,1
4718,4,2,16374,16374,16376,0,2,1
4719,3,3,16377,16377,16380,0,3,1
4720,1,3,16378,16380,16383,2,5,0
4721,2,3,16380,16383,16386,3,6,0
4722,2,2,16382,16386,16388,4,6,0
4723,3,2,16385,16388,16390,3,5,0
4724,2,3,16387,16390,16393,3,6,0
4725,3,2,16390,16393,16395,3,5,0
4726,6,3,16396,16396,16399,0,3,1
4727,2,3,16398,16399,16402,1,4,0
4728,3,2,16401,16402,16404,1,3,0
4729,1,3,16402,16404,16407,2,5,0
4730,3,3,16405,16407,16410,2,5,0
4731,4,2,16409,16410,16412,1,3,0
4732,6,1,16415,16415,16416,0,1,3
4733,5,2,16420,16420,16422,0,2,4
4734,6,3,16426,16426,16429,0,3,4
4735,1,1,16427,16429,16430,2,3,0
4736,3,1,16430,16430,16431,0,1,0
4737,2,3,16432,16432,16435,0,3,1
4738,1,1,16433,16435,16436,2,3,0
4739,5,2,16438,16438,16440,0,2,2
4740,4,2,16442,16442,16444,0,2,2
4741,2,2,16444,16444,16446,0,2,0
4742,1,3,16445,16446,16449,1,4,0
4743,6,3,16451,16451,16454,0,3,2
4744,6,1,16457,16457,16458,0,1,3
4745,5,2,16462,16462,16464,0,2,4
4746,3,3,16465,16465,16468,0,3,1
4747,5,2,16470,16470,16472,0,2,2
4748,6,1,16476,16476,16477,0,1,4
4749,3,3,16479,16479,16482,0,3,2
4750,4,3,16483,16483,16486,0,3,1
4751,5,1,16488,16488,16489,0,1,2
4752,6,3,16494,16494,16497,0,3,5
4753,3,2,16497,16497,16499,0,2,0
4754,6,3,16503,16503,16506,0,3,4
4755,4,3,16507,16507,16510,0,3,1
4756,2,2,16509,16510,16512,1,3,0
4757,6,2,16515,16515,16517,0,2,3
4758,5,3,16520,16520,16523,0,3,3
4759,4,1,16524,16524,16525,0,1,1
4760,1,2,16525,16525,16527,0,2,0
4761,4,2,16529,16529,16531,0,2,2
4762,6,1,16535,16535,16536,0,1,4
4763,6,2,16541,16541,16543,0,2,5
4764,2,1,16543,16543,16544,0,1,0
4765,4,3,16547,16547,16550,0,3,3
4766,2,2,16549,16550,16552,1,3,0
4767,4,1,16553,16553,16554,0,1,1
4768,4,1,16557,16557,16558,0,1,3
4769,4,1,16561,16561,16562,0,1,3
4770,3,2,16564,16564,16566,0,2,2
4771,4,2,16568,16568,16570,0,2,2
4772,4,3,16572,16572,16575,0,3,2
4773,6,3,16578,16578,16581,0,3,3
4774,2,1,16580,16581,16582,1,2,0
4775,2,3,16582,16582,16585,0,3,0
4776,6,2,16588,16588,16590,0,2,3
4777,5,1,16593,16593,16594,0,1,3
4778,5,2,16598,16598,16600,0,2,4
4779,5,2,16603,16603,16605,0,2,3
4780,2,1,16605,16605,16606,0,1,0
4781,5,1,16610,16610,16611,0,1,4
4782,3,2,16613,16613,16615,0,2,2
4783,6,2,16619,16619,16621,0,2,4
4784,4,1,16623,16623,16624,0,1,2
4785,2,3,16625,16625,16628,0,3,1
4786,6,3,16631,16631,16634,0,3,3
4787,6,2,16637,16637,16639,0,2,3
4788,5,1,16642,16642,16643,0,1,3
4789,4,1,16646,16646,16647,0,1,3
4790,5,3,16651,16651,16654,0,3,4
4791,6,1,16657,16657,16658,0,1,3
4792,4,1,16661,16661,16662,0,1,3
4793,5,3,16666,16666,16669,0,3,4
4794,1,2,16667,16669,16671,2,4,0
4795,2,3,16669,16671,16674,2,5,0
4796,3,2,16672,16674,16676,2,4,0
4797,6,2,16678,16678,16680,0,2,2
4798,4,3,16682,16682,16685,0,3,2
4799,6,3,16688,16688,16691,0,3,3
4800,4,2,16692,16692,16694,0,2,1
4801,3,2,16695,16695,16697,0,2,1
4802,4,1,16699,16699,16700,0,1,2
4803,3,2,16702,16702,16704,0,2,2
4804,5,2,16707,16707,16709,0,2,3
4805,1,3,16708,16709,16712,1,4,0
4806,4,2,16712,16712,16714,0,2,0
4807,6,1,16718,16718,16719,0,1,4
4808,6,2,16724,16724,16726,0,2,5
4809,1,2,16725,16726,16728,1,3,0
4810,2,1,16727,16728,16729,1,2,0
4811,1,2,16728,16729,16731,1,3,0
4812,1,1,16729,16731,16732,2,3,0
4813,5,3,16734,16734,16737,0,3,2
4814,2,2,16736,16737,16739,1,3,0
4815,5,3,16741,16741,16744,0,3,2
4816,2,3,16743,16744,16747,1,4,0
4817,5,2,16748,16748,16750,0,2,1
4818,4,1,16752,16752,16753,0,1,2
4819,2,1,16754,16754,16755,0,1,1
4820,2,2,16756,16756,16758,0,2,1
4821,3,1,16759,16759,16760,0,1,1
4822,2,1,16761,16761,16762,0,1,1
4823,5,3,16766,16766,16769,0,3,4
4824,4,1,16770,16770,16771,0,1,1
4825,6,3,16776,16776,16779,0,3,5
4826,6,3,16782,16782,16785,0,3,3
4827,1,2,16783,16785,16787,2,4,0
4828,5,1,16788,16788,16789,0,1,1
4829,6,1,16794,16794,16795,0,1,5
4830,3,3,16797,16797,16800,0,3,2
4831,2,1,16799,16800,16801,1,2,0
4832,4,1,16803,16803,16804,0,1,2
4833,5,3,16808,16808,16811,0,3,4
4834,6,2,16814,16814,16816,0,2,3
4835,3,2,16817,16817,16819,0,2,1
4836,3,1,16820,16820,16821,0,1,1
4837,5,2,16825,16825,16827,0,2,4
4838,2,3,16827,16827,16830,0,3,0
4839,4,1,16831,16831,16832,0,1,1
4840,4,2,16835,16835,16837,0,2,3
4841,2,2,16837,16837,16839,0,2,0
4842,5,3,16842,16842,16845,0,3,3
4843,3,3,16845,16845,16848,0,3,0
4844,1,3,16846,16848,16851,2,5,0
4845,4,2,16850,16851,16853,1,3,0
4846,1,2,16851,16853,16855,2,4,0
4847,4,2,16855,16855,16857,0,2,0
4848,5,3,16860,16860,16863,0,3,3
4849,5,3,16865,16865,16868,0,3,2
4850,4,1,16869,16869,16870,0,1,1
4851,6,1,16875,16875,16876,0,1,5
4852,4,3,16879,16879,16882,0,3,3
4853,2,1,16881,16882,16883,1,2,0
4854,6,3,16887,16887,16890,0,3,4
4855,5,3,16892,16892,16895,0,3,2
4856,2,3,16894,16895,16898,1,4,0
4857,3,2,16897,16898,16900,1,3,0
4858,6,3,16903,16903,16906,0,3,3
4859,4,1,16907,16907,16908,0,1,1
4860,2,3,16909,16909,16912,0,3,1
4861,4,3,16913,16913,16916,0,3,1
4862,3,1,16916,16916,16917,0,1,0
4863,1,2,16917,16917,16919,0,2,0
4864,4,2,16921,16921,16923,0,2,2
4865,4,3,16925,16925,16928,0,3,2
4866,5,3,16930,16930,16933,0,3,2
4867,6,3,16936,16936,16939,0,3,3
4868,5,1,16941,16941,16942,0,1,2
4869,1,1,16942,16942,16943,0,1,0
4870,1,2,16943,16943,16945,0,2,0
4871,6,3,16949,16949,16952,0,3,4
4872,4,3,16953,16953,16956,0,3,1
4873,6,3,16959,16959,16962,0,3,3
4874,1,3,16960,16962,16965,2,5,0
4875,4,1,16964,16965,16966,1,2,0
4876,4,3,16968,16968,16971,0,3,2
4877,6,2,16974,16974,16976,0,2,3
4878,5,1,16979,16979,16980,0,1,3
4879,6,2,16985,16985,16987,0,2,5
4880,3,2,16988,16988,16990,0,2,1
4881,3,3,16991,16991,16994,0,3,1
4882,1,1,16992,16994,16995,2,3,0
4883,5,1,16997,16997,16998,0,1,2
4884,1,1,16998,16998,16999,0,1,0
4885,3,1,17001,17001,17002,0,1,2
4886,4,1,17005,17005,17006,0,1,3
4887,3,2,17008,17008,17010,0,2,2
4888,3,1,17011,17011,17012,0,1,1
4889,3,1,17014,17014,17015,0,1,2
4890,2,1,17016,17016,17017,0,1,1
4891,2,3,17018,17018,17021,0,3,1
4892,3,1,17021,17021,17022,0,1,0
4893,6,3,17027,17027,17030,0,3,5
4894,4,2,17031,17031,17033,0,2,1
4895,4,3,17035,17035,17038,0,3,2
4896,3,3,17038,17038,17041,0,3,0
4897,6,2,17044,17044,17046,0,2,3
4898,5,1,17049,17049,17050,0,1,3
4899,3,1,17052,17052,17053,0,1,2
4900,1,1,17053,17053,17054,0,1,0
4901,5,3,17058,17058,17061,0,3,4
4902,2,2,17060,17061,17063,1,3,0
4903,3,3,17063,17063,17066,0,3,0
4904,5,3,17068,17068,17071,0,3,2
4905,3,2,17071,17071,17073,0,2,0
4906,1,1,17072,17073,17074,1,2,0
4907,1,3,17073,17074,17077,1,4,0
4908,6,1,17079,17079,17080,0,1,2
4909,2,3,17081,17081,17084,0,3,1
4910,5,3,17086,17086,17089,0,3,2
4911,6,1,17092,17092,17093,0,1,3
4912,3,1,17095,17095,17096,0,1,2
4913,2,2,17097,17097,17099,0,2,1
4914,3,1,17100,17100,17101,0,1,1
4915,3,3,17103,17103,17106,0,3,2
4916,1,2,17104,17106,17108,2,4,0
4917,3,3,17107,17108,17111,1,4,0
4918,4,2,17111,17111,17113,0,2,0
4919,5,1,17116,17116,17117,0,1,3
4920,5,3,17121,17121,17124,0,3,4
4921,4,3,17125,17125,17128,0,3,1
4922,2,1,17127,17128,17129,1,2,0
4923,1,2,17128,17129,17131,1,3,0
4924,4,1,17132,17132,17133,0,1,1
4925,5,3,17137,17137,17140,0,3,4
4926,6,3,17143,17143,17146,0,3,3
4927,2,1,17145,17146,17147,1,2,0
4928,3,3,17148,17148,17151,0,3,1
4929,3,3,17151,17151,17154,0,3,0
4930,6,1,17157,17157,17158,0,1,3
4931,5,2,17162,17162,17164,0,2,4
4932,6,2,17168,17168,17170,0,2,4
4933,6,2,17174,17174,17176,0,2,4
4934,2,1,17176,17176,17177,0,1,0
4935,1,2,17177,17177,17179,0,2,0
4936,6,1,17183,17183,17184,0,1,4
4937,4,3,17187,17187,17190,0,3,3
4938,6,1,17193,17193,17194,0,1,3
4939,4,2,17197,17197,17199,0,2,3
4940,1,2,17198,17199,17201,1,3,0
4941,5,2,17203,17203,17205,0,2,2
4942,2,3,17205,17205,17208,0,3,0
4943,2,3,17207,17208,17211,1,4,0
4944,5,3,17212,17212,17215,0,3,1
4945,2,3,17214,17215,17218,1,4,0
4946,4,1,17218,17218,17219,0,1,0
4947,2,3,17220,17220,17223,0,3,1
4948,6,1,17226,17226,17227,0,1,3
4949,5,2,17231,17231,17233,0,2,4
4950,1,3,17232,17233,17236,1,4,0
4951,2,1,17234,17236,17237,2,3,0
4952,6,3,17240,17240,17243,0,3,3
4953,3,3,17243,17243,17246,0,3,0
4954,1,3,17244,17246,17249,2,5,0
4955,6,1,17250,17250,17251,0,1,1
4956,2,2,17252,17252,17254,0,2,1
4957,1,2,17253,17254,17256,1,3,0
4958,3,3,17256,17256,17259,0,3,0
4959,6,1,17262,17262,17263,0,1,3
4960,4,2,17266,17266,17268,0,2,3
4961,6,1,17272,17272,17273,0,1,4
4962,5,2,17277,17277,17279,0,2,4
4963,5,1,17282,17282,17283,0,1,3
4964,2,2,17284,17284,17286,0,2,1
4965,2,2,17286,17286,17288,0,2,0
4966,5,2,17291,17291,17293,0,2,3
4967,1,2,17292,17293,17295,1,3,0
4968,1,2,17293,17295,17297,2,4,0
4969,1,2,17294,17297,17299,3,5,0
4970,1,1,17295,17299,17300,4,5,0
4971,2,3,17297,17300,17303,3,6,0
4972,5,1,17302,17303,17304,1,2,0
4973,4,2,17306,17306,17308,0,2,2
4974,3,3,17309,17309,17312,0,3,1
4975,6,3,17315,17315,17318,0,3,3
4976,1,2,17316,17318,17320,2,4,0
4977,5,3,17321,17321,17324,0,3,1
4978,1,1,17322,17324,17325,2,3,0
4979,4,3,17326,17326,17329,0,3,1
4980,4,1,17330,17330,17331,0,1,1
4981,4,3,17334,17334,17337,0,3,3
4982,4,3,17338,17338,17341,0,3,1
4983,1,3,17339,17341,17344,2,5,0
4984,3,3,17342,17344,17347,2,5,0
4985,4,2,17346,17347,17349,1,3,0
4986,2,3,17348,17349,17352,1,4,0
4987,5,2,17353,17353,17355,0,2,1
4988,2,1,17355,17355,17356,0,1,0
4989,3,3,17358,17358,17361,0,3,2
4990,2,3,17360,17361,17364,1,4,0
4991,1,2,17361,17364,17366,3,5,0
4992,3,1,17364,17366,17367,2,3,0
4993,3,2,17367,17367,17369,0,2,0
4994,4,2,17371,17371,17373,0,2,2
4995,5,2,17376,17376,17378,0,2,3
4996,2,1,17378,17378,17379,0,1,0
4997,3,1,17381,17381,17382,0,1,2
4998,1,3,17382,17382,17385,0,3,0
4999,5,3,17387,17387,17390,0,3,2
5000,4,3,17391,17391,17394,0,3,1
5001,1,3,17392,17394,17397,2,5,0
5002,3,1,17395,17397,17398,2,3,0
5003,3,2,17398,17398,17400,0,2,0
5004,3,1,17401,17401,17402,0,1,1
5005,3,1,17404,17404,17405,0,1,2
5006,3,2,17407,17407,17409,0,2,2
5007,2,2,17409,17409,17411,0,2,0
5008,1,1,17410,17411,17412,1,2,0
5009,6,1,17416,17416,17417,0,1,4
5010,6,3,17422,17422,17425,0,3,5
5011,3,2,17425,17425,17427,0,2,0
5012,3,2,17428,17428,17430,0,2,1
5013,3,2,17431,17431,17433,0,2,1
5014,1,1,17432,17433,17434,1,2,0
5015,5,3,17437,17437,17440,0,3,3
5016,6,3,17443,17443,17446,0,3,3
5017,6,1,17449,17449,17450,0,1,3
5018,5,3,17454,17454,17457,0,3,4
5019,1,1,17455,17457,17458,2,3,0
5020,6,2,17461,17461,17463,0,2,3
5021,4,2,17465,17465,17467,0,2,2
5022,4,3,17469,17469,17472,0,3,2
5023,4,1,17473,17473,17474,0,1,1
5024,6,3,17479,17479,17482,0,3,5
5025,1,2,17480,17482,17484,2,4,0
5026,6,1,17486,17486,17487,0,1,2
5027,3,2,17489,17489,17491,0,2,2
5028,2,2,17491,17491,17493,0,2,0
5029,1,2,17492,17493,17495,1,3,0
5030,5,1,17497,17497,17498,0,1,2
5031,2,2,17499,17499,17501,0,2,1
5032,2,1,17501,17501,17502,0,1,0
5033,1,2,17502,17502,17504,0,2,0
5034,5,3,17507,17507,17510,0,3,3
5035,5,1,17512,17512,17513,0,1,2
5036,2,1,17514,17514,17515,0,1,1
5037,1,3,17515,17515,17518,0,3,0
5038,1,2,17516,17518,17520,2,4,0
5039,1,3,17517,17520,17523,3,6,0
5040,4,1,17521,17523,17524,2,3,0
5041,5,2,17526,17526,17528,0,2,2
5042,1,2,17527,17528,17530,1,3,0
5043,3,1,17530,17530,17531,0,1,0
5044,1,1,17531,17531,17532,0,1,0
5045,2,3,17533,17533,17536,0,3,1
5046,5,2,17538,17538,17540,0,2,2
5047,3,1,17541,17541,17542,0,1,1
5048,5,1,17546,17546,17547,0,1,4
5049,3,2,17549,17549,17551,0,2,2
5050,5,1,17554,17554,17555,0,1,3
5051,2,2,17556,17556,17558,0,2,1
5052,3,1,17559,17559,17560,0,1,1
5053,5,1,17564,17564,17565,0,1,4
5054,5,1,17569,17569,17570,0,1,4
5055,2,3,17571,17571,17574,0,3,1
5056,3,3,17574,17574,17577,0,3,0
5057,5,2,17579,17579,17581,0,2,2
5058,5,3,17584,17584,17587,0,3,3
5059,3,3,17587,17587,17590,0,3,0
5060,6,2,17593,17593,17595,0,2,3
5061,5,1,17598,17598,17599,0,1,3
5062,5,2,17603,17603,17605,0,2,4
5063,3,1,17606,17606,17607,0,1,1
5064,6,1,17612,17612,17613,0,1,5
5065,6,1,17618,17618,17619,0,1,5
5066,5,3,17623,17623,17626,0,3,4
5067,6,1,17629,17629,17630,0,1,3
5068,1,1,17630,17630,17631,0,1,0
5069,6,3,17636,17636,17639,0,3,5
5070,6,2,17642,17642,17644,0,2,3
5071,5,3,17647,17647,17650,0,3,3
5072,6,1,17653,17653,17654,0,1,3
5073,5,1,17658,17658,17659,0,1,4
5074,6,1,17664,17664,17665,0,1,5
5075,6,2,17670,17670,17672,0,2,5
5076,2,1,17672,17672,17673,0,1,0
5077,5,1,17677,17677,17678,0,1,4
5078,6,1,17683,17683,17684,0,1,5
5079,6,1,17689,17689,17690,0,1,5
5080,4,1,17693,17693,17694,0,1,3
5081,1,3,17694,17694,17697,0,3,0
5082,6,2,17700,17700,17702,0,2,3
5083,6,1,17706,17706,17707,0,1,4
5084,5,2,17711,17711,17713,0,2,4
5085,2,1,17713,17713,17714,0,1,0
5086,2,1,17715,17715,17716,0,1,1
5087,3,3,17718,17718,17721,0,3,2
5088,4,1,17722,17722,17723,0,1,1
5089,3,1,17725,17725,17726,0,1,2
5090,5,3,17730,17730,17733,0,3,4
5091,3,2,17733,17733,17735,0,2,0
5092,3,3,17736,17736,17739,0,3,1
5093,1,3,17737,17739,17742,2,5,0
5094,1,3,17738,17742,17745,4,7,0
5095,1,1,17739,17745,17746,6,7,0
5096,2,3,17741,17746,17749,5,8,0
5097,3,2,17744,17749,17751,5,7,0
5098,3,3,17747,17751,17754,4,7,0
5099,6,3,17753,17754,17757,1,4,0
5100,3,2,17756,17757,17759,1,3,0
5101,3,1,17759,17759,17760,0,1,0
5102,6,1,17765,17765,17766,0,1,5
5103,5,3,17770,17770,17773,0,3,4
5104,4,3,17774,17774,17777,0,3,1
5105,1,3,17775,17777,17780,2,5,0
5106,6,2,17781,17781,17783,0,2,1
5107,2,1,17783,17783,17784,0,1,0
5108,4,1,17787,17787,17788,0,1,3
5109,4,2,17791,17791,17793,0,2,3
5110,2,2,17793,17793,17795,0,2,0
5111,3,2,17796,17796,17798,0,2,1
5112,2,2,17798,17798,17800,0,2,0
5113,6,2,17804,17804,17806,0,2,4
5114,2,1,17806,17806,17807,0,1,0
5115,3,3,17809,17809,17812,0,3,2
5116,6,2,17815,17815,17817,0,2,3
5117,3,3,17818,17818,17821,0,3,1
5118,6,1,17824,17824,17825,0,1,3
5119,4,1,17828,17828,17829,0,1,3
5120,3,2,17831,17831,17833,0,2,2
5121,3,3,17834,17834,17837,0,3,1
5122,5,1,17839,17839,17840,0,1,2
5123,1,3,17840,17840,17843,0,3,0
5124,4,2,17844,17844,17846,0,2,1
5125,5,1,17849,17849,17850,0,1,3
5126,4,3,17853,17853,17856,0,3,3
5127,2,3,17855,17856,17859,1,4,0
5128,6,1,17861,17861,17862,0,1,2
5129,5,2,17866,17866,17868,0,2,4
5130,6,1,17872,17872,17873,0,1,4
5131,6,3,17878,17878,17881,0,3,5
5132,5,2,17883,17883,17885,0,2,2
5133,6,2,17889,17889,17891,0,2,4
5134,5,2,17894,17894,17896,0,2,3
5135,4,1,17898,17898,17899,0,1,2
5136,2,1,17900,17900,17901,0,1,1
5137,4,1,17904,17904,17905,0,1,3
5138,1,2,17905,17905,17907,0,2,0
5139,4,1,17909,17909,17910,0,1,2
5140,4,2,17913,17913,17915,0,2,3
5141,3,3,17916,17916,17919,0,3,1
5142,3,2,17919,17919,17921,0,2,0
5143,2,1,17921,17921,17922,0,1,0
5144,3,2,17924,17924,17926,0,2,2
5145,3,3,17927,17927,17930,0,3,1
5146,3,2,17930,17930,17932,0,2,0
5147,6,1,17936,17936,17937,0,1,4
5148,6,3,17942,17942,17945,0,3,5
5149,1,2,17943,17945,17947,2,4,0
5150,4,2,17947,17947,17949,0,2,0
5151,6,3,17953,17953,17956,0,3,4
5152,5,1,17958,17958,17959,0,1,2
5153,5,1,17963,17963,17964,0,1,4
5154,3,2,17966,17966,17968,0,2,2
5155,5,3,17971,17971,17974,0,3,3
5156,1,3,17972,17974,17977,2,5,0
5157,3,2,17975,17977,17979,2,4,0
5158,1,1,17976,17979,17980,3,4,0
5159,4,1,17980,17980,17981,0,1,0
5160,5,3,17985,17985,17988,0,3,4
5161,5,1,17990,17990,17991,0,1,2
5162,2,1,17992,17992,17993,0,1,1
5163,2,1,17994,17994,17995,0,1,1
5164,3,1,17997,17997,17998,0,1,2
5165,4,2,18001,18001,18003,0,2,3
5166,1,1,18002,18003,18004,1,2,0
5167,3,2,18005,18005,18007,0,2,1
5168,5,3,18010,18010,18013,0,3,3
5169,1,1,18011,18013,18014,2,3,0
5170,4,1,18015,18015,18016,0,1,1
5171,1,3,18016,18016,18019,0,3,0
5172,3,1,18019,18019,18020,0,1,0
5173,2,2,18021,18021,18023,0,2,1
5174,5,1,18026,18026,18027,0,1,3
5175,2,1,18028,18028,18029,0,1,1
5176,1,2,18029,18029,18031,0,2,0
5177,5,3,18034,18034,18037,0,3,3
5178,6,1,18040,18040,18041,0,1,3
5179,3,1,18043,18043,18044,0,1,2
5180,4,3,18047,18047,18050,0,3,3
5181,5,3,18052,18052,18055,0,3,2
5182,1,3,18053,18055,18058,2,5,0
5183,1,3,18054,18058,18061,4,7,0
5184,5,2,18059,18061,18063,2,4,0
5185,3,2,18062,18063,18065,1,3,0
5186,3,2,18065,18065,18067,0,2,0
5187,2,3,18067,18067,18070,0,3,0
5188,1,2,18068,18070,18072,2,4,0
5189,4,1,18072,18072,18073,0,1,0
5190,6,3,18078,18078,18081,0,3,5
5191,2,1,18080,18081,18082,1,2,0
5192,1,3,18081,18082,18085,1,4,0
5193,3,2,18084,18085,18087,1,3,0
5194,1,1,18085,18087,18088,2,3,0
5195,5,2,18090,18090,18092,0,2,2
5196,5,3,18095,18095,18098,0,3,3
5197,4,1,18099,18099,18100,0,1,1
5198,4,2,18103,18103,18105,0,2,3
5199,6,2,18109,18109,18111,0,2,4
5200,4,2,18113,18113,18115,0,2,2
5201,5,1,18118,18118,18119,0,1,3
5202,1,2,18119,18119,18121,0,2,0
5203,2,1,18121,18121,18122,0,1,0
5204,4,1,18125,18125,18126,0,1,3
5205,5,2,18130,18130,18132,0,2,4
5206,5,1,18135,18135,18136,0,1,3
5207,6,2,18141,18141,18143,0,2,5
5208,1,3,18142,18143,18146,1,4,0
5209,3,1,18145,18146,18147,1,2,0
5210,5,1,18150,18150,18151,0,1,3
5211,6,3,18156,18156,18159,0,3,5
5212,2,3,18158,18159,18162,1,4,0
5213,1,3,18159,18162,18165,3,6,0
5214,6,2,18165,18165,18167,0,2,0
5215,1,2,18166,18167,18169,1,3,0
5216,5,2,18171,18171,18173,0,2,2
5217,4,1,18175,18175,18176,0,1,2
5218,5,2,18180,18180,18182,0,2,4
5219,4,2,18184,18184,18186,0,2,2
5220,4,3,18188,18188,18191,0,3,2
5221,6,3,18194,18194,18197,0,3,3
5222,3,2,18197,18197,18199,0,2,0
5223,6,3,18203,18203,18206,0,3,4
5224,5,1,18208,18208,18209,0,1,2
5225,3,1,18211,18211,18212,0,1,2
5226,6,1,18217,18217,18218,0,1,5
5227,6,3,18223,18223,18226,0,3,5
5228,4,1,18227,18227,18228,0,1,1
5229,3,1,18230,18230,18231,0,1,2
5230,6,2,18236,18236,18238,0,2,5
5231,5,1,18241,18241,18242,0,1,3
5232,6,3,18247,18247,18250,0,3,5
5233,1,3,18248,18250,18253,2,5,0
5234,6,2,18254,18254,18256,0,2,1
5235,3,1,18257,18257,18258,0,1,1
5236,4,3,18261,18261,18264,0,3,3
5237,5,3,18266,18266,18269,0,3,2
5238,4,2,18270,18270,18272,0,2,1
5239,5,3,18275,18275,18278,0,3,3
5240,3,1,18278,18278,18279,0,1,0
5241,4,3,18282,18282,18285,0,3,3
5242,6,3,18288,18288,18291,0,3,3
5243,2,1,18290,18291,18292,1,2,0
5244,4,1,18294,18294,18295,0,1,2
5245,5,3,18299,18299,18302,0,3,4
5246,6,3,18305,18305,18308,0,3,3
5247,4,2,18309,18309,18311,0,2,1
5248,1,2,18310,18311,18313,1,3,0
5249,1,1,18311,18313,18314,2,3,0
5250,4,2,18315,18315,18317,0,2,1
5251,5,3,18320,18320,18323,0,3,3
5252,5,1,18325,18325,18326,0,1,2
5253,1,1,18326,18326,18327,0,1,0
5254,2,3,18328,18328,18331,0,3,1
5255,2,3,18330,18331,18334,1,4,0
5256,3,1,18333,18334,18335,1,2,0
5257,3,3,18336,18336,18339,0,3,1
5258,4,3,18340,18340,18343,0,3,1
5259,5,3,18345,18345,18348,0,3,2
5260,5,1,18350,18350,18351,0,1,2
5261,1,1,18351,18351,18352,0,1,0
5262,1,1,18352,18352,18353,0,1,0
5263,3,1,18355,18355,18356,0,1,2
5264,1,1,18356,18356,18357,0,1,0
5265,2,3,18358,18358,18361,0,3,1
5266,4,3,18362,18362,18365,0,3,1
5267,2,3,18364,18365,18368,1,4,0
5268,1,2,18365,18368,18370,3,5,0
5269,1,1,18366,18370,18371,4,5,0
5270,5,2,18371,18371,18373,0,2,0
5271,1,1,18372,18373,18374,1,2,0
5272,5,3,18377,18377,18380,0,3,3
5273,5,2,18382,18382,18384,0,2,2
5274,1,1,18383,18384,18385,1,2,0
5275,1,1,18384,18385,18386,1,2,0
5276,6,3,18390,18390,18393,0,3,4
5277,6,1,18396,18396,18397,0,1,3
5278,2,3,18398,18398,18401,0,3,1
5279,1,3,18399,18401,18404,2,5,0
5280,2,3,18401,18404,18407,3,6,0
5281,4,2,18405,18407,18409,2,4,0
5282,2,3,18407,18409,18412,2,5,0
5283,3,2,18410,18412,18414,2,4,0
5284,3,1,18413,18414,18415,1,2,0
5285,3,3,18416,18416,18419,0,3,1
5286,1,3,18417,18419,18422,2,5,0
5287,1,3,18418,18422,18425,4,7,0
5288,4,1,18422,18425,18426,3,4,0
5289,2,1,18424,18426,18427,2,3,0
5290,6,1,18430,18430,18431,0,1,3
5291,2,3,18432,18432,18435,0,3,1
5292,1,2,18433,18435,18437,2,4,0
5293,4,1,18437,18437,18438,0,1,0
5294,3,3,18440,18440,18443,0,3,2
5295,3,1,18443,18443,18444,0,1,0
5296,1,1,18444,18444,18445,0,1,0
5297,4,1,18448,18448,18449,0,1,3
5298,2,2,18450,18450,18452,0,2,1
5299,4,2,18454,18454,18456,0,2,2
5300,1,1,18455,18456,18457,1,2,0
5301,4,3,18459,18459,18462,0,3,2
5302,3,2,18462,18462,18464,0,2,0
5303,1,1,18463,18464,18465,1,2,0
5304,6,1,18469,18469,18470,0,1,4
5305,4,2,18473,18473,18475,0,2,3
5306,1,3,18474,18475,18478,1,4,0
5307,3,1,18477,18478,18479,1,2,0
5308,4,3,18481,18481,18484,0,3,2
5309,3,2,18484,18484,18486,0,2,0
5310,5,2,18489,18489,18491,0,2,3
5311,6,1,18495,18495,18496,0,1,4
5312,3,1,18498,18498,18499,0,1,2
5313,1,1,18499,18499,18500,0,1,0
5314,4,1,18503,18503,18504,0,1,3
5315,6,3,18509,18509,18512,0,3,5
5316,3,2,18512,18512,18514,0,2,0
5317,2,3,18514,18514,18517,0,3,0
5318,5,3,18519,18519,18522,0,3,2
5319,3,3,18522,18522,18525,0,3,0
5320,2,3,18524,18525,18528,1,4,0
5321,4,2,18528,18528,18530,0,2,0
5322,2,1,18530,18530,18531,0,1,0
5323,4,1,18534,18534,18535,0,1,3
5324,1,2,18535,18535,18537,0,2,0
5325,6,2,18541,18541,18543,0,2,4
5326,4,1,18545,18545,18546,0,1,2
5327,1,3,18546,18546,18549,0,3,0
5328,4,2,18550,18550,18552,0,2,1
5329,2,2,18552,18552,18554,0,2,0
5330,2,3,18554,18554,18557,0,3,0
5331,1,3,18555,18557,18560,2,5,0
5332,6,2,18561,18561,18563,0,2,1
5333,3,2,18564,18564,18566,0,2,1
5334,1,1,18565,18566,18567,1,2,0
5335,4,3,18569,18569,18572,0,3,2
5336,1,2,18570,18572,18574,2,4,0
5337,6,1,18576,18576,18577,0,1,2
5338,6,2,18582,18582,18584,0,2,5
5339,5,3,18587,18587,18590,0,3,3
5340,3,2,18590,18590,18592,0,2,0
5341,6,1,18596,18596,18597,0,1,4
5342,1,3,18597,18597,18600,0,3,0
5343,2,2,18599,18600,18602,1,3,0
5344,2,2,18601,18602,18604,1,3,0
5345,3,3,18604,18604,18607,0,3,0
5346,6,3,18610,18610,18613,0,3,3
5347,2,2,18612,18613,18615,1,3,0
5348,3,3,18615,18615,18618,0,3,0
5349,4,1,18619,18619,18620,0,1,1
5350,6,1,18625,18625,18626,0,1,5
5351,2,1,18627,18627,18628,0,1,1
5352,6,3,18633,18633,18636,0,3,5
5353,1,1,18634,18636,18637,2,3,0
5354,1,2,18635,18637,18639,2,4,0
5355,2,3,18637,18639,18642,2,5,0
5356,6,1,18643,18643,18644,0,1,1
5357,2,3,18645,18645,18648,0,3,1
5358,3,1,18648,18648,18649,0,1,0
5359,1,2,18649,18649,18651,0,2,0
5360,4,1,18653,18653,18654,0,1,2
5361,1,2,18654,18654,18656,0,2,0
5362,2,3,18656,18656,18659,0,3,0
5363,4,3,18660,18660,18663,0,3,1
5364,1,2,18661,18663,18665,2,4,0
5365,2,3,18663,18665,18668,2,5,0
5366,5,2,18668,18668,18670,0,2,0
5367,4,2,18672,18672,18674,0,2,2
5368,5,3,18677,18677,18680,0,3,3
5369,5,1,18682,18682,18683,0,1,2
5370,2,2,18684,18684,18686,0,2,1
5371,2,3,18686,18686,18689,0,3,0
5372,2,2,18688,18689,18691,1,3,0
5373,2,3,18690,18691,18694,1,4,0
5374,2,3,18692,18694,18697,2,5,0
5375,1,1,18693,18697,18698,4,5,0
5376,2,1,18695,18698,18699,3,4,0
5377,4,3,18699,18699,18702,0,3,0
5378,5,3,18704,18704,18707,0,3,2
5379,6,1,18710,18710,18711,0,1,3
5380,3,1,18713,18713,18714,0,1,2
5381,6,2,18719,18719,18721,0,2,5
5382,1,2,18720,18721,18723,1,3,0
5383,4,3,18724,18724,18727,0,3,1
5384,4,3,18728,18728,18731,0,3,1
5385,2,3,18730,18731,18734,1,4,0
5386,5,3,18735,18735,18738,0,3,1
5387,2,2,18737,18738,18740,1,3,0
5388,1,1,18738,18740,18741,2,3,0
5389,6,3,18744,18744,18747,0,3,3
5390,1,2,18745,18747,18749,2,4,0
5391,3,2,18748,18749,18751,1,3,0
5392,5,3,18753,18753,18756,0,3,2
5393,4,2,18757,18757,18759,0,2,1
5394,1,1,18758,18759,18760,1,2,0
5395,6,3,18764,18764,18767,0,3,4
5396,6,2,18770,18770,18772,0,2,3
5397,5,3,18775,18775,18778,0,3,3
5398,3,3,18778,18778,18781,0,3,0
5399,1,1,18779,18781,18782,2,3,0
5400,2,2,18781,18782,18784,1,3,0
5401,1,3,18782,18784,18787,2,5,0
5402,4,2,18786,18787,18789,1,3,0
5403,6,2,18792,18792,18794,0,2,3
5404,1,1,18793,18794,18795,1,2,0
5405,3,2,18796,18796,18798,0,2,1
5406,1,2,18797,18798,18800,1,3,0
5407,3,1,18800,18800,18801,0,1,0
5408,6,1,18806,18806,18807,0,1,5
5409,5,2,18811,18811,18813,0,2,4
5410,2,2,18813,18813,18815,0,2,0
5411,4,1,18817,18817,18818,0,1,2
5412,2,3,18819,18819,18822,0,3,1
5413,5,2,18824,18824,18826,0,2,2
5414,1,1,18825,18826,18827,1,2,0
5415,3,2,18828,18828,18830,0,2,1
5416,6,3,18834,18834,18837,0,3,4
5417,5,3,18839,18839,18842,0,3,2
5418,4,1,18843,18843,18844,0,1,1
5419,3,3,18846,18846,18849,0,3,2
5420,2,2,18848,18849,18851,1,3,0
5421,2,3,18850,18851,18854,1,4,0
5422,4,1,18854,18854,18855,0,1,0
5423,3,1,18857,18857,18858,0,1,2
5424,1,3,18858,18858,18861,0,3,0
5425,2,2,18860,18861,18863,1,3,0
5426,6,1,18866,18866,18867,0,1,3
5427,5,2,18871,18871,18873,0,2,4
5428,1,2,18872,18873,18875,1,3,0
5429,4,2,18876,18876,18878,0,2,1
5430,6,2,18882,18882,18884,0,2,4
5431,3,3,18885,18885,18888,0,3,1
5432,1,1,18886,18888,18889,2,3,0
5433,3,3,18889,18889,18892,0,3,0
5434,6,3,18895,18895,18898,0,3,3
5435,6,2,18901,18901,18903,0,2,3
5436,6,1,18907,18907,18908,0,1,4
5437,6,2,18913,18913,18915,0,2,5
5438,1,2,18914,18915,18917,1,3,0
5439,2,3,18916,18917,18920,1,4,0
5440,4,1,18920,18920,18921,0,1,0
5441,6,3,18926,18926,18929,0,3,5
5442,4,2,18930,18930,18932,0,2,1
5443,3,3,18933,18933,18936,0,3,1
5444,1,1,18934,18936,18937,2,3,0
5445,2,1,18936,18937,18938,1,2,0
5446,4,2,18940,18940,18942,0,2,2
5447,1,2,18941,18942,18944,1,3,0
5448,1,3,18942,18944,18947,2,5,0
5449,3,2,18945,18947,18949,2,4,0
5450,2,1,18947,18949,18950,2,3,0
5451,5,2,18952,18952,18954,0,2,2
5452,5,2,18957,18957,18959,0,2,3
5453,6,3,18963,18963,18966,0,3,4
5454,1,2,18964,18966,18968,2,4,0
5455,4,3,18968,18968,18971,0,3,0
5456,2,1,18970,18971,18972,1,2,0
5457,3,1,18973,18973,18974,0,1,1
5458,4,2,18977,18977,18979,0,2,3
5459,3,1,18980,18980,18981,0,1,1
5460,2,2,18982,18982,18984,0,2,1
5461,1,2,18983,18984,18986,1,3,0
5462,6,3,18989,18989,18992,0,3,3
5463,1,3,18990,18992,18995,2,5,0
5464,1,3,18991,18995,18998,4,7,0
5465,2,3,18993,18998,19001,5,8,0
5466,5,1,18998,19001,19002,3,4,0
5467,6,1,19004,19004,19005,0,1,2
5468,3,3,19007,19007,19010,0,3,2
5469,1,2,19008,19010,19012,2,4,0
5470,1,3,19009,19012,19015,3,6,0
5471,5,3,19014,19015,19018,1,4,0
5472,5,2,19019,19019,19021,0,2,1
5473,4,3,19023,19023,19026,0,3,2
5474,3,2,19026,19026,19028,0,2,0
5475,3,1,19029,19029,19030,0,1,1
5476,1,3,19030,19030,19033,0,3,0
5477,5,2,19035,19035,19037,0,2,2
5478,6,2,19041,19041,19043,0,2,4
5479,6,1,19047,19047,19048,0,1,4
5480,6,3,19053,19053,19056,0,3,5
5481,2,1,19055,19056,19057,1,2,0
5482,2,1,19057,19057,19058,0,1,0
5483,6,2,19063,19063,19065,0,2,5
5484,1,1,19064,19065,19066,1,2,0
5485,5,3,19069,19069,19072,0,3,3
5486,1,2,19070,19072,19074,2,4,0
5487,1,1,19071,19074,19075,3,4,0
5488,1,3,19072,19075,19078,3,6,0
5489,3,1,19075,19078,19079,3,4,0
5490,3,1,19078,19079,19080,1,2,0
5491,6,1,19084,19084,19085,0,1,4
5492,3,3,19087,19087,19090,0,3,2
5493,5,2,19092,19092,19094,0,2,2
5494,6,1,19098,19098,19099,0,1,4
5495,3,1,19101,19101,19102,0,1,2
5496,3,3,19104,19104,19107,0,3,2
5497,4,2,19108,19108,19110,0,2,1
5498,3,3,19111,19111,19114,0,3,1
5499,4,2,19115,19115,19117,0,2,1
5500,1,1,19116,19117,19118,1,2,0
5501,1,2,19117,19118,19120,1,3,0
5502,6,1,19123,19123,19124,0,1,3
5503,1,3,19124,19124,19127,0,3,0
5504,6,3,19130,19130,19133,0,3,3
5505,2,3,19132,19133,19136,1,4,0
5506,2,3,19134,19136,19139,2,5,0
5507,5,3,19139,19139,19142,0,3,0
5508,6,2,19145,19145,19147,0,2,3
5509,3,1,19148,19148,19149,0,1,1
5510,3,2,19151,19151,19153,0,2,2
5511,6,1,19157,19157,19158,0,1,4
5512,2,1,19159,19159,19160,0,1,1
5513,5,3,19164,19164,19167,0,3,4
5514,4,1,19168,19168,19169,0,1,1
5515,2,2,19170,19170,19172,0,2,1
5516,2,1,19172,19172,19173,0,1,0
5517,2,2,19174,19174,19176,0,2,1
5518,2,1,19176,19176,19177,0,1,0
5519,6,1,19182,19182,19183,0,1,5
5520,1,1,19183,19183,19184,0,1,0
5521,3,3,19186,19186,19189,0,3,2
5522,1,3,19187,19189,19192,2,5,0
5523,4,1,19191,19192,19193,1,2,0
5524,6,3,19197,19197,19200,0,3,4
5525,1,3,19198,19200,19203,2,5,0
5526,4,3,19202,19203,19206,1,4,0
5527,4,3,19206,19206,19209,0,3,0
5528,5,3,19211,19211,19214,0,3,2
5529,4,1,19215,19215,19216,0,1,1
5530,4,1,19219,19219,19220,0,1,3
5531,1,1,19220,19220,19221,0,1,0
5532,1,3,19221,19221,19224,0,3,0
5533,6,2,19227,19227,19229,0,2,3
5534,5,2,19232,19232,19234,0,2,3
5535,6,1,19238,19238,19239,0,1,4
5536,2,2,19240,19240,19242,0,2,1
5537,5,3,19245,19245,19248,0,3,3
5538,5,3,19250,19250,19253,0,3,2
5539,1,1,19251,19253,19254,2,3,0
5540,1,3,19252,19254,19257,2,5,0
5541,4,3,19256,19257,19260,1,4,0
5542,6,1,19262,19262,19263,0,1,2
5543,3,3,19265,19265,19268,0,3,2
5544,5,3,19270,19270,19273,0,3,2
5545,1,3,19271,19273,19276,2,5,0
5546,5,2,19276,19276,19278,0,2,0
5547,3,1,19279,19279,19280,0,1,1
5548,5,1,19284,19284,19285,0,1,4
5549,3,3,19287,19287,19290,0,3,2
5550,6,1,19293,19293,19294,0,1,3
5551,2,2,19295,19295,19297,0,2,1
5552,4,3,19299,19299,19302,0,3,2
5553,4,2,19303,19303,19305,0,2,1
5554,6,1,19309,19309,19310,0,1,4
5555,4,1,19313,19313,19314,0,1,3
5556,3,3,19316,19316,19319,0,3,2
5557,2,1,19318,19319,19320,1,2,0
5558,2,3,19320,19320,19323,0,3,0
5559,3,2,19323,19323,19325,0,2,0
5560,6,1,19329,19329,19330,0,1,4
5561,2,2,19331,19331,19333,0,2,1
5562,5,3,19336,19336,19339,0,3,3
5563,1,1,19337,19339,19340,2,3,0
5564,1,1,19338,19340,19341,2,3,0
5565,3,3,19341,19341,19344,0,3,0
5566,3,2,19344,19344,19346,0,2,0
5567,6,3,19350,19350,19353,0,3,4
5568,6,2,19356,19356,19358,0,2,3
5569,2,2,19358,19358,19360,0,2,0
5570,1,2,19359,19360,19362,1,3,0
5571,4,1,19363,19363,19364,0,1,1
5572,6,3,19369,19369,19372,0,3,5
5573,6,1,19375,19375,19376,0,1,3
5574,2,2,19377,19377,19379,0,2,1
5575,3,3,19380,19380,19383,0,3,1
5576,3,3,19383,19383,19386,0,3,0
5577,6,1,19389,19389,19390,0,1,3
5578,6,3,19395,19395,19398,0,3,5
5579,6,3,19401,19401,19404,0,3,3
5580,6,1,19407,19407,19408,0,1,3
5581,1,1,19408,19408,19409,0,1,0
5582,1,1,19409,19409,19410,0,1,0
5583,1,1,19410,19410,19411,0,1,0
5584,4,2,19414,19414,19416,0,2,3
5585,3,1,19417,19417,19418,0,1,1
5586,5,3,19422,19422,19425,0,3,4
5587,3,1,19425,19425,19426,0,1,0
5588,5,1,19430,19430,19431,0,1,4
5589,4,1,19434,19434,19435,0,1,3
5590,3,1,19437,19437,19438,0,1,2
5591,6,2,19443,19443,19445,0,2,5
5592,6,1,19449,19449,19450,0,1,4
5593,6,2,19455,19455,19457,0,2,5
5594,4,1,19459,19459,19460,0,1,2
5595,6,2,19465,19465,19467,0,2,5
5596,4,3,19469,19469,19472,0,3,2
5597,3,3,19472,19472,19475,0,3,0
5598,2,2,19474,19475,19477,1,3,0
5599,5,1,19479,19479,19480,0,1,2
5600,3,1,19482,19482,19483,0,1,2
5601,4,2,19486,19486,19488,0,2,3
5602,3,1,19489,19489,19490,0,1,1
5603,4,3,19493,19493,19496,0,3,3
5604,5,3,19498,19498,19501,0,3,2
5605,5,3,19503,19503,19506,0,3,2
5606,3,1,19506,19506,19507,0,1,0
5607,2,1,19508,19508,19509,0,1,1
5608,2,3,19510,19510,19513,0,3,1
5609,3,1,19513,19513,19514,0,1,0
5610,3,1,19516,19516,19517,0,1,2
5611,3,3,19519,19519,19522,0,3,2
5612,6,3,19525,19525,19528,0,3,3
5613,3,3,19528,19528,19531,0,3,0
5614,2,1,19530,19531,19532,1,2,0
5615,2,3,19532,19532,19535,0,3,0
5616,1,2,19533,19535,19537,2,4,0
5617,1,2,19534,19537,19539,3,5,0
5618,2,1,19536,19539,19540,3,4,0
5619,3,3,19539,19540,19543,1,4,0
5620,4,1,19543,19543,19544,0,1,0
5621,3,2,19546,19546,19548,0,2,2
5622,4,2,19550,19550,19552,0,2,2
5623,3,2,19553,19553,19555,0,2,1
5624,6,1,19559,19559,19560,0,1,4
5625,6,1,19565,19565,19566,0,1,5
5626,6,2,19571,19571,19573,0,2,5
5627,4,1,19575,19575,19576,0,1,2
5628,3,3,19578,19578,19581,0,3,2
5629,2,2,19580,19581,19583,1,3,0
5630,3,1,19583,19583,19584,0,1,0
5631,6,3,19589,19589,19592,0,3,5
5632,1,2,19590,19592,19594,2,4,0
5633,1,3,19591,19594,19597,3,6,0
5634,1,2,19592,19597,19599,5,7,0
5635,2,1,19594,19599,19600,5,6,0
5636,1,2,19595,19600,19602,5,7,0
5637,3,2,19598,19602,19604,4,6,0
5638,4,1,19602,19604,19605,2,3,0
5639,2,2,19604,19605,19607,1,3,0
5640,2,3,19606,19607,19610,1,4,0
5641,6,2,19612,19612,19614,0,2,2
5642,1,3,19613,19614,19617,1,4,0
5643,1,1,19614,19617,19618,3,4,0
5644,1,2,19615,19618,19620,3,5,0
5645,1,2,19616,19620,19622,4,6,0
5646,1,3,19617,19622,19625,5,8,0
5647,1,3,19618,19625,19628,7,10,0
5648,5,2,19623,19628,19630,5,7,0
5649,4,2,19627,19630,19632,3,5,0
5650,4,1,19631,19632,19633,1,2,0
5651,5,3,19636,19636,19639,0,3,3
5652,6,2,19642,19642,19644,0,2,3
5653,2,3,19644,19644,19647,0,3,0
5654,5,3,19649,19649,19652,0,3,2
5655,1,3,19650,19652,19655,2,5,0
5656,4,1,19654,19655,19656,1,2,0
5657,3,3,19657,19657,19660,0,3,1
5658,5,1,19662,19662,19663,0,1,2
5659,2,1,19664,19664,19665,0,1,1
5660,4,3,19668,19668,19671,0,3,3
5661,2,1,19670,19671,19672,1,2,0
5662,6,1,19676,19676,19677,0,1,4
5663,5,1,19681,19681,19682,0,1,4
5664,2,1,19683,19683,19684,0,1,1
5665,6,2,19689,19689,19691,0,2,5
5666,3,3,19692,19692,19695,0,3,1
5667,4,1,19696,19696,19697,0,1,1
5668,6,2,19702,19702,19704,0,2,5
5669,2,2,19704,19704,19706,0,2,0
5670,6,3,19710,19710,19713,0,3,4
5671,4,1,19714,19714,19715,0,1,1
5672,4,2,19718,19718,19720,0,2,3
5673,2,3,19720,19720,19723,0,3,0
5674,4,1,19724,19724,19725,0,1,1
5675,3,2,19727,19727,19729,0,2,2
5676,6,3,19733,19733,19736,0,3,4
5677,1,1,19734,19736,19737,2,3,0
5678,5,1,19739,19739,19740,0,1,2
5679,2,1,19741,19741,19742,0,1,1
5680,4,3,19745,19745,19748,0,3,3
5681,5,2,19750,19750,19752,0,2,2
5682,6,2,19756,19756,19758,0,2,4
5683,5,1,19761,19761,19762,0,1,3
5684,1,2,19762,19762,19764,0,2,0
5685,6,3,19768,19768,19771,0,3,4
5686,2,3,19770,19771,19774,1,4,0
5687,4,2,19774,19774,19776,0,2,0
5688,5,2,19779,19779,19781,0,2,3
5689,4,2,19783,19783,19785,0,2,2
5690,6,2,19789,19789,19791,0,2,4
5691,5,3,19794,19794,19797,0,3,3
5692,5,2,19799,19799,19801,0,2,2
5693,4,2,19803,19803,19805,0,2,2
5694,1,1,19804,19805,19806,1,2,0
5695,1,2,19805,19806,19808,1,3,0
5696,6,1,19811,19811,19812,0,1,3
5697,6,2,19817,19817,19819,0,2,5
5698,6,2,19823,19823,19825,0,2,4
5699,5,1,19828,19828,19829,0,1,3
5700,4,3,19832,19832,19835,0,3,3
5701,4,3,19836,19836,19839,0,3,1
5702,3,2,19839,19839,19841,0,2,0
5703,5,2,19844,19844,19846,0,2,3
5704,3,2,19847,19847,19849,0,2,1
5705,3,1,19850,19850,19851,0,1,1
5706,6,3,19856,19856,19859,0,3,5
5707,5,1,19861,19861,19862,0,1,2
5708,4,2,19865,19865,19867,0,2,3
5709,6,3,19871,19871,19874,0,3,4
5710,1,1,19872,19874,19875,2,3,0
5711,3,3,19875,19875,19878,0,3,0
5712,6,1,19881,19881,19882,0,1,3
5713,3,2,19884,19884,19886,0,2,2
5714,2,1,19886,19886,19887,0,1,0
5715,1,2,19887,19887,19889,0,2,0
5716,5,3,19892,19892,19895,0,3,3
5717,5,2,19897,19897,19899,0,2,2
5718,3,1,19900,19900,19901,0,1,1
5719,1,1,19901,19901,19902,0,1,0
5720,4,3,19905,19905,19908,0,3,3
5721,6,2,19911,19911,19913,0,2,3
5722,5,1,19916,19916,19917,0,1,3
5723,3,1,19919,19919,19920,0,1,2
5724,2,3,19921,19921,19924,0,3,1
5725,5,3,19926,19926,19929,0,3,2
5726,6,2,19932,19932,19934,0,2,3
5727,1,3,19933,19934,19937,1,4,0
5728,4,2,19937,19937,19939,0,2,0
5729,3,3,19940,19940,19943,0,3,1
5730,1,3,19941,19943,19946,2,5,0
5731,2,1,19943,19946,19947,3,4,0
5732,4,1,19947,19947,19948,0,1,0
5733,5,2,19952,19952,19954,0,2,4
5734,1,1,19953,19954,19955,1,2,0
5735,6,1,19959,19959,19960,0,1,4
5736,6,1,19965,19965,19966,0,1,5
5737,1,1,19966,19966,19967,0,1,0
5738,1,2,19967,19967,19969,0,2,0
5739,4,3,19971,19971,19974,0,3,2
5740,6,3,19977,19977,19980,0,3,3
5741,6,1,19983,19983,19984,0,1,3
5742,1,3,19984,19984,19987,0,3,0
5743,3,3,19987,19987,19990,0,3,0
5744,3,3,19990,19990,19993,0,3,0
5745,1,1,19991,19993,19994,2,3,0
5746,3,3,19994,19994,19997,0,3,0
5747,3,3,19997,19997,20000,0,3,0
5748,5,2,20002,20002,20004,0,2,2
5749,6,2,20008,20008,20010,0,2,4
5750,5,2,20013,20013,20015,0,2,3
5751,4,3,20017,20017,20020,0,3,2
5752,3,1,20020,20020,20021,0,1,0
5753,1,2,20021,20021,20023,0,2,0
5754,2,2,20023,20023,20025,0,2,0
5755,3,1,20026,20026,20027,0,1,1
5756,1,3,20027,20027,20030,0,3,0
5757,6,1,20033,20033,20034,0,1,3
5758,3,1,20036,20036,20037,0,1,2
5759,5,1,20041,20041,20042,0,1,4
5760,4,3,20045,20045,20048,0,3,3
5761,5,2,20050,20050,20052,0,2,2
5762,3,2,20053,20053,20055,0,2,1
5763,1,2,20054,20055,20057,1,3,0
5764,4,3,20058,20058,20061,0,3,1
5765,4,3,20062,20062,20065,0,3,1
5766,5,2,20067,20067,20069,0,2,2
5767,5,2,20072,20072,20074,0,2,3
5768,4,2,20076,20076,20078,0,2,2
5769,3,3,20079,20079,20082,0,3,1
5770,2,2,20081,20082,20084,1,3,0
5771,1,2,20082,20084,20086,2,4,0
5772,2,3,20084,20086,20089,2,5,0
5773,1,2,20085,20089,20091,4,6,0
5774,6,2,20091,20091,20093,0,2,0
5775,5,2,20096,20096,20098,0,2,3
5776,5,3,20101,20101,20104,0,3,3
5777,3,1,20104,20104,20105,0,1,0
5778,3,2,20107,20107,20109,0,2,2
5779,4,2,20111,20111,20113,0,2,2
5780,6,2,20117,20117,20119,0,2,4
5781,4,1,20121,20121,20122,0,1,2
5782,1,2,20122,20122,20124,0,2,0
5783,1,1,20123,20124,20125,1,2,0
5784,4,2,20127,20127,20129,0,2,2
5785,3,3,20130,20130,20133,0,3,1
5786,5,1,20135,20135,20136,0,1,2
5787,6,2,20141,20141,20143,0,2,5
5788,3,3,20144,20144,20147,0,3,1
5789,1,3,20145,20147,20150,2,5,0
5790,1,1,20146,20150,20151,4,5,0
5791,5,3,20151,20151,20154,0,3,0
5792,2,1,20153,20154,20155,1,2,0
5793,4,3,20157,20157,20160,0,3,2
5794,3,2,20160,20160,20162,0,2,0
5795,2,2,20162,20162,20164,0,2,0
5796,4,3,20166,20166,20169,0,3,2
5797,3,1,20169,20169,20170,0,1,0
5798,5,1,20174,20174,20175,0,1,4
5799,6,1,20180,20180,20181,0,1,5
5800,5,2,20185,20185,20187,0,2,4
5801,4,2,20189,20189,20191,0,2,2
5802,2,2,20191,20191,20193,0,2,0
5803,6,3,20197,20197,20200,0,3,4
5804,5,1,20202,20202,20203,0,1,2
5805,2,3,20204,20204,20207,0,3,1
5806,3,3,20207,20207,20210,0,3,0
5807,6,1,20213,20213,20214,0,1,3
5808,3,2,20216,20216,20218,0,2,2
5809,5,2,20221,20221,20223,0,2,3
5810,3,2,20224,20224,20226,0,2,1
5811,2,3,20226,20226,20229,0,3,0
5812,6,2,20232,20232,20234,0,2,3
5813,5,3,20237,20237,20240,0,3,3
5814,6,2,20243,20243,20245,0,2,3
5815,2,1,20245,20245,20246,0,1,0
5816,4,2,20249,20249,20251,0,2,3
5817,5,2,20254,20254,20256,0,2,3
5818,3,3,20257,20257,20260,0,3,1
5819,4,1,20261,20261,20262,0,1,1
5820,3,2,20264,20264,20266,0,2,2
5821,5,2,20269,20269,20271,0,2,3
5822,3,3,20272,20272,20275,0,3,1
5823,5,1,20277,20277,20278,0,1,2
5824,2,1,20279,20279,20280,0,1,1
5825,4,2,20283,20283,20285,0,2,3
5826,6,2,20289,20289,20291,0,2,4
5827,6,2,20295,20295,20297,0,2,4
5828,5,2,20300,20300,20302,0,2,3
5829,2,3,20302,20302,20305,0,3,0
5830,3,2,20305,20305,20307,0,2,0
5831,1,2,20306,20307,20309,1,3,0
5832,1,1,20307,20309,20310,2,3,0
5833,1,2,20308,20310,20312,2,4,0
5834,3,1,20311,20312,20313,1,2,0
5835,4,3,20315,20315,20318,0,3,2
5836,1,1,20316,20318,20319,2,3,0
5837,3,3,20319,20319,20322,0,3,0
5838,4,3,20323,20323,20326,0,3,1
5839,4,1,20327,20327,20328,0,1,1
5840,3,1,20330,20330,20331,0,1,2
5841,4,3,20334,20334,20337,0,3,3
5842,1,1,20335,20337,20338,2,3,0
5843,5,3,20340,20340,20343,0,3,2
5844,5,2,20345,20345,20347,0,2,2
5845,1,3,20346,20347,20350,1,4,0
5846,1,3,20347,20350,20353,3,6,0
5847,6,3,20353,20353,20356,0,3,0
5848,5,1,20358,20358,20359,0,1,2
5849,2,1,20360,20360,20361,0,1,1
5850,2,2,20362,20362,20364,0,2,1
5851,5,1,20367,20367,20368,0,1,3
5852,1,2,20368,20368,20370,0,2,0
5853,3,3,20371,20371,20374,0,3,1
5854,4,2,20375,20375,20377,0,2,1
5855,5,3,20380,20380,20383,0,3,3
5856,3,2,20383,20383,20385,0,2,0
5857,4,1,20387,20387,20388,0,1,2
5858,5,1,20392,20392,20393,0,1,4
5859,6,2,20398,20398,20400,0,2,5
5860,4,3,20402,20402,20405,0,3,2
5861,5,1,20407,20407,20408,0,1,2
5862,2,3,20409,20409,20412,0,3,1
5863,3,3,20412,20412,20415,0,3,0
5864,5,3,20417,20417,20420,0,3,2
5865,4,3,20421,20421,20424,0,3,1
5866,2,3,20423,20424,20427,1,4,0
5867,3,3,20426,20427,20430,1,4,0
5868,2,1,20428,20430,20431,2,3,0
5869,6,2,20434,20434,20436,0,2,3
5870,5,1,20439,20439,20440,0,1,3
5871,5,3,20444,20444,20447,0,3,4
5872,1,3,20445,20447,20450,2,5,0
5873,2,1,20447,20450,20451,3,4,0
5874,2,3,20449,20451,20454,2,5,0
5875,5,3,20454,20454,20457,0,3,0
5876,2,2,20456,20457,20459,1,3,0
5877,3,3,20459,20459,20462,0,3,0
5878,4,1,20463,20463,20464,0,1,1
5879,2,2,20465,20465,20467,0,2,1
5880,4,1,20469,20469,20470,0,1,2
5881,5,3,20474,20474,20477,0,3,4
5882,5,3,20479,20479,20482,0,3,2
5883,5,2,20484,20484,20486,0,2,2
5884,6,3,20490,20490,20493,0,3,4
5885,3,2,20493,20493,20495,0,2,0
5886,3,3,20496,20496,20499,0,3,1
5887,4,3,20500,20500,20503,0,3,1
5888,1,3,20501,20503,20506,2,5,0
5889,4,1,20505,20506,20507,1,2,0
5890,3,1,20508,20508,20509,0,1,1
5891,2,2,20510,20510,20512,0,2,1
5892,1,1,20511,20512,20513,1,2,0
5893,5,2,20516,20516,20518,0,2,3
5894,4,2,20520,20520,20522,0,2,2
5895,2,3,20522,20522,20525,0,3,0
5896,2,1,20524,20525,20526,1,2,0
5897,1,3,20525,20526,20529,1,4,0
5898,4,1,20529,20529,20530,0,1,0
5899,5,3,20534,20534,20537,0,3,4
5900,2,1,20536,20537,20538,1,2,0
5901,6,2,20542,20542,20544,0,2,4
5902,1,1,20543,20544,20545,1,2,0
5903,1,1,20544,20545,20546,1,2,0
5904,4,1,20548,20548,20549,0,1,2
5905,1,3,20549,20549,20552,0,3,0
5906,1,1,20550,20552,20553,2,3,0
5907,5,2,20555,20555,20557,0,2,2
5908,1,1,20556,20557,20558,1,2,0
5909,3,1,20559,20559,20560,0,1,1
5910,2,3,20561,20561,20564,0,3,1
5911,4,2,20565,20565,20567,0,2,1
5912,1,2,20566,20567,20569,1,3,0
5913,5,1,20571,20571,20572,0,1,2
5914,2,2,20573,20573,20575,0,2,1
5915,5,3,20578,20578,20581,0,3,3
5916,3,1,20581,20581,20582,0,1,0
5917,5,2,20586,20586,20588,0,2,4
5918,6,1,20592,20592,20593,0,1,4
5919,4,1,20596,20596,20597,0,1,3
5920,6,3,20602,20602,20605,0,3,5
5921,5,1,20607,20607,20608,0,1,2
5922,2,1,20609,20609,20610,0,1,1
5923,1,1,20610,20610,20611,0,1,0
5924,5,3,20615,20615,20618,0,3,4
5925,6,3,20621,20621,20624,0,3,3
5926,1,2,20622,20624,20626,2,4,0
5927,2,1,20624,20626,20627,2,3,0
5928,3,2,20627,20627,20629,0,2,0
5929,2,3,20629,20629,20632,0,3,0
5930,1,1,20630,20632,20633,2,3,0
5931,2,3,20632,20633,20636,1,4,0
5932,1,3,20633,20636,20639,3,6,0
5933,3,2,20636,20639,20641,3,5,0
5934,3,3,20639,20641,20644,2,5,0
5935,4,3,20643,20644,20647,1,4,0
5936,6,3,20649,20649,20652,0,3,2
5937,1,1,20650,20652,20653,2,3,0
5938,6,1,20656,20656,20657,0,1,3
5939,1,3,20657,20657,20660,0,3,0
5940,2,1,20659,20660,20661,1,2,0
5941,1,2,20660,20661,20663,1,3,0
5942,1,2,20661,20663,20665,2,4,0
5943,6,3,20667,20667,20670,0,3,2
5944,6,1,20673,20673,20674,0,1,3
5945,2,2,20675,20675,20677,0,2,1
5946,6,2,20681,20681,20683,0,2,4
5947,2,3,20683,20683,20686,0,3,0
5948,6,2,20689,20689,20691,0,2,3
5949,1,2,20690,20691,20693,1,3,0
5950,6,1,20696,20696,20697,0,1,3
5951,1,2,20697,20697,20699,0,2,0
5952,6,3,20703,20703,20706,0,3,4
5953,1,2,20704,20706,20708,2,4,0
5954,5,2,20709,20709,20711,0,2,1
5955,4,3,20713,20713,20716,0,3,2
5956,2,1,20715,20716,20717,1,2,0
5957,2,1,20717,20717,20718,0,1,0
5958,5,3,20722,20722,20725,0,3,4
5959,1,1,20723,20725,20726,2,3,0
5960,2,3,20725,20726,20729,1,4,0
5961,6,2,20731,20731,20733,0,2,2
5962,5,1,20736,20736,20737,0,1,3
5963,4,3,20740,20740,20743,0,3,3
5964,1,3,20741,20743,20746,2,5,0
5965,4,3,20745,20746,20749,1,4,0
5966,2,3,20747,20749,20752,2,5,0
5967,1,2,20748,20752,20754,4,6,0
5968,4,1,20752,20754,20755,2,3,0
5969,3,2,20755,20755,20757,0,2,0
5970,1,1,20756,20757,20758,1,2,0
5971,2,1,20758,20758,20759,0,1,0
5972,3,3,20761,20761,20764,0,3,2
5973,4,1,20765,20765,20766,0,1,1
5974,5,3,20770,20770,20773,0,3,4
5975,2,2,20772,20773,20775,1,3,0
5976,5,1,20777,20777,20778,0,1,2
5977,6,3,20783,20783,20786,0,3,5
5978,5,2,20788,20788,20790,0,2,2
5979,3,2,20791,20791,20793,0,2,1
5980,2,3,20793,20793,20796,0,3,0
5981,1,3,20794,20796,20799,2,5,0
5982,5,2,20799,20799,20801,0,2,0
5983,1,2,20800,20801,20803,1,3,0
5984,4,2,20804,20804,20806,0,2,1
5985,2,2,20806,20806,20808,0,2,0
5986,1,2,20807,20808,20810,1,3,0
5987,5,1,20812,20812,20813,0,1,2
5988,5,2,20817,20817,20819,0,2,4
5989,2,2,20819,20819,20821,0,2,0
5990,5,1,20824,20824,20825,0,1,3
5991,3,1,20827,20827,20828,0,1,2
5992,5,1,20832,20832,20833,0,1,4
5993,1,1,20833,20833,20834,0,1,0
5994,5,3,20838,20838,20841,0,3,4
5995,6,3,20844,20844,20847,0,3,3
5996,2,3,20846,20847,20850,1,4,0
5997,5,2,20851,20851,20853,0,2,1
5998,6,3,20857,20857,20860,0,3,4
5999,6,3,20863,20863,20866,0,3,3
6000,4,2,20867,20867,20869,0,2,1
6001,3,1,20870,20870,20871,0,1,1
6002,1,2,20871,20871,20873,0,2,0
6003,3,3,20874,20874,20877,0,3,1
6004,1,1,20875,20877,20878,2,3,0
6005,2,2,20877,20878,20880,1,3,0
6006,1,2,20878,20880,20882,2,4,0
6007,2,1,20880,20882,20883,2,3,0
6008,1,1,20881,20883,20884,2,3,0
6009,3,3,20884,20884,20887,0,3,0
6010,4,2,20888,20888,20890,0,2,1
6011,3,3,20891,20891,20894,0,3,1
6012,2,3,20893,20894,20897,1,4,0
6013,2,2,20895,20897,20899,2,4,0
6014,6,2,20901,20901,20903,0,2,2
6015,6,2,20907,20907,20909,0,2,4
6016,5,2,20912,20912,20914,0,2,3
6017,4,3,20916,20916,20919,0,3,2
6018,4,3,20920,20920,20923,0,3,1
6019,4,2,20924,20924,20926,0,2,1
6020,4,1,20928,20928,20929,0,1,2
6021,3,3,20931,20931,20934,0,3,2
6022,2,1,20933,20934,20935,1,2,0
6023,5,1,20938,20938,20939,0,1,3
6024,5,2,20943,20943,20945,0,2,4
6025,2,2,20945,20945,20947,0,2,0
6026,3,3,20948,20948,20951,0,3,1
6027,4,2,20952,20952,20954,0,2,1
6028,2,3,20954,20954,20957,0,3,0
6029,4,2,20958,20958,20960,0,2,1
6030,6,2,20964,20964,20966,0,2,4
6031,4,1,20968,20968,20969,0,1,2
6032,6,3,20974,20974,20977,0,3,5
6033,3,1,20977,20977,20978,0,1,0
6034,4,1,20981,20981,20982,0,1,3
6035,3,3,20984,20984,20987,0,3,2
6036,3,3,20987,20987,20990,0,3,0
6037,4,3,20991,20991,20994,0,3,1
6038,3,2,20994,20994,20996,0,2,0
6039,3,2,20997,20997,20999,0,2,1
6040,2,1,20999,20999,21000,0,1,0
6041,5,3,21004,21004,21007,0,3,4
6042,5,2,21009,21009,21011,0,2,2
6043,6,3,21015,21015,21018,0,3,4
6044,3,3,21018,21018,21021,0,3,0
6045,2,3,21020,21021,21024,1,4,0
6046,5,1,21025,21025,21026,0,1,1
6047,4,1,21029,21029,21030,0,1,3
6048,5,1,21034,21034,21035,0,1,4
6049,3,3,21037,21037,21040,0,3,2
6050,3,3,21040,21040,21043,0,3,0
6051,4,1,21044,21044,21045,0,1,1
6052,6,3,21050,21050,21053,0,3,5
6053,6,3,21056,21056,21059,0,3,3
6054,6,1,21062,21062,21063,0,1,3
6055,6,3,21068,21068,21071,0,3,5
6056,5,2,21073,21073,21075,0,2,2
6057,2,1,21075,21075,21076,0,1,0
6058,2,2,21077,21077,21079,0,2,1
6059,3,3,21080,21080,21083,0,3,1
6060,1,3,21081,21083,21086,2,5,0
6061,1,1,21082,21086,21087,4,5,0
6062,4,2,21086,21087,21089,1,3,0
6063,6,1,21092,21092,21093,0,1,3
6064,3,2,21095,21095,21097,0,2,2
6065,4,3,21099,21099,21102,0,3,2
6066,6,1,21105,21105,21106,0,1,3
6067,1,3,21106,21106,21109,0,3,0
6068,6,1,21112,21112,21113,0,1,3
6069,1,2,21113,21113,21115,0,2,0
6070,6,1,21119,21119,21120,0,1,4
6071,2,3,21121,21121,21124,0,3,1
6072,6,1,21127,21127,21128,0,1,3
6073,2,1,21129,21129,21130,0,1,1
6074,2,2,21131,21131,21133,0,2,1
6075,4,2,21135,21135,21137,0,2,2
6076,4,3,21139,21139,21142,0,3,2
6077,4,1,21143,21143,21144,0,1,1
6078,4,2,21147,21147,21149,0,2,3
6079,2,2,21149,21149,21151,0,2,0
6080,4,1,21153,21153,21154,0,1,2
6081,4,2,21157,21157,21159,0,2,3
6082,2,1,21159,21159,21160,0,1,0
6083,5,3,21164,21164,21167,0,3,4
6084,6,1,21170,21170,21171,0,1,3
6085,3,2,21173,21173,21175,0,2,2
6086,5,3,21178,21178,21181,0,3,3
6087,2,2,21180,21181,21183,1,3,0
6088,4,2,21184,21184,21186,0,2,1
6089,5,1,21189,21189,21190,0,1,3
6090,1,3,21190,21190,21193,0,3,0
6091,2,2,21192,21193,21195,1,3,0
6092,4,1,21196,21196,21197,0,1,1
6093,4,2,21200,21200,21202,0,2,3
6094,3,3,21203,21203,21206,0,3,1
6095,5,2,21208,21208,21210,0,2,2
6096,6,1,21214,21214,21215,0,1,4
6097,5,2,21219,21219,21221,0,2,4
6098,4,2,21223,21223,21225,0,2,2
6099,2,1,21225,21225,21226,0,1,0
6100,4,2,21229,21229,21231,0,2,3
6101,3,1,21232,21232,21233,0,1,1
6102,4,3,21236,21236,21239,0,3,3
6103,5,3,21241,21241,21244,0,3,2
6104,6,2,21247,21247,21249,0,2,3
6105,2,2,21249,21249,21251,0,2,0
6106,6,3,21255,21255,21258,0,3,4
6107,2,3,21257,21258,21261,1,4,0
6108,3,2,21260,21261,21263,1,3,0
6109,3,2,21263,21263,21265,0,2,0
6110,5,3,21268,21268,21271,0,3,3
6111,1,1,21269,21271,21272,2,3,0
6112,4,3,21273,21273,21276,0,3,1
6113,3,3,21276,21276,21279,0,3,0
6114,6,1,21282,21282,21283,0,1,3
6115,6,1,21288,21288,21289,0,1,5
6116,5,3,21293,21293,21296,0,3,4
6117,6,1,21299,21299,21300,0,1,3
6118,1,1,21300,21300,21301,0,1,0
6119,1,1,21301,21301,21302,0,1,0
6120,3,3,21304,21304,21307,0,3,2
6121,3,1,21307,21307,21308,0,1,0
6122,6,3,21313,21313,21316,0,3,5
6123,3,3,21316,21316,21319,0,3,0
6124,1,3,21317,21319,21322,2,5,0
6125,5,3,21322,21322,21325,0,3,0
6126,2,3,21324,21325,21328,1,4,0
6127,4,3,21328,21328,21331,0,3,0
6128,5,2,21333,21333,21335,0,2,2
6129,1,3,21334,21335,21338,1,4,0
6130,2,1,21336,21338,21339,2,3,0
6131,4,2,21340,21340,21342,0,2,1
6132,3,3,21343,21343,21346,0,3,1
6133,1,3,21344,21346,21349,2,5,0
6134,6,1,21350,21350,21351,0,1,1
6135,5,1,21355,21355,21356,0,1,4
6136,3,3,21358,21358,21361,0,3,2
6137,4,3,21362,21362,21365,0,3,1
6138,1,3,21363,21365,21368,2,5,0
6139,2,2,21365,21368,21370,3,5,0
6140,3,1,21368,21370,21371,2,3,0
6141,1,1,21369,21371,21372,2,3,0
6142,1,2,21370,21372,21374,2,4,0
6143,3,3,21373,21374,21377,1,4,0
6144,3,2,21376,21377,21379,1,3,0
6145,1,1,21377,21379,21380,2,3,0
6146,1,1,21378,21380,21381,2,3,0
6147,4,1,21382,21382,21383,0,1,1
6148,3,3,21385,21385,21388,0,3,2
6149,6,3,21391,21391,21394,0,3,3
6150,6,3,21397,21397,21400,0,3,3
6151,1,3,21398,21400,21403,2,5,0
6152,5,1,21403,21403,21404,0,1,0
6153,5,1,21408,21408,21409,0,1,4
6154,4,2,21412,21412,21414,0,2,3
6155,4,1,21416,21416,21417,0,1,2
6156,6,1,21422,21422,21423,0,1,5
6157,1,2,21423,21423,21425,0,2,0
6158,3,1,21426,21426,21427,0,1,1
6159,2,1,21428,21428,21429,0,1,1
6160,6,2,21434,21434,21436,0,2,5
6161,5,3,21439,21439,21442,0,3,3
6162,3,3,21442,21442,21445,0,3,0
6163,4,1,21446,21446,21447,0,1,1
6164,5,3,21451,21451,21454,0,3,4
6165,4,3,21455,21455,21458,0,3,1
6166,3,2,21458,21458,21460,0,2,0
6167,5,1,21463,21463,21464,0,1,3
6168,4,1,21467,21467,21468,0,1,3
6169,3,1,21470,21470,21471,0,1,2
6170,3,3,21473,21473,21476,0,3,2
6171,3,2,21476,21476,21478,0,2,0
6172,3,2,21479,21479,21481,0,2,1
6173,3,1,21482,21482,21483,0,1,1
6174,5,2,21487,21487,21489,0,2,4
6175,4,1,21491,21491,21492,0,1,2
6176,3,2,21494,21494,21496,0,2,2
6177,6,1,21500,21500,21501,0,1,4
6178,2,1,21502,21502,21503,0,1,1
6179,5,2,21507,21507,21509,0,2,4
6180,3,3,21510,21510,21513,0,3,1
6181,5,3,21515,21515,21518,0,3,2
6182,6,2,21521,21521,21523,0,2,3
6183,5,2,21526,21526,21528,0,2,3
6184,6,2,21532,21532,21534,0,2,4
6185,3,3,21535,21535,21538,0,3,1
6186,3,3,21538,21538,21541,0,3,0
6187,6,1,21544,21544,21545,0,1,3
6188,6,3,21550,21550,21553,0,3,5
6189,6,2,21556,21556,21558,0,2,3
6190,6,1,21562,21562,21563,0,1,4
6191,6,3,21568,21568,21571,0,3,5
6192,4,3,21572,21572,21575,0,3,1
6193,2,3,21574,21575,21578,1,4,0
6194,6,2,21580,21580,21582,0,2,2
6195,1,2,21581,21582,21584,1,3,0
6196,6,1,21587,21587,21588,0,1,3
6197,1,1,21588,21588,21589,0,1,0
6198,3,3,21591,21591,21594,0,3,2
6199,4,3,21595,21595,21598,0,3,1
6200,1,2,21596,21598,21600,2,4,0
6201,5,1,21601,21601,21602,0,1,1
6202,6,1,21607,21607,21608,0,1,5
6203,2,2,21609,21609,21611,0,2,1
6204,5,1,21614,21614,21615,0,1,3
6205,5,1,21619,21619,21620,0,1,4
6206,6,2,21625,21625,21627,0,2,5
6207,1,2,21626,21627,21629,1,3,0
6208,6,1,21632,21632,21633,0,1,3
6209,3,1,21635,21635,21636,0,1,2
6210,6,3,21641,21641,21644,0,3,5
6211,5,2,21646,21646,21648,0,2,2
6212,6,3,21652,21652,21655,0,3,4
6213,5,3,21657,21657,21660,0,3,2
6214,5,3,21662,21662,21665,0,3,2
6215,1,3,21663,21665,21668,2,5,0
6216,4,2,21667,21668,21670,1,3,0
6217,2,3,21669,21670,21673,1,4,0
6218,1,2,21670,21673,21675,3,5,0
6219,2,1,21672,21675,21676,3,4,0
6220,3,3,21675,21676,21679,1,4,0
6221,3,3,21678,21679,21682,1,4,0
6222,4,1,21682,21682,21683,0,1,0
6223,6,2,21688,21688,21690,0,2,5
6224,4,3,21692,21692,21695,0,3,2
6225,4,3,21696,21696,21699,0,3,1
6226,5,1,21701,21701,21702,0,1,2
6227,2,3,21703,21703,21706,0,3,1
6228,2,3,21705,21706,21709,1,4,0
6229,4,3,21709,21709,21712,0,3,0
6230,4,2,21713,21713,21715,0,2,1
6231,6,3,21719,21719,21722,0,3,4
6232,3,3,21722,21722,21725,0,3,0
6233,5,2,21727,21727,21729,0,2,2
6234,5,1,21732,21732,21733,0,1,3
6235,1,2,21733,21733,21735,0,2,0
6236,2,2,21735,21735,21737,0,2,0
6237,1,3,21736,21737,21740,1,4,0
6238,2,2,21738,21740,21742,2,4,0
6239,1,1,21739,21742,21743,3,4,0
6240,6,3,21745,21745,21748,0,3,2
6241,2,1,21747,21748,21749,1,2,0
6242,2,2,21749,21749,21751,0,2,0
6243,3,3,21752,21752,21755,0,3,1
6244,1,2,21753,21755,21757,2,4,0
6245,5,2,21758,21758,21760,0,2,1
6246,4,2,21762,21762,21764,0,2,2
6247,3,3,21765,21765,21768,0,3,1
6248,3,1,21768,21768,21769,0,1,0
6249,5,3,21773,21773,21776,0,3,4
6250,5,3,21778,21778,21781,0,3,2
6251,4,3,21782,21782,21785,0,3,1
6252,2,2,21784,21785,21787,1,3,0
6253,3,2,21787,21787,21789,0,2,0
6254,2,2,21789,21789,21791,0,2,0
6255,4,1,21793,21793,21794,0,1,2
6256,4,1,21797,21797,21798,0,1,3
6257,4,2,21801,21801,21803,0,2,3
6258,2,2,21803,21803,21805,0,2,0
6259,3,1,21806,21806,21807,0,1,1
6260,4,3,21810,21810,21813,0,3,3
6261,1,3,21811,21813,21816,2,5,0
6262,4,1,21815,21816,21817,1,2,0
6263,2,1,21817,21817,21818,0,1,0
6264,2,1,21819,21819,21820,0,1,1
6265,2,1,21821,21821,21822,0,1,1
6266,4,1,21825,21825,21826,0,1,3
6267,6,2,21831,21831,21833,0,2,5
6268,3,1,21834,21834,21835,0,1,1
6269,1,1,21835,21835,21836,0,1,0
6270,3,1,21838,21838,21839,0,1,2
6271,1,1,21839,21839,21840,0,1,0
6272,1,3,21840,21840,21843,0,3,0
6273,5,1,21845,21845,21846,0,1,2
6274,3,2,21848,21848,21850,0,2,2
6275,1,3,21849,21850,21853,1,4,0
6276,3,3,21852,21853,21856,1,4,0
6277,3,3,21855,21856,21859,1,4,0
6278,1,3,21856,21859,21862,3,6,0
6279,2,1,21858,21862,21863,4,5,0
6280,6,2,21864,21864,21866,0,2,1
6281,3,1,21867,21867,21868,0,1,1
6282,1,1,21868,21868,21869,0,1,0
6283,6,3,21874,21874,21877,0,3,5
6284,2,3,21876,21877,21880,1,4,0
6285,5,2,21881,21881,21883,0,2,1
6286,5,2,21886,21886,21888,0,2,3
6287,1,3,21887,21888,21891,1,4,0
6288,2,2,21889,21891,21893,2,4,0
6289,3,2,21892,21893,21895,1,3,0
6290,5,1,21897,21897,21898,0,1,2
6291,2,2,21899,21899,21901,0,2,1
6292,2,3,21901,21901,21904,0,3,0
6293,6,3,21907,21907,21910,0,3,3
6294,2,1,21909,21910,21911,1,2,0
6295,6,2,21915,21915,21917,0,2,4
6296,4,3,21919,21919,21922,0,3,2
6297,2,3,21921,21922,21925,1,4,0
6298,3,3,21924,21925,21928,1,4,0
6299,2,1,21926,21928,21929,2,3,0
6300,6,3,21932,21932,21935,0,3,3
6301,3,3,21935,21935,21938,0,3,0
6302,3,2,21938,21938,21940,0,2,0
6303,1,2,21939,21940,21942,1,3,0
6304,2,1,21941,21942,21943,1,2,0
6305,3,1,21944,21944,21945,0,1,1
6306,5,3,21949,21949,21952,0,3,4
6307,1,2,21950,21952,21954,2,4,0
6308,2,3,21952,21954,21957,2,5,0
6309,5,1,21957,21957,21958,0,1,0
6310,4,3,21961,21961,21964,0,3,3
6311,5,1,21966,21966,21967,0,1,2
6312,6,1,21972,21972,21973,0,1,5
6313,6,3,21978,21978,21981,0,3,5
6314,3,1,21981,21981,21982,0,1,0
6315,6,3,21987,21987,21990,0,3,5
6316,4,3,21991,21991,21994,0,3,1
6317,3,1,21994,21994,21995,0,1,0
6318,4,1,21998,21998,21999,0,1,3
6319,6,1,22004,22004,22005,0,1,5
6320,3,1,22007,22007,22008,0,1,2
6321,1,3,22008,22008,22011,0,3,0
6322,4,3,22012,22012,22015,0,3,1
6323,2,1,22014,22015,22016,1,2,0
6324,3,3,22017,22017,22020,0,3,1
6325,3,2,22020,22020,22022,0,2,0
6326,3,1,22023,22023,22024,0,1,1
6327,5,3,22028,22028,22031,0,3,4
6328,5,3,22033,22033,22036,0,3,2
6329,6,2,22039,22039,22041,0,2,3
6330,4,1,22043,22043,22044,0,1,2
6331,2,3,22045,22045,22048,0,3,1
6332,2,3,22047,22048,22051,1,4,0
6333,5,3,22052,22052,22055,0,3,1
6334,6,3,22058,22058,22061,0,3,3
6335,2,1,22060,22061,22062,1,2,0
6336,1,3,22061,22062,22065,1,4,0
6337,2,1,22063,22065,22066,2,3,0
6338,3,3,22066,22066,22069,0,3,0
6339,6,1,22072,22072,22073,0,1,3
6340,4,2,22076,22076,22078,0,2,3
6341,4,2,22080,22080,22082,0,2,2
6342,3,1,22083,22083,22084,0,1,1
6343,5,2,22088,22088,22090,0,2,4
6344,6,2,22094,22094,22096,0,2,4
6345,4,1,22098,22098,22099,0,1,2
6346,2,3,22100,22100,22103,0,3,1
6347,4,3,22104,22104,22107,0,3,1
6348,3,3,22107,22107,22110,0,3,0
6349,4,3,22111,22111,22114,0,3,1
6350,4,1,22115,22115,22116,0,1,1
6351,3,1,22118,22118,22119,0,1,2
6352,6,3,22124,22124,22127,0,3,5
6353,5,1,22129,22129,22130,0,1,2
6354,1,1,22130,22130,22131,0,1,0
6355,1,1,22131,22131,22132,0,1,0
6356,5,2,22136,22136,22138,0,2,4
6357,2,3,22138,22138,22141,0,3,0
6358,6,2,22144,22144,22146,0,2,3
6359,5,1,22149,22149,22150,0,1,3
6360,4,3,22153,22153,22156,0,3,3
6361,5,3,22158,22158,22161,0,3,2
6362,4,3,22162,22162,22165,0,3,1
6363,6,3,22168,22168,22171,0,3,3
6364,5,2,22173,22173,22175,0,2,2
6365,4,2,22177,22177,22179,0,2,2
6366,5,1,22182,22182,22183,0,1,3
6367,4,1,22186,22186,22187,0,1,3
6368,1,2,22187,22187,22189,0,2,0
6369,2,2,22189,22189,22191,0,2,0
6370,5,1,22194,22194,22195,0,1,3
6371,2,1,22196,22196,22197,0,1,1
6372,4,1,22200,22200,22201,0,1,3
6373,4,3,22204,22204,22207,0,3,3
6374,2,3,22206,22207,22210,1,4,0
6375,5,2,22211,22211,22213,0,2,1
6376,5,2,22216,22216,22218,0,2,3
6377,1,1,22217,22218,22219,1,2,0
6378,5,1,22222,22222,22223,0,1,3
6379,3,3,22225,22225,22228,0,3,2
6380,6,3,22231,22231,22234,0,3,3
6381,4,3,22235,22235,22238,0,3,1
6382,3,2,22238,22238,22240,0,2,0
6383,3,3,22241,22241,22244,0,3,1
6384,3,2,22244,22244,22246,0,2,0
6385,2,3,22246,22246,22249,0,3,0
6386,6,1,22252,22252,22253,0,1,3
6387,6,3,22258,22258,22261,0,3,5
6388,1,1,22259,22261,22262,2,3,0
6389,1,3,22260,22262,22265,2,5,0
6390,1,2,22261,22265,22267,4,6,0
6391,4,1,22265,22267,22268,2,3,0
6392,1,2,22266,22268,22270,2,4,0
6393,3,1,22269,22270,22271,1,2,0
6394,3,3,22272,22272,22275,0,3,1
6395,5,3,22277,22277,22280,0,3,2
6396,1,1,22278,22280,22281,2,3,0
6397,5,3,22283,22283,22286,0,3,2
6398,2,2,22285,22286,22288,1,3,0
6399,6,3,22291,22291,22294,0,3,3
6400,3,1,22294,22294,22295,0,1,0
6401,6,1,22300,22300,22301,0,1,5
6402,1,3,22301,22301,22304,0,3,0
6403,3,3,22304,22304,22307,0,3,0
6404,4,3,22308,22308,22311,0,3,1
6405,4,3,22312,22312,22315,0,3,1
6406,3,3,22315,22315,22318,0,3,0
6407,4,2,22319,22319,22321,0,2,1
6408,1,1,22320,22321,22322,1,2,0
6409,6,2,22326,22326,22328,0,2,4
6410,3,1,22329,22329,22330,0,1,1
6411,6,1,22335,22335,22336,0,1,5
6412,3,1,22338,22338,22339,0,1,2
6413,5,3,22343,22343,22346,0,3,4
6414,5,2,22348,22348,22350,0,2,2
6415,4,2,22352,22352,22354,0,2,2
6416,3,2,22355,22355,22357,0,2,1
6417,3,2,22358,22358,22360,0,2,1
6418,1,2,22359,22360,22362,1,3,0
6419,1,2,22360,22362,22364,2,4,0
6420,3,2,22363,22364,22366,1,3,0
6421,4,2,22367,22367,22369,0,2,1
6422,3,2,22370,22370,22372,0,2,1
6423,6,3,22376,22376,22379,0,3,4
6424,1,1,22377,22379,22380,2,3,0
6425,5,2,22382,22382,22384,0,2,2
6426,1,2,22383,22384,22386,1,3,0
6427,4,3,22387,22387,22390,0,3,1
6428,4,3,22391,22391,22394,0,3,1
6429,5,3,22396,22396,22399,0,3,2
6430,3,3,22399,22399,22402,0,3,0
6431,6,2,22405,22405,22407,0,2,3
6432,1,3,22406,22407,22410,1,4,0
6433,3,1,22409,22410,22411,1,2,0
6434,2,2,22411,22411,22413,0,2,0
6435,2,3,22413,22413,22416,0,3,0
6436,5,1,22418,22418,22419,0,1,2
6437,1,2,22419,22419,22421,0,2,0
6438,3,3,22422,22422,22425,0,3,1
6439,6,3,22428,22428,22431,0,3,3
6440,3,1,22431,22431,22432,0,1,0
6441,2,1,22433,22433,22434,0,1,1
6442,4,2,22437,22437,22439,0,2,3
6443,4,2,22441,22441,22443,0,2,2
6444,3,1,22444,22444,22445,0,1,1
6445,3,1,22447,22447,22448,0,1,2
6446,6,2,22453,22453,22455,0,2,5
6447,5,1,22458,22458,22459,0,1,3
6448,5,2,22463,22463,22465,0,2,4
6449,1,1,22464,22465,22466,1,2,0
6450,1,2,22465,22466,22468,1,3,0
6451,1,3,22466,22468,22471,2,5,0
6452,2,1,22468,22471,22472,3,4,0
6453,4,2,22472,22472,22474,0,2,0
6454,2,2,22474,22474,22476,0,2,0
6455,1,1,22475,22476,22477,1,2,0
6456,1,2,22476,22477,22479,1,3,0
6457,2,3,22478,22479,22482,1,4,0
6458,5,1,22483,22483,22484,0,1,1
6459,1,1,22484,22484,22485,0,1,0
6460,2,3,22486,22486,22489,0,3,1
6461,5,1,22491,22491,22492,0,1,2
6462,5,3,22496,22496,22499,0,3,4
6463,3,2,22499,22499,22501,0,2,0
6464,1,1,22500,22501,22502,1,2,0
6465,4,3,22504,22504,22507,0,3,2
6466,1,2,22505,22507,22509,2,4,0
6467,1,2,22506,22509,22511,3,5,0
6468,3,2,22509,22511,22513,2,4,0
6469,2,2,22511,22513,22515,2,4,0
6470,5,2,22516,22516,22518,0,2,1
6471,1,2,22517,22518,22520,1,3,0
6472,5,3,22522,22522,22525,0,3,2
6473,4,3,22526,22526,22529,0,3,1
6474,5,2,22531,22531,22533,0,2,2
6475,2,3,22533,22533,22536,0,3,0
6476,3,1,22536,22536,22537,0,1,0
6477,6,3,22542,22542,22545,0,3,5
6478,1,3,22543,22545,22548,2,5,0
6479,2,3,22545,22548,22551,3,6,0
6480,6,3,22551,22551,22554,0,3,0
6481,5,1,22556,22556,22557,0,1,2
6482,3,2,22559,22559,22561,0,2,2
6483,2,3,22561,22561,22564,0,3,0
6484,3,2,22564,22564,22566,0,2,0
6485,1,3,22565,22566,22569,1,4,0
6486,6,1,22571,22571,22572,0,1,2
6487,1,2,22572,22572,22574,0,2,0
6488,6,2,22578,22578,22580,0,2,4
6489,2,3,22580,22580,22583,0,3,0
6490,1,3,22581,22583,22586,2,5,0
6491,1,1,22582,22586,22587,4,5,0
6492,1,3,22583,22587,22590,4,7,0
6493,3,3,22586,22590,22593,4,7,0
6494,5,1,22591,22593,22594,2,3,0
6495,1,2,22592,22594,22596,2,4,0
6496,3,2,22595,22596,22598,1,3,0
6497,3,1,22598,22598,22599,0,1,0
6498,6,2,22604,22604,22606,0,2,5
6499,6,3,22610,22610,22613,0,3,4
6500,5,3,22615,22615,22618,0,3,2
6501,6,2,22621,22621,22623,0,2,3
6502,1,3,22622,22623,22626,1,4,0
6503,2,1,22624,22626,22627,2,3,0
6504,6,2,22630,22630,22632,0,2,3
6505,5,3,22635,22635,22638,0,3,3
6506,3,3,22638,22638,22641,0,3,0
6507,5,3,22643,22643,22646,0,3,2
6508,2,2,22645,22646,22648,1,3,0
6509,6,2,22651,22651,22653,0,2,3
6510,1,3,22652,22653,22656,1,4,0
6511,4,1,22656,22656,22657,0,1,0
6512,1,1,22657,22657,22658,0,1,0
6513,5,3,22662,22662,22665,0,3,4
6514,5,2,22667,22667,22669,0,2,2
6515,1,2,22668,22669,22671,1,3,0
6516,1,3,22669,22671,22674,2,5,0
6517,2,2,22671,22674,22676,3,5,0
6518,4,2,22675,22676,22678,1,3,0
6519,3,2,22678,22678,22680,0,2,0
6520,1,3,22679,22680,22683,1,4,0
6521,6,2,22685,22685,22687,0,2,2
6522,2,2,22687,22687,22689,0,2,0
6523,6,1,22693,22693,22694,0,1,4
6524,6,1,22699,22699,22700,0,1,5
6525,3,1,22702,22702,22703,0,1,2
6526,4,1,22706,22706,22707,0,1,3
6527,3,1,22709,22709,22710,0,1,2
6528,6,1,22715,22715,22716,0,1,5
6529,2,1,22717,22717,22718,0,1,1
6530,4,3,22721,22721,22724,0,3,3
6531,6,2,22727,22727,22729,0,2,3
6532,6,1,22733,22733,22734,0,1,4
6533,4,1,22737,22737,22738,0,1,3
6534,1,1,22738,22738,22739,0,1,0
6535,1,3,22739,22739,22742,0,3,0
6536,4,1,22743,22743,22744,0,1,1
6537,6,3,22749,22749,22752,0,3,5
6538,5,2,22754,22754,22756,0,2,2
6539,2,2,22756,22756,22758,0,2,0
6540,3,1,22759,22759,22760,0,1,1
6541,3,1,22762,22762,22763,0,1,2
6542,2,2,22764,22764,22766,0,2,1
6543,1,2,22765,22766,22768,1,3,0
6544,3,3,22768,22768,22771,0,3,0
6545,5,3,22773,22773,22776,0,3,2
6546,6,2,22779,22779,22781,0,2,3
6547,3,3,22782,22782,22785,0,3,1
6548,5,3,22787,22787,22790,0,3,2
6549,6,2,22793,22793,22795,0,2,3
6550,5,3,22798,22798,22801,0,3,3
6551,4,1,22802,22802,22803,0,1,1
6552,5,3,22807,22807,22810,0,3,4
6553,5,1,22812,22812,22813,0,1,2
6554,3,2,22815,22815,22817,0,2,2
6555,1,3,22816,22817,22820,1,4,0
6556,5,1,22821,22821,22822,0,1,1
6557,4,2,22825,22825,22827,0,2,3
6558,2,1,22827,22827,22828,0,1,0
6559,6,1,22833,22833,22834,0,1,5
6560,3,2,22836,22836,22838,0,2,2
6561,4,1,22840,22840,22841,0,1,2
6562,6,3,22846,22846,22849,0,3,5
6563,4,3,22850,22850,22853,0,3,1
6564,1,2,22851,22853,22855,2,4,0
6565,4,1,22855,22855,22856,0,1,0
6566,5,3,22860,22860,22863,0,3,4
6567,6,2,22866,22866,22868,0,2,3
6568,3,1,22869,22869,22870,0,1,1
6569,2,2,22871,22871,22873,0,2,1
6570,5,2,22876,22876,22878,0,2,3
6571,4,3,22880,22880,22883,0,3,2
6572,5,2,22885,22885,22887,0,2,2
6573,4,1,22889,22889,22890,0,1,2
6574,6,2,22895,22895,22897,0,2,5
6575,2,1,22897,22897,22898,0,1,0
6576,4,3,22901,22901,22904,0,3,3
6577,2,2,22903,22904,22906,1,3,0
6578,6,3,22909,22909,22912,0,3,3
6579,6,3,22915,22915,22918,0,3,3
6580,2,2,22917,22918,22920,1,3,0
6581,4,2,22921,22921,22923,0,2,1
6582,4,1,22925,22925,22926,0,1,2
6583,3,1,22928,22928,22929,0,1,2
6584,4,2,22932,22932,22934,0,2,3
6585,3,3,22935,22935,22938,0,3,1
6586,6,3,22941,22941,22944,0,3,3
6587,1,1,22942,22944,22945,2,3,0
6588,2,3,22944,22945,22948,1,4,0
6589,4,2,22948,22948,22950,0,2,0
6590,6,1,22954,22954,22955,0,1,4
6591,1,2,22955,22955,22957,0,2,0
6592,1,3,22956,22957,22960,1,4,0
6593,4,3,22960,22960,22963,0,3,0
6594,5,3,22965,22965,22968,0,3,2
6595,5,1,22970,22970,22971,0,1,2
6596,2,1,22972,22972,22973,0,1,1
6597,5,2,22977,22977,22979,0,2,4
6598,6,1,22983,22983,22984,0,1,4
6599,3,3,22986,22986,22989,0,3,2
6600,6,3,22992,22992,22995,0,3,3
6601,5,3,22997,22997,23000,0,3,2
6602,4,3,23001,23001,23004,0,3,1
6603,6,3,23007,23007,23010,0,3,3
6604,4,2,23011,23011,23013,0,2,1
6605,6,1,23017,23017,23018,0,1,4
6606,3,1,23020,23020,23021,0,1,2
6607,3,2,23023,23023,23025,0,2,2
6608,5,3,23028,23028,23031,0,3,3
6609,1,3,23029,23031,23034,2,5,0
6610,4,1,23033,23034,23035,1,2,0
6611,2,3,23035,23035,23038,0,3,0
6612,1,3,23036,23038,23041,2,5,0
6613,5,3,23041,23041,23044,0,3,0
6614,5,2,23046,23046,23048,0,2,2
6615,1,1,23047,23048,23049,1,2,0
6616,3,2,23050,23050,23052,0,2,1
6617,6,1,23056,23056,23057,0,1,4
6618,5,1,23061,23061,23062,0,1,4
6619,6,3,23067,23067,23070,0,3,5
6620,2,2,23069,23070,23072,1,3,0
6621,5,2,23074,23074,23076,0,2,2
6622,6,2,23080,23080,23082,0,2,4
6623,3,2,23083,23083,23085,0,2,1
6624,2,2,23085,23085,23087,0,2,0
6625,1,2,23086,23087,23089,1,3,0
6626,2,3,23088,23089,23092,1,4,0
6627,3,1,23091,23092,23093,1,2,0
6628,6,2,23097,23097,23099,0,2,4
6629,2,3,23099,23099,23102,0,3,0
6630,4,1,23103,23103,23104,0,1,1
6631,6,2,23109,23109,23111,0,2,5
6632,3,1,23112,23112,23113,0,1,1
6633,5,1,23117,23117,23118,0,1,4
6634,5,1,23122,23122,23123,0,1,4
6635,2,1,23124,23124,23125,0,1,1
6636,6,3,23130,23130,23133,0,3,5
6637,5,3,23135,23135,23138,0,3,2
6638,6,1,23141,23141,23142,0,1,3
6639,5,1,23146,23146,23147,0,1,4
6640,1,1,23147,23147,23148,0,1,0
6641,3,2,23150,23150,23152,0,2,2
6642,1,3,23151,23152,23155,1,4,0
6643,5,3,23156,23156,23159,0,3,1
6644,2,3,23158,23159,23162,1,4,0
6645,3,3,23161,23162,23165,1,4,0
6646,6,1,23167,23167,23168,0,1,2
6647,3,2,23170,23170,23172,0,2,2
6648,5,2,23175,23175,23177,0,2,3
6649,2,2,23177,23177,23179,0,2,0
6650,6,2,23183,23183,23185,0,2,4
6651,1,2,23184,23185,23187,1,3,0
6652,2,3,23186,23187,23190,1,4,0
6653,4,3,23190,23190,23193,0,3,0
6654,3,1,23193,23193,23194,0,1,0
6655,6,3,23199,23199,23202,0,3,5
6656,2,2,23201,23202,23204,1,3,0
6657,2,3,23203,23204,23207,1,4,0
6658,5,3,23208,23208,23211,0,3,1
6659,2,3,23210,23211,23214,1,4,0
6660,1,3,23211,23214,23217,3,6,0
6661,6,2,23217,23217,23219,0,2,0
6662,5,2,23222,23222,23224,0,2,3
6663,6,2,23228,23228,23230,0,2,4
6664,1,2,23229,23230,23232,1,3,0
6665,6,1,23235,23235,23236,0,1,3
6666,5,2,23240,23240,23242,0,2,4
6667,2,2,23242,23242,23244,0,2,0
6668,5,2,23247,23247,23249,0,2,3
6669,1,2,23248,23249,23251,1,3,0
6670,4,1,23252,23252,23253,0,1,1
6671,4,2,23256,23256,23258,0,2,3
6672,4,1,23260,23260,23261,0,1,2
6673,4,1,23264,23264,23265,0,1,3
6674,5,2,23269,23269,23271,0,2,4
6675,1,3,23270,23271,23274,1,4,0
6676,1,1,23271,23274,23275,3,4,0
6677,3,1,23274,23275,23276,1,2,0
6678,5,2,23279,23279,23281,0,2,3
6679,1,3,23280,23281,23284,1,4,0
6680,5,1,23285,23285,23286,0,1,1
6681,2,1,23287,23287,23288,0,1,1
6682,5,2,23292,23292,23294,0,2,4
6683,2,2,23294,23294,23296,0,2,0
6684,6,2,23300,23300,23302,0,2,4
6685,4,1,23304,23304,23305,0,1,2
6686,5,3,23309,23309,23312,0,3,4
6687,2,3,23311,23312,23315,1,4,0
6688,1,1,23312,23315,23316,3,4,0
6689,1,1,23313,23316,23317,3,4,0
6690,6,2,23319,23319,23321,0,2,2
6691,2,2,23321,23321,23323,0,2,0
6692,4,1,23325,23325,23326,0,1,2
6693,2,2,23327,23327,23329,0,2,1
6694,6,2,23333,23333,23335,0,2,4
6695,4,3,23337,23337,23340,0,3,2
6696,2,1,23339,23340,23341,1,2,0
6697,4,1,23343,23343,23344,0,1,2
6698,4,2,23347,23347,23349,0,2,3
6699,6,3,23353,23353,23356,0,3,4
6700,4,3,23357,23357,23360,0,3,1
6701,2,2,23359,23360,23362,1,3,0
6702,1,3,23360,23362,23365,2,5,0
6703,5,1,23365,23365,23366,0,1,0
6704,2,3,23367,23367,23370,0,3,1
6705,3,1,23370,23370,23371,0,1,0
6706,4,1,23374,23374,23375,0,1,3
6707,4,3,23378,23378,23381,0,3,3
6708,4,3,23382,23382,23385,0,3,1
6709,2,3,23384,23385,23388,1,4,0
6710,2,2,23386,23388,23390,2,4,0
6711,4,2,23390,23390,23392,0,2,0
6712,1,3,23391,23392,23395,1,4,0
6713,5,1,23396,23396,23397,0,1,1
6714,6,2,23402,23402,23404,0,2,5
6715,4,1,23406,23406,23407,0,1,2
6716,6,2,23412,23412,23414,0,2,5
6717,5,1,23417,23417,23418,0,1,3
6718,6,1,23423,23423,23424,0,1,5
6719,6,2,23429,23429,23431,0,2,5
6720,2,1,23431,23431,23432,0,1,0
6721,1,3,23432,23432,23435,0,3,0
6722,3,2,23435,23435,23437,0,2,0
6723,1,2,23436,23437,23439,1,3,0
6724,4,1,23440,23440,23441,0,1,1
6725,6,2,23446,23446,23448,0,2,5
6726,5,1,23451,23451,23452,0,1,3
6727,2,1,23453,23453,23454,0,1,1
6728,1,2,23454,23454,23456,0,2,0
6729,1,1,23455,23456,23457,1,2,0
6730,5,1,23460,23460,23461,0,1,3
6731,1,3,23461,23461,23464,0,3,0
6732,6,1,23467,23467,23468,0,1,3
6733,6,2,23473,23473,23475,0,2,5
6734,4,2,23477,23477,23479,0,2,2
6735,6,1,23483,23483,23484,0,1,4
6736,3,1,23486,23486,23487,0,1,2
6737,6,1,23492,23492,23493,0,1,5
6738,2,2,23494,23494,23496,0,2,1
6739,3,1,23497,23497,23498,0,1,1
6740,5,1,23502,23502,23503,0,1,4
6741,4,1,23506,23506,23507,0,1,3
6742,1,2,23507,23507,23509,0,2,0
6743,4,2,23511,23511,23513,0,2,2
6744,3,2,23514,23514,23516,0,2,1
6745,6,3,23520,23520,23523,0,3,4
6746,5,3,23525,23525,23528,0,3,2
6747,6,1,23531,23531,23532,0,1,3
6748,6,1,23537,23537,23538,0,1,5
6749,6,2,23543,23543,23545,0,2,5
6750,2,2,23545,23545,23547,0,2,0
6751,6,1,23551,23551,23552,0,1,4
6752,4,1,23555,23555,23556,0,1,3
6753,2,3,23557,23557,23560,0,3,1
6754,5,2,23562,23562,23564,0,2,2
6755,6,2,23568,23568,23570,0,2,4
6756,4,2,23572,23572,23574,0,2,2
6757,1,3,23573,23574,23577,1,4,0
6758,2,3,23575,23577,23580,2,5,0
6759,6,3,23581,23581,23584,0,3,1
6760,3,3,23584,23584,23587,0,3,0
6761,6,1,23590,23590,23591,0,1,3
6762,6,3,23596,23596,23599,0,3,5
6763,6,2,23602,23602,23604,0,2,3
6764,6,3,23608,23608,23611,0,3,4
6765,5,1,23613,23613,23614,0,1,2
6766,1,2,23614,23614,23616,0,2,0
6767,3,1,23617,23617,23618,0,1,1
6768,1,2,23618,23618,23620,0,2,0
6769,4,3,23622,23622,23625,0,3,2
6770,3,1,23625,23625,23626,0,1,0
6771,2,3,23627,23627,23630,0,3,1
6772,1,2,23628,23630,23632,2,4,0
6773,6,2,23634,23634,23636,0,2,2
6774,2,3,23636,23636,23639,0,3,0
6775,4,2,23640,23640,23642,0,2,1
6776,5,2,23645,23645,23647,0,2,3
6777,6,1,23651,23651,23652,0,1,4
6778,6,3,23657,23657,23660,0,3,5
6779,4,1,23661,23661,23662,0,1,1
6780,3,1,23664,23664,23665,0,1,2
6781,2,3,23666,23666,23669,0,3,1
6782,2,1,23668,23669,23670,1,2,0
6783,3,1,23671,23671,23672,0,1,1
6784,3,1,23674,23674,23675,0,1,2
6785,1,3,23675,23675,23678,0,3,0
6786,5,1,23680,23680,23681,0,1,2
6787,2,3,23682,23682,23685,0,3,1
6788,6,3,23688,23688,23691,0,3,3
6789,1,2,23689,23691,23693,2,4,0
6790,6,1,23695,23695,23696,0,1,2
6791,5,3,23700,23700,23703,0,3,4
6792,6,2,23706,23706,23708,0,2,3
6793,6,2,23712,23712,23714,0,2,4
6794,5,3,23717,23717,23720,0,3,3
6795,2,3,23719,23720,23723,1,4,0
6796,1,1,23720,23723,23724,3,4,0
6797,5,2,23725,23725,23727,0,2,1
6798,1,3,23726,23727,23730,1,4,0
6799,6,2,23732,23732,23734,0,2,2
6800,3,2,23735,23735,23737,0,2,1
6801,3,2,23738,23738,23740,0,2,1
6802,5,2,23743,23743,23745,0,2,3
6803,4,1,23747,23747,23748,0,1,2
6804,3,3,23750,23750,23753,0,3,2
6805,3,3,23753,23753,23756,0,3,0
6806,4,2,23757,23757,23759,0,2,1
6807,4,2,23761,23761,23763,0,2,2
6808,3,1,23764,23764,23765,0,1,1
6809,3,2,23767,23767,23769,0,2,2
6810,6,3,23773,23773,23776,0,3,4
6811,4,1,23777,23777,23778,0,1,1
6812,5,3,23782,23782,23785,0,3,4
6813,2,1,23784,23785,23786,1,2,0
6814,6,2,23790,23790,23792,0,2,4
6815,3,2,23793,23793,23795,0,2,1
6816,2,2,23795,23795,23797,0,2,0
6817,2,2,23797,23797,23799,0,2,0
6818,1,1,23798,23799,23800,1,2,0
6819,3,1,23801,23801,23802,0,1,1
6820,1,2,23802,23802,23804,0,2,0
6821,3,3,23805,23805,23808,0,3,1
6822,5,3,23810,23810,23813,0,3,2
6823,5,1,23815,23815,23816,0,1,2
6824,2,3,23817,23817,23820,0,3,1
6825,1,2,23818,23820,23822,2,4,0
6826,3,2,23821,23822,23824,1,3,0
6827,2,3,23823,23824,23827,1,4,0
6828,1,2,23824,23827,23829,3,5,0
6829,2,2,23826,23829,23831,3,5,0
6830,6,1,23832,23832,23833,0,1,1
6831,4,3,23836,23836,23839,0,3,3
6832,6,1,23842,23842,23843,0,1,3
6833,2,3,23844,23844,23847,0,3,1
6834,3,2,23847,23847,23849,0,2,0
6835,2,3,23849,23849,23852,0,3,0
6836,2,3,23851,23852,23855,1,4,0
6837,2,2,23853,23855,23857,2,4,0
6838,4,1,23857,23857,23858,0,1,0
6839,1,3,23858,23858,23861,0,3,0
6840,3,1,23861,23861,23862,0,1,0
6841,1,1,23862,23862,23863,0,1,0
6842,3,1,23865,23865,23866,0,1,2
6843,6,3,23871,23871,23874,0,3,5
6844,4,3,23875,23875,23878,0,3,1
6845,2,2,23877,23878,23880,1,3,0
6846,3,1,23880,23880,23881,0,1,0
6847,4,3,23884,23884,23887,0,3,3
6848,4,1,23888,23888,23889,0,1,1
6849,3,2,23891,23891,23893,0,2,2
6850,4,3,23895,23895,23898,0,3,2
6851,1,3,23896,23898,23901,2,5,0
6852,3,1,23899,23901,23902,2,3,0
6853,4,3,23903,23903,23906,0,3,1
6854,1,3,23904,23906,23909,2,5,0
6855,3,3,23907,23909,23912,2,5,0
6856,5,1,23912,23912,23913,0,1,0
6857,4,2,23916,23916,23918,0,2,3
6858,4,3,23920,23920,23923,0,3,2
6859,4,1,23924,23924,23925,0,1,1
6860,2,1,23926,23926,23927,0,1,1
6861,2,2,23928,23928,23930,0,2,1
6862,5,1,23933,23933,23934,0,1,3
6863,2,2,23935,23935,23937,0,2,1
6864,4,2,23939,23939,23941,0,2,2
6865,2,1,23941,23941,23942,0,1,0
6866,3,3,23944,23944,23947,0,3,2
6867,3,3,23947,23947,23950,0,3,0
6868,3,1,23950,23950,23951,0,1,0
6869,3,3,23953,23953,23956,0,3,2
6870,5,2,23958,23958,23960,0,2,2
6871,3,2,23961,23961,23963,0,2,1
6872,5,3,23966,23966,23969,0,3,3
6873,2,2,23968,23969,23971,1,3,0
6874,3,3,23971,23971,23974,0,3,0
6875,5,1,23976,23976,23977,0,1,2
6876,6,1,23982,23982,23983,0,1,5
6877,3,3,23985,23985,23988,0,3,2
6878,1,2,23986,23988,23990,2,4,0
6879,4,3,23990,23990,23993,0,3,0
6880,5,2,23995,23995,23997,0,2,2
6881,4,1,23999,23999,24000,0,1,2
6882,5,3,24004,24004,24007,0,3,4
6883,1,3,24005,24007,24010,2,5,0
6884,3,3,24008,24010,24013,2,5,0
6885,1,3,24009,24013,24016,4,7,0
6886,6,1,24015,24016,24017,1,2,0
6887,3,3,24018,24018,24021,0,3,1
6888,6,3,24024,24024,24027,0,3,3
6889,6,1,24030,24030,24031,0,1,3
6890,5,2,24035,24035,24037,0,2,4
6891,5,3,24040,24040,24043,0,3,3
6892,5,1,24045,24045,24046,0,1,2
6893,2,3,24047,24047,24050,0,3,1
6894,3,1,24050,24050,24051,0,1,0
6895,6,3,24056,24056,24059,0,3,5
6896,4,2,24060,24060,24062,0,2,1
6897,1,2,24061,24062,24064,1,3,0
6898,5,2,24066,24066,24068,0,2,2
6899,6,3,24072,24072,24075,0,3,4
6900,4,2,24076,24076,24078,0,2,1
6901,6,3,24082,24082,24085,0,3,4
6902,2,2,24084,24085,24087,1,3,0
6903,6,1,24090,24090,24091,0,1,3
6904,3,2,24093,24093,24095,0,2,2
6905,4,1,24097,24097,24098,0,1,2
6906,6,3,24103,24103,24106,0,3,5
6907,4,3,24107,24107,24110,0,3,1
6908,6,3,24113,24113,24116,0,3,3
6909,4,1,24117,24117,24118,0,1,1
6910,3,2,24120,24120,24122,0,2,2
6911,3,3,24123,24123,24126,0,3,1
6912,2,2,24125,24126,24128,1,3,0
6913,3,1,24128,24128,24129,0,1,0
6914,1,2,24129,24129,24131,0,2,0
6915,1,1,24130,24131,24132,1,2,0
6916,1,3,24131,24132,24135,1,4,0
6917,1,1,24132,24135,24136,3,4,0
6918,2,2,24134,24136,24138,2,4,0
6919,4,2,24138,24138,24140,0,2,0
6920,5,1,24143,24143,24144,0,1,3
6921,4,2,24147,24147,24149,0,2,3
6922,5,2,24152,24152,24154,0,2,3
6923,6,2,24158,24158,24160,0,2,4
6924,6,2,24164,24164,24166,0,2,4
6925,1,1,24165,24166,24167,1,2,0
6926,5,1,24170,24170,24171,0,1,3
6927,3,2,24173,24173,24175,0,2,2
6928,1,3,24174,24175,24178,1,4,0
6929,3,1,24177,24178,24179,1,2,0
6930,3,1,24180,24180,24181,0,1,1
6931,2,3,24182,24182,24185,0,3,1
6932,2,1,24184,24185,24186,1,2,0
6933,1,3,24185,24186,24189,1,4,0
6934,4,1,24189,24189,24190,0,1,0
6935,1,2,24190,24190,24192,0,2,0
6936,1,1,24191,24192,24193,1,2,0
6937,3,3,24194,24194,24197,0,3,1
6938,1,2,24195,24197,24199,2,4,0
6939,2,2,24197,24199,24201,2,4,0
6940,6,2,24203,24203,24205,0,2,2
6941,6,1,24209,24209,24210,0,1,4
6942,3,3,24212,24212,24215,0,3,2
6943,4,2,24216,24216,24218,0,2,1
6944,4,2,24220,24220,24222,0,2,2
6945,4,1,24224,24224,24225,0,1,2
6946,6,2,24230,24230,24232,0,2,5
6947,1,1,24231,24232,24233,1,2,0
6948,2,1,24233,24233,24234,0,1,0
6949,3,2,24236,24236,24238,0,2,2
6950,6,3,24242,24242,24245,0,3,4
6951,4,3,24246,24246,24249,0,3,1
6952,6,3,24252,24252,24255,0,3,3
6953,5,3,24257,24257,24260,0,3,2
6954,4,3,24261,24261,24264,0,3,1
6955,4,2,24265,24265,24267,0,2,1
6956,5,3,24270,24270,24273,0,3,3
6957,5,1,24275,24275,24276,0,1,2
6958,6,3,24281,24281,24284,0,3,5
6959,2,3,24283,24284,24287,1,4,0
6960,6,1,24289,24289,24290,0,1,2
6961,1,2,24290,24290,24292,0,2,0
6962,3,1,24293,24293,24294,0,1,1
6963,5,1,24298,24298,24299,0,1,4
6964,1,1,24299,24299,24300,0,1,0
6965,5,1,24304,24304,24305,0,1,4
6966,4,3,24308,24308,24311,0,3,3
6967,3,2,24311,24311,24313,0,2,0
6968,6,1,24317,24317,24318,0,1,4
6969,4,2,24321,24321,24323,0,2,3
6970,1,2,24322,24323,24325,1,3,0
6971,3,2,24325,24325,24327,0,2,0
6972,5,3,24330,24330,24333,0,3,3
6973,5,3,24335,24335,24338,0,3,2
6974,1,1,24336,24338,24339,2,3,0
6975,1,1,24337,24339,24340,2,3,0
6976,3,1,24340,24340,24341,0,1,0
6977,1,2,24341,24341,24343,0,2,0
6978,4,3,24345,24345,24348,0,3,2
6979,2,1,24347,24348,24349,1,2,0
6980,3,2,24350,24350,24352,0,2,1
6981,4,1,24354,24354,24355,0,1,2
6982,5,1,24359,24359,24360,0,1,4
6983,4,3,24363,24363,24366,0,3,3
6984,4,2,24367,24367,24369,0,2,1
6985,5,3,24372,24372,24375,0,3,3
6986,4,2,24376,24376,24378,0,2,1
6987,6,1,24382,24382,24383,0,1,4
6988,4,1,24386,24386,24387,0,1,3
6989,3,1,24389,24389,24390,0,1,2
6990,5,3,24394,24394,24397,0,3,4
6991,2,3,24396,24397,24400,1,4,0
6992,5,2,24401,24401,24403,0,2,1
6993,2,1,24403,24403,24404,0,1,0
6994,4,1,24407,24407,24408,0,1,3
6995,3,1,24410,24410,24411,0,1,2
6996,5,1,24415,24415,24416,0,1,4
6997,2,1,24417,24417,24418,0,1,1
6998,4,3,24421,24421,24424,0,3,3
6999,1,3,24422,24424,24427,2,5,0
7000,1,3,24423,24427,24430,4,7,0
7001,2,3,24425,24430,24433,5,8,0
7002,5,2,24430,24433,24435,3,5,0
7003,3,2,24433,24435,24437,2,4,0
7004,3,2,24436,24437,24439,1,3,0
7005,1,2,24437,24439,24441,2,4,0
7006,2,3,24439,24441,24444,2,5,0
7007,6,3,24445,24445,24448,0,3,1
7008,2,1,24447,24448,24449,1,2,0
7009,1,2,24448,24449,24451,1,3,0
7010,5,2,24453,24453,24455,0,2,2
7011,4,1,24457,24457,24458,0,1,2
7012,1,1,24458,24458,24459,0,1,0
7013,2,2,24460,24460,24462,0,2,1
7014,2,3,24462,24462,24465,0,3,0
7015,1,1,24463,24465,24466,2,3,0
7016,3,2,24466,24466,24468,0,2,0
7017,4,1,24470,24470,24471,0,1,2
7018,3,3,24473,24473,24476,0,3,2
7019,5,1,24478,24478,24479,0,1,2
7020,4,1,24482,24482,24483,0,1,3
7021,5,3,24487,24487,24490,0,3,4
7022,3,1,24490,24490,24491,0,1,0
7023,2,3,24492,24492,24495,0,3,1
7024,2,3,24494,24495,24498,1,4,0
7025,6,3,24500,24500,24503,0,3,2
7026,3,3,24503,24503,24506,0,3,0
7027,5,3,24508,24508,24511,0,3,2
7028,1,3,24509,24511,24514,2,5,0
7029,4,2,24513,24514,24516,1,3,0
7030,6,3,24519,24519,24522,0,3,3
7031,3,1,24522,24522,24523,0,1,0
7032,2,2,24524,24524,24526,0,2,1
7033,6,1,24530,24530,24531,0,1,4
7034,1,1,24531,24531,24532,0,1,0
7035,4,2,24535,24535,24537,0,2,3
7036,4,2,24539,24539,24541,0,2,2
7037,6,2,24545,24545,24547,0,2,4
7038,3,3,24548,24548,24551,0,3,1
7039,1,1,24549,24551,24552,2,3,0
7040,6,3,24555,24555,24558,0,3,3
7041,6,1,24561,24561,24562,0,1,3
7042,5,3,24566,24566,24569,0,3,4
7043,3,1,24569,24569,24570,0,1,0
7044,6,1,24575,24575,24576,0,1,5
7045,4,2,24579,24579,24581,0,2,3
7046,2,1,24581,24581,24582,0,1,0
7047,6,2,24587,24587,24589,0,2,5
7048,1,2,24588,24589,24591,1,3,0
7049,1,3,24589,24591,24594,2,5,0
7050,5,1,24594,24594,24595,0,1,0
7051,6,2,24600,24600,24602,0,2,5
7052,4,3,24604,24604,24607,0,3,2
7053,5,2,24609,24609,24611,0,2,2
7054,3,3,24612,24612,24615,0,3,1
7055,1,2,24613,24615,24617,2,4,0
7056,6,1,24619,24619,24620,0,1,2
7057,5,3,24624,24624,24627,0,3,4
7058,2,3,24626,24627,24630,1,4,0
7059,2,1,24628,24630,24631,2,3,0
7060,6,3,24634,24634,24637,0,3,3
7061,5,3,24639,24639,24642,0,3,2
7062,2,3,24641,24642,24645,1,4,0
7063,2,3,24643,24645,24648,2,5,0
7064,2,2,24645,24648,24650,3,5,0
7065,5,3,24650,24650,24653,0,3,0
7066,3,2,24653,24653,24655,0,2,0
7067,5,2,24658,24658,24660,0,2,3
7068,2,3,24660,24660,24663,0,3,0
7069,4,1,24664,24664,24665,0,1,1
7070,2,1,24666,24666,24667,0,1,1
7071,6,2,24672,24672,24674,0,2,5
7072,1,2,24673,24674,24676,1,3,0
7073,6,2,24679,24679,24681,0,2,3
7074,5,3,24684,24684,24687,0,3,3
7075,2,3,24686,24687,24690,1,4,0
7076,1,3,24687,24690,24693,3,6,0
7077,3,1,24690,24693,24694,3,4,0
7078,5,2,24695,24695,24697,0,2,1
7079,4,2,24699,24699,24701,0,2,2
7080,6,2,24705,24705,24707,0,2,4
7081,1,3,24706,24707,24710,1,4,0
7082,2,2,24708,24710,24712,2,4,0
7083,5,3,24713,24713,24716,0,3,1
7084,6,1,24719,24719,24720,0,1,3
7085,1,2,24720,24720,24722,0,2,0
7086,3,3,24723,24723,24726,0,3,1
7087,5,2,24728,24728,24730,0,2,2
7088,3,2,24731,24731,24733,0,2,1
7089,5,1,24736,24736,24737,0,1,3
7090,3,1,24739,24739,24740,0,1,2
7091,4,2,24743,24743,24745,0,2,3
7092,1,3,24744,24745,24748,1,4,0
7093,4,2,24748,24748,24750,0,2,0
7094,3,3,24751,24751,24754,0,3,1
7095,3,3,24754,24754,24757,0,3,0
7096,2,3,24756,24757,24760,1,4,0
7097,6,1,24762,24762,24763,0,1,2
7098,6,2,24768,24768,24770,0,2,5
7099,6,1,24774,24774,24775,0,1,4
7100,5,1,24779,24779,24780,0,1,4
7101,6,3,24785,24785,24788,0,3,5
7102,1,3,24786,24788,24791,2,5,0
7103,1,3,24787,24791,24794,4,7,0
7104,3,2,24790,24794,24796,4,6,0
7105,1,3,24791,24796,24799,5,8,0
7106,3,3,24794,24799,24802,5,8,0
7107,4,1,24798,24802,24803,4,5,0
7108,3,1,24801,24803,24804,2,3,0
7109,3,3,24804,24804,24807,0,3,0
7110,4,3,24808,24808,24811,0,3,1
7111,2,2,24810,24811,24813,1,3,0
7112,1,1,24811,24813,24814,2,3,0
7113,4,3,24815,24815,24818,0,3,1
7114,6,1,24821,24821,24822,0,1,3
7115,4,2,24825,24825,24827,0,2,3
7116,5,2,24830,24830,24832,0,2,3
7117,5,1,24835,24835,24836,0,1,3
7118,6,2,24841,24841,24843,0,2,5
7119,1,3,24842,24843,24846,1,4,0
7120,2,3,24844,24846,24849,2,5,0
7121,4,2,24848,24849,24851,1,3,0
7122,4,3,24852,24852,24855,0,3,1
7123,3,1,24855,24855,24856,0,1,0
7124,1,2,24856,24856,24858,0,2,0
7125,5,3,24861,24861,24864,0,3,3
7126,4,1,24865,24865,24866,0,1,1
7127,3,1,24868,24868,24869,0,1,2
7128,3,3,24871,24871,24874,0,3,2
7129,5,3,24876,24876,24879,0,3,2
7130,3,3,24879,24879,24882,0,3,0
7131,6,1,24885,24885,24886,0,1,3
7132,1,2,24886,24886,24888,0,2,0
7133,1,1,24887,24888,24889,1,2,0
7134,5,1,24892,24892,24893,0,1,3
7135,1,2,24893,24893,24895,0,2,0
7136,3,1,24896,24896,24897,0,1,1
7137,5,2,24901,24901,24903,0,2,4
7138,5,2,24906,24906,24908,0,2,3
7139,2,2,24908,24908,24910,0,2,0
7140,5,2,24913,24913,24915,0,2,3
7141,3,3,24916,24916,24919,0,3,1
7142,1,3,24917,24919,24922,2,5,0
7143,6,3,24923,24923,24926,0,3,1
7144,1,3,24924,24926,24929,2,5,0
7145,3,1,24927,24929,24930,2,3,0
7146,5,3,24932,24932,24935,0,3,2
7147,5,2,24937,24937,24939,0,2,2
7148,6,3,24943,24943,24946,0,3,4
7149,4,2,24947,24947,24949,0,2,1
7150,3,3,24950,24950,24953,0,3,1
7151,4,1,24954,24954,24955,0,1,1
7152,2,2,24956,24956,24958,0,2,1
7153,5,3,24961,24961,24964,0,3,3
7154,3,1,24964,24964,24965,0,1,0
7155,5,3,24969,24969,24972,0,3,4
7156,3,2,24972,24972,24974,0,2,0
7157,1,1,24973,24974,24975,1,2,0
7158,2,1,24975,24975,24976,0,1,0
7159,2,2,24977,24977,24979,0,2,1
7160,5,1,24982,24982,24983,0,1,3
7161,2,1,24984,24984,24985,0,1,1
7162,4,1,24988,24988,24989,0,1,3
7163,4,1,24992,24992,24993,0,1,3
7164,1,2,24993,24993,24995,0,2,0
7165,5,1,24998,24998,24999,0,1,3
7166,1,2,24999,24999,25001,0,2,0
7167,4,3,25003,25003,25006,0,3,2
7168,5,2,25008,25008,25010,0,2,2
7169,5,2,25013,25013,25015,0,2,3
7170,3,3,25016,25016,25019,0,3,1
7171,2,3,25018,25019,25022,1,4,0
7172,2,2,25020,25022,25024,2,4,0
7173,6,1,25026,25026,25027,0,1,2
7174,2,2,25028,25028,25030,0,2,1
7175,6,2,25034,25034,25036,0,2,4
7176,3,1,25037,25037,25038,0,1,1
7177,6,2,25043,25043,25045,0,2,5
7178,6,3,25049,25049,25052,0,3,4
7179,4,3,25053,25053,25056,0,3,1
7180,3,1,25056,25056,25057,0,1,0
7181,6,1,25062,25062,25063,0,1,5
7182,4,3,25066,25066,25069,0,3,3
7183,4,2,25070,25070,25072,0,2,1
7184,6,2,25076,25076,25078,0,2,4
7185,4,1,25080,25080,25081,0,1,2
7186,4,1,25084,25084,25085,0,1,3
7187,4,1,25088,25088,25089,0,1,3
7188,6,3,25094,25094,25097,0,3,5
7189,4,3,25098,25098,25101,0,3,1
7190,5,1,25103,25103,25104,0,1,2
7191,5,1,25108,25108,25109,0,1,4
7192,3,1,25111,25111,25112,0,1,2
7193,2,2,25113,25113,25115,0,2,1
7194,3,1,25116,25116,25117,0,1,1
7195,3,1,25119,25119,25120,0,1,2
7196,6,3,25125,25125,25128,0,3,5
7197,5,2,25130,25130,25132,0,2,2
7198,4,1,25134,25134,25135,0,1,2
7199,6,2,25140,25140,25142,0,2,5
7200,2,2,25142,25142,25144,0,2,0
7201,5,2,25147,25147,25149,0,2,3
7202,2,2,25149,25149,25151,0,2,0
7203,3,1,25152,25152,25153,0,1,1
7204,2,2,25154,25154,25156,0,2,1
7205,1,1,25155,25156,25157,1,2,0
7206,6,2,25161,25161,25163,0,2,4
7207,5,3,25166,25166,25169,0,3,3
7208,1,3,25167,25169,25172,2,5,0
7209,1,2,25168,25172,25174,4,6,0
7210,5,2,25173,25174,25176,1,3,0
7211,1,1,25174,25176,25177,2,3,0
7212,1,1,25175,25177,25178,2,3,0
7213,5,1,25180,25180,25181,0,1,2
7214,4,1,25184,25184,25185,0,1,3
7215,4,3,25188,25188,25191,0,3,3
7216,5,1,25193,25193,25194,0,1,2
7217,3,1,25196,25196,25197,0,1,2
7218,6,3,25202,25202,25205,0,3,5
7219,4,2,25206,25206,25208,0,2,1
7220,5,1,25211,25211,25212,0,1,3
7221,4,2,25215,25215,25217,0,2,3
7222,5,2,25220,25220,25222,0,2,3
7223,5,2,25225,25225,25227,0,2,3
7224,1,1,25226,25227,25228,1,2,0
7225,1,1,25227,25228,25229,1,2,0
7226,1,3,25228,25229,25232,1,4,0
7227,1,1,25229,25232,25233,3,4,0
7228,2,3,25231,25233,25236,2,5,0
7229,3,2,25234,25236,25238,2,4,0
7230,3,3,25237,25238,25241,1,4,0
7231,1,2,25238,25241,25243,3,5,0
7232,4,2,25242,25243,25245,1,3,0
7233,3,2,25245,25245,25247,0,2,0
7234,2,1,25247,25247,25248,0,1,0
7235,1,3,25248,25248,25251,0,3,0
7236,4,2,25252,25252,25254,0,2,1
7237,5,1,25257,25257,25258,0,1,3
7238,6,3,25263,25263,25266,0,3,5
7239,3,1,25266,25266,25267,0,1,0
7240,3,2,25269,25269,25271,0,2,2
7241,5,3,25274,25274,25277,0,3,3
7242,1,3,25275,25277,25280,2,5,0
7243,2,3,25277,25280,25283,3,6,0
7244,6,3,25283,25283,25286,0,3,0
7245,6,2,25289,25289,25291,0,2,3
7246,3,2,25292,25292,25294,0,2,1
7247,4,2,25296,25296,25298,0,2,2
7248,1,1,25297,25298,25299,1,2,0
7249,2,2,25299,25299,25301,0,2,0
7250,1,1,25300,25301,25302,1,2,0
7251,4,3,25304,25304,25307,0,3,2
7252,6,2,25310,25310,25312,0,2,3
7253,4,1,25314,25314,25315,0,1,2
7254,6,1,25320,25320,25321,0,1,5
7255,1,2,25321,25321,25323,0,2,0
7256,6,3,25327,25327,25330,0,3,4
7257,3,2,25330,25330,25332,0,2,0
7258,2,1,25332,25332,25333,0,1,0
7259,3,1,25335,25335,25336,0,1,2
7260,3,3,25338,25338,25341,0,3,2
7261,5,1,25343,25343,25344,0,1,2
7262,2,2,25345,25345,25347,0,2,1
7263,3,1,25348,25348,25349,0,1,1
7264,2,1,25350,25350,25351,0,1,1
7265,1,3,25351,25351,25354,0,3,0
7266,3,2,25354,25354,25356,0,2,0
7267,6,1,25360,25360,25361,0,1,4
7268,1,3,25361,25361,25364,0,3,0
7269,4,3,25365,25365,25368,0,3,1
7270,3,1,25368,25368,25369,0,1,0
7271,5,2,25373,25373,25375,0,2,4
7272,1,2,25374,25375,25377,1,3,0
7273,6,1,25380,25380,25381,0,1,3
7274,5,3,25385,25385,25388,0,3,4
7275,2,1,25387,25388,25389,1,2,0
7276,3,2,25390,25390,25392,0,2,1
7277,4,2,25394,25394,25396,0,2,2
7278,5,2,25399,25399,25401,0,2,3
7279,4,3,25403,25403,25406,0,3,2
7280,5,3,25408,25408,25411,0,3,2
7281,2,2,25410,25411,25413,1,3,0
7282,6,1,25416,25416,25417,0,1,3
7283,6,2,25422,25422,25424,0,2,5
7284,5,2,25427,25427,25429,0,2,3
7285,4,1,25431,25431,25432,0,1,2
7286,4,2,25435,25435,25437,0,2,3
7287,5,3,25440,25440,25443,0,3,3
7288,5,2,25445,25445,25447,0,2,2
7289,5,3,25450,25450,25453,0,3,3
7290,6,1,25456,25456,25457,0,1,3
7291,1,2,25457,25457,25459,0,2,0
7292,3,1,25460,25460,25461,0,1,1
7293,3,1,25463,25463,25464,0,1,2
7294,4,2,25467,25467,25469,0,2,3
7295,2,1,25469,25469,25470,0,1,0
7296,5,3,25474,25474,25477,0,3,4
7297,3,1,25477,25477,25478,0,1,0
7298,4,1,25481,25481,25482,0,1,3
7299,5,2,25486,25486,25488,0,2,4
7300,2,2,25488,25488,25490,0,2,0
7301,6,2,25494,25494,25496,0,2,4
7302,5,1,25499,25499,25500,0,1,3
7303,1,3,25500,25500,25503,0,3,0
7304,2,3,25502,25503,25506,1,4,0
7305,5,2,25507,25507,25509,0,2,1
7306,3,1,25510,25510,25511,0,1,1
7307,6,1,25516,25516,25517,0,1,5
7308,2,2,25518,25518,25520,0,2,1
7309,1,3,25519,25520,25523,1,4,0
7310,1,1,25520,25523,25524,3,4,0
7311,5,2,25525,25525,25527,0,2,1
7312,6,3,25531,25531,25534,0,3,4
7313,5,1,25536,25536,25537,0,1,2
7314,2,3,25538,25538,25541,0,3,1
7315,5,2,25543,25543,25545,0,2,2
7316,3,2,25546,25546,25548,0,2,1
7317,2,3,25548,25548,25551,0,3,0
7318,4,2,25552,25552,25554,0,2,1
7319,1,1,25553,25554,25555,1,2,0
7320,1,2,25554,25555,25557,1,3,0
7321,6,2,25560,25560,25562,0,2,3
7322,4,1,25564,25564,25565,0,1,2
7323,1,2,25565,25565,25567,0,2,0
7324,6,3,25571,25571,25574,0,3,4
7325,1,2,25572,25574,25576,2,4,0
7326,1,3,25573,25576,25579,3,6,0
7327,5,3,25578,25579,25582,1,4,0
7328,4,1,25582,25582,25583,0,1,0
7329,2,1,25584,25584,25585,0,1,1
7330,3,1,25587,25587,25588,0,1,2
7331,6,3,25593,25593,25596,0,3,5
7332,6,1,25599,25599,25600,0,1,3
7333,3,1,25602,25602,25603,0,1,2
7334,4,1,25606,25606,25607,0,1,3
7335,3,2,25609,25609,25611,0,2,2
7336,2,2,25611,25611,25613,0,2,0
7337,6,3,25617,25617,25620,0,3,4
7338,3,1,25620,25620,25621,0,1,0
7339,3,3,25623,25623,25626,0,3,2
7340,2,2,25625,25626,25628,1,3,0
7341,6,1,25631,25631,25632,0,1,3
7342,3,2,25634,25634,25636,0,2,2
7343,2,1,25636,25636,25637,0,1,0
7344,6,2,25642,25642,25644,0,2,5
7345,1,1,25643,25644,25645,1,2,0
7346,4,1,25647,25647,25648,0,1,2
7347,2,3,25649,25649,25652,0,3,1
7348,4,2,25653,25653,25655,0,2,1
7349,3,2,25656,25656,25658,0,2,1
7350,4,2,25660,25660,25662,0,2,2
7351,6,2,25666,25666,25668,0,2,4
7352,2,1,25668,25668,25669,0,1,0
7353,1,2,25669,25669,25671,0,2,0
7354,1,2,25670,25671,25673,1,3,0
7355,6,2,25676,25676,25678,0,2,3
7356,6,3,25682,25682,25685,0,3,4
7357,4,1,25686,25686,25687,0,1,1
7358,4,2,25690,25690,25692,0,2,3
7359,4,3,25694,25694,25697,0,3,2
7360,2,3,25696,25697,25700,1,4,0
7361,5,2,25701,25701,25703,0,2,1
7362,5,3,25706,25706,25709,0,3,3
7363,6,3,25712,25712,25715,0,3,3
7364,4,2,25716,25716,25718,0,2,1
7365,4,2,25720,25720,25722,0,2,2
7366,5,3,25725,25725,25728,0,3,3
7367,3,2,25728,25728,25730,0,2,0
7368,1,1,25729,25730,25731,1,2,0
7369,1,3,25730,25731,25734,1,4,0
7370,4,3,25734,25734,25737,0,3,0
7371,3,3,25737,25737,25740,0,3,0
7372,5,1,25742,25742,25743,0,1,2
7373,4,2,25746,25746,25748,0,2,3
7374,5,2,25751,25751,25753,0,2,3
7375,2,2,25753,25753,25755,0,2,0
7376,1,3,25754,25755,25758,1,4,0
7377,6,2,25760,25760,25762,0,2,2
7378,5,1,25765,25765,25766,0,1,3
7379,1,2,25766,25766,25768,0,2,0
7380,3,2,25769,25769,25771,0,2,1
7381,6,3,25775,25775,25778,0,3,4
7382,4,3,25779,25779,25782,0,3,1
7383,3,1,25782,25782,25783,0,1,0
7384,3,1,25785,25785,25786,0,1,2
7385,5,1,25790,25790,25791,0,1,4
7386,6,2,25796,25796,25798,0,2,5
7387,3,1,25799,25799,25800,0,1,1
7388,5,3,25804,25804,25807,0,3,4
7389,5,1,25809,25809,25810,0,1,2
7390,5,2,25814,25814,25816,0,2,4
7391,1,2,25815,25816,25818,1,3,0
7392,1,2,25816,25818,25820,2,4,0
7393,4,2,25820,25820,25822,0,2,0
7394,5,3,25825,25825,25828,0,3,3
7395,5,2,25830,25830,25832,0,2,2
7396,5,3,25835,25835,25838,0,3,3
7397,3,3,25838,25838,25841,0,3,0
7398,2,2,25840,25841,25843,1,3,0
7399,5,3,25845,25845,25848,0,3,2
7400,1,1,25846,25848,25849,2,3,0
7401,5,3,25851,25851,25854,0,3,2
7402,6,1,25857,25857,25858,0,1,3
7403,1,1,25858,25858,25859,0,1,0
7404,6,1,25864,25864,25865,0,1,5
7405,5,3,25869,25869,25872,0,3,4
7406,1,2,25870,25872,25874,2,4,0
7407,6,2,25876,25876,25878,0,2,2
7408,2,3,25878,25878,25881,0,3,0
7409,6,3,25884,25884,25887,0,3,3
7410,5,3,25889,25889,25892,0,3,2
7411,3,2,25892,25892,25894,0,2,0
7412,3,3,25895,25895,25898,0,3,1
7413,5,1,25900,25900,25901,0,1,2
7414,3,3,25903,25903,25906,0,3,2
7415,6,3,25909,25909,25912,0,3,3
7416,1,1,25910,25912,25913,2,3,0
7417,5,1,25915,25915,25916,0,1,2
7418,3,3,25918,25918,25921,0,3,2
7419,4,1,25922,25922,25923,0,1,1
7420,5,1,25927,25927,25928,0,1,4
7421,1,2,25928,25928,25930,0,2,0
7422,2,1,25930,25930,25931,0,1,0
7423,4,1,25934,25934,25935,0,1,3
7424,2,2,25936,25936,25938,0,2,1
7425,2,3,25938,25938,25941,0,3,0
7426,3,3,25941,25941,25944,0,3,0
7427,2,2,25943,25944,25946,1,3,0
7428,3,3,25946,25946,25949,0,3,0
7429,6,3,25952,25952,25955,0,3,3
7430,6,1,25958,25958,25959,0,1,3
7431,2,1,25960,25960,25961,0,1,1
7432,6,1,25966,25966,25967,0,1,5
7433,5,2,25971,25971,25973,0,2,4
7434,6,3,25977,25977,25980,0,3,4
7435,2,2,25979,25980,25982,1,3,0
7436,6,2,25985,25985,25987,0,2,3
7437,6,3,25991,25991,25994,0,3,4
7438,4,1,25995,25995,25996,0,1,1
7439,2,1,25997,25997,25998,0,1,1
7440,1,3,25998,25998,26001,0,3,0
7441,5,2,26003,26003,26005,0,2,2
7442,4,2,26007,26007,26009,0,2,2
7443,1,1,26008,26009,26010,1,2,0
7444,3,3,26011,26011,26014,0,3,1
7445,2,1,26013,26014,26015,1,2,0
7446,6,1,26019,26019,26020,0,1,4
7447,3,3,26022,26022,26025,0,3,2
7448,3,1,26025,26025,26026,0,1,0
7449,2,2,26027,26027,26029,0,2,1
7450,6,1,26033,26033,26034,0,1,4
7451,6,2,26039,26039,26041,0,2,5
7452,4,2,26043,26043,26045,0,2,2
7453,6,3,26049,26049,26052,0,3,4
7454,2,1,26051,26052,26053,1,2,0
7455,4,1,26055,26055,26056,0,1,2
7456,5,1,26060,26060,26061,0,1,4
7457,2,1,26062,26062,26063,0,1,1
7458,2,2,26064,26064,26066,0,2,1
7459,3,1,26067,26067,26068,0,1,1
7460,1,2,26068,26068,26070,0,2,0
7461,3,3,26071,26071,26074,0,3,1
7462,1,1,26072,26074,26075,2,3,0
7463,6,2,26078,26078,26080,0,2,3
7464,2,2,26080,26080,26082,0,2,0
7465,1,2,26081,26082,26084,1,3,0
7466,3,3,26084,26084,26087,0,3,0
7467,4,2,26088,26088,26090,0,2,1
7468,4,1,26092,26092,26093,0,1,2
7469,5,1,26097,26097,26098,0,1,4
7470,1,1,26098,26098,26099,0,1,0
7471,2,2,26100,26100,26102,0,2,1
7472,3,3,26103,26103,26106,0,3,1
7473,4,3,26107,26107,26110,0,3,1
7474,1,1,26108,26110,26111,2,3,0
7475,1,2,26109,26111,26113,2,4,0
7476,2,3,26111,26113,26116,2,5,0
7477,4,3,26115,26116,26119,1,4,0
7478,2,1,26117,26119,26120,2,3,0
7479,3,1,26120,26120,26121,0,1,0
7480,2,3,26122,26122,26125,0,3,1
7481,4,1,26126,26126,26127,0,1,1
7482,5,2,26131,26131,26133,0,2,4
7483,6,3,26137,26137,26140,0,3,4
7484,4,1,26141,26141,26142,0,1,1
7485,2,1,26143,26143,26144,0,1,1
7486,6,3,26149,26149,26152,0,3,5
7487,1,3,26150,26152,26155,2,5,0
7488,2,1,26152,26155,26156,3,4,0
7489,6,2,26158,26158,26160,0,2,2
7490,4,1,26162,26162,26163,0,1,2
7491,2,2,26164,26164,26166,0,2,1
7492,1,3,26165,26166,26169,1,4,0
7493,4,1,26169,26169,26170,0,1,0
7494,6,2,26175,26175,26177,0,2,5
7495,6,2,26181,26181,26183,0,2,4
7496,2,1,26183,26183,26184,0,1,0
7497,5,1,26188,26188,26189,0,1,4
7498,5,1,26193,26193,26194,0,1,4
7499,3,2,26196,26196,26198,0,2,2
7500,2,1,26198,26198,26199,0,1,0
7501,4,3,26202,26202,26205,0,3,3
7502,1,2,26203,26205,26207,2,4,0
7503,5,2,26208,26208,26210,0,2,1
7504,3,3,26211,26211,26214,0,3,1
7505,3,2,26214,26214,26216,0,2,0
7506,5,3,26219,26219,26222,0,3,3
7507,6,2,26225,26225,26227,0,2,3
7508,3,1,26228,26228,26229,0,1,1
7509,3,3,26231,26231,26234,0,3,2
7510,3,3,26234,26234,26237,0,3,0
7511,2,3,26236,26237,26240,1,4,0
7512,5,2,26241,26241,26243,0,2,1
7513,6,1,26247,26247,26248,0,1,4
7514,2,3,26249,26249,26252,0,3,1
7515,6,2,26255,26255,26257,0,2,3
7516,6,1,26261,26261,26262,0,1,4
7517,3,2,26264,26264,26266,0,2,2
7518,2,1,26266,26266,26267,0,1,0
7519,4,3,26270,26270,26273,0,3,3
7520,1,2,26271,26273,26275,2,4,0
7521,5,3,26276,26276,26279,0,3,1
7522,3,3,26279,26279,26282,0,3,0
7523,6,3,26285,26285,26288,0,3,3
7524,2,2,26287,26288,26290,1,3,0
7525,1,1,26288,26290,26291,2,3,0
7526,4,2,26292,26292,26294,0,2,1
7527,5,3,26297,26297,26300,0,3,3
7528,1,1,26298,26300,26301,2,3,0
7529,2,2,26300,26301,26303,1,3,0
7530,5,2,26305,26305,26307,0,2,2
7531,4,3,26309,26309,26312,0,3,2
7532,6,2,26315,26315,26317,0,2,3
7533,6,3,26321,26321,26324,0,3,4
7534,2,2,26323,26324,26326,1,3,0
7535,4,3,26327,26327,26330,0,3,1
7536,5,1,26332,26332,26333,0,1,2
7537,3,3,26335,26335,26338,0,3,2
7538,4,3,26339,26339,26342,0,3,1
7539,3,2,26342,26342,26344,0,2,0
7540,6,1,26348,26348,26349,0,1,4
7541,4,2,26352,26352,26354,0,2,3
7542,2,1,26354,26354,26355,0,1,0
7543,4,2,26358,26358,26360,0,2,3
7544,1,3,26359,26360,26363,1,4,0
7545,6,1,26365,26365,26366,0,1,2
7546,2,3,26367,26367,26370,0,3,1
7547,2,3,26369,26370,26373,1,4,0
7548,2,2,26371,26373,26375,2,4,0
7549,1,3,26372,26375,26378,3,6,0
7550,1,3,26373,26378,26381,5,8,0
7551,1,3,26374,26381,26384,7,10,0
7552,2,1,26376,26384,26385,8,9,0
7553,2,1,26378,26385,26386,7,8,0
7554,6,3,26384,26386,26389,2,5,0
7555,4,1,26388,26389,26390,1,2,0
7556,1,3,26389,26390,26393,1,4,0
7557,5,2,26394,26394,26396,0,2,1
7558,4,1,26398,26398,26399,0,1,2
7559,4,1,26402,26402,26403,0,1,3
7560,3,2,26405,26405,26407,0,2,2
7561,2,2,26407,26407,26409,0,2,0
7562,1,2,26408,26409,26411,1,3,0
7563,6,1,26414,26414,26415,0,1,3
7564,2,2,26416,26416,26418,0,2,1
7565,4,3,26420,26420,26423,0,3,2
7566,1,3,26421,26423,26426,2,5,0
7567,5,3,26426,26426,26429,0,3,0
7568,5,3,26431,26431,26434,0,3,2
7569,1,2,26432,26434,26436,2,4,0
7570,4,1,26436,26436,26437,0,1,0
7571,1,3,26437,26437,26440,0,3,0
7572,2,1,26439,26440,26441,1,2,0
7573,1,3,26440,26441,26444,1,4,0
7574,1,2,26441,26444,26446,3,5,0
7575,6,3,26447,26447,26450,0,3,1
7576,6,2,26453,26453,26455,0,2,3
7577,4,1,26457,26457,26458,0,1,2
7578,6,3,26463,26463,26466,0,3,5
7579,3,2,26466,26466,26468,0,2,0
7580,4,1,26470,26470,26471,0,1,2
7581,1,3,26471,26471,26474,0,3,0
7582,5,3,26476,26476,26479,0,3,2
7583,1,3,26477,26479,26482,2,5,0
7584,4,3,26481,26482,26485,1,4,0
7585,1,1,26482,26485,26486,3,4,0
7586,6,3,26488,26488,26491,0,3,2
7587,3,2,26491,26491,26493,0,2,0
7588,5,3,26496,26496,26499,0,3,3
7589,2,1,26498,26499,26500,1,2,0
7590,5,2,26503,26503,26505,0,2,3
7591,3,1,26506,26506,26507,0,1,1
7592,2,3,26508,26508,26511,0,3,1
7593,4,3,26512,26512,26515,0,3,1
7594,4,3,26516,26516,26519,0,3,1
7595,3,2,26519,26519,26521,0,2,0
7596,4,2,26523,26523,26525,0,2,2
7597,6,2,26529,26529,26531,0,2,4
7598,3,3,26532,26532,26535,0,3,1
7599,6,2,26538,26538,26540,0,2,3
7600,5,3,26543,26543,26546,0,3,3
7601,3,2,26546,26546,26548,0,2,0
7602,1,1,26547,26548,26549,1,2,0
7603,4,2,26551,26551,26553,0,2,2
7604,5,2,26556,26556,26558,0,2,3
7605,4,1,26560,26560,26561,0,1,2
7606,2,3,26562,26562,26565,0,3,1
7607,2,1,26564,26565,26566,1,2,0
7608,2,2,26566,26566,26568,0,2,0
7609,2,1,26568,26568,26569,0,1,0
7610,3,1,26571,26571,26572,0,1,2
7611,6,3,26577,26577,26580,0,3,5
7612,1,3,26578,26580,26583,2,5,0
7613,4,3,26582,26583,26586,1,4,0
7614,6,3,26588,26588,26591,0,3,2
7615,6,2,26594,26594,26596,0,2,3
7616,4,2,26598,26598,26600,0,2,2
7617,3,2,26601,26601,26603,0,2,1
7618,1,2,26602,26603,26605,1,3,0
7619,6,1,26608,26608,26609,0,1,3
7620,6,3,26614,26614,26617,0,3,5
7621,6,2,26620,26620,26622,0,2,3
7622,3,2,26623,26623,26625,0,2,1
7623,6,3,26629,26629,26632,0,3,4
7624,5,3,26634,26634,26637,0,3,2
7625,1,1,26635,26637,26638,2,3,0
7626,5,1,26640,26640,26641,0,1,2
7627,4,1,26644,26644,26645,0,1,3
7628,3,1,26647,26647,26648,0,1,2
7629,4,2,26651,26651,26653,0,2,3
7630,4,2,26655,26655,26657,0,2,2
7631,4,2,26659,26659,26661,0,2,2
7632,1,1,26660,26661,26662,1,2,0
7633,2,3,26662,26662,26665,0,3,0
7634,2,3,26664,26665,26668,1,4,0
7635,1,1,26665,26668,26669,3,4,0
7636,1,1,26666,26669,26670,3,4,0
7637,4,3,26670,26670,26673,0,3,0
7638,4,1,26674,26674,26675,0,1,1
7639,3,2,26677,26677,26679,0,2,2
7640,5,3,26682,26682,26685,0,3,3
7641,5,3,26687,26687,26690,0,3,2
7642,6,2,26693,26693,26695,0,2,3
7643,6,2,26699,26699,26701,0,2,4
7644,2,3,26701,26701,26704,0,3,0
7645,2,3,26703,26704,26707,1,4,0
7646,4,1,26707,26707,26708,0,1,0
7647,5,1,26712,26712,26713,0,1,4
7648,4,2,26716,26716,26718,0,2,3
7649,5,2,26721,26721,26723,0,2,3
7650,4,3,26725,26725,26728,0,3,2
7651,3,2,26728,26728,26730,0,2,0
7652,4,2,26732,26732,26734,0,2,2
7653,1,3,26733,26734,26737,1,4,0
7654,4,3,26737,26737,26740,0,3,0
7655,2,3,26739,26740,26743,1,4,0
7656,1,1,26740,26743,26744,3,4,0
7657,5,1,26745,26745,26746,0,1,1
7658,1,2,26746,26746,26748,0,2,0
7659,3,3,26749,26749,26752,0,3,1
7660,6,3,26755,26755,26758,0,3,3
7661,1,2,26756,26758,26760,2,4,0
7662,2,3,26758,26760,26763,2,5,0
7663,6,3,26764,26764,26767,0,3,1
7664,1,2,26765,26767,26769,2,4,0
7665,1,2,26766,26769,26771,3,5,0
7666,1,2,26767,26771,26773,4,6,0
7667,5,3,26772,26773,26776,1,4,0
7668,4,2,26776,26776,26778,0,2,0
7669,3,3,26779,26779,26782,0,3,1
7670,5,2,26784,26784,26786,0,2,2
7671,4,2,26788,26788,26790,0,2,2
7672,5,3,26793,26793,26796,0,3,3
7673,6,1,26799,26799,26800,0,1,3
7674,5,2,26804,26804,26806,0,2,4
7675,2,3,26806,26806,26809,0,3,0
7676,3,2,26809,26809,26811,0,2,0
7677,1,1,26810,26811,26812,1,2,0
7678,6,3,26816,26816,26819,0,3,4
7679,4,2,26820,26820,26822,0,2,1
7680,5,3,26825,26825,26828,0,3,3
7681,3,3,26828,26828,26831,0,3,0
7682,6,3,26834,26834,26837,0,3,3
7683,1,1,26835,26837,26838,2,3,0
7684,4,1,26839,26839,26840,0,1,1
7685,3,2,26842,26842,26844,0,2,2
7686,2,3,26844,26844,26847,0,3,0
7687,2,3,26846,26847,26850,1,4,0
7688,2,1,26848,26850,26851,2,3,0
7689,1,2,26849,26851,26853,2,4,0
7690,3,1,26852,26853,26854,1,2,0
7691,4,3,26856,26856,26859,0,3,2
7692,2,1,26858,26859,26860,1,2,0
7693,5,1,26863,26863,26864,0,1,3
7694,2,1,26865,26865,26866,0,1,1
7695,1,1,26866,26866,26867,0,1,0
7696,1,1,26867,26867,26868,0,1,0
7697,4,3,26871,26871,26874,0,3,3
7698,1,2,26872,26874,26876,2,4,0
7699,1,1,26873,26876,26877,3,4,0
7700,1,2,26874,26877,26879,3,5,0
7701,3,3,26877,26879,26882,2,5,0
7702,3,1,26880,26882,26883,2,3,0
7703,2,1,26882,26883,26884,1,2,0
7704,1,1,26883,26884,26885,1,2,0
7705,6,2,26889,26889,26891,0,2,4
7706,2,1,26891,26891,26892,0,1,0
7707,6,3,26897,26897,26900,0,3,5
7708,2,1,26899,26900,26901,1,2,0
7709,1,1,26900,26901,26902,1,2,0
7710,1,1,26901,26902,26903,1,2,0
7711,2,1,26903,26903,26904,0,1,0
7712,6,1,26909,26909,26910,0,1,5
7713,4,2,26913,26913,26915,0,2,3
7714,2,3,26915,26915,26918,0,3,0
7715,6,1,26921,26921,26922,0,1,3
7716,6,3,26927,26927,26930,0,3,5
7717,6,3,26933,26933,26936,0,3,3
7718,1,1,26934,26936,26937,2,3,0
7719,3,1,26937,26937,26938,0,1,0
7720,3,2,26940,26940,26942,0,2,2
7721,3,1,26943,26943,26944,0,1,1
7722,1,2,26944,26944,26946,0,2,0
7723,1,3,26945,26946,26949,1,4,0
7724,5,3,26950,26950,26953,0,3,1
7725,4,1,26954,26954,26955,0,1,1
7726,1,3,26955,26955,26958,0,3,0
7727,2,2,26957,26958,26960,1,3,0
7728,5,2,26962,26962,26964,0,2,2
7729,6,3,26968,26968,26971,0,3,4
7730,5,1,26973,26973,26974,0,1,2
7731,1,2,26974,26974,26976,0,2,0
7732,5,1,26979,26979,26980,0,1,3
7733,5,2,26984,26984,26986,0,2,4
7734,1,3,26985,26986,26989,1,4,0
7735,2,3,26987,26989,26992,2,5,0
7736,5,2,26992,26992,26994,0,2,0
7737,4,1,26996,26996,26997,0,1,2
7738,5,1,27001,27001,27002,0,1,4
7739,4,2,27005,27005,27007,0,2,3
7740,5,2,27010,27010,27012,0,2,3
7741,3,2,27013,27013,27015,0,2,1
7742,3,3,27016,27016,27019,0,3,1
7743,2,1,27018,27019,27020,1,2,0
7744,1,1,27019,27020,27021,1,2,0
7745,2,2,27021,27021,27023,0,2,0
7746,4,2,27025,27025,27027,0,2,2
7747,2,3,27027,27027,27030,0,3,0
7748,5,3,27032,27032,27035,0,3,2
7749,1,3,27033,27035,27038,2,5,0
7750,6,1,27039,27039,27040,0,1,1
7751,4,1,27043,27043,27044,0,1,3
7752,1,3,27044,27044,27047,0,3,0
7753,6,1,27050,27050,27051,0,1,3
7754,3,2,27053,27053,27055,0,2,2
7755,2,3,27055,27055,27058,0,3,0
7756,6,1,27061,27061,27062,0,1,3
7757,5,1,27066,27066,27067,0,1,4
7758,2,2,27068,27068,27070,0,2,1
7759,6,2,27074,27074,27076,0,2,4
7760,1,2,27075,27076,27078,1,3,0
7761,6,3,27081,27081,27084,0,3,3
7762,5,2,27086,27086,27088,0,2,2
7763,6,2,27092,27092,27094,0,2,4
7764,4,3,27096,27096,27099,0,3,2
7765,6,1,27102,27102,27103,0,1,3
7766,1,3,27103,27103,27106,0,3,0
7767,5,2,27108,27108,27110,0,2,2
7768,5,2,27113,27113,27115,0,2,3
7769,4,1,27117,27117,27118,0,1,2
7770,5,3,27122,27122,27125,0,3,4
7771,2,1,27124,27125,27126,1,2,0
7772,6,3,27130,27130,27133,0,3,4
7773,3,1,27133,27133,27134,0,1,0
7774,4,2,27137,27137,27139,0,2,3
7775,1,2,27138,27139,27141,1,3,0
7776,6,1,27144,27144,27145,0,1,3
7777,2,3,27146,27146,27149,0,3,1
7778,2,2,27148,27149,27151,1,3,0
7779,2,3,27150,27151,27154,1,4,0
7780,2,2,27152,27154,27156,2,4,0
7781,1,1,27153,27156,27157,3,4,0
7782,4,2,27157,27157,27159,0,2,0
7783,4,1,27161,27161,27162,0,1,2
7784,2,2,27163,27163,27165,0,2,1
7785,2,2,27165,27165,27167,0,2,0
7786,5,3,27170,27170,27173,0,3,3
7787,6,3,27176,27176,27179,0,3,3
7788,2,3,27178,27179,27182,1,4,0
7789,5,3,27183,27183,27186,0,3,1
7790,1,3,27184,27186,27189,2,5,0
7791,4,2,27188,27189,27191,1,3,0
7792,6,3,27194,27194,27197,0,3,3
7793,4,2,27198,27198,27200,0,2,1
7794,6,2,27204,27204,27206,0,2,4
7795,3,3,27207,27207,27210,0,3,1
7796,1,2,27208,27210,27212,2,4,0
7797,3,3,27211,27212,27215,1,4,0
7798,3,1,27214,27215,27216,1,2,0
7799,6,1,27220,27220,27221,0,1,4
7800,2,1,27222,27222,27223,0,1,1
7801,6,1,27228,27228,27229,0,1,5
7802,5,3,27233,27233,27236,0,3,4
7803,2,3,27235,27236,27239,1,4,0
7804,1,3,27236,27239,27242,3,6,0
7805,6,1,27242,27242,27243,0,1,0
7806,2,2,27244,27244,27246,0,2,1
7807,2,1,27246,27246,27247,0,1,0
7808,2,3,27248,27248,27251,0,3,1
7809,4,1,27252,27252,27253,0,1,1
7810,2,2,27254,27254,27256,0,2,1
7811,6,1,27260,27260,27261,0,1,4
7812,3,1,27263,27263,27264,0,1,2
7813,4,2,27267,27267,27269,0,2,3
7814,1,2,27268,27269,27271,1,3,0
7815,4,1,27272,27272,27273,0,1,1
7816,2,1,27274,27274,27275,0,1,1
7817,2,3,27276,27276,27279,0,3,1
7818,6,1,27282,27282,27283,0,1,3
7819,6,1,27288,27288,27289,0,1,5
7820,4,3,27292,27292,27295,0,3,3
7821,1,1,27293,27295,27296,2,3,0
7822,3,3,27296,27296,27299,0,3,0
7823,6,3,27302,27302,27305,0,3,3
7824,4,1,27306,27306,27307,0,1,1
7825,1,3,27307,27307,27310,0,3,0
7826,1,1,27308,27310,27311,2,3,0
7827,2,2,27310,27311,27313,1,3,0
7828,6,3,27316,27316,27319,0,3,3
7829,6,3,27322,27322,27325,0,3,3
7830,4,1,27326,27326,27327,0,1,1
7831,3,1,27329,27329,27330,0,1,2
7832,3,3,27332,27332,27335,0,3,2
7833,6,1,27338,27338,27339,0,1,3
7834,3,3,27341,27341,27344,0,3,2
7835,4,1,27345,27345,27346,0,1,1
7836,3,3,27348,27348,27351,0,3,2
7837,6,1,27354,27354,27355,0,1,3
7838,5,1,27359,27359,27360,0,1,4
7839,5,2,27364,27364,27366,0,2,4
7840,5,2,27369,27369,27371,0,2,3
7841,1,2,27370,27371,27373,1,3,0
7842,1,3,27371,27373,27376,2,5,0
7843,2,1,27373,27376,27377,3,4,0
7844,3,1,27376,27377,27378,1,2,0
7845,5,1,27381,27381,27382,0,1,3
7846,2,1,27383,27383,27384,0,1,1
7847,3,1,27386,27386,27387,0,1,2
7848,1,1,27387,27387,27388,0,1,0
7849,5,1,27392,27392,27393,0,1,4
7850,3,3,27395,27395,27398,0,3,2
7851,2,1,27397,27398,27399,1,2,0
7852,5,3,27402,27402,27405,0,3,3
7853,6,2,27408,27408,27410,0,2,3
7854,6,3,27414,27414,27417,0,3,4
7855,4,3,27418,27418,27421,0,3,1
7856,1,1,27419,27421,27422,2,3,0
7857,3,2,27422,27422,27424,0,2,0
7858,3,3,27425,27425,27428,0,3,1
7859,5,1,27430,27430,27431,0,1,2
7860,5,3,27435,27435,27438,0,3,4
7861,1,2,27436,27438,27440,2,4,0
7862,4,1,27440,27440,27441,0,1,0
7863,5,1,27445,27445,27446,0,1,4
7864,4,3,27449,27449,27452,0,3,3
7865,2,3,27451,27452,27455,1,4,0
7866,2,2,27453,27455,27457,2,4,0
7867,5,2,27458,27458,27460,0,2,1
7868,2,1,27460,27460,27461,0,1,0
7869,6,3,27466,27466,27469,0,3,5
7870,4,2,27470,27470,27472,0,2,1
7871,2,1,27472,27472,27473,0,1,0
7872,5,2,27477,27477,27479,0,2,4
7873,3,3,27480,27480,27483,0,3,1
7874,4,2,27484,27484,27486,0,2,1
7875,6,2,27490,27490,27492,0,2,4
7876,6,3,27496,27496,27499,0,3,4
7877,5,1,27501,27501,27502,0,1,2
7878,2,3,27503,27503,27506,0,3,1
7879,2,1,27505,27506,27507,1,2,0
7880,2,2,27507,27507,27509,0,2,0
7881,6,3,27513,27513,27516,0,3,4
7882,6,3,27519,27519,27522,0,3,3
7883,2,1,27521,27522,27523,1,2,0
7884,6,1,27527,27527,27528,0,1,4
7885,5,1,27532,27532,27533,0,1,4
7886,4,2,27536,27536,27538,0,2,3
7887,3,3,27539,27539,27542,0,3,1
7888,6,2,27545,27545,27547,0,2,3
7889,4,2,27549,27549,27551,0,2,2
7890,3,3,27552,27552,27555,0,3,1
7891,5,3,27557,27557,27560,0,3,2
7892,2,2,27559,27560,27562,1,3,0
7893,5,2,27564,27564,27566,0,2,2
7894,1,1,27565,27566,27567,1,2,0
7895,3,1,27568,27568,27569,0,1,1
7896,4,3,27572,27572,27575,0,3,3
7897,1,1,27573,27575,27576,2,3,0
7898,4,1,27577,27577,27578,0,1,1
7899,4,3,27581,27581,27584,0,3,3
7900,4,1,27585,27585,27586,0,1,1
7901,6,3,27591,27591,27594,0,3,5
7902,2,2,27593,27594,27596,1,3,0
7903,6,1,27599,27599,27600,0,1,3
7904,1,1,27600,27600,27601,0,1,0
7905,2,2,27602,27602,27604,0,2,1
7906,5,2,27607,27607,27609,0,2,3
7907,3,2,27610,27610,27612,0,2,1
7908,1,2,27611,27612,27614,1,3,0
7909,6,1,27617,27617,27618,0,1,3
7910,5,3,27622,27622,27625,0,3,4
7911,3,3,27625,27625,27628,0,3,0
7912,3,1,27628,27628,27629,0,1,0
7913,4,3,27632,27632,27635,0,3,3
7914,2,3,27634,27635,27638,1,4,0
7915,4,1,27638,27638,27639,0,1,0
7916,3,3,27641,27641,27644,0,3,2
7917,4,1,27645,27645,27646,0,1,1
7918,6,1,27651,27651,27652,0,1,5
7919,3,2,27654,27654,27656,0,2,2
7920,4,2,27658,27658,27660,0,2,2
7921,2,1,27660,27660,27661,0,1,0
7922,1,2,27661,27661,27663,0,2,0
7923,1,2,27662,27663,27665,1,3,0
7924,2,3,27664,27665,27668,1,4,0
7925,3,1,27667,27668,27669,1,2,0
7926,3,1,27670,27670,27671,0,1,1
7927,2,1,27672,27672,27673,0,1,1
7928,6,3,27678,27678,27681,0,3,5
7929,5,1,27683,27683,27684,0,1,2
7930,1,1,27684,27684,27685,0,1,0
7931,5,2,27689,27689,27691,0,2,4
7932,6,2,27695,27695,27697,0,2,4
7933,2,2,27697,27697,27699,0,2,0
7934,5,2,27702,27702,27704,0,2,3
7935,2,2,27704,27704,27706,0,2,0
7936,6,2,27710,27710,27712,0,2,4
7937,2,1,27712,27712,27713,0,1,0
7938,3,1,27715,27715,27716,0,1,2
7939,1,2,27716,27716,27718,0,2,0
7940,6,2,27722,27722,27724,0,2,4
7941,5,2,27727,27727,27729,0,2,3
7942,1,3,27728,27729,27732,1,4,0
7943,5,2,27733,27733,27735,0,2,1
7944,3,1,27736,27736,27737,0,1,1
7945,4,2,27740,27740,27742,0,2,3
7946,3,3,27743,27743,27746,0,3,1
7947,1,1,27744,27746,27747,2,3,0
7948,2,1,27746,27747,27748,1,2,0
7949,5,2,27751,27751,27753,0,2,3
7950,1,2,27752,27753,27755,1,3,0
7951,5,2,27757,27757,27759,0,2,2
7952,1,1,27758,27759,27760,1,2,0
7953,4,3,27762,27762,27765,0,3,2
7954,3,3,27765,27765,27768,0,3,0
7955,5,1,27770,27770,27771,0,1,2
7956,5,3,27775,27775,27778,0,3,4
7957,2,2,27777,27778,27780,1,3,0
7958,4,1,27781,27781,27782,0,1,1
7959,1,3,27782,27782,27785,0,3,0
7960,5,3,27787,27787,27790,0,3,2
7961,1,3,27788,27790,27793,2,5,0
7962,3,2,27791,27793,27795,2,4,0
7963,1,3,27792,27795,27798,3,6,0
7964,5,2,27797,27798,27800,1,3,0
7965,4,1,27801,27801,27802,0,1,1
7966,4,1,27805,27805,27806,0,1,3
7967,4,3,27809,27809,27812,0,3,3
7968,1,2,27810,27812,27814,2,4,0
7969,1,3,27811,27814,27817,3,6,0
7970,2,1,27813,27817,27818,4,5,0
7971,5,2,27818,27818,27820,0,2,0
7972,3,2,27821,27821,27823,0,2,1
7973,4,2,27825,27825,27827,0,2,2
7974,1,2,27826,27827,27829,1,3,0
7975,1,3,27827,27829,27832,2,5,0
7976,6,1,27833,27833,27834,0,1,1
7977,5,1,27838,27838,27839,0,1,4
7978,4,3,27842,27842,27845,0,3,3
7979,3,2,27845,27845,27847,0,2,0
7980,4,2,27849,27849,27851,0,2,2
7981,4,3,27853,27853,27856,0,3,2
7982,4,2,27857,27857,27859,0,2,1
7983,2,1,27859,27859,27860,0,1,0
7984,5,2,27864,27864,27866,0,2,4
7985,3,2,27867,27867,27869,0,2,1
7986,1,3,27868,27869,27872,1,4,0
7987,4,3,27872,27872,27875,0,3,0
7988,2,3,27874,27875,27878,1,4,0
7989,3,2,27877,27878,27880,1,3,0
7990,1,1,27878,27880,27881,2,3,0
7991,6,2,27884,27884,27886,0,2,3
7992,3,2,27887,27887,27889,0,2,1
7993,4,2,27891,27891,27893,0,2,2
7994,5,1,27896,27896,27897,0,1,3
7995,3,2,27899,27899,27901,0,2,2
7996,1,1,27900,27901,27902,1,2,0
7997,6,2,27906,27906,27908,0,2,4
7998,1,2,27907,27908,27910,1,3,0
7999,5,2,27912,27912,27914,0,2,2
8000,2,1,27914,27914,27915,0,1,0
8001,4,3,27918,27918,27921,0,3,3
8002,5,2,27923,27923,27925,0,2,2
8003,4,3,27927,27927,27930,0,3,2
8004,3,3,27930,27930,27933,0,3,0
8005,1,1,27931,27933,27934,2,3,0
8006,4,3,27935,27935,27938,0,3,1
8007,5,3,27940,27940,27943,0,3,2
8008,5,3,27945,27945,27948,0,3,2
8009,2,1,27947,27948,27949,1,2,0
8010,1,1,27948,27949,27950,1,2,0
8011,6,2,27954,27954,27956,0,2,4
8012,4,1,27958,27958,27959,0,1,2
8013,6,3,27964,27964,27967,0,3,5
8014,2,3,27966,27967,27970,1,4,0
8015,6,2,27972,27972,27974,0,2,2
8016,5,1,27977,27977,27978,0,1,3
8017,2,1,27979,27979,27980,0,1,1
8018,1,1,27980,27980,27981,0,1,0
8019,1,3,27981,27981,27984,0,3,0
8020,6,2,27987,27987,27989,0,2,3
8021,5,1,27992,27992,27993,0,1,3
8022,5,1,27997,27997,27998,0,1,4
8023,1,2,27998,27998,28000,0,2,0
8024,5,1,28003,28003,28004,0,1,3
8025,5,1,28008,28008,28009,0,1,4
8026,1,2,28009,28009,28011,0,2,0
8027,6,1,28015,28015,28016,0,1,4
8028,1,1,28016,28016,28017,0,1,0
8029,2,2,28018,28018,28020,0,2,1
8030,3,3,28021,28021,28024,0,3,1
8031,2,3,28023,28024,28027,1,4,0
8032,3,3,28026,28027,28030,1,4,0
8033,1,3,28027,28030,28033,3,6,0
8034,6,2,28033,28033,28035,0,2,0
8035,5,1,28038,28038,28039,0,1,3
8036,6,3,28044,28044,28047,0,3,5
8037,2,2,28046,28047,28049,1,3,0
8038,3,2,28049,28049,28051,0,2,0
8039,4,1,28053,28053,28054,0,1,2
8040,4,3,28057,28057,28060,0,3,3
8041,6,1,28063,28063,28064,0,1,3
8042,4,2,28067,28067,28069,0,2,3
8043,5,2,28072,28072,28074,0,2,3
8044,2,2,28074,28074,28076,0,2,0
8045,1,3,28075,28076,28079,1,4,0
8046,1,3,28076,28079,28082,3,6,0
8047,4,2,28080,28082,28084,2,4,0
8048,5,3,28085,28085,28088,0,3,1
8049,2,3,28087,28088,28091,1,4,0
8050,2,1,28089,28091,28092,2,3,0
8051,4,1,28093,28093,28094,0,1,1
8052,6,1,28099,28099,28100,0,1,5
8053,4,3,28103,28103,28106,0,3,3
8054,5,3,28108,28108,28111,0,3,2
8055,3,2,28111,28111,28113,0,2,0
8056,2,1,28113,28113,28114,0,1,0
8057,6,3,28119,28119,28122,0,3,5
8058,1,2,28120,28122,28124,2,4,0
8059,1,1,28121,28124,28125,3,4,0
8060,1,2,28122,28125,28127,3,5,0
8061,4,2,28126,28127,28129,1,3,0
8062,2,1,28128,28129,28130,1,2,0
8063,3,1,28131,28131,28132,0,1,1
8064,4,1,28135,28135,28136,0,1,3
8065,6,1,28141,28141,28142,0,1,5
8066,2,1,28143,28143,28144,0,1,1
8067,3,3,28146,28146,28149,0,3,2
8068,3,1,28149,28149,28150,0,1,0
8069,6,1,28155,28155,28156,0,1,5
8070,3,2,28158,28158,28160,0,2,2
8071,6,3,28164,28164,28167,0,3,4
8072,6,1,28170,28170,28171,0,1,3
8073,5,2,28175,28175,28177,0,2,4
8074,2,3,28177,28177,28180,0,3,0
8075,1,3,28178,28180,28183,2,5,0
8076,1,3,28179,28183,28186,4,7,0
8077,2,3,28181,28186,28189,5,8,0
8078,2,2,28183,28189,28191,6,8,0
8079,5,3,28188,28191,28194,3,6,0
8080,1,3,28189,28194,28197,5,8,0
8081,5,2,28194,28197,28199,3,5,0
8082,6,3,28200,28200,28203,0,3,1
8083,6,1,28206,28206,28207,0,1,3
8084,1,1,28207,28207,28208,0,1,0
8085,4,3,28211,28211,28214,0,3,3
8086,6,2,28217,28217,28219,0,2,3
8087,5,2,28222,28222,28224,0,2,3
8088,3,3,28225,28225,28228,0,3,1
8089,1,1,28226,28228,28229,2,3,0
8090,4,3,28230,28230,28233,0,3,1
8091,6,2,28236,28236,28238,0,2,3
8092,3,1,28239,28239,28240,0,1,1
8093,1,2,28240,28240,28242,0,2,0
8094,5,2,28245,28245,28247,0,2,3
8095,4,1,28249,28249,28250,0,1,2
8096,1,1,28250,28250,28251,0,1,0
8097,4,2,28254,28254,28256,0,2,3
8098,2,3,28256,28256,28259,0,3,0
8099,5,3,28261,28261,28264,0,3,2
8100,3,1,28264,28264,28265,0,1,0
8101,5,2,28269,28269,28271,0,2,4
8102,2,2,28271,28271,28273,0,2,0
8103,5,2,28276,28276,28278,0,2,3
8104,5,2,28281,28281,28283,0,2,3
8105,1,3,28282,28283,28286,1,4,0
8106,6,1,28288,28288,28289,0,1,2
8107,1,1,28289,28289,28290,0,1,0
8108,3,1,28292,28292,28293,0,1,2
8109,5,2,28297,28297,28299,0,2,4
8110,2,2,28299,28299,28301,0,2,0
8111,4,3,28303,28303,28306,0,3,2
8112,3,2,28306,28306,28308,0,2,0
8113,3,1,28309,28309,28310,0,1,1
8114,2,3,28311,28311,28314,0,3,1
8115,4,1,28315,28315,28316,0,1,1
8116,1,1,28316,28316,28317,0,1,0
8117,5,3,28321,28321,28324,0,3,4
8118,3,3,28324,28324,28327,0,3,0
8119,2,2,28326,28327,28329,1,3,0
8120,3,1,28329,28329,28330,0,1,0
8121,6,2,28335,28335,28337,0,2,5
8122,1,2,28336,28337,28339,1,3,0
8123,6,1,28342,28342,28343,0,1,3
8124,2,2,28344,28344,28346,0,2,1
8125,1,3,28345,28346,28349,1,4,0
8126,6,2,28351,28351,28353,0,2,2
8127,5,2,28356,28356,28358,0,2,3
8128,5,2,28361,28361,28363,0,2,3
8129,2,2,28363,28363,28365,0,2,0
8130,4,2,28367,28367,28369,0,2,2
8131,5,3,28372,28372,28375,0,3,3
8132,4,1,28376,28376,28377,0,1,1
8133,6,3,28382,28382,28385,0,3,5
8134,6,1,28388,28388,28389,0,1,3
8135,5,2,28393,28393,28395,0,2,4
8136,2,2,28395,28395,28397,0,2,0
8137,1,1,28396,28397,28398,1,2,0
8138,2,3,28398,28398,28401,0,3,0
8139,1,2,28399,28401,28403,2,4,0
8140,5,2,28404,28404,28406,0,2,1
8141,1,3,28405,28406,28409,1,4,0
8142,2,2,28407,28409,28411,2,4,0
8143,2,3,28409,28411,28414,2,5,0
8144,3,1,28412,28414,28415,2,3,0
8145,5,1,28417,28417,28418,0,1,2
8146,6,3,28423,28423,28426,0,3,5
8147,5,1,28428,28428,28429,0,1,2
8148,2,1,28430,28430,28431,0,1,1
8149,5,1,28435,28435,28436,0,1,4
8150,1,1,28436,28436,28437,0,1,0
8151,6,1,28442,28442,28443,0,1,5
8152,2,1,28444,28444,28445,0,1,1
8153,1,1,28445,28445,28446,0,1,0
8154,1,1,28446,28446,28447,0,1,0
8155,3,2,28449,28449,28451,0,2,2
8156,1,3,28450,28451,28454,1,4,0
8157,6,1,28456,28456,28457,0,1,2
8158,4,2,28460,28460,28462,0,2,3
8159,4,3,28464,28464,28467,0,3,2
8160,5,2,28469,28469,28471,0,2,2
8161,2,1,28471,28471,28472,0,1,0
8162,1,1,28472,28472,28473,0,1,0
8163,2,1,28474,28474,28475,0,1,1
8164,4,3,28478,28478,28481,0,3,3
8165,5,2,28483,28483,28485,0,2,2
8166,1,3,28484,28485,28488,1,4,0
8167,4,2,28488,28488,28490,0,2,0
8168,1,3,28489,28490,28493,1,4,0
8169,6,3,28495,28495,28498,0,3,2
8170,4,1,28499,28499,28500,0,1,1
8171,4,1,28503,28503,28504,0,1,3
8172,5,2,28508,28508,28510,0,2,4
8173,2,1,28510,28510,28511,0,1,0
8174,4,3,28514,28514,28517,0,3,3
8175,4,3,28518,28518,28521,0,3,1
8176,2,2,28520,28521,28523,1,3,0
8177,5,3,28525,28525,28528,0,3,2
8178,3,3,28528,28528,28531,0,3,0
8179,5,1,28533,28533,28534,0,1,2
8180,6,2,28539,28539,28541,0,2,5
8181,1,2,28540,28541,28543,1,3,0
8182,3,3,28543,28543,28546,0,3,0
8183,4,1,28547,28547,28548,0,1,1
8184,4,2,28551,28551,28553,0,2,3
8185,5,3,28556,28556,28559,0,3,3
8186,2,3,28558,28559,28562,1,4,0
8187,5,1,28563,28563,28564,0,1,1
8188,2,2,28565,28565,28567,0,2,1
8189,6,1,28571,28571,28572,0,1,4
8190,4,1,28575,28575,28576,0,1,3
8191,5,1,28580,28580,28581,0,1,4
8192,2,3,28582,28582,28585,0,3,1
8193,2,3,28584,28585,28588,1,4,0
8194,5,3,28589,28589,28592,0,3,1
8195,2,1,28591,28592,28593,1,2,0
8196,5,1,28596,28596,28597,0,1,3
8197,4,2,28600,28600,28602,0,2,3
8198,4,2,28604,28604,28606,0,2,2
8199,5,2,28609,28609,28611,0,2,3
8200,2,3,28611,28611,28614,0,3,0
8201,6,1,28617,28617,28618,0,1,3
8202,5,1,28622,28622,28623,0,1,4
8203,4,1,28626,28626,28627,0,1,3
8204,5,2,28631,28631,28633,0,2,4
8205,4,3,28635,28635,28638,0,3,2
8206,3,2,28638,28638,28640,0,2,0
8207,4,2,28642,28642,28644,0,2,2
8208,3,3,28645,28645,28648,0,3,1
8209,3,3,28648,28648,28651,0,3,0
8210,4,1,28652,28652,28653,0,1,1
8211,2,1,28654,28654,28655,0,1,1
8212,2,2,28656,28656,28658,0,2,1
8213,4,2,28660,28660,28662,0,2,2
8214,4,3,28664,28664,28667,0,3,2
8215,4,3,28668,28668,28671,0,3,1
8216,4,2,28672,28672,28674,0,2,1
8217,6,3,28678,28678,28681,0,3,4
8218,3,1,28681,28681,28682,0,1,0
8219,4,2,28685,28685,28687,0,2,3
8220,5,2,28690,28690,28692,0,2,3
8221,3,1,28693,28693,28694,0,1,1
8222,3,1,28696,28696,28697,0,1,2
8223,6,1,28702,28702,28703,0,1,5
8224,4,3,28706,28706,28709,0,3,3
8225,5,1,28711,28711,28712,0,1,2
8226,4,1,28715,28715,28716,0,1,3
8227,2,2,28717,28717,28719,0,2,1
8228,5,3,28722,28722,28725,0,3,3
8229,3,2,28725,28725,28727,0,2,0
8230,4,1,28729,28729,28730,0,1,2
8231,4,3,28733,28733,28736,0,3,3
8232,3,3,28736,28736,28739,0,3,0
8233,3,3,28739,28739,28742,0,3,0
8234,5,2,28744,28744,28746,0,2,2
8235,4,2,28748,28748,28750,0,2,2
8236,6,2,28754,28754,28756,0,2,4
8237,2,2,28756,28756,28758,0,2,0
8238,4,1,28760,28760,28761,0,1,2
8239,3,2,28763,28763,28765,0,2,2
8240,3,1,28766,28766,28767,0,1,1
8241,2,2,28768,28768,28770,0,2,1
8242,4,3,28772,28772,28775,0,3,2
8243,5,2,28777,28777,28779,0,2,2
8244,3,1,28780,28780,28781,0,1,1
8245,5,1,28785,28785,28786,0,1,4
8246,2,2,28787,28787,28789,0,2,1
8247,6,1,28793,28793,28794,0,1,4
8248,1,2,28794,28794,28796,0,2,0
8249,4,3,28798,28798,28801,0,3,2
8250,2,1,28800,28801,28802,1,2,0
8251,6,1,28806,28806,28807,0,1,4
8252,2,2,28808,28808,28810,0,2,1
8253,4,2,28812,28812,28814,0,2,2
8254,6,1,28818,28818,28819,0,1,4
8255,6,3,28824,28824,28827,0,3,5
8256,5,2,28829,28829,28831,0,2,2
8257,4,1,28833,28833,28834,0,1,2
8258,5,3,28838,28838,28841,0,3,4
8259,3,1,28841,28841,28842,0,1,0
8260,2,3,28843,28843,28846,0,3,1
8261,4,3,28847,28847,28850,0,3,1
8262,6,3,28853,28853,28856,0,3,3
8263,4,3,28857,28857,28860,0,3,1
8264,3,2,28860,28860,28862,0,2,0
8265,3,2,28863,28863,28865,0,2,1
8266,1,1,28864,28865,28866,1,2,0
8267,2,2,28866,28866,28868,0,2,0
8268,4,2,28870,28870,28872,0,2,2
8269,4,3,28874,28874,28877,0,3,2
8270,3,1,28877,28877,28878,0,1,0
8271,3,2,28880,28880,28882,0,2,2
8272,1,1,28881,28882,28883,1,2,0
8273,6,3,28887,28887,28890,0,3,4
8274,4,1,28891,28891,28892,0,1,1
8275,3,1,28894,28894,28895,0,1,2
8276,6,2,28900,28900,28902,0,2,5
8277,4,1,28904,28904,28905,0,1,2
8278,4,3,28908,28908,28911,0,3,3
8279,6,2,28914,28914,28916,0,2,3
8280,2,2,28916,28916,28918,0,2,0
8281,5,3,28921,28921,28924,0,3,3
8282,6,3,28927,28927,28930,0,3,3
8283,3,1,28930,28930,28931,0,1,0
8284,3,3,28933,28933,28936,0,3,2
8285,6,1,28939,28939,28940,0,1,3
8286,4,1,28943,28943,28944,0,1,3
8287,4,2,28947,28947,28949,0,2,3
8288,5,3,28952,28952,28955,0,3,3
8289,2,2,28954,28955,28957,1,3,0
8290,1,3,28955,28957,28960,2,5,0
8291,2,1,28957,28960,28961,3,4,0
8292,2,2,28959,28961,28963,2,4,0
8293,3,2,28962,28963,28965,1,3,0
8294,6,3,28968,28968,28971,0,3,3
8295,3,2,28971,28971,28973,0,2,0
8296,6,3,28977,28977,28980,0,3,4
8297,1,1,28978,28980,28981,2,3,0
8298,5,2,28983,28983,28985,0,2,2
8299,4,2,28987,28987,28989,0,2,2
8300,3,3,28990,28990,28993,0,3,1
8301,1,1,28991,28993,28994,2,3,0
8302,1,1,28992,28994,28995,2,3,0
8303,3,1,28995,28995,28996,0,1,0
8304,3,2,28998,28998,29000,0,2,2
8305,3,3,29001,29001,29004,0,3,1
8306,5,3,29006,29006,29009,0,3,2
8307,3,1,29009,29009,29010,0,1,0
8308,5,1,29014,29014,29015,0,1,4
8309,1,3,29015,29015,29018,0,3,0
8310,2,1,29017,29018,29019,1,2,0
8311,6,2,29023,29023,29025,0,2,4
8312,5,2,29028,29028,29030,0,2,3
8313,3,3,29031,29031,29034,0,3,1
8314,1,3,29032,29034,29037,2,5,0
8315,1,3,29033,29037,29040,4,7,0
8316,5,2,29038,29040,29042,2,4,0
8317,4,1,29042,29042,29043,0,1,0
8318,3,2,29045,29045,29047,0,2,2
8319,5,3,29050,29050,29053,0,3,3
8320,2,1,29052,29053,29054,1,2,0
8321,6,1,29058,29058,29059,0,1,4
8322,3,3,29061,29061,29064,0,3,2
8323,2,3,29063,29064,29067,1,4,0
8324,1,2,29064,29067,29069,3,5,0
8325,3,2,29067,29069,29071,2,4,0
8326,4,3,29071,29071,29074,0,3,0
8327,6,1,29077,29077,29078,0,1,3
8328,1,2,29078,29078,29080,0,2,0
8329,1,3,29079,29080,29083,1,4,0
8330,1,2,29080,29083,29085,3,5,0
8331,5,1,29085,29085,29086,0,1,0
8332,6,1,29091,29091,29092,0,1,5
8333,1,3,29092,29092,29095,0,3,0
8334,5,3,29097,29097,29100,0,3,2
8335,2,1,29099,29100,29101,1,2,0
8336,4,3,29103,29103,29106,0,3,2
8337,2,2,29105,29106,29108,1,3,0
8338,4,1,29109,29109,29110,0,1,1
8339,3,1,29112,29112,29113,0,1,2
8340,4,1,29116,29116,29117,0,1,3
8341,1,1,29117,29117,29118,0,1,0
8342,5,2,29122,29122,29124,0,2,4
8343,2,3,29124,29124,29127,0,3,0
8344,5,1,29129,29129,29130,0,1,2
8345,3,2,29132,29132,29134,0,2,2
8346,3,1,29135,29135,29136,0,1,1
8347,3,2,29138,29138,29140,0,2,2
8348,6,1,29144,29144,29145,0,1,4
8349,2,1,29146,29146,29147,0,1,1
8350,3,3,29149,29149,29152,0,3,2
8351,6,1,29155,29155,29156,0,1,3
8352,3,2,29158,29158,29160,0,2,2
8353,3,2,29161,29161,29163,0,2,1
8354,5,2,29166,29166,29168,0,2,3
8355,1,1,29167,29168,29169,1,2,0
8356,3,3,29170,29170,29173,0,3,1
8357,5,3,29175,29175,29178,0,3,2
8358,6,2,29181,29181,29183,0,2,3
8359,6,2,29187,29187,29189,0,2,4
8360,6,1,29193,29193,29194,0,1,4
8361,3,3,29196,29196,29199,0,3,2
8362,2,2,29198,29199,29201,1,3,0
8363,6,3,29204,29204,29207,0,3,3
8364,5,1,29209,29209,29210,0,1,2
8365,1,1,29210,29210,29211,0,1,0
8366,5,2,29215,29215,29217,0,2,4
8367,5,2,29220,29220,29222,0,2,3
8368,3,3,29223,29223,29226,0,3,1
8369,5,2,29228,29228,29230,0,2,2
8370,5,2,29233,29233,29235,0,2,3
8371,4,1,29237,29237,29238,0,1,2
8372,5,1,29242,29242,29243,0,1,4
8373,6,2,29248,29248,29250,0,2,5
8374,2,1,29250,29250,29251,0,1,0
8375,3,2,29253,29253,29255,0,2,2
8376,1,2,29254,29255,29257,1,3,0
8377,3,3,29257,29257,29260,0,3,0
8378,3,1,29260,29260,29261,0,1,0
8379,3,1,29263,29263,29264,0,1,2
8380,6,3,29269,29269,29272,0,3,5
8381,6,1,29275,29275,29276,0,1,3
8382,4,2,29279,29279,29281,0,2,3
8383,2,3,29281,29281,29284,0,3,0
8384,5,2,29286,29286,29288,0,2,2
8385,1,3,29287,29288,29291,1,4,0
8386,6,1,29293,29293,29294,0,1,2
8387,4,2,29297,29297,29299,0,2,3
8388,4,2,29301,29301,29303,0,2,2
8389,2,3,29303,29303,29306,0,3,0
8390,4,1,29307,29307,29308,0,1,1
8391,1,1,29308,29308,29309,0,1,0
8392,5,1,29313,29313,29314,0,1,4
8393,1,2,29314,29314,29316,0,2,0
8394,4,2,29318,29318,29320,0,2,2
8395,1,1,29319,29320,29321,1,2,0
8396,2,1,29321,29321,29322,0,1,0
8397,3,2,29324,29324,29326,0,2,2
8398,4,1,29328,29328,29329,0,1,2
8399,5,2,29333,29333,29335,0,2,4
8400,6,3,29339,29339,29342,0,3,4
8401,1,3,29340,29342,29345,2,5,0
8402,4,3,29344,29345,29348,1,4,0
8403,3,3,29347,29348,29351,1,4,0
8404,6,1,29353,29353,29354,0,1,2
8405,2,1,29355,29355,29356,0,1,1
8406,4,2,29359,29359,29361,0,2,3
8407,3,3,29362,29362,29365,0,3,1
8408,1,2,29363,29365,29367,2,4,0
8409,4,2,29367,29367,29369,0,2,0
8410,6,2,29373,29373,29375,0,2,4
8411,6,1,29379,29379,29380,0,1,4
8412,5,2,29384,29384,29386,0,2,4
8413,4,3,29388,29388,29391,0,3,2
8414,3,1,29391,29391,29392,0,1,0
8415,4,2,29395,29395,29397,0,2,3
8416,1,1,29396,29397,29398,1,2,0
8417,5,2,29401,29401,29403,0,2,3
8418,3,1,29404,29404,29405,0,1,1
8419,1,2,29405,29405,29407,0,2,0
8420,5,2,29410,29410,29412,0,2,3
8421,4,3,29414,29414,29417,0,3,2
8422,2,2,29416,29417,29419,1,3,0
8423,1,2,29417,29419,29421,2,4,0
8424,3,2,29420,29421,29423,1,3,0
8425,1,2,29421,29423,29425,2,4,0
8426,5,1,29426,29426,29427,0,1,1
8427,6,1,29432,29432,29433,0,1,5
8428,6,1,29438,29438,29439,0,1,5
8429,1,3,29439,29439,29442,0,3,0
8430,5,1,29444,29444,29445,0,1,2
8431,1,3,29445,29445,29448,0,3,0
8432,2,1,29447,29448,29449,1,2,0
8433,2,2,29449,29449,29451,0,2,0
8434,1,3,29450,29451,29454,1,4,0
8435,1,2,29451,29454,29456,3,5,0
8436,5,2,29456,29456,29458,0,2,0
8437,2,3,29458,29458,29461,0,3,0
8438,6,3,29464,29464,29467,0,3,3
8439,6,2,29470,29470,29472,0,2,3
8440,4,3,29474,29474,29477,0,3,2
8441,3,1,29477,29477,29478,0,1,0
8442,4,2,29481,29481,29483,0,2,3
8443,3,3,29484,29484,29487,0,3,1
8444,3,3,29487,29487,29490,0,3,0
8445,1,3,29488,29490,29493,2,5,0
8446,4,2,29492,29493,29495,1,3,0
8447,1,3,29493,29495,29498,2,5,0
8448,2,1,29495,29498,29499,3,4,0
8449,1,1,29496,29499,29500,3,4,0
8450,1,1,29497,29500,29501,3,4,0
8451,5,2,29502,29502,29504,0,2,1
8452,6,2,29508,29508,29510,0,2,4
8453,2,1,29510,29510,29511,0,1,0
8454,5,1,29515,29515,29516,0,1,4
8455,3,3,29518,29518,29521,0,3,2
8456,1,2,29519,29521,29523,2,4,0
8457,2,2,29521,29523,29525,2,4,0
8458,5,3,29526,29526,29529,0,3,1
8459,5,2,29531,29531,29533,0,2,2
8460,3,1,29534,29534,29535,0,1,1
8461,2,1,29536,29536,29537,0,1,1
8462,3,1,29539,29539,29540,0,1,2
8463,1,3,29540,29540,29543,0,3,0
8464,3,1,29543,29543,29544,0,1,0
8465,6,2,29549,29549,29551,0,2,5
8466,6,3,29555,29555,29558,0,3,4
8467,6,1,29561,29561,29562,0,1,3
8468,2,1,29563,29563,29564,0,1,1
8469,5,3,29568,29568,29571,0,3,4
8470,3,1,29571,29571,29572,0,1,0
8471,6,2,29577,29577,29579,0,2,5
8472,4,3,29581,29581,29584,0,3,2
8473,6,2,29587,29587,29589,0,2,3
8474,3,3,29590,29590,29593,0,3,1
8475,3,1,29593,29593,29594,0,1,0
8476,4,2,29597,29597,29599,0,2,3
8477,2,1,29599,29599,29600,0,1,0
8478,2,2,29601,29601,29603,0,2,1
8479,5,2,29606,29606,29608,0,2,3
8480,6,1,29612,29612,29613,0,1,4
8481,4,2,29616,29616,29618,0,2,3
8482,4,3,29620,29620,29623,0,3,2
8483,6,2,29626,29626,29628,0,2,3
8484,1,3,29627,29628,29631,1,4,0
8485,4,1,29631,29631,29632,0,1,0
8486,3,2,29634,29634,29636,0,2,2
8487,3,2,29637,29637,29639,0,2,1
8488,5,1,29642,29642,29643,0,1,3
8489,1,3,29643,29643,29646,0,3,0
8490,2,3,29645,29646,29649,1,4,0
8491,2,1,29647,29649,29650,2,3,0
8492,2,2,29649,29650,29652,1,3,0
8493,3,1,29652,29652,29653,0,1,0
8494,6,1,29658,29658,29659,0,1,5
8495,5,2,29663,29663,29665,0,2,4
8496,4,1,29667,29667,29668,0,1,2
8497,6,2,29673,29673,29675,0,2,5
8498,5,1,29678,29678,29679,0,1,3
8499,2,1,29680,29680,29681,0,1,1
8500,2,3,29682,29682,29685,0,3,1
8501,5,2,29687,29687,29689,0,2,2
8502,4,1,29691,29691,29692,0,1,2
8503,6,2,29697,29697,29699,0,2,5
8504,1,3,29698,29699,29702,1,4,0
8505,3,3,29701,29702,29705,1,4,0
8506,5,2,29706,29706,29708,0,2,1
8507,3,2,29709,29709,29711,0,2,1
8508,3,2,29712,29712,29714,0,2,1
8509,3,3,29715,29715,29718,0,3,1
8510,1,3,29716,29718,29721,2,5,0
8511,3,2,29719,29721,29723,2,4,0
8512,3,1,29722,29723,29724,1,2,0
8513,1,1,29723,29724,29725,1,2,0
8514,1,2,29724,29725,29727,1,3,0
8515,4,2,29728,29728,29730,0,2,1
8516,2,2,29730,29730,29732,0,2,0
8517,1,2,29731,29732,29734,1,3,0
8518,3,2,29734,29734,29736,0,2,0
8519,1,3,29735,29736,29739,1,4,0
8520,5,1,29740,29740,29741,0,1,1
8521,5,2,29745,29745,29747,0,2,4
8522,2,3,29747,29747,29750,0,3,0
8523,4,2,29751,29751,29753,0,2,1
8524,6,3,29757,29757,29760,0,3,4
8525,4,1,29761,29761,29762,0,1,1
8526,6,3,29767,29767,29770,0,3,5
8527,2,3,29769,29770,29773,1,4,0
8528,6,2,29775,29775,29777,0,2,2
8529,3,1,29778,29778,29779,0,1,1
8530,2,3,29780,29780,29783,0,3,1
8531,5,3,29785,29785,29788,0,3,2
8532,1,2,29786,29788,29790,2,4,0
8533,6,3,29792,29792,29795,0,3,2
8534,2,1,29794,29795,29796,1,2,0
8535,2,1,29796,29796,29797,0,1,0
8536,3,1,29799,29799,29800,0,1,2
8537,4,1,29803,29803,29804,0,1,3
8538,6,3,29809,29809,29812,0,3,5
8539,1,2,29810,29812,29814,2,4,0
8540,5,2,29815,29815,29817,0,2,1
8541,1,1,29816,29817,29818,1,2,0
8542,5,3,29821,29821,29824,0,3,3
8543,4,1,29825,29825,29826,0,1,1
8544,6,3,29831,29831,29834,0,3,5
8545,1,1,29832,29834,29835,2,3,0
8546,3,2,29835,29835,29837,0,2,0
8547,6,2,29841,29841,29843,0,2,4
8548,3,3,29844,29844,29847,0,3,1
8549,6,2,29850,29850,29852,0,2,3
8550,4,1,29854,29854,29855,0,1,2
8551,3,1,29857,29857,29858,0,1,2
8552,1,1,29858,29858,29859,0,1,0
8553,6,3,29864,29864,29867,0,3,5
8554,3,3,29867,29867,29870,0,3,0
8555,1,2,29868,29870,29872,2,4,0
8556,3,3,29871,29872,29875,1,4,0
8557,2,3,29873,29875,29878,2,5,0
8558,5,2,29878,29878,29880,0,2,0
8559,3,3,29881,29881,29884,0,3,1
8560,1,2,29882,29884,29886,2,4,0
8561,3,3,29885,29886,29889,1,4,0
8562,2,3,29887,29889,29892,2,5,0
8563,2,2,29889,29892,29894,3,5,0
8564,1,2,29890,29894,29896,4,6,0
8565,2,2,29892,29896,29898,4,6,0
8566,4,3,29896,29898,29901,2,5,0
8567,3,3,29899,29901,29904,2,5,0
8568,6,3,29905,29905,29908,0,3,1
8569,3,1,29908,29908,29909,0,1,0
8570,6,1,29914,29914,29915,0,1,5
8571,2,3,29916,29916,29919,0,3,1
8572,4,2,29920,29920,29922,0,2,1
8573,3,3,29923,29923,29926,0,3,1
8574,1,3,29924,29926,29929,2,5,0
8575,5,2,29929,29929,29931,0,2,0
8576,6,3,29935,29935,29938,0,3,4
8577,5,3,29940,29940,29943,0,3,2
8578,5,3,29945,29945,29948,0,3,2
8579,3,1,29948,29948,29949,0,1,0
8580,6,1,29954,29954,29955,0,1,5
8581,5,2,29959,29959,29961,0,2,4
8582,6,2,29965,29965,29967,0,2,4
8583,6,3,29971,29971,29974,0,3,4
8584,3,2,29974,29974,29976,0,2,0
8585,6,3,29980,29980,29983,0,3,4
8586,6,3,29986,29986,29989,0,3,3
8587,6,3,29992,29992,29995,0,3,3
8588,5,1,29997,29997,29998,0,1,2
8589,5,1,30002,30002,30003,0,1,4
8590,1,2,30003,30003,30005,0,2,0
8591,6,2,30009,30009,30011,0,2,4
8592,1,1,30010,30011,30012,1,2,0
8593,6,3,30016,30016,30019,0,3,4
8594,5,2,30021,30021,30023,0,2,2
8595,1,1,30022,30023,30024,1,2,0
8596,3,1,30025,30025,30026,0,1,1
8597,3,2,30028,30028,30030,0,2,2
8598,5,3,30033,30033,30036,0,3,3
8599,3,2,30036,30036,30038,0,2,0
8600,5,3,30041,30041,30044,0,3,3
8601,3,2,30044,30044,30046,0,2,0
8602,4,2,30048,30048,30050,0,2,2
8603,2,3,30050,30050,30053,0,3,0
8604,1,3,30051,30053,30056,2,5,0
8605,6,3,30057,30057,30060,0,3,1
8606,3,3,30060,30060,30063,0,3,0
8607,2,2,30062,30063,30065,1,3,0
8608,6,3,30068,30068,30071,0,3,3
8609,5,3,30073,30073,30076,0,3,2
8610,2,3,30075,30076,30079,1,4,0
8611,6,2,30081,30081,30083,0,2,2
8612,1,2,30082,30083,30085,1,3,0
8613,2,2,30084,30085,30087,1,3,0
8614,1,3,30085,30087,30090,2,5,0
8615,3,2,30088,30090,30092,2,4,0
8616,3,3,30091,30092,30095,1,4,0
8617,4,3,30095,30095,30098,0,3,0
8618,1,3,30096,30098,30101,2,5,0
8619,6,1,30102,30102,30103,0,1,1
8620,1,3,30103,30103,30106,0,3,0
8621,6,1,30109,30109,30110,0,1,3
8622,4,1,30113,30113,30114,0,1,3
8623,1,1,30114,30114,30115,0,1,0
8624,1,3,30115,30115,30118,0,3,0
8625,5,1,30120,30120,30121,0,1,2
8626,5,2,30125,30125,30127,0,2,4
8627,5,2,30130,30130,30132,0,2,3
8628,3,1,30133,30133,30134,0,1,1
8629,2,2,30135,30135,30137,0,2,1
8630,5,3,30140,30140,30143,0,3,3
8631,2,2,30142,30143,30145,1,3,0
8632,3,3,30145,30145,30148,0,3,0
8633,5,1,30150,30150,30151,0,1,2
8634,6,3,30156,30156,30159,0,3,5
8635,4,2,30160,30160,30162,0,2,1
8636,1,3,30161,30162,30165,1,4,0
8637,5,1,30166,30166,30167,0,1,1
8638,5,2,30171,30171,30173,0,2,4
8639,5,1,30176,30176,30177,0,1,3
8640,4,3,30180,30180,30183,0,3,3
8641,5,1,30185,30185,30186,0,1,2
8642,1,3,30186,30186,30189,0,3,0
8643,6,3,30192,30192,30195,0,3,3
8644,1,2,30193,30195,30197,2,4,0
8645,5,2,30198,30198,30200,0,2,1
8646,2,3,30200,30200,30203,0,3,0
8647,3,3,30203,30203,30206,0,3,0
8648,3,3,30206,30206,30209,0,3,0
8649,2,3,30208,30209,30212,1,4,0
8650,1,3,30209,30212,30215,3,6,0
8651,2,3,30211,30215,30218,4,7,0
8652,3,1,30214,30218,30219,4,5,0
8653,6,3,30220,30220,30223,0,3,1
8654,6,2,30226,30226,30228,0,2,3
8655,6,1,30232,30232,30233,0,1,4
8656,6,2,30238,30238,30240,0,2,5
8657,4,1,30242,30242,30243,0,1,2
8658,3,2,30245,30245,30247,0,2,2
8659,1,3,30246,30247,30250,1,4,0
8660,6,1,30252,30252,30253,0,1,2
8661,5,2,30257,30257,30259,0,2,4
8662,5,2,30262,30262,30264,0,2,3
8663,2,1,30264,30264,30265,0,1,0
8664,4,3,30268,30268,30271,0,3,3
8665,6,3,30274,30274,30277,0,3,3
8666,3,2,30277,30277,30279,0,2,0
8667,4,1,30281,30281,30282,0,1,2
8668,4,1,30285,30285,30286,0,1,3
8669,3,3,30288,30288,30291,0,3,2
8670,3,2,30291,30291,30293,0,2,0
8671,4,3,30295,30295,30298,0,3,2
8672,2,2,30297,30298,30300,1,3,0
8673,2,2,30299,30300,30302,1,3,0
8674,1,1,30300,30302,30303,2,3,0
8675,5,1,30305,30305,30306,0,1,2
8676,6,3,30311,30311,30314,0,3,5
8677,5,1,30316,30316,30317,0,1,2
8678,3,3,30319,30319,30322,0,3,2
8679,1,3,30320,30322,30325,2,5,0
8680,2,2,30322,30325,30327,3,5,0
8681,2,3,30324,30327,30330,3,6,0
8682,3,2,30327,30330,30332,3,5,0
8683,1,3,30328,30332,30335,4,7,0
8684,1,3,30329,30335,30338,6,9,0
8685,5,1,30334,30338,30339,4,5,0
8686,6,1,30340,30340,30341,0,1,1
8687,2,2,30342,30342,30344,0,2,1
8688,5,3,30347,30347,30350,0,3,3
8689,4,3,30351,30351,30354,0,3,1
8690,2,1,30353,30354,30355,1,2,0
8691,1,2,30354,30355,30357,1,3,0
8692,1,2,30355,30357,30359,2,4,0
8693,3,3,30358,30359,30362,1,4,0
8694,2,1,30360,30362,30363,2,3,0
8695,1,2,30361,30363,30365,2,4,0
8696,6,2,30367,30367,30369,0,2,2
8697,5,1,30372,30372,30373,0,1,3
8698,1,1,30373,30373,30374,0,1,0
8699,1,2,30374,30374,30376,0,2,0
8700,3,2,30377,30377,30379,0,2,1
8701,6,2,30383,30383,30385,0,2,4
8702,4,2,30387,30387,30389,0,2,2
8703,6,3,30393,30393,30396,0,3,4
8704,5,2,30398,30398,30400,0,2,2
8705,2,3,30400,30400,30403,0,3,0
8706,5,2,30405,30405,30407,0,2,2
8707,1,2,30406,30407,30409,1,3,0
8708,6,2,30412,30412,30414,0,2,3
8709,4,1,30416,30416,30417,0,1,2
8710,4,1,30420,30420,30421,0,1,3
8711,1,1,30421,30421,30422,0,1,0
8712,5,3,30426,30426,30429,0,3,4
8713,1,2,30427,30429,30431,2,4,0
8714,2,3,30429,30431,30434,2,5,0
8715,3,3,30432,30434,30437,2,5,0
8716,5,1,30437,30437,30438,0,1,0
8717,5,2,30442,30442,30444,0,2,4
8718,3,3,30445,30445,30448,0,3,1
8719,6,3,30451,30451,30454,0,3,3
8720,1,1,30452,30454,30455,2,3,0
8721,2,1,30454,30455,30456,1,2,0
8722,3,1,30457,30457,30458,0,1,1
8723,5,3,30462,30462,30465,0,3,4
8724,4,2,30466,30466,30468,0,2,1
8725,5,2,30471,30471,30473,0,2,3
8726,2,1,30473,30473,30474,0,1,0
8727,2,2,30475,30475,30477,0,2,1
8728,3,3,30478,30478,30481,0,3,1
8729,6,1,30484,30484,30485,0,1,3
8730,3,3,30487,30487,30490,0,3,2
8731,3,3,30490,30490,30493,0,3,0
8732,2,1,30492,30493,30494,1,2,0
8733,4,1,30496,30496,30497,0,1,2
8734,3,3,30499,30499,30502,0,3,2
8735,4,2,30503,30503,30505,0,2,1
8736,2,2,30505,30505,30507,0,2,0
8737,3,3,30508,30508,30511,0,3,1
8738,6,2,30514,30514,30516,0,2,3
8739,6,2,30520,30520,30522,0,2,4
8740,2,2,30522,30522,30524,0,2,0
8741,5,1,30527,30527,30528,0,1,3
8742,5,2,30532,30532,30534,0,2,4
8743,2,3,30534,30534,30537,0,3,0
8744,2,3,30536,30537,30540,1,4,0
8745,5,1,30541,30541,30542,0,1,1
8746,1,1,30542,30542,30543,0,1,0
8747,6,1,30548,30548,30549,0,1,5
8748,4,3,30552,30552,30555,0,3,3
8749,3,3,30555,30555,30558,0,3,0
8750,6,3,30561,30561,30564,0,3,3
8751,4,1,30565,30565,30566,0,1,1
8752,6,3,30571,30571,30574,0,3,5
8753,6,2,30577,30577,30579,0,2,3
8754,4,3,30581,30581,30584,0,3,2
8755,1,2,30582,30584,30586,2,4,0
8756,4,2,30586,30586,30588,0,2,0
8757,2,2,30588,30588,30590,0,2,0
8758,2,3,30590,30590,30593,0,3,0
8759,3,3,30593,30593,30596,0,3,0
8760,5,2,30598,30598,30600,0,2,2
8761,4,2,30602,30602,30604,0,2,2
8762,1,1,30603,30604,30605,1,2,0
8763,1,3,30604,30605,30608,1,4,0
8764,1,3,30605,30608,30611,3,6,0
8765,5,3,30610,30611,30614,1,4,0
8766,4,1,30614,30614,30615,0,1,0
8767,5,2,30619,30619,30621,0,2,4
8768,5,2,30624,30624,30626,0,2,3
8769,3,2,30627,30627,30629,0,2,1
8770,3,3,30630,30630,30633,0,3,1
8771,5,2,30635,30635,30637,0,2,2
8772,2,2,30637,30637,30639,0,2,0
8773,4,1,30641,30641,30642,0,1,2
8774,3,2,30644,30644,30646,0,2,2
8775,1,3,30645,30646,30649,1,4,0
8776,4,3,30649,30649,30652,0,3,0
8777,1,1,30650,30652,30653,2,3,0
8778,2,3,30652,30653,30656,1,4,0
8779,1,1,30653,30656,30657,3,4,0
8780,2,3,30655,30657,30660,2,5,0
8781,3,2,30658,30660,30662,2,4,0
8782,1,3,30659,30662,30665,3,6,0
8783,2,3,30661,30665,30668,4,7,0
8784,1,1,30662,30668,30669,6,7,0
8785,6,3,30668,30669,30672,1,4,0
8786,4,3,30672,30672,30675,0,3,0
8787,5,2,30677,30677,30679,0,2,2
8788,2,2,30679,30679,30681,0,2,0
8789,2,2,30681,30681,30683,0,2,0
8790,6,2,30687,30687,30689,0,2,4
8791,3,2,30690,30690,30692,0,2,1
8792,5,1,30695,30695,30696,0,1,3
8793,2,1,30697,30697,30698,0,1,1
8794,2,3,30699,30699,30702,0,3,1
8795,5,3,30704,30704,30707,0,3,2
8796,4,1,30708,30708,30709,0,1,1
8797,3,1,30711,30711,30712,0,1,2
8798,6,2,30717,30717,30719,0,2,5
8799,4,2,30721,30721,30723,0,2,2
8800,2,1,30723,30723,30724,0,1,0
8801,3,1,30726,30726,30727,0,1,2
8802,4,1,30730,30730,30731,0,1,3
8803,4,2,30734,30734,30736,0,2,3
8804,6,2,30740,30740,30742,0,2,4
8805,1,3,30741,30742,30745,1,4,0
8806,4,3,30745,30745,30748,0,3,0
8807,5,1,30750,30750,30751,0,1,2
8808,2,1,30752,30752,30753,0,1,1
8809,2,1,30754,30754,30755,0,1,1
8810,5,3,30759,30759,30762,0,3,4
8811,6,3,30765,30765,30768,0,3,3
8812,1,2,30766,30768,30770,2,4,0
8813,4,3,30770,30770,30773,0,3,0
8814,5,1,30775,30775,30776,0,1,2
8815,4,3,30779,30779,30782,0,3,3
8816,6,3,30785,30785,30788,0,3,3
8817,1,2,30786,30788,30790,2,4,0
8818,6,2,30792,30792,30794,0,2,2
8819,4,3,30796,30796,30799,0,3,2
8820,1,1,30797,30799,30800,2,3,0
8821,1,3,30798,30800,30803,2,5,0
8822,1,1,30799,30803,30804,4,5,0
8823,5,1,30804,30804,30805,0,1,0
8824,5,2,30809,30809,30811,0,2,4
8825,1,3,30810,30811,30814,1,4,0
8826,5,3,30815,30815,30818,0,3,1
8827,5,2,30820,30820,30822,0,2,2
8828,2,3,30822,30822,30825,0,3,0
8829,2,2,30824,30825,30827,1,3,0
8830,5,1,30829,30829,30830,0,1,2
8831,6,1,30835,30835,30836,0,1,5
8832,1,2,30836,30836,30838,0,2,0
8833,5,2,30841,30841,30843,0,2,3
8834,4,2,30845,30845,30847,0,2,2
8835,5,2,30850,30850,30852,0,2,3
8836,6,2,30856,30856,30858,0,2,4
8837,3,2,30859,30859,30861,0,2,1
8838,4,1,30863,30863,30864,0,1,2
8839,6,2,30869,30869,30871,0,2,5
8840,4,3,30873,30873,30876,0,3,2
8841,5,3,30878,30878,30881,0,3,2
8842,3,3,30881,30881,30884,0,3,0
8843,6,2,30887,30887,30889,0,2,3
8844,3,3,30890,30890,30893,0,3,1
8845,5,1,30895,30895,30896,0,1,2
8846,4,1,30899,30899,30900,0,1,3
8847,6,2,30905,30905,30907,0,2,5
8848,4,2,30909,30909,30911,0,2,2
8849,6,2,30915,30915,30917,0,2,4
8850,5,1,30920,30920,30921,0,1,3
8851,2,1,30922,30922,30923,0,1,1
8852,1,1,30923,30923,30924,0,1,0
8853,6,3,30929,30929,30932,0,3,5
8854,3,1,30932,30932,30933,0,1,0
8855,4,1,30936,30936,30937,0,1,3
8856,1,2,30937,30937,30939,0,2,0
8857,4,1,30941,30941,30942,0,1,2
8858,3,2,30944,30944,30946,0,2,2
8859,1,1,30945,30946,30947,1,2,0
8860,1,2,30946,30947,30949,1,3,0
8861,6,2,30952,30952,30954,0,2,3
8862,3,3,30955,30955,30958,0,3,1
8863,1,1,30956,30958,30959,2,3,0
8864,5,2,30961,30961,30963,0,2,2
8865,2,2,30963,30963,30965,0,2,0
8866,4,1,30967,30967,30968,0,1,2
8867,6,1,30973,30973,30974,0,1,5
8868,1,1,30974,30974,30975,0,1,0
8869,2,2,30976,30976,30978,0,2,1
8870,6,3,30982,30982,30985,0,3,4
8871,6,3,30988,30988,30991,0,3,3
8872,3,3,30991,30991,30994,0,3,0
8873,3,2,30994,30994,30996,0,2,0
8874,4,3,30998,30998,31001,0,3,2
8875,3,2,31001,31001,31003,0,2,0
8876,6,3,31007,31007,31010,0,3,4
8877,3,2,31010,31010,31012,0,2,0
8878,4,1,31014,31014,31015,0,1,2
8879,2,3,31016,31016,31019,0,3,1
8880,1,2,31017,31019,31021,2,4,0
8881,5,1,31022,31022,31023,0,1,1
8882,6,3,31028,31028,31031,0,3,5
8883,4,2,31032,31032,31034,0,2,1
8884,6,1,31038,31038,31039,0,1,4
8885,1,1,31039,31039,31040,0,1,0
8886,6,3,31045,31045,31048,0,3,5
8887,6,1,31051,31051,31052,0,1,3
8888,5,3,31056,31056,31059,0,3,4
8889,5,3,31061,31061,31064,0,3,2
8890,4,1,31065,31065,31066,0,1,1
8891,3,3,31068,31068,31071,0,3,2
8892,4,2,31072,31072,31074,0,2,1
8893,6,2,31078,31078,31080,0,2,4
8894,1,3,31079,31080,31083,1,4,0
8895,2,3,31081,31083,31086,2,5,0
8896,3,2,31084,31086,31088,2,4,0
8897,4,2,31088,31088,31090,0,2,0
8898,4,1,31092,31092,31093,0,1,2
8899,4,2,31096,31096,31098,0,2,3
8900,5,1,31101,31101,31102,0,1,3
8901,4,3,31105,31105,31108,0,3,3
8902,5,1,31110,31110,31111,0,1,2
8903,2,3,31112,31112,31115,0,3,1
8904,5,1,31117,31117,31118,0,1,2
8905,3,1,31120,31120,31121,0,1,2
8906,3,3,31123,31123,31126,0,3,2
8907,4,2,31127,31127,31129,0,2,1
8908,1,2,31128,31129,31131,1,3,0
8909,5,1,31133,31133,31134,0,1,2
8910,1,2,31134,31134,31136,0,2,0
8911,2,3,31136,31136,31139,0,3,0
8912,2,3,31138,31139,31142,1,4,0
8913,2,3,31140,31142,31145,2,5,0
8914,5,1,31145,31145,31146,0,1,0
8915,4,1,31149,31149,31150,0,1,3
8916,4,1,31153,31153,31154,0,1,3
8917,2,2,31155,31155,31157,0,2,1
8918,5,1,31160,31160,31161,0,1,3
8919,3,1,31163,31163,31164,0,1,2
8920,2,2,31165,31165,31167,0,2,1
8921,2,2,31167,31167,31169,0,2,0
8922,2,3,31169,31169,31172,0,3,0
8923,3,2,31172,31172,31174,0,2,0
8924,4,1,31176,31176,31177,0,1,2
8925,4,1,31180,31180,31181,0,1,3
8926,3,3,31183,31183,31186,0,3,2
8927,6,2,31189,31189,31191,0,2,3
8928,2,3,31191,31191,31194,0,3,0
8929,5,1,31196,31196,31197,0,1,2
8930,2,3,31198,31198,31201,0,3,1
8931,2,3,31200,31201,31204,1,4,0
8932,2,1,31202,31204,31205,2,3,0
8933,3,2,31205,31205,31207,0,2,0
8934,6,3,31211,31211,31214,0,3,4
8935,3,2,31214,31214,31216,0,2,0
8936,5,2,31219,31219,31221,0,2,3
8937,3,1,31222,31222,31223,0,1,1
8938,3,3,31225,31225,31228,0,3,2
8939,4,1,31229,31229,31230,0,1,1
8940,2,3,31231,31231,31234,0,3,1
8941,2,3,31233,31234,31237,1,4,0
8942,1,1,31234,31237,31238,3,4,0
8943,5,2,31239,31239,31241,0,2,1
8944,5,2,31244,31244,31246,0,2,3
8945,1,2,31245,31246,31248,1,3,0
8946,1,3,31246,31248,31251,2,5,0
8947,6,1,31252,31252,31253,0,1,1
8948,1,3,31253,31253,31256,0,3,0
8949,5,3,31258,31258,31261,0,3,2
8950,2,3,31260,31261,31264,1,4,0
8951,1,2,31261,31264,31266,3,5,0
8952,2,1,31263,31266,31267,3,4,0
8953,1,1,31264,31267,31268,3,4,0
8954,3,1,31267,31268,31269,1,2,0
8955,6,1,31273,31273,31274,0,1,4
8956,1,3,31274,31274,31277,0,3,0
8957,2,3,31276,31277,31280,1,4,0
8958,2,1,31278,31280,31281,2,3,0
8959,6,1,31284,31284,31285,0,1,3
8960,6,2,31290,31290,31292,0,2,5
8961,6,3,31296,31296,31299,0,3,4
8962,4,1,31300,31300,31301,0,1,1
8963,4,1,31304,31304,31305,0,1,3
8964,4,2,31308,31308,31310,0,2,3
8965,5,3,31313,31313,31316,0,3,3
8966,4,3,31317,31317,31320,0,3,1
8967,2,3,31319,31320,31323,1,4,0
8968,6,1,31325,31325,31326,0,1,2
8969,6,1,31331,31331,31332,0,1,5
8970,5,2,31336,31336,31338,0,2,4
8971,5,3,31341,31341,31344,0,3,3
8972,5,1,31346,31346,31347,0,1,2
8973,5,3,31351,31351,31354,0,3,4
8974,6,3,31357,31357,31360,0,3,3
8975,1,1,31358,31360,31361,2,3,0
8976,1,1,31359,31361,31362,2,3,0
8977,6,3,31365,31365,31368,0,3,3
8978,2,3,31367,31368,31371,1,4,0
8979,4,2,31371,31371,31373,0,2,0
8980,5,2,31376,31376,31378,0,2,3
8981,1,2,31377,31378,31380,1,3,0
8982,4,1,31381,31381,31382,0,1,1
8983,5,3,31386,31386,31389,0,3,4
8984,6,1,31392,31392,31393,0,1,3
8985,1,2,31393,31393,31395,0,2,0
8986,5,1,31398,31398,31399,0,1,3
8987,5,1,31403,31403,31404,0,1,4
8988,4,1,31407,31407,31408,0,1,3
8989,5,3,31412,31412,31415,0,3,4
8990,6,3,31418,31418,31421,0,3,3
8991,3,1,31421,31421,31422,0,1,0
8992,6,3,31427,31427,31430,0,3,5
8993,3,3,31430,31430,31433,0,3,0
8994,6,1,31436,31436,31437,0,1,3
8995,4,2,31440,31440,31442,0,2,3
8996,5,2,31445,31445,31447,0,2,3
8997,2,2,31447,31447,31449,0,2,0
8998,6,2,31453,31453,31455,0,2,4
8999,5,3,31458,31458,31461,0,3,3
9000,2,3,31460,31461,31464,1,4,0
9001,3,2,31463,31464,31466,1,3,0
9002,5,3,31468,31468,31471,0,3,2
9003,6,1,31474,31474,31475,0,1,3
9004,4,2,31478,31478,31480,0,2,3
9005,3,1,31481,31481,31482,0,1,1
9006,4,2,31485,31485,31487,0,2,3
9007,6,3,31491,31491,31494,0,3,4
9008,1,3,31492,31494,31497,2,5,0
9009,6,1,31498,31498,31499,0,1,1
9010,1,3,31499,31499,31502,0,3,0
9011,5,2,31504,31504,31506,0,2,2
9012,2,3,31506,31506,31509,0,3,0
9013,5,2,31511,31511,31513,0,2,2
9014,4,2,31515,31515,31517,0,2,2
9015,2,1,31517,31517,31518,0,1,0
9016,3,2,31520,31520,31522,0,2,2
9017,3,2,31523,31523,31525,0,2,1
9018,4,3,31527,31527,31530,0,3,2
9019,3,2,31530,31530,31532,0,2,0
9020,2,3,31532,31532,31535,0,3,0
9021,5,1,31537,31537,31538,0,1,2
9022,3,1,31540,31540,31541,0,1,2
9023,5,1,31545,31545,31546,0,1,4
9024,6,2,31551,31551,31553,0,2,5
9025,4,3,31555,31555,31558,0,3,2
9026,4,2,31559,31559,31561,0,2,1
9027,5,2,31564,31564,31566,0,2,3
9028,5,3,31569,31569,31572,0,3,3
9029,3,3,31572,31572,31575,0,3,0
9030,2,2,31574,31575,31577,1,3,0
9031,3,3,31577,31577,31580,0,3,0
9032,4,3,31581,31581,31584,0,3,1
9033,3,1,31584,31584,31585,0,1,0
9034,3,3,31587,31587,31590,0,3,2
9035,5,2,31592,31592,31594,0,2,2
9036,5,3,31597,31597,31600,0,3,3
9037,6,2,31603,31603,31605,0,2,3
9038,1,1,31604,31605,31606,1,2,0
9039,1,2,31605,31606,31608,1,3,0
9040,1,3,31606,31608,31611,2,5,0
9041,5,2,31611,31611,31613,0,2,0
9042,6,2,31617,31617,31619,0,2,4
9043,3,2,31620,31620,31622,0,2,1
9044,5,3,31625,31625,31628,0,3,3
9045,4,2,31629,31629,31631,0,2,1
9046,6,2,31635,31635,31637,0,2,4
9047,6,2,31641,31641,31643,0,2,4
9048,1,2,31642,31643,31645,1,3,0
9049,4,2,31646,31646,31648,0,2,1
9050,1,1,31647,31648,31649,1,2,0
9051,1,3,31648,31649,31652,1,4,0
9052,1,3,31649,31652,31655,3,6,0
9053,5,1,31654,31655,31656,1,2,0
9054,6,2,31660,31660,31662,0,2,4
9055,5,1,31665,31665,31666,0,1,3
9056,4,3,31669,31669,31672,0,3,3
9057,2,2,31671,31672,31674,1,3,0
9058,2,1,31673,31674,31675,1,2,0
9059,2,1,31675,31675,31676,0,1,0
9060,2,2,31677,31677,31679,0,2,1
9061,2,2,31679,31679,31681,0,2,0
9062,4,1,31683,31683,31684,0,1,2
9063,5,3,31688,31688,31691,0,3,4
9064,3,2,31691,31691,31693,0,2,0
9065,6,1,31697,31697,31698,0,1,4
9066,5,2,31702,31702,31704,0,2,4
9067,3,2,31705,31705,31707,0,2,1
9068,1,3,31706,31707,31710,1,4,0
9069,2,3,31708,31710,31713,2,5,0
9070,4,2,31712,31713,31715,1,3,0
9071,3,2,31715,31715,31717,0,2,0
9072,6,3,31721,31721,31724,0,3,4
9073,5,2,31726,31726,31728,0,2,2
9074,1,3,31727,31728,31731,1,4,0
9075,5,3,31732,31732,31735,0,3,1
9076,5,3,31737,31737,31740,0,3,2
9077,6,3,31743,31743,31746,0,3,3
9078,4,1,31747,31747,31748,0,1,1
9079,3,2,31750,31750,31752,0,2,2
9080,1,1,31751,31752,31753,1,2,0
9081,1,3,31752,31753,31756,1,4,0
9082,3,1,31755,31756,31757,1,2,0
9083,6,2,31761,31761,31763,0,2,4
9084,2,3,31763,31763,31766,0,3,0
9085,4,1,31767,31767,31768,0,1,1
9086,6,3,31773,31773,31776,0,3,5
9087,4,1,31777,31777,31778,0,1,1
9088,1,1,31778,31778,31779,0,1,0
9089,5,1,31783,31783,31784,0,1,4
9090,4,1,31787,31787,31788,0,1,3
9091,1,3,31788,31788,31791,0,3,0
9092,4,3,31792,31792,31795,0,3,1
9093,1,3,31793,31795,31798,2,5,0
9094,1,2,31794,31798,31800,4,6,0
9095,5,2,31799,31800,31802,1,3,0
9096,2,2,31801,31802,31804,1,3,0
9097,1,2,31802,31804,31806,2,4,0
9098,6,3,31808,31808,31811,0,3,2
9099,4,3,31812,31812,31815,0,3,1
9100,1,2,31813,31815,31817,2,4,0
9101,1,1,31814,31817,31818,3,4,0
9102,4,3,31818,31818,31821,0,3,0
9103,1,2,31819,31821,31823,2,4,0
9104,1,3,31820,31823,31826,3,6,0
9105,6,3,31826,31826,31829,0,3,0
9106,2,1,31828,31829,31830,1,2,0
9107,5,1,31833,31833,31834,0,1,3
9108,6,3,31839,31839,31842,0,3,5
9109,2,2,31841,31842,31844,1,3,0
9110,4,3,31845,31845,31848,0,3,1
9111,5,1,31850,31850,31851,0,1,2
9112,5,2,31855,31855,31857,0,2,4
9113,4,1,31859,31859,31860,0,1,2
9114,6,2,31865,31865,31867,0,2,5
9115,5,2,31870,31870,31872,0,2,3
9116,3,1,31873,31873,31874,0,1,1
9117,2,3,31875,31875,31878,0,3,1
9118,2,1,31877,31878,31879,1,2,0
9119,4,1,31881,31881,31882,0,1,2
9120,3,3,31884,31884,31887,0,3,2
9121,1,2,31885,31887,31889,2,4,0
9122,6,3,31891,31891,31894,0,3,2
9123,6,2,31897,31897,31899,0,2,3
9124,2,2,31899,31899,31901,0,2,0
9125,6,2,31905,31905,31907,0,2,4
9126,2,2,31907,31907,31909,0,2,0
9127,3,2,31910,31910,31912,0,2,1
9128,5,3,31915,31915,31918,0,3,3
9129,2,2,31917,31918,31920,1,3,0
9130,3,1,31920,31920,31921,0,1,0
9131,4,1,31924,31924,31925,0,1,3
9132,6,3,31930,31930,31933,0,3,5
9133,3,1,31933,31933,31934,0,1,0
9134,1,2,31934,31934,31936,0,2,0
9135,1,2,31935,31936,31938,1,3,0
9136,6,2,31941,31941,31943,0,2,3
9137,6,2,31947,31947,31949,0,2,4
9138,5,2,31952,31952,31954,0,2,3
9139,4,1,31956,31956,31957,0,1,2
9140,2,2,31958,31958,31960,0,2,1
9141,2,1,31960,31960,31961,0,1,0
9142,4,2,31964,31964,31966,0,2,3
9143,5,3,31969,31969,31972,0,3,3
9144,5,1,31974,31974,31975,0,1,2
9145,3,3,31977,31977,31980,0,3,2
9146,3,1,31980,31980,31981,0,1,0
9147,1,1,31981,31981,31982,0,1,0
9148,6,1,31987,31987,31988,0,1,5
9149,6,2,31993,31993,31995,0,2,5
9150,2,1,31995,31995,31996,0,1,0
9151,1,3,31996,31996,31999,0,3,0
9152,6,1,32002,32002,32003,0,1,3
9153,2,1,32004,32004,32005,0,1,1
9154,4,1,32008,32008,32009,0,1,3
9155,4,3,32012,32012,32015,0,3,3
9156,5,2,32017,32017,32019,0,2,2
9157,4,1,32021,32021,32022,0,1,2
9158,5,1,32026,32026,32027,0,1,4
9159,5,1,32031,32031,32032,0,1,4
9160,6,1,32037,32037,32038,0,1,5
9161,1,2,32038,32038,32040,0,2,0
9162,1,3,32039,32040,32043,1,4,0
9163,3,3,32042,32043,32046,1,4,0
9164,6,3,32048,32048,32051,0,3,2
9165,2,3,32050,32051,32054,1,4,0
9166,5,2,32055,32055,32057,0,2,1
9167,2,1,32057,32057,32058,0,1,0
9168,2,2,32059,32059,32061,0,2,1
9169,4,1,32063,32063,32064,0,1,2
9170,1,1,32064,32064,32065,0,1,0
9171,3,3,32067,32067,32070,0,3,2
9172,4,1,32071,32071,32072,0,1,1
9173,3,1,32074,32074,32075,0,1,2
9174,2,3,32076,32076,32079,0,3,1
9175,2,2,32078,32079,32081,1,3,0
9176,2,2,32080,32081,32083,1,3,0
9177,6,1,32086,32086,32087,0,1,3
9178,2,1,32088,32088,32089,0,1,1
9179,3,2,32091,32091,32093,0,2,2
9180,4,1,32095,32095,32096,0,1,2
9181,3,2,32098,32098,32100,0,2,2
9182,5,1,32103,32103,32104,0,1,3
9183,5,1,32108,32108,32109,0,1,4
9184,5,1,32113,32113,32114,0,1,4
9185,1,1,32114,32114,32115,0,1,0
9186,1,1,32115,32115,32116,0,1,0
9187,4,3,32119,32119,32122,0,3,3
9188,6,1,32125,32125,32126,0,1,3
9189,1,3,32126,32126,32129,0,3,0
9190,1,1,32127,32129,32130,2,3,0
9191,2,3,32129,32130,32133,1,4,0
9192,6,2,32135,32135,32137,0,2,2
9193,3,3,32138,32138,32141,0,3,1
9194,5,1,32143,32143,32144,0,1,2
9195,6,1,32149,32149,32150,0,1,5
9196,6,3,32155,32155,32158,0,3,5
9197,3,2,32158,32158,32160,0,2,0
9198,1,3,32159,32160,32163,1,4,0
9199,2,2,32161,32163,32165,2,4,0
9200,2,3,32163,32165,32168,2,5,0
9201,6,2,32169,32169,32171,0,2,1
9202,6,1,32175,32175,32176,0,1,4
9203,5,2,32180,32180,32182,0,2,4
9204,1,2,32181,32182,32184,1,3,0
9205,6,2,32187,32187,32189,0,2,3
9206,6,3,32193,32193,32196,0,3,4
9207,5,2,32198,32198,32200,0,2,2
9208,1,1,32199,32200,32201,1,2,0
9209,4,3,32203,32203,32206,0,3,2
9210,1,3,32204,32206,32209,2,5,0
9211,3,2,32207,32209,32211,2,4,0
9212,2,1,32209,32211,32212,2,3,0
9213,1,2,32210,32212,32214,2,4,0
9214,5,1,32215,32215,32216,0,1,1
9215,3,2,32218,32218,32220,0,2,2
9216,4,2,32222,32222,32224,0,2,2
9217,6,2,32228,32228,32230,0,2,4
9218,1,1,32229,32230,32231,1,2,0
9219,3,3,32232,32232,32235,0,3,1
9220,4,1,32236,32236,32237,0,1,1
9221,5,1,32241,32241,32242,0,1,4
9222,3,2,32244,32244,32246,0,2,2
9223,5,1,32249,32249,32250,0,1,3
9224,1,2,32250,32250,32252,0,2,0
9225,5,1,32255,32255,32256,0,1,3
9226,3,3,32258,32258,32261,0,3,2
9227,4,3,32262,32262,32265,0,3,1
9228,3,1,32265,32265,32266,0,1,0
9229,5,3,32270,32270,32273,0,3,4
9230,2,1,32272,32273,32274,1,2,0
9231,6,3,32278,32278,32281,0,3,4
9232,3,1,32281,32281,32282,0,1,0
9233,3,3,32284,32284,32287,0,3,2
9234,5,3,32289,32289,32292,0,3,2
9235,5,3,32294,32294,32297,0,3,2
9236,5,3,32299,32299,32302,0,3,2
9237,4,3,32303,32303,32306,0,3,1
9238,5,1,32308,32308,32309,0,1,2
9239,5,3,32313,32313,32316,0,3,4
9240,3,2,32316,32316,32318,0,2,0
9241,5,3,32321,32321,32324,0,3,3
9242,6,2,32327,32327,32329,0,2,3
9243,6,3,32333,32333,32336,0,3,4
9244,2,2,32335,32336,32338,1,3,0
9245,4,2,32339,32339,32341,0,2,1
9246,5,2,32344,32344,32346,0,2,3
9247,2,2,32346,32346,32348,0,2,0
9248,4,1,32350,32350,32351,0,1,2
9249,5,3,32355,32355,32358,0,3,4
9250,3,3,32358,32358,32361,0,3,0
9251,4,3,32362,32362,32365,0,3,1
9252,3,2,32365,32365,32367,0,2,0
9253,1,3,32366,32367,32370,1,4,0
9254,1,3,32367,32370,32373,3,6,0
9255,2,1,32369,32373,32374,4,5,0
9256,1,2,32370,32374,32376,4,6,0
9257,1,2,32371,32376,32378,5,7,0
9258,6,1,32377,32378,32379,1,2,0
9259,1,3,32378,32379,32382,1,4,0
9260,1,1,32379,32382,32383,3,4,0
9261,3,2,32382,32383,32385,1,3,0
9262,5,3,32387,32387,32390,0,3,2
9263,5,1,32392,32392,32393,0,1,2
9264,1,1,32393,32393,32394,0,1,0
9265,5,3,32398,32398,32401,0,3,4
9266,2,2,32400,32401,32403,1,3,0
9267,6,2,32406,32406,32408,0,2,3
9268,5,2,32411,32411,32413,0,2,3
9269,1,3,32412,32413,32416,1,4,0
9270,6,2,32418,32418,32420,0,2,2
9271,5,1,32423,32423,32424,0,1,3
9272,1,1,32424,32424,32425,0,1,0
9273,5,3,32429,32429,32432,0,3,4
9274,2,2,32431,32432,32434,1,3,0
9275,1,1,32432,32434,32435,2,3,0
9276,1,2,32433,32435,32437,2,4,0
9277,5,3,32438,32438,32441,0,3,1
9278,4,1,32442,32442,32443,0,1,1
9279,4,2,32446,32446,32448,0,2,3
9280,3,3,32449,32449,32452,0,3,1
9281,6,3,32455,32455,32458,0,3,3
9282,4,1,32459,32459,32460,0,1,1
9283,5,1,32464,32464,32465,0,1,4
9284,1,2,32465,32465,32467,0,2,0
9285,5,3,32470,32470,32473,0,3,3
9286,6,1,32476,32476,32477,0,1,3
9287,1,1,32477,32477,32478,0,1,0
9288,4,2,32481,32481,32483,0,2,3
9289,1,3,32482,32483,32486,1,4,0
9290,3,1,32485,32486,32487,1,2,0
9291,2,3,32487,32487,32490,0,3,0
9292,6,1,32493,32493,32494,0,1,3
9293,3,2,32496,32496,32498,0,2,2
9294,2,2,32498,32498,32500,0,2,0
9295,4,3,32502,32502,32505,0,3,2
9296,1,1,32503,32505,32506,2,3,0
9297,2,3,32505,32506,32509,1,4,0
9298,5,3,32510,32510,32513,0,3,1
9299,4,2,32514,32514,32516,0,2,1
9300,6,1,32520,32520,32521,0,1,4
9301,1,3,32521,32521,32524,0,3,0
9302,4,3,32525,32525,32528,0,3,1
9303,4,2,32529,32529,32531,0,2,1
9304,3,1,32532,32532,32533,0,1,1
9305,5,3,32537,32537,32540,0,3,4
9306,5,1,32542,32542,32543,0,1,2
9307,1,3,32543,32543,32546,0,3,0
9308,4,2,32547,32547,32549,0,2,1
9309,5,1,32552,32552,32553,0,1,3
9310,1,3,32553,32553,32556,0,3,0
9311,6,1,32559,32559,32560,0,1,3
9312,2,1,32561,32561,32562,0,1,1
9313,3,3,32564,32564,32567,0,3,2
9314,4,1,32568,32568,32569,0,1,1
9315,3,3,32571,32571,32574,0,3,2
9316,5,3,32576,32576,32579,0,3,2
9317,4,3,32580,32580,32583,0,3,1
9318,1,3,32581,32583,32586,2,5,0
9319,6,1,32587,32587,32588,0,1,1
9320,5,1,32592,32592,32593,0,1,4
9321,5,1,32597,32597,32598,0,1,4
9322,2,1,32599,32599,32600,0,1,1
9323,5,1,32604,32604,32605,0,1,4
9324,1,2,32605,32605,32607,0,2,0
9325,1,1,32606,32607,32608,1,2,0
9326,2,2,32608,32608,32610,0,2,0
9327,4,1,32612,32612,32613,0,1,2
9328,2,1,32614,32614,32615,0,1,1
9329,1,1,32615,32615,32616,0,1,0
9330,3,3,32618,32618,32621,0,3,2
9331,6,3,32624,32624,32627,0,3,3
9332,2,1,32626,32627,32628,1,2,0
9333,4,1,32630,32630,32631,0,1,2
9334,5,2,32635,32635,32637,0,2,4
9335,1,1,32636,32637,32638,1,2,0
9336,3,2,32639,32639,32641,0,2,1
9337,6,1,32645,32645,32646,0,1,4
9338,5,2,32650,32650,32652,0,2,4
9339,2,3,32652,32652,32655,0,3,0
9340,1,1,32653,32655,32656,2,3,0
9341,1,2,32654,32656,32658,2,4,0
9342,5,3,32659,32659,32662,0,3,1
9343,1,3,32660,32662,32665,2,5,0
9344,2,1,32662,32665,32666,3,4,0
9345,6,3,32668,32668,32671,0,3,2
9346,1,1,32669,32671,32672,2,3,0
9347,5,1,32674,32674,32675,0,1,2
9348,1,3,32675,32675,32678,0,3,0
9349,5,2,32680,32680,32682,0,2,2
9350,2,1,32682,32682,32683,0,1,0
9351,6,1,32688,32688,32689,0,1,5
9352,6,1,32694,32694,32695,0,1,5
9353,1,1,32695,32695,32696,0,1,0
9354,1,3,32696,32696,32699,0,3,0
9355,6,2,32702,32702,32704,0,2,3
9356,6,2,32708,32708,32710,0,2,4
9357,3,3,32711,32711,32714,0,3,1
9358,3,1,32714,32714,32715,0,1,0
9359,4,1,32718,32718,32719,0,1,3
9360,3,3,32721,32721,32724,0,3,2
9361,1,3,32722,32724,32727,2,5,0
9362,6,1,32728,32728,32729,0,1,1
9363,3,2,32731,32731,32733,0,2,2
9364,4,2,32735,32735,32737,0,2,2
9365,6,3,32741,32741,32744,0,3,4
9366,4,2,32745,32745,32747,0,2,1
9367,4,1,32749,32749,32750,0,1,2
9368,5,3,32754,32754,32757,0,3,4
9369,1,2,32755,32757,32759,2,4,0
9370,5,3,32760,32760,32763,0,3,1
9371,1,2,32761,32763,32765,2,4,0
9372,2,2,32763,32765,32767,2,4,0
9373,6,1,32769,32769,32770,0,1,2
9374,1,3,32770,32770,32773,0,3,0
9375,2,1,32772,32773,32774,1,2,0
9376,4,1,32776,32776,32777,0,1,2
9377,4,3,32780,32780,32783,0,3,3
9378,3,2,32783,32783,32785,0,2,0
9379,6,1,32789,32789,32790,0,1,4
9380,1,3,32790,32790,32793,0,3,0
9381,1,3,32791,32793,32796,2,5,0
9382,2,2,32793,32796,32798,3,5,0
9383,4,2,32797,32798,32800,1,3,0
9384,6,2,32803,32803,32805,0,2,3
9385,1,2,32804,32805,32807,1,3,0
9386,4,1,32808,32808,32809,0,1,1
9387,6,1,32814,32814,32815,0,1,5
9388,6,3,32820,32820,32823,0,3,5
9389,2,2,32822,32823,32825,1,3,0
9390,1,3,32823,32825,32828,2,5,0
9391,1,2,32824,32828,32830,4,6,0
9392,3,3,32827,32830,32833,3,6,0
9393,1,2,32828,32833,32835,5,7,0
9394,4,3,32832,32835,32838,3,6,0
9395,4,3,32836,32838,32841,2,5,0
9396,1,3,32837,32841,32844,4,7,0
9397,4,2,32841,32844,32846,3,5,0
9398,6,2,32847,32847,32849,0,2,1
9399,1,1,32848,32849,32850,1,2,0
9400,1,1,32849,32850,32851,1,2,0
9401,4,2,32853,32853,32855,0,2,2
9402,4,3,32857,32857,32860,0,3,2
9403,6,2,32863,32863,32865,0,2,3
9404,5,2,32868,32868,32870,0,2,3
9405,1,3,32869,32870,32873,1,4,0
9406,4,1,32873,32873,32874,0,1,0
9407,1,1,32874,32874,32875,0,1,0
9408,5,1,32879,32879,32880,0,1,4
9409,5,1,32884,32884,32885,0,1,4
9410,5,2,32889,32889,32891,0,2,4
9411,3,3,32892,32892,32895,0,3,1
9412,3,1,32895,32895,32896,0,1,0
9413,4,3,32899,32899,32902,0,3,3
9414,2,3,32901,32902,32905,1,4,0
9415,1,2,32902,32905,32907,3,5,0
9416,2,2,32904,32907,32909,3,5,0
9417,1,3,32905,32909,32912,4,7,0
9418,6,2,32911,32912,32914,1,3,0
9419,6,3,32917,32917,32920,0,3,3
9420,4,1,32921,32921,32922,0,1,1
9421,1,3,32922,32922,32925,0,3,0
9422,4,3,32926,32926,32929,0,3,1
9423,3,2,32929,32929,32931,0,2,0
9424,4,3,32933,32933,32936,0,3,2
9425,4,2,32937,32937,32939,0,2,1
9426,2,3,32939,32939,32942,0,3,0
9427,5,2,32944,32944,32946,0,2,2
9428,5,2,32949,32949,32951,0,2,3
9429,2,2,32951,32951,32953,0,2,0
9430,1,3,32952,32953,32956,1,4,0
9431,4,1,32956,32956,32957,0,1,0
9432,1,1,32957,32957,32958,0,1,0
9433,4,2,32961,32961,32963,0,2,3
9434,3,1,32964,32964,32965,0,1,1
9435,4,1,32968,32968,32969,0,1,3
9436,4,1,32972,32972,32973,0,1,3
9437,2,3,32974,32974,32977,0,3,1
9438,4,3,32978,32978,32981,0,3,1
9439,5,2,32983,32983,32985,0,2,2
9440,3,1,32986,32986,32987,0,1,1
9441,1,3,32987,32987,32990,0,3,0
9442,4,3,32991,32991,32994,0,3,1
9443,5,1,32996,32996,32997,0,1,2
9444,6,2,33002,33002,33004,0,2,5
9445,1,3,33003,33004,33007,1,4,0
9446,4,3,33007,33007,33010,0,3,0
9447,6,1,33013,33013,33014,0,1,3
9448,3,2,33016,33016,33018,0,2,2
9449,5,3,33021,33021,33024,0,3,3
9450,4,3,33025,33025,33028,0,3,1
9451,4,3,33029,33029,33032,0,3,1
9452,2,2,33031,33032,33034,1,3,0
9453,6,3,33037,33037,33040,0,3,3
9454,2,1,33039,33040,33041,1,2,0
9455,6,2,33045,33045,33047,0,2,4
9456,5,1,33050,33050,33051,0,1,3
9457,6,3,33056,33056,33059,0,3,5
9458,6,3,33062,33062,33065,0,3,3
9459,4,2,33066,33066,33068,0,2,1
9460,6,2,33072,33072,33074,0,2,4
9461,2,3,33074,33074,33077,0,3,0
9462,1,1,33075,33077,33078,2,3,0
9463,6,3,33081,33081,33084,0,3,3
9464,3,1,33084,33084,33085,0,1,0
9465,6,3,33090,33090,33093,0,3,5
9466,1,3,33091,33093,33096,2,5,0
9467,4,3,33095,33096,33099,1,4,0
9468,6,3,33101,33101,33104,0,3,2
9469,1,1,33102,33104,33105,2,3,0
9470,4,1,33106,33106,33107,0,1,1
9471,5,1,33111,33111,33112,0,1,4
9472,1,3,33112,33112,33115,0,3,0
9473,4,3,33116,33116,33119,0,3,1
9474,5,1,33121,33121,33122,0,1,2
9475,2,1,33123,33123,33124,0,1,1
9476,2,2,33125,33125,33127,0,2,1
9477,2,3,33127,33127,33130,0,3,0
9478,4,2,33131,33131,33133,0,2,1
9479,1,1,33132,33133,33134,1,2,0
9480,6,3,33138,33138,33141,0,3,4
9481,1,2,33139,33141,33143,2,4,0
9482,6,1,33145,33145,33146,0,1,2
9483,4,1,33149,33149,33150,0,1,3
9484,4,1,33153,33153,33154,0,1,3
9485,4,2,33157,33157,33159,0,2,3
9486,1,2,33158,33159,33161,1,3,0
9487,5,3,33163,33163,33166,0,3,2
9488,6,3,33169,33169,33172,0,3,3
9489,5,2,33174,33174,33176,0,2,2
9490,6,1,33180,33180,33181,0,1,4
9491,2,1,33182,33182,33183,0,1,1
9492,4,3,33186,33186,33189,0,3,3
9493,6,2,33192,33192,33194,0,2,3
9494,3,1,33195,33195,33196,0,1,1
9495,3,1,33198,33198,33199,0,1,2
9496,1,2,33199,33199,33201,0,2,0
9497,3,3,33202,33202,33205,0,3,1
9498,1,3,33203,33205,33208,2,5,0
9499,1,1,33204,33208,33209,4,5,0
9500,1,1,33205,33209,33210,4,5,0
9501,2,2,33207,33210,33212,3,5,0
9502,6,1,33213,33213,33214,0,1,1
9503,2,2,33215,33215,33217,0,2,1
9504,6,2,33221,33221,33223,0,2,4
9505,6,2,33227,33227,33229,0,2,4
9506,4,1,33231,33231,33232,0,1,2
9507,4,2,33235,33235,33237,0,2,3
9508,1,1,33236,33237,33238,1,2,0
9509,2,1,33238,33238,33239,0,1,0
9510,3,2,33241,33241,33243,0,2,2
9511,6,1,33247,33247,33248,0,1,4
9512,3,2,33250,33250,33252,0,2,2
9513,2,1,33252,33252,33253,0,1,0
9514,4,1,33256,33256,33257,0,1,3
9515,3,2,33259,33259,33261,0,2,2
9516,6,2,33265,33265,33267,0,2,4
9517,1,3,33266,33267,33270,1,4,0
9518,3,1,33269,33270,33271,1,2,0
9519,3,3,33272,33272,33275,0,3,1
9520,1,3,33273,33275,33278,2,5,0
9521,1,1,33274,33278,33279,4,5,0
9522,1,3,33275,33279,33282,4,7,0
9523,2,2,33277,33282,33284,5,7,0
9524,1,1,33278,33284,33285,6,7,0
9525,5,1,33283,33285,33286,2,3,0
9526,2,2,33285,33286,33288,1,3,0
9527,3,2,33288,33288,33290,0,2,0
9528,5,2,33293,33293,33295,0,2,3
9529,5,1,33298,33298,33299,0,1,3
9530,6,1,33304,33304,33305,0,1,5
9531,6,3,33310,33310,33313,0,3,5
9532,6,3,33316,33316,33319,0,3,3
9533,4,3,33320,33320,33323,0,3,1
9534,5,3,33325,33325,33328,0,3,2
9535,6,2,33331,33331,33333,0,2,3
9536,4,1,33335,33335,33336,0,1,2
9537,1,2,33336,33336,33338,0,2,0
9538,2,3,33338,33338,33341,0,3,0
9539,6,1,33344,33344,33345,0,1,3
9540,2,1,33346,33346,33347,0,1,1
9541,6,3,33352,33352,33355,0,3,5
9542,6,2,33358,33358,33360,0,2,3
9543,3,3,33361,33361,33364,0,3,1
9544,5,2,33366,33366,33368,0,2,2
9545,3,2,33369,33369,33371,0,2,1
9546,3,3,33372,33372,33375,0,3,1
9547,3,1,33375,33375,33376,0,1,0
9548,2,3,33377,33377,33380,0,3,1
9549,6,1,33383,33383,33384,0,1,3
9550,4,1,33387,33387,33388,0,1,3
9551,4,1,33391,33391,33392,0,1,3
9552,6,2,33397,33397,33399,0,2,5
9553,5,1,33402,33402,33403,0,1,3
9554,5,2,33407,33407,33409,0,2,4
9555,5,3,33412,33412,33415,0,3,3
9556,4,1,33416,33416,33417,0,1,1
9557,3,3,33419,33419,33422,0,3,2
9558,1,2,33420,33422,33424,2,4,0
9559,4,1,33424,33424,33425,0,1,0
9560,4,3,33428,33428,33431,0,3,3
9561,1,3,33429,33431,33434,2,5,0
9562,1,2,33430,33434,33436,4,6,0
9563,5,1,33435,33436,33437,1,2,0
9564,6,3,33441,33441,33444,0,3,4
9565,1,3,33442,33444,33447,2,5,0
9566,3,3,33445,33447,33450,2,5,0
9567,5,3,33450,33450,33453,0,3,0
9568,1,3,33451,33453,33456,2,5,0
9569,3,2,33454,33456,33458,2,4,0
9570,3,3,33457,33458,33461,1,4,0
9571,4,2,33461,33461,33463,0,2,0
9572,4,3,33465,33465,33468,0,3,2
9573,3,2,33468,33468,33470,0,2,0
9574,2,1,33470,33470,33471,0,1,0
9575,3,1,33473,33473,33474,0,1,2
9576,1,2,33474,33474,33476,0,2,0
9577,1,2,33475,33476,33478,1,3,0
9578,2,1,33477,33478,33479,1,2,0
9579,1,2,33478,33479,33481,1,3,0
9580,6,1,33484,33484,33485,0,1,3
9581,4,3,33488,33488,33491,0,3,3
9582,4,3,33492,33492,33495,0,3,1
9583,5,3,33497,33497,33500,0,3,2
9584,3,1,33500,33500,33501,0,1,0
9585,4,3,33504,33504,33507,0,3,3
9586,2,1,33506,33507,33508,1,2,0
9587,6,2,33512,33512,33514,0,2,4
9588,3,1,33515,33515,33516,0,1,1
9589,4,3,33519,33519,33522,0,3,3
9590,6,1,33525,33525,33526,0,1,3
9591,6,2,33531,33531,33533,0,2,5
9592,5,2,33536,33536,33538,0,2,3
9593,6,1,33542,33542,33543,0,1,4
9594,5,1,33547,33547,33548,0,1,4
9595,2,2,33549,33549,33551,0,2,1
9596,2,1,33551,33551,33552,0,1,0
9597,3,2,33554,33554,33556,0,2,2
9598,3,2,33557,33557,33559,0,2,1
9599,6,3,33563,33563,33566,0,3,4
9600,4,1,33567,33567,33568,0,1,1
9601,3,3,33570,33570,33573,0,3,2
9602,5,3,33575,33575,33578,0,3,2
9603,3,2,33578,33578,33580,0,2,0
9604,4,2,33582,33582,33584,0,2,2
9605,3,1,33585,33585,33586,0,1,1
9606,4,3,33589,33589,33592,0,3,3
9607,2,2,33591,33592,33594,1,3,0
9608,2,2,33593,33594,33596,1,3,0
9609,4,2,33597,33597,33599,0,2,1
9610,6,1,33603,33603,33604,0,1,4
9611,2,1,33605,33605,33606,0,1,1
9612,5,3,33610,33610,33613,0,3,4
9613,5,3,33615,33615,33618,0,3,2
9614,3,3,33618,33618,33621,0,3,0
9615,1,3,33619,33621,33624,2,5,0
9616,1,3,33620,33624,33627,4,7,0
9617,2,1,33622,33627,33628,5,6,0
9618,4,3,33626,33628,33631,2,5,0
9619,6,3,33632,33632,33635,0,3,1
9620,6,3,33638,33638,33641,0,3,3
9621,3,2,33641,33641,33643,0,2,0
9622,5,2,33646,33646,33648,0,2,3
9623,1,1,33647,33648,33649,1,2,0
9624,6,3,33653,33653,33656,0,3,4
9625,3,1,33656,33656,33657,0,1,0
9626,3,2,33659,33659,33661,0,2,2
9627,6,2,33665,33665,33667,0,2,4
9628,5,2,33670,33670,33672,0,2,3
9629,3,1,33673,33673,33674,0,1,1
9630,5,1,33678,33678,33679,0,1,4
9631,5,1,33683,33683,33684,0,1,4
9632,4,1,33687,33687,33688,0,1,3
9633,3,2,33690,33690,33692,0,2,2
9634,2,1,33692,33692,33693,0,1,0
9635,4,2,33696,33696,33698,0,2,3
9636,6,1,33702,33702,33703,0,1,4
9637,5,1,33707,33707,33708,0,1,4
9638,2,1,33709,33709,33710,0,1,1
9639,3,1,33712,33712,33713,0,1,2
9640,1,1,33713,33713,33714,0,1,0
9641,6,3,33719,33719,33722,0,3,5
9642,5,3,33724,33724,33727,0,3,2
9643,4,2,33728,33728,33730,0,2,1
9644,6,2,33734,33734,33736,0,2,4
9645,4,3,33738,33738,33741,0,3,2
9646,4,2,33742,33742,33744,0,2,1
9647,5,2,33747,33747,33749,0,2,3
9648,2,3,33749,33749,33752,0,3,0
9649,1,2,33750,33752,33754,2,4,0
9650,6,1,33756,33756,33757,0,1,2
9651,6,2,33762,33762,33764,0,2,5
9652,1,1,33763,33764,33765,1,2,0
9653,1,2,33764,33765,33767,1,3,0
9654,5,1,33769,33769,33770,0,1,2
9655,3,3,33772,33772,33775,0,3,2
9656,4,3,33776,33776,33779,0,3,1
9657,4,3,33780,33780,33783,0,3,1
9658,6,1,33786,33786,33787,0,1,3
9659,6,1,33792,33792,33793,0,1,5
9660,4,2,33796,33796,33798,0,2,3
9661,3,3,33799,33799,33802,0,3,1
9662,4,2,33803,33803,33805,0,2,1
9663,6,3,33809,33809,33812,0,3,4
9664,1,1,33810,33812,33813,2,3,0
9665,2,3,33812,33813,33816,1,4,0
9666,5,2,33817,33817,33819,0,2,1
9667,2,1,33819,33819,33820,0,1,0
9668,4,2,33823,33823,33825,0,2,3
9669,4,1,33827,33827,33828,0,1,2
9670,3,1,33830,33830,33831,0,1,2
9671,4,3,33834,33834,33837,0,3,3
9672,6,1,33840,33840,33841,0,1,3
9673,4,3,33844,33844,33847,0,3,3
9674,5,2,33849,33849,33851,0,2,2
9675,1,3,33850,33851,33854,1,4,0
9676,5,1,33855,33855,33856,0,1,1
9677,4,2,33859,33859,33861,0,2,3
9678,6,2,33865,33865,33867,0,2,4
9679,5,1,33870,33870,33871,0,1,3
9680,6,3,33876,33876,33879,0,3,5
9681,5,1,33881,33881,33882,0,1,2
9682,6,3,33887,33887,33890,0,3,5
9683,4,3,33891,33891,33894,0,3,1
9684,4,2,33895,33895,33897,0,2,1
9685,6,2,33901,33901,33903,0,2,4
9686,5,1,33906,33906,33907,0,1,3
9687,2,3,33908,33908,33911,0,3,1
9688,4,3,33912,33912,33915,0,3,1
9689,5,3,33917,33917,33920,0,3,2
9690,1,1,33918,33920,33921,2,3,0
9691,4,1,33922,33922,33923,0,1,1
9692,1,2,33923,33923,33925,0,2,0
9693,6,1,33929,33929,33930,0,1,4
9694,2,3,33931,33931,33934,0,3,1
9695,6,3,33937,33937,33940,0,3,3
9696,6,3,33943,33943,33946,0,3,3
9697,1,3,33944,33946,33949,2,5,0
9698,4,2,33948,33949,33951,1,3,0
9699,5,3,33953,33953,33956,0,3,2
9700,3,2,33956,33956,33958,0,2,0
9701,1,1,33957,33958,33959,1,2,0
9702,6,1,33963,33963,33964,0,1,4
9703,1,2,33964,33964,33966,0,2,0
9704,4,2,33968,33968,33970,0,2,2
9705,5,3,33973,33973,33976,0,3,3
9706,5,1,33978,33978,33979,0,1,2
9707,5,2,33983,33983,33985,0,2,4
9708,6,1,33989,33989,33990,0,1,4
9709,5,2,33994,33994,33996,0,2,4
9710,2,2,33996,33996,33998,0,2,0
9711,1,3,33997,33998,34001,1,4,0
9712,5,3,34002,34002,34005,0,3,1
9713,4,1,34006,34006,34007,0,1,1
9714,6,2,34012,34012,34014,0,2,5
9715,5,1,34017,34017,34018,0,1,3
9716,5,1,34022,34022,34023,0,1,4
9717,4,3,34026,34026,34029,0,3,3
9718,3,2,34029,34029,34031,0,2,0
9719,1,3,34030,34031,34034,1,4,0
9720,3,1,34033,34034,34035,1,2,0
9721,6,2,34039,34039,34041,0,2,4
9722,1,2,34040,34041,34043,1,3,0
9723,2,1,34042,34043,34044,1,2,0
9724,5,1,34047,34047,34048,0,1,3
9725,2,3,34049,34049,34052,0,3,1
9726,6,2,34055,34055,34057,0,2,3
9727,2,3,34057,34057,34060,0,3,0
9728,1,2,34058,34060,34062,2,4,0
9729,1,1,34059,34062,34063,3,4,0
9730,1,2,34060,34063,34065,3,5,0
9731,6,2,34066,34066,34068,0,2,1
9732,3,1,34069,34069,34070,0,1,1
9733,2,3,34071,34071,34074,0,3,1
9734,4,3,34075,34075,34078,0,3,1
9735,5,2,34080,34080,34082,0,2,2
9736,5,2,34085,34085,34087,0,2,3
9737,5,2,34090,34090,34092,0,2,3
9738,2,3,34092,34092,34095,0,3,0
9739,1,1,34093,34095,34096,2,3,0
9740,1,1,34094,34096,34097,2,3,0
9741,2,2,34096,34097,34099,1,3,0
9742,2,3,34098,34099,34102,1,4,0
9743,1,1,34099,34102,34103,3,4,0
9744,5,1,34104,34104,34105,0,1,1
9745,3,2,34107,34107,34109,0,2,2
9746,6,1,34113,34113,34114,0,1,4
9747,4,3,34117,34117,34120,0,3,3
9748,3,3,34120,34120,34123,0,3,0
9749,5,1,34125,34125,34126,0,1,2
9750,1,1,34126,34126,34127,0,1,0
9751,3,2,34129,34129,34131,0,2,2
9752,2,1,34131,34131,34132,0,1,0
9753,1,3,34132,34132,34135,0,3,0
9754,3,1,34135,34135,34136,0,1,0
9755,3,2,34138,34138,34140,0,2,2
9756,6,3,34144,34144,34147,0,3,4
9757,2,1,34146,34147,34148,1,2,0
9758,4,3,34150,34150,34153,0,3,2
9759,5,2,34155,34155,34157,0,2,2
9760,4,2,34159,34159,34161,0,2,2
9761,2,1,34161,34161,34162,0,1,0
9762,5,1,34166,34166,34167,0,1,4
9763,4,3,34170,34170,34173,0,3,3
9764,3,3,34173,34173,34176,0,3,0
9765,6,3,34179,34179,34182,0,3,3
9766,3,1,34182,34182,34183,0,1,0
9767,5,3,34187,34187,34190,0,3,4
9768,2,1,34189,34190,34191,1,2,0
9769,2,1,34191,34191,34192,0,1,0
9770,5,2,34196,34196,34198,0,2,4
9771,6,3,34202,34202,34205,0,3,4
9772,6,2,34208,34208,34210,0,2,3
9773,1,1,34209,34210,34211,1,2,0
9774,4,3,34213,34213,34216,0,3,2
9775,3,1,34216,34216,34217,0,1,0
9776,3,3,34219,34219,34222,0,3,2
9777,4,2,34223,34223,34225,0,2,1
9778,1,3,34224,34225,34228,1,4,0
9779,1,1,34225,34228,34229,3,4,0
9780,2,3,34227,34229,34232,2,5,0
9781,2,1,34229,34232,34233,3,4,0
9782,2,2,34231,34233,34235,2,4,0
9783,3,2,34234,34235,34237,1,3,0
9784,4,3,34238,34238,34241,0,3,1
9785,2,3,34240,34241,34244,1,4,0
9786,1,2,34241,34244,34246,3,5,0
9787,2,3,34243,34246,34249,3,6,0
9788,2,3,34245,34249,34252,4,7,0
9789,2,3,34247,34252,34255,5,8,0
9790,1,2,34248,34255,34257,7,9,0
9791,1,1,34249,34257,34258,8,9,0
9792,3,3,34252,34258,34261,6,9,0
9793,2,3,34254,34261,34264,7,10,0
9794,2,1,34256,34264,34265,8,9,0
9795,5,2,34261,34265,34267,4,6,0
9796,5,2,34266,34267,34269,1,3,0
9797,5,1,34271,34271,34272,0,1,2
9798,5,2,34276,34276,34278,0,2,4
9799,3,2,34279,34279,34281,0,2,1
9800,1,3,34280,34281,34284,1,4,0
9801,4,3,34284,34284,34287,0,3,0
9802,1,3,34285,34287,34290,2,5,0
9803,2,2,34287,34290,34292,3,5,0
9804,3,1,34290,34292,34293,2,3,0
9805,2,2,34292,34293,34295,1,3,0
9806,6,2,34298,34298,34300,0,2,3
9807,3,1,34301,34301,34302,0,1,1
9808,2,1,34303,34303,34304,0,1,1
9809,1,1,34304,34304,34305,0,1,0
9810,6,2,34310,34310,34312,0,2,5
9811,4,2,34314,34314,34316,0,2,2
9812,3,1,34317,34317,34318,0,1,1
9813,5,2,34322,34322,34324,0,2,4
9814,3,1,34325,34325,34326,0,1,1
9815,4,3,34329,34329,34332,0,3,3
9816,2,1,34331,34332,34333,1,2,0
9817,4,1,34335,34335,34336,0,1,2
9818,2,2,34337,34337,34339,0,2,1
9819,2,3,34339,34339,34342,0,3,0
9820,6,1,34345,34345,34346,0,1,3
9821,3,1,34348,34348,34349,0,1,2
9822,3,3,34351,34351,34354,0,3,2
9823,3,2,34354,34354,34356,0,2,0
9824,4,1,34358,34358,34359,0,1,2
9825,5,2,34363,34363,34365,0,2,4
9826,4,2,34367,34367,34369,0,2,2
9827,2,1,34369,34369,34370,0,1,0
9828,4,2,34373,34373,34375,0,2,3
9829,3,2,34376,34376,34378,0,2,1
9830,2,1,34378,34378,34379,0,1,0
9831,1,2,34379,34379,34381,0,2,0
9832,4,2,34383,34383,34385,0,2,2
9833,1,3,34384,34385,34388,1,4,0
9834,4,1,34388,34388,34389,0,1,0
9835,3,2,34391,34391,34393,0,2,2
9836,5,3,34396,34396,34399,0,3,3
9837,1,1,34397,34399,34400,2,3,0
9838,5,3,34402,34402,34405,0,3,2
9839,2,3,34404,34405,34408,1,4,0
9840,3,1,34407,34408,34409,1,2,0
9841,1,1,34408,34409,34410,1,2,0
9842,2,1,34410,34410,34411,0,1,0
9843,3,3,34413,34413,34416,0,3,2
9844,5,1,34418,34418,34419,0,1,2
9845,4,3,34422,34422,34425,0,3,3
9846,2,1,34424,34425,34426,1,2,0
9847,5,1,34429,34429,34430,0,1,3
9848,4,2,34433,34433,34435,0,2,3
9849,3,3,34436,34436,34439,0,3,1
9850,2,1,34438,34439,34440,1,2,0
9851,6,3,34444,34444,34447,0,3,4
9852,6,3,34450,34450,34453,0,3,3
9853,5,3,34455,34455,34458,0,3,2
9854,1,3,34456,34458,34461,2,5,0
9855,1,1,34457,34461,34462,4,5,0
9856,3,2,34460,34462,34464,2,4,0
9857,4,3,34464,34464,34467,0,3,0
9858,3,2,34467,34467,34469,0,2,0
9859,3,1,34470,34470,34471,0,1,1
9860,3,1,34473,34473,34474,0,1,2
9861,6,3,34479,34479,34482,0,3,5
9862,3,1,34482,34482,34483,0,1,0
9863,6,1,34488,34488,34489,0,1,5
9864,3,3,34491,34491,34494,0,3,2
9865,2,3,34493,34494,34497,1,4,0
9866,1,1,34494,34497,34498,3,4,0
9867,2,3,34496,34498,34501,2,5,0
9868,5,1,34501,34501,34502,0,1,0
9869,5,2,34506,34506,34508,0,2,4
9870,1,2,34507,34508,34510,1,3,0
9871,1,1,34508,34510,34511,2,3,0
9872,5,3,34513,34513,34516,0,3,2
9873,5,2,34518,34518,34520,0,2,2
9874,3,1,34521,34521,34522,0,1,1
9875,5,2,34526,34526,34528,0,2,4
9876,3,2,34529,34529,34531,0,2,1
9877,3,2,34532,34532,34534,0,2,1
9878,4,1,34536,34536,34537,0,1,2
9879,2,3,34538,34538,34541,0,3,1
9880,4,2,34542,34542,34544,0,2,1
9881,5,1,34547,34547,34548,0,1,3
9882,6,3,34553,34553,34556,0,3,5
9883,1,2,34554,34556,34558,2,4,0
9884,1,3,34555,34558,34561,3,6,0
9885,6,3,34561,34561,34564,0,3,0
9886,4,1,34565,34565,34566,0,1,1
9887,5,1,34570,34570,34571,0,1,4
9888,4,2,34574,34574,34576,0,2,3
9889,5,1,34579,34579,34580,0,1,3
9890,3,3,34582,34582,34585,0,3,2
9891,3,1,34585,34585,34586,0,1,0
9892,3,2,34588,34588,34590,0,2,2
9893,6,2,34594,34594,34596,0,2,4
9894,2,3,34596,34596,34599,0,3,0
9895,4,1,34600,34600,34601,0,1,1
9896,6,3,34606,34606,34609,0,3,5
9897,6,1,34612,34612,34613,0,1,3
9898,3,2,34615,34615,34617,0,2,2
9899,2,3,34617,34617,34620,0,3,0
9900,6,3,34623,34623,34626,0,3,3
9901,3,1,34626,34626,34627,0,1,0
9902,4,2,34630,34630,34632,0,2,3
9903,5,3,34635,34635,34638,0,3,3
9904,5,1,34640,34640,34641,0,1,2
9905,5,3,34645,34645,34648,0,3,4
9906,6,2,34651,34651,34653,0,2,3
9907,1,1,34652,34653,34654,1,2,0
9908,6,1,34658,34658,34659,0,1,4
9909,2,2,34660,34660,34662,0,2,1
9910,2,3,34662,34662,34665,0,3,0
9911,5,2,34667,34667,34669,0,2,2
9912,1,1,34668,34669,34670,1,2,0
9913,5,3,34673,34673,34676,0,3,3
9914,5,2,34678,34678,34680,0,2,2
9915,2,3,34680,34680,34683,0,3,0
9916,1,3,34681,34683,34686,2,5,0
9917,6,3,34687,34687,34690,0,3,1
9918,2,1,34689,34690,34691,1,2,0
9919,1,1,34690,34691,34692,1,2,0
9920,6,2,34696,34696,34698,0,2,4
9921,5,3,34701,34701,34704,0,3,3
9922,5,1,34706,34706,34707,0,1,2
9923,2,3,34708,34708,34711,0,3,1
9924,2,1,34710,34711,34712,1,2,0
9925,3,1,34713,34713,34714,0,1,1
9926,2,2,34715,34715,34717,0,2,1
9927,5,2,34720,34720,34722,0,2,3
9928,5,3,34725,34725,34728,0,3,3
9929,6,1,34731,34731,34732,0,1,3
9930,2,2,34733,34733,34735,0,2,1
9931,6,1,34739,34739,34740,0,1,4
9932,4,1,34743,34743,34744,0,1,3
9933,2,3,34745,34745,34748,0,3,1
9934,4,2,34749,34749,34751,0,2,1
9935,2,3,34751,34751,34754,0,3,0
9936,5,2,34756,34756,34758,0,2,2
9937,2,1,34758,34758,34759,0,1,0
9938,5,2,34763,34763,34765,0,2,4
9939,1,2,34764,34765,34767,1,3,0
9940,6,2,34770,34770,34772,0,2,3
9941,5,3,34775,34775,34778,0,3,3
9942,1,1,34776,34778,34779,2,3,0
9943,5,2,34781,34781,34783,0,2,2
9944,1,3,34782,34783,34786,1,4,0
9945,2,3,34784,34786,34789,2,5,0
9946,3,3,34787,34789,34792,2,5,0
9947,1,3,34788,34792,34795,4,7,0
9948,4,1,34792,34795,34796,3,4,0
9949,5,2,34797,34797,34799,0,2,1
9950,2,2,34799,34799,34801,0,2,0
9951,2,2,34801,34801,34803,0,2,0
9952,5,1,34806,34806,34807,0,1,3
9953,4,1,34810,34810,34811,0,1,3
9954,6,1,34816,34816,34817,0,1,5
9955,2,2,34818,34818,34820,0,2,1
9956,4,3,34822,34822,34825,0,3,2
9957,4,1,34826,34826,34827,0,1,1
9958,4,3,34830,34830,34833,0,3,3
9959,6,2,34836,34836,34838,0,2,3
9960,1,3,34837,34838,34841,1,4,0
9961,6,3,34843,34843,34846,0,3,2
9962,1,3,34844,34846,34849,2,5,0
9963,2,3,34846,34849,34852,3,6,0
9964,5,3,34851,34852,34855,1,4,0
9965,6,3,34857,34857,34860,0,3,2
9966,5,1,34862,34862,34863,0,1,2
9967,5,2,34867,34867,34869,0,2,4
9968,5,2,34872,34872,34874,0,2,3
9969,4,1,34876,34876,34877,0,1,2
9970,6,1,34882,34882,34883,0,1,5
9971,3,1,34885,34885,34886,0,1,2
9972,5,1,34890,34890,34891,0,1,4
9973,5,2,34895,34895,34897,0,2,4
9974,1,2,34896,34897,34899,1,3,0
9975,3,3,34899,34899,34902,0,3,0
9976,4,1,34903,34903,34904,0,1,1
9977,4,3,34907,34907,34910,0,3,3
9978,6,1,34913,34913,34914,0,1,3
9979,5,1,34918,34918,34919,0,1,4
9980,3,3,34921,34921,34924,0,3,2
9981,1,2,34922,34924,34926,2,4,0
9982,5,2,34927,34927,34929,0,2,1
9983,5,1,34932,34932,34933,0,1,3
9984,4,2,34936,34936,34938,0,2,3
9985,3,3,34939,34939,34942,0,3,1
9986,2,2,34941,34942,34944,1,3,0
9987,6,2,34947,34947,34949,0,2,3
9988,5,1,34952,34952,34953,0,1,3
9989,3,3,34955,34955,34958,0,3,2
9990,5,2,34960,34960,34962,0,2,2
9991,4,3,34964,34964,34967,0,3,2
9992,4,1,34968,34968,34969,0,1,1
9993,5,2,34973,34973,34975,0,2,4
9994,1,3,34974,34975,34978,1,4,0
9995,4,3,34978,34978,34981,0,3,0
9996,4,2,34982,34982,34984,0,2,1
9997,6,1,34988,34988,34989,0,1,4
9998,2,1,34990,34990,34991,0,1,1
9999,6,1,34996,34996,34997,0,1,5
10000,3,2,34999,34999,35001,0,2,2
10001,2,3,35001,35001,35004,0,3,0
10002,1,1,35002,35004,35005,2,3,0
10003,6,3,35008,35008,35011,0,3,3
10004,4,2,35012,35012,35014,0,2,1
10005,3,3,35015,35015,35018,0,3,1
10006,4,1,35019,35019,35020,0,1,1
10007,5,2,35024,35024,35026,0,2,4
10008,2,2,35026,35026,35028,0,2,0
10009,4,1,35030,35030,35031,0,1,2
10010,3,2,35033,35033,35035,0,2,2
10011,5,2,35038,35038,35040,0,2,3
10012,1,1,35039,35040,35041,1,2,0
10013,5,3,35044,35044,35047,0,3,3
10014,3,1,35047,35047,35048,0,1,0
10015,3,2,35050,35050,35052,0,2,2
10016,6,2,35056,35056,35058,0,2,4
10017,6,3,35062,35062,35065,0,3,4
10018,3,2,35065,35065,35067,0,2,0
10019,6,3,35071,35071,35074,0,3,4
10020,3,1,35074,35074,35075,0,1,0
10021,3,1,35077,35077,35078,0,1,2
10022,6,2,35083,35083,35085,0,2,5
10023,2,2,35085,35085,35087,0,2,0
10024,3,1,35088,35088,35089,0,1,1
10025,6,3,35094,35094,35097,0,3,5
10026,1,1,35095,35097,35098,2,3,0
10027,1,1,35096,35098,35099,2,3,0
10028,3,2,35099,35099,35101,0,2,0
10029,6,3,35105,35105,35108,0,3,4
10030,5,1,35110,35110,35111,0,1,2
10031,2,3,35112,35112,35115,0,3,1
10032,1,1,35113,35115,35116,2,3,0
10033,1,1,35114,35116,35117,2,3,0
10034,6,1,35120,35120,35121,0,1,3
10035,3,2,35123,35123,35125,0,2,2
10036,1,3,35124,35125,35128,1,4,0
10037,2,3,35126,35128,35131,2,5,0
10038,4,3,35130,35131,35134,1,4,0
10039,2,3,35132,35134,35137,2,5,0
10040,5,1,35137,35137,35138,0,1,0
10041,3,2,35140,35140,35142,0,2,2
10042,6,2,35146,35146,35148,0,2,4
10043,4,3,35150,35150,35153,0,3,2
10044,5,3,35155,35155,35158,0,3,2
10045,5,2,35160,35160,35162,0,2,2
10046,4,2,35164,35164,35166,0,2,2
10047,4,3,35168,35168,35171,0,3,2
10048,6,1,35174,35174,35175,0,1,3
10049,1,1,35175,35175,35176,0,1,0
10050,4,2,35179,35179,35181,0,2,3
10051,5,1,35184,35184,35185,0,1,3
10052,3,3,35187,35187,35190,0,3,2
10053,4,2,35191,35191,35193,0,2,1
10054,5,3,35196,35196,35199,0,3,3
10055,4,2,35200,35200,35202,0,2,1
10056,2,3,35202,35202,35205,0,3,0
10057,6,1,35208,35208,35209,0,1,3
10058,4,3,35212,35212,35215,0,3,3
10059,6,3,35218,35218,35221,0,3,3
10060,1,3,35219,35221,35224,2,5,0
10061,1,3,35220,35224,35227,4,7,0
10062,4,3,35224,35227,35230,3,6,0
10063,3,3,35227,35230,35233,3,6,0
10064,1,1,35228,35233,35234,5,6,0
10065,3,2,35231,35234,35236,3,5,0
10066,2,2,35233,35236,35238,3,5,0
10067,1,1,35234,35238,35239,4,5,0
10068,5,3,35239,35239,35242,0,3,0
10069,4,3,35243,35243,35246,0,3,1
10070,1,3,35244,35246,35249,2,5,0
10071,5,2,35249,35249,35251,0,2,0
10072,2,1,35251,35251,35252,0,1,0
10073,6,2,35257,35257,35259,0,2,5
10074,2,2,35259,35259,35261,0,2,0
10075,5,2,35264,35264,35266,0,2,3
10076,5,3,35269,35269,35272,0,3,3
10077,2,2,35271,35272,35274,1,3,0
10078,2,2,35273,35274,35276,1,3,0
10079,1,1,35274,35276,35277,2,3,0
10080,2,1,35276,35277,35278,1,2,0
10081,5,2,35281,35281,35283,0,2,3
10082,2,1,35283,35283,35284,0,1,0
10083,1,1,35284,35284,35285,0,1,0
10084,4,2,35288,35288,35290,0,2,3
10085,6,3,35294,35294,35297,0,3,4
10086,3,2,35297,35297,35299,0,2,0
10087,5,3,35302,35302,35305,0,3,3
10088,6,1,35308,35308,35309,0,1,3
10089,6,1,35314,35314,35315,0,1,5
10090,5,3,35319,35319,35322,0,3,4
10091,5,2,35324,35324,35326,0,2,2
10092,3,2,35327,35327,35329,0,2,1
10093,5,1,35332,35332,35333,0,1,3
10094,3,1,35335,35335,35336,0,1,2
10095,5,1,35340,35340,35341,0,1,4
10096,5,1,35345,35345,35346,0,1,4
10097,5,3,35350,35350,35353,0,3,4
10098,6,3,35356,35356,35359,0,3,3
10099,6,2,35362,35362,35364,0,2,3
10100,6,1,35368,35368,35369,0,1,4
10101,4,1,35372,35372,35373,0,1,3
10102,4,3,35376,35376,35379,0,3,3
10103,6,3,35382,35382,35385,0,3,3
10104,5,1,35387,35387,35388,0,1,2
10105,1,1,35388,35388,35389,0,1,0
10106,3,2,35391,35391,35393,0,2,2
10107,1,2,35392,35393,35395,1,3,0
10108,3,2,35395,35395,35397,0,2,0
10109,2,1,35397,35397,35398,0,1,0
10110,3,2,35400,35400,35402,0,2,2
10111,6,3,35406,35406,35409,0,3,4
10112,5,1,35411,35411,35412,0,1,2
10113,2,1,35413,35413,35414,0,1,1
10114,6,1,35419,35419,35420,0,1,5
10115,2,2,35421,35421,35423,0,2,1
10116,2,2,35423,35423,35425,0,2,0
10117,5,1,35428,35428,35429,0,1,3
10118,2,3,35430,35430,35433,0,3,1
10119,2,1,35432,35433,35434,1,2,0
10120,1,2,35433,35434,35436,1,3,0
10121,5,1,35438,35438,35439,0,1,2
10122,6,2,35444,35444,35446,0,2,5
10123,2,1,35446,35446,35447,0,1,0
10124,6,3,35452,35452,35455,0,3,5
10125,5,3,35457,35457,35460,0,3,2
10126,5,3,35462,35462,35465,0,3,2
10127,1,2,35463,35465,35467,2,4,0
10128,3,2,35466,35467,35469,1,3,0
10129,3,2,35469,35469,35471,0,2,0
10130,4,2,35473,35473,35475,0,2,2
10131,1,3,35474,35475,35478,1,4,0
10132,4,1,35478,35478,35479,0,1,0
10133,3,1,35481,35481,35482,0,1,2
10134,5,1,35486,35486,35487,0,1,4
10135,5,1,35491,35491,35492,0,1,4
10136,1,1,35492,35492,35493,0,1,0
10137,4,2,35496,35496,35498,0,2,3
10138,4,1,35500,35500,35501,0,1,2
10139,4,2,35504,35504,35506,0,2,3
10140,3,2,35507,35507,35509,0,2,1
10141,3,3,35510,35510,35513,0,3,1
10142,3,2,35513,35513,35515,0,2,0
10143,1,2,35514,35515,35517,1,3,0
10144,6,2,35520,35520,35522,0,2,3
10145,5,2,35525,35525,35527,0,2,3
10146,5,1,35530,35530,35531,0,1,3
10147,5,1,35535,35535,35536,0,1,4
10148,6,3,35541,35541,35544,0,3,5
10149,3,1,35544,35544,35545,0,1,0
10150,1,3,35545,35545,35548,0,3,0
10151,6,3,35551,35551,35554,0,3,3
10152,3,2,35554,35554,35556,0,2,0
10153,3,1,35557,35557,35558,0,1,1
10154,2,1,35559,35559,35560,0,1,1
10155,3,1,35562,35562,35563,0,1,2
10156,2,1,35564,35564,35565,0,1,1
10157,3,1,35567,35567,35568,0,1,2
10158,4,2,35571,35571,35573,0,2,3
10159,5,2,35576,35576,35578,0,2,3
10160,2,3,35578,35578,35581,0,3,0
10161,6,3,35584,35584,35587,0,3,3
10162,5,2,35589,35589,35591,0,2,2
10163,5,3,35594,35594,35597,0,3,3
10164,4,3,35598,35598,35601,0,3,1
10165,1,2,35599,35601,35603,2,4,0
10166,1,1,35600,35603,35604,3,4,0
10167,5,3,35605,35605,35608,0,3,1
10168,1,3,35606,35608,35611,2,5,0
10169,1,1,35607,35611,35612,4,5,0
10170,6,2,35613,35613,35615,0,2,1
10171,6,2,35619,35619,35621,0,2,4
10172,5,3,35624,35624,35627,0,3,3
10173,4,3,35628,35628,35631,0,3,1
10174,1,2,35629,35631,35633,2,4,0
10175,1,3,35630,35633,35636,3,6,0
10176,5,3,35635,35636,35639,1,4,0
10177,1,3,35636,35639,35642,3,6,0
10178,1,1,35637,35642,35643,5,6,0
10179,3,3,35640,35643,35646,3,6,0
10180,1,3,35641,35646,35649,5,8,0
10181,6,3,35647,35649,35652,2,5,0
10182,6,1,35653,35653,35654,0,1,1
10183,6,2,35659,35659,35661,0,2,5
10184,1,2,35660,35661,35663,1,3,0
10185,3,3,35663,35663,35666,0,3,0
10186,5,1,35668,35668,35669,0,1,2
10187,1,2,35669,35669,35671,0,2,0
10188,1,1,35670,35671,35672,1,2,0
10189,5,2,35675,35675,35677,0,2,3
10190,3,2,35678,35678,35680,0,2,1
10191,5,2,35683,35683,35685,0,2,3
10192,4,1,35687,35687,35688,0,1,2
10193,4,3,35691,35691,35694,0,3,3
10194,2,3,35693,35694,35697,1,4,0
10195,1,1,35694,35697,35698,3,4,0
10196,3,3,35697,35698,35701,1,4,0
10197,6,3,35703,35703,35706,0,3,2
10198,3,1,35706,35706,35707,0,1,0
10199,2,3,35708,35708,35711,0,3,1
10200,5,3,35713,35713,35716,0,3,2
10201,2,1,35715,35716,35717,1,2,0
10202,6,1,35721,35721,35722,0,1,4
10203,5,3,35726,35726,35729,0,3,4
10204,5,1,35731,35731,35732,0,1,2
10205,2,2,35733,35733,35735,0,2,1
10206,3,2,35736,35736,35738,0,2,1
10207,6,1,35742,35742,35743,0,1,4
10208,1,1,35743,35743,35744,0,1,0
10209,1,3,35744,35744,35747,0,3,0
10210,5,2,35749,35749,35751,0,2,2
10211,6,2,35755,35755,35757,0,2,4
10212,4,1,35759,35759,35760,0,1,2
10213,1,1,35760,35760,35761,0,1,0
10214,3,3,35763,35763,35766,0,3,2
10215,2,3,35765,35766,35769,1,4,0
10216,2,2,35767,35769,35771,2,4,0
10217,4,1,35771,35771,35772,0,1,0
10218,3,1,35774,35774,35775,0,1,2
10219,4,1,35778,35778,35779,0,1,3
10220,1,2,35779,35779,35781,0,2,0
10221,3,3,35782,35782,35785,0,3,1
10222,4,2,35786,35786,35788,0,2,1
10223,6,3,35792,35792,35795,0,3,4
10224,1,2,35793,35795,35797,2,4,0
10225,2,1,35795,35797,35798,2,3,0
10226,5,3,35800,35800,35803,0,3,2
10227,2,1,35802,35803,35804,1,2,0
10228,4,1,35806,35806,35807,0,1,2
10229,5,3,35811,35811,35814,0,3,4
10230,3,2,35814,35814,35816,0,2,0
10231,3,2,35817,35817,35819,0,2,1
10232,5,2,35822,35822,35824,0,2,3
10233,1,2,35823,35824,35826,1,3,0
10234,6,2,35829,35829,35831,0,2,3
10235,4,2,35833,35833,35835,0,2,2
10236,5,3,35838,35838,35841,0,3,3
10237,2,2,35840,35841,35843,1,3,0
10238,6,2,35846,35846,35848,0,2,3
10239,4,1,35850,35850,35851,0,1,2
10240,5,3,35855,35855,35858,0,3,4
10241,6,1,35861,35861,35862,0,1,3
10242,4,3,35865,35865,35868,0,3,3
10243,2,3,35867,35868,35871,1,4,0
10244,4,1,35871,35871,35872,0,1,0
10245,6,3,35877,35877,35880,0,3,5
10246,1,2,35878,35880,35882,2,4,0
10247,2,2,35880,35882,35884,2,4,0
10248,6,3,35886,35886,35889,0,3,2
10249,5,1,35891,35891,35892,0,1,2
10250,2,3,35893,35893,35896,0,3,1
10251,2,3,35895,35896,35899,1,4,0
10252,1,3,35896,35899,35902,3,6,0
10253,3,3,35899,35902,35905,3,6,0
10254,4,1,35903,35905,35906,2,3,0
10255,1,3,35904,35906,35909,2,5,0
10256,1,3,35905,35909,35912,4,7,0
10257,3,3,35908,35912,35915,4,7,0
10258,3,2,35911,35915,35917,4,6,0
10259,3,3,35914,35917,35920,3,6,0
10260,3,2,35917,35920,35922,3,5,0
10261,1,2,35918,35922,35924,4,6,0
10262,1,3,35919,35924,35927,5,8,0
10263,4,2,35923,35927,35929,4,6,0
10264,5,1,35928,35929,35930,1,2,0
10265,5,3,35933,35933,35936,0,3,3
10266,4,1,35937,35937,35938,0,1,1
10267,4,3,35941,35941,35944,0,3,3
10268,3,1,35944,35944,35945,0,1,0
10269,4,3,35948,35948,35951,0,3,3
10270,3,1,35951,35951,35952,0,1,0
10271,1,3,35952,35952,35955,0,3,0
10272,1,3,35953,35955,35958,2,5,0
10273,3,1,35956,35958,35959,2,3,0
10274,2,3,35958,35959,35962,1,4,0
10275,6,1,35964,35964,35965,0,1,2
10276,5,1,35969,35969,35970,0,1,4
10277,1,1,35970,35970,35971,0,1,0
10278,4,3,35974,35974,35977,0,3,3
10279,3,2,35977,35977,35979,0,2,0
10280,3,3,35980,35980,35983,0,3,1
10281,1,2,35981,35983,35985,2,4,0
10282,1,3,35982,35985,35988,3,6,0
10283,4,2,35986,35988,35990,2,4,0
10284,1,2,35987,35990,35992,3,5,0
10285,4,1,35991,35992,35993,1,2,0
10286,3,3,35994,35994,35997,0,3,1
10287,3,3,35997,35997,36000,0,3,0
10288,3,3,36000,36000,36003,0,3,0
10289,3,3,36003,36003,36006,0,3,0
10290,4,1,36007,36007,36008,0,1,1
10291,2,1,36009,36009,36010,0,1,1
10292,4,1,36013,36013,36014,0,1,3
10293,2,1,36015,36015,36016,0,1,1
10294,6,3,36021,36021,36024,0,3,5
10295,2,2,36023,36024,36026,1,3,0
10296,4,1,36027,36027,36028,0,1,1
10297,6,2,36033,36033,36035,0,2,5
10298,6,2,36039,36039,36041,0,2,4
10299,3,1,36042,36042,36043,0,1,1
10300,2,3,36044,36044,36047,0,3,1
10301,5,2,36049,36049,36051,0,2,2
10302,5,3,36054,36054,36057,0,3,3
10303,3,3,36057,36057,36060,0,3,0
10304,3,3,36060,36060,36063,0,3,0
10305,3,3,36063,36063,36066,0,3,0
10306,2,1,36065,36066,36067,1,2,0
10307,6,2,36071,36071,36073,0,2,4
10308,4,3,36075,36075,36078,0,3,2
10309,2,1,36077,36078,36079,1,2,0
10310,6,2,36083,36083,36085,0,2,4
10311,3,3,36086,36086,36089,0,3,1
10312,4,3,36090,36090,36093,0,3,1
10313,6,1,36096,36096,36097,0,1,3
10314,2,1,36098,36098,36099,0,1,1
10315,1,2,36099,36099,36101,0,2,0
10316,3,1,36102,36102,36103,0,1,1
10317,4,2,36106,36106,36108,0,2,3
10318,5,2,36111,36111,36113,0,2,3
10319,2,2,36113,36113,36115,0,2,0
10320,2,1,36115,36115,36116,0,1,0
10321,4,3,36119,36119,36122,0,3,3
10322,1,3,36120,36122,36125,2,5,0
10323,4,3,36124,36125,36128,1,4,0
10324,3,2,36127,36128,36130,1,3,0
10325,1,1,36128,36130,36131,2,3,0
10326,5,1,36133,36133,36134,0,1,2
10327,2,3,36135,36135,36138,0,3,1
10328,6,2,36141,36141,36143,0,2,3
10329,5,3,36146,36146,36149,0,3,3
10330,3,3,36149,36149,36152,0,3,0
10331,1,3,36150,36152,36155,2,5,0
10332,3,2,36153,36155,36157,2,4,0
10333,1,2,36154,36157,36159,3,5,0
10334,6,3,36160,36160,36163,0,3,1
10335,2,1,36162,36163,36164,1,2,0
10336,4,1,36166,36166,36167,0,1,2
10337,3,3,36169,36169,36172,0,3,2
10338,6,2,36175,36175,36177,0,2,3
10339,3,1,36178,36178,36179,0,1,1
10340,2,2,36180,36180,36182,0,2,1
10341,6,1,36186,36186,36187,0,1,4
10342,1,1,36187,36187,36188,0,1,0
10343,6,2,36193,36193,36195,0,2,5
10344,5,2,36198,36198,36200,0,2,3
10345,4,3,36202,36202,36205,0,3,2
10346,3,3,36205,36205,36208,0,3,0
10347,4,3,36209,36209,36212,0,3,1
10348,2,3,36211,36212,36215,1,4,0
10349,1,1,36212,36215,36216,3,4,0
10350,1,3,36213,36216,36219,3,6,0
10351,3,2,36216,36219,36221,3,5,0
10352,6,2,36222,36222,36224,0,2,1
10353,2,2,36224,36224,36226,0,2,0
10354,5,2,36229,36229,36231,0,2,3
10355,1,2,36230,36231,36233,1,3,0
10356,4,2,36234,36234,36236,0,2,1
10357,1,1,36235,36236,36237,1,2,0
10358,4,3,36239,36239,36242,0,3,2
10359,5,1,36244,36244,36245,0,1,2
10360,3,1,36247,36247,36248,0,1,2
10361,6,1,36253,36253,36254,0,1,5
10362,5,2,36258,36258,36260,0,2,4
10363,4,1,36262,36262,36263,0,1,2
10364,2,1,36264,36264,36265,0,1,1
10365,5,3,36269,36269,36272,0,3,4
10366,2,1,36271,36272,36273,1,2,0
10367,4,2,36275,36275,36277,0,2,2
10368,5,3,36280,36280,36283,0,3,3
10369,3,1,36283,36283,36284,0,1,0
10370,2,3,36285,36285,36288,0,3,1
10371,1,1,36286,36288,36289,2,3,0
10372,5,2,36291,36291,36293,0,2,2
10373,3,1,36294,36294,36295,0,1,1
10374,6,2,36300,36300,36302,0,2,5
10375,2,1,36302,36302,36303,0,1,0
10376,1,3,36303,36303,36306,0,3,0
10377,5,2,36308,36308,36310,0,2,2
10378,6,2,36314,36314,36316,0,2,4
10379,1,3,36315,36316,36319,1,4,0
10380,1,2,36316,36319,36321,3,5,0
10381,2,3,36318,36321,36324,3,6,0
10382,5,1,36323,36324,36325,1,2,0
10383,4,3,36327,36327,36330,0,3,2
10384,2,1,36329,36330,36331,1,2,0
10385,4,3,36333,36333,36336,0,3,2
10386,2,1,36335,36336,36337,1,2,0
10387,2,2,36337,36337,36339,0,2,0
10388,5,3,36342,36342,36345,0,3,3
10389,5,3,36347,36347,36350,0,3,2
10390,5,3,36352,36352,36355,0,3,2
10391,3,2,36355,36355,36357,0,2,0
10392,3,2,36358,36358,36360,0,2,1
10393,1,1,36359,36360,36361,1,2,0
10394,4,2,36363,36363,36365,0,2,2
10395,5,1,36368,36368,36369,0,1,3
10396,4,2,36372,36372,36374,0,2,3
10397,1,2,36373,36374,36376,1,3,0
10398,3,2,36376,36376,36378,0,2,0
10399,3,1,36379,36379,36380,0,1,1
10400,4,3,36383,36383,36386,0,3,3
10401,6,3,36389,36389,36392,0,3,3
10402,1,1,36390,36392,36393,2,3,0
10403,2,3,36392,36393,36396,1,4,0
10404,6,3,36398,36398,36401,0,3,2
10405,4,1,36402,36402,36403,0,1,1
10406,5,2,36407,36407,36409,0,2,4
10407,6,1,36413,36413,36414,0,1,4
10408,1,1,36414,36414,36415,0,1,0
10409,2,2,36416,36416,36418,0,2,1
10410,1,2,36417,36418,36420,1,3,0
10411,1,3,36418,36420,36423,2,5,0
10412,3,1,36421,36423,36424,2,3,0
10413,4,3,36425,36425,36428,0,3,1
10414,4,1,36429,36429,36430,0,1,1
10415,3,2,36432,36432,36434,0,2,2
10416,6,1,36438,36438,36439,0,1,4
10417,4,3,36442,36442,36445,0,3,3
10418,4,1,36446,36446,36447,0,1,1
10419,3,1,36449,36449,36450,0,1,2
10420,6,2,36455,36455,36457,0,2,5
10421,5,1,36460,36460,36461,0,1,3
10422,5,3,36465,36465,36468,0,3,4
10423,1,3,36466,36468,36471,2,5,0
10424,1,3,36467,36471,36474,4,7,0
10425,2,2,36469,36474,36476,5,7,0
10426,5,2,36474,36476,36478,2,4,0
10427,3,3,36477,36478,36481,1,4,0
10428,6,2,36483,36483,36485,0,2,2
10429,3,1,36486,36486,36487,0,1,1
10430,4,1,36490,36490,36491,0,1,3
10431,6,3,36496,36496,36499,0,3,5
10432,1,2,36497,36499,36501,2,4,0
10433,2,3,36499,36501,36504,2,5,0
10434,2,2,36501,36504,36506,3,5,0
10435,3,1,36504,36506,36507,2,3,0
10436,2,3,36506,36507,36510,1,4,0
10437,3,3,36509,36510,36513,1,4,0
10438,3,3,36512,36513,36516,1,4,0
10439,2,1,36514,36516,36517,2,3,0
10440,1,1,36515,36517,36518,2,3,0
10441,6,2,36521,36521,36523,0,2,3
10442,3,1,36524,36524,36525,0,1,1
10443,1,3,36525,36525,36528,0,3,0
10444,3,1,36528,36528,36529,0,1,0
10445,5,1,36533,36533,36534,0,1,4
10446,6,2,36539,36539,36541,0,2,5
10447,3,3,36542,36542,36545,0,3,1
10448,3,1,36545,36545,36546,0,1,0
10449,1,3,36546,36546,36549,0,3,0
10450,1,3,36547,36549,36552,2,5,0
10451,3,2,36550,36552,36554,2,4,0
10452,5,2,36555,36555,36557,0,2,1
10453,3,1,36558,36558,36559,0,1,1
10454,4,3,36562,36562,36565,0,3,3
10455,1,3,36563,36565,36568,2,5,0
10456,3,1,36566,36568,36569,2,3,0
10457,3,1,36569,36569,36570,0,1,0
10458,5,3,36574,36574,36577,0,3,4
10459,3,1,36577,36577,36578,0,1,0
10460,2,2,36579,36579,36581,0,2,1
10461,3,1,36582,36582,36583,0,1,1
10462,3,1,36585,36585,36586,0,1,2
10463,3,1,36588,36588,36589,0,1,2
10464,4,2,36592,36592,36594,0,2,3
10465,4,3,36596,36596,36599,0,3,2
10466,3,2,36599,36599,36601,0,2,0
10467,6,1,36605,36605,36606,0,1,4
10468,1,2,36606,36606,36608,0,2,0
10469,5,3,36611,36611,36614,0,3,3
10470,2,2,36613,36614,36616,1,3,0
10471,1,2,36614,36616,36618,2,4,0
10472,4,2,36618,36618,36620,0,2,0
10473,4,2,36622,36622,36624,0,2,2
10474,1,1,36623,36624,36625,1,2,0
10475,4,1,36627,36627,36628,0,1,2
10476,3,1,36630,36630,36631,0,1,2
10477,4,1,36634,36634,36635,0,1,3
10478,3,2,36637,36637,36639,0,2,2
10479,2,1,36639,36639,36640,0,1,0
10480,6,3,36645,36645,36648,0,3,5
10481,5,2,36650,36650,36652,0,2,2
10482,4,1,36654,36654,36655,0,1,2
10483,5,3,36659,36659,36662,0,3,4
10484,6,2,36665,36665,36667,0,2,3
10485,3,3,36668,36668,36671,0,3,1
10486,4,1,36672,36672,36673,0,1,1
10487,5,3,36677,36677,36680,0,3,4
10488,4,2,36681,36681,36683,0,2,1
10489,6,1,36687,36687,36688,0,1,4
10490,3,1,36690,36690,36691,0,1,2
10491,6,3,36696,36696,36699,0,3,5
10492,3,3,36699,36699,36702,0,3,0
10493,2,2,36701,36702,36704,1,3,0
10494,5,2,36706,36706,36708,0,2,2
10495,5,1,36711,36711,36712,0,1,3
10496,2,2,36713,36713,36715,0,2,1
10497,3,2,36716,36716,36718,0,2,1
10498,2,2,36718,36718,36720,0,2,0
10499,6,2,36724,36724,36726,0,2,4
10500,5,1,36729,36729,36730,0,1,3
10501,3,2,36732,36732,36734,0,2,2
10502,5,1,36737,36737,36738,0,1,3
10503,1,2,36738,36738,36740,0,2,0
10504,6,2,36744,36744,36746,0,2,4
10505,3,3,36747,36747,36750,0,3,1
10506,3,2,36750,36750,36752,0,2,0
10507,1,1,36751,36752,36753,1,2,0
10508,1,2,36752,36753,36755,1,3,0
10509,2,3,36754,36755,36758,1,4,0
10510,1,2,36755,36758,36760,3,5,0
10511,4,2,36759,36760,36762,1,3,0
10512,1,1,36760,36762,36763,2,3,0
10513,5,1,36765,36765,36766,0,1,2
10514,1,3,36766,36766,36769,0,3,0
10515,3,3,36769,36769,36772,0,3,0
10516,3,1,36772,36772,36773,0,1,0
10517,1,3,36773,36773,36776,0,3,0
10518,3,2,36776,36776,36778,0,2,0
10519,3,3,36779,36779,36782,0,3,1
10520,6,3,36785,36785,36788,0,3,3
10521,2,2,36787,36788,36790,1,3,0
10522,2,2,36789,36790,36792,1,3,0
10523,3,1,36792,36792,36793,0,1,0
10524,4,3,36796,36796,36799,0,3,3
10525,2,3,36798,36799,36802,1,4,0
10526,4,3,36802,36802,36805,0,3,0
10527,3,3,36805,36805,36808,0,3,0
10528,3,1,36808,36808,36809,0,1,0
10529,3,3,36811,36811,36814,0,3,2
10530,3,2,36814,36814,36816,0,2,0
10531,2,1,36816,36816,36817,0,1,0
10532,3,3,36819,36819,36822,0,3,2
10533,4,1,36823,36823,36824,0,1,1
10534,6,2,36829,36829,36831,0,2,5
10535,5,2,36834,36834,36836,0,2,3
10536,5,3,36839,36839,36842,0,3,3
10537,6,2,36845,36845,36847,0,2,3
10538,6,2,36851,36851,36853,0,2,4
10539,1,1,36852,36853,36854,1,2,0
10540,5,1,36857,36857,36858,0,1,3
10541,6,2,36863,36863,36865,0,2,5
10542,5,2,36868,36868,36870,0,2,3
10543,3,1,36871,36871,36872,0,1,1
10544,3,2,36874,36874,36876,0,2,2
10545,2,3,36876,36876,36879,0,3,0
10546,5,3,36881,36881,36884,0,3,2
10547,2,3,36883,36884,36887,1,4,0
10548,3,2,36886,36887,36889,1,3,0
10549,1,1,36887,36889,36890,2,3,0
10550,2,3,36889,36890,36893,1,4,0
10551,1,2,36890,36893,36895,3,5,0
10552,4,3,36894,36895,36898,1,4,0
10553,4,2,36898,36898,36900,0,2,0
10554,2,2,36900,36900,36902,0,2,0
10555,1,1,36901,36902,36903,1,2,0
10556,1,1,36902,36903,36904,1,2,0
10557,5,1,36907,36907,36908,0,1,3
10558,3,2,36910,36910,36912,0,2,2
10559,1,1,36911,36912,36913,1,2,0
10560,4,2,36915,36915,36917,0,2,2
10561,3,1,36918,36918,36919,0,1,1
10562,4,1,36922,36922,36923,0,1,3
10563,5,1,36927,36927,36928,0,1,4
10564,5,3,36932,36932,36935,0,3,4
10565,2,3,36934,36935,36938,1,4,0
10566,4,1,36938,36938,36939,0,1,0
10567,4,2,36942,36942,36944,0,2,3
10568,6,3,36948,36948,36951,0,3,4
10569,1,3,36949,36951,36954,2,5,0
10570,4,3,36953,36954,36957,1,4,0
10571,4,3,36957,36957,36960,0,3,0
10572,2,2,36959,36960,36962,1,3,0
10573,3,1,36962,36962,36963,0,1,0
10574,6,1,36968,36968,36969,0,1,5
10575,1,2,36969,36969,36971,0,2,0
10576,2,1,36971,36971,36972,0,1,0
10577,6,1,36977,36977,36978,0,1,5
10578,2,2,36979,36979,36981,0,2,1
10579,4,3,36983,36983,36986,0,3,2
10580,4,1,36987,36987,36988,0,1,1
10581,1,1,36988,36988,36989,0,1,0
10582,4,1,36992,36992,36993,0,1,3
10583,4,1,36996,36996,36997,0,1,3
10584,1,1,36997,36997,36998,0,1,0
10585,2,1,36999,36999,37000,0,1,1
10586,4,3,37003,37003,37006,0,3,3
10587,5,2,37008,37008,37010,0,2,2
10588,1,1,37009,37010,37011,1,2,0
10589,1,2,37010,37011,37013,1,3,0
10590,5,1,37015,37015,37016,0,1,2
10591,3,3,37018,37018,37021,0,3,2
10592,6,3,37024,37024,37027,0,3,3
10593,4,3,37028,37028,37031,0,3,1
10594,6,3,37034,37034,37037,0,3,3
10595,2,1,37036,37037,37038,1,2,0
10596,4,1,37040,37040,37041,0,1,2
10597,6,1,37046,37046,37047,0,1,5
10598,4,2,37050,37050,37052,0,2,3
10599,3,2,37053,37053,37055,0,2,1
10600,3,3,37056,37056,37059,0,3,1
10601,4,2,37060,37060,37062,0,2,1
10602,3,2,37063,37063,37065,0,2,1
10603,2,3,37065,37065,37068,0,3,0
10604,2,2,37067,37068,37070,1,3,0
10605,2,1,37069,37070,37071,1,2,0
10606,4,2,37073,37073,37075,0,2,2
10607,4,1,37077,37077,37078,0,1,2
10608,4,3,37081,37081,37084,0,3,3
10609,4,1,37085,37085,37086,0,1,1
10610,4,3,37089,37089,37092,0,3,3
10611,4,2,37093,37093,37095,0,2,1
10612,6,3,37099,37099,37102,0,3,4
10613,6,2,37105,37105,37107,0,2,3
10614,3,1,37108,37108,37109,0,1,1
10615,6,2,37114,37114,37116,0,2,5
10616,3,1,37117,37117,37118,0,1,1
10617,4,2,37121,37121,37123,0,2,3
10618,6,1,37127,37127,37128,0,1,4
10619,1,1,37128,37128,37129,0,1,0
10620,3,1,37131,37131,37132,0,1,2
10621,4,3,37135,37135,37138,0,3,3
10622,4,3,37139,37139,37142,0,3,1
10623,2,1,37141,37142,37143,1,2,0
10624,6,1,37147,37147,37148,0,1,4
10625,3,1,37150,37150,37151,0,1,2
10626,4,1,37154,37154,37155,0,1,3
10627,4,3,37158,37158,37161,0,3,3
10628,2,1,37160,37161,37162,1,2,0
10629,5,1,37165,37165,37166,0,1,3
10630,6,1,37171,37171,37172,0,1,5
10631,4,2,37175,37175,37177,0,2,3
10632,3,1,37178,37178,37179,0,1,1
10633,1,2,37179,37179,37181,0,2,0
10634,2,1,37181,37181,37182,0,1,0
10635,4,1,37185,37185,37186,0,1,3
10636,6,1,37191,37191,37192,0,1,5
10637,3,3,37194,37194,37197,0,3,2
10638,6,1,37200,37200,37201,0,1,3
10639,3,2,37203,37203,37205,0,2,2
10640,4,2,37207,37207,37209,0,2,2
10641,3,2,37210,37210,37212,0,2,1
10642,2,1,37212,37212,37213,0,1,0
10643,2,1,37214,37214,37215,0,1,1
10644,2,3,37216,37216,37219,0,3,1
10645,1,1,37217,37219,37220,2,3,0
10646,5,2,37222,37222,37224,0,2,2
10647,3,1,37225,37225,37226,0,1,1
10648,6,2,37231,37231,37233,0,2,5
10649,2,3,37233,37233,37236,0,3,0
10650,5,1,37238,37238,37239,0,1,2
10651,3,2,37241,37241,37243,0,2,2
10652,5,2,37246,37246,37248,0,2,3
10653,2,1,37248,37248,37249,0,1,0
10654,5,1,37253,37253,37254,0,1,4
10655,2,2,37255,37255,37257,0,2,1
10656,2,1,37257,37257,37258,0,1,0
10657,6,3,37263,37263,37266,0,3,5
10658,1,2,37264,37266,37268,2,4,0
10659,1,3,37265,37268,37271,3,6,0
10660,2,1,37267,37271,37272,4,5,0
10661,4,1,37271,37272,37273,1,2,0
10662,6,2,37277,37277,37279,0,2,4
10663,1,2,37278,37279,37281,1,3,0
10664,3,2,37281,37281,37283,0,2,0
10665,5,2,37286,37286,37288,0,2,3
10666,1,2,37287,37288,37290,1,3,0
10667,4,1,37291,37291,37292,0,1,1
10668,5,1,37296,37296,37297,0,1,4
10669,2,1,37298,37298,37299,0,1,1
10670,4,3,37302,37302,37305,0,3,3
10671,4,1,37306,37306,37307,0,1,1
10672,5,1,37311,37311,37312,0,1,4
10673,2,3,37313,37313,37316,0,3,1
10674,6,3,37319,37319,37322,0,3,3
10675,3,1,37322,37322,37323,0,1,0
10676,6,3,37328,37328,37331,0,3,5
10677,5,1,37333,37333,37334,0,1,2
10678,5,3,37338,37338,37341,0,3,4
10679,1,1,37339,37341,37342,2,3,0
10680,6,3,37345,37345,37348,0,3,3
10681,1,2,37346,37348,37350,2,4,0
10682,4,2,37350,37350,37352,0,2,0
10683,3,2,37353,37353,37355,0,2,1
10684,1,1,37354,37355,37356,1,2,0
10685,2,2,37356,37356,37358,0,2,0
10686,2,2,37358,37358,37360,0,2,0
10687,2,3,37360,37360,37363,0,3,0
10688,5,3,37365,37365,37368,0,3,2
10689,5,3,37370,37370,37373,0,3,2
10690,3,1,37373,37373,37374,0,1,0
10691,5,1,37378,37378,37379,0,1,4
10692,3,2,37381,37381,37383,0,2,2
10693,3,3,37384,37384,37387,0,3,1
10694,1,1,37385,37387,37388,2,3,0
10695,4,3,37389,37389,37392,0,3,1
10696,2,2,37391,37392,37394,1,3,0
10697,3,2,37394,37394,37396,0,2,0
10698,4,2,37398,37398,37400,0,2,2
10699,4,3,37402,37402,37405,0,3,2
10700,3,3,37405,37405,37408,0,3,0
10701,6,1,37411,37411,37412,0,1,3
10702,3,2,37414,37414,37416,0,2,2
10703,2,1,37416,37416,37417,0,1,0
10704,1,2,37417,37417,37419,0,2,0
10705,3,3,37420,37420,37423,0,3,1
10706,1,3,37421,37423,37426,2,5,0
10707,3,3,37424,37426,37429,2,5,0
10708,6,1,37430,37430,37431,0,1,1
10709,2,2,37432,37432,37434,0,2,1
10710,2,1,37434,37434,37435,0,1,0
10711,1,3,37435,37435,37438,0,3,0
10712,3,1,37438,37438,37439,0,1,0
10713,4,3,37442,37442,37445,0,3,3
10714,2,2,37444,37445,37447,1,3,0
10715,4,1,37448,37448,37449,0,1,1
10716,1,1,37449,37449,37450,0,1,0
10717,1,3,37450,37450,37453,0,3,0
10718,3,3,37453,37453,37456,0,3,0
10719,3,3,37456,37456,37459,0,3,0
10720,4,1,37460,37460,37461,0,1,1
10721,2,2,37462,37462,37464,0,2,1
10722,3,3,37465,37465,37468,0,3,1
10723,5,3,37470,37470,37473,0,3,2
10724,6,1,37476,37476,37477,0,1,3
10725,1,1,37477,37477,37478,0,1,0
10726,1,1,37478,37478,37479,0,1,0
10727,5,3,37483,37483,37486,0,3,4
10728,6,3,37489,37489,37492,0,3,3
10729,1,1,37490,37492,37493,2,3,0
10730,5,1,37495,37495,37496,0,1,2
10731,1,2,37496,37496,37498,0,2,0
10732,5,3,37501,37501,37504,0,3,3
10733,3,1,37504,37504,37505,0,1,0
10734,5,1,37509,37509,37510,0,1,4
10735,5,2,37514,37514,37516,0,2,4
10736,6,3,37520,37520,37523,0,3,4
10737,3,3,37523,37523,37526,0,3,0
10738,3,1,37526,37526,37527,0,1,0
10739,5,3,37531,37531,37534,0,3,4
10740,3,1,37534,37534,37535,0,1,0
10741,1,1,37535,37535,37536,0,1,0
10742,6,1,37541,37541,37542,0,1,5
10743,5,3,37546,37546,37549,0,3,4
10744,1,3,37547,37549,37552,2,5,0
10745,3,3,37550,37552,37555,2,5,0
10746,3,3,37553,37555,37558,2,5,0
10747,4,1,37557,37558,37559,1,2,0
10748,5,2,37562,37562,37564,0,2,3
10749,3,2,37565,37565,37567,0,2,1
10750,2,2,37567,37567,37569,0,2,0
10751,3,1,37570,37570,37571,0,1,1
10752,3,3,37573,37573,37576,0,3,2
10753,2,3,37575,37576,37579,1,4,0
10754,2,1,37577,37579,37580,2,3,0
10755,5,3,37582,37582,37585,0,3,2
10756,2,1,37584,37585,37586,1,2,0
10757,3,2,37587,37587,37589,0,2,1
10758,6,2,37593,37593,37595,0,2,4
10759,4,3,37597,37597,37600,0,3,2
10760,3,2,37600,37600,37602,0,2,0
10761,6,3,37606,37606,37609,0,3,4
10762,6,1,37612,37612,37613,0,1,3
10763,1,1,37613,37613,37614,0,1,0
10764,4,1,37617,37617,37618,0,1,3
10765,3,1,37620,37620,37621,0,1,2
10766,4,1,37624,37624,37625,0,1,3
10767,1,1,37625,37625,37626,0,1,0
10768,1,3,37626,37626,37629,0,3,0
10769,3,1,37629,37629,37630,0,1,0
10770,5,3,37634,37634,37637,0,3,4
10771,2,3,37636,37637,37640,1,4,0
10772,2,3,37638,37640,37643,2,5,0
10773,3,3,37641,37643,37646,2,5,0
10774,5,2,37646,37646,37648,0,2,0
10775,1,2,37647,37648,37650,1,3,0
10776,6,2,37653,37653,37655,0,2,3
10777,1,1,37654,37655,37656,1,2,0
10778,4,1,37658,37658,37659,0,1,2
10779,5,2,37663,37663,37665,0,2,4
10780,6,1,37669,37669,37670,0,1,4
10781,5,2,37674,37674,37676,0,2,4
10782,1,2,37675,37676,37678,1,3,0
10783,3,3,37678,37678,37681,0,3,0
10784,1,3,37679,37681,37684,2,5,0
10785,3,3,37682,37684,37687,2,5,0
10786,3,1,37685,37687,37688,2,3,0
10787,2,2,37687,37688,37690,1,3,0
10788,5,1,37692,37692,37693,0,1,2
10789,6,2,37698,37698,37700,0,2,5
10790,3,3,37701,37701,37704,0,3,1
10791,4,2,37705,37705,37707,0,2,1
10792,4,3,37709,37709,37712,0,3,2
10793,1,2,37710,37712,37714,2,4,0
10794,5,2,37715,37715,37717,0,2,1
10795,6,2,37721,37721,37723,0,2,4
10796,6,2,37727,37727,37729,0,2,4
10797,6,1,37733,37733,37734,0,1,4
10798,4,1,37737,37737,37738,0,1,3
10799,4,3,37741,37741,37744,0,3,3
10800,4,2,37745,37745,37747,0,2,1
10801,2,2,37747,37747,37749,0,2,0
10802,3,1,37750,37750,37751,0,1,1
10803,5,3,37755,37755,37758,0,3,4
10804,1,2,37756,37758,37760,2,4,0
10805,5,3,37761,37761,37764,0,3,1
10806,3,1,37764,37764,37765,0,1,0
10807,5,1,37769,37769,37770,0,1,4
10808,5,2,37774,37774,37776,0,2,4
10809,1,3,37775,37776,37779,1,4,0
10810,3,1,37778,37779,37780,1,2,0
10811,5,1,37783,37783,37784,0,1,3
10812,4,2,37787,37787,37789,0,2,3
10813,4,1,37791,37791,37792,0,1,2
10814,3,3,37794,37794,37797,0,3,2
10815,3,2,37797,37797,37799,0,2,0
10816,1,3,37798,37799,37802,1,4,0
10817,4,1,37802,37802,37803,0,1,0
10818,5,1,37807,37807,37808,0,1,4
10819,4,2,37811,37811,37813,0,2,3
10820,4,2,37815,37815,37817,0,2,2
10821,1,2,37816,37817,37819,1,3,0
10822,4,1,37820,37820,37821,0,1,1
10823,1,1,37821,37821,37822,0,1,0
10824,3,3,37824,37824,37827,0,3,2
10825,5,1,37829,37829,37830,0,1,2
10826,3,2,37832,37832,37834,0,2,2
10827,5,3,37837,37837,37840,0,3,3
10828,3,1,37840,37840,37841,0,1,0
10829,3,1,37843,37843,37844,0,1,2
10830,4,1,37847,37847,37848,0,1,3
10831,3,3,37850,37850,37853,0,3,2
10832,1,2,37851,37853,37855,2,4,0
10833,2,1,37853,37855,37856,2,3,0
10834,1,1,37854,37856,37857,2,3,0
10835,1,2,37855,37857,37859,2,4,0
10836,5,1,37860,37860,37861,0,1,1
10837,2,2,37862,37862,37864,0,2,1
10838,6,1,37868,37868,37869,0,1,4
10839,6,1,37874,37874,37875,0,1,5
10840,3,3,37877,37877,37880,0,3,2
10841,5,2,37882,37882,37884,0,2,2
10842,6,1,37888,37888,37889,0,1,4
10843,3,3,37891,37891,37894,0,3,2
10844,2,1,37893,37894,37895,1,2,0
10845,2,1,37895,37895,37896,0,1,0
10846,1,3,37896,37896,37899,0,3,0
10847,4,3,37900,37900,37903,0,3,1
10848,4,3,37904,37904,37907,0,3,1
10849,4,3,37908,37908,37911,0,3,1
10850,4,3,37912,37912,37915,0,3,1
10851,5,2,37917,37917,37919,0,2,2
10852,4,3,37921,37921,37924,0,3,2
10853,1,1,37922,37924,37925,2,3,0
10854,2,3,37924,37925,37928,1,4,0
10855,1,3,37925,37928,37931,3,6,0
10856,4,3,37929,37931,37934,2,5,0
10857,1,2,37930,37934,37936,4,6,0
10858,4,2,37934,37936,37938,2,4,0
10859,3,3,37937,37938,37941,1,4,0
10860,6,2,37943,37943,37945,0,2,2
10861,3,3,37946,37946,37949,0,3,1
10862,2,3,37948,37949,37952,1,4,0
10863,1,2,37949,37952,37954,3,5,0
10864,5,2,37954,37954,37956,0,2,0
10865,6,2,37960,37960,37962,0,2,4
10866,5,2,37965,37965,37967,0,2,3
10867,2,3,37967,37967,37970,0,3,0
10868,6,2,37973,37973,37975,0,2,3
10869,5,2,37978,37978,37980,0,2,3
10870,3,3,37981,37981,37984,0,3,1
10871,3,3,37984,37984,37987,0,3,0
10872,6,3,37990,37990,37993,0,3,3
10873,5,2,37995,37995,37997,0,2,2
10874,6,1,38001,38001,38002,0,1,4
10875,3,2,38004,38004,38006,0,2,2
10876,1,1,38005,38006,38007,1,2,0
10877,6,3,38011,38011,38014,0,3,4
10878,1,2,38012,38014,38016,2,4,0
10879,1,1,38013,38016,38017,3,4,0
10880,3,3,38016,38017,38020,1,4,0
10881,1,1,38017,38020,38021,3,4,0
10882,1,2,38018,38021,38023,3,5,0
10883,4,3,38022,38023,38026,1,4,0
10884,3,3,38025,38026,38029,1,4,0
10885,4,2,38029,38029,38031,0,2,0
10886,4,1,38033,38033,38034,0,1,2
10887,6,3,38039,38039,38042,0,3,5
10888,3,3,38042,38042,38045,0,3,0
10889,4,3,38046,38046,38049,0,3,1
10890,5,2,38051,38051,38053,0,2,2
10891,3,2,38054,38054,38056,0,2,1
10892,3,2,38057,38057,38059,0,2,1
10893,6,1,38063,38063,38064,0,1,4
10894,2,3,38065,38065,38068,0,3,1
10895,1,3,38066,38068,38071,2,5,0
10896,4,1,38070,38071,38072,1,2,0
10897,5,2,38075,38075,38077,0,2,3
10898,3,1,38078,38078,38079,0,1,1
10899,2,1,38080,38080,38081,0,1,1
10900,4,3,38084,38084,38087,0,3,3
10901,2,1,38086,38087,38088,1,2,0
10902,1,1,38087,38088,38089,1,2,0
10903,2,2,38089,38089,38091,0,2,0
10904,5,2,38094,38094,38096,0,2,3
10905,3,1,38097,38097,38098,0,1,1
10906,6,1,38103,38103,38104,0,1,5
10907,2,3,38105,38105,38108,0,3,1
10908,4,2,38109,38109,38111,0,2,1
10909,1,3,38110,38111,38114,1,4,0
10910,6,1,38116,38116,38117,0,1,2
10911,5,1,38121,38121,38122,0,1,4
10912,3,1,38124,38124,38125,0,1,2
10913,5,1,38129,38129,38130,0,1,4
10914,5,2,38134,38134,38136,0,2,4
10915,4,2,38138,38138,38140,0,2,2
10916,2,2,38140,38140,38142,0,2,0
10917,4,1,38144,38144,38145,0,1,2
10918,5,3,38149,38149,38152,0,3,4
10919,6,2,38155,38155,38157,0,2,3
10920,3,3,38158,38158,38161,0,3,1
10921,5,2,38163,38163,38165,0,2,2
10922,4,2,38167,38167,38169,0,2,2
10923,3,1,38170,38170,38171,0,1,1
10924,4,2,38174,38174,38176,0,2,3
10925,1,2,38175,38176,38178,1,3,0
10926,4,3,38179,38179,38182,0,3,1
10927,4,1,38183,38183,38184,0,1,1
10928,3,2,38186,38186,38188,0,2,2
10929,6,1,38192,38192,38193,0,1,4
10930,5,1,38197,38197,38198,0,1,4
10931,4,2,38201,38201,38203,0,2,3
10932,3,1,38204,38204,38205,0,1,1
10933,4,1,38208,38208,38209,0,1,3
10934,6,2,38214,38214,38216,0,2,5
10935,6,3,38220,38220,38223,0,3,4
10936,4,2,38224,38224,38226,0,2,1
10937,1,2,38225,38226,38228,1,3,0
10938,3,3,38228,38228,38231,0,3,0
10939,3,1,38231,38231,38232,0,1,0
10940,1,3,38232,38232,38235,0,3,0
10941,5,1,38237,38237,38238,0,1,2
10942,3,2,38240,38240,38242,0,2,2
10943,2,2,38242,38242,38244,0,2,0
10944,3,3,38245,38245,38248,0,3,1
10945,3,2,38248,38248,38250,0,2,0
10946,1,1,38249,38250,38251,1,2,0
10947,1,2,38250,38251,38253,1,3,0
10948,3,3,38253,38253,38256,0,3,0
10949,5,3,38258,38258,38261,0,3,2
10950,5,1,38263,38263,38264,0,1,2
10951,2,1,38265,38265,38266,0,1,1
10952,4,2,38269,38269,38271,0,2,3
10953,3,3,38272,38272,38275,0,3,1
10954,3,2,38275,38275,38277,0,2,0
10955,6,1,38281,38281,38282,0,1,4
10956,6,1,38287,38287,38288,0,1,5
10957,3,2,38290,38290,38292,0,2,2
10958,1,3,38291,38292,38295,1,4,0
10959,5,3,38296,38296,38299,0,3,1
10960,3,3,38299,38299,38302,0,3,0
10961,6,1,38305,38305,38306,0,1,3
10962,1,1,38306,38306,38307,0,1,0
10963,5,2,38311,38311,38313,0,2,4
10964,5,3,38316,38316,38319,0,3,3
10965,2,1,38318,38319,38320,1,2,0
10966,5,3,38323,38323,38326,0,3,3
10967,6,3,38329,38329,38332,0,3,3
10968,6,1,38335,38335,38336,0,1,3
10969,4,3,38339,38339,38342,0,3,3
10970,4,3,38343,38343,38346,0,3,1
10971,3,1,38346,38346,38347,0,1,0
10972,5,1,38351,38351,38352,0,1,4
10973,3,3,38354,38354,38357,0,3,2
10974,1,1,38355,38357,38358,2,3,0
10975,6,3,38361,38361,38364,0,3,3
10976,6,3,38367,38367,38370,0,3,3
10977,4,1,38371,38371,38372,0,1,1
10978,6,3,38377,38377,38380,0,3,5
10979,5,3,38382,38382,38385,0,3,2
10980,5,2,38387,38387,38389,0,2,2
10981,5,2,38392,38392,38394,0,2,3
10982,3,2,38395,38395,38397,0,2,1
10983,6,2,38401,38401,38403,0,2,4
10984,6,2,38407,38407,38409,0,2,4
10985,5,1,38412,38412,38413,0,1,3
10986,4,2,38416,38416,38418,0,2,3
10987,5,3,38421,38421,38424,0,3,3
10988,4,1,38425,38425,38426,0,1,1
10989,4,2,38429,38429,38431,0,2,3
10990,1,1,38430,38431,38432,1,2,0
10991,1,3,38431,38432,38435,1,4,0
10992,5,2,38436,38436,38438,0,2,1
10993,4,3,38440,38440,38443,0,3,2
10994,1,3,38441,38443,38446,2,5,0
10995,4,3,38445,38446,38449,1,4,0
10996,5,2,38450,38450,38452,0,2,1
10997,6,2,38456,38456,38458,0,2,4
10998,5,3,38461,38461,38464,0,3,3
10999,2,2,38463,38464,38466,1,3,0
11000,3,3,38466,38466,38469,0,3,0
11001,6,3,38472,38472,38475,0,3,3
11002,6,3,38478,38478,38481,0,3,3
11003,3,1,38481,38481,38482,0,1,0
11004,5,1,38486,38486,38487,0,1,4
11005,4,1,38490,38490,38491,0,1,3
11006,1,1,38491,38491,38492,0,1,0
11007,1,3,38492,38492,38495,0,3,0
11008,2,2,38494,38495,38497,1,3,0
11009,1,1,38495,38497,38498,2,3,0
11010,6,3,38501,38501,38504,0,3,3
11011,1,2,38502,38504,38506,2,4,0
11012,6,3,38508,38508,38511,0,3,2
11013,3,1,38511,38511,38512,0,1,0
11014,2,1,38513,38513,38514,0,1,1
11015,1,3,38514,38514,38517,0,3,0
11016,2,1,38516,38517,38518,1,2,0
11017,2,1,38518,38518,38519,0,1,0
11018,1,3,38519,38519,38522,0,3,0
11019,1,3,38520,38522,38525,2,5,0
11020,2,2,38522,38525,38527,3,5,0
11021,2,1,38524,38527,38528,3,4,0
11022,2,3,38526,38528,38531,2,5,0
11023,6,1,38532,38532,38533,0,1,1
11024,3,2,38535,38535,38537,0,2,2
11025,4,1,38539,38539,38540,0,1,2
11026,2,1,38541,38541,38542,0,1,1
11027,4,3,38545,38545,38548,0,3,3
11028,2,1,38547,38548,38549,1,2,0
11029,3,2,38550,38550,38552,0,2,1
11030,5,1,38555,38555,38556,0,1,3
11031,5,3,38560,38560,38563,0,3,4
11032,1,3,38561,38563,38566,2,5,0
11033,2,3,38563,38566,38569,3,6,0
11034,5,3,38568,38569,38572,1,4,0
11035,2,3,38570,38572,38575,2,5,0
11036,5,2,38575,38575,38577,0,2,0
11037,4,3,38579,38579,38582,0,3,2
11038,3,2,38582,38582,38584,0,2,0
11039,5,3,38587,38587,38590,0,3,3
11040,6,2,38593,38593,38595,0,2,3
11041,1,1,38594,38595,38596,1,2,0
11042,5,2,38599,38599,38601,0,2,3
11043,1,3,38600,38601,38604,1,4,0
11044,6,1,38606,38606,38607,0,1,2
11045,3,2,38609,38609,38611,0,2,2
11046,4,3,38613,38613,38616,0,3,2
11047,4,3,38617,38617,38620,0,3,1
11048,3,2,38620,38620,38622,0,2,0
11049,6,1,38626,38626,38627,0,1,4
11050,3,1,38629,38629,38630,0,1,2
11051,3,2,38632,38632,38634,0,2,2
11052,1,1,38633,38634,38635,1,2,0
11053,5,1,38638,38638,38639,0,1,3
11054,3,1,38641,38641,38642,0,1,2
11055,4,2,38645,38645,38647,0,2,3
11056,1,3,38646,38647,38650,1,4,0
11057,4,2,38650,38650,38652,0,2,0
11058,6,1,38656,38656,38657,0,1,4
11059,3,2,38659,38659,38661,0,2,2
11060,4,3,38663,38663,38666,0,3,2
11061,5,3,38668,38668,38671,0,3,2
11062,2,1,38670,38671,38672,1,2,0
11063,6,3,38676,38676,38679,0,3,4
11064,3,2,38679,38679,38681,0,2,0
11065,1,1,38680,38681,38682,1,2,0
11066,4,3,38684,38684,38687,0,3,2
11067,5,3,38689,38689,38692,0,3,2
11068,4,2,38693,38693,38695,0,2,1
11069,3,1,38696,38696,38697,0,1,1
11070,2,1,38698,38698,38699,0,1,1
11071,1,2,38699,38699,38701,0,2,0
11072,1,1,38700,38701,38702,1,2,0
11073,1,2,38701,38702,38704,1,3,0
11074,5,2,38706,38706,38708,0,2,2
11075,1,1,38707,38708,38709,1,2,0
11076,1,1,38708,38709,38710,1,2,0
11077,1,2,38709,38710,38712,1,3,0
11078,6,3,38715,38715,38718,0,3,3
11079,2,3,38717,38718,38721,1,4,0
11080,6,2,38723,38723,38725,0,2,2
11081,2,1,38725,38725,38726,0,1,0
11082,4,1,38729,38729,38730,0,1,3
11083,2,2,38731,38731,38733,0,2,1
11084,2,2,38733,38733,38735,0,2,0
11085,5,3,38738,38738,38741,0,3,3
11086,1,1,38739,38741,38742,2,3,0
11087,3,1,38742,38742,38743,0,1,0
11088,3,1,38745,38745,38746,0,1,2
11089,3,1,38748,38748,38749,0,1,2
11090,4,3,38752,38752,38755,0,3,3
11091,1,3,38753,38755,38758,2,5,0
11092,1,2,38754,38758,38760,4,6,0
11093,3,1,38757,38760,38761,3,4,0
11094,6,3,38763,38763,38766,0,3,2
11095,6,2,38769,38769,38771,0,2,3
11096,1,3,38770,38771,38774,1,4,0
11097,5,2,38775,38775,38777,0,2,1
11098,4,3,38779,38779,38782,0,3,2
11099,1,1,38780,38782,38783,2,3,0
11100,1,3,38781,38783,38786,2,5,0
11101,3,3,38784,38786,38789,2,5,0
11102,3,3,38787,38789,38792,2,5,0
11103,6,1,38793,38793,38794,0,1,1
11104,4,3,38797,38797,38800,0,3,3
11105,3,3,38800,38800,38803,0,3,0
11106,5,2,38805,38805,38807,0,2,2
11107,3,3,38808,38808,38811,0,3,1
11108,2,1,38810,38811,38812,1,2,0
11109,5,3,38815,38815,38818,0,3,3
11110,6,1,38821,38821,38822,0,1,3
11111,5,1,38826,38826,38827,0,1,4
11112,5,1,38831,38831,38832,0,1,4
11113,1,1,38832,38832,38833,0,1,0
11114,5,1,38837,38837,38838,0,1,4
11115,3,3,38840,38840,38843,0,3,2
11116,1,3,38841,38843,38846,2,5,0
11117,2,2,38843,38846,38848,3,5,0
11118,4,3,38847,38848,38851,1,4,0
11119,5,3,38852,38852,38855,0,3,1
11120,6,2,38858,38858,38860,0,2,3
11121,6,2,38864,38864,38866,0,2,4
11122,4,2,38868,38868,38870,0,2,2
11123,1,3,38869,38870,38873,1,4,0
11124,6,3,38875,38875,38878,0,3,2
11125,1,3,38876,38878,38881,2,5,0
11126,4,2,38880,38881,38883,1,3,0
11127,2,1,38882,38883,38884,1,2,0
11128,6,1,38888,38888,38889,0,1,4
11129,6,2,38894,38894,38896,0,2,5
11130,4,1,38898,38898,38899,0,1,2
11131,2,1,38900,38900,38901,0,1,1
11132,2,3,38902,38902,38905,0,3,1
11133,6,2,38908,38908,38910,0,2,3
11134,4,2,38912,38912,38914,0,2,2
11135,2,2,38914,38914,38916,0,2,0
11136,4,2,38918,38918,38920,0,2,2
11137,4,1,38922,38922,38923,0,1,2
11138,4,2,38926,38926,38928,0,2,3
11139,4,2,38930,38930,38932,0,2,2
11140,6,3,38936,38936,38939,0,3,4
11141,5,3,38941,38941,38944,0,3,2
11142,2,3,38943,38944,38947,1,4,0
11143,6,1,38949,38949,38950,0,1,2
11144,1,1,38950,38950,38951,0,1,0
11145,3,3,38953,38953,38956,0,3,2
11146,3,3,38956,38956,38959,0,3,0
11147,6,2,38962,38962,38964,0,2,3
11148,2,2,38964,38964,38966,0,2,0
11149,2,3,38966,38966,38969,0,3,0
11150,3,3,38969,38969,38972,0,3,0
11151,2,2,38971,38972,38974,1,3,0
11152,1,2,38972,38974,38976,2,4,0
11153,5,2,38977,38977,38979,0,2,1
11154,2,2,38979,38979,38981,0,2,0
11155,5,2,38984,38984,38986,0,2,3
11156,4,1,38988,38988,38989,0,1,2
11157,2,1,38990,38990,38991,0,1,1
11158,4,3,38994,38994,38997,0,3,3
11159,1,3,38995,38997,39000,2,5,0
11160,1,1,38996,39000,39001,4,5,0
11161,4,3,39000,39001,39004,1,4,0
11162,1,1,39001,39004,39005,3,4,0
11163,2,1,39003,39005,39006,2,3,0
11164,1,3,39004,39006,39009,2,5,0
11165,4,1,39008,39009,39010,1,2,0
11166,6,1,39014,39014,39015,0,1,4
11167,2,2,39016,39016,39018,0,2,1
11168,1,3,39017,39018,39021,1,4,0
11169,6,3,39023,39023,39026,0,3,2
11170,1,1,39024,39026,39027,2,3,0
11171,4,1,39028,39028,39029,0,1,1
11172,4,1,39032,39032,39033,0,1,3
11173,1,3,39033,39033,39036,0,3,0
11174,3,3,39036,39036,39039,0,3,0
11175,2,2,39038,39039,39041,1,3,0
11176,1,2,39039,39041,39043,2,4,0
11177,4,1,39043,39043,39044,0,1,0
11178,3,2,39046,39046,39048,0,2,2
11179,4,2,39050,39050,39052,0,2,2
11180,6,2,39056,39056,39058,0,2,4
11181,1,1,39057,39058,39059,1,2,0
11182,5,1,39062,39062,39063,0,1,3
11183,6,2,39068,39068,39070,0,2,5
11184,4,3,39072,39072,39075,0,3,2
11185,2,2,39074,39075,39077,1,3,0
11186,5,1,39079,39079,39080,0,1,2
11187,3,3,39082,39082,39085,0,3,2
11188,6,3,39088,39088,39091,0,3,3
11189,3,3,39091,39091,39094,0,3,0
11190,6,1,39097,39097,39098,0,1,3
11191,3,1,39100,39100,39101,0,1,2
11192,2,3,39102,39102,39105,0,3,1
11193,5,2,39107,39107,39109,0,2,2
11194,5,3,39112,39112,39115,0,3,3
11195,1,1,39113,39115,39116,2,3,0
11196,6,2,39119,39119,39121,0,2,3
11197,5,3,39124,39124,39127,0,3,3
11198,4,1,39128,39128,39129,0,1,1
11199,5,2,39133,39133,39135,0,2,4
11200,2,2,39135,39135,39137,0,2,0
11201,3,3,39138,39138,39141,0,3,1
11202,6,1,39144,39144,39145,0,1,3
11203,2,1,39146,39146,39147,0,1,1
11204,4,2,39150,39150,39152,0,2,3
11205,2,1,39152,39152,39153,0,1,0
11206,1,1,39153,39153,39154,0,1,0
11207,4,2,39157,39157,39159,0,2,3
11208,2,3,39159,39159,39162,0,3,0
11209,1,3,39160,39162,39165,2,5,0
11210,2,1,39162,39165,39166,3,4,0
11211,4,1,39166,39166,39167,0,1,0
11212,6,3,39172,39172,39175,0,3,5
11213,6,3,39178,39178,39181,0,3,3
11214,6,2,39184,39184,39186,0,2,3
11215,2,1,39186,39186,39187,0,1,0
11216,2,3,39188,39188,39191,0,3,1
11217,5,2,39193,39193,39195,0,2,2
11218,3,2,39196,39196,39198,0,2,1
11219,4,3,39200,39200,39203,0,3,2
11220,1,3,39201,39203,39206,2,5,0
11221,5,3,39206,39206,39209,0,3,0
11222,5,1,39211,39211,39212,0,1,2
11223,1,1,39212,39212,39213,0,1,0
11224,5,3,39217,39217,39220,0,3,4
11225,1,3,39218,39220,39223,2,5,0
11226,3,2,39221,39223,39225,2,4,0
11227,2,3,39223,39225,39228,2,5,0
11228,3,1,39226,39228,39229,2,3,0
11229,1,2,39227,39229,39231,2,4,0
11230,1,1,39228,39231,39232,3,4,0
11231,5,2,39233,39233,39235,0,2,1
11232,4,1,39237,39237,39238,0,1,2
11233,6,3,39243,39243,39246,0,3,5
11234,2,2,39245,39246,39248,1,3,0
11235,6,3,39251,39251,39254,0,3,3
11236,1,3,39252,39254,39257,2,5,0
11237,6,1,39258,39258,39259,0,1,1
11238,4,2,39262,39262,39264,0,2,3
11239,2,3,39264,39264,39267,0,3,0
11240,1,2,39265,39267,39269,2,4,0
11241,6,3,39271,39271,39274,0,3,2
11242,2,2,39273,39274,39276,1,3,0
11243,3,2,39276,39276,39278,0,2,0
11244,3,1,39279,39279,39280,0,1,1
11245,6,1,39285,39285,39286,0,1,5
11246,4,2,39289,39289,39291,0,2,3
11247,1,2,39290,39291,39293,1,3,0
11248,6,2,39296,39296,39298,0,2,3
11249,2,2,39298,39298,39300,0,2,0
11250,3,3,39301,39301,39304,0,3,1
11251,4,1,39305,39305,39306,0,1,1
11252,2,3,39307,39307,39310,0,3,1
11253,4,1,39311,39311,39312,0,1,1
11254,4,1,39315,39315,39316,0,1,3
11255,3,3,39318,39318,39321,0,3,2
11256,1,1,39319,39321,39322,2,3,0
11257,2,3,39321,39322,39325,1,4,0
11258,4,2,39325,39325,39327,0,2,0
11259,4,2,39329,39329,39331,0,2,2
11260,4,1,39333,39333,39334,0,1,2
11261,4,1,39337,39337,39338,0,1,3
11262,5,1,39342,39342,39343,0,1,4
11263,5,2,39347,39347,39349,0,2,4
11264,3,2,39350,39350,39352,0,2,1
11265,6,1,39356,39356,39357,0,1,4
11266,3,2,39359,39359,39361,0,2,2
11267,1,1,39360,39361,39362,1,2,0
11268,4,3,39364,39364,39367,0,3,2
11269,2,1,39366,39367,39368,1,2,0
11270,3,1,39369,39369,39370,0,1,1
11271,1,2,39370,39370,39372,0,2,0
11272,3,3,39373,39373,39376,0,3,1
11273,4,1,39377,39377,39378,0,1,1
11274,6,1,39383,39383,39384,0,1,5
11275,5,2,39388,39388,39390,0,2,4
11276,4,2,39392,39392,39394,0,2,2
11277,4,2,39396,39396,39398,0,2,2
11278,1,2,39397,39398,39400,1,3,0
11279,5,2,39402,39402,39404,0,2,2
11280,3,2,39405,39405,39407,0,2,1
11281,5,1,39410,39410,39411,0,1,3
11282,2,3,39412,39412,39415,0,3,1
11283,5,2,39417,39417,39419,0,2,2
11284,1,3,39418,39419,39422,1,4,0
11285,3,1,39421,39422,39423,1,2,0
11286,4,2,39425,39425,39427,0,2,2
11287,4,3,39429,39429,39432,0,3,2
11288,2,3,39431,39432,39435,1,4,0
11289,3,2,39434,39435,39437,1,3,0
11290,1,2,39435,39437,39439,2,4,0
11291,6,3,39441,39441,39444,0,3,2
11292,4,2,39445,39445,39447,0,2,1
11293,1,1,39446,39447,39448,1,2,0
11294,5,3,39451,39451,39454,0,3,3
11295,6,1,39457,39457,39458,0,1,3
11296,2,2,39459,39459,39461,0,2,1
11297,5,1,39464,39464,39465,0,1,3
11298,5,2,39469,39469,39471,0,2,4
11299,1,1,39470,39471,39472,1,2,0
11300,2,3,39472,39472,39475,0,3,0
11301,6,3,39478,39478,39481,0,3,3
11302,3,3,39481,39481,39484,0,3,0
11303,1,2,39482,39484,39486,2,4,0
11304,4,2,39486,39486,39488,0,2,0
11305,1,2,39487,39488,39490,1,3,0
11306,1,3,39488,39490,39493,2,5,0
11307,2,3,39490,39493,39496,3,6,0
11308,3,2,39493,39496,39498,3,5,0
11309,4,3,39497,39498,39501,1,4,0
11310,6,3,39503,39503,39506,0,3,2
11311,4,2,39507,39507,39509,0,2,1
11312,2,3,39509,39509,39512,0,3,0
11313,6,2,39515,39515,39517,0,2,3
11314,5,3,39520,39520,39523,0,3,3
11315,4,1,39524,39524,39525,0,1,1
11316,3,2,39527,39527,39529,0,2,2
11317,4,3,39531,39531,39534,0,3,2
11318,1,3,39532,39534,39537,2,5,0
11319,5,2,39537,39537,39539,0,2,0
11320,5,1,39542,39542,39543,0,1,3
11321,6,1,39548,39548,39549,0,1,5
11322,4,1,39552,39552,39553,0,1,3
11323,6,1,39558,39558,39559,0,1,5
11324,4,1,39562,39562,39563,0,1,3
11325,5,1,39567,39567,39568,0,1,4
11326,1,3,39568,39568,39571,0,3,0
11327,6,3,39574,39574,39577,0,3,3
11328,2,3,39576,39577,39580,1,4,0
11329,6,1,39582,39582,39583,0,1,2
11330,3,2,39585,39585,39587,0,2,2
11331,3,3,39588,39588,39591,0,3,1
11332,5,1,39593,39593,39594,0,1,2
11333,2,3,39595,39595,39598,0,3,1
11334,6,3,39601,39601,39604,0,3,3
11335,3,2,39604,39604,39606,0,2,0
11336,1,2,39605,39606,39608,1,3,0
11337,4,3,39609,39609,39612,0,3,1
11338,1,3,39610,39612,39615,2,5,0
11339,3,2,39613,39615,39617,2,4,0
11340,3,2,39616,39617,39619,1,3,0
11341,5,2,39621,39621,39623,0,2,2
11342,4,1,39625,39625,39626,0,1,2
11343,4,1,39629,39629,39630,0,1,3
11344,1,1,39630,39630,39631,0,1,0
11345,4,3,39634,39634,39637,0,3,3
11346,2,3,39636,39637,39640,1,4,0
11347,6,3,39642,39642,39645,0,3,2
11348,3,3,39645,39645,39648,0,3,0
11349,5,2,39650,39650,39652,0,2,2
11350,3,3,39653,39653,39656,0,3,1
11351,4,2,39657,39657,39659,0,2,1
11352,3,2,39660,39660,39662,0,2,1
11353,3,3,39663,39663,39666,0,3,1
11354,5,1,39668,39668,39669,0,1,2
11355,1,3,39669,39669,39672,0,3,0
11356,5,3,39674,39674,39677,0,3,2
11357,3,1,39677,39677,39678,0,1,0
11358,2,3,39679,39679,39682,0,3,1
11359,4,2,39683,39683,39685,0,2,1
11360,1,2,39684,39685,39687,1,3,0
11361,3,2,39687,39687,39689,0,2,0
11362,2,2,39689,39689,39691,0,2,0
11363,4,1,39693,39693,39694,0,1,2
11364,1,2,39694,39694,39696,0,2,0
11365,4,3,39698,39698,39701,0,3,2
11366,1,3,39699,39701,39704,2,5,0
11367,1,3,39700,39704,39707,4,7,0
11368,2,2,39702,39707,39709,5,7,0
11369,6,3,39708,39709,39712,1,4,0
11370,3,1,39711,39712,39713,1,2,0
11371,6,3,39717,39717,39720,0,3,4
11372,4,3,39721,39721,39724,0,3,1
11373,6,2,39727,39727,39729,0,2,3
11374,3,2,39730,39730,39732,0,2,1
11375,4,3,39734,39734,39737,0,3,2
11376,5,1,39739,39739,39740,0,1,2
11377,3,1,39742,39742,39743,0,1,2
11378,6,2,39748,39748,39750,0,2,5
11379,2,3,39750,39750,39753,0,3,0
11380,4,3,39754,39754,39757,0,3,1
11381,2,2,39756,39757,39759,1,3,0
11382,5,1,39761,39761,39762,0,1,2
11383,2,3,39763,39763,39766,0,3,1
11384,6,1,39769,39769,39770,0,1,3
11385,5,2,39774,39774,39776,0,2,4
11386,5,2,39779,39779,39781,0,2,3
11387,3,1,39782,39782,39783,0,1,1
11388,4,2,39786,39786,39788,0,2,3
11389,2,3,39788,39788,39791,0,3,0
11390,6,1,39794,39794,39795,0,1,3
11391,2,1,39796,39796,39797,0,1,1
11392,6,1,39802,39802,39803,0,1,5
11393,4,2,39806,39806,39808,0,2,3
11394,5,1,39811,39811,39812,0,1,3
11395,6,1,39817,39817,39818,0,1,5
11396,6,2,39823,39823,39825,0,2,5
11397,4,3,39827,39827,39830,0,3,2
11398,5,1,39832,39832,39833,0,1,2
11399,3,2,39835,39835,39837,0,2,2
11400,3,1,39838,39838,39839,0,1,1
11401,3,2,39841,39841,39843,0,2,2
11402,1,1,39842,39843,39844,1,2,0
11403,5,1,39847,39847,39848,0,1,3
11404,2,2,39849,39849,39851,0,2,1
11405,1,1,39850,39851,39852,1,2,0
11406,5,2,39855,39855,39857,0,2,3
11407,4,1,39859,39859,39860,0,1,2
11408,3,3,39862,39862,39865,0,3,2
11409,2,2,39864,39865,39867,1,3,0
11410,3,2,39867,39867,39869,0,2,0
11411,1,2,39868,39869,39871,1,3,0
11412,5,1,39873,39873,39874,0,1,2
11413,5,2,39878,39878,39880,0,2,4
11414,1,2,39879,39880,39882,1,3,0
11415,2,2,39881,39882,39884,1,3,0
11416,2,1,39883,39884,39885,1,2,0
11417,3,3,39886,39886,39889,0,3,1
11418,1,2,39887,39889,39891,2,4,0
11419,5,2,39892,39892,39894,0,2,1
11420,6,2,39898,39898,39900,0,2,4
11421,3,1,39901,39901,39902,0,1,1
11422,1,1,39902,39902,39903,0,1,0
11423,3,1,39905,39905,39906,0,1,2
11424,3,2,39908,39908,39910,0,2,2
11425,2,2,39910,39910,39912,0,2,0
11426,6,3,39916,39916,39919,0,3,4
11427,3,3,39919,39919,39922,0,3,0
11428,5,1,39924,39924,39925,0,1,2
11429,2,2,39926,39926,39928,0,2,1
11430,3,1,39929,39929,39930,0,1,1
11431,6,2,39935,39935,39937,0,2,5
11432,3,2,39938,39938,39940,0,2,1
11433,5,1,39943,39943,39944,0,1,3
11434,4,1,39947,39947,39948,0,1,3
11435,2,1,39949,39949,39950,0,1,1
11436,1,3,39950,39950,39953,0,3,0
11437,3,1,39953,39953,39954,0,1,0
11438,6,2,39959,39959,39961,0,2,5
11439,1,1,39960,39961,39962,1,2,0
11440,5,3,39965,39965,39968,0,3,3
11441,2,2,39967,39968,39970,1,3,0
11442,6,2,39973,39973,39975,0,2,3
11443,2,3,39975,39975,39978,0,3,0
11444,3,2,39978,39978,39980,0,2,0
11445,4,1,39982,39982,39983,0,1,2
11446,3,1,39985,39985,39986,0,1,2
11447,4,3,39989,39989,39992,0,3,3
11448,4,3,39993,39993,39996,0,3,1
11449,2,1,39995,39996,39997,1,2,0
11450,4,3,39999,39999,40002,0,3,2
11451,1,2,40000,40002,40004,2,4,0
11452,6,2,40006,40006,40008,0,2,2
11453,2,2,40008,40008,40010,0,2,0
11454,6,2,40014,40014,40016,0,2,4
11455,6,1,40020,40020,40021,0,1,4
11456,5,3,40025,40025,40028,0,3,4
11457,1,2,40026,40028,40030,2,4,0
11458,4,1,40030,40030,40031,0,1,0
11459,4,3,40034,40034,40037,0,3,3
11460,3,3,40037,40037,40040,0,3,0
11461,1,1,40038,40040,40041,2,3,0
11462,6,1,40044,40044,40045,0,1,3
11463,4,3,40048,40048,40051,0,3,3
11464,6,1,40054,40054,40055,0,1,3
11465,3,3,40057,40057,40060,0,3,2
11466,6,1,40063,40063,40064,0,1,3
11467,2,1,40065,40065,40066,0,1,1
11468,5,1,40070,40070,40071,0,1,4
11469,3,1,40073,40073,40074,0,1,2
11470,3,1,40076,40076,40077,0,1,2
11471,4,3,40080,40080,40083,0,3,3
11472,5,2,40085,40085,40087,0,2,2
11473,1,1,40086,40087,40088,1,2,0
11474,5,1,40091,40091,40092,0,1,3
11475,4,3,40095,40095,40098,0,3,3
11476,2,3,40097,40098,40101,1,4,0
11477,3,3,40100,40101,40104,1,4,0
11478,2,2,40102,40104,40106,2,4,0
11479,3,2,40105,40106,40108,1,3,0
11480,6,1,40111,40111,40112,0,1,3
11481,5,3,40116,40116,40119,0,3,4
11482,3,2,40119,40119,40121,0,2,0
11483,5,1,40124,40124,40125,0,1,3
11484,1,2,40125,40125,40127,0,2,0
11485,3,2,40128,40128,40130,0,2,1
11486,4,1,40132,40132,40133,0,1,2
11487,6,1,40138,40138,40139,0,1,5
11488,3,3,40141,40141,40144,0,3,2
11489,3,2,40144,40144,40146,0,2,0
11490,6,1,40150,40150,40151,0,1,4
11491,1,1,40151,40151,40152,0,1,0
11492,3,3,40154,40154,40157,0,3,2
11493,5,1,40159,40159,40160,0,1,2
11494,6,1,40165,40165,40166,0,1,5
11495,1,2,40166,40166,40168,0,2,0
11496,2,2,40168,40168,40170,0,2,0
11497,3,3,40171,40171,40174,0,3,1
11498,4,3,40175,40175,40178,0,3,1
11499,4,1,40179,40179,40180,0,1,1
11500,3,1,40182,40182,40183,0,1,2
11501,5,1,40187,40187,40188,0,1,4
11502,6,3,40193,40193,40196,0,3,5
11503,2,1,40195,40196,40197,1,2,0
11504,3,3,40198,40198,40201,0,3,1
11505,4,2,40202,40202,40204,0,2,1
11506,6,1,40208,40208,40209,0,1,4
11507,4,3,40212,40212,40215,0,3,3
11508,6,2,40218,40218,40220,0,2,3
11509,3,3,40221,40221,40224,0,3,1
11510,5,2,40226,40226,40228,0,2,2
11511,3,3,40229,40229,40232,0,3,1
11512,3,1,40232,40232,40233,0,1,0
11513,3,2,40235,40235,40237,0,2,2
11514,2,1,40237,40237,40238,0,1,0
11515,3,3,40240,40240,40243,0,3,2
11516,2,2,40242,40243,40245,1,3,0
11517,3,1,40245,40245,40246,0,1,0
11518,6,1,40251,40251,40252,0,1,5
11519,5,2,40256,40256,40258,0,2,4
11520,2,3,40258,40258,40261,0,3,0
11521,6,1,40264,40264,40265,0,1,3
11522,1,2,40265,40265,40267,0,2,0
11523,5,3,40270,40270,40273,0,3,3
11524,6,2,40276,40276,40278,0,2,3
11525,4,1,40280,40280,40281,0,1,2
11526,6,1,40286,40286,40287,0,1,5
11527,1,3,40287,40287,40290,0,3,0
11528,3,3,40290,40290,40293,0,3,0
11529,6,1,40296,40296,40297,0,1,3
11530,1,2,40297,40297,40299,0,2,0
11531,6,1,40303,40303,40304,0,1,4
11532,4,2,40307,40307,40309,0,2,3
11533,6,3,40313,40313,40316,0,3,4
11534,5,2,40318,40318,40320,0,2,2
11535,3,1,40321,40321,40322,0,1,1
11536,6,2,40327,40327,40329,0,2,5
11537,2,2,40329,40329,40331,0,2,0
11538,4,3,40333,40333,40336,0,3,2
11539,6,3,40339,40339,40342,0,3,3
11540,1,3,40340,40342,40345,2,5,0
11541,6,2,40346,40346,40348,0,2,1
11542,5,1,40351,40351,40352,0,1,3
11543,6,3,40357,40357,40360,0,3,5
11544,6,3,40363,40363,40366,0,3,3
11545,2,3,40365,40366,40369,1,4,0
11546,4,1,40369,40369,40370,0,1,0
11547,1,2,40370,40370,40372,0,2,0
11548,5,3,40375,40375,40378,0,3,3
11549,2,1,40377,40378,40379,1,2,0
11550,2,1,40379,40379,40380,0,1,0
11551,2,2,40381,40381,40383,0,2,1
11552,2,3,40383,40383,40386,0,3,0
11553,6,2,40389,40389,40391,0,2,3
11554,5,2,40394,40394,40396,0,2,3
11555,5,1,40399,40399,40400,0,1,3
11556,3,2,40402,40402,40404,0,2,2
11557,2,3,40404,40404,40407,0,3,0
11558,4,1,40408,40408,40409,0,1,1
11559,3,3,40411,40411,40414,0,3,2
11560,5,1,40416,40416,40417,0,1,2
11561,6,3,40422,40422,40425,0,3,5
11562,6,1,40428,40428,40429,0,1,3
11563,1,2,40429,40429,40431,0,2,0
11564,4,2,40433,40433,40435,0,2,2
11565,1,1,40434,40435,40436,1,2,0
11566,6,1,40440,40440,40441,0,1,4
11567,2,3,40442,40442,40445,0,3,1
11568,5,1,40447,40447,40448,0,1,2
11569,2,2,40449,40449,40451,0,2,1
11570,6,2,40455,40455,40457,0,2,4
11571,2,3,40457,40457,40460,0,3,0
11572,6,1,40463,40463,40464,0,1,3
11573,3,1,40466,40466,40467,0,1,2
11574,4,1,40470,40470,40471,0,1,3
11575,1,3,40471,40471,40474,0,3,0
11576,5,2,40476,40476,40478,0,2,2
11577,4,1,40480,40480,40481,0,1,2
11578,1,1,40481,40481,40482,0,1,0
11579,6,1,40487,40487,40488,0,1,5
11580,2,2,40489,40489,40491,0,2,1
11581,4,1,40493,40493,40494,0,1,2
11582,4,2,40497,40497,40499,0,2,3
11583,6,3,40503,40503,40506,0,3,4
11584,4,1,40507,40507,40508,0,1,1
11585,3,3,40510,40510,40513,0,3,2
11586,2,1,40512,40513,40514,1,2,0
11587,4,3,40516,40516,40519,0,3,2
11588,3,2,40519,40519,40521,0,2,0
11589,3,2,40522,40522,40524,0,2,1
11590,1,1,40523,40524,40525,1,2,0
11591,3,2,40526,40526,40528,0,2,1
11592,3,1,40529,40529,40530,0,1,1
11593,2,1,40531,40531,40532,0,1,1
11594,1,3,40532,40532,40535,0,3,0
11595,4,3,40536,40536,40539,0,3,1
11596,1,2,40537,40539,40541,2,4,0
11597,5,3,40542,40542,40545,0,3,1
11598,6,3,40548,40548,40551,0,3,3
11599,3,1,40551,40551,40552,0,1,0
11600,2,1,40553,40553,40554,0,1,1
11601,5,3,40558,40558,40561,0,3,4
11602,1,2,40559,40561,40563,2,4,0
11603,5,1,40564,40564,40565,0,1,1
11604,3,3,40567,40567,40570,0,3,2
11605,1,1,40568,40570,40571,2,3,0
11606,4,3,40572,40572,40575,0,3,1
11607,4,3,40576,40576,40579,0,3,1
11608,4,1,40580,40580,40581,0,1,1
11609,4,2,40584,40584,40586,0,2,3
11610,2,1,40586,40586,40587,0,1,0
11611,2,1,40588,40588,40589,0,1,1
11612,1,3,40589,40589,40592,0,3,0
11613,4,2,40593,40593,40595,0,2,1
11614,1,1,40594,40595,40596,1,2,0
11615,1,2,40595,40596,40598,1,3,0
11616,2,2,40597,40598,40600,1,3,0
11617,3,3,40600,40600,40603,0,3,0
11618,1,2,40601,40603,40605,2,4,0
11619,2,3,40603,40605,40608,2,5,0
11620,2,1,40605,40608,40609,3,4,0
11621,6,3,40611,40611,40614,0,3,2
11622,3,3,40614,40614,40617,0,3,0
11623,5,3,40619,40619,40622,0,3,2
11624,6,1,40625,40625,40626,0,1,3
11625,5,2,40630,40630,40632,0,2,4
11626,6,3,40636,40636,40639,0,3,4
11627,6,2,40642,40642,40644,0,2,3
11628,5,1,40647,40647,40648,0,1,3
11629,4,3,40651,40651,40654,0,3,3
11630,2,1,40653,40654,40655,1,2,0
11631,6,2,40659,40659,40661,0,2,4
11632,1,1,40660,40661,40662,1,2,0
11633,6,3,40666,40666,40669,0,3,4
11634,3,1,40669,40669,40670,0,1,0
11635,4,3,40673,40673,40676,0,3,3
11636,6,3,40679,40679,40682,0,3,3
11637,3,1,40682,40682,40683,0,1,0
11638,6,3,40688,40688,40691,0,3,5
11639,6,2,40694,40694,40696,0,2,3
11640,5,2,40699,40699,40701,0,2,3
11641,2,2,40701,40701,40703,0,2,0
11642,2,3,40703,40703,40706,0,3,0
11643,6,3,40709,40709,40712,0,3,3
11644,1,3,40710,40712,40715,2,5,0
11645,6,2,40716,40716,40718,0,2,1
11646,5,3,40721,40721,40724,0,3,3
11647,6,1,40727,40727,40728,0,1,3
11648,1,2,40728,40728,40730,0,2,0
11649,4,1,40732,40732,40733,0,1,2
11650,2,2,40734,40734,40736,0,2,1
11651,2,3,40736,40736,40739,0,3,0
11652,4,2,40740,40740,40742,0,2,1
11653,5,3,40745,40745,40748,0,3,3
11654,2,3,40747,40748,40751,1,4,0
11655,5,1,40752,40752,40753,0,1,1
11656,6,1,40758,40758,40759,0,1,5
11657,6,2,40764,40764,40766,0,2,5
11658,4,1,40768,40768,40769,0,1,2
11659,1,3,40769,40769,40772,0,3,0
11660,2,1,40771,40772,40773,1,2,0
11661,4,3,40775,40775,40778,0,3,2
11662,6,1,40781,40781,40782,0,1,3
11663,1,3,40782,40782,40785,0,3,0
11664,1,1,40783,40785,40786,2,3,0
11665,1,1,40784,40786,40787,2,3,0
11666,1,2,40785,40787,40789,2,4,0
11667,2,1,40787,40789,40790,2,3,0
11668,3,2,40790,40790,40792,0,2,0
11669,4,1,40794,40794,40795,0,1,2
11670,4,1,40798,40798,40799,0,1,3
11671,2,1,40800,40800,40801,0,1,1
11672,5,1,40805,40805,40806,0,1,4
11673,3,2,40808,40808,40810,0,2,2
11674,4,3,40812,40812,40815,0,3,2
11675,1,2,40813,40815,40817,2,4,0
11676,4,2,40817,40817,40819,0,2,0
11677,3,3,40820,40820,40823,0,3,1
11678,6,3,40826,40826,40829,0,3,3
11679,2,2,40828,40829,40831,1,3,0
11680,3,3,40831,40831,40834,0,3,0
11681,5,3,40836,40836,40839,0,3,2
11682,2,3,40838,40839,40842,1,4,0
11683,6,1,40844,40844,40845,0,1,2
11684,5,3,40849,40849,40852,0,3,4
11685,2,1,40851,40852,40853,1,2,0
11686,4,1,40855,40855,40856,0,1,2
11687,6,1,40861,40861,40862,0,1,5
11688,4,1,40865,40865,40866,0,1,3
11689,2,2,40867,40867,40869,0,2,1
11690,4,3,40871,40871,40874,0,3,2
11691,1,3,40872,40874,40877,2,5,0
11692,1,1,40873,40877,40878,4,5,0
11693,3,2,40876,40878,40880,2,4,0
11694,1,3,40877,40880,40883,3,6,0
11695,6,3,40883,40883,40886,0,3,0
11696,1,3,40884,40886,40889,2,5,0
11697,4,2,40888,40889,40891,1,3,0
11698,2,2,40890,40891,40893,1,3,0
11699,1,3,40891,40893,40896,2,5,0
11700,1,2,40892,40896,40898,4,6,0
11701,3,1,40895,40898,40899,3,4,0
11702,4,2,40899,40899,40901,0,2,0
11703,3,3,40902,40902,40905,0,3,1
11704,4,1,40906,40906,40907,0,1,1
11705,1,1,40907,40907,40908,0,1,0
11706,4,3,40911,40911,40914,0,3,3
11707,3,2,40914,40914,40916,0,2,0
11708,1,3,40915,40916,40919,1,4,0
11709,5,1,40920,40920,40921,0,1,1
11710,4,2,40924,40924,40926,0,2,3
11711,2,1,40926,40926,40927,0,1,0
11712,3,2,40929,40929,40931,0,2,2
11713,3,2,40932,40932,40934,0,2,1
11714,1,3,40933,40934,40937,1,4,0
11715,2,2,40935,40937,40939,2,4,0
11716,6,1,40941,40941,40942,0,1,2
11717,4,1,40945,40945,40946,0,1,3
11718,6,3,40951,40951,40954,0,3,5
11719,3,2,40954,40954,40956,0,2,0
11720,5,2,40959,40959,40961,0,2,3
11721,2,1,40961,40961,40962,0,1,0
11722,6,2,40967,40967,40969,0,2,5
11723,6,3,40973,40973,40976,0,3,4
11724,2,1,40975,40976,40977,1,2,0
11725,3,2,40978,40978,40980,0,2,1
11726,5,3,40983,40983,40986,0,3,3
11727,1,1,40984,40986,40987,2,3,0
11728,1,1,40985,40987,40988,2,3,0
11729,6,3,40991,40991,40994,0,3,3
11730,1,2,40992,40994,40996,2,4,0
11731,6,2,40998,40998,41000,0,2,2
11732,2,2,41000,41000,41002,0,2,0
11733,5,3,41005,41005,41008,0,3,3
11734,6,2,41011,41011,41013,0,2,3
11735,4,1,41015,41015,41016,0,1,2
11736,5,2,41020,41020,41022,0,2,4
11737,1,1,41021,41022,41023,1,2,0
11738,6,3,41027,41027,41030,0,3,4
11739,2,3,41029,41030,41033,1,4,0
11740,1,1,41030,41033,41034,3,4,0
11741,3,2,41033,41034,41036,1,3,0
11742,4,1,41037,41037,41038,0,1,1
11743,5,1,41042,41042,41043,0,1,4
11744,3,3,41045,41045,41048,0,3,2
11745,6,2,41051,41051,41053,0,2,3
11746,5,3,41056,41056,41059,0,3,3
11747,1,1,41057,41059,41060,2,3,0
11748,4,1,41061,41061,41062,0,1,1
11749,5,2,41066,41066,41068,0,2,4
11750,3,2,41069,41069,41071,0,2,1
11751,4,2,41073,41073,41075,0,2,2
11752,5,1,41078,41078,41079,0,1,3
11753,2,1,41080,41080,41081,0,1,1
11754,6,1,41086,41086,41087,0,1,5
11755,1,3,41087,41087,41090,0,3,0
11756,1,1,41088,41090,41091,2,3,0
11757,6,2,41094,41094,41096,0,2,3
11758,6,3,41100,41100,41103,0,3,4
11759,4,3,41104,41104,41107,0,3,1
11760,2,2,41106,41107,41109,1,3,0
11761,1,2,41107,41109,41111,2,4,0
11762,2,1,41109,41111,41112,2,3,0
11763,4,3,41113,41113,41116,0,3,1
11764,1,1,41114,41116,41117,2,3,0
11765,3,1,41117,41117,41118,0,1,0
11766,5,3,41122,41122,41125,0,3,4
11767,4,2,41126,41126,41128,0,2,1
11768,1,1,41127,41128,41129,1,2,0
11769,1,3,41128,41129,41132,1,4,0
11770,1,2,41129,41132,41134,3,5,0
11771,5,3,41134,41134,41137,0,3,0
11772,5,2,41139,41139,41141,0,2,2
11773,5,1,41144,41144,41145,0,1,3
11774,4,2,41148,41148,41150,0,2,3
11775,6,2,41154,41154,41156,0,2,4
11776,4,3,41158,41158,41161,0,3,2
11777,1,3,41159,41161,41164,2,5,0
11778,2,2,41161,41164,41166,3,5,0
11779,5,1,41166,41166,41167,0,1,0
11780,5,2,41171,41171,41173,0,2,4
11781,1,3,41172,41173,41176,1,4,0
11782,1,1,41173,41176,41177,3,4,0
11783,5,3,41178,41178,41181,0,3,1
11784,5,1,41183,41183,41184,0,1,2
11785,4,2,41187,41187,41189,0,2,3
11786,5,2,41192,41192,41194,0,2,3
11787,2,1,41194,41194,41195,0,1,0
11788,6,1,41200,41200,41201,0,1,5
11789,4,3,41204,41204,41207,0,3,3
11790,4,1,41208,41208,41209,0,1,1
11791,3,2,41211,41211,41213,0,2,2
11792,4,2,41215,41215,41217,0,2,2
11793,2,2,41217,41217,41219,0,2,0
11794,2,3,41219,41219,41222,0,3,0
11795,4,1,41223,41223,41224,0,1,1
11796,1,2,41224,41224,41226,0,2,0
11797,2,3,41226,41226,41229,0,3,0
11798,3,1,41229,41229,41230,0,1,0
11799,5,1,41234,41234,41235,0,1,4
11800,1,1,41235,41235,41236,0,1,0
11801,1,2,41236,41236,41238,0,2,0
11802,6,2,41242,41242,41244,0,2,4
11803,4,1,41246,41246,41247,0,1,2
11804,6,1,41252,41252,41253,0,1,5
11805,3,1,41255,41255,41256,0,1,2
11806,5,3,41260,41260,41263,0,3,4
11807,1,3,41261,41263,41266,2,5,0
11808,1,1,41262,41266,41267,4,5,0
11809,4,2,41266,41267,41269,1,3,0
11810,4,3,41270,41270,41273,0,3,1
11811,3,3,41273,41273,41276,0,3,0
11812,6,2,41279,41279,41281,0,2,3
11813,5,2,41284,41284,41286,0,2,3
11814,6,3,41290,41290,41293,0,3,4
11815,2,3,41292,41293,41296,1,4,0
11816,6,1,41298,41298,41299,0,1,2
11817,5,1,41303,41303,41304,0,1,4
11818,2,2,41305,41305,41307,0,2,1
11819,6,2,41311,41311,41313,0,2,4
11820,1,2,41312,41313,41315,1,3,0
11821,3,1,41315,41315,41316,0,1,0
11822,1,3,41316,41316,41319,0,3,0
11823,6,1,41322,41322,41323,0,1,3
11824,2,1,41324,41324,41325,0,1,1
11825,2,3,41326,41326,41329,0,3,1
11826,1,2,41327,41329,41331,2,4,0
11827,1,2,41328,41331,41333,3,5,0
11828,4,3,41332,41333,41336,1,4,0
11829,5,3,41337,41337,41340,0,3,1
11830,5,3,41342,41342,41345,0,3,2
11831,3,2,41345,41345,41347,0,2,0
11832,6,3,41351,41351,41354,0,3,4
11833,2,2,41353,41354,41356,1,3,0
11834,1,2,41354,41356,41358,2,4,0
11835,3,3,41357,41358,41361,1,4,0
11836,2,2,41359,41361,41363,2,4,0
11837,4,3,41363,41363,41366,0,3,0
11838,6,1,41369,41369,41370,0,1,3
11839,1,3,41370,41370,41373,0,3,0
11840,6,1,41376,41376,41377,0,1,3
11841,5,3,41381,41381,41384,0,3,4
11842,3,3,41384,41384,41387,0,3,0
11843,2,2,41386,41387,41389,1,3,0
11844,5,2,41391,41391,41393,0,2,2
11845,3,1,41394,41394,41395,0,1,1
11846,5,3,41399,41399,41402,0,3,4
11847,6,1,41405,41405,41406,0,1,3
11848,2,1,41407,41407,41408,0,1,1
11849,4,2,41411,41411,41413,0,2,3
11850,2,1,41413,41413,41414,0,1,0
11851,3,1,41416,41416,41417,0,1,2
11852,5,3,41421,41421,41424,0,3,4
11853,1,3,41422,41424,41427,2,5,0
11854,2,3,41424,41427,41430,3,6,0
11855,6,1,41430,41430,41431,0,1,0
11856,5,1,41435,41435,41436,0,1,4
11857,4,2,41439,41439,41441,0,2,3
11858,3,2,41442,41442,41444,0,2,1
11859,3,2,41445,41445,41447,0,2,1
11860,5,2,41450,41450,41452,0,2,3
11861,2,1,41452,41452,41453,0,1,0
11862,4,3,41456,41456,41459,0,3,3
11863,5,1,41461,41461,41462,0,1,2
11864,5,1,41466,41466,41467,0,1,4
11865,2,2,41468,41468,41470,0,2,1
11866,2,2,41470,41470,41472,0,2,0
11867,2,3,41472,41472,41475,0,3,0
11868,2,1,41474,41475,41476,1,2,0
11869,6,2,41480,41480,41482,0,2,4
11870,6,2,41486,41486,41488,0,2,4
11871,4,3,41490,41490,41493,0,3,2
11872,4,1,41494,41494,41495,0,1,1
11873,5,2,41499,41499,41501,0,2,4
11874,5,1,41504,41504,41505,0,1,3
11875,5,1,41509,41509,41510,0,1,4
11876,5,3,41514,41514,41517,0,3,4
11877,3,1,41517,41517,41518,0,1,0
11878,4,2,41521,41521,41523,0,2,3
11879,4,1,41525,41525,41526,0,1,2
11880,4,2,41529,41529,41531,0,2,3
11881,6,2,41535,41535,41537,0,2,4
11882,5,1,41540,41540,41541,0,1,3
11883,6,3,41546,41546,41549,0,3,5
11884,4,3,41550,41550,41553,0,3,1
11885,5,1,41555,41555,41556,0,1,2
11886,4,1,41559,41559,41560,0,1,3
11887,5,3,41564,41564,41567,0,3,4
11888,2,3,41566,41567,41570,1,4,0
11889,3,1,41569,41570,41571,1,2,0
11890,2,3,41571,41571,41574,0,3,0
11891,2,3,41573,41574,41577,1,4,0
11892,6,3,41579,41579,41582,0,3,2
11893,2,1,41581,41582,41583,1,2,0
11894,4,2,41585,41585,41587,0,2,2
11895,2,1,41587,41587,41588,0,1,0
11896,6,2,41593,41593,41595,0,2,5
11897,4,2,41597,41597,41599,0,2,2
11898,1,3,41598,41599,41602,1,4,0
11899,5,2,41603,41603,41605,0,2,1
11900,2,1,41605,41605,41606,0,1,0
11901,3,3,41608,41608,41611,0,3,2
11902,5,2,41613,41613,41615,0,2,2
11903,2,2,41615,41615,41617,0,2,0
11904,1,2,41616,41617,41619,1,3,0
11905,2,1,41618,41619,41620,1,2,0
11906,1,3,41619,41620,41623,1,4,0
11907,6,3,41625,41625,41628,0,3,2
11908,6,1,41631,41631,41632,0,1,3
11909,5,1,41636,41636,41637,0,1,4
11910,5,1,41641,41641,41642,0,1,4
11911,3,2,41644,41644,41646,0,2,2
11912,6,3,41650,41650,41653,0,3,4
11913,1,3,41651,41653,41656,2,5,0
11914,6,1,41657,41657,41658,0,1,1
11915,3,1,41660,41660,41661,0,1,2
11916,1,3,41661,41661,41664,0,3,0
11917,6,2,41667,41667,41669,0,2,3
11918,3,3,41670,41670,41673,0,3,1
11919,6,2,41676,41676,41678,0,2,3
11920,2,1,41678,41678,41679,0,1,0
11921,5,3,41683,41683,41686,0,3,4
11922,1,3,41684,41686,41689,2,5,0
11923,4,1,41688,41689,41690,1,2,0
11924,6,3,41694,41694,41697,0,3,4
11925,5,2,41699,41699,41701,0,2,2
11926,5,1,41704,41704,41705,0,1,3
11927,1,2,41705,41705,41707,0,2,0
11928,5,1,41710,41710,41711,0,1,3
11929,4,3,41714,41714,41717,0,3,3
11930,6,3,41720,41720,41723,0,3,3
11931,1,3,41721,41723,41726,2,5,0
11932,5,2,41726,41726,41728,0,2,0
11933,6,3,41732,41732,41735,0,3,4
11934,6,1,41738,41738,41739,0,1,3
11935,4,3,41742,41742,41745,0,3,3
11936,1,1,41743,41745,41746,2,3,0
11937,2,2,41745,41746,41748,1,3,0
11938,6,3,41751,41751,41754,0,3,3
11939,2,2,41753,41754,41756,1,3,0
11940,5,2,41758,41758,41760,0,2,2
11941,4,3,41762,41762,41765,0,3,2
11942,4,2,41766,41766,41768,0,2,1
11943,1,2,41767,41768,41770,1,3,0
11944,6,1,41773,41773,41774,0,1,3
11945,4,2,41777,41777,41779,0,2,3
11946,2,2,41779,41779,41781,0,2,0
11947,5,1,41784,41784,41785,0,1,3
11948,6,1,41790,41790,41791,0,1,5
11949,2,2,41792,41792,41794,0,2,1
11950,2,2,41794,41794,41796,0,2,0
11951,2,2,41796,41796,41798,0,2,0
11952,1,1,41797,41798,41799,1,2,0
11953,5,3,41802,41802,41805,0,3,3
11954,2,1,41804,41805,41806,1,2,0
11955,5,2,41809,41809,41811,0,2,3
11956,5,3,41814,41814,41817,0,3,3
11957,4,3,41818,41818,41821,0,3,1
11958,1,2,41819,41821,41823,2,4,0
11959,1,1,41820,41823,41824,3,4,0
11960,2,2,41822,41824,41826,2,4,0
11961,6,3,41828,41828,41831,0,3,2
11962,6,3,41834,41834,41837,0,3,3
11963,5,1,41839,41839,41840,0,1,2
11964,5,2,41844,41844,41846,0,2,4
11965,6,1,41850,41850,41851,0,1,4
11966,2,2,41852,41852,41854,0,2,1
11967,5,1,41857,41857,41858,0,1,3
11968,3,1,41860,41860,41861,0,1,2
11969,3,3,41863,41863,41866,0,3,2
11970,5,3,41868,41868,41871,0,3,2
11971,4,3,41872,41872,41875,0,3,1
11972,3,3,41875,41875,41878,0,3,0
11973,4,2,41879,41879,41881,0,2,1
11974,2,3,41881,41881,41884,0,3,0
11975,1,3,41882,41884,41887,2,5,0
11976,4,2,41886,41887,41889,1,3,0
11977,5,1,41891,41891,41892,0,1,2
11978,5,3,41896,41896,41899,0,3,4
11979,4,1,41900,41900,41901,0,1,1
11980,3,1,41903,41903,41904,0,1,2
11981,6,3,41909,41909,41912,0,3,5
11982,4,1,41913,41913,41914,0,1,1
11983,4,3,41917,41917,41920,0,3,3
11984,5,2,41922,41922,41924,0,2,2
11985,5,1,41927,41927,41928,0,1,3
11986,3,2,41930,41930,41932,0,2,2
11987,5,1,41935,41935,41936,0,1,3
11988,6,1,41941,41941,41942,0,1,5
11989,2,3,41943,41943,41946,0,3,1
11990,3,3,41946,41946,41949,0,3,0
11991,5,2,41951,41951,41953,0,2,2
11992,4,1,41955,41955,41956,0,1,2
11993,4,1,41959,41959,41960,0,1,3
11994,6,2,41965,41965,41967,0,2,5
11995,4,2,41969,41969,41971,0,2,2
11996,3,3,41972,41972,41975,0,3,1
11997,2,2,41974,41975,41977,1,3,0
11998,4,3,41978,41978,41981,0,3,1
11999,4,3,41982,41982,41985,0,3,1
12000,6,1,41988,41988,41989,0,1,3
12001,3,3,41991,41991,41994,0,3,2
12002,6,2,41997,41997,41999,0,2,3
12003,5,2,42002,42002,42004,0,2,3
12004,3,3,42005,42005,42008,0,3,1
12005,1,3,42006,42008,42011,2,5,0
12006,1,2,42007,42011,42013,4,6,0
12007,4,1,42011,42013,42014,2,3,0
12008,5,1,42016,42016,42017,0,1,2
12009,4,1,42020,42020,42021,0,1,3
12010,2,3,42022,42022,42025,0,3,1
12011,1,3,42023,42025,42028,2,5,0
12012,1,2,42024,42028,42030,4,6,0
12013,4,1,42028,42030,42031,2,3,0
12014,4,3,42032,42032,42035,0,3,1
12015,3,3,42035,42035,42038,0,3,0
12016,5,3,42040,42040,42043,0,3,2
12017,2,3,42042,42043,42046,1,4,0
12018,4,2,42046,42046,42048,0,2,0
12019,6,1,42052,42052,42053,0,1,4
12020,3,1,42055,42055,42056,0,1,2
12021,6,3,42061,42061,42064,0,3,5
12022,6,2,42067,42067,42069,0,2,3
12023,2,3,42069,42069,42072,0,3,0
12024,1,2,42070,42072,42074,2,4,0
12025,3,1,42073,42074,42075,1,2,0
12026,1,3,42074,42075,42078,1,4,0
12027,3,3,42077,42078,42081,1,4,0
12028,3,1,42080,42081,42082,1,2,0
12029,1,2,42081,42082,42084,1,3,0
12030,3,2,42084,42084,42086,0,2,0
12031,2,3,42086,42086,42089,0,3,0
12032,4,3,42090,42090,42093,0,3,1
12033,2,2,42092,42093,42095,1,3,0
12034,3,2,42095,42095,42097,0,2,0
12035,5,3,42100,42100,42103,0,3,3
12036,4,3,42104,42104,42107,0,3,1
12037,4,1,42108,42108,42109,0,1,1
12038,1,3,42109,42109,42112,0,3,0
12039,3,2,42112,42112,42114,0,2,0
12040,6,1,42118,42118,42119,0,1,4
12041,4,1,42122,42122,42123,0,1,3
12042,4,1,42126,42126,42127,0,1,3
12043,2,3,42128,42128,42131,0,3,1
12044,4,3,42132,42132,42135,0,3,1
12045,6,3,42138,42138,42141,0,3,3
12046,5,1,42143,42143,42144,0,1,2
12047,3,2,42146,42146,42148,0,2,2
12048,1,3,42147,42148,42151,1,4,0
12049,2,3,42149,42151,42154,2,5,0
12050,1,1,42150,42154,42155,4,5,0
12051,2,3,42152,42155,42158,3,6,0
12052,6,3,42158,42158,42161,0,3,0
12053,2,3,42160,42161,42164,1,4,0
12054,3,2,42163,42164,42166,1,3,0
12055,3,2,42166,42166,42168,0,2,0
12056,4,2,42170,42170,42172,0,2,2
12057,3,3,42173,42173,42176,0,3,1
12058,3,1,42176,42176,42177,0,1,0
12059,2,1,42178,42178,42179,0,1,1
12060,2,2,42180,42180,42182,0,2,1
12061,4,1,42184,42184,42185,0,1,2
12062,2,2,42186,42186,42188,0,2,1
12063,6,2,42192,42192,42194,0,2,4
12064,4,2,42196,42196,42198,0,2,2
12065,5,3,42201,42201,42204,0,3,3
12066,5,1,42206,42206,42207,0,1,2
12067,6,1,42212,42212,42213,0,1,5
12068,2,2,42214,42214,42216,0,2,1
12069,4,3,42218,42218,42221,0,3,2
12070,5,1,42223,42223,42224,0,1,2
12071,3,3,42226,42226,42229,0,3,2
12072,5,2,42231,42231,42233,0,2,2
12073,2,1,42233,42233,42234,0,1,0
12074,5,1,42238,42238,42239,0,1,4
12075,6,3,42244,42244,42247,0,3,5
12076,4,2,42248,42248,42250,0,2,1
12077,5,1,42253,42253,42254,0,1,3
12078,5,1,42258,42258,42259,0,1,4
12079,3,1,42261,42261,42262,0,1,2
12080,3,3,42264,42264,42267,0,3,2
12081,2,3,42266,42267,42270,1,4,0
12082,3,2,42269,42270,42272,1,3,0
12083,6,3,42275,42275,42278,0,3,3
12084,2,1,42277,42278,42279,1,2,0
12085,4,1,42281,42281,42282,0,1,2
12086,2,2,42283,42283,42285,0,2,1
12087,4,1,42287,42287,42288,0,1,2
12088,3,2,42290,42290,42292,0,2,2
12089,5,2,42295,42295,42297,0,2,3
12090,2,2,42297,42297,42299,0,2,0
12091,1,2,42298,42299,42301,1,3,0
12092,5,1,42303,42303,42304,0,1,2
12093,4,3,42307,42307,42310,0,3,3
12094,1,1,42308,42310,42311,2,3,0
12095,4,3,42312,42312,42315,0,3,1
12096,1,2,42313,42315,42317,2,4,0
12097,1,3,42314,42317,42320,3,6,0
12098,1,1,42315,42320,42321,5,6,0
12099,3,2,42318,42321,42323,3,5,0
12100,4,1,42322,42323,42324,1,2,0
12101,6,2,42328,42328,42330,0,2,4
12102,2,1,42330,42330,42331,0,1,0
12103,5,2,42335,42335,42337,0,2,4
12104,3,3,42338,42338,42341,0,3,1
12105,2,3,42340,42341,42344,1,4,0
12106,1,1,42341,42344,42345,3,4,0
12107,2,3,42343,42345,42348,2,5,0
12108,2,3,42345,42348,42351,3,6,0
12109,2,2,42347,42351,42353,4,6,0
12110,6,3,42353,42353,42356,0,3,0
12111,4,3,42357,42357,42360,0,3,1
12112,4,3,42361,42361,42364,0,3,1
12113,5,1,42366,42366,42367,0,1,2
12114,5,3,42371,42371,42374,0,3,4
12115,1,1,42372,42374,42375,2,3,0
12116,1,1,42373,42375,42376,2,3,0
12117,4,1,42377,42377,42378,0,1,1
12118,3,2,42380,42380,42382,0,2,2
12119,5,1,42385,42385,42386,0,1,3
12120,6,2,42391,42391,42393,0,2,5
12121,4,1,42395,42395,42396,0,1,2
12122,2,1,42397,42397,42398,0,1,1
12123,1,1,42398,42398,42399,0,1,0
12124,2,2,42400,42400,42402,0,2,1
12125,5,1,42405,42405,42406,0,1,3
12126,5,2,42410,42410,42412,0,2,4
12127,5,3,42415,42415,42418,0,3,3
12128,5,3,42420,42420,42423,0,3,2
12129,2,2,42422,42423,42425,1,3,0
12130,5,1,42427,42427,42428,0,1,2
12131,5,2,42432,42432,42434,0,2,4
12132,2,1,42434,42434,42435,0,1,0
12133,2,2,42436,42436,42438,0,2,1
12134,2,2,42438,42438,42440,0,2,0
12135,2,2,42440,42440,42442,0,2,0
12136,4,2,42444,42444,42446,0,2,2
12137,6,1,42450,42450,42451,0,1,4
12138,5,3,42455,42455,42458,0,3,4
12139,1,3,42456,42458,42461,2,5,0
12140,1,2,42457,42461,42463,4,6,0
12141,5,3,42462,42463,42466,1,4,0
12142,1,2,42463,42466,42468,3,5,0
12143,5,1,42468,42468,42469,0,1,0
12144,4,3,42472,42472,42475,0,3,3
12145,4,1,42476,42476,42477,0,1,1
12146,5,2,42481,42481,42483,0,2,4
12147,3,2,42484,42484,42486,0,2,1
12148,3,1,42487,42487,42488,0,1,1
12149,5,1,42492,42492,42493,0,1,4
12150,6,2,42498,42498,42500,0,2,5
12151,6,1,42504,42504,42505,0,1,4
12152,3,3,42507,42507,42510,0,3,2
12153,3,2,42510,42510,42512,0,2,0
12154,3,3,42513,42513,42516,0,3,1
12155,6,2,42519,42519,42521,0,2,3
12156,2,1,42521,42521,42522,0,1,0
12157,2,2,42523,42523,42525,0,2,1
12158,4,3,42527,42527,42530,0,3,2
12159,4,2,42531,42531,42533,0,2,1
12160,1,2,42532,42533,42535,1,3,0
12161,2,1,42534,42535,42536,1,2,0
12162,1,1,42535,42536,42537,1,2,0
12163,1,1,42536,42537,42538,1,2,0
12164,4,1,42540,42540,42541,0,1,2
12165,3,3,42543,42543,42546,0,3,2
12166,6,3,42549,42549,42552,0,3,3
12167,3,3,42552,42552,42555,0,3,0
12168,3,1,42555,42555,42556,0,1,0
12169,6,1,42561,42561,42562,0,1,5
12170,3,1,42564,42564,42565,0,1,2
12171,4,3,42568,42568,42571,0,3,3
12172,3,3,42571,42571,42574,0,3,0
12173,5,1,42576,42576,42577,0,1,2
12174,3,3,42579,42579,42582,0,3,2
12175,3,2,42582,42582,42584,0,2,0
12176,1,1,42583,42584,42585,1,2,0
12177,6,3,42589,42589,42592,0,3,4
12178,5,2,42594,42594,42596,0,2,2
12179,6,3,42600,42600,42603,0,3,4
12180,3,2,42603,42603,42605,0,2,0
12181,1,1,42604,42605,42606,1,2,0
12182,2,3,42606,42606,42609,0,3,0
12183,6,1,42612,42612,42613,0,1,3
12184,6,3,42618,42618,42621,0,3,5
12185,5,1,42623,42623,42624,0,1,2
12186,2,3,42625,42625,42628,0,3,1
12187,3,1,42628,42628,42629,0,1,0
12188,5,3,42633,42633,42636,0,3,4
12189,4,2,42637,42637,42639,0,2,1
12190,5,2,42642,42642,42644,0,2,3
12191,4,1,42646,42646,42647,0,1,2
12192,5,2,42651,42651,42653,0,2,4
12193,6,3,42657,42657,42660,0,3,4
12194,5,1,42662,42662,42663,0,1,2
12195,3,2,42665,42665,42667,0,2,2
12196,6,3,42671,42671,42674,0,3,4
12197,4,3,42675,42675,42678,0,3,1
12198,2,1,42677,42678,42679,1,2,0
12199,6,1,42683,42683,42684,0,1,4
12200,1,2,42684,42684,42686,0,2,0
12201,5,1,42689,42689,42690,0,1,3
12202,4,1,42693,42693,42694,0,1,3
12203,1,3,42694,42694,42697,0,3,0
12204,6,3,42700,42700,42703,0,3,3
12205,5,2,42705,42705,42707,0,2,2
12206,1,1,42706,42707,42708,1,2,0
12207,5,2,42711,42711,42713,0,2,3
12208,1,2,42712,42713,42715,1,3,0
12209,6,3,42718,42718,42721,0,3,3
12210,2,3,42720,42721,42724,1,4,0
12211,6,1,42726,42726,42727,0,1,2
12212,2,3,42728,42728,42731,0,3,1
12213,3,2,42731,42731,42733,0,2,0
12214,5,1,42736,42736,42737,0,1,3
12215,4,3,42740,42740,42743,0,3,3
12216,5,3,42745,42745,42748,0,3,2
12217,3,2,42748,42748,42750,0,2,0
12218,4,1,42752,42752,42753,0,1,2
12219,3,3,42755,42755,42758,0,3,2
12220,6,2,42761,42761,42763,0,2,3
12221,5,3,42766,42766,42769,0,3,3
12222,1,3,42767,42769,42772,2,5,0
12223,2,3,42769,42772,42775,3,6,0
12224,3,3,42772,42775,42778,3,6,0
12225,6,2,42778,42778,42780,0,2,0
12226,4,1,42782,42782,42783,0,1,2
12227,6,1,42788,42788,42789,0,1,5
12228,5,2,42793,42793,42795,0,2,4
12229,1,2,42794,42795,42797,1,3,0
12230,3,2,42797,42797,42799,0,2,0
12231,5,2,42802,42802,42804,0,2,3
12232,6,2,42808,42808,42810,0,2,4
12233,3,3,42811,42811,42814,0,3,1
12234,5,3,42816,42816,42819,0,3,2
12235,1,2,42817,42819,42821,2,4,0
12236,6,3,42823,42823,42826,0,3,2
12237,6,3,42829,42829,42832,0,3,3
12238,1,2,42830,42832,42834,2,4,0
12239,6,2,42836,42836,42838,0,2,2
12240,3,1,42839,42839,42840,0,1,1
12241,5,3,42844,42844,42847,0,3,4
12242,6,2,42850,42850,42852,0,2,3
12243,3,2,42853,42853,42855,0,2,1
12244,4,3,42857,42857,42860,0,3,2
12245,1,2,42858,42860,42862,2,4,0
12246,4,2,42862,42862,42864,0,2,0
12247,3,2,42865,42865,42867,0,2,1
12248,2,3,42867,42867,42870,0,3,0
12249,5,3,42872,42872,42875,0,3,2
12250,2,2,42874,42875,42877,1,3,0
12251,6,3,42880,42880,42883,0,3,3
12252,1,3,42881,42883,42886,2,5,0
12253,3,3,42884,42886,42889,2,5,0
12254,1,3,42885,42889,42892,4,7,0
12255,6,3,42891,42892,42895,1,4,0
12256,1,1,42892,42895,42896,3,4,0
12257,4,1,42896,42896,42897,0,1,0
12258,4,2,42900,42900,42902,0,2,3
12259,2,2,42902,42902,42904,0,2,0
12260,4,3,42906,42906,42909,0,3,2
12261,1,3,42907,42909,42912,2,5,0
12262,6,1,42913,42913,42914,0,1,1
12263,1,2,42914,42914,42916,0,2,0
12264,4,3,42918,42918,42921,0,3,2
12265,2,2,42920,42921,42923,1,3,0
12266,5,1,42925,42925,42926,0,1,2
12267,4,3,42929,42929,42932,0,3,3
12268,5,3,42934,42934,42937,0,3,2
12269,2,2,42936,42937,42939,1,3,0
12270,3,2,42939,42939,42941,0,2,0
12271,4,3,42943,42943,42946,0,3,2
12272,5,1,42948,42948,42949,0,1,2
12273,3,1,42951,42951,42952,0,1,2
12274,4,3,42955,42955,42958,0,3,3
12275,3,2,42958,42958,42960,0,2,0
12276,2,2,42960,42960,42962,0,2,0
12277,1,1,42961,42962,42963,1,2,0
12278,1,2,42962,42963,42965,1,3,0
12279,6,2,42968,42968,42970,0,2,3
12280,4,2,42972,42972,42974,0,2,2
12281,4,2,42976,42976,42978,0,2,2
12282,4,2,42980,42980,42982,0,2,2
12283,1,1,42981,42982,42983,1,2,0
12284,6,2,42987,42987,42989,0,2,4
12285,1,2,42988,42989,42991,1,3,0
12286,6,2,42994,42994,42996,0,2,3
12287,3,2,42997,42997,42999,0,2,1
12288,3,1,43000,43000,43001,0,1,1
12289,4,3,43004,43004,43007,0,3,3
12290,2,2,43006,43007,43009,1,3,0
12291,1,2,43007,43009,43011,2,4,0
12292,2,2,43009,43011,43013,2,4,0
12293,4,2,43013,43013,43015,0,2,0
12294,3,3,43016,43016,43019,0,3,1
12295,6,3,43022,43022,43025,0,3,3
12296,6,2,43028,43028,43030,0,2,3
12297,4,2,43032,43032,43034,0,2,2
12298,3,3,43035,43035,43038,0,3,1
12299,6,3,43041,43041,43044,0,3,3
12300,5,1,43046,43046,43047,0,1,2
12301,2,1,43048,43048,43049,0,1,1
12302,1,1,43049,43049,43050,0,1,0
12303,4,1,43053,43053,43054,0,1,3
12304,4,2,43057,43057,43059,0,2,3
12305,6,1,43063,43063,43064,0,1,4
12306,6,2,43069,43069,43071,0,2,5
12307,1,1,43070,43071,43072,1,2,0
12308,2,2,43072,43072,43074,0,2,0
12309,2,2,43074,43074,43076,0,2,0
12310,1,2,43075,43076,43078,1,3,0
12311,1,1,43076,43078,43079,2,3,0
12312,3,3,43079,43079,43082,0,3,0
12313,1,3,43080,43082,43085,2,5,0
12314,6,3,43086,43086,43089,0,3,1
12315,2,1,43088,43089,43090,1,2,0
12316,2,2,43090,43090,43092,0,2,0
12317,1,1,43091,43092,43093,1,2,0
12318,3,1,43094,43094,43095,0,1,1
12319,5,2,43099,43099,43101,0,2,4
12320,3,2,43102,43102,43104,0,2,1
12321,6,2,43108,43108,43110,0,2,4
12322,2,2,43110,43110,43112,0,2,0
12323,5,3,43115,43115,43118,0,3,3
12324,2,1,43117,43118,43119,1,2,0
12325,5,1,43122,43122,43123,0,1,3
12326,3,1,43125,43125,43126,0,1,2
12327,1,3,43126,43126,43129,0,3,0
12328,6,2,43132,43132,43134,0,2,3
12329,3,3,43135,43135,43138,0,3,1
12330,6,3,43141,43141,43144,0,3,3
12331,5,2,43146,43146,43148,0,2,2
12332,4,1,43150,43150,43151,0,1,2
12333,3,2,43153,43153,43155,0,2,2
12334,1,2,43154,43155,43157,1,3,0
12335,3,2,43157,43157,43159,0,2,0
12336,3,1,43160,43160,43161,0,1,1
12337,6,1,43166,43166,43167,0,1,5
12338,4,1,43170,43170,43171,0,1,3
12339,6,3,43176,43176,43179,0,3,5
12340,3,3,43179,43179,43182,0,3,0
12341,5,3,43184,43184,43187,0,3,2
12342,3,2,43187,43187,43189,0,2,0
12343,2,2,43189,43189,43191,0,2,0
12344,5,3,43194,43194,43197,0,3,3
12345,1,3,43195,43197,43200,2,5,0
12346,3,3,43198,43200,43203,2,5,0
12347,5,3,43203,43203,43206,0,3,0
12348,3,1,43206,43206,43207,0,1,0
12349,5,2,43211,43211,43213,0,2,4
12350,1,1,43212,43213,43214,1,2,0
12351,3,3,43215,43215,43218,0,3,1
12352,6,1,43221,43221,43222,0,1,3
12353,2,1,43223,43223,43224,0,1,1
12354,4,1,43227,43227,43228,0,1,3
12355,3,1,43230,43230,43231,0,1,2
12356,2,1,43232,43232,43233,0,1,1
12357,4,1,43236,43236,43237,0,1,3
12358,6,1,43242,43242,43243,0,1,5
12359,5,1,43247,43247,43248,0,1,4
12360,6,1,43253,43253,43254,0,1,5
12361,1,2,43254,43254,43256,0,2,0
12362,4,3,43258,43258,43261,0,3,2
12363,1,1,43259,43261,43262,2,3,0
12364,2,2,43261,43262,43264,1,3,0
12365,2,1,43263,43264,43265,1,2,0
12366,5,3,43268,43268,43271,0,3,3
12367,2,1,43270,43271,43272,1,2,0
12368,1,1,43271,43272,43273,1,2,0
12369,3,3,43274,43274,43277,0,3,1
12370,1,2,43275,43277,43279,2,4,0
12371,4,3,43279,43279,43282,0,3,0
12372,4,2,43283,43283,43285,0,2,1
12373,6,1,43289,43289,43290,0,1,4
12374,2,1,43291,43291,43292,0,1,1
12375,1,1,43292,43292,43293,0,1,0
12376,3,3,43295,43295,43298,0,3,2
12377,5,1,43300,43300,43301,0,1,2
12378,6,3,43306,43306,43309,0,3,5
12379,3,1,43309,43309,43310,0,1,0
12380,4,1,43313,43313,43314,0,1,3
12381,1,3,43314,43314,43317,0,3,0
12382,2,3,43316,43317,43320,1,4,0
12383,2,1,43318,43320,43321,2,3,0
12384,3,2,43321,43321,43323,0,2,0
12385,5,3,43326,43326,43329,0,3,3
12386,1,2,43327,43329,43331,2,4,0
12387,1,1,43328,43331,43332,3,4,0
12388,3,1,43331,43332,43333,1,2,0
12389,4,2,43335,43335,43337,0,2,2
12390,4,2,43339,43339,43341,0,2,2
12391,2,3,43341,43341,43344,0,3,0
12392,5,2,43346,43346,43348,0,2,2
12393,2,2,43348,43348,43350,0,2,0
12394,3,3,43351,43351,43354,0,3,1
12395,1,1,43352,43354,43355,2,3,0
12396,1,2,43353,43355,43357,2,4,0
12397,6,2,43359,43359,43361,0,2,2
12398,5,2,43364,43364,43366,0,2,3
12399,3,1,43367,43367,43368,0,1,1
12400,4,1,43371,43371,43372,0,1,3
12401,3,3,43374,43374,43377,0,3,2
12402,4,3,43378,43378,43381,0,3,1
12403,2,1,43380,43381,43382,1,2,0
12404,5,3,43385,43385,43388,0,3,3
12405,2,3,43387,43388,43391,1,4,0
12406,2,3,43389,43391,43394,2,5,0
12407,6,3,43395,43395,43398,0,3,1
12408,5,1,43400,43400,43401,0,1,2
12409,3,1,43403,43403,43404,0,1,2
12410,5,3,43408,43408,43411,0,3,4
12411,5,2,43413,43413,43415,0,2,2
12412,2,3,43415,43415,43418,0,3,0
12413,2,2,43417,43418,43420,1,3,0
12414,1,3,43418,43420,43423,2,5,0
12415,5,2,43423,43423,43425,0,2,0
12416,3,2,43426,43426,43428,0,2,1
12417,1,1,43427,43428,43429,1,2,0
12418,1,3,43428,43429,43432,1,4,0
12419,5,1,43433,43433,43434,0,1,1
12420,6,3,43439,43439,43442,0,3,5
12421,1,3,43440,43442,43445,2,5,0
12422,3,3,43443,43445,43448,2,5,0
12423,3,3,43446,43448,43451,2,5,0
12424,1,3,43447,43451,43454,4,7,0
12425,2,3,43449,43454,43457,5,8,0
12426,5,2,43454,43457,43459,3,5,0
12427,4,1,43458,43459,43460,1,2,0
12428,4,1,43462,43462,43463,0,1,2
12429,6,2,43468,43468,43470,0,2,5
12430,1,1,43469,43470,43471,1,2,0
12431,4,1,43473,43473,43474,0,1,2
12432,3,1,43476,43476,43477,0,1,2
12433,4,1,43480,43480,43481,0,1,3
12434,5,2,43485,43485,43487,0,2,4
12435,3,1,43488,43488,43489,0,1,1
12436,6,2,43494,43494,43496,0,2,5
12437,4,1,43498,43498,43499,0,1,2
12438,3,3,43501,43501,43504,0,3,2
12439,6,1,43507,43507,43508,0,1,3
12440,3,1,43510,43510,43511,0,1,2
12441,6,2,43516,43516,43518,0,2,5
12442,5,1,43521,43521,43522,0,1,3
12443,2,3,43523,43523,43526,0,3,1
12444,1,1,43524,43526,43527,2,3,0
12445,2,2,43526,43527,43529,1,3,0
12446,4,3,43530,43530,43533,0,3,1
12447,3,2,43533,43533,43535,0,2,0
12448,1,1,43534,43535,43536,1,2,0
12449,5,1,43539,43539,43540,0,1,3
12450,2,1,43541,43541,43542,0,1,1
12451,3,3,43544,43544,43547,0,3,2
12452,2,3,43546,43547,43550,1,4,0
12453,2,1,43548,43550,43551,2,3,0
12454,5,3,43553,43553,43556,0,3,2
12455,3,2,43556,43556,43558,0,2,0
12456,2,3,43558,43558,43561,0,3,0
12457,4,1,43562,43562,43563,0,1,1
12458,2,2,43564,43564,43566,0,2,1
12459,2,1,43566,43566,43567,0,1,0
12460,1,2,43567,43567,43569,0,2,0
12461,2,3,43569,43569,43572,0,3,0
12462,6,1,43575,43575,43576,0,1,3
12463,1,2,43576,43576,43578,0,2,0
12464,1,1,43577,43578,43579,1,2,0
12465,5,2,43582,43582,43584,0,2,3
12466,2,3,43584,43584,43587,0,3,0
12467,2,3,43586,43587,43590,1,4,0
12468,4,3,43590,43590,43593,0,3,0
12469,2,3,43592,43593,43596,1,4,0
12470,1,3,43593,43596,43599,3,6,0
12471,5,3,43598,43599,43602,1,4,0
12472,5,1,43603,43603,43604,0,1,1
12473,1,3,43604,43604,43607,0,3,0
12474,3,2,43607,43607,43609,0,2,0
12475,1,1,43608,43609,43610,1,2,0
12476,3,1,43611,43611,43612,0,1,1
12477,4,3,43615,43615,43618,0,3,3
12478,2,2,43617,43618,43620,1,3,0
12479,1,2,43618,43620,43622,2,4,0
12480,6,2,43624,43624,43626,0,2,2
12481,6,1,43630,43630,43631,0,1,4
12482,1,2,43631,43631,43633,0,2,0
12483,2,1,43633,43633,43634,0,1,0
12484,2,3,43635,43635,43638,0,3,1
12485,1,3,43636,43638,43641,2,5,0
12486,5,2,43641,43641,43643,0,2,0
12487,6,3,43647,43647,43650,0,3,4
12488,4,2,43651,43651,43653,0,2,1
12489,1,1,43652,43653,43654,1,2,0
12490,6,1,43658,43658,43659,0,1,4
12491,5,2,43663,43663,43665,0,2,4
12492,4,1,43667,43667,43668,0,1,2
12493,5,1,43672,43672,43673,0,1,4
12494,5,2,43677,43677,43679,0,2,4
12495,4,3,43681,43681,43684,0,3,2
12496,5,1,43686,43686,43687,0,1,2
12497,2,3,43688,43688,43691,0,3,1
12498,4,2,43692,43692,43694,0,2,1
12499,5,1,43697,43697,43698,0,1,3
12500,1,1,43698,43698,43699,0,1,0
12501,4,1,43702,43702,43703,0,1,3
12502,6,1,43708,43708,43709,0,1,5
12503,6,3,43714,43714,43717,0,3,5
12504,6,2,43720,43720,43722,0,2,3
12505,5,3,43725,43725,43728,0,3,3
12506,2,2,43727,43728,43730,1,3,0
12507,2,2,43729,43730,43732,1,3,0
12508,6,3,43735,43735,43738,0,3,3
12509,1,1,43736,43738,43739,2,3,0
12510,4,2,43740,43740,43742,0,2,1
12511,5,1,43745,43745,43746,0,1,3
12512,2,2,43747,43747,43749,0,2,1
12513,1,3,43748,43749,43752,1,4,0
12514,1,3,43749,43752,43755,3,6,0
12515,3,1,43752,43755,43756,3,4,0
12516,3,1,43755,43756,43757,1,2,0
12517,1,2,43756,43757,43759,1,3,0
12518,2,2,43758,43759,43761,1,3,0
12519,3,2,43761,43761,43763,0,2,0
12520,4,2,43765,43765,43767,0,2,2
12521,3,1,43768,43768,43769,0,1,1
12522,6,3,43774,43774,43777,0,3,5
12523,2,3,43776,43777,43780,1,4,0
12524,2,2,43778,43780,43782,2,4,0
12525,5,1,43783,43783,43784,0,1,1
12526,4,2,43787,43787,43789,0,2,3
12527,6,1,43793,43793,43794,0,1,4
12528,5,3,43798,43798,43801,0,3,4
12529,6,3,43804,43804,43807,0,3,3
12530,1,3,43805,43807,43810,2,5,0
12531,5,1,43810,43810,43811,0,1,0
12532,5,2,43815,43815,43817,0,2,4
12533,4,3,43819,43819,43822,0,3,2
12534,4,3,43823,43823,43826,0,3,1
12535,5,1,43828,43828,43829,0,1,2
12536,4,2,43832,43832,43834,0,2,3
12537,2,3,43834,43834,43837,0,3,0
12538,2,2,43836,43837,43839,1,3,0
12539,5,1,43841,43841,43842,0,1,2
12540,2,2,43843,43843,43845,0,2,1
12541,3,3,43846,43846,43849,0,3,1
12542,1,2,43847,43849,43851,2,4,0
12543,1,3,43848,43851,43854,3,6,0
12544,6,3,43854,43854,43857,0,3,0
12545,6,3,43860,43860,43863,0,3,3
12546,3,1,43863,43863,43864,0,1,0
12547,3,2,43866,43866,43868,0,2,2
12548,1,2,43867,43868,43870,1,3,0
12549,3,3,43870,43870,43873,0,3,0
12550,2,3,43872,43873,43876,1,4,0
12551,6,3,43878,43878,43881,0,3,2
12552,3,1,43881,43881,43882,0,1,0
12553,1,2,43882,43882,43884,0,2,0
12554,3,2,43885,43885,43887,0,2,1
12555,4,2,43889,43889,43891,0,2,2
12556,3,3,43892,43892,43895,0,3,1
12557,1,3,43893,43895,43898,2,5,0
12558,2,3,43895,43898,43901,3,6,0
12559,1,2,43896,43901,43903,5,7,0
12560,5,1,43901,43903,43904,2,3,0
12561,4,1,43905,43905,43906,0,1,1
12562,6,2,43911,43911,43913,0,2,5
12563,3,1,43914,43914,43915,0,1,1
12564,5,3,43919,43919,43922,0,3,4
12565,6,2,43925,43925,43927,0,2,3
12566,4,2,43929,43929,43931,0,2,2
12567,5,1,43934,43934,43935,0,1,3
12568,3,3,43937,43937,43940,0,3,2
12569,3,3,43940,43940,43943,0,3,0
12570,6,2,43946,43946,43948,0,2,3
12571,3,2,43949,43949,43951,0,2,1
12572,3,1,43952,43952,43953,0,1,1
12573,5,3,43957,43957,43960,0,3,4
12574,1,2,43958,43960,43962,2,4,0
12575,5,1,43963,43963,43964,0,1,1
12576,5,1,43968,43968,43969,0,1,4
12577,4,1,43972,43972,43973,0,1,3
12578,4,2,43976,43976,43978,0,2,3
12579,3,1,43979,43979,43980,0,1,1
12580,6,3,43985,43985,43988,0,3,5
12581,2,3,43987,43988,43991,1,4,0
12582,1,2,43988,43991,43993,3,5,0
12583,5,1,43993,43993,43994,0,1,0
12584,5,1,43998,43998,43999,0,1,4
12585,6,2,44004,44004,44006,0,2,5
12586,3,3,44007,44007,44010,0,3,1
12587,4,3,44011,44011,44014,0,3,1
12588,4,1,44015,44015,44016,0,1,1
12589,5,2,44020,44020,44022,0,2,4
12590,2,2,44022,44022,44024,0,2,0
12591,2,1,44024,44024,44025,0,1,0
12592,3,3,44027,44027,44030,0,3,2
12593,3,2,44030,44030,44032,0,2,0
12594,1,3,44031,44032,44035,1,4,0
12595,4,3,44035,44035,44038,0,3,0
12596,1,3,44036,44038,44041,2,5,0
12597,5,3,44041,44041,44044,0,3,0
12598,1,3,44042,44044,44047,2,5,0
12599,1,3,44043,44047,44050,4,7,0
12600,4,2,44047,44050,44052,3,5,0
12601,6,2,44053,44053,44055,0,2,1
12602,5,2,44058,44058,44060,0,2,3
12603,1,2,44059,44060,44062,1,3,0
12604,5,2,44064,44064,44066,0,2,2
12605,5,1,44069,44069,44070,0,1,3
12606,3,2,44072,44072,44074,0,2,2
12607,1,2,44073,44074,44076,1,3,0
12608,4,3,44077,44077,44080,0,3,1
12609,4,1,44081,44081,44082,0,1,1
12610,5,2,44086,44086,44088,0,2,4
12611,4,1,44090,44090,44091,0,1,2
12612,3,1,44093,44093,44094,0,1,2
12613,4,1,44097,44097,44098,0,1,3
12614,3,1,44100,44100,44101,0,1,2
12615,1,3,44101,44101,44104,0,3,0
12616,1,2,44102,44104,44106,2,4,0
12617,5,2,44107,44107,44109,0,2,1
12618,2,1,44109,44109,44110,0,1,0
12619,6,3,44115,44115,44118,0,3,5
12620,2,1,44117,44118,44119,1,2,0
12621,4,1,44121,44121,44122,0,1,2
12622,4,2,44125,44125,44127,0,2,3
12623,5,1,44130,44130,44131,0,1,3
12624,3,1,44133,44133,44134,0,1,2
12625,5,3,44138,44138,44141,0,3,4
12626,2,2,44140,44141,44143,1,3,0
12627,2,1,44142,44143,44144,1,2,0
12628,2,2,44144,44144,44146,0,2,0
12629,6,3,44150,44150,44153,0,3,4
12630,6,1,44156,44156,44157,0,1,3
12631,5,1,44161,44161,44162,0,1,4
12632,4,2,44165,44165,44167,0,2,3
12633,3,3,44168,44168,44171,0,3,1
12634,3,1,44171,44171,44172,0,1,0
12635,5,2,44176,44176,44178,0,2,4
12636,3,3,44179,44179,44182,0,3,1
12637,3,1,44182,44182,44183,0,1,0
12638,6,3,44188,44188,44191,0,3,5
12639,3,2,44191,44191,44193,0,2,0
12640,5,2,44196,44196,44198,0,2,3
12641,1,1,44197,44198,44199,1,2,0
12642,6,1,44203,44203,44204,0,1,4
12643,3,3,44206,44206,44209,0,3,2
12644,4,3,44210,44210,44213,0,3,1
12645,5,1,44215,44215,44216,0,1,2
12646,6,2,44221,44221,44223,0,2,5
12647,1,3,44222,44223,44226,1,4,0
12648,3,3,44225,44226,44229,1,4,0
12649,2,2,44227,44229,44231,2,4,0
12650,1,3,44228,44231,44234,3,6,0
12651,2,3,44230,44234,44237,4,7,0
12652,2,2,44232,44237,44239,5,7,0
12653,4,3,44236,44239,44242,3,6,0
12654,5,1,44241,44242,44243,1,2,0
12655,2,1,44243,44243,44244,0,1,0
12656,5,2,44248,44248,44250,0,2,4
12657,6,3,44254,44254,44257,0,3,4
12658,5,1,44259,44259,44260,0,1,2
12659,4,2,44263,44263,44265,0,2,3
12660,1,3,44264,44265,44268,1,4,0
12661,2,2,44266,44268,44270,2,4,0
12662,3,3,44269,44270,44273,1,4,0
12663,2,3,44271,44273,44276,2,5,0
12664,6,3,44277,44277,44280,0,3,1
12665,3,3,44280,44280,44283,0,3,0
12666,4,1,44284,44284,44285,0,1,1
12667,6,1,44290,44290,44291,0,1,5
12668,5,3,44295,44295,44298,0,3,4
12669,5,3,44300,44300,44303,0,3,2
12670,3,1,44303,44303,44304,0,1,0
12671,1,2,44304,44304,44306,0,2,0
12672,3,2,44307,44307,44309,0,2,1
12673,2,3,44309,44309,44312,0,3,0
12674,4,2,44313,44313,44315,0,2,1
12675,2,1,44315,44315,44316,0,1,0
12676,6,2,44321,44321,44323,0,2,5
12677,2,1,44323,44323,44324,0,1,0
12678,1,3,44324,44324,44327,0,3,0
12679,3,1,44327,44327,44328,0,1,0
12680,2,1,44329,44329,44330,0,1,1
12681,1,1,44330,44330,44331,0,1,0
12682,6,3,44336,44336,44339,0,3,5
12683,6,2,44342,44342,44344,0,2,3
12684,4,3,44346,44346,44349,0,3,2
12685,1,3,44347,44349,44352,2,5,0
12686,3,2,44350,44352,44354,2,4,0
12687,2,3,44352,44354,44357,2,5,0
12688,1,1,44353,44357,44358,4,5,0
12689,5,3,44358,44358,44361,0,3,0
12690,5,2,44363,44363,44365,0,2,2
12691,4,3,44367,44367,44370,0,3,2
12692,5,1,44372,44372,44373,0,1,2
12693,4,1,44376,44376,44377,0,1,3
12694,1,3,44377,44377,44380,0,3,0
12695,2,3,44379,44380,44383,1,4,0
12696,6,3,44385,44385,44388,0,3,2
12697,3,2,44388,44388,44390,0,2,0
12698,2,2,44390,44390,44392,0,2,0
12699,2,2,44392,44392,44394,0,2,0
12700,1,1,44393,44394,44395,1,2,0
12701,6,3,44399,44399,44402,0,3,4
12702,6,2,44405,44405,44407,0,2,3
12703,5,3,44410,44410,44413,0,3,3
12704,6,1,44416,44416,44417,0,1,3
12705,1,1,44417,44417,44418,0,1,0
12706,5,1,44422,44422,44423,0,1,4
12707,5,2,44427,44427,44429,0,2,4
12708,1,2,44428,44429,44431,1,3,0
12709,1,3,44429,44431,44434,2,5,0
12710,2,2,44431,44434,44436,3,5,0
12711,5,1,44436,44436,44437,0,1,0
12712,2,2,44438,44438,44440,0,2,1
12713,2,1,44440,44440,44441,0,1,0
12714,5,3,44445,44445,44448,0,3,4
12715,3,2,44448,44448,44450,0,2,0
12716,1,3,44449,44450,44453,1,4,0
12717,4,3,44453,44453,44456,0,3,0
12718,5,3,44458,44458,44461,0,3,2
12719,1,3,44459,44461,44464,2,5,0
12720,6,3,44465,44465,44468,0,3,1
12721,5,3,44470,44470,44473,0,3,2
12722,4,3,44474,44474,44477,0,3,1
12723,5,3,44479,44479,44482,0,3,2
12724,4,2,44483,44483,44485,0,2,1
12725,4,3,44487,44487,44490,0,3,2
12726,2,3,44489,44490,44493,1,4,0
12727,4,3,44493,44493,44496,0,3,0
12728,2,1,44495,44496,44497,1,2,0
12729,6,3,44501,44501,44504,0,3,4
12730,3,1,44504,44504,44505,0,1,0
12731,3,3,44507,44507,44510,0,3,2
12732,5,2,44512,44512,44514,0,2,2
12733,5,3,44517,44517,44520,0,3,3
12734,3,2,44520,44520,44522,0,2,0
12735,6,2,44526,44526,44528,0,2,4
12736,2,1,44528,44528,44529,0,1,0
12737,6,2,44534,44534,44536,0,2,5
12738,5,3,44539,44539,44542,0,3,3
12739,4,3,44543,44543,44546,0,3,1
12740,5,2,44548,44548,44550,0,2,2
12741,4,1,44552,44552,44553,0,1,2
12742,5,2,44557,44557,44559,0,2,4
12743,4,3,44561,44561,44564,0,3,2
12744,4,3,44565,44565,44568,0,3,1
12745,2,3,44567,44568,44571,1,4,0
12746,6,1,44573,44573,44574,0,1,2
12747,6,3,44579,44579,44582,0,3,5
12748,1,3,44580,44582,44585,2,5,0
12749,2,3,44582,44585,44588,3,6,0
12750,2,2,44584,44588,44590,4,6,0
12751,2,2,44586,44590,44592,4,6,0
12752,1,1,44587,44592,44593,5,6,0
12753,6,2,44593,44593,44595,0,2,0
12754,4,3,44597,44597,44600,0,3,2
12755,5,1,44602,44602,44603,0,1,2
12756,1,2,44603,44603,44605,0,2,0
12757,4,2,44607,44607,44609,0,2,2
12758,2,1,44609,44609,44610,0,1,0
12759,2,1,44611,44611,44612,0,1,1
12760,4,2,44615,44615,44617,0,2,3
12761,5,1,44620,44620,44621,0,1,3
12762,3,2,44623,44623,44625,0,2,2
12763,1,2,44624,44625,44627,1,3,0
12764,3,2,44627,44627,44629,0,2,0
12765,5,2,44632,44632,44634,0,2,3
12766,4,3,44636,44636,44639,0,3,2
12767,3,2,44639,44639,44641,0,2,0
12768,5,2,44644,44644,44646,0,2,3
12769,1,1,44645,44646,44647,1,2,0
12770,1,3,44646,44647,44650,1,4,0
12771,3,2,44649,44650,44652,1,3,0
12772,1,3,44650,44652,44655,2,5,0
12773,5,1,44655,44655,44656,0,1,0
12774,4,1,44659,44659,44660,0,1,3
12775,5,2,44664,44664,44666,0,2,4
12776,5,1,44669,44669,44670,0,1,3
12777,4,2,44673,44673,44675,0,2,3
12778,5,3,44678,44678,44681,0,3,3
12779,4,2,44682,44682,44684,0,2,1
12780,3,3,44685,44685,44688,0,3,1
12781,3,2,44688,44688,44690,0,2,0
12782,4,2,44692,44692,44694,0,2,2
12783,6,1,44698,44698,44699,0,1,4
12784,4,2,44702,44702,44704,0,2,3
12785,2,1,44704,44704,44705,0,1,0
12786,6,2,44710,44710,44712,0,2,5
12787,4,2,44714,44714,44716,0,2,2
12788,5,3,44719,44719,44722,0,3,3
12789,1,2,44720,44722,44724,2,4,0
12790,4,3,44724,44724,44727,0,3,0
12791,6,3,44730,44730,44733,0,3,3
12792,5,2,44735,44735,44737,0,2,2
12793,5,2,44740,44740,44742,0,2,3
12794,6,1,44746,44746,44747,0,1,4
12795,1,2,44747,44747,44749,0,2,0
12796,6,1,44753,44753,44754,0,1,4
12797,2,1,44755,44755,44756,0,1,1
12798,2,3,44757,44757,44760,0,3,1
12799,6,1,44763,44763,44764,0,1,3
12800,3,1,44766,44766,44767,0,1,2
12801,5,3,44771,44771,44774,0,3,4
12802,5,2,44776,44776,44778,0,2,2
12803,2,3,44778,44778,44781,0,3,0
12804,5,2,44783,44783,44785,0,2,2
12805,6,2,44789,44789,44791,0,2,4
12806,2,1,44791,44791,44792,0,1,0
12807,5,1,44796,44796,44797,0,1,4
12808,6,3,44802,44802,44805,0,3,5
12809,4,1,44806,44806,44807,0,1,1
12810,3,1,44809,44809,44810,0,1,2
12811,6,1,44815,44815,44816,0,1,5
12812,6,2,44821,44821,44823,0,2,5
12813,6,1,44827,44827,44828,0,1,4
12814,3,1,44830,44830,44831,0,1,2
12815,6,1,44836,44836,44837,0,1,5
12816,3,2,44839,44839,44841,0,2,2
12817,4,1,44843,44843,44844,0,1,2
12818,3,1,44846,44846,44847,0,1,2
12819,6,1,44852,44852,44853,0,1,5
12820,5,1,44857,44857,44858,0,1,4
12821,1,3,44858,44858,44861,0,3,0
12822,6,3,44864,44864,44867,0,3,3
12823,4,2,44868,44868,44870,0,2,1
12824,5,2,44873,44873,44875,0,2,3
12825,3,3,44876,44876,44879,0,3,1
12826,3,1,44879,44879,44880,0,1,0
12827,4,2,44883,44883,44885,0,2,3
12828,5,3,44888,44888,44891,0,3,3
12829,3,3,44891,44891,44894,0,3,0
12830,4,3,44895,44895,44898,0,3,1
12831,3,3,44898,44898,44901,0,3,0
12832,5,2,44903,44903,44905,0,2,2
12833,3,1,44906,44906,44907,0,1,1
12834,6,3,44912,44912,44915,0,3,5
12835,5,2,44917,44917,44919,0,2,2
12836,1,3,44918,44919,44922,1,4,0
12837,2,2,44920,44922,44924,2,4,0
12838,2,2,44922,44924,44926,2,4,0
12839,3,1,44925,44926,44927,1,2,0
12840,6,2,44931,44931,44933,0,2,4
12841,5,3,44936,44936,44939,0,3,3
12842,2,1,44938,44939,44940,1,2,0
12843,4,1,44942,44942,44943,0,1,2
12844,2,2,44944,44944,44946,0,2,1
12845,1,3,44945,44946,44949,1,4,0
12846,3,3,44948,44949,44952,1,4,0
12847,4,1,44952,44952,44953,0,1,0
12848,1,1,44953,44953,44954,0,1,0
12849,1,3,44954,44954,44957,0,3,0
12850,5,2,44959,44959,44961,0,2,2
12851,3,2,44962,44962,44964,0,2,1
12852,5,1,44967,44967,44968,0,1,3
12853,3,3,44970,44970,44973,0,3,2
12854,4,1,44974,44974,44975,0,1,1
12855,1,1,44975,44975,44976,0,1,0
12856,1,3,44976,44976,44979,0,3,0
12857,4,1,44980,44980,44981,0,1,1
12858,3,1,44983,44983,44984,0,1,2
12859,6,1,44989,44989,44990,0,1,5
12860,6,1,44995,44995,44996,0,1,5
12861,2,2,44997,44997,44999,0,2,1
12862,2,2,44999,44999,45001,0,2,0
12863,5,2,45004,45004,45006,0,2,3
12864,3,3,45007,45007,45010,0,3,1
12865,3,3,45010,45010,45013,0,3,0
12866,3,1,45013,45013,45014,0,1,0
12867,6,2,45019,45019,45021,0,2,5
12868,6,1,45025,45025,45026,0,1,4
12869,3,3,45028,45028,45031,0,3,2
12870,5,2,45033,45033,45035,0,2,2
12871,6,1,45039,45039,45040,0,1,4
12872,4,2,45043,45043,45045,0,2,3
12873,5,3,45048,45048,45051,0,3,3
12874,3,2,45051,45051,45053,0,2,0
12875,1,2,45052,45053,45055,1,3,0
12876,1,2,45053,45055,45057,2,4,0
12877,5,1,45058,45058,45059,0,1,1
12878,4,1,45062,45062,45063,0,1,3
12879,6,3,45068,45068,45071,0,3,5
12880,2,2,45070,45071,45073,1,3,0
12881,3,2,45073,45073,45075,0,2,0
12882,3,3,45076,45076,45079,0,3,1
12883,4,3,45080,45080,45083,0,3,1
12884,5,2,45085,45085,45087,0,2,2
12885,3,1,45088,45088,45089,0,1,1
12886,1,3,45089,45089,45092,0,3,0
12887,2,2,45091,45092,45094,1,3,0
12888,6,2,45097,45097,45099,0,2,3
12889,5,2,45102,45102,45104,0,2,3
12890,6,1,45108,45108,45109,0,1,4
12891,3,2,45111,45111,45113,0,2,2
12892,4,1,45115,45115,45116,0,1,2
12893,4,1,45119,45119,45120,0,1,3
12894,6,1,45125,45125,45126,0,1,5
12895,5,3,45130,45130,45133,0,3,4
12896,2,1,45132,45133,45134,1,2,0
12897,2,2,45134,45134,45136,0,2,0
12898,6,1,45140,45140,45141,0,1,4
12899,2,3,45142,45142,45145,0,3,1
12900,2,2,45144,45145,45147,1,3,0
12901,1,2,45145,45147,45149,2,4,0
12902,6,3,45151,45151,45154,0,3,2
12903,6,1,45157,45157,45158,0,1,3
12904,6,3,45163,45163,45166,0,3,5
12905,6,3,45169,45169,45172,0,3,3
12906,6,2,45175,45175,45177,0,2,3
12907,1,1,45176,45177,45178,1,2,0
12908,6,2,45182,45182,45184,0,2,4
12909,3,1,45185,45185,45186,0,1,1
12910,4,2,45189,45189,45191,0,2,3
12911,4,1,45193,45193,45194,0,1,2
12912,2,1,45195,45195,45196,0,1,1
12913,6,3,45201,45201,45204,0,3,5
12914,2,3,45203,45204,45207,1,4,0
12915,2,1,45205,45207,45208,2,3,0
12916,2,1,45207,45208,45209,1,2,0
12917,3,2,45210,45210,45212,0,2,1
12918,4,1,45214,45214,45215,0,1,2
12919,4,1,45218,45218,45219,0,1,3
12920,4,1,45222,45222,45223,0,1,3
12921,3,2,45225,45225,45227,0,2,2
12922,4,3,45229,45229,45232,0,3,2
12923,4,1,45233,45233,45234,0,1,1
12924,6,3,45239,45239,45242,0,3,5
12925,6,2,45245,45245,45247,0,2,3
12926,6,2,45251,45251,45253,0,2,4
12927,6,2,45257,45257,45259,0,2,4
12928,5,1,45262,45262,45263,0,1,3
12929,1,3,45263,45263,45266,0,3,0
12930,6,3,45269,45269,45272,0,3,3
12931,2,1,45271,45272,45273,1,2,0
12932,6,2,45277,45277,45279,0,2,4
12933,2,3,45279,45279,45282,0,3,0
12934,6,1,45285,45285,45286,0,1,3
12935,3,1,45288,45288,45289,0,1,2
12936,5,3,45293,45293,45296,0,3,4
12937,4,1,45297,45297,45298,0,1,1
12938,3,3,45300,45300,45303,0,3,2
12939,6,1,45306,45306,45307,0,1,3
12940,1,1,45307,45307,45308,0,1,0
12941,5,2,45312,45312,45314,0,2,4
12942,5,1,45317,45317,45318,0,1,3
12943,2,2,45319,45319,45321,0,2,1
12944,6,1,45325,45325,45326,0,1,4
12945,1,1,45326,45326,45327,0,1,0
12946,5,3,45331,45331,45334,0,3,4
12947,3,1,45334,45334,45335,0,1,0
12948,5,2,45339,45339,45341,0,2,4
12949,2,2,45341,45341,45343,0,2,0
12950,5,1,45346,45346,45347,0,1,3
12951,3,3,45349,45349,45352,0,3,2
12952,2,1,45351,45352,45353,1,2,0
12953,2,1,45353,45353,45354,0,1,0
12954,5,1,45358,45358,45359,0,1,4
12955,2,1,45360,45360,45361,0,1,1
12956,5,2,45365,45365,45367,0,2,4
12957,5,1,45370,45370,45371,0,1,3
12958,1,2,45371,45371,45373,0,2,0
12959,1,3,45372,45373,45376,1,4,0
12960,4,1,45376,45376,45377,0,1,0
12961,3,3,45379,45379,45382,0,3,2
12962,1,2,45380,45382,45384,2,4,0
12963,3,2,45383,45384,45386,1,3,0
12964,1,2,45384,45386,45388,2,4,0
12965,6,2,45390,45390,45392,0,2,2
12966,3,3,45393,45393,45396,0,3,1
12967,1,3,45394,45396,45399,2,5,0
12968,5,1,45399,45399,45400,0,1,0
12969,2,1,45401,45401,45402,0,1,1
12970,6,3,45407,45407,45410,0,3,5
12971,2,1,45409,45410,45411,1,2,0
12972,6,1,45415,45415,45416,0,1,4
12973,2,3,45417,45417,45420,0,3,1
12974,6,1,45423,45423,45424,0,1,3
12975,5,2,45428,45428,45430,0,2,4
12976,6,2,45434,45434,45436,0,2,4
12977,5,3,45439,45439,45442,0,3,3
12978,6,3,45445,45445,45448,0,3,3
12979,3,2,45448,45448,45450,0,2,0
12980,6,2,45454,45454,45456,0,2,4
12981,5,1,45459,45459,45460,0,1,3
12982,5,1,45464,45464,45465,0,1,4
12983,2,2,45466,45466,45468,0,2,1
12984,1,2,45467,45468,45470,1,3,0
12985,4,3,45471,45471,45474,0,3,1
12986,6,3,45477,45477,45480,0,3,3
12987,6,3,45483,45483,45486,0,3,3
12988,4,3,45487,45487,45490,0,3,1
12989,4,3,45491,45491,45494,0,3,1
12990,2,1,45493,45494,45495,1,2,0
12991,4,1,45497,45497,45498,0,1,2
12992,5,3,45502,45502,45505,0,3,4
12993,4,2,45506,45506,45508,0,2,1
12994,4,3,45510,45510,45513,0,3,2
12995,6,1,45516,45516,45517,0,1,3
12996,2,3,45518,45518,45521,0,3,1
12997,2,3,45520,45521,45524,1,4,0
12998,5,3,45525,45525,45528,0,3,1
12999,4,1,45529,45529,45530,0,1,1
13000,4,1,45533,45533,45534,0,1,3
13001,2,3,45535,45535,45538,0,3,1
13002,4,1,45539,45539,45540,0,1,1
13003,2,2,45541,45541,45543,0,2,1
13004,4,3,45545,45545,45548,0,3,2
13005,4,1,45549,45549,45550,0,1,1
13006,1,1,45550,45550,45551,0,1,0
13007,5,2,45555,45555,45557,0,2,4
13008,6,3,45561,45561,45564,0,3,4
13009,5,3,45566,45566,45569,0,3,2
13010,2,3,45568,45569,45572,1,4,0
13011,4,1,45572,45572,45573,0,1,0
13012,6,3,45578,45578,45581,0,3,5
13013,3,1,45581,45581,45582,0,1,0
13014,4,2,45585,45585,45587,0,2,3
13015,4,1,45589,45589,45590,0,1,2
13016,6,3,45595,45595,45598,0,3,5
13017,1,3,45596,45598,45601,2,5,0
13018,1,2,45597,45601,45603,4,6,0
13019,6,3,45603,45603,45606,0,3,0
13020,1,3,45604,45606,45609,2,5,0
13021,5,1,45609,45609,45610,0,1,0
13022,4,3,45613,45613,45616,0,3,3
13023,6,2,45619,45619,45621,0,2,3
13024,4,2,45623,45623,45625,0,2,2
13025,6,2,45629,45629,45631,0,2,4
13026,6,1,45635,45635,45636,0,1,4
13027,5,3,45640,45640,45643,0,3,4
13028,3,3,45643,45643,45646,0,3,0
13029,2,3,45645,45646,45649,1,4,0
13030,2,3,45647,45649,45652,2,5,0
13031,4,3,45651,45652,45655,1,4,0
13032,5,2,45656,45656,45658,0,2,1
13033,2,1,45658,45658,45659,0,1,0
13034,5,3,45663,45663,45666,0,3,4
13035,4,2,45667,45667,45669,0,2,1
13036,5,2,45672,45672,45674,0,2,3
13037,3,2,45675,45675,45677,0,2,1
13038,2,3,45677,45677,45680,0,3,0
13039,5,1,45682,45682,45683,0,1,2
13040,2,3,45684,45684,45687,0,3,1
13041,4,2,45688,45688,45690,0,2,1
13042,2,3,45690,45690,45693,0,3,0
13043,1,2,45691,45693,45695,2,4,0
13044,1,3,45692,45695,45698,3,6,0
13045,4,1,45696,45698,45699,2,3,0
13046,6,1,45702,45702,45703,0,1,3
13047,3,1,45705,45705,45706,0,1,2
13048,6,2,45711,45711,45713,0,2,5
13049,2,1,45713,45713,45714,0,1,0
13050,1,1,45714,45714,45715,0,1,0
13051,4,3,45718,45718,45721,0,3,3
13052,6,2,45724,45724,45726,0,2,3
13053,3,3,45727,45727,45730,0,3,1
13054,3,1,45730,45730,45731,0,1,0
13055,4,1,45734,45734,45735,0,1,3
13056,5,2,45739,45739,45741,0,2,4
13057,4,3,45743,45743,45746,0,3,2
13058,2,3,45745,45746,45749,1,4,0
13059,2,2,45747,45749,45751,2,4,0
13060,5,1,45752,45752,45753,0,1,1
13061,4,3,45756,45756,45759,0,3,3
13062,1,3,45757,45759,45762,2,5,0
13063,4,3,45761,45762,45765,1,4,0
13064,4,1,45765,45765,45766,0,1,0
13065,1,3,45766,45766,45769,0,3,0
13066,1,3,45767,45769,45772,2,5,0
13067,4,1,45771,45772,45773,1,2,0
13068,3,1,45774,45774,45775,0,1,1
13069,1,3,45775,45775,45778,0,3,0
13070,2,3,45777,45778,45781,1,4,0
13071,3,1,45780,45781,45782,1,2,0
13072,5,2,45785,45785,45787,0,2,3
13073,6,1,45791,45791,45792,0,1,4
13074,1,2,45792,45792,45794,0,2,0
13075,5,1,45797,45797,45798,0,1,3
13076,1,2,45798,45798,45800,0,2,0
13077,4,2,45802,45802,45804,0,2,2
13078,6,3,45808,45808,45811,0,3,4
13079,4,3,45812,45812,45815,0,3,1
13080,4,3,45816,45816,45819,0,3,1
13081,3,3,45819,45819,45822,0,3,0
13082,1,2,45820,45822,45824,2,4,0
13083,3,1,45823,45824,45825,1,2,0
13084,4,3,45827,45827,45830,0,3,2
13085,3,3,45830,45830,45833,0,3,0
13086,6,2,45836,45836,45838,0,2,3
13087,4,1,45840,45840,45841,0,1,2
13088,4,1,45844,45844,45845,0,1,3
13089,3,1,45847,45847,45848,0,1,2
13090,2,3,45849,45849,45852,0,3,1
13091,6,3,45855,45855,45858,0,3,3
13092,4,2,45859,45859,45861,0,2,1
13093,1,1,45860,45861,45862,1,2,0
13094,6,3,45866,45866,45869,0,3,4
13095,3,1,45869,45869,45870,0,1,0
13096,2,3,45871,45871,45874,0,3,1
13097,3,1,45874,45874,45875,0,1,0
13098,2,3,45876,45876,45879,0,3,1
13099,3,2,45879,45879,45881,0,2,0
13100,4,1,45883,45883,45884,0,1,2
13101,6,1,45889,45889,45890,0,1,5
13102,6,1,45895,45895,45896,0,1,5
13103,2,2,45897,45897,45899,0,2,1
13104,1,1,45898,45899,45900,1,2,0
13105,3,2,45901,45901,45903,0,2,1
13106,2,2,45903,45903,45905,0,2,0
13107,4,2,45907,45907,45909,0,2,2
13108,4,2,45911,45911,45913,0,2,2
13109,2,1,45913,45913,45914,0,1,0
13110,6,2,45919,45919,45921,0,2,5
13111,6,2,45925,45925,45927,0,2,4
13112,1,1,45926,45927,45928,1,2,0
13113,1,3,45927,45928,45931,1,4,0
13114,5,3,45932,45932,45935,0,3,1
13115,2,3,45934,45935,45938,1,4,0
13116,1,2,45935,45938,45940,3,5,0
13117,3,1,45938,45940,45941,2,3,0
13118,4,3,45942,45942,45945,0,3,1
13119,4,2,45946,45946,45948,0,2,1
13120,2,3,45948,45948,45951,0,3,0
13121,3,1,45951,45951,45952,0,1,0
13122,4,1,45955,45955,45956,0,1,3
13123,3,1,45958,45958,45959,0,1,2
13124,4,2,45962,45962,45964,0,2,3
13125,5,2,45967,45967,45969,0,2,3
13126,3,2,45970,45970,45972,0,2,1
13127,1,2,45971,45972,45974,1,3,0
13128,4,2,45975,45975,45977,0,2,1
13129,5,1,45980,45980,45981,0,1,3
13130,3,3,45983,45983,45986,0,3,2
13131,5,3,45988,45988,45991,0,3,2
13132,5,3,45993,45993,45996,0,3,2
13133,3,3,45996,45996,45999,0,3,0
13134,4,2,46000,46000,46002,0,2,1
13135,1,1,46001,46002,46003,1,2,0
13136,5,1,46006,46006,46007,0,1,3
13137,5,2,46011,46011,46013,0,2,4
13138,4,1,46015,46015,46016,0,1,2
13139,6,2,46021,46021,46023,0,2,5
13140,3,3,46024,46024,46027,0,3,1
13141,3,3,46027,46027,46030,0,3,0
13142,2,2,46029,46030,46032,1,3,0
13143,4,2,46033,46033,46035,0,2,1
13144,2,1,46035,46035,46036,0,1,0
13145,6,3,46041,46041,46044,0,3,5
13146,6,2,46047,46047,46049,0,2,3
13147,6,1,46053,46053,46054,0,1,4
13148,6,1,46059,46059,46060,0,1,5
13149,2,2,46061,46061,46063,0,2,1
13150,3,1,46064,46064,46065,0,1,1
13151,3,2,46067,46067,46069,0,2,2
13152,2,3,46069,46069,46072,0,3,0
13153,3,2,46072,46072,46074,0,2,0
13154,5,3,46077,46077,46080,0,3,3
13155,4,2,46081,46081,46083,0,2,1
13156,3,1,46084,46084,46085,0,1,1
13157,1,3,46085,46085,46088,0,3,0
13158,2,1,46087,46088,46089,1,2,0
13159,6,2,46093,46093,46095,0,2,4
13160,3,1,46096,46096,46097,0,1,1
13161,4,2,46100,46100,46102,0,2,3
13162,6,2,46106,46106,46108,0,2,4
13163,6,2,46112,46112,46114,0,2,4
13164,5,2,46117,46117,46119,0,2,3
13165,1,2,46118,46119,46121,1,3,0
13166,1,3,46119,46121,46124,2,5,0
13167,2,1,46121,46124,46125,3,4,0
13168,1,3,46122,46125,46128,3,6,0
13169,3,1,46125,46128,46129,3,4,0
13170,3,2,46128,46129,46131,1,3,0
13171,2,2,46130,46131,46133,1,3,0
13172,6,2,46136,46136,46138,0,2,3
13173,5,2,46141,46141,46143,0,2,3
13174,3,1,46144,46144,46145,0,1,1
13175,6,2,46150,46150,46152,0,2,5
13176,1,2,46151,46152,46154,1,3,0
13177,5,3,46156,46156,46159,0,3,2
13178,3,2,46159,46159,46161,0,2,0
13179,2,3,46161,46161,46164,0,3,0
13180,6,3,46167,46167,46170,0,3,3
13181,6,2,46173,46173,46175,0,2,3
13182,2,1,46175,46175,46176,0,1,0
13183,1,3,46176,46176,46179,0,3,0
13184,1,1,46177,46179,46180,2,3,0
13185,3,3,46180,46180,46183,0,3,0
13186,6,2,46186,46186,46188,0,2,3
13187,3,2,46189,46189,46191,0,2,1
13188,3,2,46192,46192,46194,0,2,1
13189,1,2,46193,46194,46196,1,3,0
13190,3,1,46196,46196,46197,0,1,0
13191,6,1,46202,46202,46203,0,1,5
13192,4,3,46206,46206,46209,0,3,3
13193,6,3,46212,46212,46215,0,3,3
13194,1,3,46213,46215,46218,2,5,0
13195,4,2,46217,46218,46220,1,3,0
13196,3,1,46220,46220,46221,0,1,0
13197,1,1,46221,46221,46222,0,1,0
13198,2,3,46223,46223,46226,0,3,1
13199,3,1,46226,46226,46227,0,1,0
13200,1,3,46227,46227,46230,0,3,0
13201,4,2,46231,46231,46233,0,2,1
13202,3,3,46234,46234,46237,0,3,1
13203,1,3,46235,46237,46240,2,5,0
13204,5,1,46240,46240,46241,0,1,0
13205,3,2,46243,46243,46245,0,2,2
13206,2,2,46245,46245,46247,0,2,0
13207,5,2,46250,46250,46252,0,2,3
13208,6,1,46256,46256,46257,0,1,4
13209,5,1,46261,46261,46262,0,1,4
13210,4,2,46265,46265,46267,0,2,3
13211,4,3,46269,46269,46272,0,3,2
13212,3,2,46272,46272,46274,0,2,0
13213,6,3,46278,46278,46281,0,3,4
13214,2,3,46280,46281,46284,1,4,0
13215,5,2,46285,46285,46287,0,2,1
13216,4,3,46289,46289,46292,0,3,2
13217,1,1,46290,46292,46293,2,3,0
13218,5,3,46295,46295,46298,0,3,2
13219,3,1,46298,46298,46299,0,1,0
13220,3,3,46301,46301,46304,0,3,2
13221,1,2,46302,46304,46306,2,4,0
13222,3,3,46305,46306,46309,1,4,0
13223,3,1,46308,46309,46310,1,2,0
13224,3,1,46311,46311,46312,0,1,1
13225,6,3,46317,46317,46320,0,3,5
13226,5,3,46322,46322,46325,0,3,2
13227,5,1,46327,46327,46328,0,1,2
13228,6,2,46333,46333,46335,0,2,5
13229,5,1,46338,46338,46339,0,1,3
13230,4,3,46342,46342,46345,0,3,3
13231,5,2,46347,46347,46349,0,2,2
13232,5,1,46352,46352,46353,0,1,3
13233,4,2,46356,46356,46358,0,2,3
13234,3,1,46359,46359,46360,0,1,1
13235,3,2,46362,46362,46364,0,2,2
13236,3,3,46365,46365,46368,0,3,1
13237,5,1,46370,46370,46371,0,1,2
13238,4,1,46374,46374,46375,0,1,3
13239,6,1,46380,46380,46381,0,1,5
13240,6,2,46386,46386,46388,0,2,5
13241,1,1,46387,46388,46389,1,2,0
13242,2,2,46389,46389,46391,0,2,0
13243,1,2,46390,46391,46393,1,3,0
13244,6,1,46396,46396,46397,0,1,3
13245,2,1,46398,46398,46399,0,1,1
13246,1,1,46399,46399,46400,0,1,0
13247,5,3,46404,46404,46407,0,3,4
13248,2,1,46406,46407,46408,1,2,0
13249,1,2,46407,46408,46410,1,3,0
13250,4,2,46411,46411,46413,0,2,1
13251,6,3,46417,46417,46420,0,3,4
13252,6,1,46423,46423,46424,0,1,3
13253,6,2,46429,46429,46431,0,2,5
13254,3,2,46432,46432,46434,0,2,1
13255,5,1,46437,46437,46438,0,1,3
13256,2,1,46439,46439,46440,0,1,1
13257,5,1,46444,46444,46445,0,1,4
13258,5,1,46449,46449,46450,0,1,4
13259,1,1,46450,46450,46451,0,1,0
13260,5,1,46455,46455,46456,0,1,4
13261,2,2,46457,46457,46459,0,2,1
13262,4,3,46461,46461,46464,0,3,2
13263,4,3,46465,46465,46468,0,3,1
13264,5,1,46470,46470,46471,0,1,2
13265,3,3,46473,46473,46476,0,3,2
13266,1,3,46474,46476,46479,2,5,0
13267,3,2,46477,46479,46481,2,4,0
13268,3,3,46480,46481,46484,1,4,0
13269,4,2,46484,46484,46486,0,2,0
13270,1,1,46485,46486,46487,1,2,0
13271,2,2,46487,46487,46489,0,2,0
13272,4,3,46491,46491,46494,0,3,2
13273,2,2,46493,46494,46496,1,3,0
13274,1,3,46494,46496,46499,2,5,0
13275,4,1,46498,46499,46500,1,2,0
13276,2,2,46500,46500,46502,0,2,0
13277,4,3,46504,46504,46507,0,3,2
13278,4,2,46508,46508,46510,0,2,1
13279,2,3,46510,46510,46513,0,3,0
13280,1,1,46511,46513,46514,2,3,0
13281,3,3,46514,46514,46517,0,3,0
13282,6,3,46520,46520,46523,0,3,3
13283,3,3,46523,46523,46526,0,3,0
13284,2,2,46525,46526,46528,1,3,0
13285,4,1,46529,46529,46530,0,1,1
13286,2,1,46531,46531,46532,0,1,1
13287,5,3,46536,46536,46539,0,3,4
13288,5,3,46541,46541,46544,0,3,2
13289,1,3,46542,46544,46547,2,5,0
13290,4,3,46546,46547,46550,1,4,0
13291,6,3,46552,46552,46555,0,3,2
13292,4,1,46556,46556,46557,0,1,1
13293,1,2,46557,46557,46559,0,2,0
13294,4,3,46561,46561,46564,0,3,2
13295,4,3,46565,46565,46568,0,3,1
13296,5,2,46570,46570,46572,0,2,2
13297,1,2,46571,46572,46574,1,3,0
13298,2,1,46573,46574,46575,1,2,0
13299,5,3,46578,46578,46581,0,3,3
13300,3,3,46581,46581,46584,0,3,0
13301,6,1,46587,46587,46588,0,1,3
13302,3,3,46590,46590,46593,0,3,2
13303,3,3,46593,46593,46596,0,3,0
13304,1,3,46594,46596,46599,2,5,0
13305,6,1,46600,46600,46601,0,1,1
13306,2,1,46602,46602,46603,0,1,1
13307,3,1,46605,46605,46606,0,1,2
13308,1,1,46606,46606,46607,0,1,0
13309,1,2,46607,46607,46609,0,2,0
13310,5,3,46612,46612,46615,0,3,3
13311,4,2,46616,46616,46618,0,2,1
13312,1,1,46617,46618,46619,1,2,0
13313,1,1,46618,46619,46620,1,2,0
13314,1,2,46619,46620,46622,1,3,0
13315,6,1,46625,46625,46626,0,1,3
13316,4,2,46629,46629,46631,0,2,3
13317,6,1,46635,46635,46636,0,1,4
13318,5,2,46640,46640,46642,0,2,4
13319,1,1,46641,46642,46643,1,2,0
13320,6,2,46647,46647,46649,0,2,4
13321,2,3,46649,46649,46652,0,3,0
13322,1,1,46650,46652,46653,2,3,0
13323,3,2,46653,46653,46655,0,2,0
13324,5,1,46658,46658,46659,0,1,3
13325,5,2,46663,46663,46665,0,2,4
13326,5,2,46668,46668,46670,0,2,3
13327,2,1,46670,46670,46671,0,1,0
13328,4,2,46674,46674,46676,0,2,3
13329,1,3,46675,46676,46679,1,4,0
13330,2,2,46677,46679,46681,2,4,0
13331,6,3,46683,46683,46686,0,3,2
13332,5,3,46688,46688,46691,0,3,2
13333,1,2,46689,46691,46693,2,4,0
13334,5,3,46694,46694,46697,0,3,1
13335,4,1,46698,46698,46699,0,1,1
13336,3,3,46701,46701,46704,0,3,2
13337,5,3,46706,46706,46709,0,3,2
13338,5,1,46711,46711,46712,0,1,2
13339,3,1,46714,46714,46715,0,1,2
13340,4,2,46718,46718,46720,0,2,3
13341,2,1,46720,46720,46721,0,1,0
13342,2,1,46722,46722,46723,0,1,1
13343,2,3,46724,46724,46727,0,3,1
13344,4,3,46728,46728,46731,0,3,1
13345,4,3,46732,46732,46735,0,3,1
13346,5,1,46737,46737,46738,0,1,2
13347,5,2,46742,46742,46744,0,2,4
13348,4,3,46746,46746,46749,0,3,2
13349,5,3,46751,46751,46754,0,3,2
13350,3,3,46754,46754,46757,0,3,0
13351,2,3,46756,46757,46760,1,4,0
13352,2,1,46758,46760,46761,2,3,0
13353,5,2,46763,46763,46765,0,2,2
13354,1,2,46764,46765,46767,1,3,0
13355,3,3,46767,46767,46770,0,3,0
13356,4,3,46771,46771,46774,0,3,1
13357,2,1,46773,46774,46775,1,2,0
13358,1,3,46774,46775,46778,1,4,0
13359,1,2,46775,46778,46780,3,5,0
13360,6,3,46781,46781,46784,0,3,1
13361,2,2,46783,46784,46786,1,3,0
13362,6,2,46789,46789,46791,0,2,3
13363,2,3,46791,46791,46794,0,3,0
13364,1,1,46792,46794,46795,2,3,0
13365,4,3,46796,46796,46799,0,3,1
13366,6,1,46802,46802,46803,0,1,3
13367,2,1,46804,46804,46805,0,1,1
13368,6,3,46810,46810,46813,0,3,5
13369,4,1,46814,46814,46815,0,1,1
13370,4,1,46818,46818,46819,0,1,3
13371,6,2,46824,46824,46826,0,2,5
13372,3,2,46827,46827,46829,0,2,1
13373,5,3,46832,46832,46835,0,3,3
13374,2,2,46834,46835,46837,1,3,0
13375,1,1,46835,46837,46838,2,3,0
13376,1,2,46836,46838,46840,2,4,0
13377,6,2,46842,46842,46844,0,2,2
13378,1,3,46843,46844,46847,1,4,0
13379,3,1,46846,46847,46848,1,2,0
13380,4,2,46850,46850,46852,0,2,2
13381,2,2,46852,46852,46854,0,2,0
13382,3,1,46855,46855,46856,0,1,1
13383,4,1,46859,46859,46860,0,1,3
13384,4,1,46863,46863,46864,0,1,3
13385,2,3,46865,46865,46868,0,3,1
13386,5,1,46870,46870,46871,0,1,2
13387,4,3,46874,46874,46877,0,3,3
13388,3,1,46877,46877,46878,0,1,0
13389,3,3,46880,46880,46883,0,3,2
13390,2,2,46882,46883,46885,1,3,0
13391,3,3,46885,46885,46888,0,3,0
13392,1,3,46886,46888,46891,2,5,0
13393,6,2,46892,46892,46894,0,2,1
13394,5,2,46897,46897,46899,0,2,3
13395,5,3,46902,46902,46905,0,3,3
13396,6,2,46908,46908,46910,0,2,3
13397,5,2,46913,46913,46915,0,2,3
13398,6,3,46919,46919,46922,0,3,4
13399,6,3,46925,46925,46928,0,3,3
13400,1,3,46926,46928,46931,2,5,0
13401,2,3,46928,46931,46934,3,6,0
13402,4,2,46932,46934,46936,2,4,0
13403,6,2,46938,46938,46940,0,2,2
13404,5,2,46943,46943,46945,0,2,3
13405,1,3,46944,46945,46948,1,4,0
13406,3,3,46947,46948,46951,1,4,0
13407,6,3,46953,46953,46956,0,3,2
13408,1,1,46954,46956,46957,2,3,0
13409,2,3,46956,46957,46960,1,4,0
13410,5,2,46961,46961,46963,0,2,1
13411,1,1,46962,46963,46964,1,2,0
13412,5,1,46967,46967,46968,0,1,3
13413,3,2,46970,46970,46972,0,2,2
13414,3,1,46973,46973,46974,0,1,1
13415,6,2,46979,46979,46981,0,2,5
13416,1,1,46980,46981,46982,1,2,0
13417,3,1,46983,46983,46984,0,1,1
13418,1,2,46984,46984,46986,0,2,0
13419,6,1,46990,46990,46991,0,1,4
13420,4,3,46994,46994,46997,0,3,3
13421,2,1,46996,46997,46998,1,2,0
13422,6,2,47002,47002,47004,0,2,4
13423,3,3,47005,47005,47008,0,3,1
13424,6,3,47011,47011,47014,0,3,3
13425,3,3,47014,47014,47017,0,3,0
13426,2,3,47016,47017,47020,1,4,0
13427,6,2,47022,47022,47024,0,2,2
13428,4,2,47026,47026,47028,0,2,2
13429,6,3,47032,47032,47035,0,3,4
13430,1,3,47033,47035,47038,2,5,0
13431,5,1,47038,47038,47039,0,1,0
13432,3,2,47041,47041,47043,0,2,2
13433,2,3,47043,47043,47046,0,3,0
13434,6,2,47049,47049,47051,0,2,3
13435,6,3,47055,47055,47058,0,3,4
13436,3,3,47058,47058,47061,0,3,0
13437,6,1,47064,47064,47065,0,1,3
13438,4,1,47068,47068,47069,0,1,3
13439,3,3,47071,47071,47074,0,3,2
13440,5,3,47076,47076,47079,0,3,2
13441,5,1,47081,47081,47082,0,1,2
13442,4,1,47085,47085,47086,0,1,3
13443,5,2,47090,47090,47092,0,2,4
13444,5,3,47095,47095,47098,0,3,3
13445,1,3,47096,47098,47101,2,5,0
13446,6,3,47102,47102,47105,0,3,1
13447,6,3,47108,47108,47111,0,3,3
13448,4,3,47112,47112,47115,0,3,1
13449,2,1,47114,47115,47116,1,2,0
13450,5,1,47119,47119,47120,0,1,3
13451,3,3,47122,47122,47125,0,3,2
13452,2,1,47124,47125,47126,1,2,0
13453,5,1,47129,47129,47130,0,1,3
13454,1,2,47130,47130,47132,0,2,0
13455,2,3,47132,47132,47135,0,3,0
13456,2,1,47134,47135,47136,1,2,0
13457,3,3,47137,47137,47140,0,3,1
13458,6,1,47143,47143,47144,0,1,3
13459,2,2,47145,47145,47147,0,2,1
13460,6,2,47151,47151,47153,0,2,4
13461,5,3,47156,47156,47159,0,3,3
13462,5,1,47161,47161,47162,0,1,2
13463,6,2,47167,47167,47169,0,2,5
13464,6,1,47173,47173,47174,0,1,4
13465,5,2,47178,47178,47180,0,2,4
13466,3,2,47181,47181,47183,0,2,1
13467,5,2,47186,47186,47188,0,2,3
13468,1,2,47187,47188,47190,1,3,0
13469,6,3,47193,47193,47196,0,3,3
13470,1,2,47194,47196,47198,2,4,0
13471,1,3,47195,47198,47201,3,6,0
13472,1,2,47196,47201,47203,5,7,0
13473,1,1,47197,47203,47204,6,7,0
13474,1,3,47198,47204,47207,6,9,0
13475,4,1,47202,47207,47208,5,6,0
13476,6,1,47208,47208,47209,0,1,0
13477,1,2,47209,47209,47211,0,2,0
13478,3,2,47212,47212,47214,0,2,1
13479,5,1,47217,47217,47218,0,1,3
13480,3,1,47220,47220,47221,0,1,2
13481,3,2,47223,47223,47225,0,2,2
13482,6,2,47229,47229,47231,0,2,4
13483,2,1,47231,47231,47232,0,1,0
13484,1,1,47232,47232,47233,0,1,0
13485,3,1,47235,47235,47236,0,1,2
13486,5,1,47240,47240,47241,0,1,4
13487,1,2,47241,47241,47243,0,2,0
13488,5,1,47246,47246,47247,0,1,3
13489,2,3,47248,47248,47251,0,3,1
13490,6,1,47254,47254,47255,0,1,3
13491,1,2,47255,47255,47257,0,2,0
13492,4,1,47259,47259,47260,0,1,2
13493,3,2,47262,47262,47264,0,2,2
13494,5,3,47267,47267,47270,0,3,3
13495,5,3,47272,47272,47275,0,3,2
13496,2,1,47274,47275,47276,1,2,0
13497,5,2,47279,47279,47281,0,2,3
13498,3,1,47282,47282,47283,0,1,1
13499,3,1,47285,47285,47286,0,1,2
13500,3,3,47288,47288,47291,0,3,2
13501,2,3,47290,47291,47294,1,4,0
13502,5,3,47295,47295,47298,0,3,1
13503,5,3,47300,47300,47303,0,3,2
13504,5,1,47305,47305,47306,0,1,2
13505,1,3,47306,47306,47309,0,3,0
13506,4,1,47310,47310,47311,0,1,1
13507,1,3,47311,47311,47314,0,3,0
13508,6,2,47317,47317,47319,0,2,3
13509,4,2,47321,47321,47323,0,2,2
13510,5,3,47326,47326,47329,0,3,3
13511,4,3,47330,47330,47333,0,3,1
13512,6,1,47336,47336,47337,0,1,3
13513,6,3,47342,47342,47345,0,3,5
13514,2,2,47344,47345,47347,1,3,0
13515,5,2,47349,47349,47351,0,2,2
13516,6,1,47355,47355,47356,0,1,4
13517,5,1,47360,47360,47361,0,1,4
13518,1,1,47361,47361,47362,0,1,0
13519,5,2,47366,47366,47368,0,2,4
13520,2,1,47368,47368,47369,0,1,0
13521,2,2,47370,47370,47372,0,2,1
13522,1,3,47371,47372,47375,1,4,0
13523,5,1,47376,47376,47377,0,1,1
13524,6,3,47382,47382,47385,0,3,5
13525,1,3,47383,47385,47388,2,5,0
13526,6,1,47389,47389,47390,0,1,1
13527,4,3,47393,47393,47396,0,3,3
13528,4,2,47397,47397,47399,0,2,1
13529,6,1,47403,47403,47404,0,1,4
13530,2,2,47405,47405,47407,0,2,1
13531,5,2,47410,47410,47412,0,2,3
13532,4,1,47414,47414,47415,0,1,2
13533,1,3,47415,47415,47418,0,3,0
13534,4,2,47419,47419,47421,0,2,1
13535,1,1,47420,47421,47422,1,2,0
13536,1,2,47421,47422,47424,1,3,0
13537,1,3,47422,47424,47427,2,5,0
13538,6,1,47428,47428,47429,0,1,1
13539,1,1,47429,47429,47430,0,1,0
13540,1,2,47430,47430,47432,0,2,0
13541,5,2,47435,47435,47437,0,2,3
13542,2,1,47437,47437,47438,0,1,0
13543,1,1,47438,47438,47439,0,1,0
13544,4,3,47442,47442,47445,0,3,3
13545,5,2,47447,47447,47449,0,2,2
13546,6,2,47453,47453,47455,0,2,4
13547,3,1,47456,47456,47457,0,1,1
13548,5,3,47461,47461,47464,0,3,4
13549,1,2,47462,47464,47466,2,4,0
13550,2,3,47464,47466,47469,2,5,0
13551,3,1,47467,47469,47470,2,3,0
13552,4,1,47471,47471,47472,0,1,1
13553,1,2,47472,47472,47474,0,2,0
13554,6,2,47478,47478,47480,0,2,4
13555,3,1,47481,47481,47482,0,1,1
13556,6,3,47487,47487,47490,0,3,5
13557,2,2,47489,47490,47492,1,3,0
13558,2,3,47491,47492,47495,1,4,0
13559,2,2,47493,47495,47497,2,4,0
13560,5,1,47498,47498,47499,0,1,1
13561,6,3,47504,47504,47507,0,3,5
13562,5,3,47509,47509,47512,0,3,2
13563,4,2,47513,47513,47515,0,2,1
13564,3,1,47516,47516,47517,0,1,1
13565,2,1,47518,47518,47519,0,1,1
13566,1,2,47519,47519,47521,0,2,0
13567,3,2,47522,47522,47524,0,2,1
13568,3,2,47525,47525,47527,0,2,1
13569,6,2,47531,47531,47533,0,2,4
13570,6,3,47537,47537,47540,0,3,4
13571,4,2,47541,47541,47543,0,2,1
13572,6,1,47547,47547,47548,0,1,4
13573,4,3,47551,47551,47554,0,3,3
13574,2,2,47553,47554,47556,1,3,0
13575,2,1,47555,47556,47557,1,2,0
13576,5,2,47560,47560,47562,0,2,3
13577,3,2,47563,47563,47565,0,2,1
13578,6,3,47569,47569,47572,0,3,4
13579,3,3,47572,47572,47575,0,3,0
13580,3,1,47575,47575,47576,0,1,0
13581,6,1,47581,47581,47582,0,1,5
13582,6,3,47587,47587,47590,0,3,5
13583,4,3,47591,47591,47594,0,3,1
13584,6,2,47597,47597,47599,0,2,3
13585,5,1,47602,47602,47603,0,1,3
13586,4,2,47606,47606,47608,0,2,3
13587,5,3,47611,47611,47614,0,3,3
13588,6,1,47617,47617,47618,0,1,3
13589,6,3,47623,47623,47626,0,3,5
13590,2,1,47625,47626,47627,1,2,0
13591,4,1,47629,47629,47630,0,1,2
13592,4,2,47633,47633,47635,0,2,3
13593,4,1,47637,47637,47638,0,1,2
13594,4,2,47641,47641,47643,0,2,3
13595,2,1,47643,47643,47644,0,1,0
13596,1,2,47644,47644,47646,0,2,0
13597,2,1,47646,47646,47647,0,1,0
13598,5,1,47651,47651,47652,0,1,4
13599,6,1,47657,47657,47658,0,1,5
13600,3,2,47660,47660,47662,0,2,2
13601,2,2,47662,47662,47664,0,2,0
13602,4,3,47666,47666,47669,0,3,2
13603,5,2,47671,47671,47673,0,2,2
13604,1,3,47672,47673,47676,1,4,0
13605,6,3,47678,47678,47681,0,3,2
13606,6,3,47684,47684,47687,0,3,3
13607,4,3,47688,47688,47691,0,3,1
13608,6,2,47694,47694,47696,0,2,3
13609,1,3,47695,47696,47699,1,4,0
13610,1,1,47696,47699,47700,3,4,0
13611,1,2,47697,47700,47702,3,5,0
13612,1,1,47698,47702,47703,4,5,0
13613,5,1,47703,47703,47704,0,1,0
13614,1,2,47704,47704,47706,0,2,0
13615,1,2,47705,47706,47708,1,3,0
13616,4,1,47709,47709,47710,0,1,1
13617,6,1,47715,47715,47716,0,1,5
13618,6,1,47721,47721,47722,0,1,5
13619,2,1,47723,47723,47724,0,1,1
13620,4,1,47727,47727,47728,0,1,3
13621,2,3,47729,47729,47732,0,3,1
13622,1,1,47730,47732,47733,2,3,0
13623,3,1,47733,47733,47734,0,1,0
13624,2,1,47735,47735,47736,0,1,1
13625,4,1,47739,47739,47740,0,1,3
13626,1,2,47740,47740,47742,0,2,0
13627,2,3,47742,47742,47745,0,3,0
13628,4,1,47746,47746,47747,0,1,1
13629,4,1,47750,47750,47751,0,1,3
13630,4,2,47754,47754,47756,0,2,3
13631,1,2,47755,47756,47758,1,3,0
13632,1,3,47756,47758,47761,2,5,0
13633,2,1,47758,47761,47762,3,4,0
13634,3,2,47761,47762,47764,1,3,0
13635,1,3,47762,47764,47767,2,5,0
13636,4,3,47766,47767,47770,1,4,0
13637,6,3,47772,47772,47775,0,3,2
13638,1,2,47773,47775,47777,2,4,0
13639,1,1,47774,47777,47778,3,4,0
13640,2,1,47776,47778,47779,2,3,0
13641,3,3,47779,47779,47782,0,3,0
13642,3,1,47782,47782,47783,0,1,0
13643,5,3,47787,47787,47790,0,3,4
13644,6,3,47793,47793,47796,0,3,3
13645,2,2,47795,47796,47798,1,3,0
13646,5,2,47800,47800,47802,0,2,2
13647,6,3,47806,47806,47809,0,3,4
13648,6,1,47812,47812,47813,0,1,3
13649,4,3,47816,47816,47819,0,3,3
13650,5,2,47821,47821,47823,0,2,2
13651,4,2,47825,47825,47827,0,2,2
13652,1,2,47826,47827,47829,1,3,0
13653,6,2,47832,47832,47834,0,2,3
13654,4,2,47836,47836,47838,0,2,2
13655,6,3,47842,47842,47845,0,3,4
13656,5,1,47847,47847,47848,0,1,2
13657,4,3,47851,47851,47854,0,3,3
13658,3,2,47854,47854,47856,0,2,0
13659,4,1,47858,47858,47859,0,1,2
13660,2,2,47860,47860,47862,0,2,1
13661,5,2,47865,47865,47867,0,2,3
13662,1,3,47866,47867,47870,1,4,0
13663,3,3,47869,47870,47873,1,4,0
13664,4,2,47873,47873,47875,0,2,0
13665,1,2,47874,47875,47877,1,3,0
13666,5,3,47879,47879,47882,0,3,2
13667,4,1,47883,47883,47884,0,1,1
13668,1,2,47884,47884,47886,0,2,0
13669,5,3,47889,47889,47892,0,3,3
13670,6,2,47895,47895,47897,0,2,3
13671,6,3,47901,47901,47904,0,3,4
13672,1,3,47902,47904,47907,2,5,0
13673,3,1,47905,47907,47908,2,3,0
13674,4,2,47909,47909,47911,0,2,1
13675,3,1,47912,47912,47913,0,1,1
13676,5,2,47917,47917,47919,0,2,4
13677,5,2,47922,47922,47924,0,2,3
13678,3,3,47925,47925,47928,0,3,1
13679,6,2,47931,47931,47933,0,2,3
13680,1,1,47932,47933,47934,1,2,0
13681,1,2,47933,47934,47936,1,3,0
13682,3,2,47936,47936,47938,0,2,0
13683,2,1,47938,47938,47939,0,1,0
13684,5,1,47943,47943,47944,0,1,4
13685,6,2,47949,47949,47951,0,2,5
13686,4,3,47953,47953,47956,0,3,2
13687,2,1,47955,47956,47957,1,2,0
13688,5,2,47960,47960,47962,0,2,3
13689,5,3,47965,47965,47968,0,3,3
13690,5,2,47970,47970,47972,0,2,2
13691,6,3,47976,47976,47979,0,3,4
13692,4,1,47980,47980,47981,0,1,1
13693,1,3,47981,47981,47984,0,3,0
13694,5,2,47986,47986,47988,0,2,2
13695,2,2,47988,47988,47990,0,2,0
13696,4,1,47992,47992,47993,0,1,2
13697,5,2,47997,47997,47999,0,2,4
13698,6,3,48003,48003,48006,0,3,4
13699,2,2,48005,48006,48008,1,3,0
13700,5,2,48010,48010,48012,0,2,2
13701,5,2,48015,48015,48017,0,2,3
13702,2,3,48017,48017,48020,0,3,0
13703,6,3,48023,48023,48026,0,3,3
13704,4,2,48027,48027,48029,0,2,1
13705,3,2,48030,48030,48032,0,2,1
13706,5,1,48035,48035,48036,0,1,3
13707,6,1,48041,48041,48042,0,1,5
13708,2,3,48043,48043,48046,0,3,1
13709,6,3,48049,48049,48052,0,3,3
13710,1,3,48050,48052,48055,2,5,0
13711,3,1,48053,48055,48056,2,3,0
13712,3,1,48056,48056,48057,0,1,0
13713,4,3,48060,48060,48063,0,3,3
13714,5,3,48065,48065,48068,0,3,2
13715,2,1,48067,48068,48069,1,2,0
13716,1,3,48068,48069,48072,1,4,0
13717,1,3,48069,48072,48075,3,6,0
13718,2,2,48071,48075,48077,4,6,0
13719,2,3,48073,48077,48080,4,7,0
13720,2,2,48075,48080,48082,5,7,0
13721,1,2,48076,48082,48084,6,8,0
13722,4,3,48080,48084,48087,4,7,0
13723,6,1,48086,48087,48088,1,2,0
13724,1,2,48087,48088,48090,1,3,0
13725,4,2,48091,48091,48093,0,2,1
13726,2,2,48093,48093,48095,0,2,0
13727,4,3,48097,48097,48100,0,3,2
13728,6,2,48103,48103,48105,0,2,3
13729,5,2,48108,48108,48110,0,2,3
13730,5,2,48113,48113,48115,0,2,3
13731,5,3,48118,48118,48121,0,3,3
13732,4,3,48122,48122,48125,0,3,1
13733,4,3,48126,48126,48129,0,3,1
13734,4,1,48130,48130,48131,0,1,1
13735,6,2,48136,48136,48138,0,2,5
13736,6,3,48142,48142,48145,0,3,4
13737,1,3,48143,48145,48148,2,5,0
13738,4,2,48147,48148,48150,1,3,0
13739,3,1,48150,48150,48151,0,1,0
13740,3,1,48153,48153,48154,0,1,2
13741,6,1,48159,48159,48160,0,1,5
13742,5,1,48164,48164,48165,0,1,4
13743,6,3,48170,48170,48173,0,3,5
13744,4,2,48174,48174,48176,0,2,1
13745,3,1,48177,48177,48178,0,1,1
13746,4,1,48181,48181,48182,0,1,3
13747,6,3,48187,48187,48190,0,3,5
13748,6,1,48193,48193,48194,0,1,3
13749,2,1,48195,48195,48196,0,1,1
13750,4,2,48199,48199,48201,0,2,3
13751,1,2,48200,48201,48203,1,3,0
13752,3,1,48203,48203,48204,0,1,0
13753,1,1,48204,48204,48205,0,1,0
13754,2,3,48206,48206,48209,0,3,1
13755,6,1,48212,48212,48213,0,1,3
13756,5,2,48217,48217,48219,0,2,4
13757,4,1,48221,48221,48222,0,1,2
13758,6,2,48227,48227,48229,0,2,5
13759,3,1,48230,48230,48231,0,1,1
13760,2,2,48232,48232,48234,0,2,1
13761,2,2,48234,48234,48236,0,2,0
13762,1,1,48235,48236,48237,1,2,0
13763,2,3,48237,48237,48240,0,3,0
13764,3,3,48240,48240,48243,0,3,0
13765,2,2,48242,48243,48245,1,3,0
13766,2,3,48244,48245,48248,1,4,0
13767,6,1,48250,48250,48251,0,1,2
13768,5,2,48255,48255,48257,0,2,4
13769,2,3,48257,48257,48260,0,3,0
13770,1,1,48258,48260,48261,2,3,0
13771,1,2,48259,48261,48263,2,4,0
13772,5,2,48264,48264,48266,0,2,1
13773,2,3,48266,48266,48269,0,3,0
13774,1,2,48267,48269,48271,2,4,0
13775,1,3,48268,48271,48274,3,6,0
13776,6,1,48274,48274,48275,0,1,0
13777,2,1,48276,48276,48277,0,1,1
13778,4,2,48280,48280,48282,0,2,3
13779,4,1,48284,48284,48285,0,1,2
13780,2,2,48286,48286,48288,0,2,1
13781,4,1,48290,48290,48291,0,1,2
13782,1,3,48291,48291,48294,0,3,0
13783,6,1,48297,48297,48298,0,1,3
13784,6,3,48303,48303,48306,0,3,5
13785,4,1,48307,48307,48308,0,1,1
13786,6,3,48313,48313,48316,0,3,5
13787,5,1,48318,48318,48319,0,1,2
13788,6,2,48324,48324,48326,0,2,5
13789,4,2,48328,48328,48330,0,2,2
13790,4,1,48332,48332,48333,0,1,2
13791,6,3,48338,48338,48341,0,3,5
13792,5,3,48343,48343,48346,0,3,2
13793,5,2,48348,48348,48350,0,2,2
13794,1,1,48349,48350,48351,1,2,0
13795,4,1,48353,48353,48354,0,1,2
13796,5,1,48358,48358,48359,0,1,4
13797,4,1,48362,48362,48363,0,1,3
13798,2,3,48364,48364,48367,0,3,1
13799,6,2,48370,48370,48372,0,2,3
13800,5,2,48375,48375,48377,0,2,3
13801,1,3,48376,48377,48380,1,4,0
13802,6,1,48382,48382,48383,0,1,2
13803,5,3,48387,48387,48390,0,3,4
13804,2,2,48389,48390,48392,1,3,0
13805,4,1,48393,48393,48394,0,1,1
13806,1,3,48394,48394,48397,0,3,0
13807,6,2,48400,48400,48402,0,2,3
13808,2,3,48402,48402,48405,0,3,0
13809,1,3,48403,48405,48408,2,5,0
13810,4,3,48407,48408,48411,1,4,0
13811,3,2,48410,48411,48413,1,3,0
13812,4,3,48414,48414,48417,0,3,1
13813,5,3,48419,48419,48422,0,3,2
13814,2,3,48421,48422,48425,1,4,0
13815,2,2,48423,48425,48427,2,4,0
13816,6,2,48429,48429,48431,0,2,2
13817,5,2,48434,48434,48436,0,2,3
13818,1,3,48435,48436,48439,1,4,0
13819,1,2,48436,48439,48441,3,5,0
13820,2,3,48438,48441,48444,3,6,0
13821,1,3,48439,48444,48447,5,8,0
13822,3,2,48442,48447,48449,5,7,0
13823,1,3,48443,48449,48452,6,9,0
13824,1,1,48444,48452,48453,8,9,0
13825,4,2,48448,48453,48455,5,7,0
13826,2,1,48450,48455,48456,5,6,0
13827,3,3,48453,48456,48459,3,6,0
13828,3,2,48456,48459,48461,3,5,0
13829,2,2,48458,48461,48463,3,5,0
13830,2,3,48460,48463,48466,3,6,0
13831,2,3,48462,48466,48469,4,7,0
13832,6,1,48468,48469,48470,1,2,0
13833,1,3,48469,48470,48473,1,4,0
13834,5,2,48474,48474,48476,0,2,1
13835,1,1,48475,48476,48477,1,2,0
13836,1,3,48476,48477,48480,1,4,0
13837,4,2,48480,48480,48482,0,2,0
13838,1,1,48481,48482,48483,1,2,0
13839,4,1,48485,48485,48486,0,1,2
13840,3,2,48488,48488,48490,0,2,2
13841,1,2,48489,48490,48492,1,3,0
13842,5,1,48494,48494,48495,0,1,2
13843,5,1,48499,48499,48500,0,1,4
13844,2,3,48501,48501,48504,0,3,1
13845,5,3,48506,48506,48509,0,3,2
13846,5,3,48511,48511,48514,0,3,2
13847,3,1,48514,48514,48515,0,1,0
13848,6,3,48520,48520,48523,0,3,5
13849,5,3,48525,48525,48528,0,3,2
13850,6,1,48531,48531,48532,0,1,3
13851,6,1,48537,48537,48538,0,1,5
13852,5,2,48542,48542,48544,0,2,4
13853,6,3,48548,48548,48551,0,3,4
13854,1,2,48549,48551,48553,2,4,0
13855,5,1,48554,48554,48555,0,1,1
13856,3,2,48557,48557,48559,0,2,2
13857,2,3,48559,48559,48562,0,3,0
13858,6,1,48565,48565,48566,0,1,3
13859,2,3,48567,48567,48570,0,3,1
13860,6,2,48573,48573,48575,0,2,3
13861,2,1,48575,48575,48576,0,1,0
13862,3,3,48578,48578,48581,0,3,2
13863,3,2,48581,48581,48583,0,2,0
13864,1,2,48582,48583,48585,1,3,0
13865,4,3,48586,48586,48589,0,3,1
13866,4,3,48590,48590,48593,0,3,1
13867,2,3,48592,48593,48596,1,4,0
13868,1,2,48593,48596,48598,3,5,0
13869,6,2,48599,48599,48601,0,2,1
13870,2,2,48601,48601,48603,0,2,0
13871,5,1,48606,48606,48607,0,1,3
13872,6,3,48612,48612,48615,0,3,5
13873,3,3,48615,48615,48618,0,3,0
13874,1,2,48616,48618,48620,2,4,0
13875,5,2,48621,48621,48623,0,2,1
13876,4,3,48625,48625,48628,0,3,2
13877,3,3,48628,48628,48631,0,3,0
13878,3,3,48631,48631,48634,0,3,0
13879,1,2,48632,48634,48636,2,4,0
13880,3,1,48635,48636,48637,1,2,0
13881,2,2,48637,48637,48639,0,2,0
13882,5,1,48642,48642,48643,0,1,3
13883,5,1,48647,48647,48648,0,1,4
13884,4,1,48651,48651,48652,0,1,3
13885,1,2,48652,48652,48654,0,2,0
13886,4,1,48656,48656,48657,0,1,2
13887,3,2,48659,48659,48661,0,2,2
13888,1,2,48660,48661,48663,1,3,0
13889,2,2,48662,48663,48665,1,3,0
13890,5,1,48667,48667,48668,0,1,2
13891,3,1,48670,48670,48671,0,1,2
13892,2,1,48672,48672,48673,0,1,1
13893,2,2,48674,48674,48676,0,2,1
13894,3,3,48677,48677,48680,0,3,1
13895,2,3,48679,48680,48683,1,4,0
13896,3,1,48682,48683,48684,1,2,0
13897,5,1,48687,48687,48688,0,1,3
13898,5,2,48692,48692,48694,0,2,4
13899,3,3,48695,48695,48698,0,3,1
13900,3,1,48698,48698,48699,0,1,0
13901,3,3,48701,48701,48704,0,3,2
13902,3,3,48704,48704,48707,0,3,0
13903,3,2,48707,48707,48709,0,2,0
13904,3,3,48710,48710,48713,0,3,1
13905,5,3,48715,48715,48718,0,3,2
13906,2,2,48717,48718,48720,1,3,0
13907,5,3,48722,48722,48725,0,3,2
13908,3,2,48725,48725,48727,0,2,0
13909,3,1,48728,48728,48729,0,1,1
13910,6,3,48734,48734,48737,0,3,5
13911,5,3,48739,48739,48742,0,3,2
13912,3,2,48742,48742,48744,0,2,0
13913,2,3,48744,48744,48747,0,3,0
13914,4,1,48748,48748,48749,0,1,1
13915,1,1,48749,48749,48750,0,1,0
13916,5,1,48754,48754,48755,0,1,4
13917,4,2,48758,48758,48760,0,2,3
13918,1,2,48759,48760,48762,1,3,0
13919,6,3,48765,48765,48768,0,3,3
13920,3,3,48768,48768,48771,0,3,0
13921,5,1,48773,48773,48774,0,1,2
13922,6,3,48779,48779,48782,0,3,5
13923,2,3,48781,48782,48785,1,4,0
13924,2,2,48783,48785,48787,2,4,0
13925,1,1,48784,48787,48788,3,4,0
13926,6,2,48790,48790,48792,0,2,2
13927,1,1,48791,48792,48793,1,2,0
13928,3,3,48794,48794,48797,0,3,1
13929,2,2,48796,48797,48799,1,3,0
13930,3,3,48799,48799,48802,0,3,0
13931,1,2,48800,48802,48804,2,4,0
13932,6,3,48806,48806,48809,0,3,2
13933,3,3,48809,48809,48812,0,3,0
13934,1,1,48810,48812,48813,2,3,0
13935,2,3,48812,48813,48816,1,4,0
13936,3,2,48815,48816,48818,1,3,0
13937,4,2,48819,48819,48821,0,2,1
13938,1,3,48820,48821,48824,1,4,0
13939,1,3,48821,48824,48827,3,6,0
13940,6,3,48827,48827,48830,0,3,0
13941,2,2,48829,48830,48832,1,3,0
13942,4,2,48833,48833,48835,0,2,1
13943,3,1,48836,48836,48837,0,1,1
13944,6,3,48842,48842,48845,0,3,5
13945,1,2,48843,48845,48847,2,4,0
13946,2,3,48845,48847,48850,2,5,0
13947,6,1,48851,48851,48852,0,1,1
13948,5,1,48856,48856,48857,0,1,4
13949,6,1,48862,48862,48863,0,1,5
13950,2,2,48864,48864,48866,0,2,1
13951,3,3,48867,48867,48870,0,3,1
13952,1,1,48868,48870,48871,2,3,0
13953,5,3,48873,48873,48876,0,3,2
13954,6,2,48879,48879,48881,0,2,3
13955,6,2,48885,48885,48887,0,2,4
13956,4,2,48889,48889,48891,0,2,2
13957,3,3,48892,48892,48895,0,3,1
13958,4,1,48896,48896,48897,0,1,1
13959,2,2,48898,48898,48900,0,2,1
13960,2,3,48900,48900,48903,0,3,0
13961,1,3,48901,48903,48906,2,5,0
13962,2,3,48903,48906,48909,3,6,0
13963,2,1,48905,48909,48910,4,5,0
13964,6,2,48911,48911,48913,0,2,1
13965,2,3,48913,48913,48916,0,3,0
13966,3,1,48916,48916,48917,0,1,0
13967,6,2,48922,48922,48924,0,2,5
13968,2,3,48924,48924,48927,0,3,0
13969,6,1,48930,48930,48931,0,1,3
13970,3,3,48933,48933,48936,0,3,2
13971,3,2,48936,48936,48938,0,2,0
13972,2,1,48938,48938,48939,0,1,0
13973,2,3,48940,48940,48943,0,3,1
13974,1,1,48941,48943,48944,2,3,0
13975,5,1,48946,48946,48947,0,1,2
13976,5,2,48951,48951,48953,0,2,4
13977,6,1,48957,48957,48958,0,1,4
13978,3,2,48960,48960,48962,0,2,2
13979,2,2,48962,48962,48964,0,2,0
13980,5,3,48967,48967,48970,0,3,3
13981,1,3,48968,48970,48973,2,5,0
13982,1,3,48969,48973,48976,4,7,0
13983,4,1,48973,48976,48977,3,4,0
13984,6,3,48979,48979,48982,0,3,2
13985,5,2,48984,48984,48986,0,2,2
13986,5,3,48989,48989,48992,0,3,3
13987,1,1,48990,48992,48993,2,3,0
13988,3,2,48993,48993,48995,0,2,0
13989,1,1,48994,48995,48996,1,2,0
13990,4,2,48998,48998,49000,0,2,2
13991,2,3,49000,49000,49003,0,3,0
13992,5,3,49005,49005,49008,0,3,2
13993,1,3,49006,49008,49011,2,5,0
13994,2,3,49008,49011,49014,3,6,0
13995,2,3,49010,49014,49017,4,7,0
13996,2,2,49012,49017,49019,5,7,0
13997,3,1,49015,49019,49020,4,5,0
13998,5,2,49020,49020,49022,0,2,0
13999,1,3,49021,49022,49025,1,4,0
14000,5,3,49026,49026,49029,0,3,1
14001,5,2,49031,49031,49033,0,2,2
14002,6,3,49037,49037,49040,0,3,4
14003,3,2,49040,49040,49042,0,2,0
14004,5,3,49045,49045,49048,0,3,3
14005,5,2,49050,49050,49052,0,2,2
14006,6,2,49056,49056,49058,0,2,4
14007,2,3,49058,49058,49061,0,3,0
14008,6,3,49064,49064,49067,0,3,3
14009,4,2,49068,49068,49070,0,2,1
14010,2,2,49070,49070,49072,0,2,0
14011,5,2,49075,49075,49077,0,2,3
14012,1,2,49076,49077,49079,1,3,0
14013,2,3,49078,49079,49082,1,4,0
14014,2,1,49080,49082,49083,2,3,0
14015,5,3,49085,49085,49088,0,3,2
14016,1,2,49086,49088,49090,2,4,0
14017,6,2,49092,49092,49094,0,2,2
14018,3,1,49095,49095,49096,0,1,1
14019,4,1,49099,49099,49100,0,1,3
14020,3,2,49102,49102,49104,0,2,2
14021,2,3,49104,49104,49107,0,3,0
14022,2,2,49106,49107,49109,1,3,0
14023,3,3,49109,49109,49112,0,3,0
14024,4,1,49113,49113,49114,0,1,1
14025,6,1,49119,49119,49120,0,1,5
14026,5,1,49124,49124,49125,0,1,4
14027,6,1,49130,49130,49131,0,1,5
14028,2,2,49132,49132,49134,0,2,1
14029,3,2,49135,49135,49137,0,2,1
14030,1,1,49136,49137,49138,1,2,0
14031,2,3,49138,49138,49141,0,3,0
14032,2,1,49140,49141,49142,1,2,0
14033,2,3,49142,49142,49145,0,3,0
14034,4,3,49146,49146,49149,0,3,1
14035,2,2,49148,49149,49151,1,3,0
14036,4,1,49152,49152,49153,0,1,1
14037,5,1,49157,49157,49158,0,1,4
14038,4,2,49161,49161,49163,0,2,3
14039,4,1,49165,49165,49166,0,1,2
14040,1,2,49166,49166,49168,0,2,0
14041,6,1,49172,49172,49173,0,1,4
14042,4,2,49176,49176,49178,0,2,3
14043,2,3,49178,49178,49181,0,3,0
14044,6,2,49184,49184,49186,0,2,3
14045,6,3,49190,49190,49193,0,3,4
14046,2,3,49192,49193,49196,1,4,0
14047,1,2,49193,49196,49198,3,5,0
14048,6,2,49199,49199,49201,0,2,1
14049,3,2,49202,49202,49204,0,2,1
14050,6,1,49208,49208,49209,0,1,4
14051,4,2,49212,49212,49214,0,2,3
14052,6,1,49218,49218,49219,0,1,4
14053,4,3,49222,49222,49225,0,3,3
14054,6,3,49228,49228,49231,0,3,3
14055,5,3,49233,49233,49236,0,3,2
14056,6,2,49239,49239,49241,0,2,3
14057,2,2,49241,49241,49243,0,2,0
14058,1,2,49242,49243,49245,1,3,0
14059,3,1,49245,49245,49246,0,1,0
14060,6,1,49251,49251,49252,0,1,5
14061,6,3,49257,49257,49260,0,3,5
14062,1,1,49258,49260,49261,2,3,0
14063,4,1,49262,49262,49263,0,1,1
14064,1,3,49263,49263,49266,0,3,0
14065,3,1,49266,49266,49267,0,1,0
14066,3,2,49269,49269,49271,0,2,2
14067,5,1,49274,49274,49275,0,1,3
14068,3,3,49277,49277,49280,0,3,2
14069,2,2,49279,49280,49282,1,3,0
14070,1,2,49280,49282,49284,2,4,0
14071,6,2,49286,49286,49288,0,2,2
14072,3,2,49289,49289,49291,0,2,1
14073,6,2,49295,49295,49297,0,2,4
14074,1,3,49296,49297,49300,1,4,0
14075,4,2,49300,49300,49302,0,2,0
14076,2,3,49302,49302,49305,0,3,0
14077,3,3,49305,49305,49308,0,3,0
14078,4,3,49309,49309,49312,0,3,1
14079,6,1,49315,49315,49316,0,1,3
14080,5,3,49320,49320,49323,0,3,4
14081,3,3,49323,49323,49326,0,3,0
14082,3,2,49326,49326,49328,0,2,0
14083,4,3,49330,49330,49333,0,3,2
14084,6,3,49336,49336,49339,0,3,3
14085,1,2,49337,49339,49341,2,4,0
14086,1,1,49338,49341,49342,3,4,0
14087,1,3,49339,49342,49345,3,6,0
14088,6,1,49345,49345,49346,0,1,0
14089,6,3,49351,49351,49354,0,3,5
14090,5,3,49356,49356,49359,0,3,2
14091,3,1,49359,49359,49360,0,1,0
14092,3,3,49362,49362,49365,0,3,2
14093,1,3,49363,49365,49368,2,5,0
14094,3,3,49366,49368,49371,2,5,0
14095,6,3,49372,49372,49375,0,3,1
14096,6,1,49378,49378,49379,0,1,3
14097,2,3,49380,49380,49383,0,3,1
14098,1,2,49381,49383,49385,2,4,0
14099,2,3,49383,49385,49388,2,5,0
14100,1,3,49384,49388,49391,4,7,0
14101,2,3,49386,49391,49394,5,8,0
14102,6,3,49392,49394,49397,2,5,0
14103,2,2,49394,49397,49399,3,5,0
14104,3,3,49397,49399,49402,2,5,0
14105,2,1,49399,49402,49403,3,4,0
14106,4,3,49403,49403,49406,0,3,0
14107,5,1,49408,49408,49409,0,1,2
14108,1,3,49409,49409,49412,0,3,0
14109,6,2,49415,49415,49417,0,2,3
14110,4,1,49419,49419,49420,0,1,2
14111,3,1,49422,49422,49423,0,1,2
14112,1,1,49423,49423,49424,0,1,0
14113,2,2,49425,49425,49427,0,2,1
14114,4,1,49429,49429,49430,0,1,2
14115,5,2,49434,49434,49436,0,2,4
14116,1,2,49435,49436,49438,1,3,0
14117,1,2,49436,49438,49440,2,4,0
14118,3,2,49439,49440,49442,1,3,0
14119,6,2,49445,49445,49447,0,2,3
14120,6,3,49451,49451,49454,0,3,4
14121,2,1,49453,49454,49455,1,2,0
14122,4,3,49457,49457,49460,0,3,2
14123,6,3,49463,49463,49466,0,3,3
14124,2,2,49465,49466,49468,1,3,0
14125,6,3,49471,49471,49474,0,3,3
14126,1,2,49472,49474,49476,2,4,0
14127,6,2,49478,49478,49480,0,2,2
14128,5,2,49483,49483,49485,0,2,3
14129,4,2,49487,49487,49489,0,2,2
14130,5,2,49492,49492,49494,0,2,3
14131,6,3,49498,49498,49501,0,3,4
14132,2,3,49500,49501,49504,1,4,0
14133,3,3,49503,49504,49507,1,4,0
14134,5,3,49508,49508,49511,0,3,1
14135,2,1,49510,49511,49512,1,2,0
14136,3,2,49513,49513,49515,0,2,1
14137,5,2,49518,49518,49520,0,2,3
14138,4,3,49522,49522,49525,0,3,2
14139,3,1,49525,49525,49526,0,1,0
14140,2,1,49527,49527,49528,0,1,1
14141,5,3,49532,49532,49535,0,3,4
14142,4,2,49536,49536,49538,0,2,1
14143,2,2,49538,49538,49540,0,2,0
14144,3,3,49541,49541,49544,0,3,1
14145,3,2,49544,49544,49546,0,2,0
14146,5,3,49549,49549,49552,0,3,3
14147,4,3,49553,49553,49556,0,3,1
14148,5,2,49558,49558,49560,0,2,2
14149,1,1,49559,49560,49561,1,2,0
14150,6,1,49565,49565,49566,0,1,4
14151,6,1,49571,49571,49572,0,1,5
14152,1,3,49572,49572,49575,0,3,0
14153,1,1,49573,49575,49576,2,3,0
14154,4,1,49577,49577,49578,0,1,1
14155,5,3,49582,49582,49585,0,3,4
14156,1,1,49583,49585,49586,2,3,0
14157,1,1,49584,49586,49587,2,3,0
14158,1,3,49585,49587,49590,2,5,0
14159,3,2,49588,49590,49592,2,4,0
14160,1,2,49589,49592,49594,3,5,0
14161,4,1,49593,49594,49595,1,2,0
14162,6,1,49599,49599,49600,0,1,4
14163,5,1,49604,49604,49605,0,1,4
14164,2,2,49606,49606,49608,0,2,1
14165,4,1,49610,49610,49611,0,1,2
14166,5,2,49615,49615,49617,0,2,4
14167,3,3,49618,49618,49621,0,3,1
14168,6,2,49624,49624,49626,0,2,3
14169,3,1,49627,49627,49628,0,1,1
14170,6,2,49633,49633,49635,0,2,5
14171,6,2,49639,49639,49641,0,2,4
14172,1,2,49640,49641,49643,1,3,0
14173,5,1,49645,49645,49646,0,1,2
14174,4,2,49649,49649,49651,0,2,3
14175,2,3,49651,49651,49654,0,3,0
14176,2,3,49653,49654,49657,1,4,0
14177,3,1,49656,49657,49658,1,2,0
14178,1,3,49657,49658,49661,1,4,0
14179,1,2,49658,49661,49663,3,5,0
14180,6,1,49664,49664,49665,0,1,1
14181,2,1,49666,49666,49667,0,1,1
14182,4,3,49670,49670,49673,0,3,3
14183,1,2,49671,49673,49675,2,4,0
14184,3,3,49674,49675,49678,1,4,0
14185,3,2,49677,49678,49680,1,3,0
14186,2,2,49679,49680,49682,1,3,0
14187,3,1,49682,49682,49683,0,1,0
14188,1,1,49683,49683,49684,0,1,0
14189,4,2,49687,49687,49689,0,2,3
14190,1,2,49688,49689,49691,1,3,0
14191,3,2,49691,49691,49693,0,2,0
14192,1,2,49692,49693,49695,1,3,0
14193,5,1,49697,49697,49698,0,1,2
14194,6,2,49703,49703,49705,0,2,5
14195,1,1,49704,49705,49706,1,2,0
14196,5,1,49709,49709,49710,0,1,3
14197,1,2,49710,49710,49712,0,2,0
14198,4,2,49714,49714,49716,0,2,2
14199,2,3,49716,49716,49719,0,3,0
14200,1,2,49717,49719,49721,2,4,0
14201,3,3,49720,49721,49724,1,4,0
14202,3,3,49723,49724,49727,1,4,0
14203,5,2,49728,49728,49730,0,2,1
14204,3,1,49731,49731,49732,0,1,1
14205,4,3,49735,49735,49738,0,3,3
14206,3,1,49738,49738,49739,0,1,0
14207,6,2,49744,49744,49746,0,2,5
14208,1,2,49745,49746,49748,1,3,0
14209,4,2,49749,49749,49751,0,2,1
14210,3,2,49752,49752,49754,0,2,1
14211,5,2,49757,49757,49759,0,2,3
14212,4,1,49761,49761,49762,0,1,2
14213,1,2,49762,49762,49764,0,2,0
14214,3,3,49765,49765,49768,0,3,1
14215,1,2,49766,49768,49770,2,4,0
14216,5,3,49771,49771,49774,0,3,1
14217,1,2,49772,49774,49776,2,4,0
14218,6,3,49778,49778,49781,0,3,2
14219,3,1,49781,49781,49782,0,1,0
14220,4,2,49785,49785,49787,0,2,3
14221,4,3,49789,49789,49792,0,3,2
14222,6,2,49795,49795,49797,0,2,3
14223,1,1,49796,49797,49798,1,2,0
14224,4,2,49800,49800,49802,0,2,2
14225,5,3,49805,49805,49808,0,3,3
14226,4,1,49809,49809,49810,0,1,1
14227,5,1,49814,49814,49815,0,1,4
14228,3,3,49817,49817,49820,0,3,2
14229,6,3,49823,49823,49826,0,3,3
14230,4,3,49827,49827,49830,0,3,1
14231,5,3,49832,49832,49835,0,3,2
14232,4,2,49836,49836,49838,0,2,1
14233,1,1,49837,49838,49839,1,2,0
14234,2,3,49839,49839,49842,0,3,0
14235,1,3,49840,49842,49845,2,5,0
14236,1,3,49841,49845,49848,4,7,0
14237,6,3,49847,49848,49851,1,4,0
14238,6,2,49853,49853,49855,0,2,2
14239,4,1,49857,49857,49858,0,1,2
14240,6,2,49863,49863,49865,0,2,5
14241,1,2,49864,49865,49867,1,3,0
14242,4,1,49868,49868,49869,0,1,1
14243,2,3,49870,49870,49873,0,3,1
14244,1,3,49871,49873,49876,2,5,0
14245,5,3,49876,49876,49879,0,3,0
14246,5,1,49881,49881,49882,0,1,2
14247,5,3,49886,49886,49889,0,3,4
14248,5,2,49891,49891,49893,0,2,2
14249,3,3,49894,49894,49897,0,3,1
14250,1,1,49895,49897,49898,2,3,0
14251,6,3,49901,49901,49904,0,3,3
14252,4,3,49905,49905,49908,0,3,1
14253,4,2,49909,49909,49911,0,2,1
14254,1,3,49910,49911,49914,1,4,0
14255,5,3,49915,49915,49918,0,3,1
14256,5,2,49920,49920,49922,0,2,2
14257,6,3,49926,49926,49929,0,3,4
14258,5,1,49931,49931,49932,0,1,2
14259,4,2,49935,49935,49937,0,2,3
14260,5,1,49940,49940,49941,0,1,3
14261,1,2,49941,49941,49943,0,2,0
14262,5,1,49946,49946,49947,0,1,3
14263,4,3,49950,49950,49953,0,3,3
14264,1,1,49951,49953,49954,2,3,0
14265,5,2,49956,49956,49958,0,2,2
14266,1,2,49957,49958,49960,1,3,0
14267,3,2,49960,49960,49962,0,2,0
14268,4,2,49964,49964,49966,0,2,2
14269,6,3,49970,49970,49973,0,3,4
14270,5,1,49975,49975,49976,0,1,2
14271,4,1,49979,49979,49980,0,1,3
14272,5,1,49984,49984,49985,0,1,4
14273,5,3,49989,49989,49992,0,3,4
14274,1,3,49990,49992,49995,2,5,0
14275,3,2,49993,49995,49997,2,4,0
14276,6,1,49999,49999,50000,0,1,2
14277,3,1,50002,50002,50003,0,1,2
14278,1,1,50003,50003,50004,0,1,0
14279,6,3,50009,50009,50012,0,3,5
14280,1,1,50010,50012,50013,2,3,0
14281,3,3,50013,50013,50016,0,3,0
14282,1,1,50014,50016,50017,2,3,0
14283,1,1,50015,50017,50018,2,3,0
14284,4,3,50019,50019,50022,0,3,1
14285,3,3,50022,50022,50025,0,3,0
14286,4,2,50026,50026,50028,0,2,1
14287,4,3,50030,50030,50033,0,3,2
14288,1,3,50031,50033,50036,2,5,0
14289,6,2,50037,50037,50039,0,2,1
14290,1,1,50038,50039,50040,1,2,0
14291,2,1,50040,50040,50041,0,1,0
14292,6,2,50046,50046,50048,0,2,5
14293,4,1,50050,50050,50051,0,1,2
14294,4,3,50054,50054,50057,0,3,3
14295,4,1,50058,50058,50059,0,1,1
14296,6,3,50064,50064,50067,0,3,5
14297,6,2,50070,50070,50072,0,2,3
14298,5,3,50075,50075,50078,0,3,3
14299,6,2,50081,50081,50083,0,2,3
14300,6,1,50087,50087,50088,0,1,4
14301,3,1,50090,50090,50091,0,1,2
14302,1,3,50091,50091,50094,0,3,0
14303,6,2,50097,50097,50099,0,2,3
14304,4,2,50101,50101,50103,0,2,2
14305,5,1,50106,50106,50107,0,1,3
14306,1,1,50107,50107,50108,0,1,0
14307,4,2,50111,50111,50113,0,2,3
14308,3,1,50114,50114,50115,0,1,1
14309,3,1,50117,50117,50118,0,1,2
14310,1,2,50118,50118,50120,0,2,0
14311,4,1,50122,50122,50123,0,1,2
14312,5,1,50127,50127,50128,0,1,4
14313,2,2,50129,50129,50131,0,2,1
14314,2,1,50131,50131,50132,0,1,0
14315,3,2,50134,50134,50136,0,2,2
14316,5,1,50139,50139,50140,0,1,3
14317,4,1,50143,50143,50144,0,1,3
14318,3,2,50146,50146,50148,0,2,2
14319,3,2,50149,50149,50151,0,2,1
14320,5,3,50154,50154,50157,0,3,3
14321,5,2,50159,50159,50161,0,2,2
14322,5,3,50164,50164,50167,0,3,3
14323,3,2,50167,50167,50169,0,2,0
14324,5,2,50172,50172,50174,0,2,3
14325,3,1,50175,50175,50176,0,1,1
14326,5,1,50180,50180,50181,0,1,4
14327,5,3,50185,50185,50188,0,3,4
14328,5,2,50190,50190,50192,0,2,2
14329,4,2,50194,50194,50196,0,2,2
14330,4,2,50198,50198,50200,0,2,2
14331,5,3,50203,50203,50206,0,3,3
14332,6,2,50209,50209,50211,0,2,3
14333,3,1,50212,50212,50213,0,1,1
14334,6,2,50218,50218,50220,0,2,5
14335,4,1,50222,50222,50223,0,1,2
14336,3,2,50225,50225,50227,0,2,2
14337,1,1,50226,50227,50228,1,2,0
14338,4,2,50230,50230,50232,0,2,2
14339,5,3,50235,50235,50238,0,3,3
14340,5,1,50240,50240,50241,0,1,2
14341,6,3,50246,50246,50249,0,3,5
14342,3,3,50249,50249,50252,0,3,0
14343,3,3,50252,50252,50255,0,3,0
14344,1,2,50253,50255,50257,2,4,0
14345,1,1,50254,50257,50258,3,4,0
14346,5,1,50259,50259,50260,0,1,1
14347,2,1,50261,50261,50262,0,1,1
14348,5,3,50266,50266,50269,0,3,4
14349,1,3,50267,50269,50272,2,5,0
14350,5,3,50272,50272,50275,0,3,0
14351,2,2,50274,50275,50277,1,3,0
14352,2,1,50276,50277,50278,1,2,0
14353,2,3,50278,50278,50281,0,3,0
14354,6,1,50284,50284,50285,0,1,3
14355,4,3,50288,50288,50291,0,3,3
14356,3,2,50291,50291,50293,0,2,0
14357,5,1,50296,50296,50297,0,1,3
14358,6,2,50302,50302,50304,0,2,5
14359,3,3,50305,50305,50308,0,3,1
14360,3,1,50308,50308,50309,0,1,0
14361,1,2,50309,50309,50311,0,2,0
14362,6,1,50315,50315,50316,0,1,4
14363,6,3,50321,50321,50324,0,3,5
14364,5,1,50326,50326,50327,0,1,2
14365,6,3,50332,50332,50335,0,3,5
14366,3,3,50335,50335,50338,0,3,0
14367,4,1,50339,50339,50340,0,1,1
14368,3,2,50342,50342,50344,0,2,2
14369,6,2,50348,50348,50350,0,2,4
14370,4,2,50352,50352,50354,0,2,2
14371,4,1,50356,50356,50357,0,1,2
14372,3,2,50359,50359,50361,0,2,2
14373,4,2,50363,50363,50365,0,2,2
14374,4,1,50367,50367,50368,0,1,2
14375,4,3,50371,50371,50374,0,3,3
14376,6,1,50377,50377,50378,0,1,3
14377,4,3,50381,50381,50384,0,3,3
14378,1,3,50382,50384,50387,2,5,0
14379,1,1,50383,50387,50388,4,5,0
14380,3,2,50386,50388,50390,2,4,0
14381,4,2,50390,50390,50392,0,2,0
14382,2,1,50392,50392,50393,0,1,0
14383,1,2,50393,50393,50395,0,2,0
14384,1,2,50394,50395,50397,1,3,0
14385,3,1,50397,50397,50398,0,1,0
14386,6,2,50403,50403,50405,0,2,5
14387,4,3,50407,50407,50410,0,3,2
14388,1,2,50408,50410,50412,2,4,0
14389,3,2,50411,50412,50414,1,3,0
14390,5,3,50416,50416,50419,0,3,2
14391,5,1,50421,50421,50422,0,1,2
14392,1,3,50422,50422,50425,0,3,0
14393,2,3,50424,50425,50428,1,4,0
14394,2,1,50426,50428,50429,2,3,0
14395,1,3,50427,50429,50432,2,5,0
14396,5,3,50432,50432,50435,0,3,0
14397,1,3,50433,50435,50438,2,5,0
14398,1,1,50434,50438,50439,4,5,0
14399,5,1,50439,50439,50440,0,1,0
14400,2,3,50441,50441,50444,0,3,1
14401,5,3,50446,50446,50449,0,3,2
14402,3,2,50449,50449,50451,0,2,0
14403,3,1,50452,50452,50453,0,1,1
14404,5,2,50457,50457,50459,0,2,4
14405,3,3,50460,50460,50463,0,3,1
14406,3,2,50463,50463,50465,0,2,0
14407,6,2,50469,50469,50471,0,2,4
14408,5,1,50474,50474,50475,0,1,3
14409,2,2,50476,50476,50478,0,2,1
14410,1,2,50477,50478,50480,1,3,0
14411,2,1,50479,50480,50481,1,2,0
14412,4,2,50483,50483,50485,0,2,2
14413,2,1,50485,50485,50486,0,1,0
14414,3,3,50488,50488,50491,0,3,2
14415,4,2,50492,50492,50494,0,2,1
14416,5,3,50497,50497,50500,0,3,3
14417,2,1,50499,50500,50501,1,2,0
14418,2,3,50501,50501,50504,0,3,0
14419,6,2,50507,50507,50509,0,2,3
14420,3,3,50510,50510,50513,0,3,1
14421,1,2,50511,50513,50515,2,4,0
14422,4,3,50515,50515,50518,0,3,0
14423,3,2,50518,50518,50520,0,2,0
14424,6,1,50524,50524,50525,0,1,4
14425,5,3,50529,50529,50532,0,3,4
14426,4,1,50533,50533,50534,0,1,1
14427,4,2,50537,50537,50539,0,2,3
14428,5,1,50542,50542,50543,0,1,3
14429,4,1,50546,50546,50547,0,1,3
14430,6,3,50552,50552,50555,0,3,5
14431,4,1,50556,50556,50557,0,1,1
14432,6,3,50562,50562,50565,0,3,5
14433,4,3,50566,50566,50569,0,3,1
14434,2,2,50568,50569,50571,1,3,0
14435,3,2,50571,50571,50573,0,2,0
14436,3,3,50574,50574,50577,0,3,1
14437,5,2,50579,50579,50581,0,2,2
14438,2,1,50581,50581,50582,0,1,0
14439,6,2,50587,50587,50589,0,2,5
14440,5,3,50592,50592,50595,0,3,3
14441,4,3,50596,50596,50599,0,3,1
14442,1,1,50597,50599,50600,2,3,0
14443,4,3,50601,50601,50604,0,3,1
14444,3,1,50604,50604,50605,0,1,0
14445,3,2,50607,50607,50609,0,2,2
14446,1,3,50608,50609,50612,1,4,0
14447,4,2,50612,50612,50614,0,2,0
14448,1,3,50613,50614,50617,1,4,0
14449,5,2,50618,50618,50620,0,2,1
14450,6,2,50624,50624,50626,0,2,4
14451,1,1,50625,50626,50627,1,2,0
14452,6,2,50631,50631,50633,0,2,4
14453,6,3,50637,50637,50640,0,3,4
14454,2,2,50639,50640,50642,1,3,0
14455,1,2,50640,50642,50644,2,4,0
14456,2,1,50642,50644,50645,2,3,0
14457,2,1,50644,50645,50646,1,2,0
14458,2,1,50646,50646,50647,0,1,0
14459,2,3,50648,50648,50651,0,3,1
14460,2,1,50650,50651,50652,1,2,0
14461,3,2,50653,50653,50655,0,2,1
14462,3,1,50656,50656,50657,0,1,1
14463,4,3,50660,50660,50663,0,3,3
14464,1,1,50661,50663,50664,2,3,0
14465,1,3,50662,50664,50667,2,5,0
14466,2,1,50664,50667,50668,3,4,0
14467,5,3,50669,50669,50672,0,3,1
14468,6,3,50675,50675,50678,0,3,3
14469,2,2,50677,50678,50680,1,3,0
14470,6,2,50683,50683,50685,0,2,3
14471,5,3,50688,50688,50691,0,3,3
14472,6,2,50694,50694,50696,0,2,3
14473,4,3,50698,50698,50701,0,3,2
14474,6,2,50704,50704,50706,0,2,3
14475,3,1,50707,50707,50708,0,1,1
14476,4,1,50711,50711,50712,0,1,3
14477,6,1,50717,50717,50718,0,1,5
14478,5,2,50722,50722,50724,0,2,4
14479,1,1,50723,50724,50725,1,2,0
14480,6,1,50729,50729,50730,0,1,4
14481,1,3,50730,50730,50733,0,3,0
14482,5,3,50735,50735,50738,0,3,2
14483,1,1,50736,50738,50739,2,3,0
14484,2,2,50738,50739,50741,1,3,0
14485,6,1,50744,50744,50745,0,1,3
14486,5,2,50749,50749,50751,0,2,4
14487,3,1,50752,50752,50753,0,1,1
14488,2,1,50754,50754,50755,0,1,1
14489,3,1,50757,50757,50758,0,1,2
14490,2,2,50759,50759,50761,0,2,1
14491,1,1,50760,50761,50762,1,2,0
14492,6,2,50766,50766,50768,0,2,4
14493,6,2,50772,50772,50774,0,2,4
14494,3,3,50775,50775,50778,0,3,1
14495,5,2,50780,50780,50782,0,2,2
14496,5,1,50785,50785,50786,0,1,3
14497,5,3,50790,50790,50793,0,3,4
14498,5,1,50795,50795,50796,0,1,2
14499,4,2,50799,50799,50801,0,2,3
14500,3,3,50802,50802,50805,0,3,1
14501,1,2,50803,50805,50807,2,4,0
14502,4,2,50807,50807,50809,0,2,0
14503,6,1,50813,50813,50814,0,1,4
14504,1,2,50814,50814,50816,0,2,0
14505,6,3,50820,50820,50823,0,3,4
14506,1,3,50821,50823,50826,2,5,0
14507,1,3,50822,50826,50829,4,7,0
14508,4,2,50826,50829,50831,3,5,0
14509,2,2,50828,50831,50833,3,5,0
14510,2,3,50830,50833,50836,3,6,0
14511,5,2,50835,50836,50838,1,3,0
14512,1,3,50836,50838,50841,2,5,0
14513,6,1,50842,50842,50843,0,1,1
14514,3,1,50845,50845,50846,0,1,2
14515,1,1,50846,50846,50847,0,1,0
14516,3,3,50849,50849,50852,0,3,2
14517,5,2,50854,50854,50856,0,2,2
14518,3,3,50857,50857,50860,0,3,1
14519,2,3,50859,50860,50863,1,4,0
14520,3,3,50862,50863,50866,1,4,0
14521,6,3,50868,50868,50871,0,3,2
14522,6,2,50874,50874,50876,0,2,3
14523,4,2,50878,50878,50880,0,2,2
14524,4,2,50882,50882,50884,0,2,2
14525,4,1,50886,50886,50887,0,1,2
14526,5,3,50891,50891,50894,0,3,4
14527,2,1,50893,50894,50895,1,2,0
14528,2,1,50895,50895,50896,0,1,0
14529,3,3,50898,50898,50901,0,3,2
14530,6,1,50904,50904,50905,0,1,3
14531,1,1,50905,50905,50906,0,1,0
14532,5,2,50910,50910,50912,0,2,4
14533,1,3,50911,50912,50915,1,4,0
14534,2,3,50913,50915,50918,2,5,0
14535,5,3,50918,50918,50921,0,3,0
14536,2,1,50920,50921,50922,1,2,0
14537,4,3,50924,50924,50927,0,3,2
14538,1,3,50925,50927,50930,2,5,0
14539,4,2,50929,50930,50932,1,3,0
14540,4,2,50933,50933,50935,0,2,1
14541,1,3,50934,50935,50938,1,4,0
14542,5,2,50939,50939,50941,0,2,1
14543,5,2,50944,50944,50946,0,2,3
14544,2,3,50946,50946,50949,0,3,0
14545,6,2,50952,50952,50954,0,2,3
14546,1,2,50953,50954,50956,1,3,0
14547,4,2,50957,50957,50959,0,2,1
14548,2,1,50959,50959,50960,0,1,0
14549,1,2,50960,50960,50962,0,2,0
14550,1,2,50961,50962,50964,1,3,0
14551,1,1,50962,50964,50965,2,3,0
14552,3,2,50965,50965,50967,0,2,0
14553,6,3,50971,50971,50974,0,3,4
14554,3,2,50974,50974,50976,0,2,0
14555,2,3,50976,50976,50979,0,3,0
14556,4,3,50980,50980,50983,0,3,1
14557,1,1,50981,50983,50984,2,3,0
14558,4,2,50985,50985,50987,0,2,1
14559,4,1,50989,50989,50990,0,1,2
14560,2,1,50991,50991,50992,0,1,1
14561,6,3,50997,50997,51000,0,3,5
14562,2,2,50999,51000,51002,1,3,0
14563,4,3,51003,51003,51006,0,3,1
14564,2,2,51005,51006,51008,1,3,0
14565,5,3,51010,51010,51013,0,3,2
14566,2,2,51012,51013,51015,1,3,0
14567,5,1,51017,51017,51018,0,1,2
14568,3,2,51020,51020,51022,0,2,2
14569,6,1,51026,51026,51027,0,1,4
14570,4,2,51030,51030,51032,0,2,3
14571,1,2,51031,51032,51034,1,3,0
14572,1,2,51032,51034,51036,2,4,0
14573,3,1,51035,51036,51037,1,2,0
14574,1,2,51036,51037,51039,1,3,0
14575,2,2,51038,51039,51041,1,3,0
14576,4,1,51042,51042,51043,0,1,1
14577,5,1,51047,51047,51048,0,1,4
14578,5,2,51052,51052,51054,0,2,4
14579,6,2,51058,51058,51060,0,2,4
14580,6,1,51064,51064,51065,0,1,4
14581,5,1,51069,51069,51070,0,1,4
14582,4,1,51073,51073,51074,0,1,3
14583,1,3,51074,51074,51077,0,3,0
14584,6,2,51080,51080,51082,0,2,3
14585,6,3,51086,51086,51089,0,3,4
14586,6,1,51092,51092,51093,0,1,3
14587,3,3,51095,51095,51098,0,3,2
14588,3,1,51098,51098,51099,0,1,0
14589,3,1,51101,51101,51102,0,1,2
14590,1,2,51102,51102,51104,0,2,0
14591,4,2,51106,51106,51108,0,2,2
14592,6,2,51112,51112,51114,0,2,4
14593,6,3,51118,51118,51121,0,3,4
14594,4,2,51122,51122,51124,0,2,1
14595,4,2,51126,51126,51128,0,2,2
14596,6,3,51132,51132,51135,0,3,4
14597,3,1,51135,51135,51136,0,1,0
14598,5,2,51140,51140,51142,0,2,4
14599,1,1,51141,51142,51143,1,2,0
14600,5,1,51146,51146,51147,0,1,3
14601,3,2,51149,51149,51151,0,2,2
14602,1,2,51150,51151,51153,1,3,0
14603,1,2,51151,51153,51155,2,4,0
14604,4,2,51155,51155,51157,0,2,0
14605,4,1,51159,51159,51160,0,1,2
14606,6,2,51165,51165,51167,0,2,5
14607,6,3,51171,51171,51174,0,3,4
14608,3,3,51174,51174,51177,0,3,0
14609,5,1,51179,51179,51180,0,1,2
14610,6,3,51185,51185,51188,0,3,5
14611,4,3,51189,51189,51192,0,3,1
14612,1,1,51190,51192,51193,2,3,0
14613,1,3,51191,51193,51196,2,5,0
14614,1,2,51192,51196,51198,4,6,0
14615,2,3,51194,51198,51201,4,7,0
14616,4,2,51198,51201,51203,3,5,0
14617,6,2,51204,51204,51206,0,2,1
14618,5,2,51209,51209,51211,0,2,3
14619,3,3,51212,51212,51215,0,3,1
14620,4,3,51216,51216,51219,0,3,1
14621,1,1,51217,51219,51220,2,3,0
14622,3,3,51220,51220,51223,0,3,0
14623,1,3,51221,51223,51226,2,5,0
14624,6,1,51227,51227,51228,0,1,1
14625,3,2,51230,51230,51232,0,2,2
14626,1,3,51231,51232,51235,1,4,0
14627,6,1,51237,51237,51238,0,1,2
14628,1,2,51238,51238,51240,0,2,0
14629,5,1,51243,51243,51244,0,1,3
14630,1,2,51244,51244,51246,0,2,0
14631,6,3,51250,51250,51253,0,3,4
14632,2,2,51252,51253,51255,1,3,0
14633,2,3,51254,51255,51258,1,4,0
14634,1,1,51255,51258,51259,3,4,0
14635,4,2,51259,51259,51261,0,2,0
14636,3,2,51262,51262,51264,0,2,1
14637,6,3,51268,51268,51271,0,3,4
14638,6,2,51274,51274,51276,0,2,3
14639,3,1,51277,51277,51278,0,1,1
14640,3,1,51280,51280,51281,0,1,2
14641,4,3,51284,51284,51287,0,3,3
14642,1,3,51285,51287,51290,2,5,0
14643,2,1,51287,51290,51291,3,4,0
14644,2,3,51289,51291,51294,2,5,0
14645,6,3,51295,51295,51298,0,3,1
14646,4,3,51299,51299,51302,0,3,1
14647,1,3,51300,51302,51305,2,5,0
14648,4,2,51304,51305,51307,1,3,0
14649,6,2,51310,51310,51312,0,2,3
14650,6,3,51316,51316,51319,0,3,4
14651,5,2,51321,51321,51323,0,2,2
14652,1,2,51322,51323,51325,1,3,0
14653,5,3,51327,51327,51330,0,3,2
14654,1,1,51328,51330,51331,2,3,0
14655,3,3,51331,51331,51334,0,3,0
14656,2,1,51333,51334,51335,1,2,0
14657,3,2,51336,51336,51338,0,2,1
14658,6,1,51342,51342,51343,0,1,4
14659,2,3,51344,51344,51347,0,3,1
14660,3,3,51347,51347,51350,0,3,0
14661,1,3,51348,51350,51353,2,5,0
14662,5,2,51353,51353,51355,0,2,0
14663,4,1,51357,51357,51358,0,1,2
14664,5,1,51362,51362,51363,0,1,4
14665,3,2,51365,51365,51367,0,2,2
14666,1,2,51366,51367,51369,1,3,0
14667,6,3,51372,51372,51375,0,3,3
14668,6,3,51378,51378,51381,0,3,3
14669,1,1,51379,51381,51382,2,3,0
14670,5,3,51384,51384,51387,0,3,2
14671,6,2,51390,51390,51392,0,2,3
14672,4,2,51394,51394,51396,0,2,2
14673,3,3,51397,51397,51400,0,3,1
14674,6,2,51403,51403,51405,0,2,3
14675,5,3,51408,51408,51411,0,3,3
14676,2,1,51410,51411,51412,1,2,0
14677,6,2,51416,51416,51418,0,2,4
14678,5,2,51421,51421,51423,0,2,3
14679,4,1,51425,51425,51426,0,1,2
14680,5,3,51430,51430,51433,0,3,4
14681,2,1,51432,51433,51434,1,2,0
14682,3,3,51435,51435,51438,0,3,1
14683,6,1,51441,51441,51442,0,1,3
14684,6,1,51447,51447,51448,0,1,5
14685,5,2,51452,51452,51454,0,2,4
14686,1,3,51453,51454,51457,1,4,0
14687,3,3,51456,51457,51460,1,4,0
14688,5,1,51461,51461,51462,0,1,1
14689,3,2,51464,51464,51466,0,2,2
14690,3,3,51467,51467,51470,0,3,1
14691,4,2,51471,51471,51473,0,2,1
14692,6,2,51477,51477,51479,0,2,4
14693,5,1,51482,51482,51483,0,1,3
14694,4,3,51486,51486,51489,0,3,3
14695,3,3,51489,51489,51492,0,3,0
14696,4,2,51493,51493,51495,0,2,1
14697,4,1,51497,51497,51498,0,1,2
14698,3,2,51500,51500,51502,0,2,2
14699,2,1,51502,51502,51503,0,1,0
14700,5,3,51507,51507,51510,0,3,4
14701,1,3,51508,51510,51513,2,5,0
14702,2,3,51510,51513,51516,3,6,0
14703,3,1,51513,51516,51517,3,4,0
14704,6,3,51519,51519,51522,0,3,2
14705,1,3,51520,51522,51525,2,5,0
14706,3,2,51523,51525,51527,2,4,0
14707,5,3,51528,51528,51531,0,3,1
14708,6,3,51534,51534,51537,0,3,3
14709,1,3,51535,51537,51540,2,5,0
14710,6,2,51541,51541,51543,0,2,1
14711,2,1,51543,51543,51544,0,1,0
14712,2,1,51545,51545,51546,0,1,1
14713,2,2,51547,51547,51549,0,2,1
14714,4,2,51551,51551,51553,0,2,2
14715,6,3,51557,51557,51560,0,3,4
14716,2,2,51559,51560,51562,1,3,0
14717,4,1,51563,51563,51564,0,1,1
14718,2,3,51565,51565,51568,0,3,1
14719,2,1,51567,51568,51569,1,2,0
14720,6,3,51573,51573,51576,0,3,4
14721,6,1,51579,51579,51580,0,1,3
14722,5,2,51584,51584,51586,0,2,4
14723,4,2,51588,51588,51590,0,2,2
14724,3,1,51591,51591,51592,0,1,1
14725,5,3,51596,51596,51599,0,3,4
14726,2,1,51598,51599,51600,1,2,0
14727,1,1,51599,51600,51601,1,2,0
14728,4,3,51603,51603,51606,0,3,2
14729,2,1,51605,51606,51607,1,2,0
14730,3,1,51608,51608,51609,0,1,1
14731,5,3,51613,51613,51616,0,3,4
14732,1,2,51614,51616,51618,2,4,0
14733,5,2,51619,51619,51621,0,2,1
14734,5,2,51624,51624,51626,0,2,3
14735,2,1,51626,51626,51627,0,1,0
14736,4,1,51630,51630,51631,0,1,3
14737,2,2,51632,51632,51634,0,2,1
14738,5,2,51637,51637,51639,0,2,3
14739,2,3,51639,51639,51642,0,3,0
14740,1,1,51640,51642,51643,2,3,0
14741,6,3,51646,51646,51649,0,3,3
14742,4,2,51650,51650,51652,0,2,1
14743,1,1,51651,51652,51653,1,2,0
14744,5,2,51656,51656,51658,0,2,3
14745,2,3,51658,51658,51661,0,3,0
14746,6,1,51664,51664,51665,0,1,3
14747,1,3,51665,51665,51668,0,3,0
14748,1,2,51666,51668,51670,2,4,0
14749,3,2,51669,51670,51672,1,3,0
14750,2,3,51671,51672,51675,1,4,0
14751,4,3,51675,51675,51678,0,3,0
14752,6,3,51681,51681,51684,0,3,3
14753,5,3,51686,51686,51689,0,3,2
14754,1,1,51687,51689,51690,2,3,0
14755,2,3,51689,51690,51693,1,4,0
14756,2,1,51691,51693,51694,2,3,0
14757,6,3,51697,51697,51700,0,3,3
14758,1,2,51698,51700,51702,2,4,0
14759,5,1,51703,51703,51704,0,1,1
14760,6,3,51709,51709,51712,0,3,5
14761,3,1,51712,51712,51713,0,1,0
14762,6,2,51718,51718,51720,0,2,5
14763,3,2,51721,51721,51723,0,2,1
14764,2,3,51723,51723,51726,0,3,0
14765,4,2,51727,51727,51729,0,2,1
14766,5,1,51732,51732,51733,0,1,3
14767,6,3,51738,51738,51741,0,3,5
14768,2,2,51740,51741,51743,1,3,0
14769,5,2,51745,51745,51747,0,2,2
14770,1,2,51746,51747,51749,1,3,0
14771,2,2,51748,51749,51751,1,3,0
14772,5,1,51753,51753,51754,0,1,2
14773,4,3,51757,51757,51760,0,3,3
14774,6,1,51763,51763,51764,0,1,3
14775,2,2,51765,51765,51767,0,2,1
14776,3,3,51768,51768,51771,0,3,1
14777,6,3,51774,51774,51777,0,3,3
14778,1,2,51775,51777,51779,2,4,0
14779,5,1,51780,51780,51781,0,1,1
14780,2,1,51782,51782,51783,0,1,1
14781,3,1,51785,51785,51786,0,1,2
14782,6,3,51791,51791,51794,0,3,5
14783,1,1,51792,51794,51795,2,3,0
14784,2,1,51794,51795,51796,1,2,0
14785,5,2,51799,51799,51801,0,2,3
14786,3,3,51802,51802,51805,0,3,1
14787,5,3,51807,51807,51810,0,3,2
14788,1,1,51808,51810,51811,2,3,0
14789,4,3,51812,51812,51815,0,3,1
14790,2,2,51814,51815,51817,1,3,0
14791,4,3,51818,51818,51821,0,3,1
14792,2,1,51820,51821,51822,1,2,0
14793,1,2,51821,51822,51824,1,3,0
14794,6,1,51827,51827,51828,0,1,3
14795,5,2,51832,51832,51834,0,2,4
14796,1,3,51833,51834,51837,1,4,0
14797,1,2,51834,51837,51839,3,5,0
14798,4,1,51838,51839,51840,1,2,0
14799,5,3,51843,51843,51846,0,3,3
14800,2,2,51845,51846,51848,1,3,0
14801,5,2,51850,51850,51852,0,2,2
14802,5,3,51855,51855,51858,0,3,3
14803,3,2,51858,51858,51860,0,2,0
14804,5,2,51863,51863,51865,0,2,3
14805,1,3,51864,51865,51868,1,4,0
14806,2,3,51866,51868,51871,2,5,0
14807,3,3,51869,51871,51874,2,5,0
14808,4,3,51873,51874,51877,1,4,0
14809,2,1,51875,51877,51878,2,3,0
14810,5,2,51880,51880,51882,0,2,2
14811,5,1,51885,51885,51886,0,1,3
14812,6,1,51891,51891,51892,0,1,5
14813,6,3,51897,51897,51900,0,3,5
14814,6,3,51903,51903,51906,0,3,3
14815,3,1,51906,51906,51907,0,1,0
14816,5,3,51911,51911,51914,0,3,4
14817,6,3,51917,51917,51920,0,3,3
14818,6,3,51923,51923,51926,0,3,3
14819,4,3,51927,51927,51930,0,3,1
14820,4,3,51931,51931,51934,0,3,1
14821,6,2,51937,51937,51939,0,2,3
14822,2,3,51939,51939,51942,0,3,0
14823,6,1,51945,51945,51946,0,1,3
14824,2,2,51947,51947,51949,0,2,1
14825,4,2,51951,51951,51953,0,2,2
14826,1,2,51952,51953,51955,1,3,0
14827,6,3,51958,51958,51961,0,3,3
14828,1,3,51959,51961,51964,2,5,0
14829,2,2,51961,51964,51966,3,5,0
14830,5,1,51966,51966,51967,0,1,0
14831,5,3,51971,51971,51974,0,3,4
14832,6,1,51977,51977,51978,0,1,3
14833,2,1,51979,51979,51980,0,1,1
14834,5,1,51984,51984,51985,0,1,4
14835,3,2,51987,51987,51989,0,2,2
14836,5,3,51992,51992,51995,0,3,3
14837,6,1,51998,51998,51999,0,1,3
14838,3,3,52001,52001,52004,0,3,2
14839,3,2,52004,52004,52006,0,2,0
14840,5,1,52009,52009,52010,0,1,3
14841,5,2,52014,52014,52016,0,2,4
14842,6,3,52020,52020,52023,0,3,4
14843,3,2,52023,52023,52025,0,2,0
14844,6,3,52029,52029,52032,0,3,4
14845,1,2,52030,52032,52034,2,4,0
14846,3,2,52033,52034,52036,1,3,0
14847,4,3,52037,52037,52040,0,3,1
14848,1,2,52038,52040,52042,2,4,0
14849,2,3,52040,52042,52045,2,5,0
14850,1,1,52041,52045,52046,4,5,0
14851,1,2,52042,52046,52048,4,6,0
14852,2,3,52044,52048,52051,4,7,0
14853,1,2,52045,52051,52053,6,8,0
14854,6,1,52051,52053,52054,2,3,0
14855,5,3,52056,52056,52059,0,3,2
14856,4,1,52060,52060,52061,0,1,1
14857,2,3,52062,52062,52065,0,3,1
14858,6,2,52068,52068,52070,0,2,3
14859,6,3,52074,52074,52077,0,3,4
14860,3,2,52077,52077,52079,0,2,0
14861,4,3,52081,52081,52084,0,3,2
14862,5,1,52086,52086,52087,0,1,2
14863,3,3,52089,52089,52092,0,3,2
14864,4,2,52093,52093,52095,0,2,1
14865,4,1,52097,52097,52098,0,1,2
14866,6,3,52103,52103,52106,0,3,5
14867,4,3,52107,52107,52110,0,3,1
14868,1,3,52108,52110,52113,2,5,0
14869,1,1,52109,52113,52114,4,5,0
14870,2,3,52111,52114,52117,3,6,0
14871,4,2,52115,52117,52119,2,4,0
14872,4,2,52119,52119,52121,0,2,0
14873,1,2,52120,52121,52123,1,3,0
14874,4,3,52124,52124,52127,0,3,1
14875,4,3,52128,52128,52131,0,3,1
14876,4,2,52132,52132,52134,0,2,1
14877,3,2,52135,52135,52137,0,2,1
14878,3,2,52138,52138,52140,0,2,1
14879,4,1,52142,52142,52143,0,1,2
14880,1,3,52143,52143,52146,0,3,0
14881,1,3,52144,52146,52149,2,5,0
14882,1,2,52145,52149,52151,4,6,0
14883,3,2,52148,52151,52153,3,5,0
14884,5,3,52153,52153,52156,0,3,0
14885,6,2,52159,52159,52161,0,2,3
14886,1,2,52160,52161,52163,1,3,0
14887,5,2,52165,52165,52167,0,2,2
14888,1,1,52166,52167,52168,1,2,0
14889,6,2,52172,52172,52174,0,2,4
14890,2,2,52174,52174,52176,0,2,0
14891,5,3,52179,52179,52182,0,3,3
14892,4,2,52183,52183,52185,0,2,1
14893,1,1,52184,52185,52186,1,2,0
14894,2,1,52186,52186,52187,0,1,0
14895,3,1,52189,52189,52190,0,1,2
14896,1,3,52190,52190,52193,0,3,0
14897,3,2,52193,52193,52195,0,2,0
14898,4,1,52197,52197,52198,0,1,2
14899,6,2,52203,52203,52205,0,2,5
14900,3,1,52206,52206,52207,0,1,1
14901,3,1,52209,52209,52210,0,1,2
14902,4,1,52213,52213,52214,0,1,3
14903,2,3,52215,52215,52218,0,3,1
14904,3,2,52218,52218,52220,0,2,0
14905,3,2,52221,52221,52223,0,2,1
14906,4,2,52225,52225,52227,0,2,2
14907,6,1,52231,52231,52232,0,1,4
14908,5,2,52236,52236,52238,0,2,4
14909,6,3,52242,52242,52245,0,3,4
14910,3,2,52245,52245,52247,0,2,0
14911,4,1,52249,52249,52250,0,1,2
14912,3,2,52252,52252,52254,0,2,2
14913,6,1,52258,52258,52259,0,1,4
14914,1,3,52259,52259,52262,0,3,0
14915,1,3,52260,52262,52265,2,5,0
14916,2,2,52262,52265,52267,3,5,0
14917,1,1,52263,52267,52268,4,5,0
14918,3,2,52266,52268,52270,2,4,0
14919,4,3,52270,52270,52273,0,3,0
14920,3,2,52273,52273,52275,0,2,0
14921,4,2,52277,52277,52279,0,2,2
14922,2,2,52279,52279,52281,0,2,0
14923,5,1,52284,52284,52285,0,1,3
14924,4,3,52288,52288,52291,0,3,3
14925,3,1,52291,52291,52292,0,1,0
14926,6,2,52297,52297,52299,0,2,5
14927,3,2,52300,52300,52302,0,2,1
14928,1,1,52301,52302,52303,1,2,0
14929,2,1,52303,52303,52304,0,1,0
14930,5,2,52308,52308,52310,0,2,4
14931,2,1,52310,52310,52311,0,1,0
14932,3,3,52313,52313,52316,0,3,2
14933,2,3,52315,52316,52319,1,4,0
14934,5,3,52320,52320,52323,0,3,1
14935,4,3,52324,52324,52327,0,3,1
14936,4,1,52328,52328,52329,0,1,1
14937,1,1,52329,52329,52330,0,1,0
14938,5,1,52334,52334,52335,0,1,4
14939,3,2,52337,52337,52339,0,2,2
14940,6,1,52343,52343,52344,0,1,4
14941,2,1,52345,52345,52346,0,1,1
14942,2,2,52347,52347,52349,0,2,1
14943,6,2,52353,52353,52355,0,2,4
14944,3,2,52356,52356,52358,0,2,1
14945,2,1,52358,52358,52359,0,1,0
14946,2,3,52360,52360,52363,0,3,1
14947,4,3,52364,52364,52367,0,3,1
14948,1,2,52365,52367,52369,2,4,0
14949,4,3,52369,52369,52372,0,3,0
14950,5,1,52374,52374,52375,0,1,2
14951,1,2,52375,52375,52377,0,2,0
14952,2,3,52377,52377,52380,0,3,0
14953,6,2,52383,52383,52385,0,2,3
14954,4,2,52387,52387,52389,0,2,2
14955,2,3,52389,52389,52392,0,3,0
14956,2,2,52391,52392,52394,1,3,0
14957,1,2,52392,52394,52396,2,4,0
14958,6,3,52398,52398,52401,0,3,2
14959,1,1,52399,52401,52402,2,3,0
14960,2,3,52401,52402,52405,1,4,0
14961,4,2,52405,52405,52407,0,2,0
14962,1,2,52406,52407,52409,1,3,0
14963,3,3,52409,52409,52412,0,3,0
14964,4,3,52413,52413,52416,0,3,1
14965,3,1,52416,52416,52417,0,1,0
14966,3,2,52419,52419,52421,0,2,2
14967,3,2,52422,52422,52424,0,2,1
14968,3,3,52425,52425,52428,0,3,1
14969,6,2,52431,52431,52433,0,2,3
14970,3,1,52434,52434,52435,0,1,1
14971,3,1,52437,52437,52438,0,1,2
14972,6,2,52443,52443,52445,0,2,5
14973,1,3,52444,52445,52448,1,4,0
14974,1,1,52445,52448,52449,3,4,0
14975,2,1,52447,52449,52450,2,3,0
14976,3,1,52450,52450,52451,0,1,0
14977,4,1,52454,52454,52455,0,1,3
14978,2,3,52456,52456,52459,0,3,1
14979,6,1,52462,52462,52463,0,1,3
14980,4,2,52466,52466,52468,0,2,3
14981,2,2,52468,52468,52470,0,2,0
14982,3,3,52471,52471,52474,0,3,1
14983,5,2,52476,52476,52478,0,2,2
14984,5,1,52481,52481,52482,0,1,3
14985,6,3,52487,52487,52490,0,3,5
14986,3,3,52490,52490,52493,0,3,0
14987,3,2,52493,52493,52495,0,2,0
14988,5,3,52498,52498,52501,0,3,3
14989,2,2,52500,52501,52503,1,3,0
14990,1,3,52501,52503,52506,2,5,0
14991,5,2,52506,52506,52508,0,2,0
14992,3,1,52509,52509,52510,0,1,1
14993,1,2,52510,52510,52512,0,2,0
14994,3,2,52513,52513,52515,0,2,1
14995,3,2,52516,52516,52518,0,2,1
14996,3,2,52519,52519,52521,0,2,1
14997,2,3,52521,52521,52524,0,3,0
14998,2,2,52523,52524,52526,1,3,0
14999,1,3,52524,52526,52529,2,5,0
15000,1,3,52525,52529,52532,4,7,0
15001,6,3,52531,52532,52535,1,4,0
15002,3,2,52534,52535,52537,1,3,0
15003,4,3,52538,52538,52541,0,3,1
15004,6,2,52544,52544,52546,0,2,3
15005,5,1,52549,52549,52550,0,1,3
15006,3,1,52552,52552,52553,0,1,2
15007,5,1,52557,52557,52558,0,1,4
15008,3,2,52560,52560,52562,0,2,2
15009,1,1,52561,52562,52563,1,2,0
15010,5,2,52566,52566,52568,0,2,3
15011,4,3,52570,52570,52573,0,3,2
15012,3,3,52573,52573,52576,0,3,0
15013,2,3,52575,52576,52579,1,4,0
15014,5,1,52580,52580,52581,0,1,1
15015,4,2,52584,52584,52586,0,2,3
15016,2,3,52586,52586,52589,0,3,0
15017,5,3,52591,52591,52594,0,3,2
15018,1,3,52592,52594,52597,2,5,0
15019,4,1,52596,52597,52598,1,2,0
15020,3,1,52599,52599,52600,0,1,1
15021,4,2,52603,52603,52605,0,2,3
15022,4,1,52607,52607,52608,0,1,2
15023,3,2,52610,52610,52612,0,2,2
15024,6,2,52616,52616,52618,0,2,4
15025,6,1,52622,52622,52623,0,1,4
15026,1,2,52623,52623,52625,0,2,0
15027,1,1,52624,52625,52626,1,2,0
15028,3,3,52627,52627,52630,0,3,1
15029,4,3,52631,52631,52634,0,3,1
15030,1,2,52632,52634,52636,2,4,0
15031,2,2,52634,52636,52638,2,4,0
15032,2,1,52636,52638,52639,2,3,0
15033,4,3,52640,52640,52643,0,3,1
15034,4,2,52644,52644,52646,0,2,1
15035,2,1,52646,52646,52647,0,1,0
15036,6,3,52652,52652,52655,0,3,5
15037,3,1,52655,52655,52656,0,1,0
15038,3,3,52658,52658,52661,0,3,2
15039,5,1,52663,52663,52664,0,1,2
15040,6,2,52669,52669,52671,0,2,5
15041,1,3,52670,52671,52674,1,4,0
15042,5,3,52675,52675,52678,0,3,1
15043,6,3,52681,52681,52684,0,3,3
15044,3,2,52684,52684,52686,0,2,0
15045,5,2,52689,52689,52691,0,2,3
15046,4,3,52693,52693,52696,0,3,2
15047,1,2,52694,52696,52698,2,4,0
15048,6,1,52700,52700,52701,0,1,2
15049,5,2,52705,52705,52707,0,2,4
15050,1,3,52706,52707,52710,1,4,0
15051,4,2,52710,52710,52712,0,2,0
15052,1,3,52711,52712,52715,1,4,0
15053,4,1,52715,52715,52716,0,1,0
15054,1,1,52716,52716,52717,0,1,0
15055,1,2,52717,52717,52719,0,2,0
15056,4,2,52721,52721,52723,0,2,2
15057,1,1,52722,52723,52724,1,2,0
15058,4,1,52726,52726,52727,0,1,2
15059,3,3,52729,52729,52732,0,3,2
15060,2,3,52731,52732,52735,1,4,0
15061,2,2,52733,52735,52737,2,4,0
15062,6,2,52739,52739,52741,0,2,2
15063,5,1,52744,52744,52745,0,1,3
15064,3,2,52747,52747,52749,0,2,2
15065,2,1,52749,52749,52750,0,1,0
15066,1,1,52750,52750,52751,0,1,0
15067,3,3,52753,52753,52756,0,3,2
15068,5,2,52758,52758,52760,0,2,2
15069,1,2,52759,52760,52762,1,3,0
15070,3,2,52762,52762,52764,0,2,0
15071,5,1,52767,52767,52768,0,1,3
15072,5,2,52772,52772,52774,0,2,4
15073,2,3,52774,52774,52777,0,3,0
15074,5,3,52779,52779,52782,0,3,2
15075,3,3,52782,52782,52785,0,3,0
15076,5,2,52787,52787,52789,0,2,2
15077,1,2,52788,52789,52791,1,3,0
15078,3,2,52791,52791,52793,0,2,0
15079,1,1,52792,52793,52794,1,2,0
15080,6,3,52798,52798,52801,0,3,4
15081,3,1,52801,52801,52802,0,1,0
15082,5,1,52806,52806,52807,0,1,4
15083,1,3,52807,52807,52810,0,3,0
15084,5,1,52812,52812,52813,0,1,2
15085,2,1,52814,52814,52815,0,1,1
15086,6,3,52820,52820,52823,0,3,5
15087,3,2,52823,52823,52825,0,2,0
15088,5,1,52828,52828,52829,0,1,3
15089,4,2,52832,52832,52834,0,2,3
15090,2,1,52834,52834,52835,0,1,0
15091,2,3,52836,52836,52839,0,3,1
15092,3,1,52839,52839,52840,0,1,0
15093,4,1,52843,52843,52844,0,1,3
15094,5,3,52848,52848,52851,0,3,4
15095,2,3,52850,52851,52854,1,4,0
15096,4,2,52854,52854,52856,0,2,0
15097,3,3,52857,52857,52860,0,3,1
15098,2,2,52859,52860,52862,1,3,0
15099,1,2,52860,52862,52864,2,4,0
15100,2,1,52862,52864,52865,2,3,0
15101,2,2,52864,52865,52867,1,3,0
15102,2,1,52866,52867,52868,1,2,0
15103,2,2,52868,52868,52870,0,2,0
15104,1,1,52869,52870,52871,1,2,0
15105,1,3,52870,52871,52874,1,4,0
15106,2,2,52872,52874,52876,2,4,0
15107,3,2,52875,52876,52878,1,3,0
15108,4,1,52879,52879,52880,0,1,1
15109,2,3,52881,52881,52884,0,3,1
15110,5,3,52886,52886,52889,0,3,2
15111,4,2,52890,52890,52892,0,2,1
15112,5,2,52895,52895,52897,0,2,3
15113,1,2,52896,52897,52899,1,3,0
15114,5,1,52901,52901,52902,0,1,2
15115,2,2,52903,52903,52905,0,2,1
15116,2,1,52905,52905,52906,0,1,0
15117,6,3,52911,52911,52914,0,3,5
15118,4,1,52915,52915,52916,0,1,1
15119,3,2,52918,52918,52920,0,2,2
15120,5,1,52923,52923,52924,0,1,3
15121,5,2,52928,52928,52930,0,2,4
15122,2,2,52930,52930,52932,0,2,0
15123,3,1,52933,52933,52934,0,1,1
15124,6,1,52939,52939,52940,0,1,5
15125,3,1,52942,52942,52943,0,1,2
15126,5,2,52947,52947,52949,0,2,4
15127,5,3,52952,52952,52955,0,3,3
15128,5,3,52957,52957,52960,0,3,2
15129,1,1,52958,52960,52961,2,3,0
15130,6,1,52964,52964,52965,0,1,3
15131,5,3,52969,52969,52972,0,3,4
15132,1,2,52970,52972,52974,2,4,0
15133,4,1,52974,52974,52975,0,1,0
15134,2,3,52976,52976,52979,0,3,1
15135,3,3,52979,52979,52982,0,3,0
15136,5,1,52984,52984,52985,0,1,2
15137,4,2,52988,52988,52990,0,2,3
15138,4,2,52992,52992,52994,0,2,2
15139,6,2,52998,52998,53000,0,2,4
15140,6,2,53004,53004,53006,0,2,4
15141,1,3,53005,53006,53009,1,4,0
15142,5,3,53010,53010,53013,0,3,1
15143,1,2,53011,53013,53015,2,4,0
15144,1,1,53012,53015,53016,3,4,0
15145,5,1,53017,53017,53018,0,1,1
15146,4,1,53021,53021,53022,0,1,3
15147,5,3,53026,53026,53029,0,3,4
15148,1,3,53027,53029,53032,2,5,0
15149,6,3,53033,53033,53036,0,3,1
15150,2,2,53035,53036,53038,1,3,0
15151,6,2,53041,53041,53043,0,2,3
15152,6,2,53047,53047,53049,0,2,4
15153,2,2,53049,53049,53051,0,2,0
15154,4,2,53053,53053,53055,0,2,2
15155,1,3,53054,53055,53058,1,4,0
15156,6,2,53060,53060,53062,0,2,2
15157,3,2,53063,53063,53065,0,2,1
15158,4,2,53067,53067,53069,0,2,2
15159,1,3,53068,53069,53072,1,4,0
15160,5,2,53073,53073,53075,0,2,1
15161,2,1,53075,53075,53076,0,1,0
15162,3,2,53078,53078,53080,0,2,2
15163,3,3,53081,53081,53084,0,3,1
15164,4,1,53085,53085,53086,0,1,1
15165,3,2,53088,53088,53090,0,2,2
15166,6,1,53094,53094,53095,0,1,4
15167,5,1,53099,53099,53100,0,1,4
15168,1,1,53100,53100,53101,0,1,0
15169,3,1,53103,53103,53104,0,1,2
15170,1,2,53104,53104,53106,0,2,0
15171,1,2,53105,53106,53108,1,3,0
15172,2,1,53107,53108,53109,1,2,0
15173,6,2,53113,53113,53115,0,2,4
15174,2,2,53115,53115,53117,0,2,0
15175,5,2,53120,53120,53122,0,2,3
15176,3,3,53123,53123,53126,0,3,1
15177,2,3,53125,53126,53129,1,4,0
15178,4,3,53129,53129,53132,0,3,0
15179,6,1,53135,53135,53136,0,1,3
15180,1,2,53136,53136,53138,0,2,0
15181,5,2,53141,53141,53143,0,2,3
15182,1,3,53142,53143,53146,1,4,0
15183,2,1,53144,53146,53147,2,3,0
15184,3,2,53147,53147,53149,0,2,0
15185,3,2,53150,53150,53152,0,2,1
15186,2,1,53152,53152,53153,0,1,0
15187,1,2,53153,53153,53155,0,2,0
15188,6,1,53159,53159,53160,0,1,4
15189,1,3,53160,53160,53163,0,3,0
15190,3,1,53163,53163,53164,0,1,0
15191,4,3,53167,53167,53170,0,3,3
15192,5,1,53172,53172,53173,0,1,2
15193,5,3,53177,53177,53180,0,3,4
15194,1,3,53178,53180,53183,2,5,0
15195,5,1,53183,53183,53184,0,1,0
15196,4,3,53187,53187,53190,0,3,3
15197,3,3,53190,53190,53193,0,3,0
15198,4,2,53194,53194,53196,0,2,1
15199,4,2,53198,53198,53200,0,2,2
15200,6,2,53204,53204,53206,0,2,4
15201,1,1,53205,53206,53207,1,2,0
15202,4,2,53209,53209,53211,0,2,2
15203,2,1,53211,53211,53212,0,1,0
15204,2,1,53213,53213,53214,0,1,1
15205,6,1,53219,53219,53220,0,1,5
15206,3,2,53222,53222,53224,0,2,2
15207,6,2,53228,53228,53230,0,2,4
15208,2,1,53230,53230,53231,0,1,0
15209,5,3,53235,53235,53238,0,3,4
15210,6,1,53241,53241,53242,0,1,3
15211,4,2,53245,53245,53247,0,2,3
15212,1,3,53246,53247,53250,1,4,0
15213,1,3,53247,53250,53253,3,6,0
15214,3,2,53250,53253,53255,3,5,0
15215,2,3,53252,53255,53258,3,6,0
15216,6,1,53258,53258,53259,0,1,0
15217,3,2,53261,53261,53263,0,2,2
15218,4,3,53265,53265,53268,0,3,2
15219,5,1,53270,53270,53271,0,1,2
15220,1,1,53271,53271,53272,0,1,0
15221,5,2,53276,53276,53278,0,2,4
15222,5,2,53281,53281,53283,0,2,3
15223,1,1,53282,53283,53284,1,2,0
15224,5,1,53287,53287,53288,0,1,3
15225,6,1,53293,53293,53294,0,1,5
15226,1,2,53294,53294,53296,0,2,0
15227,6,1,53300,53300,53301,0,1,4
15228,6,2,53306,53306,53308,0,2,5
15229,4,1,53310,53310,53311,0,1,2
15230,3,2,53313,53313,53315,0,2,2
15231,3,3,53316,53316,53319,0,3,1
15232,6,2,53322,53322,53324,0,2,3
15233,5,3,53327,53327,53330,0,3,3
15234,2,2,53329,53330,53332,1,3,0
15235,2,1,53331,53332,53333,1,2,0
15236,5,2,53336,53336,53338,0,2,3
15237,1,2,53337,53338,53340,1,3,0
15238,5,3,53342,53342,53345,0,3,2
15239,2,3,53344,53345,53348,1,4,0
15240,2,3,53346,53348,53351,2,5,0
15241,2,1,53348,53351,53352,3,4,0
15242,3,1,53351,53352,53353,1,2,0
15243,1,2,53352,53353,53355,1,3,0
15244,6,1,53358,53358,53359,0,1,3
15245,3,3,53361,53361,53364,0,3,2
15246,1,2,53362,53364,53366,2,4,0
15247,1,3,53363,53366,53369,3,6,0
15248,5,1,53368,53369,53370,1,2,0
15249,4,3,53372,53372,53375,0,3,2
15250,5,2,53377,53377,53379,0,2,2
15251,3,2,53380,53380,53382,0,2,1
15252,1,2,53381,53382,53384,1,3,0
15253,2,2,53383,53384,53386,1,3,0
15254,5,3,53388,53388,53391,0,3,2
15255,3,1,53391,53391,53392,0,1,0
15256,3,3,53394,53394,53397,0,3,2
15257,6,2,53400,53400,53402,0,2,3
15258,1,3,53401,53402,53405,1,4,0
15259,6,3,53407,53407,53410,0,3,2
15260,2,3,53409,53410,53413,1,4,0
15261,6,3,53415,53415,53418,0,3,2
15262,1,3,53416,53418,53421,2,5,0
15263,1,3,53417,53421,53424,4,7,0
15264,5,1,53422,53424,53425,2,3,0
15265,3,1,53425,53425,53426,0,1,0
15266,3,2,53428,53428,53430,0,2,2
15267,1,2,53429,53430,53432,1,3,0
15268,6,3,53435,53435,53438,0,3,3
15269,4,3,53439,53439,53442,0,3,1
15270,4,2,53443,53443,53445,0,2,1
15271,4,3,53447,53447,53450,0,3,2
15272,3,2,53450,53450,53452,0,2,0
15273,3,3,53453,53453,53456,0,3,1
15274,1,3,53454,53456,53459,2,5,0
15275,3,2,53457,53459,53461,2,4,0
15276,2,1,53459,53461,53462,2,3,0
15277,4,2,53463,53463,53465,0,2,1
15278,4,2,53467,53467,53469,0,2,2
15279,3,3,53470,53470,53473,0,3,1
15280,2,3,53472,53473,53476,1,4,0
15281,1,2,53473,53476,53478,3,5,0
15282,4,1,53477,53478,53479,1,2,0
15283,1,2,53478,53479,53481,1,3,0
15284,3,1,53481,53481,53482,0,1,0
15285,5,2,53486,53486,53488,0,2,4
15286,4,3,53490,53490,53493,0,3,2
15287,5,2,53495,53495,53497,0,2,2
15288,5,2,53500,53500,53502,0,2,3
15289,3,1,53503,53503,53504,0,1,1
15290,6,1,53509,53509,53510,0,1,5
15291,6,1,53515,53515,53516,0,1,5
15292,5,1,53520,53520,53521,0,1,4
15293,4,2,53524,53524,53526,0,2,3
15294,4,3,53528,53528,53531,0,3,2
15295,4,1,53532,53532,53533,0,1,1
15296,4,3,53536,53536,53539,0,3,3
15297,3,2,53539,53539,53541,0,2,0
15298,6,3,53545,53545,53548,0,3,4
15299,5,2,53550,53550,53552,0,2,2
15300,2,1,53552,53552,53553,0,1,0
15301,2,1,53554,53554,53555,0,1,1
15302,6,1,53560,53560,53561,0,1,5
15303,6,2,53566,53566,53568,0,2,5
15304,4,3,53570,53570,53573,0,3,2
15305,5,3,53575,53575,53578,0,3,2
15306,6,3,53581,53581,53584,0,3,3
15307,1,3,53582,53584,53587,2,5,0
15308,5,2,53587,53587,53589,0,2,0
15309,4,3,53591,53591,53594,0,3,2
15310,1,2,53592,53594,53596,2,4,0
15311,3,1,53595,53596,53597,1,2,0
15312,2,3,53597,53597,53600,0,3,0
15313,5,2,53602,53602,53604,0,2,2
15314,1,3,53603,53604,53607,1,4,0
15315,3,2,53606,53607,53609,1,3,0
15316,1,2,53607,53609,53611,2,4,0
15317,6,2,53613,53613,53615,0,2,2
15318,2,1,53615,53615,53616,0,1,0
15319,4,3,53619,53619,53622,0,3,3
15320,2,3,53621,53622,53625,1,4,0
15321,3,3,53624,53625,53628,1,4,0
15322,6,1,53630,53630,53631,0,1,2
15323,2,3,53632,53632,53635,0,3,1
15324,3,2,53635,53635,53637,0,2,0
15325,3,2,53638,53638,53640,0,2,1
15326,5,1,53643,53643,53644,0,1,3
15327,1,3,53644,53644,53647,0,3,0
15328,2,2,53646,53647,53649,1,3,0
15329,5,1,53651,53651,53652,0,1,2
15330,2,3,53653,53653,53656,0,3,1
15331,5,1,53658,53658,53659,0,1,2
15332,2,1,53660,53660,53661,0,1,1
15333,6,1,53666,53666,53667,0,1,5
15334,4,1,53670,53670,53671,0,1,3
15335,4,2,53674,53674,53676,0,2,3
15336,6,1,53680,53680,53681,0,1,4
15337,1,2,53681,53681,53683,0,2,0
15338,6,2,53687,53687,53689,0,2,4
15339,3,1,53690,53690,53691,0,1,1
15340,5,1,53695,53695,53696,0,1,4
15341,3,3,53698,53698,53701,0,3,2
15342,6,2,53704,53704,53706,0,2,3
15343,6,3,53710,53710,53713,0,3,4
15344,5,3,53715,53715,53718,0,3,2
15345,4,2,53719,53719,53721,0,2,1
15346,1,3,53720,53721,53724,1,4,0
15347,2,1,53722,53724,53725,2,3,0
15348,6,2,53728,53728,53730,0,2,3
15349,3,3,53731,53731,53734,0,3,1
15350,2,2,53733,53734,53736,1,3,0
15351,1,2,53734,53736,53738,2,4,0
15352,1,2,53735,53738,53740,3,5,0
15353,1,3,53736,53740,53743,4,7,0
15354,3,3,53739,53743,53746,4,7,0
15355,3,2,53742,53746,53748,4,6,0
15356,5,1,53747,53748,53749,1,2,0
15357,3,2,53750,53750,53752,0,2,1
15358,1,1,53751,53752,53753,1,2,0
15359,1,2,53752,53753,53755,1,3,0
15360,5,2,53757,53757,53759,0,2,2
15361,2,3,53759,53759,53762,0,3,0
15362,5,3,53764,53764,53767,0,3,2
15363,5,2,53769,53769,53771,0,2,2
15364,1,2,53770,53771,53773,1,3,0
15365,6,3,53776,53776,53779,0,3,3
15366,3,1,53779,53779,53780,0,1,0
15367,3,3,53782,53782,53785,0,3,2
15368,1,2,53783,53785,53787,2,4,0
15369,6,3,53789,53789,53792,0,3,2
15370,4,3,53793,53793,53796,0,3,1
15371,6,2,53799,53799,53801,0,2,3
15372,5,2,53804,53804,53806,0,2,3
15373,6,2,53810,53810,53812,0,2,4
15374,2,1,53812,53812,53813,0,1,0
15375,5,2,53817,53817,53819,0,2,4
15376,5,2,53822,53822,53824,0,2,3
15377,6,1,53828,53828,53829,0,1,4
15378,5,3,53833,53833,53836,0,3,4
15379,6,2,53839,53839,53841,0,2,3
15380,5,2,53844,53844,53846,0,2,3
15381,4,3,53848,53848,53851,0,3,2
15382,1,1,53849,53851,53852,2,3,0
15383,6,3,53855,53855,53858,0,3,3
15384,6,3,53861,53861,53864,0,3,3
15385,6,1,53867,53867,53868,0,1,3
15386,6,1,53873,53873,53874,0,1,5
15387,5,2,53878,53878,53880,0,2,4
15388,3,3,53881,53881,53884,0,3,1
15389,1,2,53882,53884,53886,2,4,0
15390,3,3,53885,53886,53889,1,4,0
15391,1,1,53886,53889,53890,3,4,0
15392,4,3,53890,53890,53893,0,3,0
15393,1,3,53891,53893,53896,2,5,0
15394,2,3,53893,53896,53899,3,6,0
15395,5,3,53898,53899,53902,1,4,0
15396,5,1,53903,53903,53904,0,1,1
15397,1,2,53904,53904,53906,0,2,0
15398,3,1,53907,53907,53908,0,1,1
15399,1,2,53908,53908,53910,0,2,0
15400,1,3,53909,53910,53913,1,4,0
15401,6,2,53915,53915,53917,0,2,2
15402,2,2,53917,53917,53919,0,2,0
15403,5,3,53922,53922,53925,0,3,3
15404,2,3,53924,53925,53928,1,4,0
15405,5,3,53929,53929,53932,0,3,1
15406,5,3,53934,53934,53937,0,3,2
15407,1,3,53935,53937,53940,2,5,0
15408,5,2,53940,53940,53942,0,2,0
15409,5,3,53945,53945,53948,0,3,3
15410,1,3,53946,53948,53951,2,5,0
15411,1,1,53947,53951,53952,4,5,0
15412,5,2,53952,53952,53954,0,2,0
15413,2,3,53954,53954,53957,0,3,0
15414,5,3,53959,53959,53962,0,3,2
15415,1,2,53960,53962,53964,2,4,0
15416,5,1,53965,53965,53966,0,1,1
15417,2,1,53967,53967,53968,0,1,1
15418,5,2,53972,53972,53974,0,2,4
15419,1,1,53973,53974,53975,1,2,0
15420,2,1,53975,53975,53976,0,1,0
15421,5,1,53980,53980,53981,0,1,4
15422,2,2,53982,53982,53984,0,2,1
15423,1,2,53983,53984,53986,1,3,0
15424,2,2,53985,53986,53988,1,3,0
15425,4,2,53989,53989,53991,0,2,1
15426,3,1,53992,53992,53993,0,1,1
15427,6,3,53998,53998,54001,0,3,5
15428,3,1,54001,54001,54002,0,1,0
15429,2,1,54003,54003,54004,0,1,1
15430,5,2,54008,54008,54010,0,2,4
15431,4,3,54012,54012,54015,0,3,2
15432,4,2,54016,54016,54018,0,2,1
15433,3,3,54019,54019,54022,0,3,1
15434,3,2,54022,54022,54024,0,2,0
15435,4,1,54026,54026,54027,0,1,2
15436,6,2,54032,54032,54034,0,2,5
15437,1,1,54033,54034,54035,1,2,0
15438,6,2,54039,54039,54041,0,2,4
15439,1,1,54040,54041,54042,1,2,0
15440,3,2,54043,54043,54045,0,2,1
15441,4,3,54047,54047,54050,0,3,2
15442,5,1,54052,54052,54053,0,1,2
15443,6,1,54058,54058,54059,0,1,5
15444,1,3,54059,54059,54062,0,3,0
15445,1,3,54060,54062,54065,2,5,0
15446,4,1,54064,54065,54066,1,2,0
15447,6,1,54070,54070,54071,0,1,4
15448,2,2,54072,54072,54074,0,2,1
15449,5,2,54077,54077,54079,0,2,3
15450,4,1,54081,54081,54082,0,1,2
15451,4,3,54085,54085,54088,0,3,3
15452,1,3,54086,54088,54091,2,5,0
15453,6,3,54092,54092,54095,0,3,1
15454,5,3,54097,54097,54100,0,3,2
15455,5,1,54102,54102,54103,0,1,2
15456,1,2,54103,54103,54105,0,2,0
15457,3,2,54106,54106,54108,0,2,1
15458,1,3,54107,54108,54111,1,4,0
15459,2,3,54109,54111,54114,2,5,0
15460,4,2,54113,54114,54116,1,3,0
15461,4,2,54117,54117,54119,0,2,1
15462,2,3,54119,54119,54122,0,3,0
15463,2,1,54121,54122,54123,1,2,0
15464,5,1,54126,54126,54127,0,1,3
15465,4,3,54130,54130,54133,0,3,3
15466,3,1,54133,54133,54134,0,1,0
15467,1,1,54134,54134,54135,0,1,0
15468,2,1,54136,54136,54137,0,1,1
15469,2,2,54138,54138,54140,0,2,1
15470,6,2,54144,54144,54146,0,2,4
15471,1,2,54145,54146,54148,1,3,0
15472,2,2,54147,54148,54150,1,3,0
15473,3,2,54150,54150,54152,0,2,0
15474,2,1,54152,54152,54153,0,1,0
15475,6,3,54158,54158,54161,0,3,5
15476,5,1,54163,54163,54164,0,1,2
15477,6,3,54169,54169,54172,0,3,5
15478,1,2,54170,54172,54174,2,4,0
15479,4,1,54174,54174,54175,0,1,0
15480,5,3,54179,54179,54182,0,3,4
15481,5,1,54184,54184,54185,0,1,2
15482,5,3,54189,54189,54192,0,3,4
15483,1,2,54190,54192,54194,2,4,0
15484,3,3,54193,54194,54197,1,4,0
15485,3,3,54196,54197,54200,1,4,0
15486,2,3,54198,54200,54203,2,5,0
15487,4,2,54202,54203,54205,1,3,0
15488,6,2,54208,54208,54210,0,2,3
15489,3,2,54211,54211,54213,0,2,1
15490,4,1,54215,54215,54216,0,1,2
15491,1,3,54216,54216,54219,0,3,0
15492,6,1,54222,54222,54223,0,1,3
15493,1,2,54223,54223,54225,0,2,0
15494,4,1,54227,54227,54228,0,1,2
15495,2,2,54229,54229,54231,0,2,1
15496,2,1,54231,54231,54232,0,1,0
15497,6,3,54237,54237,54240,0,3,5
15498,4,2,54241,54241,54243,0,2,1
15499,2,1,54243,54243,54244,0,1,0
15500,2,1,54245,54245,54246,0,1,1
15501,3,2,54248,54248,54250,0,2,2
15502,2,1,54250,54250,54251,0,1,0
15503,4,3,54254,54254,54257,0,3,3
15504,5,2,54259,54259,54261,0,2,2
15505,4,2,54263,54263,54265,0,2,2
15506,1,3,54264,54265,54268,1,4,0
15507,1,2,54265,54268,54270,3,5,0
15508,1,2,54266,54270,54272,4,6,0
15509,3,3,54269,54272,54275,3,6,0
15510,4,3,54273,54275,54278,2,5,0
15511,5,2,54278,54278,54280,0,2,0
15512,1,2,54279,54280,54282,1,3,0
15513,2,1,54281,54282,54283,1,2,0
15514,1,3,54282,54283,54286,1,4,0
15515,6,3,54288,54288,54291,0,3,2
15516,6,1,54294,54294,54295,0,1,3
15517,3,1,54297,54297,54298,0,1,2
15518,6,3,54303,54303,54306,0,3,5
15519,6,3,54309,54309,54312,0,3,3
15520,5,1,54314,54314,54315,0,1,2
15521,2,1,54316,54316,54317,0,1,1
15522,3,3,54319,54319,54322,0,3,2
15523,5,2,54324,54324,54326,0,2,2
15524,2,3,54326,54326,54329,0,3,0
15525,5,2,54331,54331,54333,0,2,2
15526,5,3,54336,54336,54339,0,3,3
15527,4,3,54340,54340,54343,0,3,1
15528,2,2,54342,54343,54345,1,3,0
15529,1,3,54343,54345,54348,2,5,0
15530,4,2,54347,54348,54350,1,3,0
15531,5,2,54352,54352,54354,0,2,2
15532,3,1,54355,54355,54356,0,1,1
15533,4,3,54359,54359,54362,0,3,3
15534,1,1,54360,54362,54363,2,3,0
15535,2,2,54362,54363,54365,1,3,0
15536,1,3,54363,54365,54368,2,5,0
15537,4,1,54367,54368,54369,1,2,0
15538,2,1,54369,54369,54370,0,1,0
15539,1,1,54370,54370,54371,0,1,0
15540,4,1,54374,54374,54375,0,1,3
15541,1,1,54375,54375,54376,0,1,0
15542,3,1,54378,54378,54379,0,1,2
15543,3,3,54381,54381,54384,0,3,2
15544,1,2,54382,54384,54386,2,4,0
15545,6,2,54388,54388,54390,0,2,2
15546,3,3,54391,54391,54394,0,3,1
15547,3,3,54394,54394,54397,0,3,0
15548,1,3,54395,54397,54400,2,5,0
15549,4,1,54399,54400,54401,1,2,0
15550,5,1,54404,54404,54405,0,1,3
15551,4,1,54408,54408,54409,0,1,3
15552,1,3,54409,54409,54412,0,3,0
15553,3,3,54412,54412,54415,0,3,0
15554,3,1,54415,54415,54416,0,1,0
15555,2,2,54417,54417,54419,0,2,1
15556,3,2,54420,54420,54422,0,2,1
15557,6,1,54426,54426,54427,0,1,4
15558,3,2,54429,54429,54431,0,2,2
15559,3,2,54432,54432,54434,0,2,1
15560,4,2,54436,54436,54438,0,2,2
15561,1,3,54437,54438,54441,1,4,0
15562,3,3,54440,54441,54444,1,4,0
15563,5,3,54445,54445,54448,0,3,1
15564,6,3,54451,54451,54454,0,3,3
15565,6,2,54457,54457,54459,0,2,3
15566,1,3,54458,54459,54462,1,4,0
15567,1,1,54459,54462,54463,3,4,0
15568,1,3,54460,54463,54466,3,6,0
15569,5,3,54465,54466,54469,1,4,0
15570,3,3,54468,54469,54472,1,4,0
15571,5,2,54473,54473,54475,0,2,1
15572,5,2,54478,54478,54480,0,2,3
15573,1,3,54479,54480,54483,1,4,0
15574,2,3,54481,54483,54486,2,5,0
15575,5,3,54486,54486,54489,0,3,0
15576,4,3,54490,54490,54493,0,3,1
15577,5,3,54495,54495,54498,0,3,2
15578,4,2,54499,54499,54501,0,2,1
15579,1,1,54500,54501,54502,1,2,0
15580,4,2,54504,54504,54506,0,2,2
15581,4,2,54508,54508,54510,0,2,2
15582,5,2,54513,54513,54515,0,2,3
15583,6,1,54519,54519,54520,0,1,4
15584,4,1,54523,54523,54524,0,1,3
15585,1,2,54524,54524,54526,0,2,0
15586,4,2,54528,54528,54530,0,2,2
15587,6,1,54534,54534,54535,0,1,4
15588,1,1,54535,54535,54536,0,1,0
15589,3,2,54538,54538,54540,0,2,2
15590,4,1,54542,54542,54543,0,1,2
15591,5,1,54547,54547,54548,0,1,4
15592,5,2,54552,54552,54554,0,2,4
15593,6,2,54558,54558,54560,0,2,4
15594,2,3,54560,54560,54563,0,3,0
15595,6,1,54566,54566,54567,0,1,3
15596,4,1,54570,54570,54571,0,1,3
15597,5,1,54575,54575,54576,0,1,4
15598,6,1,54581,54581,54582,0,1,5
15599,2,3,54583,54583,54586,0,3,1
15600,2,2,54585,54586,54588,1,3,0
15601,1,3,54586,54588,54591,2,5,0
15602,5,1,54591,54591,54592,0,1,0
15603,1,3,54592,54592,54595,0,3,0
15604,2,1,54594,54595,54596,1,2,0
15605,5,1,54599,54599,54600,0,1,3
15606,6,1,54605,54605,54606,0,1,5
15607,3,1,54608,54608,54609,0,1,2
15608,6,1,54614,54614,54615,0,1,5
15609,6,2,54620,54620,54622,0,2,5
15610,2,2,54622,54622,54624,0,2,0
15611,1,2,54623,54624,54626,1,3,0
15612,2,2,54625,54626,54628,1,3,0
15613,1,2,54626,54628,54630,2,4,0
15614,3,2,54629,54630,54632,1,3,0
15615,3,2,54632,54632,54634,0,2,0
15616,3,2,54635,54635,54637,0,2,1
15617,6,1,54641,54641,54642,0,1,4
15618,3,2,54644,54644,54646,0,2,2
15619,3,3,54647,54647,54650,0,3,1
15620,5,2,54652,54652,54654,0,2,2
15621,6,3,54658,54658,54661,0,3,4
15622,4,3,54662,54662,54665,0,3,1
15623,1,3,54663,54665,54668,2,5,0
15624,2,2,54665,54668,54670,3,5,0
15625,2,3,54667,54670,54673,3,6,0
15626,6,2,54673,54673,54675,0,2,0
15627,1,1,54674,54675,54676,1,2,0
15628,1,1,54675,54676,54677,1,2,0
15629,5,1,54680,54680,54681,0,1,3
15630,1,2,54681,54681,54683,0,2,0
15631,2,3,54683,54683,54686,0,3,0
15632,1,2,54684,54686,54688,2,4,0
15633,4,3,54688,54688,54691,0,3,0
15634,6,2,54694,54694,54696,0,2,3
15635,5,1,54699,54699,54700,0,1,3
15636,3,3,54702,54702,54705,0,3,2
15637,6,3,54708,54708,54711,0,3,3
15638,6,3,54714,54714,54717,0,3,3
15639,3,3,54717,54717,54720,0,3,0
15640,4,3,54721,54721,54724,0,3,1
15641,1,1,54722,54724,54725,2,3,0
15642,2,3,54724,54725,54728,1,4,0
15643,3,1,54727,54728,54729,1,2,0
15644,3,3,54730,54730,54733,0,3,1
15645,3,3,54733,54733,54736,0,3,0
15646,2,2,54735,54736,54738,1,3,0
15647,5,1,54740,54740,54741,0,1,2
15648,5,3,54745,54745,54748,0,3,4
15649,2,3,54747,54748,54751,1,4,0
15650,6,3,54753,54753,54756,0,3,2
15651,4,2,54757,54757,54759,0,2,1
15652,6,2,54763,54763,54765,0,2,4
15653,6,1,54769,54769,54770,0,1,4
15654,4,3,54773,54773,54776,0,3,3
15655,3,1,54776,54776,54777,0,1,0
15656,5,3,54781,54781,54784,0,3,4
15657,2,1,54783,54784,54785,1,2,0
15658,3,3,54786,54786,54789,0,3,1
15659,2,2,54788,54789,54791,1,3,0
15660,2,1,54790,54791,54792,1,2,0
15661,4,2,54794,54794,54796,0,2,2
15662,4,1,54798,54798,54799,0,1,2
15663,4,2,54802,54802,54804,0,2,3
15664,1,1,54803,54804,54805,1,2,0
15665,6,1,54809,54809,54810,0,1,4
15666,5,1,54814,54814,54815,0,1,4
15667,3,1,54817,54817,54818,0,1,2
15668,2,1,54819,54819,54820,0,1,1
15669,4,3,54823,54823,54826,0,3,3
15670,2,3,54825,54826,54829,1,4,0
15671,4,3,54829,54829,54832,0,3,0
15672,5,2,54834,54834,54836,0,2,2
15673,3,2,54837,54837,54839,0,2,1
15674,4,2,54841,54841,54843,0,2,2
15675,3,1,54844,54844,54845,0,1,1
15676,3,1,54847,54847,54848,0,1,2
15677,1,2,54848,54848,54850,0,2,0
15678,5,2,54853,54853,54855,0,2,3
15679,3,2,54856,54856,54858,0,2,1
15680,1,2,54857,54858,54860,1,3,0
15681,5,2,54862,54862,54864,0,2,2
15682,1,1,54863,54864,54865,1,2,0
15683,2,2,54865,54865,54867,0,2,0
15684,3,3,54868,54868,54871,0,3,1
15685,4,1,54872,54872,54873,0,1,1
15686,2,2,54874,54874,54876,0,2,1
15687,4,1,54878,54878,54879,0,1,2
15688,5,3,54883,54883,54886,0,3,4
15689,2,2,54885,54886,54888,1,3,0
15690,5,2,54890,54890,54892,0,2,2
15691,2,2,54892,54892,54894,0,2,0
15692,2,3,54894,54894,54897,0,3,0
15693,4,1,54898,54898,54899,0,1,1
15694,4,1,54902,54902,54903,0,1,3
15695,2,3,54904,54904,54907,0,3,1
15696,2,2,54906,54907,54909,1,3,0
15697,6,1,54912,54912,54913,0,1,3
15698,6,3,54918,54918,54921,0,3,5
15699,2,2,54920,54921,54923,1,3,0
15700,1,1,54921,54923,54924,2,3,0
15701,4,1,54925,54925,54926,0,1,1
15702,4,2,54929,54929,54931,0,2,3
15703,5,3,54934,54934,54937,0,3,3
15704,1,2,54935,54937,54939,2,4,0
15705,2,3,54937,54939,54942,2,5,0
15706,5,2,54942,54942,54944,0,2,0
15707,1,2,54943,54944,54946,1,3,0
15708,1,1,54944,54946,54947,2,3,0
15709,6,3,54950,54950,54953,0,3,3
15710,2,2,54952,54953,54955,1,3,0
15711,5,1,54957,54957,54958,0,1,2
15712,6,2,54963,54963,54965,0,2,5
15713,2,1,54965,54965,54966,0,1,0
15714,4,2,54969,54969,54971,0,2,3
15715,3,2,54972,54972,54974,0,2,1
15716,4,1,54976,54976,54977,0,1,2
15717,3,3,54979,54979,54982,0,3,2
15718,1,1,54980,54982,54983,2,3,0
15719,3,1,54983,54983,54984,0,1,0
15720,5,1,54988,54988,54989,0,1,4
15721,3,2,54991,54991,54993,0,2,2
15722,1,1,54992,54993,54994,1,2,0
15723,1,3,54993,54994,54997,1,4,0
15724,2,3,54995,54997,55000,2,5,0
15725,1,1,54996,55000,55001,4,5,0
15726,6,2,55002,55002,55004,0,2,1
15727,1,1,55003,55004,55005,1,2,0
15728,3,1,55006,55006,55007,0,1,1
15729,1,2,55007,55007,55009,0,2,0
15730,3,1,55010,55010,55011,0,1,1
15731,1,2,55011,55011,55013,0,2,0
15732,1,2,55012,55013,55015,1,3,0
15733,3,3,55015,55015,55018,0,3,0
15734,2,2,55017,55018,55020,1,3,0
15735,3,2,55020,55020,55022,0,2,0
15736,6,2,55026,55026,55028,0,2,4
15737,2,2,55028,55028,55030,0,2,0
15738,6,3,55034,55034,55037,0,3,4
15739,2,2,55036,55037,55039,1,3,0
15740,4,2,55040,55040,55042,0,2,1
15741,6,2,55046,55046,55048,0,2,4
15742,5,3,55051,55051,55054,0,3,3
15743,6,3,55057,55057,55060,0,3,3
15744,2,3,55059,55060,55063,1,4,0
15745,3,2,55062,55063,55065,1,3,0
15746,4,3,55066,55066,55069,0,3,1
15747,3,2,55069,55069,55071,0,2,0
15748,3,2,55072,55072,55074,0,2,1
15749,4,2,55076,55076,55078,0,2,2
15750,4,1,55080,55080,55081,0,1,2
15751,4,3,55084,55084,55087,0,3,3
15752,1,2,55085,55087,55089,2,4,0
15753,6,3,55091,55091,55094,0,3,2
15754,4,1,55095,55095,55096,0,1,1
15755,5,3,55100,55100,55103,0,3,4
15756,3,2,55103,55103,55105,0,2,0
15757,1,1,55104,55105,55106,1,2,0
15758,6,2,55110,55110,55112,0,2,4
15759,6,2,55116,55116,55118,0,2,4
15760,5,2,55121,55121,55123,0,2,3
15761,5,1,55126,55126,55127,0,1,3
15762,1,2,55127,55127,55129,0,2,0
15763,6,1,55133,55133,55134,0,1,4
15764,4,3,55137,55137,55140,0,3,3
15765,5,1,55142,55142,55143,0,1,2
15766,6,1,55148,55148,55149,0,1,5
15767,5,1,55153,55153,55154,0,1,4
15768,6,2,55159,55159,55161,0,2,5
15769,4,2,55163,55163,55165,0,2,2
15770,2,2,55165,55165,55167,0,2,0
15771,3,2,55168,55168,55170,0,2,1
15772,5,3,55173,55173,55176,0,3,3
15773,4,3,55177,55177,55180,0,3,1
15774,1,3,55178,55180,55183,2,5,0
15775,6,3,55184,55184,55187,0,3,1
15776,4,3,55188,55188,55191,0,3,1
15777,6,1,55194,55194,55195,0,1,3
15778,4,2,55198,55198,55200,0,2,3
15779,6,2,55204,55204,55206,0,2,4
15780,2,1,55206,55206,55207,0,1,0
15781,1,2,55207,55207,55209,0,2,0
15782,6,3,55213,55213,55216,0,3,4
15783,5,1,55218,55218,55219,0,1,2
15784,3,2,55221,55221,55223,0,2,2
15785,2,3,55223,55223,55226,0,3,0
15786,6,2,55229,55229,55231,0,2,3
15787,2,1,55231,55231,55232,0,1,0
15788,2,2,55233,55233,55235,0,2,1
15789,4,3,55237,55237,55240,0,3,2
15790,5,2,55242,55242,55244,0,2,2
15791,5,2,55247,55247,55249,0,2,3
15792,4,3,55251,55251,55254,0,3,2
15793,2,3,55253,55254,55257,1,4,0
15794,1,2,55254,55257,55259,3,5,0
15795,4,1,55258,55259,55260,1,2,0
15796,5,3,55263,55263,55266,0,3,3
15797,5,2,55268,55268,55270,0,2,2
15798,5,1,55273,55273,55274,0,1,3
15799,1,3,55274,55274,55277,0,3,0
15800,2,2,55276,55277,55279,1,3,0
15801,1,1,55277,55279,55280,2,3,0
15802,5,3,55282,55282,55285,0,3,2
15803,5,2,55287,55287,55289,0,2,2
15804,3,2,55290,55290,55292,0,2,1
15805,1,2,55291,55292,55294,1,3,0
15806,2,2,55293,55294,55296,1,3,0
15807,3,3,55296,55296,55299,0,3,0
15808,3,2,55299,55299,55301,0,2,0
15809,1,3,55300,55301,55304,1,4,0
15810,5,2,55305,55305,55307,0,2,1
15811,6,3,55311,55311,55314,0,3,4
15812,5,3,55316,55316,55319,0,3,2
15813,2,2,55318,55319,55321,1,3,0
15814,5,2,55323,55323,55325,0,2,2
15815,6,1,55329,55329,55330,0,1,4
15816,5,1,55334,55334,55335,0,1,4
15817,6,2,55340,55340,55342,0,2,5
15818,6,3,55346,55346,55349,0,3,4
15819,4,1,55350,55350,55351,0,1,1
15820,2,1,55352,55352,55353,0,1,1
15821,2,1,55354,55354,55355,0,1,1
15822,4,1,55358,55358,55359,0,1,3
15823,4,2,55362,55362,55364,0,2,3
15824,4,3,55366,55366,55369,0,3,2
15825,2,3,55368,55369,55372,1,4,0
15826,2,2,55370,55372,55374,2,4,0
15827,5,3,55375,55375,55378,0,3,1
15828,4,3,55379,55379,55382,0,3,1
15829,3,1,55382,55382,55383,0,1,0
15830,2,2,55384,55384,55386,0,2,1
15831,3,1,55387,55387,55388,0,1,1
15832,1,3,55388,55388,55391,0,3,0
15833,4,3,55392,55392,55395,0,3,1
15834,6,1,55398,55398,55399,0,1,3
15835,2,2,55400,55400,55402,0,2,1
15836,5,1,55405,55405,55406,0,1,3
15837,3,3,55408,55408,55411,0,3,2
15838,1,3,55409,55411,55414,2,5,0
15839,2,3,55411,55414,55417,3,6,0
15840,5,2,55416,55417,55419,1,3,0
15841,5,1,55421,55421,55422,0,1,2
15842,2,3,55423,55423,55426,0,3,1
15843,6,2,55429,55429,55431,0,2,3
15844,6,2,55435,55435,55437,0,2,4
15845,3,1,55438,55438,55439,0,1,1
15846,5,3,55443,55443,55446,0,3,4
15847,3,2,55446,55446,55448,0,2,0
15848,3,1,55449,55449,55450,0,1,1
15849,5,3,55454,55454,55457,0,3,4
15850,3,3,55457,55457,55460,0,3,0
15851,3,2,55460,55460,55462,0,2,0
15852,2,1,55462,55462,55463,0,1,0
15853,6,3,55468,55468,55471,0,3,5
15854,6,2,55474,55474,55476,0,2,3
15855,5,1,55479,55479,55480,0,1,3
15856,2,1,55481,55481,55482,0,1,1
15857,3,2,55484,55484,55486,0,2,2
15858,4,3,55488,55488,55491,0,3,2
15859,5,3,55493,55493,55496,0,3,2
15860,6,3,55499,55499,55502,0,3,3
15861,5,3,55504,55504,55507,0,3,2
15862,5,1,55509,55509,55510,0,1,2
15863,2,2,55511,55511,55513,0,2,1
15864,5,3,55516,55516,55519,0,3,3
15865,2,3,55518,55519,55522,1,4,0
15866,2,1,55520,55522,55523,2,3,0
15867,1,2,55521,55523,55525,2,4,0
15868,4,2,55525,55525,55527,0,2,0
15869,5,3,55530,55530,55533,0,3,3
15870,5,1,55535,55535,55536,0,1,2
15871,1,3,55536,55536,55539,0,3,0
15872,5,1,55541,55541,55542,0,1,2
15873,6,3,55547,55547,55550,0,3,5
15874,6,3,55553,55553,55556,0,3,3
15875,4,1,55557,55557,55558,0,1,1
15876,3,3,55560,55560,55563,0,3,2
15877,2,1,55562,55563,55564,1,2,0
15878,4,3,55566,55566,55569,0,3,2
15879,3,3,55569,55569,55572,0,3,0
15880,5,2,55574,55574,55576,0,2,2
15881,6,2,55580,55580,55582,0,2,4
15882,4,3,55584,55584,55587,0,3,2
15883,3,1,55587,55587,55588,0,1,0
15884,3,3,55590,55590,55593,0,3,2
15885,1,3,55591,55593,55596,2,5,0
15886,5,1,55596,55596,55597,0,1,0
15887,5,1,55601,55601,55602,0,1,4
15888,4,3,55605,55605,55608,0,3,3
15889,2,1,55607,55608,55609,1,2,0
15890,6,3,55613,55613,55616,0,3,4
15891,6,1,55619,55619,55620,0,1,3
15892,3,1,55622,55622,55623,0,1,2
15893,2,1,55624,55624,55625,0,1,1
15894,1,2,55625,55625,55627,0,2,0
15895,4,3,55629,55629,55632,0,3,2
15896,6,1,55635,55635,55636,0,1,3
15897,1,3,55636,55636,55639,0,3,0
15898,3,2,55639,55639,55641,0,2,0
15899,2,1,55641,55641,55642,0,1,0
15900,4,1,55645,55645,55646,0,1,3
15901,2,3,55647,55647,55650,0,3,1
15902,6,2,55653,55653,55655,0,2,3
15903,6,2,55659,55659,55661,0,2,4
15904,6,2,55665,55665,55667,0,2,4
15905,3,1,55668,55668,55669,0,1,1
15906,5,2,55673,55673,55675,0,2,4
15907,3,1,55676,55676,55677,0,1,1
15908,6,3,55682,55682,55685,0,3,5
15909,1,1,55683,55685,55686,2,3,0
15910,4,1,55687,55687,55688,0,1,1
15911,3,1,55690,55690,55691,0,1,2
15912,1,1,55691,55691,55692,0,1,0
15913,2,3,55693,55693,55696,0,3,1
15914,6,1,55699,55699,55700,0,1,3
15915,2,2,55701,55701,55703,0,2,1
15916,5,1,55706,55706,55707,0,1,3
15917,4,1,55710,55710,55711,0,1,3
15918,2,2,55712,55712,55714,0,2,1
15919,6,1,55718,55718,55719,0,1,4
15920,4,1,55722,55722,55723,0,1,3
15921,2,1,55724,55724,55725,0,1,1
15922,5,2,55729,55729,55731,0,2,4
15923,2,1,55731,55731,55732,0,1,0
15924,6,1,55737,55737,55738,0,1,5
15925,3,1,55740,55740,55741,0,1,2
15926,6,2,55746,55746,55748,0,2,5
15927,1,3,55747,55748,55751,1,4,0
15928,5,1,55752,55752,55753,0,1,1
15929,4,3,55756,55756,55759,0,3,3
15930,3,1,55759,55759,55760,0,1,0
15931,3,2,55762,55762,55764,0,2,2
15932,6,2,55768,55768,55770,0,2,4
15933,1,2,55769,55770,55772,1,3,0
15934,4,3,55773,55773,55776,0,3,1
15935,6,3,55779,55779,55782,0,3,3
15936,1,2,55780,55782,55784,2,4,0
15937,2,1,55782,55784,55785,2,3,0
15938,5,1,55787,55787,55788,0,1,2
15939,2,2,55789,55789,55791,0,2,1
15940,6,2,55795,55795,55797,0,2,4
15941,5,1,55800,55800,55801,0,1,3
15942,5,3,55805,55805,55808,0,3,4
15943,5,2,55810,55810,55812,0,2,2
15944,1,2,55811,55812,55814,1,3,0
15945,1,1,55812,55814,55815,2,3,0
15946,4,1,55816,55816,55817,0,1,1
15947,3,2,55819,55819,55821,0,2,2
15948,5,2,55824,55824,55826,0,2,3
15949,4,1,55828,55828,55829,0,1,2
15950,4,3,55832,55832,55835,0,3,3
15951,5,1,55837,55837,55838,0,1,2
15952,4,3,55841,55841,55844,0,3,3
15953,1,1,55842,55844,55845,2,3,0
15954,1,3,55843,55845,55848,2,5,0
15955,3,3,55846,55848,55851,2,5,0
15956,1,1,55847,55851,55852,4,5,0
15957,1,2,55848,55852,55854,4,6,0
15958,5,2,55853,55854,55856,1,3,0
15959,1,1,55854,55856,55857,2,3,0
15960,5,2,55859,55859,55861,0,2,2
15961,3,1,55862,55862,55863,0,1,1
15962,6,1,55868,55868,55869,0,1,5
15963,2,1,55870,55870,55871,0,1,1
15964,3,1,55873,55873,55874,0,1,2
15965,1,1,55874,55874,55875,0,1,0
15966,1,1,55875,55875,55876,0,1,0
15967,4,2,55879,55879,55881,0,2,3
15968,6,2,55885,55885,55887,0,2,4
15969,4,1,55889,55889,55890,0,1,2
15970,6,1,55895,55895,55896,0,1,5
15971,1,3,55896,55896,55899,0,3,0
15972,2,2,55898,55899,55901,1,3,0
15973,4,1,55902,55902,55903,0,1,1
15974,5,3,55907,55907,55910,0,3,4
15975,2,3,55909,55910,55913,1,4,0
15976,4,3,55913,55913,55916,0,3,0
15977,6,2,55919,55919,55921,0,2,3
15978,3,3,55922,55922,55925,0,3,1
15979,3,1,55925,55925,55926,0,1,0
15980,6,2,55931,55931,55933,0,2,5
15981,6,2,55937,55937,55939,0,2,4
15982,2,3,55939,55939,55942,0,3,0
15983,2,3,55941,55942,55945,1,4,0
15984,2,2,55943,55945,55947,2,4,0
15985,2,3,55945,55947,55950,2,5,0
15986,2,3,55947,55950,55953,3,6,0
15987,3,1,55950,55953,55954,3,4,0
15988,3,2,55953,55954,55956,1,3,0
15989,6,1,55959,55959,55960,0,1,3
15990,6,1,55965,55965,55966,0,1,5
15991,3,3,55968,55968,55971,0,3,2
15992,2,2,55970,55971,55973,1,3,0
15993,5,1,55975,55975,55976,0,1,2
15994,3,2,55978,55978,55980,0,2,2
15995,3,1,55981,55981,55982,0,1,1
15996,5,3,55986,55986,55989,0,3,4
15997,3,1,55989,55989,55990,0,1,0
15998,2,2,55991,55991,55993,0,2,1
15999,5,2,55996,55996,55998,0,2,3
16000,6,3,56002,56002,56005,0,3,4
16001,2,1,56004,56005,56006,1,2,0
16002,1,3,56005,56006,56009,1,4,0
16003,6,2,56011,56011,56013,0,2,2
16004,2,1,56013,56013,56014,0,1,0
16005,6,2,56019,56019,56021,0,2,5
16006,1,1,56020,56021,56022,1,2,0
16007,3,3,56023,56023,56026,0,3,1
16008,3,2,56026,56026,56028,0,2,0
16009,5,1,56031,56031,56032,0,1,3
16010,2,2,56033,56033,56035,0,2,1
16011,3,3,56036,56036,56039,0,3,1
16012,3,2,56039,56039,56041,0,2,0
16013,6,3,56045,56045,56048,0,3,4
16014,6,1,56051,56051,56052,0,1,3
16015,2,2,56053,56053,56055,0,2,1
16016,3,2,56056,56056,56058,0,2,1
16017,3,1,56059,56059,56060,0,1,1
16018,3,1,56062,56062,56063,0,1,2
16019,5,2,56067,56067,56069,0,2,4
16020,4,3,56071,56071,56074,0,3,2
16021,6,1,56077,56077,56078,0,1,3
16022,2,1,56079,56079,56080,0,1,1
16023,4,1,56083,56083,56084,0,1,3
16024,2,3,56085,56085,56088,0,3,1
16025,3,2,56088,56088,56090,0,2,0
16026,1,3,56089,56090,56093,1,4,0
16027,4,3,56093,56093,56096,0,3,0
16028,5,1,56098,56098,56099,0,1,2
16029,3,2,56101,56101,56103,0,2,2
16030,2,1,56103,56103,56104,0,1,0
16031,5,2,56108,56108,56110,0,2,4
16032,6,2,56114,56114,56116,0,2,4
16033,6,3,56120,56120,56123,0,3,4
16034,4,3,56124,56124,56127,0,3,1
16035,2,2,56126,56127,56129,1,3,0
16036,4,2,56130,56130,56132,0,2,1
16037,3,3,56133,56133,56136,0,3,1
16038,3,2,56136,56136,56138,0,2,0
16039,4,2,56140,56140,56142,0,2,2
16040,6,1,56146,56146,56147,0,1,4
16041,3,1,56149,56149,56150,0,1,2
16042,1,2,56150,56150,56152,0,2,0
16043,6,1,56156,56156,56157,0,1,4
16044,1,1,56157,56157,56158,0,1,0
16045,4,3,56161,56161,56164,0,3,3
16046,1,2,56162,56164,56166,2,4,0
16047,3,1,56165,56166,56167,1,2,0
16048,1,2,56166,56167,56169,1,3,0
16049,2,3,56168,56169,56172,1,4,0
16050,3,3,56171,56172,56175,1,4,0
16051,6,3,56177,56177,56180,0,3,2
16052,4,2,56181,56181,56183,0,2,1
16053,1,2,56182,56183,56185,1,3,0
16054,5,2,56187,56187,56189,0,2,2
16055,1,3,56188,56189,56192,1,4,0
16056,3,1,56191,56192,56193,1,2,0
16057,6,3,56197,56197,56200,0,3,4
16058,3,3,56200,56200,56203,0,3,0
16059,4,2,56204,56204,56206,0,2,1
16060,6,2,56210,56210,56212,0,2,4
16061,3,1,56213,56213,56214,0,1,1
16062,2,3,56215,56215,56218,0,3,1
16063,3,3,56218,56218,56221,0,3,0
16064,3,1,56221,56221,56222,0,1,0
16065,3,1,56224,56224,56225,0,1,2
16066,4,2,56228,56228,56230,0,2,3
16067,2,3,56230,56230,56233,0,3,0
16068,1,1,56231,56233,56234,2,3,0
16069,5,2,56236,56236,56238,0,2,2
16070,5,2,56241,56241,56243,0,2,3
16071,2,3,56243,56243,56246,0,3,0
16072,1,1,56244,56246,56247,2,3,0
16073,1,1,56245,56247,56248,2,3,0
16074,3,2,56248,56248,56250,0,2,0
16075,2,1,56250,56250,56251,0,1,0
16076,3,1,56253,56253,56254,0,1,2
16077,6,2,56259,56259,56261,0,2,5
16078,3,2,56262,56262,56264,0,2,1
16079,6,3,56268,56268,56271,0,3,4
16080,2,3,56270,56271,56274,1,4,0
16081,6,2,56276,56276,56278,0,2,2
16082,2,2,56278,56278,56280,0,2,0
16083,1,2,56279,56280,56282,1,3,0
16084,3,2,56282,56282,56284,0,2,0
16085,2,3,56284,56284,56287,0,3,0
16086,4,1,56288,56288,56289,0,1,1
16087,6,1,56294,56294,56295,0,1,5
16088,1,1,56295,56295,56296,0,1,0
16089,2,3,56297,56297,56300,0,3,1
16090,5,2,56302,56302,56304,0,2,2
16091,6,2,56308,56308,56310,0,2,4
16092,4,1,56312,56312,56313,0,1,2
16093,5,1,56317,56317,56318,0,1,4
16094,1,2,56318,56318,56320,0,2,0
16095,6,3,56324,56324,56327,0,3,4
16096,6,1,56330,56330,56331,0,1,3
16097,1,2,56331,56331,56333,0,2,0
16098,3,2,56334,56334,56336,0,2,1
16099,6,2,56340,56340,56342,0,2,4
16100,1,1,56341,56342,56343,1,2,0
16101,2,2,56343,56343,56345,0,2,0
16102,1,1,56344,56345,56346,1,2,0
16103,2,3,56346,56346,56349,0,3,0
16104,6,3,56352,56352,56355,0,3,3
16105,3,3,56355,56355,56358,0,3,0
16106,3,2,56358,56358,56360,0,2,0
16107,4,2,56362,56362,56364,0,2,2
16108,6,1,56368,56368,56369,0,1,4
16109,5,1,56373,56373,56374,0,1,4
16110,5,1,56378,56378,56379,0,1,4
16111,5,2,56383,56383,56385,0,2,4
16112,3,2,56386,56386,56388,0,2,1
16113,4,2,56390,56390,56392,0,2,2
16114,6,1,56396,56396,56397,0,1,4
16115,3,2,56399,56399,56401,0,2,2
16116,1,3,56400,56401,56404,1,4,0
16117,1,1,56401,56404,56405,3,4,0
16118,1,3,56402,56405,56408,3,6,0
16119,5,2,56407,56408,56410,1,3,0
16120,5,1,56412,56412,56413,0,1,2
16121,2,3,56414,56414,56417,0,3,1
16122,2,1,56416,56417,56418,1,2,0
16123,5,3,56421,56421,56424,0,3,3
16124,3,2,56424,56424,56426,0,2,0
16125,6,2,56430,56430,56432,0,2,4
16126,3,3,56433,56433,56436,0,3,1
16127,3,3,56436,56436,56439,0,3,0
16128,2,3,56438,56439,56442,1,4,0
16129,2,2,56440,56442,56444,2,4,0
16130,6,1,56446,56446,56447,0,1,2
16131,3,3,56449,56449,56452,0,3,2
16132,4,1,56453,56453,56454,0,1,1
16133,4,2,56457,56457,56459,0,2,3
16134,2,2,56459,56459,56461,0,2,0
16135,4,1,56463,56463,56464,0,1,2
16136,4,2,56467,56467,56469,0,2,3
16137,1,1,56468,56469,56470,1,2,0
16138,4,2,56472,56472,56474,0,2,2
16139,2,3,56474,56474,56477,0,3,0
16140,6,1,56480,56480,56481,0,1,3
16141,1,3,56481,56481,56484,0,3,0
16142,3,2,56484,56484,56486,0,2,0
16143,5,1,56489,56489,56490,0,1,3
16144,6,2,56495,56495,56497,0,2,5
16145,4,2,56499,56499,56501,0,2,2
16146,4,3,56503,56503,56506,0,3,2
16147,4,2,56507,56507,56509,0,2,1
16148,3,1,56510,56510,56511,0,1,1
16149,6,1,56516,56516,56517,0,1,5
16150,6,1,56522,56522,56523,0,1,5
16151,1,3,56523,56523,56526,0,3,0
16152,3,3,56526,56526,56529,0,3,0
16153,6,2,56532,56532,56534,0,2,3
16154,2,1,56534,56534,56535,0,1,0
16155,1,3,56535,56535,56538,0,3,0
16156,3,2,56538,56538,56540,0,2,0
16157,5,1,56543,56543,56544,0,1,3
16158,6,1,56549,56549,56550,0,1,5
16159,2,2,56551,56551,56553,0,2,1
16160,1,1,56552,56553,56554,1,2,0
16161,3,1,56555,56555,56556,0,1,1
16162,1,3,56556,56556,56559,0,3,0
16163,5,1,56561,56561,56562,0,1,2
16164,4,1,56565,56565,56566,0,1,3
16165,2,1,56567,56567,56568,0,1,1
16166,5,2,56572,56572,56574,0,2,4
16167,4,3,56576,56576,56579,0,3,2
16168,2,2,56578,56579,56581,1,3,0
16169,3,1,56581,56581,56582,0,1,0
16170,4,2,56585,56585,56587,0,2,3
16171,1,1,56586,56587,56588,1,2,0
16172,3,1,56589,56589,56590,0,1,1
16173,6,2,56595,56595,56597,0,2,5
16174,2,3,56597,56597,56600,0,3,0
16175,1,3,56598,56600,56603,2,5,0
16176,3,2,56601,56603,56605,2,4,0
16177,2,3,56603,56605,56608,2,5,0
16178,1,1,56604,56608,56609,4,5,0
16179,5,2,56609,56609,56611,0,2,0
16180,3,3,56612,56612,56615,0,3,1
16181,3,2,56615,56615,56617,0,2,0
16182,2,1,56617,56617,56618,0,1,0
16183,1,2,56618,56618,56620,0,2,0
16184,3,1,56621,56621,56622,0,1,1
16185,5,1,56626,56626,56627,0,1,4
16186,4,2,56630,56630,56632,0,2,3
16187,5,1,56635,56635,56636,0,1,3
16188,5,2,56640,56640,56642,0,2,4
16189,2,3,56642,56642,56645,0,3,0
16190,1,3,56643,56645,56648,2,5,0
16191,6,1,56649,56649,56650,0,1,1
16192,2,2,56651,56651,56653,0,2,1
16193,1,3,56652,56653,56656,1,4,0
16194,4,3,56656,56656,56659,0,3,0
16195,2,3,56658,56659,56662,1,4,0
16196,2,2,56660,56662,56664,2,4,0
16197,4,3,56664,56664,56667,0,3,0
16198,2,3,56666,56667,56670,1,4,0
16199,4,2,56670,56670,56672,0,2,0
16200,5,1,56675,56675,56676,0,1,3
16201,6,1,56681,56681,56682,0,1,5
16202,1,2,56682,56682,56684,0,2,0
16203,2,3,56684,56684,56687,0,3,0
16204,1,3,56685,56687,56690,2,5,0
16205,6,2,56691,56691,56693,0,2,1
16206,3,3,56694,56694,56697,0,3,1
16207,1,3,56695,56697,56700,2,5,0
16208,4,3,56699,56700,56703,1,4,0
16209,3,3,56702,56703,56706,1,4,0
16210,2,3,56704,56706,56709,2,5,0
16211,1,3,56705,56709,56712,4,7,0
16212,4,1,56709,56712,56713,3,4,0
16213,3,3,56712,56713,56716,1,4,0
16214,4,3,56716,56716,56719,0,3,0
16215,3,2,56719,56719,56721,0,2,0
16216,4,1,56723,56723,56724,0,1,2
16217,4,2,56727,56727,56729,0,2,3
16218,4,1,56731,56731,56732,0,1,2
16219,4,1,56735,56735,56736,0,1,3
16220,2,2,56737,56737,56739,0,2,1
16221,1,2,56738,56739,56741,1,3,0
16222,6,2,56744,56744,56746,0,2,3
16223,5,3,56749,56749,56752,0,3,3
16224,5,2,56754,56754,56756,0,2,2
16225,1,2,56755,56756,56758,1,3,0
16226,1,2,56756,56758,56760,2,4,0
16227,2,1,56758,56760,56761,2,3,0
16228,2,2,56760,56761,56763,1,3,0
16229,6,1,56766,56766,56767,0,1,3
16230,2,1,56768,56768,56769,0,1,1
16231,1,2,56769,56769,56771,0,2,0
16232,3,2,56772,56772,56774,0,2,1
16233,2,1,56774,56774,56775,0,1,0
16234,4,2,56778,56778,56780,0,2,3
16235,3,2,56781,56781,56783,0,2,1
16236,1,1,56782,56783,56784,1,2,0
16237,2,3,56784,56784,56787,0,3,0
16238,6,1,56790,56790,56791,0,1,3
16239,4,2,56794,56794,56796,0,2,3
16240,6,3,56800,56800,56803,0,3,4
16241,5,3,56805,56805,56808,0,3,2
16242,1,1,56806,56808,56809,2,3,0
16243,2,2,56808,56809,56811,1,3,0
16244,2,1,56810,56811,56812,1,2,0
16245,4,2,56814,56814,56816,0,2,2
16246,5,3,56819,56819,56822,0,3,3
16247,1,1,56820,56822,56823,2,3,0
16248,1,3,56821,56823,56826,2,5,0
16249,5,2,56826,56826,56828,0,2,0
16250,3,1,56829,56829,56830,0,1,1
16251,2,1,56831,56831,56832,0,1,1
16252,6,3,56837,56837,56840,0,3,5
16253,1,1,56838,56840,56841,2,3,0
16254,4,2,56842,56842,56844,0,2,1
16255,4,1,56846,56846,56847,0,1,2
16256,4,2,56850,56850,56852,0,2,3
16257,4,1,56854,56854,56855,0,1,2
16258,2,3,56856,56856,56859,0,3,1
16259,3,1,56859,56859,56860,0,1,0
16260,2,1,56861,56861,56862,0,1,1
16261,1,2,56862,56862,56864,0,2,0
16262,5,1,56867,56867,56868,0,1,3
16263,5,3,56872,56872,56875,0,3,4
16264,2,3,56874,56875,56878,1,4,0
16265,2,3,56876,56878,56881,2,5,0
16266,6,1,56882,56882,56883,0,1,1
16267,1,3,56883,56883,56886,0,3,0
16268,6,3,56889,56889,56892,0,3,3
16269,3,3,56892,56892,56895,0,3,0
16270,2,3,56894,56895,56898,1,4,0
16271,3,2,56897,56898,56900,1,3,0
16272,1,2,56898,56900,56902,2,4,0
16273,6,1,56904,56904,56905,0,1,2
16274,2,3,56906,56906,56909,0,3,1
16275,3,1,56909,56909,56910,0,1,0
16276,5,3,56914,56914,56917,0,3,4
16277,2,1,56916,56917,56918,1,2,0
16278,3,2,56919,56919,56921,0,2,1
16279,4,3,56923,56923,56926,0,3,2
16280,4,3,56927,56927,56930,0,3,1
16281,6,1,56933,56933,56934,0,1,3
16282,2,2,56935,56935,56937,0,2,1
16283,4,2,56939,56939,56941,0,2,2
16284,5,2,56944,56944,56946,0,2,3
16285,4,1,56948,56948,56949,0,1,2
16286,6,1,56954,56954,56955,0,1,5
16287,4,2,56958,56958,56960,0,2,3
16288,6,2,56964,56964,56966,0,2,4
16289,3,2,56967,56967,56969,0,2,1
16290,1,2,56968,56969,56971,1,3,0
16291,3,2,56971,56971,56973,0,2,0
16292,1,2,56972,56973,56975,1,3,0
16293,4,1,56976,56976,56977,0,1,1
16294,4,3,56980,56980,56983,0,3,3
16295,2,3,56982,56983,56986,1,4,0
16296,5,1,56987,56987,56988,0,1,1
16297,2,1,56989,56989,56990,0,1,1
16298,2,1,56991,56991,56992,0,1,1
16299,6,2,56997,56997,56999,0,2,5
16300,5,3,57002,57002,57005,0,3,3
16301,5,2,57007,57007,57009,0,2,2
16302,6,1,57013,57013,57014,0,1,4
16303,1,3,57014,57014,57017,0,3,0
16304,2,1,57016,57017,57018,1,2,0
16305,5,2,57021,57021,57023,0,2,3
16306,6,3,57027,57027,57030,0,3,4
16307,5,1,57032,57032,57033,0,1,2
16308,3,2,57035,57035,57037,0,2,2
16309,3,2,57038,57038,57040,0,2,1
16310,1,3,57039,57040,57043,1,4,0
16311,3,3,57042,57043,57046,1,4,0
16312,6,1,57048,57048,57049,0,1,2
16313,3,3,57051,57051,57054,0,3,2
16314,2,2,57053,57054,57056,1,3,0
16315,6,3,57059,57059,57062,0,3,3
16316,1,3,57060,57062,57065,2,5,0
16317,3,3,57063,57065,57068,2,5,0
16318,4,2,57067,57068,57070,1,3,0
16319,4,3,57071,57071,57074,0,3,1
16320,6,2,57077,57077,57079,0,2,3
16321,2,3,57079,57079,57082,0,3,0
16322,6,2,57085,57085,57087,0,2,3
16323,4,3,57089,57089,57092,0,3,2
16324,6,1,57095,57095,57096,0,1,3
16325,6,1,57101,57101,57102,0,1,5
16326,1,2,57102,57102,57104,0,2,0
16327,6,1,57108,57108,57109,0,1,4
16328,6,2,57114,57114,57116,0,2,5
16329,6,3,57120,57120,57123,0,3,4
16330,4,2,57124,57124,57126,0,2,1
16331,2,1,57126,57126,57127,0,1,0
16332,6,3,57132,57132,57135,0,3,5
16333,6,2,57138,57138,57140,0,2,3
16334,4,2,57142,57142,57144,0,2,2
16335,1,3,57143,57144,57147,1,4,0
16336,1,2,57144,57147,57149,3,5,0
16337,3,2,57147,57149,57151,2,4,0
16338,5,3,57152,57152,57155,0,3,1
16339,6,2,57158,57158,57160,0,2,3
16340,4,2,57162,57162,57164,0,2,2
16341,6,1,57168,57168,57169,0,1,4
16342,3,2,57171,57171,57173,0,2,2
16343,6,2,57177,57177,57179,0,2,4
16344,4,1,57181,57181,57182,0,1,2
16345,3,3,57184,57184,57187,0,3,2
16346,2,1,57186,57187,57188,1,2,0
16347,4,2,57190,57190,57192,0,2,2
16348,2,1,57192,57192,57193,0,1,0
16349,3,1,57195,57195,57196,0,1,2
16350,2,2,57197,57197,57199,0,2,1
16351,5,3,57202,57202,57205,0,3,3
16352,5,2,57207,57207,57209,0,2,2
16353,6,1,57213,57213,57214,0,1,4
16354,5,3,57218,57218,57221,0,3,4
16355,1,3,57219,57221,57224,2,5,0
16356,2,2,57221,57224,57226,3,5,0
16357,1,2,57222,57226,57228,4,6,0
16358,1,3,57223,57228,57231,5,8,0
16359,5,2,57228,57231,57233,3,5,0
16360,5,1,57233,57233,57234,0,1,0
16361,1,1,57234,57234,57235,0,1,0
16362,3,2,57237,57237,57239,0,2,2
16363,4,1,57241,57241,57242,0,1,2
16364,4,1,57245,57245,57246,0,1,3
16365,1,1,57246,57246,57247,0,1,0
16366,4,2,57250,57250,57252,0,2,3
16367,4,3,57254,57254,57257,0,3,2
16368,6,1,57260,57260,57261,0,1,3
16369,1,1,57261,57261,57262,0,1,0
16370,5,3,57266,57266,57269,0,3,4
16371,5,1,57271,57271,57272,0,1,2
16372,6,1,57277,57277,57278,0,1,5
16373,3,1,57280,57280,57281,0,1,2
16374,1,3,57281,57281,57284,0,3,0
16375,5,1,57286,57286,57287,0,1,2
16376,5,3,57291,57291,57294,0,3,4
16377,5,2,57296,57296,57298,0,2,2
16378,5,1,57301,57301,57302,0,1,3
16379,3,2,57304,57304,57306,0,2,2
16380,3,2,57307,57307,57309,0,2,1
16381,3,2,57310,57310,57312,0,2,1
16382,2,1,57312,57312,57313,0,1,0
16383,1,2,57313,57313,57315,0,2,0
16384,2,1,57315,57315,57316,0,1,0
16385,4,3,57319,57319,57322,0,3,3
16386,1,1,57320,57322,57323,2,3,0
16387,1,3,57321,57323,57326,2,5,0
16388,1,2,57322,57326,57328,4,6,0
16389,1,1,57323,57328,57329,5,6,0
16390,3,3,57326,57329,57332,3,6,0
16391,3,3,57329,57332,57335,3,6,0
16392,4,2,57333,57335,57337,2,4,0
16393,3,2,57336,57337,57339,1,3,0
16394,2,1,57338,57339,57340,1,2,0
16395,4,1,57342,57342,57343,0,1,2
16396,4,2,57346,57346,57348,0,2,3
16397,3,3,57349,57349,57352,0,3,1
16398,3,1,57352,57352,57353,0,1,0
16399,3,2,57355,57355,57357,0,2,2
16400,1,3,57356,57357,57360,1,4,0
16401,2,1,57358,57360,57361,2,3,0
16402,1,1,57359,57361,57362,2,3,0
16403,6,3,57365,57365,57368,0,3,3
16404,6,3,57371,57371,57374,0,3,3
16405,4,2,57375,57375,57377,0,2,1
16406,5,1,57380,57380,57381,0,1,3
16407,2,3,57382,57382,57385,0,3,1
16408,3,1,57385,57385,57386,0,1,0
16409,2,2,57387,57387,57389,0,2,1
16410,4,1,57391,57391,57392,0,1,2
16411,1,1,57392,57392,57393,0,1,0
16412,6,1,57398,57398,57399,0,1,5
16413,4,3,57402,57402,57405,0,3,3
16414,3,1,57405,57405,57406,0,1,0
16415,6,1,57411,57411,57412,0,1,5
16416,3,2,57414,57414,57416,0,2,2
16417,2,2,57416,57416,57418,0,2,0
16418,2,3,57418,57418,57421,0,3,0
16419,4,3,57422,57422,57425,0,3,1
16420,5,1,57427,57427,57428,0,1,2
16421,4,2,57431,57431,57433,0,2,3
16422,4,3,57435,57435,57438,0,3,2
16423,1,3,57436,57438,57441,2,5,0
16424,2,1,57438,57441,57442,3,4,0
16425,6,3,57444,57444,57447,0,3,2
16426,5,3,57449,57449,57452,0,3,2
16427,6,1,57455,57455,57456,0,1,3
16428,3,2,57458,57458,57460,0,2,2
16429,1,3,57459,57460,57463,1,4,0
16430,6,3,57465,57465,57468,0,3,2
16431,4,1,57469,57469,57470,0,1,1
16432,2,1,57471,57471,57472,0,1,1
16433,1,2,57472,57472,57474,0,2,0
16434,3,2,57475,57475,57477,0,2,1
16435,3,1,57478,57478,57479,0,1,1
16436,4,1,57482,57482,57483,0,1,3
16437,1,1,57483,57483,57484,0,1,0
16438,2,3,57485,57485,57488,0,3,1
16439,1,2,57486,57488,57490,2,4,0
16440,6,3,57492,57492,57495,0,3,2
16441,4,1,57496,57496,57497,0,1,1
16442,6,1,57502,57502,57503,0,1,5
16443,2,1,57504,57504,57505,0,1,1
16444,6,2,57510,57510,57512,0,2,5
16445,1,3,57511,57512,57515,1,4,0
16446,5,1,57516,57516,57517,0,1,1
16447,6,3,57522,57522,57525,0,3,5
16448,1,3,57523,57525,57528,2,5,0
16449,5,2,57528,57528,57530,0,2,0
16450,2,1,57530,57530,57531,0,1,0
16451,1,2,57531,57531,57533,0,2,0
16452,4,2,57535,57535,57537,0,2,2
16453,1,2,57536,57537,57539,1,3,0
16454,6,2,57542,57542,57544,0,2,3
16455,1,3,57543,57544,57547,1,4,0
16456,2,3,57545,57547,57550,2,5,0
16457,4,2,57549,57550,57552,1,3,0
16458,3,1,57552,57552,57553,0,1,0
16459,6,2,57558,57558,57560,0,2,5
16460,5,3,57563,57563,57566,0,3,3
16461,2,1,57565,57566,57567,1,2,0
16462,1,1,57566,57567,57568,1,2,0
16463,1,1,57567,57568,57569,1,2,0
16464,2,2,57569,57569,57571,0,2,0
16465,5,2,57574,57574,57576,0,2,3
16466,5,2,57579,57579,57581,0,2,3
16467,2,2,57581,57581,57583,0,2,0
16468,6,3,57587,57587,57590,0,3,4
16469,4,1,57591,57591,57592,0,1,1
16470,6,2,57597,57597,57599,0,2,5
16471,6,3,57603,57603,57606,0,3,4
16472,4,2,57607,57607,57609,0,2,1
16473,4,3,57611,57611,57614,0,3,2
16474,5,2,57616,57616,57618,0,2,2
16475,6,2,57622,57622,57624,0,2,4
16476,1,2,57623,57624,57626,1,3,0
16477,3,1,57626,57626,57627,0,1,0
16478,4,2,57630,57630,57632,0,2,3
16479,2,1,57632,57632,57633,0,1,0
16480,1,3,57633,57633,57636,0,3,0
16481,4,1,57637,57637,57638,0,1,1
16482,4,3,57641,57641,57644,0,3,3
16483,4,2,57645,57645,57647,0,2,1
16484,2,2,57647,57647,57649,0,2,0
16485,3,3,57650,57650,57653,0,3,1
16486,2,1,57652,57653,57654,1,2,0
16487,4,3,57656,57656,57659,0,3,2
16488,1,2,57657,57659,57661,2,4,0
16489,4,2,57661,57661,57663,0,2,0
16490,5,1,57666,57666,57667,0,1,3
16491,1,2,57667,57667,57669,0,2,0
16492,6,3,57673,57673,57676,0,3,4
16493,5,3,57678,57678,57681,0,3,2
16494,4,1,57682,57682,57683,0,1,1
16495,4,1,57686,57686,57687,0,1,3
16496,5,2,57691,57691,57693,0,2,4
16497,3,2,57694,57694,57696,0,2,1
16498,5,1,57699,57699,57700,0,1,3
16499,5,2,57704,57704,57706,0,2,4
16500,2,3,57706,57706,57709,0,3,0
16501,6,3,57712,57712,57715,0,3,3
16502,4,1,57716,57716,57717,0,1,1
16503,4,3,57720,57720,57723,0,3,3
16504,3,1,57723,57723,57724,0,1,0
16505,1,2,57724,57724,57726,0,2,0
16506,2,1,57726,57726,57727,0,1,0
16507,5,3,57731,57731,57734,0,3,4
16508,5,3,57736,57736,57739,0,3,2
16509,4,1,57740,57740,57741,0,1,1
16510,3,2,57743,57743,57745,0,2,2
16511,5,3,57748,57748,57751,0,3,3
16512,5,3,57753,57753,57756,0,3,2
16513,5,2,57758,57758,57760,0,2,2
16514,4,2,57762,57762,57764,0,2,2
16515,4,2,57766,57766,57768,0,2,2
16516,5,1,57771,57771,57772,0,1,3
16517,1,1,57772,57772,57773,0,1,0
16518,5,2,57777,57777,57779,0,2,4
16519,2,2,57779,57779,57781,0,2,0
16520,1,1,57780,57781,57782,1,2,0
16521,6,3,57786,57786,57789,0,3,4
16522,3,3,57789,57789,57792,0,3,0
16523,3,3,57792,57792,57795,0,3,0
16524,5,2,57797,57797,57799,0,2,2
16525,4,1,57801,57801,57802,0,1,2
16526,5,2,57806,57806,57808,0,2,4
16527,4,1,57810,57810,57811,0,1,2
16528,6,1,57816,57816,57817,0,1,5
16529,5,3,57821,57821,57824,0,3,4
16530,6,3,57827,57827,57830,0,3,3
16531,4,2,57831,57831,57833,0,2,1
16532,1,3,57832,57833,57836,1,4,0
16533,3,2,57835,57836,57838,1,3,0
16534,6,2,57841,57841,57843,0,2,3
16535,1,1,57842,57843,57844,1,2,0
16536,5,3,57847,57847,57850,0,3,3
16537,4,1,57851,57851,57852,0,1,1
16538,2,2,57853,57853,57855,0,2,1
16539,6,1,57859,57859,57860,0,1,4
16540,2,1,57861,57861,57862,0,1,1
16541,6,1,57867,57867,57868,0,1,5
16542,2,2,57869,57869,57871,0,2,1
16543,1,3,57870,57871,57874,1,4,0
16544,6,1,57876,57876,57877,0,1,2
16545,4,3,57880,57880,57883,0,3,3
16546,2,2,57882,57883,57885,1,3,0
16547,2,1,57884,57885,57886,1,2,0
16548,3,1,57887,57887,57888,0,1,1
16549,5,1,57892,57892,57893,0,1,4
16550,4,1,57896,57896,57897,0,1,3
16551,2,2,57898,57898,57900,0,2,1
16552,3,1,57901,57901,57902,0,1,1
16553,5,3,57906,57906,57909,0,3,4
16554,5,2,57911,57911,57913,0,2,2
16555,5,1,57916,57916,57917,0,1,3
16556,3,2,57919,57919,57921,0,2,2
16557,6,1,57925,57925,57926,0,1,4
16558,3,1,57928,57928,57929,0,1,2
16559,5,2,57933,57933,57935,0,2,4
16560,3,3,57936,57936,57939,0,3,1
16561,1,1,57937,57939,57940,2,3,0
16562,5,2,57942,57942,57944,0,2,2
16563,6,3,57948,57948,57951,0,3,4
16564,3,1,57951,57951,57952,0,1,0
16565,2,2,57953,57953,57955,0,2,1
16566,1,2,57954,57955,57957,1,3,0
16567,4,3,57958,57958,57961,0,3,1
16568,4,1,57962,57962,57963,0,1,1
16569,3,1,57965,57965,57966,0,1,2
16570,6,1,57971,57971,57972,0,1,5
16571,3,3,57974,57974,57977,0,3,2
16572,2,2,57976,57977,57979,1,3,0
16573,3,3,57979,57979,57982,0,3,0
16574,5,3,57984,57984,57987,0,3,2
16575,4,3,57988,57988,57991,0,3,1
16576,2,3,57990,57991,57994,1,4,0
16577,1,3,57991,57994,57997,3,6,0
16578,2,3,57993,57997,58000,4,7,0
16579,5,1,57998,58000,58001,2,3,0
16580,5,2,58003,58003,58005,0,2,2
16581,1,1,58004,58005,58006,1,2,0
16582,5,1,58009,58009,58010,0,1,3
16583,5,3,58014,58014,58017,0,3,4
16584,5,3,58019,58019,58022,0,3,2
16585,1,1,58020,58022,58023,2,3,0
16586,4,1,58024,58024,58025,0,1,1
16587,4,3,58028,58028,58031,0,3,3
16588,1,3,58029,58031,58034,2,5,0
16589,3,3,58032,58034,58037,2,5,0
16590,1,3,58033,58037,58040,4,7,0
16591,3,2,58036,58040,58042,4,6,0
16592,5,2,58041,58042,58044,1,3,0
16593,3,1,58044,58044,58045,0,1,0
16594,4,1,58048,58048,58049,0,1,3
16595,1,3,58049,58049,58052,0,3,0
16596,6,1,58055,58055,58056,0,1,3
16597,1,2,58056,58056,58058,0,2,0
16598,4,1,58060,58060,58061,0,1,2
16599,4,1,58064,58064,58065,0,1,3
16600,1,1,58065,58065,58066,0,1,0
16601,3,3,58068,58068,58071,0,3,2
16602,3,2,58071,58071,58073,0,2,0
16603,2,2,58073,58073,58075,0,2,0
16604,6,2,58079,58079,58081,0,2,4
16605,6,3,58085,58085,58088,0,3,4
16606,1,3,58086,58088,58091,2,5,0
16607,4,1,58090,58091,58092,1,2,0
16608,2,3,58092,58092,58095,0,3,0
16609,4,2,58096,58096,58098,0,2,1
16610,1,2,58097,58098,58100,1,3,0
16611,2,3,58099,58100,58103,1,4,0
16612,1,1,58100,58103,58104,3,4,0
16613,1,2,58101,58104,58106,3,5,0
16614,6,3,58107,58107,58110,0,3,1
16615,5,3,58112,58112,58115,0,3,2
16616,3,1,58115,58115,58116,0,1,0
16617,1,1,58116,58116,58117,0,1,0
16618,6,1,58122,58122,58123,0,1,5
16619,2,1,58124,58124,58125,0,1,1
16620,6,2,58130,58130,58132,0,2,5
16621,2,1,58132,58132,58133,0,1,0
16622,3,3,58135,58135,58138,0,3,2
16623,4,1,58139,58139,58140,0,1,1
16624,3,2,58142,58142,58144,0,2,2
16625,1,1,58143,58144,58145,1,2,0
16626,3,2,58146,58146,58148,0,2,1
16627,4,1,58150,58150,58151,0,1,2
16628,2,1,58152,58152,58153,0,1,1
16629,2,3,58154,58154,58157,0,3,1
16630,3,3,58157,58157,58160,0,3,0
16631,6,3,58163,58163,58166,0,3,3
16632,1,1,58164,58166,58167,2,3,0
16633,4,2,58168,58168,58170,0,2,1
16634,4,1,58172,58172,58173,0,1,2
16635,6,3,58178,58178,58181,0,3,5
16636,4,2,58182,58182,58184,0,2,1
16637,4,3,58186,58186,58189,0,3,2
16638,5,1,58191,58191,58192,0,1,2
16639,6,1,58197,58197,58198,0,1,5
16640,6,3,58203,58203,58206,0,3,5
16641,6,3,58209,58209,58212,0,3,3
16642,2,3,58211,58212,58215,1,4,0
16643,6,3,58217,58217,58220,0,3,2
16644,6,3,58223,58223,58226,0,3,3
16645,6,2,58229,58229,58231,0,2,3
16646,1,2,58230,58231,58233,1,3,0
16647,2,1,58232,58233,58234,1,2,0
16648,2,1,58234,58234,58235,0,1,0
16649,5,2,58239,58239,58241,0,2,4
16650,4,2,58243,58243,58245,0,2,2
16651,6,3,58249,58249,58252,0,3,4
16652,3,1,58252,58252,58253,0,1,0
16653,4,3,58256,58256,58259,0,3,3
16654,3,1,58259,58259,58260,0,1,0
16655,5,1,58264,58264,58265,0,1,4
16656,1,3,58265,58265,58268,0,3,0
16657,6,2,58271,58271,58273,0,2,3
16658,4,1,58275,58275,58276,0,1,2
16659,3,3,58278,58278,58281,0,3,2
16660,5,2,58283,58283,58285,0,2,2
16661,4,2,58287,58287,58289,0,2,2
16662,2,2,58289,58289,58291,0,2,0
16663,1,2,58290,58291,58293,1,3,0
16664,4,2,58294,58294,58296,0,2,1
16665,4,2,58298,58298,58300,0,2,2
16666,2,3,58300,58300,58303,0,3,0
16667,4,1,58304,58304,58305,0,1,1
16668,2,3,58306,58306,58309,0,3,1
16669,6,2,58312,58312,58314,0,2,3
16670,4,1,58316,58316,58317,0,1,2
16671,2,1,58318,58318,58319,0,1,1
16672,4,3,58322,58322,58325,0,3,3
16673,5,1,58327,58327,58328,0,1,2
16674,4,2,58331,58331,58333,0,2,3
16675,2,1,58333,58333,58334,0,1,0
16676,3,3,58336,58336,58339,0,3,2
16677,1,2,58337,58339,58341,2,4,0
16678,6,2,58343,58343,58345,0,2,2
16679,1,1,58344,58345,58346,1,2,0
16680,6,2,58350,58350,58352,0,2,4
16681,3,3,58353,58353,58356,0,3,1
16682,3,3,58356,58356,58359,0,3,0
16683,4,1,58360,58360,58361,0,1,1
16684,5,3,58365,58365,58368,0,3,4
16685,6,2,58371,58371,58373,0,2,3
16686,4,2,58375,58375,58377,0,2,2
16687,5,2,58380,58380,58382,0,2,3
16688,5,3,58385,58385,58388,0,3,3
16689,5,3,58390,58390,58393,0,3,2
16690,1,2,58391,58393,58395,2,4,0
16691,5,1,58396,58396,58397,0,1,1
16692,1,3,58397,58397,58400,0,3,0
16693,2,3,58399,58400,58403,1,4,0
16694,4,3,58403,58403,58406,0,3,0
16695,5,2,58408,58408,58410,0,2,2
16696,3,2,58411,58411,58413,0,2,1
16697,3,1,58414,58414,58415,0,1,1
16698,1,3,58415,58415,58418,0,3,0
16699,5,3,58420,58420,58423,0,3,2
16700,6,1,58426,58426,58427,0,1,3
16701,1,2,58427,58427,58429,0,2,0
16702,1,3,58428,58429,58432,1,4,0
16703,5,3,58433,58433,58436,0,3,1
16704,6,3,58439,58439,58442,0,3,3
16705,1,1,58440,58442,58443,2,3,0
16706,1,2,58441,58443,58445,2,4,0
16707,3,3,58444,58445,58448,1,4,0
16708,1,2,58445,58448,58450,3,5,0
16709,6,3,58451,58451,58454,0,3,1
16710,3,1,58454,58454,58455,0,1,0
16711,1,2,58455,58455,58457,0,2,0
16712,1,1,58456,58457,58458,1,2,0
16713,6,1,58462,58462,58463,0,1,4
16714,2,1,58464,58464,58465,0,1,1
16715,4,1,58468,58468,58469,0,1,3
16716,4,3,58472,58472,58475,0,3,3
16717,1,2,58473,58475,58477,2,4,0
16718,1,2,58474,58477,58479,3,5,0
16719,4,2,58478,58479,58481,1,3,0
16720,2,3,58480,58481,58484,1,4,0
16721,3,3,58483,58484,58487,1,4,0
16722,6,1,58489,58489,58490,0,1,2
16723,3,2,58492,58492,58494,0,2,2
16724,1,2,58493,58494,58496,1,3,0
16725,2,2,58495,58496,58498,1,3,0
16726,6,1,58501,58501,58502,0,1,3
16727,1,2,58502,58502,58504,0,2,0
16728,3,2,58505,58505,58507,0,2,1
16729,5,3,58510,58510,58513,0,3,3
16730,5,1,58515,58515,58516,0,1,2
16731,5,2,58520,58520,58522,0,2,4
16732,5,1,58525,58525,58526,0,1,3
16733,6,1,58531,58531,58532,0,1,5
16734,2,1,58533,58533,58534,0,1,1
16735,1,2,58534,58534,58536,0,2,0
16736,2,1,58536,58536,58537,0,1,0
16737,6,1,58542,58542,58543,0,1,5
16738,4,3,58546,58546,58549,0,3,3
16739,3,3,58549,58549,58552,0,3,0
16740,6,1,58555,58555,58556,0,1,3
16741,5,2,58560,58560,58562,0,2,4
16742,2,3,58562,58562,58565,0,3,0
16743,2,2,58564,58565,58567,1,3,0
16744,1,3,58565,58567,58570,2,5,0
16745,6,2,58571,58571,58573,0,2,1
16746,1,3,58572,58573,58576,1,4,0
16747,1,1,58573,58576,58577,3,4,0
16748,3,1,58576,58577,58578,1,2,0
16749,6,2,58582,58582,58584,0,2,4
16750,2,3,58584,58584,58587,0,3,0
16751,5,1,58589,58589,58590,0,1,2
16752,5,2,58594,58594,58596,0,2,4
16753,6,1,58600,58600,58601,0,1,4
16754,6,2,58606,58606,58608,0,2,5
16755,3,2,58609,58609,58611,0,2,1
16756,3,1,58612,58612,58613,0,1,1
16757,3,1,58615,58615,58616,0,1,2
16758,2,1,58617,58617,58618,0,1,1
16759,2,3,58619,58619,58622,0,3,1
16760,5,1,58624,58624,58625,0,1,2
16761,3,3,58627,58627,58630,0,3,2
16762,5,1,58632,58632,58633,0,1,2
16763,4,1,58636,58636,58637,0,1,3
16764,1,3,58637,58637,58640,0,3,0
16765,6,3,58643,58643,58646,0,3,3
16766,6,1,58649,58649,58650,0,1,3
16767,4,2,58653,58653,58655,0,2,3
16768,2,3,58655,58655,58658,0,3,0
16769,2,1,58657,58658,58659,1,2,0
16770,6,1,58663,58663,58664,0,1,4
16771,3,2,58666,58666,58668,0,2,2
16772,3,3,58669,58669,58672,0,3,1
16773,6,3,58675,58675,58678,0,3,3
16774,5,3,58680,58680,58683,0,3,2
16775,5,3,58685,58685,58688,0,3,2
16776,1,3,58686,58688,58691,2,5,0
16777,6,2,58692,58692,58694,0,2,1
16778,1,1,58693,58694,58695,1,2,0
16779,2,2,58695,58695,58697,0,2,0
16780,4,1,58699,58699,58700,0,1,2
16781,3,3,58702,58702,58705,0,3,2
16782,3,2,58705,58705,58707,0,2,0
16783,3,3,58708,58708,58711,0,3,1
16784,1,1,58709,58711,58712,2,3,0
16785,4,1,58713,58713,58714,0,1,1
16786,6,1,58719,58719,58720,0,1,5
16787,5,1,58724,58724,58725,0,1,4
16788,6,3,58730,58730,58733,0,3,5
16789,4,1,58734,58734,58735,0,1,1
16790,6,2,58740,58740,58742,0,2,5
16791,5,3,58745,58745,58748,0,3,3
16792,2,2,58747,58748,58750,1,3,0
16793,5,3,58752,58752,58755,0,3,2
16794,2,3,58754,58755,58758,1,4,0
16795,5,2,58759,58759,58761,0,2,1
16796,4,2,58763,58763,58765,0,2,2
16797,3,2,58766,58766,58768,0,2,1
16798,3,1,58769,58769,58770,0,1,1
16799,6,3,58775,58775,58778,0,3,5
16800,5,3,58780,58780,58783,0,3,2
16801,2,3,58782,58783,58786,1,4,0
16802,5,1,58787,58787,58788,0,1,1
16803,3,3,58790,58790,58793,0,3,2
16804,4,1,58794,58794,58795,0,1,1
16805,3,1,58797,58797,58798,0,1,2
16806,3,2,58800,58800,58802,0,2,2
16807,4,2,58804,58804,58806,0,2,2
16808,5,2,58809,58809,58811,0,2,3
16809,3,2,58812,58812,58814,0,2,1
16810,2,1,58814,58814,58815,0,1,0
16811,6,2,58820,58820,58822,0,2,5
16812,3,1,58823,58823,58824,0,1,1
16813,3,2,58826,58826,58828,0,2,2
16814,3,2,58829,58829,58831,0,2,1
16815,1,2,58830,58831,58833,1,3,0
16816,4,3,58834,58834,58837,0,3,1
16817,4,1,58838,58838,58839,0,1,1
16818,4,3,58842,58842,58845,0,3,3
16819,6,3,58848,58848,58851,0,3,3
16820,4,1,58852,58852,58853,0,1,1
16821,3,3,58855,58855,58858,0,3,2
16822,5,1,58860,58860,58861,0,1,2
16823,5,2,58865,58865,58867,0,2,4
16824,4,3,58869,58869,58872,0,3,2
16825,2,1,58871,58872,58873,1,2,0
16826,2,3,58873,58873,58876,0,3,0
16827,3,3,58876,58876,58879,0,3,0
16828,2,1,58878,58879,58880,1,2,0
16829,1,3,58879,58880,58883,1,4,0
16830,1,3,58880,58883,58886,3,6,0
16831,1,2,58881,58886,58888,5,7,0
16832,1,2,58882,58888,58890,6,8,0
16833,6,3,58888,58890,58893,2,5,0
16834,1,1,58889,58893,58894,4,5,0
16835,3,3,58892,58894,58897,2,5,0
16836,5,2,58897,58897,58899,0,2,0
16837,2,2,58899,58899,58901,0,2,0
16838,1,1,58900,58901,58902,1,2,0
16839,2,3,58902,58902,58905,0,3,0
16840,6,3,58908,58908,58911,0,3,3
16841,6,2,58914,58914,58916,0,2,3
16842,5,3,58919,58919,58922,0,3,3
16843,4,2,58923,58923,58925,0,2,1
16844,4,2,58927,58927,58929,0,2,2
16845,3,1,58930,58930,58931,0,1,1
16846,2,2,58932,58932,58934,0,2,1
16847,4,3,58936,58936,58939,0,3,2
16848,1,2,58937,58939,58941,2,4,0
16849,3,3,58940,58941,58944,1,4,0
16850,5,1,58945,58945,58946,0,1,1
16851,2,1,58947,58947,58948,0,1,1
16852,3,1,58950,58950,58951,0,1,2
16853,2,3,58952,58952,58955,0,3,1
16854,6,2,58958,58958,58960,0,2,3
16855,6,2,58964,58964,58966,0,2,4
16856,5,1,58969,58969,58970,0,1,3
16857,1,3,58970,58970,58973,0,3,0
16858,2,1,58972,58973,58974,1,2,0
16859,4,1,58976,58976,58977,0,1,2
16860,1,1,58977,58977,58978,0,1,0
16861,2,3,58979,58979,58982,0,3,1
16862,4,2,58983,58983,58985,0,2,1
16863,5,3,58988,58988,58991,0,3,3
16864,3,1,58991,58991,58992,0,1,0
16865,5,3,58996,58996,58999,0,3,4
16866,4,1,59000,59000,59001,0,1,1
16867,2,1,59002,59002,59003,0,1,1
16868,3,1,59005,59005,59006,0,1,2
16869,3,1,59008,59008,59009,0,1,2
16870,6,2,59014,59014,59016,0,2,5
16871,5,3,59019,59019,59022,0,3,3
16872,4,2,59023,59023,59025,0,2,1
16873,5,3,59028,59028,59031,0,3,3
16874,5,1,59033,59033,59034,0,1,2
16875,6,2,59039,59039,59041,0,2,5
16876,5,1,59044,59044,59045,0,1,3
16877,1,2,59045,59045,59047,0,2,0
16878,6,2,59051,59051,59053,0,2,4
16879,3,3,59054,59054,59057,0,3,1
16880,6,3,59060,59060,59063,0,3,3
16881,4,2,59064,59064,59066,0,2,1
16882,5,2,59069,59069,59071,0,2,3
16883,5,1,59074,59074,59075,0,1,3
16884,5,2,59079,59079,59081,0,2,4
16885,2,2,59081,59081,59083,0,2,0
16886,2,3,59083,59083,59086,0,3,0
16887,6,1,59089,59089,59090,0,1,3
16888,1,1,59090,59090,59091,0,1,0
16889,4,3,59094,59094,59097,0,3,3
16890,5,2,59099,59099,59101,0,2,2
16891,6,3,59105,59105,59108,0,3,4
16892,1,2,59106,59108,59110,2,4,0
16893,3,3,59109,59110,59113,1,4,0
16894,4,2,59113,59113,59115,0,2,0
16895,5,3,59118,59118,59121,0,3,3
16896,2,1,59120,59121,59122,1,2,0
16897,3,2,59123,59123,59125,0,2,1
16898,2,1,59125,59125,59126,0,1,0
16899,4,2,59129,59129,59131,0,2,3
16900,5,1,59134,59134,59135,0,1,3
16901,1,2,59135,59135,59137,0,2,0
16902,3,2,59138,59138,59140,0,2,1
16903,6,3,59144,59144,59147,0,3,4
16904,3,2,59147,59147,59149,0,2,0
16905,4,2,59151,59151,59153,0,2,2
16906,4,2,59155,59155,59157,0,2,2
16907,5,1,59160,59160,59161,0,1,3
16908,3,3,59163,59163,59166,0,3,2
16909,4,2,59167,59167,59169,0,2,1
16910,5,2,59172,59172,59174,0,2,3
16911,6,3,59178,59178,59181,0,3,4
16912,6,2,59184,59184,59186,0,2,3
16913,2,3,59186,59186,59189,0,3,0
16914,5,1,59191,59191,59192,0,1,2
16915,3,3,59194,59194,59197,0,3,2
16916,1,2,59195,59197,59199,2,4,0
16917,3,3,59198,59199,59202,1,4,0
16918,1,3,59199,59202,59205,3,6,0
16919,3,2,59202,59205,59207,3,5,0
16920,3,1,59205,59207,59208,2,3,0
16921,5,2,59210,59210,59212,0,2,2
16922,3,1,59213,59213,59214,0,1,1
16923,4,3,59217,59217,59220,0,3,3
16924,2,1,59219,59220,59221,1,2,0
16925,4,2,59223,59223,59225,0,2,2
16926,4,1,59227,59227,59228,0,1,2
16927,5,1,59232,59232,59233,0,1,4
16928,5,3,59237,59237,59240,0,3,4
16929,3,2,59240,59240,59242,0,2,0
16930,1,3,59241,59242,59245,1,4,0
16931,5,3,59246,59246,59249,0,3,1
16932,2,3,59248,59249,59252,1,4,0
16933,3,3,59251,59252,59255,1,4,0
16934,4,1,59255,59255,59256,0,1,0
16935,3,3,59258,59258,59261,0,3,2
16936,6,1,59264,59264,59265,0,1,3
16937,4,1,59268,59268,59269,0,1,3
16938,2,3,59270,59270,59273,0,3,1
16939,4,2,59274,59274,59276,0,2,1
16940,1,1,59275,59276,59277,1,2,0
16941,3,1,59278,59278,59279,0,1,1
16942,1,3,59279,59279,59282,0,3,0
16943,3,1,59282,59282,59283,0,1,0
16944,3,3,59285,59285,59288,0,3,2
16945,3,3,59288,59288,59291,0,3,0
16946,6,1,59294,59294,59295,0,1,3
16947,6,3,59300,59300,59303,0,3,5
16948,2,1,59302,59303,59304,1,2,0
16949,2,2,59304,59304,59306,0,2,0
16950,5,3,59309,59309,59312,0,3,3
16951,4,3,59313,59313,59316,0,3,1
16952,5,1,59318,59318,59319,0,1,2
16953,5,2,59323,59323,59325,0,2,4
16954,4,2,59327,59327,59329,0,2,2
16955,5,3,59332,59332,59335,0,3,3
16956,2,3,59334,59335,59338,1,4,0
16957,6,3,59340,59340,59343,0,3,2
16958,4,2,59344,59344,59346,0,2,1
16959,6,2,59350,59350,59352,0,2,4
16960,5,2,59355,59355,59357,0,2,3
16961,1,1,59356,59357,59358,1,2,0
16962,4,1,59360,59360,59361,0,1,2
16963,3,1,59363,59363,59364,0,1,2
16964,6,2,59369,59369,59371,0,2,5
16965,2,2,59371,59371,59373,0,2,0
16966,2,2,59373,59373,59375,0,2,0
16967,6,3,59379,59379,59382,0,3,4
16968,1,1,59380,59382,59383,2,3,0
16969,4,2,59384,59384,59386,0,2,1
16970,4,2,59388,59388,59390,0,2,2
16971,2,2,59390,59390,59392,0,2,0
16972,4,2,59394,59394,59396,0,2,2
16973,4,2,59398,59398,59400,0,2,2
16974,6,2,59404,59404,59406,0,2,4
16975,2,1,59406,59406,59407,0,1,0
16976,4,2,59410,59410,59412,0,2,3
16977,1,1,59411,59412,59413,1,2,0
16978,6,1,59417,59417,59418,0,1,4
16979,3,1,59420,59420,59421,0,1,2
16980,5,2,59425,59425,59427,0,2,4
16981,2,3,59427,59427,59430,0,3,0
16982,5,2,59432,59432,59434,0,2,2
16983,2,3,59434,59434,59437,0,3,0
16984,2,1,59436,59437,59438,1,2,0
16985,4,1,59440,59440,59441,0,1,2
16986,5,3,59445,59445,59448,0,3,4
16987,2,3,59447,59448,59451,1,4,0
16988,5,2,59452,59452,59454,0,2,1
16989,6,1,59458,59458,59459,0,1,4
16990,5,3,59463,59463,59466,0,3,4
16991,5,1,59468,59468,59469,0,1,2
16992,6,1,59474,59474,59475,0,1,5
16993,6,2,59480,59480,59482,0,2,5
16994,1,3,59481,59482,59485,1,4,0
16995,4,3,59485,59485,59488,0,3,0
16996,5,2,59490,59490,59492,0,2,2
16997,6,3,59496,59496,59499,0,3,4
16998,3,3,59499,59499,59502,0,3,0
16999,6,3,59505,59505,59508,0,3,3
17000,1,1,59506,59508,59509,2,3,0
17001,4,1,59510,59510,59511,0,1,1
17002,4,2,59514,59514,59516,0,2,3
17003,4,3,59518,59518,59521,0,3,2
17004,3,2,59521,59521,59523,0,2,0
17005,6,1,59527,59527,59528,0,1,4
17006,2,1,59529,59529,59530,0,1,1
17007,6,1,59535,59535,59536,0,1,5
17008,3,1,59538,59538,59539,0,1,2
17009,3,2,59541,59541,59543,0,2,2
17010,6,2,59547,59547,59549,0,2,4
17011,6,3,59553,59553,59556,0,3,4
17012,4,1,59557,59557,59558,0,1,1
17013,1,1,59558,59558,59559,0,1,0
17014,5,2,59563,59563,59565,0,2,4
17015,6,2,59569,59569,59571,0,2,4
17016,3,3,59572,59572,59575,0,3,1
17017,1,3,59573,59575,59578,2,5,0
17018,5,3,59578,59578,59581,0,3,0
17019,2,1,59580,59581,59582,1,2,0
17020,3,2,59583,59583,59585,0,2,1
17021,2,3,59585,59585,59588,0,3,0
17022,6,3,59591,59591,59594,0,3,3
17023,5,3,59596,59596,59599,0,3,2
17024,5,1,59601,59601,59602,0,1,2
17025,3,3,59604,59604,59607,0,3,2
17026,3,1,59607,59607,59608,0,1,0
17027,2,3,59609,59609,59612,0,3,1
17028,2,2,59611,59612,59614,1,3,0
17029,1,1,59612,59614,59615,2,3,0
17030,1,2,59613,59615,59617,2,4,0
17031,5,2,59618,59618,59620,0,2,1
17032,6,1,59624,59624,59625,0,1,4
17033,5,3,59629,59629,59632,0,3,4
17034,2,2,59631,59632,59634,1,3,0
17035,2,3,59633,59634,59637,1,4,0
17036,3,1,59636,59637,59638,1,2,0
17037,4,2,59640,59640,59642,0,2,2
17038,2,3,59642,59642,59645,0,3,0
17039,2,2,59644,59645,59647,1,3,0
17040,5,2,59649,59649,59651,0,2,2
17041,2,3,59651,59651,59654,0,3,0
17042,6,2,59657,59657,59659,0,2,3
17043,4,1,59661,59661,59662,0,1,2
17044,6,1,59667,59667,59668,0,1,5
17045,5,2,59672,59672,59674,0,2,4
17046,4,1,59676,59676,59677,0,1,2
17047,6,1,59682,59682,59683,0,1,5
17048,1,1,59683,59683,59684,0,1,0
17049,2,1,59685,59685,59686,0,1,1
17050,5,1,59690,59690,59691,0,1,4
17051,4,2,59694,59694,59696,0,2,3
17052,6,1,59700,59700,59701,0,1,4
17053,6,1,59706,59706,59707,0,1,5
17054,2,1,59708,59708,59709,0,1,1
17055,6,2,59714,59714,59716,0,2,5
17056,6,1,59720,59720,59721,0,1,4
17057,1,3,59721,59721,59724,0,3,0
17058,2,3,59723,59724,59727,1,4,0
17059,3,3,59726,59727,59730,1,4,0
17060,5,2,59731,59731,59733,0,2,1
17061,5,1,59736,59736,59737,0,1,3
17062,6,1,59742,59742,59743,0,1,5
17063,1,3,59743,59743,59746,0,3,0
17064,1,2,59744,59746,59748,2,4,0
17065,6,3,59750,59750,59753,0,3,2
17066,3,1,59753,59753,59754,0,1,0
17067,3,1,59756,59756,59757,0,1,2
17068,1,2,59757,59757,59759,0,2,0
17069,4,3,59761,59761,59764,0,3,2
17070,6,1,59767,59767,59768,0,1,3
17071,3,2,59770,59770,59772,0,2,2
17072,2,2,59772,59772,59774,0,2,0
17073,3,2,59775,59775,59777,0,2,1
17074,4,1,59779,59779,59780,0,1,2
17075,3,1,59782,59782,59783,0,1,2
17076,2,2,59784,59784,59786,0,2,1
17077,3,3,59787,59787,59790,0,3,1
17078,6,3,59793,59793,59796,0,3,3
17079,4,2,59797,59797,59799,0,2,1
17080,2,3,59799,59799,59802,0,3,0
17081,4,3,59803,59803,59806,0,3,1
17082,1,1,59804,59806,59807,2,3,0
17083,3,2,59807,59807,59809,0,2,0
17084,5,3,59812,59812,59815,0,3,3
17085,6,1,59818,59818,59819,0,1,3
17086,4,1,59822,59822,59823,0,1,3
17087,6,3,59828,59828,59831,0,3,5
17088,2,3,59830,59831,59834,1,4,0
17089,4,2,59834,59834,59836,0,2,0
17090,6,1,59840,59840,59841,0,1,4
17091,5,2,59845,59845,59847,0,2,4
17092,2,3,59847,59847,59850,0,3,0
17093,4,3,59851,59851,59854,0,3,1
17094,4,1,59855,59855,59856,0,1,1
17095,1,1,59856,59856,59857,0,1,0
17096,2,1,59858,59858,59859,0,1,1
17097,4,2,59862,59862,59864,0,2,3
17098,6,2,59868,59868,59870,0,2,4
17099,1,1,59869,59870,59871,1,2,0
17100,6,3,59875,59875,59878,0,3,4
17101,2,2,59877,59878,59880,1,3,0
17102,4,2,59881,59881,59883,0,2,1
17103,4,1,59885,59885,59886,0,1,2
17104,3,1,59888,59888,59889,0,1,2
17105,5,2,59893,59893,59895,0,2,4
17106,6,1,59899,59899,59900,0,1,4
17107,4,2,59903,59903,59905,0,2,3
17108,5,2,59908,59908,59910,0,2,3
17109,5,2,59913,59913,59915,0,2,3
17110,1,1,59914,59915,59916,1,2,0
17111,5,2,59919,59919,59921,0,2,3
17112,3,2,59922,59922,59924,0,2,1
17113,1,2,59923,59924,59926,1,3,0
17114,2,2,59925,59926,59928,1,3,0
17115,1,2,59926,59928,59930,2,4,0
17116,3,3,59929,59930,59933,1,4,0
17117,2,2,59931,59933,59935,2,4,0
17118,4,2,59935,59935,59937,0,2,0
17119,4,3,59939,59939,59942,0,3,2
17120,3,2,59942,59942,59944,0,2,0
17121,5,1,59947,59947,59948,0,1,3
17122,5,1,59952,59952,59953,0,1,4
17123,3,2,59955,59955,59957,0,2,2
17124,5,3,59960,59960,59963,0,3,3
17125,5,1,59965,59965,59966,0,1,2
17126,1,2,59966,59966,59968,0,2,0
17127,2,1,59968,59968,59969,0,1,0
17128,1,2,59969,59969,59971,0,2,0
17129,2,3,59971,59971,59974,0,3,0
17130,3,2,59974,59974,59976,0,2,0
17131,5,3,59979,59979,59982,0,3,3
17132,5,2,59984,59984,59986,0,2,2
17133,4,1,59988,59988,59989,0,1,2
17134,3,1,59991,59991,59992,0,1,2
17135,2,3,59993,59993,59996,0,3,1
17136,6,2,59999,59999,60001,0,2,3
17137,3,3,60002,60002,60005,0,3,1
17138,3,1,60005,60005,60006,0,1,0
17139,3,1,60008,60008,60009,0,1,2
17140,5,2,60013,60013,60015,0,2,4
17141,4,3,60017,60017,60020,0,3,2
17142,3,1,60020,60020,60021,0,1,0
17143,1,2,60021,60021,60023,0,2,0
17144,5,3,60026,60026,60029,0,3,3
17145,5,2,60031,60031,60033,0,2,2
17146,3,3,60034,60034,60037,0,3,1
17147,3,2,60037,60037,60039,0,2,0
17148,3,3,60040,60040,60043,0,3,1
17149,5,1,60045,60045,60046,0,1,2
17150,1,1,60046,60046,60047,0,1,0
17151,1,3,60047,60047,60050,0,3,0
17152,6,2,60053,60053,60055,0,2,3
17153,5,3,60058,60058,60061,0,3,3
17154,6,2,60064,60064,60066,0,2,3
17155,1,3,60065,60066,60069,1,4,0
17156,2,1,60067,60069,60070,2,3,0
17157,6,2,60073,60073,60075,0,2,3
17158,1,3,60074,60075,60078,1,4,0
17159,1,2,60075,60078,60080,3,5,0
17160,4,3,60079,60080,60083,1,4,0
17161,5,2,60084,60084,60086,0,2,1
17162,6,1,60090,60090,60091,0,1,4
17163,2,2,60092,60092,60094,0,2,1
17164,1,1,60093,60094,60095,1,2,0
17165,5,1,60098,60098,60099,0,1,3
17166,2,2,60100,60100,60102,0,2,1
17167,2,1,60102,60102,60103,0,1,0
17168,1,1,60103,60103,60104,0,1,0
17169,2,2,60105,60105,60107,0,2,1
17170,2,3,60107,60107,60110,0,3,0
17171,3,3,60110,60110,60113,0,3,0
17172,6,1,60116,60116,60117,0,1,3
17173,1,1,60117,60117,60118,0,1,0
17174,2,3,60119,60119,60122,0,3,1
17175,6,2,60125,60125,60127,0,2,3
17176,4,2,60129,60129,60131,0,2,2
17177,2,3,60131,60131,60134,0,3,0
17178,3,2,60134,60134,60136,0,2,0
17179,6,3,60140,60140,60143,0,3,4
17180,6,3,60146,60146,60149,0,3,3
17181,1,1,60147,60149,60150,2,3,0
17182,6,3,60153,60153,60156,0,3,3
17183,2,1,60155,60156,60157,1,2,0
17184,6,3,60161,60161,60164,0,3,4
17185,2,3,60163,60164,60167,1,4,0
17186,4,1,60167,60167,60168,0,1,0
17187,2,1,60169,60169,60170,0,1,1
17188,4,3,60173,60173,60176,0,3,3
17189,4,1,60177,60177,60178,0,1,1
17190,5,3,60182,60182,60185,0,3,4
17191,3,2,60185,60185,60187,0,2,0
17192,1,1,60186,60187,60188,1,2,0
17193,6,1,60192,60192,60193,0,1,4
17194,6,3,60198,60198,60201,0,3,5
17195,2,1,60200,60201,60202,1,2,0
17196,1,2,60201,60202,60204,1,3,0
17197,1,2,60202,60204,60206,2,4,0
17198,5,2,60207,60207,60209,0,2,1
17199,6,1,60213,60213,60214,0,1,4
17200,4,2,60217,60217,60219,0,2,3
17201,5,3,60222,60222,60225,0,3,3
17202,1,2,60223,60225,60227,2,4,0
17203,1,2,60224,60227,60229,3,5,0
17204,5,2,60229,60229,60231,0,2,0
17205,6,2,60235,60235,60237,0,2,4
17206,1,2,60236,60237,60239,1,3,0
17207,6,2,60242,60242,60244,0,2,3
17208,4,2,60246,60246,60248,0,2,2
17209,4,2,60250,60250,60252,0,2,2
17210,5,1,60255,60255,60256,0,1,3
17211,3,3,60258,60258,60261,0,3,2
17212,2,2,60260,60261,60263,1,3,0
17213,1,1,60261,60263,60264,2,3,0
17214,3,3,60264,60264,60267,0,3,0
17215,1,2,60265,60267,60269,2,4,0
17216,5,3,60270,60270,60273,0,3,1
17217,6,2,60276,60276,60278,0,2,3
17218,6,3,60282,60282,60285,0,3,4
17219,4,2,60286,60286,60288,0,2,1
17220,2,1,60288,60288,60289,0,1,0
17221,2,2,60290,60290,60292,0,2,1
17222,1,1,60291,60292,60293,1,2,0
17223,6,2,60297,60297,60299,0,2,4
17224,4,3,60301,60301,60304,0,3,2
17225,2,3,60303,60304,60307,1,4,0
17226,2,3,60305,60307,60310,2,5,0
17227,1,2,60306,60310,60312,4,6,0
17228,6,3,60312,60312,60315,0,3,0
17229,2,1,60314,60315,60316,1,2,0
17230,6,1,60320,60320,60321,0,1,4
17231,6,1,60326,60326,60327,0,1,5
17232,4,2,60330,60330,60332,0,2,3
17233,4,3,60334,60334,60337,0,3,2
17234,5,3,60339,60339,60342,0,3,2
17235,5,3,60344,60344,60347,0,3,2
17236,6,1,60350,60350,60351,0,1,3
17237,1,3,60351,60351,60354,0,3,0
17238,1,3,60352,60354,60357,2,5,0
17239,1,2,60353,60357,60359,4,6,0
17240,2,2,60355,60359,60361,4,6,0
17241,4,2,60359,60361,60363,2,4,0
17242,3,3,60362,60363,60366,1,4,0
17243,1,2,60363,60366,60368,3,5,0
17244,2,3,60365,60368,60371,3,6,0
17245,5,3,60370,60371,60374,1,4,0
17246,5,1,60375,60375,60376,0,1,1
17247,3,3,60378,60378,60381,0,3,2
17248,3,1,60381,60381,60382,0,1,0
17249,1,2,60382,60382,60384,0,2,0
17250,2,2,60384,60384,60386,0,2,0
17251,2,3,60386,60386,60389,0,3,0
17252,5,3,60391,60391,60394,0,3,2
17253,4,1,60395,60395,60396,0,1,1
17254,2,3,60397,60397,60400,0,3,1
17255,6,3,60403,60403,60406,0,3,3
17256,3,1,60406,60406,60407,0,1,0
17257,4,1,60410,60410,60411,0,1,3
17258,5,2,60415,60415,60417,0,2,4
17259,1,1,60416,60417,60418,1,2,0
17260,4,1,60420,60420,60421,0,1,2
17261,2,3,60422,60422,60425,0,3,1
17262,3,1,60425,60425,60426,0,1,0
17263,2,3,60427,60427,60430,0,3,1
17264,3,3,60430,60430,60433,0,3,0
17265,1,2,60431,60433,60435,2,4,0
17266,3,3,60434,60435,60438,1,4,0
17267,2,2,60436,60438,60440,2,4,0
17268,5,3,60441,60441,60444,0,3,1
17269,5,1,60446,60446,60447,0,1,2
17270,5,2,60451,60451,60453,0,2,4
17271,2,2,60453,60453,60455,0,2,0
17272,6,2,60459,60459,60461,0,2,4
17273,4,3,60463,60463,60466,0,3,2
17274,4,2,60467,60467,60469,0,2,1
17275,2,2,60469,60469,60471,0,2,0
17276,5,1,60474,60474,60475,0,1,3
17277,1,3,60475,60475,60478,0,3,0
17278,5,3,60480,60480,60483,0,3,2
17279,5,2,60485,60485,60487,0,2,2
17280,6,2,60491,60491,60493,0,2,4
17281,5,2,60496,60496,60498,0,2,3
17282,2,1,60498,60498,60499,0,1,0
17283,4,2,60502,60502,60504,0,2,3
17284,4,3,60506,60506,60509,0,3,2
17285,2,1,60508,60509,60510,1,2,0
17286,3,1,60511,60511,60512,0,1,1
17287,2,2,60513,60513,60515,0,2,1
17288,2,2,60515,60515,60517,0,2,0
17289,6,3,60521,60521,60524,0,3,4
17290,5,1,60526,60526,60527,0,1,2
17291,2,3,60528,60528,60531,0,3,1
17292,6,1,60534,60534,60535,0,1,3
17293,2,2,60536,60536,60538,0,2,1
17294,5,2,60541,60541,60543,0,2,3
17295,2,3,60543,60543,60546,0,3,0
17296,4,3,60547,60547,60550,0,3,1
17297,3,1,60550,60550,60551,0,1,0
17298,1,2,60551,60551,60553,0,2,0
17299,3,1,60554,60554,60555,0,1,1
17300,3,3,60557,60557,60560,0,3,2
17301,1,2,60558,60560,60562,2,4,0
17302,1,2,60559,60562,60564,3,5,0
17303,1,1,60560,60564,60565,4,5,0
17304,3,2,60563,60565,60567,2,4,0
17305,6,3,60569,60569,60572,0,3,2
17306,6,3,60575,60575,60578,0,3,3
17307,3,3,60578,60578,60581,0,3,0
17308,1,3,60579,60581,60584,2,5,0
17309,2,1,60581,60584,60585,3,4,0
17310,4,3,60585,60585,60588,0,3,0
17311,2,3,60587,60588,60591,1,4,0
17312,6,2,60593,60593,60595,0,2,2
17313,3,1,60596,60596,60597,0,1,1
17314,2,3,60598,60598,60601,0,3,1
17315,1,1,60599,60601,60602,2,3,0
17316,2,2,60601,60602,60604,1,3,0
17317,2,1,60603,60604,60605,1,2,0
17318,2,2,60605,60605,60607,0,2,0
17319,2,2,60607,60607,60609,0,2,0
17320,3,2,60610,60610,60612,0,2,1
17321,5,2,60615,60615,60617,0,2,3
17322,3,2,60618,60618,60620,0,2,1
17323,3,2,60621,60621,60623,0,2,1
17324,2,3,60623,60623,60626,0,3,0
17325,6,1,60629,60629,60630,0,1,3
17326,4,1,60633,60633,60634,0,1,3
17327,2,1,60635,60635,60636,0,1,1
17328,2,1,60637,60637,60638,0,1,1
17329,6,1,60643,60643,60644,0,1,5
17330,1,3,60644,60644,60647,0,3,0
17331,1,3,60645,60647,60650,2,5,0
17332,2,2,60647,60650,60652,3,5,0
17333,6,1,60653,60653,60654,0,1,1
17334,4,1,60657,60657,60658,0,1,3
17335,1,2,60658,60658,60660,0,2,0
17336,6,1,60664,60664,60665,0,1,4
17337,4,3,60668,60668,60671,0,3,3
17338,3,2,60671,60671,60673,0,2,0
17339,1,1,60672,60673,60674,1,2,0
17340,6,3,60678,60678,60681,0,3,4
17341,2,2,60680,60681,60683,1,3,0
17342,5,2,60685,60685,60687,0,2,2
17343,2,2,60687,60687,60689,0,2,0
17344,3,1,60690,60690,60691,0,1,1
17345,3,1,60693,60693,60694,0,1,2
17346,1,2,60694,60694,60696,0,2,0
17347,5,3,60699,60699,60702,0,3,3
17348,5,2,60704,60704,60706,0,2,2
17349,5,2,60709,60709,60711,0,2,3
17350,1,3,60710,60711,60714,1,4,0
17351,2,3,60712,60714,60717,2,5,0
17352,4,2,60716,60717,60719,1,3,0
17353,1,1,60717,60719,60720,2,3,0
17354,1,3,60718,60720,60723,2,5,0
17355,1,2,60719,60723,60725,4,6,0
17356,3,1,60722,60725,60726,3,4,0
17357,6,2,60728,60728,60730,0,2,2
17358,6,1,60734,60734,60735,0,1,4
17359,4,2,60738,60738,60740,0,2,3
17360,3,2,60741,60741,60743,0,2,1
17361,2,3,60743,60743,60746,0,3,0
17362,3,2,60746,60746,60748,0,2,0
17363,1,3,60747,60748,60751,1,4,0
17364,3,2,60750,60751,60753,1,3,0
17365,5,1,60755,60755,60756,0,1,2
17366,1,2,60756,60756,60758,0,2,0
17367,1,3,60757,60758,60761,1,4,0
17368,3,3,60760,60761,60764,1,4,0
17369,2,1,60762,60764,60765,2,3,0
17370,2,2,60764,60765,60767,1,3,0
17371,5,2,60769,60769,60771,0,2,2
17372,3,1,60772,60772,60773,0,1,1
17373,5,3,60777,60777,60780,0,3,4
17374,5,2,60782,60782,60784,0,2,2
17375,5,3,60787,60787,60790,0,3,3
17376,6,1,60793,60793,60794,0,1,3
17377,2,2,60795,60795,60797,0,2,1
17378,5,2,60800,60800,60802,0,2,3
17379,6,2,60806,60806,60808,0,2,4
17380,5,3,60811,60811,60814,0,3,3
17381,4,2,60815,60815,60817,0,2,1
17382,6,2,60821,60821,60823,0,2,4
17383,3,3,60824,60824,60827,0,3,1
17384,1,2,60825,60827,60829,2,4,0
17385,6,3,60831,60831,60834,0,3,2
17386,4,3,60835,60835,60838,0,3,1
17387,5,2,60840,60840,60842,0,2,2
17388,3,2,60843,60843,60845,0,2,1
17389,2,1,60845,60845,60846,0,1,0
17390,3,3,60848,60848,60851,0,3,2
17391,2,3,60850,60851,60854,1,4,0
17392,3,1,60853,60854,60855,1,2,0
17393,2,1,60855,60855,60856,0,1,0
17394,3,1,60858,60858,60859,0,1,2
17395,6,2,60864,60864,60866,0,2,5
17396,1,1,60865,60866,60867,1,2,0
17397,6,1,60871,60871,60872,0,1,4
17398,5,3,60876,60876,60879,0,3,4
17399,5,1,60881,60881,60882,0,1,2
17400,4,1,60885,60885,60886,0,1,3
17401,3,3,60888,60888,60891,0,3,2
17402,3,2,60891,60891,60893,0,2,0
17403,6,3,60897,60897,60900,0,3,4
17404,2,2,60899,60900,60902,1,3,0
17405,5,3,60904,60904,60907,0,3,2
17406,1,2,60905,60907,60909,2,4,0
17407,1,3,60906,60909,60912,3,6,0
17408,2,1,60908,60912,60913,4,5,0
17409,3,3,60911,60913,60916,2,5,0
17410,5,2,60916,60916,60918,0,2,0
17411,1,2,60917,60918,60920,1,3,0
17412,1,3,60918,60920,60923,2,5,0
17413,3,1,60921,60923,60924,2,3,0
17414,5,3,60926,60926,60929,0,3,2
17415,1,3,60927,60929,60932,2,5,0
17416,2,3,60929,60932,60935,3,6,0
17417,1,2,60930,60935,60937,5,7,0
17418,5,3,60935,60937,60940,2,5,0
17419,6,2,60941,60941,60943,0,2,1
17420,4,3,60945,60945,60948,0,3,2
17421,5,3,60950,60950,60953,0,3,2
17422,4,3,60954,60954,60957,0,3,1
17423,4,2,60958,60958,60960,0,2,1
17424,1,2,60959,60960,60962,1,3,0
17425,2,2,60961,60962,60964,1,3,0
17426,6,2,60967,60967,60969,0,2,3
17427,2,2,60969,60969,60971,0,2,0
17428,1,2,60970,60971,60973,1,3,0
17429,1,3,60971,60973,60976,2,5,0
17430,4,2,60975,60976,60978,1,3,0
17431,3,2,60978,60978,60980,0,2,0
17432,1,1,60979,60980,60981,1,2,0
17433,1,1,60980,60981,60982,1,2,0
17434,6,2,60986,60986,60988,0,2,4
17435,3,1,60989,60989,60990,0,1,1
17436,5,2,60994,60994,60996,0,2,4
17437,2,2,60996,60996,60998,0,2,0
17438,6,2,61002,61002,61004,0,2,4
17439,2,1,61004,61004,61005,0,1,0
17440,2,1,61006,61006,61007,0,1,1
17441,4,1,61010,61010,61011,0,1,3
17442,6,3,61016,61016,61019,0,3,5
17443,4,3,61020,61020,61023,0,3,1
17444,5,3,61025,61025,61028,0,3,2
17445,6,1,61031,61031,61032,0,1,3
17446,3,3,61034,61034,61037,0,3,2
17447,2,2,61036,61037,61039,1,3,0
17448,6,2,61042,61042,61044,0,2,3
17449,6,3,61048,61048,61051,0,3,4
17450,5,2,61053,61053,61055,0,2,2
17451,6,2,61059,61059,61061,0,2,4
17452,3,1,61062,61062,61063,0,1,1
17453,3,3,61065,61065,61068,0,3,2
17454,3,1,61068,61068,61069,0,1,0
17455,1,3,61069,61069,61072,0,3,0
17456,4,2,61073,61073,61075,0,2,1
17457,3,2,61076,61076,61078,0,2,1
17458,3,3,61079,61079,61082,0,3,1
17459,5,3,61084,61084,61087,0,3,2
17460,2,1,61086,61087,61088,1,2,0
17461,5,2,61091,61091,61093,0,2,3
17462,6,2,61097,61097,61099,0,2,4
17463,6,3,61103,61103,61106,0,3,4
17464,4,2,61107,61107,61109,0,2,1
17465,2,1,61109,61109,61110,0,1,0
17466,4,2,61113,61113,61115,0,2,3
17467,3,2,61116,61116,61118,0,2,1
17468,4,3,61120,61120,61123,0,3,2
17469,6,3,61126,61126,61129,0,3,3
17470,6,1,61132,61132,61133,0,1,3
17471,1,1,61133,61133,61134,0,1,0
17472,1,1,61134,61134,61135,0,1,0
17473,1,2,61135,61135,61137,0,2,0
17474,3,2,61138,61138,61140,0,2,1
17475,5,3,61143,61143,61146,0,3,3
17476,3,2,61146,61146,61148,0,2,0
17477,2,3,61148,61148,61151,0,3,0
17478,3,1,61151,61151,61152,0,1,0
17479,5,3,61156,61156,61159,0,3,4
17480,2,1,61158,61159,61160,1,2,0
17481,3,3,61161,61161,61164,0,3,1
17482,2,3,61163,61164,61167,1,4,0
17483,3,2,61166,61167,61169,1,3,0
17484,2,1,61168,61169,61170,1,2,0
17485,4,2,61172,61172,61174,0,2,2
17486,3,1,61175,61175,61176,0,1,1
17487,3,3,61178,61178,61181,0,3,2
17488,2,3,61180,61181,61184,1,4,0
17489,3,3,61183,61184,61187,1,4,0
17490,5,2,61188,61188,61190,0,2,1
17491,1,3,61189,61190,61193,1,4,0
17492,3,2,61192,61193,61195,1,3,0
17493,6,1,61198,61198,61199,0,1,3
17494,3,3,61201,61201,61204,0,3,2
17495,3,1,61204,61204,61205,0,1,0
17496,5,2,61209,61209,61211,0,2,4
17497,2,1,61211,61211,61212,0,1,0
17498,2,3,61213,61213,61216,0,3,1
17499,1,2,61214,61216,61218,2,4,0
17500,3,1,61217,61218,61219,1,2,0
17501,4,1,61221,61221,61222,0,1,2
17502,1,2,61222,61222,61224,0,2,0
17503,2,2,61224,61224,61226,0,2,0
17504,5,2,61229,61229,61231,0,2,3
17505,3,2,61232,61232,61234,0,2,1
17506,1,1,61233,61234,61235,1,2,0
17507,2,2,61235,61235,61237,0,2,0
17508,6,1,61241,61241,61242,0,1,4
17509,6,1,61247,61247,61248,0,1,5
17510,2,1,61249,61249,61250,0,1,1
17511,6,3,61255,61255,61258,0,3,5
17512,3,1,61258,61258,61259,0,1,0
17513,6,3,61264,61264,61267,0,3,5
17514,3,3,61267,61267,61270,0,3,0
17515,4,2,61271,61271,61273,0,2,1
17516,1,3,61272,61273,61276,1,4,0
17517,4,3,61276,61276,61279,0,3,0
17518,2,1,61278,61279,61280,1,2,0
17519,6,1,61284,61284,61285,0,1,4
17520,6,3,61290,61290,61293,0,3,5
17521,2,1,61292,61293,61294,1,2,0
17522,6,3,61298,61298,61301,0,3,4
17523,3,3,61301,61301,61304,0,3,0
17524,6,3,61307,61307,61310,0,3,3
17525,3,3,61310,61310,61313,0,3,0
17526,2,1,61312,61313,61314,1,2,0
17527,1,2,61313,61314,61316,1,3,0
17528,1,1,61314,61316,61317,2,3,0
17529,3,3,61317,61317,61320,0,3,0
17530,1,3,61318,61320,61323,2,5,0
17531,1,2,61319,61323,61325,4,6,0
17532,3,3,61322,61325,61328,3,6,0
17533,2,2,61324,61328,61330,4,6,0
17534,2,2,61326,61330,61332,4,6,0
17535,3,2,61329,61332,61334,3,5,0
17536,5,3,61334,61334,61337,0,3,0
17537,2,1,61336,61337,61338,1,2,0
17538,6,1,61342,61342,61343,0,1,4
17539,2,3,61344,61344,61347,0,3,1
17540,2,2,61346,61347,61349,1,3,0
17541,4,3,61350,61350,61353,0,3,1
17542,1,1,61351,61353,61354,2,3,0
17543,6,1,61357,61357,61358,0,1,3
17544,4,2,61361,61361,61363,0,2,3
17545,4,3,61365,61365,61368,0,3,2
17546,4,1,61369,61369,61370,0,1,1
17547,4,1,61373,61373,61374,0,1,3
17548,4,3,61377,61377,61380,0,3,3
17549,3,2,61380,61380,61382,0,2,0
17550,3,3,61383,61383,61386,0,3,1
17551,1,2,61384,61386,61388,2,4,0
17552,2,1,61386,61388,61389,2,3,0
17553,3,2,61389,61389,61391,0,2,0
17554,3,3,61392,61392,61395,0,3,1
17555,3,2,61395,61395,61397,0,2,0
17556,5,2,61400,61400,61402,0,2,3
17557,4,3,61404,61404,61407,0,3,2
17558,6,2,61410,61410,61412,0,2,3
17559,4,2,61414,61414,61416,0,2,2
17560,3,2,61417,61417,61419,0,2,1
17561,1,3,61418,61419,61422,1,4,0
17562,6,1,61424,61424,61425,0,1,2
17563,2,3,61426,61426,61429,0,3,1
17564,3,2,61429,61429,61431,0,2,0
17565,2,3,61431,61431,61434,0,3,0
17566,1,1,61432,61434,61435,2,3,0
17567,6,1,61438,61438,61439,0,1,3
17568,3,1,61441,61441,61442,0,1,2
17569,4,3,61445,61445,61448,0,3,3
17570,4,2,61449,61449,61451,0,2,1
17571,3,2,61452,61452,61454,0,2,1
17572,1,2,61453,61454,61456,1,3,0
17573,4,2,61457,61457,61459,0,2,1
17574,1,2,61458,61459,61461,1,3,0
17575,4,1,61462,61462,61463,0,1,1
17576,2,1,61464,61464,61465,0,1,1
17577,2,3,61466,61466,61469,0,3,1
17578,5,1,61471,61471,61472,0,1,2
17579,3,2,61474,61474,61476,0,2,2
17580,3,1,61477,61477,61478,0,1,1
17581,5,2,61482,61482,61484,0,2,4
17582,4,2,61486,61486,61488,0,2,2
17583,3,1,61489,61489,61490,0,1,1
17584,6,3,61495,61495,61498,0,3,5
17585,1,3,61496,61498,61501,2,5,0
17586,2,2,61498,61501,61503,3,5,0
17587,5,2,61503,61503,61505,0,2,0
17588,5,1,61508,61508,61509,0,1,3
17589,1,2,61509,61509,61511,0,2,0
17590,6,3,61515,61515,61518,0,3,4
17591,5,2,61520,61520,61522,0,2,2
17592,6,2,61526,61526,61528,0,2,4
17593,1,2,61527,61528,61530,1,3,0
17594,1,2,61528,61530,61532,2,4,0
17595,4,2,61532,61532,61534,0,2,0
17596,2,1,61534,61534,61535,0,1,0
17597,5,1,61539,61539,61540,0,1,4
17598,4,3,61543,61543,61546,0,3,3
17599,1,3,61544,61546,61549,2,5,0
17600,2,1,61546,61549,61550,3,4,0
17601,5,2,61551,61551,61553,0,2,1
17602,5,1,61556,61556,61557,0,1,3
17603,2,3,61558,61558,61561,0,3,1
17604,3,1,61561,61561,61562,0,1,0
17605,6,1,61567,61567,61568,0,1,5
17606,1,3,61568,61568,61571,0,3,0
17607,5,2,61573,61573,61575,0,2,2
17608,4,3,61577,61577,61580,0,3,2
17609,5,3,61582,61582,61585,0,3,2
17610,3,2,61585,61585,61587,0,2,0
17611,2,3,61587,61587,61590,0,3,0
17612,2,1,61589,61590,61591,1,2,0
17613,4,1,61593,61593,61594,0,1,2
17614,1,1,61594,61594,61595,0,1,0
17615,1,1,61595,61595,61596,0,1,0
17616,6,3,61601,61601,61604,0,3,5
17617,6,2,61607,61607,61609,0,2,3
17618,6,1,61613,61613,61614,0,1,4
17619,6,3,61619,61619,61622,0,3,5
17620,3,3,61622,61622,61625,0,3,0
17621,6,2,61628,61628,61630,0,2,3
17622,1,1,61629,61630,61631,1,2,0
17623,3,1,61632,61632,61633,0,1,1
17624,6,3,61638,61638,61641,0,3,5
17625,2,3,61640,61641,61644,1,4,0
17626,4,2,61644,61644,61646,0,2,0
17627,5,2,61649,61649,61651,0,2,3
17628,5,3,61654,61654,61657,0,3,3
17629,3,3,61657,61657,61660,0,3,0
17630,6,2,61663,61663,61665,0,2,3
17631,1,1,61664,61665,61666,1,2,0
17632,4,3,61668,61668,61671,0,3,2
17633,4,3,61672,61672,61675,0,3,1
17634,1,1,61673,61675,61676,2,3,0
17635,2,1,61675,61676,61677,1,2,0
17636,5,1,61680,61680,61681,0,1,3
17637,2,1,61682,61682,61683,0,1,1
17638,1,3,61683,61683,61686,0,3,0
17639,4,1,61687,61687,61688,0,1,1
17640,5,2,61692,61692,61694,0,2,4
17641,1,3,61693,61694,61697,1,4,0
17642,5,3,61698,61698,61701,0,3,1
17643,4,1,61702,61702,61703,0,1,1
17644,2,2,61704,61704,61706,0,2,1
17645,1,2,61705,61706,61708,1,3,0
17646,6,3,61711,61711,61714,0,3,3
17647,3,1,61714,61714,61715,0,1,0
17648,4,2,61718,61718,61720,0,2,3
17649,3,1,61721,61721,61722,0,1,1
17650,2,2,61723,61723,61725,0,2,1
17651,6,3,61729,61729,61732,0,3,4
17652,3,2,61732,61732,61734,0,2,0
17653,3,2,61735,61735,61737,0,2,1
17654,5,3,61740,61740,61743,0,3,3
17655,6,3,61746,61746,61749,0,3,3
17656,4,2,61750,61750,61752,0,2,1
17657,4,2,61754,61754,61756,0,2,2
17658,6,3,61760,61760,61763,0,3,4
17659,5,2,61765,61765,61767,0,2,2
17660,3,2,61768,61768,61770,0,2,1
17661,6,3,61774,61774,61777,0,3,4
17662,4,1,61778,61778,61779,0,1,1
17663,6,1,61784,61784,61785,0,1,5
17664,2,1,61786,61786,61787,0,1,1
17665,5,1,61791,61791,61792,0,1,4
17666,6,2,61797,61797,61799,0,2,5
17667,1,1,61798,61799,61800,1,2,0
17668,6,3,61804,61804,61807,0,3,4
17669,6,1,61810,61810,61811,0,1,3
17670,4,2,61814,61814,61816,0,2,3
17671,2,2,61816,61816,61818,0,2,0
17672,5,3,61821,61821,61824,0,3,3
17673,3,2,61824,61824,61826,0,2,0
17674,4,2,61828,61828,61830,0,2,2
17675,4,3,61832,61832,61835,0,3,2
17676,2,1,61834,61835,61836,1,2,0
17677,1,1,61835,61836,61837,1,2,0
17678,4,2,61839,61839,61841,0,2,2
17679,1,2,61840,61841,61843,1,3,0
17680,6,1,61846,61846,61847,0,1,3
17681,1,3,61847,61847,61850,0,3,0
17682,1,1,61848,61850,61851,2,3,0
17683,4,1,61852,61852,61853,0,1,1
17684,4,3,61856,61856,61859,0,3,3
17685,2,2,61858,61859,61861,1,3,0
17686,1,3,61859,61861,61864,2,5,0
17687,5,3,61864,61864,61867,0,3,0
17688,4,3,61868,61868,61871,0,3,1
17689,3,2,61871,61871,61873,0,2,0
17690,3,2,61874,61874,61876,0,2,1
17691,4,3,61878,61878,61881,0,3,2
17692,3,1,61881,61881,61882,0,1,0
17693,6,2,61887,61887,61889,0,2,5
17694,1,3,61888,61889,61892,1,4,0
17695,6,2,61894,61894,61896,0,2,2
17696,2,1,61896,61896,61897,0,1,0
17697,2,1,61898,61898,61899,0,1,1
17698,2,1,61900,61900,61901,0,1,1
17699,1,3,61901,61901,61904,0,3,0
17700,1,1,61902,61904,61905,2,3,0
17701,6,2,61908,61908,61910,0,2,3
17702,6,1,61914,61914,61915,0,1,4
17703,1,1,61915,61915,61916,0,1,0
17704,6,3,61921,61921,61924,0,3,5
17705,1,2,61922,61924,61926,2,4,0
17706,6,3,61928,61928,61931,0,3,2
17707,2,2,61930,61931,61933,1,3,0
17708,6,1,61936,61936,61937,0,1,3
17709,3,2,61939,61939,61941,0,2,2
17710,5,1,61944,61944,61945,0,1,3
17711,4,2,61948,61948,61950,0,2,3
17712,3,2,61951,61951,61953,0,2,1
17713,4,2,61955,61955,61957,0,2,2
17714,5,3,61960,61960,61963,0,3,3
17715,5,1,61965,61965,61966,0,1,2
17716,5,3,61970,61970,61973,0,3,4
17717,3,3,61973,61973,61976,0,3,0
17718,3,1,61976,61976,61977,0,1,0
17719,1,3,61977,61977,61980,0,3,0
17720,2,2,61979,61980,61982,1,3,0
17721,3,1,61982,61982,61983,0,1,0
17722,6,1,61988,61988,61989,0,1,5
17723,4,3,61992,61992,61995,0,3,3
17724,5,1,61997,61997,61998,0,1,2
17725,3,3,62000,62000,62003,0,3,2
17726,4,1,62004,62004,62005,0,1,1
17727,4,3,62008,62008,62011,0,3,3
17728,5,1,62013,62013,62014,0,1,2
17729,6,3,62019,62019,62022,0,3,5
17730,2,1,62021,62022,62023,1,2,0
17731,2,1,62023,62023,62024,0,1,0
17732,6,1,62029,62029,62030,0,1,5
17733,3,3,62032,62032,62035,0,3,2
17734,2,2,62034,62035,62037,1,3,0
17735,4,3,62038,62038,62041,0,3,1
17736,6,2,62044,62044,62046,0,2,3
17737,1,1,62045,62046,62047,1,2,0
17738,3,1,62048,62048,62049,0,1,1
17739,3,2,62051,62051,62053,0,2,2
17740,1,1,62052,62053,62054,1,2,0
17741,4,1,62056,62056,62057,0,1,2
17742,6,2,62062,62062,62064,0,2,5
17743,6,2,62068,62068,62070,0,2,4
17744,6,1,62074,62074,62075,0,1,4
17745,3,3,62077,62077,62080,0,3,2
17746,3,3,62080,62080,62083,0,3,0
17747,2,1,62082,62083,62084,1,2,0
17748,3,3,62085,62085,62088,0,3,1
17749,4,2,62089,62089,62091,0,2,1
17750,3,1,62092,62092,62093,0,1,1
17751,2,2,62094,62094,62096,0,2,1
17752,4,1,62098,62098,62099,0,1,2
17753,6,3,62104,62104,62107,0,3,5
17754,3,1,62107,62107,62108,0,1,0
17755,6,1,62113,62113,62114,0,1,5
17756,3,3,62116,62116,62119,0,3,2
17757,3,3,62119,62119,62122,0,3,0
17758,4,2,62123,62123,62125,0,2,1
17759,2,1,62125,62125,62126,0,1,0
17760,3,3,62128,62128,62131,0,3,2
17761,2,3,62130,62131,62134,1,4,0
17762,5,2,62135,62135,62137,0,2,1
17763,3,1,62138,62138,62139,0,1,1
17764,3,1,62141,62141,62142,0,1,2
17765,4,2,62145,62145,62147,0,2,3
17766,5,2,62150,62150,62152,0,2,3
17767,6,1,62156,62156,62157,0,1,4
17768,3,2,62159,62159,62161,0,2,2
17769,4,2,62163,62163,62165,0,2,2
17770,1,1,62164,62165,62166,1,2,0
17771,1,3,62165,62166,62169,1,4,0
17772,1,1,62166,62169,62170,3,4,0
17773,6,3,62172,62172,62175,0,3,2
17774,3,1,62175,62175,62176,0,1,0
17775,3,3,62178,62178,62181,0,3,2
17776,4,1,62182,62182,62183,0,1,1
17777,5,3,62187,62187,62190,0,3,4
17778,6,3,62193,62193,62196,0,3,3
17779,1,3,62194,62196,62199,2,5,0
17780,3,3,62197,62199,62202,2,5,0
17781,3,2,62200,62202,62204,2,4,0
17782,3,1,62203,62204,62205,1,2,0
17783,6,2,62209,62209,62211,0,2,4
17784,4,3,62213,62213,62216,0,3,2
17785,6,1,62219,62219,62220,0,1,3
17786,5,3,62224,62224,62227,0,3,4
17787,1,3,62225,62227,62230,2,5,0
17788,2,1,62227,62230,62231,3,4,0
17789,4,2,62231,62231,62233,0,2,0
17790,5,1,62236,62236,62237,0,1,3
17791,6,1,62242,62242,62243,0,1,5
17792,3,3,62245,62245,62248,0,3,2
17793,5,1,62250,62250,62251,0,1,2
17794,1,2,62251,62251,62253,0,2,0
17795,3,2,62254,62254,62256,0,2,1
17796,1,1,62255,62256,62257,1,2,0
17797,1,2,62256,62257,62259,1,3,0
17798,4,2,62260,62260,62262,0,2,1
17799,1,3,62261,62262,62265,1,4,0
17800,1,2,62262,62265,62267,3,5,0
17801,2,3,62264,62267,62270,3,6,0
17802,1,1,62265,62270,62271,5,6,0
17803,4,3,62269,62271,62274,2,5,0
17804,3,2,62272,62274,62276,2,4,0
17805,3,3,62275,62276,62279,1,4,0
17806,6,1,62281,62281,62282,0,1,2
17807,5,3,62286,62286,62289,0,3,4
17808,4,3,62290,62290,62293,0,3,1
17809,2,1,62292,62293,62294,1,2,0
17810,4,3,62296,62296,62299,0,3,2
17811,5,3,62301,62301,62304,0,3,2
17812,2,2,62303,62304,62306,1,3,0
17813,4,2,62307,62307,62309,0,2,1
17814,2,1,62309,62309,62310,0,1,0
17815,1,1,62310,62310,62311,0,1,0
17816,6,2,62316,62316,62318,0,2,5
17817,5,1,62321,62321,62322,0,1,3
17818,3,3,62324,62324,62327,0,3,2
17819,3,3,62327,62327,62330,0,3,0
17820,5,1,62332,62332,62333,0,1,2
17821,1,3,62333,62333,62336,0,3,0
17822,4,3,62337,62337,62340,0,3,1
17823,6,1,62343,62343,62344,0,1,3
17824,5,3,62348,62348,62351,0,3,4
17825,3,2,62351,62351,62353,0,2,0
17826,4,3,62355,62355,62358,0,3,2
17827,4,1,62359,62359,62360,0,1,1
17828,4,3,62363,62363,62366,0,3,3
17829,1,3,62364,62366,62369,2,5,0
17830,3,3,62367,62369,62372,2,5,0
17831,4,3,62371,62372,62375,1,4,0
17832,4,3,62375,62375,62378,0,3,0
17833,2,3,62377,62378,62381,1,4,0
17834,6,2,62383,62383,62385,0,2,2
17835,1,1,62384,62385,62386,1,2,0
17836,5,2,62389,62389,62391,0,2,3
17837,5,3,62394,62394,62397,0,3,3
17838,6,2,62400,62400,62402,0,2,3
17839,2,2,62402,62402,62404,0,2,0
17840,3,3,62405,62405,62408,0,3,1
17841,1,2,62406,62408,62410,2,4,0
17842,3,1,62409,62410,62411,1,2,0
17843,6,3,62415,62415,62418,0,3,4
17844,3,1,62418,62418,62419,0,1,0
17845,4,2,62422,62422,62424,0,2,3
17846,1,2,62423,62424,62426,1,3,0
17847,5,2,62428,62428,62430,0,2,2
17848,4,2,62432,62432,62434,0,2,2
17849,6,2,62438,62438,62440,0,2,4
17850,2,1,62440,62440,62441,0,1,0
17851,1,1,62441,62441,62442,0,1,0
17852,1,1,62442,62442,62443,0,1,0
17853,3,3,62445,62445,62448,0,3,2
17854,4,2,62449,62449,62451,0,2,1
17855,3,1,62452,62452,62453,0,1,1
17856,2,3,62454,62454,62457,0,3,1
17857,6,3,62460,62460,62463,0,3,3
17858,3,3,62463,62463,62466,0,3,0
17859,3,2,62466,62466,62468,0,2,0
17860,1,2,62467,62468,62470,1,3,0
17861,3,2,62470,62470,62472,0,2,0
17862,1,1,62471,62472,62473,1,2,0
17863,5,1,62476,62476,62477,0,1,3
17864,2,2,62478,62478,62480,0,2,1
17865,6,3,62484,62484,62487,0,3,4
17866,5,2,62489,62489,62491,0,2,2
17867,4,2,62493,62493,62495,0,2,2
17868,3,3,62496,62496,62499,0,3,1
17869,3,1,62499,62499,62500,0,1,0
17870,2,3,62501,62501,62504,0,3,1
17871,3,2,62504,62504,62506,0,2,0
17872,6,1,62510,62510,62511,0,1,4
17873,1,2,62511,62511,62513,0,2,0
17874,2,1,62513,62513,62514,0,1,0
17875,6,2,62519,62519,62521,0,2,5
17876,6,1,62525,62525,62526,0,1,4
17877,2,1,62527,62527,62528,0,1,1
17878,6,2,62533,62533,62535,0,2,5
17879,4,3,62537,62537,62540,0,3,2
17880,6,2,62543,62543,62545,0,2,3
17881,6,2,62549,62549,62551,0,2,4
17882,6,2,62555,62555,62557,0,2,4
17883,3,2,62558,62558,62560,0,2,1
17884,4,3,62562,62562,62565,0,3,2
17885,4,1,62566,62566,62567,0,1,1
17886,1,1,62567,62567,62568,0,1,0
17887,1,1,62568,62568,62569,0,1,0
17888,1,2,62569,62569,62571,0,2,0
17889,1,3,62570,62571,62574,1,4,0
17890,6,1,62576,62576,62577,0,1,2
17891,1,1,62577,62577,62578,0,1,0
17892,3,3,62580,62580,62583,0,3,2
17893,6,3,62586,62586,62589,0,3,3
17894,4,3,62590,62590,62593,0,3,1
17895,3,3,62593,62593,62596,0,3,0
17896,2,2,62595,62596,62598,1,3,0
17897,1,2,62596,62598,62600,2,4,0
17898,1,1,62597,62600,62601,3,4,0
17899,2,2,62599,62601,62603,2,4,0
17900,5,1,62604,62604,62605,0,1,1
17901,5,2,62609,62609,62611,0,2,4
17902,2,3,62611,62611,62614,0,3,0
17903,1,3,62612,62614,62617,2,5,0
17904,4,1,62616,62617,62618,1,2,0
17905,5,3,62621,62621,62624,0,3,3
17906,1,1,62622,62624,62625,2,3,0
17907,3,3,62625,62625,62628,0,3,0
17908,5,2,62630,62630,62632,0,2,2
17909,5,2,62635,62635,62637,0,2,3
17910,6,3,62641,62641,62644,0,3,4
17911,6,1,62647,62647,62648,0,1,3
17912,2,3,62649,62649,62652,0,3,1
17913,6,1,62655,62655,62656,0,1,3
17914,2,2,62657,62657,62659,0,2,1
17915,6,3,62663,62663,62666,0,3,4
17916,1,3,62664,62666,62669,2,5,0
17917,3,1,62667,62669,62670,2,3,0
17918,3,1,62670,62670,62671,0,1,0
17919,3,1,62673,62673,62674,0,1,2
17920,1,3,62674,62674,62677,0,3,0
17921,4,2,62678,62678,62680,0,2,1
17922,5,3,62683,62683,62686,0,3,3
17923,1,2,62684,62686,62688,2,4,0
17924,4,1,62688,62688,62689,0,1,0
17925,4,2,62692,62692,62694,0,2,3
17926,3,2,62695,62695,62697,0,2,1
17927,1,2,62696,62697,62699,1,3,0
17928,1,3,62697,62699,62702,2,5,0
17929,3,3,62700,62702,62705,2,5,0
17930,5,1,62705,62705,62706,0,1,0
17931,5,1,62710,62710,62711,0,1,4
17932,6,3,62716,62716,62719,0,3,5
17933,4,1,62720,62720,62721,0,1,1
17934,1,3,62721,62721,62724,0,3,0
17935,2,1,62723,62724,62725,1,2,0
17936,2,2,62725,62725,62727,0,2,0
17937,1,3,62726,62727,62730,1,4,0
17938,3,2,62729,62730,62732,1,3,0
17939,4,2,62733,62733,62735,0,2,1
17940,1,3,62734,62735,62738,1,4,0
17941,4,2,62738,62738,62740,0,2,0
17942,4,2,62742,62742,62744,0,2,2
17943,2,3,62744,62744,62747,0,3,0
17944,4,1,62748,62748,62749,0,1,1
17945,2,1,62750,62750,62751,0,1,1
17946,4,3,62754,62754,62757,0,3,3
17947,6,2,62760,62760,62762,0,2,3
17948,6,2,62766,62766,62768,0,2,4
17949,3,1,62769,62769,62770,0,1,1
17950,1,3,62770,62770,62773,0,3,0
17951,6,1,62776,62776,62777,0,1,3
17952,1,3,62777,62777,62780,0,3,0
17953,3,1,62780,62780,62781,0,1,0
17954,2,3,62782,62782,62785,0,3,1
17955,5,2,62787,62787,62789,0,2,2
17956,6,1,62793,62793,62794,0,1,4
17957,4,3,62797,62797,62800,0,3,3
17958,6,3,62803,62803,62806,0,3,3
17959,3,2,62806,62806,62808,0,2,0
17960,1,3,62807,62808,62811,1,4,0
17961,2,2,62809,62811,62813,2,4,0
17962,6,1,62815,62815,62816,0,1,2
17963,1,1,62816,62816,62817,0,1,0
17964,2,1,62818,62818,62819,0,1,1
17965,1,2,62819,62819,62821,0,2,0
17966,3,2,62822,62822,62824,0,2,1
17967,5,3,62827,62827,62830,0,3,3
17968,4,2,62831,62831,62833,0,2,1
17969,1,3,62832,62833,62836,1,4,0
17970,4,3,62836,62836,62839,0,3,0
17971,5,3,62841,62841,62844,0,3,2
17972,1,2,62842,62844,62846,2,4,0
17973,5,2,62847,62847,62849,0,2,1
17974,6,3,62853,62853,62856,0,3,4
17975,2,2,62855,62856,62858,1,3,0
17976,6,3,62861,62861,62864,0,3,3
17977,2,2,62863,62864,62866,1,3,0
17978,5,2,62868,62868,62870,0,2,2
17979,6,3,62874,62874,62877,0,3,4
17980,5,2,62879,62879,62881,0,2,2
17981,6,2,62885,62885,62887,0,2,4
17982,2,1,62887,62887,62888,0,1,0
17983,6,1,62893,62893,62894,0,1,5
17984,1,2,62894,62894,62896,0,2,0
17985,3,1,62897,62897,62898,0,1,1
17986,5,3,62902,62902,62905,0,3,4
17987,3,1,62905,62905,62906,0,1,0
17988,2,3,62907,62907,62910,0,3,1
17989,6,2,62913,62913,62915,0,2,3
17990,2,2,62915,62915,62917,0,2,0
17991,5,2,62920,62920,62922,0,2,3
17992,4,2,62924,62924,62926,0,2,2
17993,3,3,62927,62927,62930,0,3,1
17994,3,1,62930,62930,62931,0,1,0
17995,4,2,62934,62934,62936,0,2,3
17996,6,3,62940,62940,62943,0,3,4
17997,1,2,62941,62943,62945,2,4,0
17998,2,1,62943,62945,62946,2,3,0
17999,4,1,62947,62947,62948,0,1,1
18000,3,3,62950,62950,62953,0,3,2
18001,1,2,62951,62953,62955,2,4,0
18002,4,1,62955,62955,62956,0,1,0
18003,3,2,62958,62958,62960,0,2,2
18004,3,2,62961,62961,62963,0,2,1
18005,4,2,62965,62965,62967,0,2,2
18006,1,2,62966,62967,62969,1,3,0
18007,5,1,62971,62971,62972,0,1,2
18008,5,3,62976,62976,62979,0,3,4
18009,3,1,62979,62979,62980,0,1,0
18010,1,2,62980,62980,62982,0,2,0
18011,5,2,62985,62985,62987,0,2,3
18012,2,2,62987,62987,62989,0,2,0
18013,1,3,62988,62989,62992,1,4,0
18014,1,2,62989,62992,62994,3,5,0
18015,6,2,62995,62995,62997,0,2,1
18016,4,3,62999,62999,63002,0,3,2
18017,3,1,63002,63002,63003,0,1,0
18018,2,1,63004,63004,63005,0,1,1
18019,6,2,63010,63010,63012,0,2,5
18020,4,2,63014,63014,63016,0,2,2
18021,6,1,63020,63020,63021,0,1,4
18022,5,1,63025,63025,63026,0,1,4
18023,1,3,63026,63026,63029,0,3,0
18024,1,3,63027,63029,63032,2,5,0
18025,2,3,63029,63032,63035,3,6,0
18026,3,3,63032,63035,63038,3,6,0
18027,6,3,63038,63038,63041,0,3,0
18028,5,3,63043,63043,63046,0,3,2
18029,3,1,63046,63046,63047,0,1,0
18030,3,1,63049,63049,63050,0,1,2
18031,4,3,63053,63053,63056,0,3,3
18032,5,1,63058,63058,63059,0,1,2
18033,3,3,63061,63061,63064,0,3,2
18034,4,1,63065,63065,63066,0,1,1
18035,4,3,63069,63069,63072,0,3,3
18036,4,2,63073,63073,63075,0,2,1
18037,2,3,63075,63075,63078,0,3,0
18038,1,2,63076,63078,63080,2,4,0
18039,1,1,63077,63080,63081,3,4,0
18040,1,3,63078,63081,63084,3,6,0
18041,3,3,63081,63084,63087,3,6,0
18042,2,2,63083,63087,63089,4,6,0
18043,3,1,63086,63089,63090,3,4,0
18044,3,2,63089,63090,63092,1,3,0
18045,2,3,63091,63092,63095,1,4,0
18046,6,2,63097,63097,63099,0,2,2
18047,1,2,63098,63099,63101,1,3,0
18048,5,3,63103,63103,63106,0,3,2
18049,6,1,63109,63109,63110,0,1,3
18050,1,1,63110,63110,63111,0,1,0
18051,1,3,63111,63111,63114,0,3,0
18052,1,3,63112,63114,63117,2,5,0
18053,2,2,63114,63117,63119,3,5,0
18054,6,2,63120,63120,63122,0,2,1
18055,1,3,63121,63122,63125,1,4,0
18056,3,2,63124,63125,63127,1,3,0
18057,2,1,63126,63127,63128,1,2,0
18058,2,1,63128,63128,63129,0,1,0
18059,6,1,63134,63134,63135,0,1,5
18060,5,1,63139,63139,63140,0,1,4
18061,6,2,63145,63145,63147,0,2,5
18062,3,3,63148,63148,63151,0,3,1
18063,4,2,63152,63152,63154,0,2,1
18064,2,3,63154,63154,63157,0,3,0
18065,2,1,63156,63157,63158,1,2,0
18066,4,3,63160,63160,63163,0,3,2
18067,3,2,63163,63163,63165,0,2,0
18068,4,1,63167,63167,63168,0,1,2
18069,5,2,63172,63172,63174,0,2,4
18070,6,2,63178,63178,63180,0,2,4
18071,6,3,63184,63184,63187,0,3,4
18072,1,2,63185,63187,63189,2,4,0
18073,3,1,63188,63189,63190,1,2,0
18074,1,1,63189,63190,63191,1,2,0
18075,4,3,63193,63193,63196,0,3,2
18076,2,1,63195,63196,63197,1,2,0
18077,2,1,63197,63197,63198,0,1,0
18078,4,1,63201,63201,63202,0,1,3
18079,1,2,63202,63202,63204,0,2,0
18080,2,2,63204,63204,63206,0,2,0
18081,2,2,63206,63206,63208,0,2,0
18082,1,3,63207,63208,63211,1,4,0
18083,6,1,63213,63213,63214,0,1,2
18084,2,3,63215,63215,63218,0,3,1
18085,6,2,63221,63221,63223,0,2,3
18086,5,1,63226,63226,63227,0,1,3
18087,5,3,63231,63231,63234,0,3,4
18088,6,1,63237,63237,63238,0,1,3
18089,5,2,63242,63242,63244,0,2,4
18090,3,3,63245,63245,63248,0,3,1
18091,1,1,63246,63248,63249,2,3,0
18092,6,2,63252,63252,63254,0,2,3
18093,3,2,63255,63255,63257,0,2,1
18094,4,2,63259,63259,63261,0,2,2
18095,6,3,63265,63265,63268,0,3,4
18096,1,1,63266,63268,63269,2,3,0
18097,4,2,63270,63270,63272,0,2,1
18098,4,3,63274,63274,63277,0,3,2
18099,1,2,63275,63277,63279,2,4,0
18100,6,2,63281,63281,63283,0,2,2
18101,2,3,63283,63283,63286,0,3,0
18102,2,2,63285,63286,63288,1,3,0
18103,4,3,63289,63289,63292,0,3,1
18104,2,2,63291,63292,63294,1,3,0
18105,1,1,63292,63294,63295,2,3,0
18106,5,1,63297,63297,63298,0,1,2
18107,2,1,63299,63299,63300,0,1,1
18108,1,3,63300,63300,63303,0,3,0
18109,4,1,63304,63304,63305,0,1,1
18110,4,1,63308,63308,63309,0,1,3
18111,1,1,63309,63309,63310,0,1,0
18112,3,1,63312,63312,63313,0,1,2
18113,4,3,63316,63316,63319,0,3,3
18114,3,3,63319,63319,63322,0,3,0
18115,4,2,63323,63323,63325,0,2,1
18116,4,2,63327,63327,63329,0,2,2
18117,5,2,63332,63332,63334,0,2,3
18118,6,1,63338,63338,63339,0,1,4
18119,3,3,63341,63341,63344,0,3,2
18120,3,1,63344,63344,63345,0,1,0
18121,4,2,63348,63348,63350,0,2,3
18122,6,2,63354,63354,63356,0,2,4
18123,6,1,63360,63360,63361,0,1,4
18124,4,3,63364,63364,63367,0,3,3
18125,6,3,63370,63370,63373,0,3,3
18126,2,1,63372,63373,63374,1,2,0
18127,2,1,63374,63374,63375,0,1,0
18128,5,1,63379,63379,63380,0,1,4
18129,2,3,63381,63381,63384,0,3,1
18130,2,1,63383,63384,63385,1,2,0
18131,6,2,63389,63389,63391,0,2,4
18132,5,1,63394,63394,63395,0,1,3
18133,1,3,63395,63395,63398,0,3,0
18134,1,3,63396,63398,63401,2,5,0
18135,1,2,63397,63401,63403,4,6,0
18136,3,2,63400,63403,63405,3,5,0
18137,2,3,63402,63405,63408,3,6,0
18138,3,2,63405,63408,63410,3,5,0
18139,2,3,63407,63410,63413,3,6,0
18140,4,1,63411,63413,63414,2,3,0
18141,5,2,63416,63416,63418,0,2,2
18142,2,3,63418,63418,63421,0,3,0
18143,1,3,63419,63421,63424,2,5,0
18144,2,1,63421,63424,63425,3,4,0
18145,2,2,63423,63425,63427,2,4,0
18146,5,2,63428,63428,63430,0,2,1
18147,5,3,63433,63433,63436,0,3,3
18148,4,1,63437,63437,63438,0,1,1
18149,1,2,63438,63438,63440,0,2,0
18150,6,2,63444,63444,63446,0,2,4
18151,6,2,63450,63450,63452,0,2,4
18152,4,3,63454,63454,63457,0,3,2
18153,3,1,63457,63457,63458,0,1,0
18154,6,3,63463,63463,63466,0,3,5
18155,2,2,63465,63466,63468,1,3,0
18156,4,1,63469,63469,63470,0,1,1
18157,5,1,63474,63474,63475,0,1,4
18158,2,2,63476,63476,63478,0,2,1
18159,4,3,63480,63480,63483,0,3,2
18160,1,3,63481,63483,63486,2,5,0
18161,1,2,63482,63486,63488,4,6,0
18162,5,1,63487,63488,63489,1,2,0
18163,4,3,63491,63491,63494,0,3,2
18164,6,3,63497,63497,63500,0,3,3
18165,6,2,63503,63503,63505,0,2,3
18166,4,1,63507,63507,63508,0,1,2
18167,1,2,63508,63508,63510,0,2,0
18168,1,2,63509,63510,63512,1,3,0
18169,1,2,63510,63512,63514,2,4,0
18170,6,3,63516,63516,63519,0,3,2
18171,2,3,63518,63519,63522,1,4,0
18172,2,3,63520,63522,63525,2,5,0
18173,4,1,63524,63525,63526,1,2,0
18174,5,1,63529,63529,63530,0,1,3
18175,4,1,63533,63533,63534,0,1,3
18176,2,3,63535,63535,63538,0,3,1
18177,4,1,63539,63539,63540,0,1,1
18178,5,1,63544,63544,63545,0,1,4
18179,2,1,63546,63546,63547,0,1,1
18180,4,3,63550,63550,63553,0,3,3
18181,5,3,63555,63555,63558,0,3,2
18182,4,1,63559,63559,63560,0,1,1
18183,6,3,63565,63565,63568,0,3,5
18184,6,2,63571,63571,63573,0,2,3
18185,5,2,63576,63576,63578,0,2,3
18186,2,2,63578,63578,63580,0,2,0
18187,6,3,63584,63584,63587,0,3,4
18188,4,1,63588,63588,63589,0,1,1
18189,3,1,63591,63591,63592,0,1,2
18190,5,3,63596,63596,63599,0,3,4
18191,5,3,63601,63601,63604,0,3,2
18192,5,3,63606,63606,63609,0,3,2
18193,5,3,63611,63611,63614,0,3,2
18194,2,1,63613,63614,63615,1,2,0
18195,2,3,63615,63615,63618,0,3,0
18196,5,2,63620,63620,63622,0,2,2
18197,4,3,63624,63624,63627,0,3,2
18198,3,2,63627,63627,63629,0,2,0
18199,3,2,63630,63630,63632,0,2,1
18200,6,1,63636,63636,63637,0,1,4
18201,6,1,63642,63642,63643,0,1,5
18202,2,1,63644,63644,63645,0,1,1
18203,4,2,63648,63648,63650,0,2,3
18204,6,1,63654,63654,63655,0,1,4
18205,2,3,63656,63656,63659,0,3,1
18206,3,2,63659,63659,63661,0,2,0
18207,3,1,63662,63662,63663,0,1,1
18208,3,1,63665,63665,63666,0,1,2
18209,1,1,63666,63666,63667,0,1,0
18210,2,2,63668,63668,63670,0,2,1
18211,4,2,63672,63672,63674,0,2,2
18212,3,2,63675,63675,63677,0,2,1
18213,2,2,63677,63677,63679,0,2,0
18214,6,1,63683,63683,63684,0,1,4
18215,1,2,63684,63684,63686,0,2,0
18216,3,2,63687,63687,63689,0,2,1
18217,4,3,63691,63691,63694,0,3,2
18218,4,1,63695,63695,63696,0,1,1
18219,6,2,63701,63701,63703,0,2,5
18220,2,3,63703,63703,63706,0,3,0
18221,5,2,63708,63708,63710,0,2,2
18222,3,1,63711,63711,63712,0,1,1
18223,2,1,63713,63713,63714,0,1,1
18224,6,1,63719,63719,63720,0,1,5
18225,5,3,63724,63724,63727,0,3,4
18226,2,1,63726,63727,63728,1,2,0
18227,5,2,63731,63731,63733,0,2,3
18228,2,1,63733,63733,63734,0,1,0
18229,1,1,63734,63734,63735,0,1,0
18230,2,1,63736,63736,63737,0,1,1
18231,1,3,63737,63737,63740,0,3,0
18232,3,1,63740,63740,63741,0,1,0
18233,6,2,63746,63746,63748,0,2,5
18234,4,2,63750,63750,63752,0,2,2
18235,5,1,63755,63755,63756,0,1,3
18236,4,2,63759,63759,63761,0,2,3
18237,2,1,63761,63761,63762,0,1,0
18238,1,1,63762,63762,63763,0,1,0
18239,6,3,63768,63768,63771,0,3,5
18240,4,3,63772,63772,63775,0,3,1
18241,5,1,63777,63777,63778,0,1,2
18242,3,1,63780,63780,63781,0,1,2
18243,1,1,63781,63781,63782,0,1,0
18244,3,1,63784,63784,63785,0,1,2
18245,6,3,63790,63790,63793,0,3,5
18246,6,3,63796,63796,63799,0,3,3
18247,3,3,63799,63799,63802,0,3,0
18248,3,3,63802,63802,63805,0,3,0
18249,3,1,63805,63805,63806,0,1,0
18250,2,1,63807,63807,63808,0,1,1
18251,6,3,63813,63813,63816,0,3,5
18252,6,1,63819,63819,63820,0,1,3
18253,2,2,63821,63821,63823,0,2,1
18254,5,1,63826,63826,63827,0,1,3
18255,6,1,63832,63832,63833,0,1,5
18256,4,3,63836,63836,63839,0,3,3
18257,4,3,63840,63840,63843,0,3,1
18258,1,1,63841,63843,63844,2,3,0
18259,5,2,63846,63846,63848,0,2,2
18260,2,1,63848,63848,63849,0,1,0
18261,3,1,63851,63851,63852,0,1,2
18262,6,3,63857,63857,63860,0,3,5
18263,3,2,63860,63860,63862,0,2,0
18264,4,2,63864,63864,63866,0,2,2
18265,1,1,63865,63866,63867,1,2,0
18266,4,2,63869,63869,63871,0,2,2
18267,6,3,63875,63875,63878,0,3,4
18268,1,1,63876,63878,63879,2,3,0
18269,4,1,63880,63880,63881,0,1,1
18270,3,2,63883,63883,63885,0,2,2
18271,5,3,63888,63888,63891,0,3,3
18272,2,2,63890,63891,63893,1,3,0
18273,2,1,63892,63893,63894,1,2,0
18274,3,3,63895,63895,63898,0,3,1
18275,4,3,63899,63899,63902,0,3,1
18276,4,2,63903,63903,63905,0,2,1
18277,4,2,63907,63907,63909,0,2,2
18278,6,3,63913,63913,63916,0,3,4
18279,6,3,63919,63919,63922,0,3,3
18280,5,3,63924,63924,63927,0,3,2
18281,3,3,63927,63927,63930,0,3,0
18282,2,1,63929,63930,63931,1,2,0
18283,5,2,63934,63934,63936,0,2,3
18284,2,2,63936,63936,63938,0,2,0
18285,3,3,63939,63939,63942,0,3,1
18286,1,2,63940,63942,63944,2,4,0
18287,1,1,63941,63944,63945,3,4,0
18288,5,1,63946,63946,63947,0,1,1
18289,6,1,63952,63952,63953,0,1,5
18290,3,2,63955,63955,63957,0,2,2
18291,6,2,63961,63961,63963,0,2,4
18292,5,3,63966,63966,63969,0,3,3
18293,1,1,63967,63969,63970,2,3,0
18294,5,2,63972,63972,63974,0,2,2
18295,3,2,63975,63975,63977,0,2,1
18296,2,1,63977,63977,63978,0,1,0
18297,5,3,63982,63982,63985,0,3,4
18298,6,1,63988,63988,63989,0,1,3
18299,6,1,63994,63994,63995,0,1,5
18300,1,2,63995,63995,63997,0,2,0
18301,4,2,63999,63999,64001,0,2,2
18302,1,1,64000,64001,64002,1,2,0
18303,4,1,64004,64004,64005,0,1,2
18304,2,1,64006,64006,64007,0,1,1
18305,2,1,64008,64008,64009,0,1,1
18306,1,1,64009,64009,64010,0,1,0
18307,1,1,64010,64010,64011,0,1,0
18308,1,1,64011,64011,64012,0,1,0
18309,4,2,64015,64015,64017,0,2,3
18310,5,3,64020,64020,64023,0,3,3
18311,3,1,64023,64023,64024,0,1,0
18312,6,2,64029,64029,64031,0,2,5
18313,4,3,64033,64033,64036,0,3,2
18314,2,1,64035,64036,64037,1,2,0
18315,3,1,64038,64038,64039,0,1,1
18316,6,3,64044,64044,64047,0,3,5
18317,5,1,64049,64049,64050,0,1,2
18318,4,1,64053,64053,64054,0,1,3
18319,1,1,64054,64054,64055,0,1,0
18320,1,1,64055,64055,64056,0,1,0
18321,4,1,64059,64059,64060,0,1,3
18322,2,3,64061,64061,64064,0,3,1
18323,6,3,64067,64067,64070,0,3,3
18324,4,3,64071,64071,64074,0,3,1
18325,5,2,64076,64076,64078,0,2,2
18326,1,2,64077,64078,64080,1,3,0
18327,1,1,64078,64080,64081,2,3,0
18328,4,1,64082,64082,64083,0,1,1
18329,4,3,64086,64086,64089,0,3,3
18330,3,2,64089,64089,64091,0,2,0
18331,4,1,64093,64093,64094,0,1,2
18332,6,3,64099,64099,64102,0,3,5
18333,6,1,64105,64105,64106,0,1,3
18334,1,3,64106,64106,64109,0,3,0
18335,3,2,64109,64109,64111,0,2,0
18336,5,3,64114,64114,64117,0,3,3
18337,4,2,64118,64118,64120,0,2,1
18338,5,1,64123,64123,64124,0,1,3
18339,2,3,64125,64125,64128,0,3,1
18340,2,3,64127,64128,64131,1,4,0
18341,6,2,64133,64133,64135,0,2,2
18342,3,3,64136,64136,64139,0,3,1
18343,6,3,64142,64142,64145,0,3,3
18344,5,2,64147,64147,64149,0,2,2
18345,3,2,64150,64150,64152,0,2,1
18346,2,1,64152,64152,64153,0,1,0
18347,5,2,64157,64157,64159,0,2,4
18348,5,3,64162,64162,64165,0,3,3
18349,5,1,64167,64167,64168,0,1,2
18350,2,3,64169,64169,64172,0,3,1
18351,4,2,64173,64173,64175,0,2,1
18352,4,2,64177,64177,64179,0,2,2
18353,2,1,64179,64179,64180,0,1,0
18354,1,1,64180,64180,64181,0,1,0
18355,4,3,64184,64184,64187,0,3,3
18356,1,2,64185,64187,64189,2,4,0
18357,6,2,64191,64191,64193,0,2,2
18358,3,2,64194,64194,64196,0,2,1
18359,1,3,64195,64196,64199,1,4,0
18360,3,2,64198,64199,64201,1,3,0
18361,3,1,64201,64201,64202,0,1,0
18362,3,2,64204,64204,64206,0,2,2
18363,1,1,64205,64206,64207,1,2,0
18364,3,1,64208,64208,64209,0,1,1
18365,4,3,64212,64212,64215,0,3,3
18366,1,2,64213,64215,64217,2,4,0
18367,1,1,64214,64217,64218,3,4,0
18368,4,2,64218,64218,64220,0,2,0
18369,4,1,64222,64222,64223,0,1,2
18370,5,1,64227,64227,64228,0,1,4
18371,3,1,64230,64230,64231,0,1,2
18372,3,1,64233,64233,64234,0,1,2
18373,5,2,64238,64238,64240,0,2,4
18374,6,3,64244,64244,64247,0,3,4
18375,2,3,64246,64247,64250,1,4,0
18376,1,2,64247,64250,64252,3,5,0
18377,2,3,64249,64252,64255,3,6,0
18378,5,1,64254,64255,64256,1,2,0
18379,4,1,64258,64258,64259,0,1,2
18380,4,1,64262,64262,64263,0,1,3
18381,2,1,64264,64264,64265,0,1,1
18382,6,3,64270,64270,64273,0,3,5
18383,2,1,64272,64273,64274,1,2,0
18384,6,3,64278,64278,64281,0,3,4
18385,5,3,64283,64283,64286,0,3,2
18386,3,2,64286,64286,64288,0,2,0
18387,2,1,64288,64288,64289,0,1,0
18388,1,3,64289,64289,64292,0,3,0
18389,1,2,64290,64292,64294,2,4,0
18390,3,1,64293,64294,64295,1,2,0
18391,5,2,64298,64298,64300,0,2,3
18392,2,3,64300,64300,64303,0,3,0
18393,4,2,64304,64304,64306,0,2,1
18394,4,2,64308,64308,64310,0,2,2
18395,1,1,64309,64310,64311,1,2,0
18396,3,1,64312,64312,64313,0,1,1
18397,5,3,64317,64317,64320,0,3,4
18398,1,2,64318,64320,64322,2,4,0
18399,3,2,64321,64322,64324,1,3,0
18400,3,2,64324,64324,64326,0,2,0
18401,3,1,64327,64327,64328,0,1,1
18402,4,2,64331,64331,64333,0,2,3
18403,1,1,64332,64333,64334,1,2,0
18404,3,3,64335,64335,64338,0,3,1
18405,1,3,64336,64338,64341,2,5,0
18406,2,3,64338,64341,64344,3,6,0
18407,4,1,64342,64344,64345,2,3,0
18408,1,1,64343,64345,64346,2,3,0
18409,4,3,64347,64347,64350,0,3,1
18410,6,3,64353,64353,64356,0,3,3
18411,5,1,64358,64358,64359,0,1,2
18412,3,3,64361,64361,64364,0,3,2
18413,1,2,64362,64364,64366,2,4,0
18414,5,1,64367,64367,64368,0,1,1
18415,4,2,64371,64371,64373,0,2,3
18416,1,1,64372,64373,64374,1,2,0
18417,1,3,64373,64374,64377,1,4,0
18418,1,3,64374,64377,64380,3,6,0
18419,5,1,64379,64380,64381,1,2,0
18420,4,3,64383,64383,64386,0,3,2
18421,6,3,64389,64389,64392,0,3,3
18422,2,2,64391,64392,64394,1,3,0
18423,5,1,64396,64396,64397,0,1,2
18424,6,1,64402,64402,64403,0,1,5
18425,1,1,64403,64403,64404,0,1,0
18426,2,3,64405,64405,64408,0,3,1
18427,6,3,64411,64411,64414,0,3,3
18428,6,3,64417,64417,64420,0,3,3
18429,5,2,64422,64422,64424,0,2,2
18430,6,1,64428,64428,64429,0,1,4
18431,6,2,64434,64434,64436,0,2,5
18432,3,2,64437,64437,64439,0,2,1
18433,2,1,64439,64439,64440,0,1,0
18434,1,1,64440,64440,64441,0,1,0
18435,5,3,64445,64445,64448,0,3,4
18436,5,3,64450,64450,64453,0,3,2
18437,4,2,64454,64454,64456,0,2,1
18438,1,2,64455,64456,64458,1,3,0
18439,4,2,64459,64459,64461,0,2,1
18440,1,3,64460,64461,64464,1,4,0
18441,5,2,64465,64465,64467,0,2,1
18442,3,2,64468,64468,64470,0,2,1
18443,3,2,64471,64471,64473,0,2,1
18444,6,3,64477,64477,64480,0,3,4
18445,2,1,64479,64480,64481,1,2,0
18446,3,2,64482,64482,64484,0,2,1
18447,4,2,64486,64486,64488,0,2,2
18448,1,2,64487,64488,64490,1,3,0
18449,5,2,64492,64492,64494,0,2,2
18450,3,1,64495,64495,64496,0,1,1
18451,4,3,64499,64499,64502,0,3,3
18452,6,2,64505,64505,64507,0,2,3
18453,1,1,64506,64507,64508,1,2,0
18454,1,1,64507,64508,64509,1,2,0
18455,3,2,64510,64510,64512,0,2,1
18456,1,1,64511,64512,64513,1,2,0
18457,4,3,64515,64515,64518,0,3,2
18458,2,3,64517,64518,64521,1,4,0
18459,5,1,64522,64522,64523,0,1,1
18460,4,3,64526,64526,64529,0,3,3
18461,6,3,64532,64532,64535,0,3,3
18462,1,1,64533,64535,64536,2,3,0
18463,6,2,64539,64539,64541,0,2,3
18464,3,2,64542,64542,64544,0,2,1
18465,1,3,64543,64544,64547,1,4,0
18466,5,3,64548,64548,64551,0,3,1
18467,2,3,64550,64551,64554,1,4,0
18468,6,1,64556,64556,64557,0,1,2
18469,3,2,64559,64559,64561,0,2,2
18470,6,3,64565,64565,64568,0,3,4
18471,4,3,64569,64569,64572,0,3,1
18472,6,2,64575,64575,64577,0,2,3
18473,5,2,64580,64580,64582,0,2,3
18474,2,2,64582,64582,64584,0,2,0
18475,6,3,64588,64588,64591,0,3,4
18476,6,1,64594,64594,64595,0,1,3
18477,2,3,64596,64596,64599,0,3,1
18478,2,2,64598,64599,64601,1,3,0
18479,4,2,64602,64602,64604,0,2,1
18480,2,1,64604,64604,64605,0,1,0
18481,5,1,64609,64609,64610,0,1,4
18482,4,3,64613,64613,64616,0,3,3
18483,4,1,64617,64617,64618,0,1,1
18484,5,3,64622,64622,64625,0,3,4
18485,5,3,64627,64627,64630,0,3,2
18486,2,3,64629,64630,64633,1,4,0
18487,1,1,64630,64633,64634,3,4,0
18488,5,1,64635,64635,64636,0,1,1
18489,1,1,64636,64636,64637,0,1,0
18490,5,1,64641,64641,64642,0,1,4
18491,2,3,64643,64643,64646,0,3,1
18492,1,2,64644,64646,64648,2,4,0
18493,3,3,64647,64648,64651,1,4,0
18494,6,1,64653,64653,64654,0,1,2
18495,4,2,64657,64657,64659,0,2,3
18496,6,3,64663,64663,64666,0,3,4
18497,3,3,64666,64666,64669,0,3,0
18498,5,2,64671,64671,64673,0,2,2
18499,6,2,64677,64677,64679,0,2,4
18500,1,2,64678,64679,64681,1,3,0
18501,1,1,64679,64681,64682,2,3,0
18502,3,3,64682,64682,64685,0,3,0
18503,6,3,64688,64688,64691,0,3,3
18504,5,3,64693,64693,64696,0,3,2
18505,6,1,64699,64699,64700,0,1,3
18506,2,2,64701,64701,64703,0,2,1
18507,4,1,64705,64705,64706,0,1,2
18508,2,3,64707,64707,64710,0,3,1
18509,2,1,64709,64710,64711,1,2,0
18510,6,2,64715,64715,64717,0,2,4
18511,4,3,64719,64719,64722,0,3,2
18512,5,1,64724,64724,64725,0,1,2
18513,6,1,64730,64730,64731,0,1,5
18514,1,3,64731,64731,64734,0,3,0
18515,2,2,64733,64734,64736,1,3,0
18516,1,2,64734,64736,64738,2,4,0
18517,2,1,64736,64738,64739,2,3,0
18518,3,1,64739,64739,64740,0,1,0
18519,2,3,64741,64741,64744,0,3,1
18520,2,2,64743,64744,64746,1,3,0
18521,3,1,64746,64746,64747,0,1,0
18522,1,3,64747,64747,64750,0,3,0
18523,5,3,64752,64752,64755,0,3,2
18524,2,2,64754,64755,64757,1,3,0
18525,4,2,64758,64758,64760,0,2,1
18526,4,3,64762,64762,64765,0,3,2
18527,2,2,64764,64765,64767,1,3,0
18528,6,1,64770,64770,64771,0,1,3
18529,6,2,64776,64776,64778,0,2,5
18530,5,1,64781,64781,64782,0,1,3
18531,6,1,64787,64787,64788,0,1,5
18532,4,2,64791,64791,64793,0,2,3
18533,4,2,64795,64795,64797,0,2,2
18534,2,1,64797,64797,64798,0,1,0
18535,1,1,64798,64798,64799,0,1,0
18536,1,3,64799,64799,64802,0,3,0
18537,3,3,64802,64802,64805,0,3,0
18538,4,1,64806,64806,64807,0,1,1
18539,3,3,64809,64809,64812,0,3,2
18540,4,2,64813,64813,64815,0,2,1
18541,1,3,64814,64815,64818,1,4,0
18542,4,2,64818,64818,64820,0,2,0
18543,5,3,64823,64823,64826,0,3,3
18544,5,3,64828,64828,64831,0,3,2
18545,1,2,64829,64831,64833,2,4,0
18546,6,2,64835,64835,64837,0,2,2
18547,4,2,64839,64839,64841,0,2,2
18548,2,2,64841,64841,64843,0,2,0
18549,3,2,64844,64844,64846,0,2,1
18550,3,2,64847,64847,64849,0,2,1
18551,2,1,64849,64849,64850,0,1,0
18552,5,1,64854,64854,64855,0,1,4
18553,6,2,64860,64860,64862,0,2,5
18554,4,3,64864,64864,64867,0,3,2
18555,2,3,64866,64867,64870,1,4,0
18556,6,3,64872,64872,64875,0,3,2
18557,3,3,64875,64875,64878,0,3,0
18558,5,1,64880,64880,64881,0,1,2
18559,4,3,64884,64884,64887,0,3,3
18560,2,3,64886,64887,64890,1,4,0
18561,4,1,64890,64890,64891,0,1,0
18562,2,3,64892,64892,64895,0,3,1
18563,2,1,64894,64895,64896,1,2,0
18564,4,2,64898,64898,64900,0,2,2
18565,6,1,64904,64904,64905,0,1,4
18566,5,2,64909,64909,64911,0,2,4
18567,5,3,64914,64914,64917,0,3,3
18568,5,3,64919,64919,64922,0,3,2
18569,6,3,64925,64925,64928,0,3,3
18570,5,3,64930,64930,64933,0,3,2
18571,2,1,64932,64933,64934,1,2,0
18572,6,2,64938,64938,64940,0,2,4
18573,1,1,64939,64940,64941,1,2,0
18574,1,1,64940,64941,64942,1,2,0
18575,5,2,64945,64945,64947,0,2,3
18576,3,2,64948,64948,64950,0,2,1
18577,5,3,64953,64953,64956,0,3,3
18578,3,2,64956,64956,64958,0,2,0
18579,1,3,64957,64958,64961,1,4,0
18580,2,1,64959,64961,64962,2,3,0
18581,5,2,64964,64964,64966,0,2,2
18582,1,1,64965,64966,64967,1,2,0
18583,4,2,64969,64969,64971,0,2,2
18584,2,2,64971,64971,64973,0,2,0
18585,6,2,64977,64977,64979,0,2,4
18586,4,2,64981,64981,64983,0,2,2
18587,3,1,64984,64984,64985,0,1,1
18588,4,3,64988,64988,64991,0,3,3
18589,1,2,64989,64991,64993,2,4,0
18590,6,2,64995,64995,64997,0,2,2
18591,1,3,64996,64997,65000,1,4,0
18592,2,1,64998,65000,65001,2,3,0
18593,5,3,65003,65003,65006,0,3,2
18594,3,3,65006,65006,65009,0,3,0
18595,6,2,65012,65012,65014,0,2,3
18596,1,1,65013,65014,65015,1,2,0
18597,1,3,65014,65015,65018,1,4,0
18598,3,3,65017,65018,65021,1,4,0
18599,2,2,65019,65021,65023,2,4,0
18600,3,2,65022,65023,65025,1,3,0
18601,6,2,65028,65028,65030,0,2,3
18602,6,1,65034,65034,65035,0,1,4
18603,1,1,65035,65035,65036,0,1,0
18604,2,2,65037,65037,65039,0,2,1
18605,3,3,65040,65040,65043,0,3,1
18606,1,1,65041,65043,65044,2,3,0
18607,3,3,65044,65044,65047,0,3,0
18608,2,2,65046,65047,65049,1,3,0
18609,1,1,65047,65049,65050,2,3,0
18610,4,3,65051,65051,65054,0,3,1
18611,6,2,65057,65057,65059,0,2,3
18612,2,3,65059,65059,65062,0,3,0
18613,5,1,65064,65064,65065,0,1,2
18614,2,2,65066,65066,65068,0,2,1
18615,3,3,65069,65069,65072,0,3,1
18616,1,1,65070,65072,65073,2,3,0
18617,4,1,65074,65074,65075,0,1,1
18618,4,3,65078,65078,65081,0,3,3
18619,2,1,65080,65081,65082,1,2,0
18620,5,3,65085,65085,65088,0,3,3
18621,4,2,65089,65089,65091,0,2,1
18622,5,3,65094,65094,65097,0,3,3
18623,2,3,65096,65097,65100,1,4,0
18624,4,1,65100,65100,65101,0,1,0
18625,4,3,65104,65104,65107,0,3,3
18626,4,1,65108,65108,65109,0,1,1
18627,3,2,65111,65111,65113,0,2,2
18628,6,1,65117,65117,65118,0,1,4
18629,1,3,65118,65118,65121,0,3,0
18630,5,2,65123,65123,65125,0,2,2
18631,3,2,65126,65126,65128,0,2,1
18632,4,2,65130,65130,65132,0,2,2
18633,1,3,65131,65132,65135,1,4,0
18634,5,3,65136,65136,65139,0,3,1
18635,2,3,65138,65139,65142,1,4,0
18636,1,3,65139,65142,65145,3,6,0
18637,6,1,65145,65145,65146,0,1,0
18638,6,3,65151,65151,65154,0,3,5
18639,6,1,65157,65157,65158,0,1,3
18640,5,1,65162,65162,65163,0,1,4
18641,5,3,65167,65167,65170,0,3,4
18642,5,3,65172,65172,65175,0,3,2
18643,2,2,65174,65175,65177,1,3,0
18644,2,1,65176,65177,65178,1,2,0
18645,2,2,65178,65178,65180,0,2,0
18646,4,2,65182,65182,65184,0,2,2
18647,2,1,65184,65184,65185,0,1,0
18648,1,2,65185,65185,65187,0,2,0
18649,2,3,65187,65187,65190,0,3,0
18650,6,3,65193,65193,65196,0,3,3
18651,1,1,65194,65196,65197,2,3,0
18652,1,1,65195,65197,65198,2,3,0
18653,1,2,65196,65198,65200,2,4,0
18654,2,3,65198,65200,65203,2,5,0
18655,5,3,65203,65203,65206,0,3,0
18656,5,1,65208,65208,65209,0,1,2
18657,4,1,65212,65212,65213,0,1,3
18658,5,2,65217,65217,65219,0,2,4
18659,3,2,65220,65220,65222,0,2,1
18660,3,2,65223,65223,65225,0,2,1
18661,2,3,65225,65225,65228,0,3,0
18662,5,1,65230,65230,65231,0,1,2
18663,1,1,65231,65231,65232,0,1,0
18664,3,3,65234,65234,65237,0,3,2
18665,5,1,65239,65239,65240,0,1,2
18666,5,3,65244,65244,65247,0,3,4
18667,4,1,65248,65248,65249,0,1,1
18668,5,2,65253,65253,65255,0,2,4
18669,3,1,65256,65256,65257,0,1,1
18670,2,3,65258,65258,65261,0,3,1
18671,3,3,65261,65261,65264,0,3,0
18672,4,2,65265,65265,65267,0,2,1
18673,4,1,65269,65269,65270,0,1,2
18674,1,1,65270,65270,65271,0,1,0
18675,4,2,65274,65274,65276,0,2,3
18676,6,3,65280,65280,65283,0,3,4
18677,6,2,65286,65286,65288,0,2,3
18678,1,2,65287,65288,65290,1,3,0
18679,4,1,65291,65291,65292,0,1,1
18680,4,1,65295,65295,65296,0,1,3
18681,2,1,65297,65297,65298,0,1,1
18682,2,1,65299,65299,65300,0,1,1
18683,3,2,65302,65302,65304,0,2,2
18684,6,3,65308,65308,65311,0,3,4
18685,5,1,65313,65313,65314,0,1,2
18686,6,3,65319,65319,65322,0,3,5
18687,6,1,65325,65325,65326,0,1,3
18688,5,3,65330,65330,65333,0,3,4
18689,2,2,65332,65333,65335,1,3,0
18690,6,3,65338,65338,65341,0,3,3
18691,5,1,65343,65343,65344,0,1,2
18692,4,2,65347,65347,65349,0,2,3
18693,6,3,65353,65353,65356,0,3,4
18694,5,3,65358,65358,65361,0,3,2
18695,4,1,65362,65362,65363,0,1,1
18696,1,2,65363,65363,65365,0,2,0
18697,2,3,65365,65365,65368,0,3,0
18698,5,2,65370,65370,65372,0,2,2
18699,3,3,65373,65373,65376,0,3,1
18700,2,2,65375,65376,65378,1,3,0
18701,5,3,65380,65380,65383,0,3,2
18702,6,1,65386,65386,65387,0,1,3
18703,2,3,65388,65388,65391,0,3,1
18704,4,2,65392,65392,65394,0,2,1
18705,3,2,65395,65395,65397,0,2,1
18706,1,3,65396,65397,65400,1,4,0
18707,2,3,65398,65400,65403,2,5,0
18708,2,2,65400,65403,65405,3,5,0
18709,6,1,65406,65406,65407,0,1,1
18710,1,1,65407,65407,65408,0,1,0
18711,6,3,65413,65413,65416,0,3,5
18712,3,1,65416,65416,65417,0,1,0
18713,5,1,65421,65421,65422,0,1,4
18714,4,2,65425,65425,65427,0,2,3
18715,2,2,65427,65427,65429,0,2,0
18716,3,3,65430,65430,65433,0,3,1
18717,4,3,65434,65434,65437,0,3,1
18718,2,3,65436,65437,65440,1,4,0
18719,3,3,65439,65440,65443,1,4,0
18720,5,2,65444,65444,65446,0,2,1
18721,6,2,65450,65450,65452,0,2,4
18722,3,2,65453,65453,65455,0,2,1
18723,4,2,65457,65457,65459,0,2,2
18724,2,1,65459,65459,65460,0,1,0
18725,5,2,65464,65464,65466,0,2,4
18726,1,3,65465,65466,65469,1,4,0
18727,6,2,65471,65471,65473,0,2,2
18728,1,3,65472,65473,65476,1,4,0
18729,1,1,65473,65476,65477,3,4,0
18730,4,1,65477,65477,65478,0,1,0
18731,2,3,65479,65479,65482,0,3,1
18732,2,3,65481,65482,65485,1,4,0
18733,6,1,65487,65487,65488,0,1,2
18734,6,3,65493,65493,65496,0,3,5
18735,5,2,65498,65498,65500,0,2,2
18736,6,3,65504,65504,65507,0,3,4
18737,3,1,65507,65507,65508,0,1,0
18738,3,3,65510,65510,65513,0,3,2
18739,2,1,65512,65513,65514,1,2,0
18740,1,2,65513,65514,65516,1,3,0
18741,3,2,65516,65516,65518,0,2,0
18742,1,3,65517,65518,65521,1,4,0
18743,4,3,65521,65521,65524,0,3,0
18744,4,1,65525,65525,65526,0,1,1
18745,2,2,65527,65527,65529,0,2,1
18746,2,1,65529,65529,65530,0,1,0
18747,3,2,65532,65532,65534,0,2,2
18748,6,1,65538,65538,65539,0,1,4
18749,4,3,65542,65542,65545,0,3,3
18750,4,1,65546,65546,65547,0,1,1
18751,1,2,65547,65547,65549,0,2,0
18752,5,1,65552,65552,65553,0,1,3
18753,6,2,65558,65558,65560,0,2,5
18754,4,3,65562,65562,65565,0,3,2
18755,6,1,65568,65568,65569,0,1,3
18756,4,2,65572,65572,65574,0,2,3
18757,1,3,65573,65574,65577,1,4,0
18758,6,3,65579,65579,65582,0,3,2
18759,1,2,65580,65582,65584,2,4,0
18760,3,1,65583,65584,65585,1,2,0
18761,4,1,65587,65587,65588,0,1,2
18762,5,1,65592,65592,65593,0,1,4
18763,4,1,65596,65596,65597,0,1,3
18764,4,3,65600,65600,65603,0,3,3
18765,1,2,65601,65603,65605,2,4,0
18766,6,1,65607,65607,65608,0,1,2
18767,5,3,65612,65612,65615,0,3,4
18768,4,3,65616,65616,65619,0,3,1
18769,1,3,65617,65619,65622,2,5,0
18770,4,3,65621,65622,65625,1,4,0
18771,3,1,65624,65625,65626,1,2,0
18772,6,3,65630,65630,65633,0,3,4
18773,2,1,65632,65633,65634,1,2,0
18774,3,3,65635,65635,65638,0,3,1
18775,6,3,65641,65641,65644,0,3,3
18776,2,3,65643,65644,65647,1,4,0
18777,2,3,65645,65647,65650,2,5,0
18778,2,2,65647,65650,65652,3,5,0
18779,1,2,65648,65652,65654,4,6,0
18780,3,1,65651,65654,65655,3,4,0
18781,3,2,65654,65655,65657,1,3,0
18782,1,3,65655,65657,65660,2,5,0
18783,1,3,65656,65660,65663,4,7,0
18784,1,1,65657,65663,65664,6,7,0
18785,3,2,65660,65664,65666,4,6,0
18786,6,3,65666,65666,65669,0,3,0
18787,1,2,65667,65669,65671,2,4,0
18788,2,3,65669,65671,65674,2,5,0
18789,2,2,65671,65674,65676,3,5,0
18790,4,2,65675,65676,65678,1,3,0
18791,5,1,65680,65680,65681,0,1,2
18792,2,1,65682,65682,65683,0,1,1
18793,3,2,65685,65685,65687,0,2,2
18794,3,3,65688,65688,65691,0,3,1
18795,1,1,65689,65691,65692,2,3,0
18796,1,3,65690,65692,65695,2,5,0
18797,5,2,65695,65695,65697,0,2,0
18798,5,3,65700,65700,65703,0,3,3
18799,6,1,65706,65706,65707,0,1,3
18800,3,3,65709,65709,65712,0,3,2
18801,1,1,65710,65712,65713,2,3,0
18802,6,2,65716,65716,65718,0,2,3
18803,3,3,65719,65719,65722,0,3,1
18804,3,1,65722,65722,65723,0,1,0
18805,3,2,65725,65725,65727,0,2,2
18806,3,3,65728,65728,65731,0,3,1
18807,4,3,65732,65732,65735,0,3,1
18808,6,2,65738,65738,65740,0,2,3
18809,1,3,65739,65740,65743,1,4,0
18810,6,3,65745,65745,65748,0,3,2
18811,2,1,65747,65748,65749,1,2,0
18812,1,3,65748,65749,65752,1,4,0
18813,1,2,65749,65752,65754,3,5,0
18814,5,3,65754,65754,65757,0,3,0
18815,1,1,65755,65757,65758,2,3,0
18816,2,1,65757,65758,65759,1,2,0
18817,1,2,65758,65759,65761,1,3,0
18818,4,1,65762,65762,65763,0,1,1
18819,4,1,65766,65766,65767,0,1,3
18820,3,3,65769,65769,65772,0,3,2
18821,4,1,65773,65773,65774,0,1,1
18822,5,2,65778,65778,65780,0,2,4
18823,5,3,65783,65783,65786,0,3,3
18824,4,2,65787,65787,65789,0,2,1
18825,2,1,65789,65789,65790,0,1,0
18826,6,1,65795,65795,65796,0,1,5
18827,6,3,65801,65801,65804,0,3,5
18828,6,3,65807,65807,65810,0,3,3
18829,5,1,65812,65812,65813,0,1,2
18830,2,2,65814,65814,65816,0,2,1
18831,4,2,65818,65818,65820,0,2,2
18832,2,1,65820,65820,65821,0,1,0
18833,1,2,65821,65821,65823,0,2,0
18834,2,1,65823,65823,65824,0,1,0
18835,5,3,65828,65828,65831,0,3,4
18836,5,2,65833,65833,65835,0,2,2
18837,4,3,65837,65837,65840,0,3,2
18838,1,3,65838,65840,65843,2,5,0
18839,1,3,65839,65843,65846,4,7,0
18840,2,2,65841,65846,65848,5,7,0
18841,1,1,65842,65848,65849,6,7,0
18842,4,2,65846,65849,65851,3,5,0
18843,6,1,65852,65852,65853,0,1,1
18844,2,3,65854,65854,65857,0,3,1
18845,4,3,65858,65858,65861,0,3,1
18846,5,1,65863,65863,65864,0,1,2
18847,1,2,65864,65864,65866,0,2,0
18848,4,1,65868,65868,65869,0,1,2
18849,4,3,65872,65872,65875,0,3,3
18850,6,2,65878,65878,65880,0,2,3
18851,2,2,65880,65880,65882,0,2,0
18852,2,1,65882,65882,65883,0,1,0
18853,3,2,65885,65885,65887,0,2,2
18854,5,1,65890,65890,65891,0,1,3
18855,5,1,65895,65895,65896,0,1,4
18856,6,3,65901,65901,65904,0,3,5
18857,6,2,65907,65907,65909,0,2,3
18858,1,2,65908,65909,65911,1,3,0
18859,2,2,65910,65911,65913,1,3,0
18860,5,3,65915,65915,65918,0,3,2
18861,1,1,65916,65918,65919,2,3,0
18862,3,1,65919,65919,65920,0,1,0
18863,5,1,65924,65924,65925,0,1,4
18864,6,1,65930,65930,65931,0,1,5
18865,4,2,65934,65934,65936,0,2,3
18866,5,1,65939,65939,65940,0,1,3
18867,4,3,65943,65943,65946,0,3,3
18868,1,2,65944,65946,65948,2,4,0
18869,4,1,65948,65948,65949,0,1,0
18870,6,2,65954,65954,65956,0,2,5
18871,2,1,65956,65956,65957,0,1,0
18872,3,2,65959,65959,65961,0,2,2
18873,5,1,65964,65964,65965,0,1,3
18874,4,1,65968,65968,65969,0,1,3
18875,6,1,65974,65974,65975,0,1,5
18876,6,1,65980,65980,65981,0,1,5
18877,1,3,65981,65981,65984,0,3,0
18878,4,1,65985,65985,65986,0,1,1
18879,3,2,65988,65988,65990,0,2,2
18880,3,2,65991,65991,65993,0,2,1
18881,4,3,65995,65995,65998,0,3,2
18882,6,2,66001,66001,66003,0,2,3
18883,4,3,66005,66005,66008,0,3,2
18884,6,3,66011,66011,66014,0,3,3
18885,1,2,66012,66014,66016,2,4,0
18886,6,1,66018,66018,66019,0,1,2
18887,3,3,66021,66021,66024,0,3,2
18888,5,3,66026,66026,66029,0,3,2
18889,6,2,66032,66032,66034,0,2,3
18890,6,3,66038,66038,66041,0,3,4
18891,6,2,66044,66044,66046,0,2,3
18892,6,1,66050,66050,66051,0,1,4
18893,3,1,66053,66053,66054,0,1,2
18894,1,2,66054,66054,66056,0,2,0
18895,6,2,66060,66060,66062,0,2,4
18896,5,1,66065,66065,66066,0,1,3
18897,4,3,66069,66069,66072,0,3,3
18898,5,3,66074,66074,66077,0,3,2
18899,1,2,66075,66077,66079,2,4,0
18900,5,1,66080,66080,66081,0,1,1
18901,2,1,66082,66082,66083,0,1,1
18902,6,2,66088,66088,66090,0,2,5
18903,4,1,66092,66092,66093,0,1,2
18904,4,1,66096,66096,66097,0,1,3
18905,2,2,66098,66098,66100,0,2,1
18906,2,2,66100,66100,66102,0,2,0
18907,2,2,66102,66102,66104,0,2,0
18908,3,1,66105,66105,66106,0,1,1
18909,2,2,66107,66107,66109,0,2,1
18910,1,1,66108,66109,66110,1,2,0
18911,1,3,66109,66110,66113,1,4,0
18912,2,3,66111,66113,66116,2,5,0
18913,2,1,66113,66116,66117,3,4,0
18914,6,2,66119,66119,66121,0,2,2
18915,2,1,66121,66121,66122,0,1,0
18916,1,2,66122,66122,66124,0,2,0
18917,5,1,66127,66127,66128,0,1,3
18918,3,1,66130,66130,66131,0,1,2
18919,5,1,66135,66135,66136,0,1,4
18920,6,1,66141,66141,66142,0,1,5
18921,5,1,66146,66146,66147,0,1,4
18922,1,1,66147,66147,66148,0,1,0
18923,2,1,66149,66149,66150,0,1,1
18924,3,3,66152,66152,66155,0,3,2
18925,4,2,66156,66156,66158,0,2,1
18926,5,1,66161,66161,66162,0,1,3
18927,4,1,66165,66165,66166,0,1,3
18928,3,2,66168,66168,66170,0,2,2
18929,2,1,66170,66170,66171,0,1,0
18930,3,3,66173,66173,66176,0,3,2
18931,5,1,66178,66178,66179,0,1,2
18932,4,3,66182,66182,66185,0,3,3
18933,3,2,66185,66185,66187,0,2,0
18934,3,2,66188,66188,66190,0,2,1
18935,4,1,66192,66192,66193,0,1,2
18936,1,2,66193,66193,66195,0,2,0
18937,1,3,66194,66195,66198,1,4,0
18938,3,1,66197,66198,66199,1,2,0
18939,2,3,66199,66199,66202,0,3,0
18940,3,1,66202,66202,66203,0,1,0
18941,3,2,66205,66205,66207,0,2,2
18942,5,2,66210,66210,66212,0,2,3
18943,6,3,66216,66216,66219,0,3,4
18944,5,3,66221,66221,66224,0,3,2
18945,5,3,66226,66226,66229,0,3,2
18946,6,2,66232,66232,66234,0,2,3
18947,2,3,66234,66234,66237,0,3,0
18948,4,3,66238,66238,66241,0,3,1
18949,4,2,66242,66242,66244,0,2,1
18950,5,2,66247,66247,66249,0,2,3
18951,3,2,66250,66250,66252,0,2,1
18952,6,1,66256,66256,66257,0,1,4
18953,2,3,66258,66258,66261,0,3,1
18954,2,1,66260,66261,66262,1,2,0
18955,5,1,66265,66265,66266,0,1,3
18956,6,2,66271,66271,66273,0,2,5
18957,1,1,66272,66273,66274,1,2,0
18958,3,1,66275,66275,66276,0,1,1
18959,4,3,66279,66279,66282,0,3,3
18960,5,2,66284,66284,66286,0,2,2
18961,2,2,66286,66286,66288,0,2,0
18962,1,3,66287,66288,66291,1,4,0
18963,1,3,66288,66291,66294,3,6,0
18964,5,3,66293,66294,66297,1,4,0
18965,4,3,66297,66297,66300,0,3,0
18966,1,3,66298,66300,66303,2,5,0
18967,6,3,66304,66304,66307,0,3,1
18968,5,2,66309,66309,66311,0,2,2
18969,6,3,66315,66315,66318,0,3,4
18970,3,2,66318,66318,66320,0,2,0
18971,5,1,66323,66323,66324,0,1,3
18972,1,2,66324,66324,66326,0,2,0
18973,4,3,66328,66328,66331,0,3,2
18974,6,1,66334,66334,66335,0,1,3
18975,5,3,66339,66339,66342,0,3,4
18976,6,3,66345,66345,66348,0,3,3
18977,1,3,66346,66348,66351,2,5,0
18978,1,1,66347,66351,66352,4,5,0
18979,2,2,66349,66352,66354,3,5,0
18980,2,3,66351,66354,66357,3,6,0
18981,5,1,66356,66357,66358,1,2,0
18982,5,2,66361,66361,66363,0,2,3
18983,6,3,66367,66367,66370,0,3,4
18984,3,1,66370,66370,66371,0,1,0
18985,5,1,66375,66375,66376,0,1,4
18986,3,1,66378,66378,66379,0,1,2
18987,5,2,66383,66383,66385,0,2,4
18988,3,1,66386,66386,66387,0,1,1
18989,1,1,66387,66387,66388,0,1,0
18990,6,1,66393,66393,66394,0,1,5
18991,4,3,66397,66397,66400,0,3,3
18992,5,1,66402,66402,66403,0,1,2
18993,2,1,66404,66404,66405,0,1,1
18994,3,3,66407,66407,66410,0,3,2
18995,3,2,66410,66410,66412,0,2,0
18996,3,3,66413,66413,66416,0,3,1
18997,4,3,66417,66417,66420,0,3,1
18998,4,3,66421,66421,66424,0,3,1
18999,5,1,66426,66426,66427,0,1,2
19000,6,1,66432,66432,66433,0,1,5
19001,5,3,66437,66437,66440,0,3,4
19002,2,2,66439,66440,66442,1,3,0
19003,2,1,66441,66442,66443,1,2,0
19004,6,2,66447,66447,66449,0,2,4
19005,4,2,66451,66451,66453,0,2,2
19006,1,3,66452,66453,66456,1,4,0
19007,6,1,66458,66458,66459,0,1,2
19008,2,2,66460,66460,66462,0,2,1
19009,5,3,66465,66465,66468,0,3,3
19010,1,3,66466,66468,66471,2,5,0
19011,3,3,66469,66471,66474,2,5,0
19012,3,2,66472,66474,66476,2,4,0
19013,4,3,66476,66476,66479,0,3,0
19014,1,3,66477,66479,66482,2,5,0
19015,5,1,66482,66482,66483,0,1,0
19016,2,3,66484,66484,66487,0,3,1
19017,4,1,66488,66488,66489,0,1,1
19018,2,3,66490,66490,66493,0,3,1
19019,6,3,66496,66496,66499,0,3,3
19020,2,2,66498,66499,66501,1,3,0
19021,6,1,66504,66504,66505,0,1,3
19022,3,1,66507,66507,66508,0,1,2
19023,1,3,66508,66508,66511,0,3,0
19024,6,1,66514,66514,66515,0,1,3
19025,4,2,66518,66518,66520,0,2,3
19026,4,1,66522,66522,66523,0,1,2
19027,1,2,66523,66523,66525,0,2,0
19028,4,3,66527,66527,66530,0,3,2
19029,3,2,66530,66530,66532,0,2,0
19030,6,2,66536,66536,66538,0,2,4
19031,1,2,66537,66538,66540,1,3,0
19032,4,2,66541,66541,66543,0,2,1
19033,4,3,66545,66545,66548,0,3,2
19034,6,3,66551,66551,66554,0,3,3
19035,1,2,66552,66554,66556,2,4,0
19036,3,3,66555,66556,66559,1,4,0
19037,5,3,66560,66560,66563,0,3,1
19038,4,1,66564,66564,66565,0,1,1
19039,5,2,66569,66569,66571,0,2,4
19040,4,3,66573,66573,66576,0,3,2
19041,5,1,66578,66578,66579,0,1,2
19042,1,3,66579,66579,66582,0,3,0
19043,5,2,66584,66584,66586,0,2,2
19044,4,3,66588,66588,66591,0,3,2
19045,1,3,66589,66591,66594,2,5,0
19046,3,1,66592,66594,66595,2,3,0
19047,3,1,66595,66595,66596,0,1,0
19048,4,2,66599,66599,66601,0,2,3
19049,3,1,66602,66602,66603,0,1,1
19050,4,2,66606,66606,66608,0,2,3
19051,3,1,66609,66609,66610,0,1,1
19052,3,2,66612,66612,66614,0,2,2
19053,4,1,66616,66616,66617,0,1,2
19054,3,3,66619,66619,66622,0,3,2
19055,3,3,66622,66622,66625,0,3,0
19056,1,3,66623,66625,66628,2,5,0
19057,1,1,66624,66628,66629,4,5,0
19058,3,2,66627,66629,66631,2,4,0
19059,2,3,66629,66631,66634,2,5,0
19060,4,1,66633,66634,66635,1,2,0
19061,2,2,66635,66635,66637,0,2,0
19062,5,3,66640,66640,66643,0,3,3
19063,5,3,66645,66645,66648,0,3,2
19064,5,1,66650,66650,66651,0,1,2
19065,6,3,66656,66656,66659,0,3,5
19066,2,2,66658,66659,66661,1,3,0
19067,3,3,66661,66661,66664,0,3,0
19068,5,2,66666,66666,66668,0,2,2
19069,5,2,66671,66671,66673,0,2,3
19070,5,1,66676,66676,66677,0,1,3
19071,3,3,66679,66679,66682,0,3,2
19072,4,1,66683,66683,66684,0,1,1
19073,4,1,66687,66687,66688,0,1,3
19074,4,1,66691,66691,66692,0,1,3
19075,5,1,66696,66696,66697,0,1,4
19076,6,1,66702,66702,66703,0,1,5
19077,3,1,66705,66705,66706,0,1,2
19078,3,2,66708,66708,66710,0,2,2
19079,3,1,66711,66711,66712,0,1,1
19080,3,1,66714,66714,66715,0,1,2
19081,2,3,66716,66716,66719,0,3,1
19082,4,1,66720,66720,66721,0,1,1
19083,5,2,66725,66725,66727,0,2,4
19084,2,1,66727,66727,66728,0,1,0
19085,5,2,66732,66732,66734,0,2,4
19086,4,1,66736,66736,66737,0,1,2
19087,1,1,66737,66737,66738,0,1,0
19088,2,2,66739,66739,66741,0,2,1
19089,4,2,66743,66743,66745,0,2,2
19090,2,1,66745,66745,66746,0,1,0
19091,1,3,66746,66746,66749,0,3,0
19092,6,3,66752,66752,66755,0,3,3
19093,2,2,66754,66755,66757,1,3,0
19094,6,1,66760,66760,66761,0,1,3
19095,4,3,66764,66764,66767,0,3,3
19096,2,1,66766,66767,66768,1,2,0
19097,5,1,66771,66771,66772,0,1,3
19098,1,2,66772,66772,66774,0,2,0
19099,3,1,66775,66775,66776,0,1,1
19100,2,1,66777,66777,66778,0,1,1
19101,6,2,66783,66783,66785,0,2,5
19102,1,3,66784,66785,66788,1,4,0
19103,6,2,66790,66790,66792,0,2,2
19104,2,1,66792,66792,66793,0,1,0
19105,2,2,66794,66794,66796,0,2,1
19106,2,3,66796,66796,66799,0,3,0
19107,4,2,66800,66800,66802,0,2,1
19108,6,3,66806,66806,66809,0,3,4
19109,4,2,66810,66810,66812,0,2,1
19110,2,2,66812,66812,66814,0,2,0
19111,2,1,66814,66814,66815,0,1,0
19112,4,2,66818,66818,66820,0,2,3
19113,2,3,66820,66820,66823,0,3,0
19114,3,2,66823,66823,66825,0,2,0
19115,4,2,66827,66827,66829,0,2,2
19116,6,2,66833,66833,66835,0,2,4
19117,2,1,66835,66835,66836,0,1,0
19118,3,1,66838,66838,66839,0,1,2
19119,5,3,66843,66843,66846,0,3,4
19120,3,1,66846,66846,66847,0,1,0
19121,2,1,66848,66848,66849,0,1,1
19122,3,2,66851,66851,66853,0,2,2
19123,6,2,66857,66857,66859,0,2,4
19124,6,2,66863,66863,66865,0,2,4
19125,2,2,66865,66865,66867,0,2,0
19126,1,2,66866,66867,66869,1,3,0
19127,4,3,66870,66870,66873,0,3,1
19128,1,2,66871,66873,66875,2,4,0
19129,3,3,66874,66875,66878,1,4,0
19130,3,3,66877,66878,66881,1,4,0
19131,1,3,66878,66881,66884,3,6,0
19132,1,2,66879,66884,66886,5,7,0
19133,6,3,66885,66886,66889,1,4,0
19134,1,1,66886,66889,66890,3,4,0
19135,4,1,66890,66890,66891,0,1,0
19136,2,2,66892,66892,66894,0,2,1
19137,4,1,66896,66896,66897,0,1,2
19138,6,1,66902,66902,66903,0,1,5
19139,4,3,66906,66906,66909,0,3,3
19140,6,3,66912,66912,66915,0,3,3
19141,4,1,66916,66916,66917,0,1,1
19142,5,2,66921,66921,66923,0,2,4
19143,3,1,66924,66924,66925,0,1,1
19144,4,3,66928,66928,66931,0,3,3
19145,2,2,66930,66931,66933,1,3,0
19146,2,1,66932,66933,66934,1,2,0
19147,6,1,66938,66938,66939,0,1,4
19148,2,1,66940,66940,66941,0,1,1
19149,4,2,66944,66944,66946,0,2,3
19150,5,1,66949,66949,66950,0,1,3
19151,1,1,66950,66950,66951,0,1,0
19152,2,2,66952,66952,66954,0,2,1
19153,4,2,66956,66956,66958,0,2,2
19154,5,1,66961,66961,66962,0,1,3
19155,2,2,66963,66963,66965,0,2,1
19156,5,1,66968,66968,66969,0,1,3
19157,2,1,66970,66970,66971,0,1,1
19158,3,2,66973,66973,66975,0,2,2
19159,4,2,66977,66977,66979,0,2,2
19160,3,2,66980,66980,66982,0,2,1
19161,4,2,66984,66984,66986,0,2,2
19162,4,1,66988,66988,66989,0,1,2
19163,6,3,66994,66994,66997,0,3,5
19164,4,1,66998,66998,66999,0,1,1
19165,2,1,67000,67000,67001,0,1,1
19166,4,3,67004,67004,67007,0,3,3
19167,2,2,67006,67007,67009,1,3,0
19168,2,1,67008,67009,67010,1,2,0
19169,5,2,67013,67013,67015,0,2,3
19170,2,3,67015,67015,67018,0,3,0
19171,4,1,67019,67019,67020,0,1,1
19172,1,3,67020,67020,67023,0,3,0
19173,6,2,67026,67026,67028,0,2,3
19174,1,2,67027,67028,67030,1,3,0
19175,3,3,67030,67030,67033,0,3,0
19176,4,3,67034,67034,67037,0,3,1
19177,6,2,67040,67040,67042,0,2,3
19178,2,1,67042,67042,67043,0,1,0
19179,5,3,67047,67047,67050,0,3,4
19180,6,1,67053,67053,67054,0,1,3
19181,6,1,67059,67059,67060,0,1,5
19182,4,2,67063,67063,67065,0,2,3
19183,6,3,67069,67069,67072,0,3,4
19184,6,3,67075,67075,67078,0,3,3
19185,3,1,67078,67078,67079,0,1,0
19186,2,3,67080,67080,67083,0,3,1
19187,6,3,67086,67086,67089,0,3,3
19188,3,3,67089,67089,67092,0,3,0
19189,3,1,67092,67092,67093,0,1,0
19190,6,1,67098,67098,67099,0,1,5
19191,6,2,67104,67104,67106,0,2,5
19192,1,3,67105,67106,67109,1,4,0
19193,3,3,67108,67109,67112,1,4,0
19194,4,1,67112,67112,67113,0,1,0
19195,1,2,67113,67113,67115,0,2,0
19196,2,2,67115,67115,67117,0,2,0
19197,3,2,67118,67118,67120,0,2,1
19198,4,1,67122,67122,67123,0,1,2
19199,1,1,67123,67123,67124,0,1,0
19200,4,2,67127,67127,67129,0,2,3
19201,1,2,67128,67129,67131,1,3,0
19202,5,3,67133,67133,67136,0,3,2
19203,1,3,67134,67136,67139,2,5,0
19204,6,3,67140,67140,67143,0,3,1
19205,1,1,67141,67143,67144,2,3,0
19206,4,2,67145,67145,67147,0,2,1
19207,4,2,67149,67149,67151,0,2,2
19208,3,3,67152,67152,67155,0,3,1
19209,5,3,67157,67157,67160,0,3,2
19210,4,3,67161,67161,67164,0,3,1
19211,2,2,67163,67164,67166,1,3,0
19212,2,2,67165,67166,67168,1,3,0
19213,6,1,67171,67171,67172,0,1,3
19214,4,2,67175,67175,67177,0,2,3
19215,4,1,67179,67179,67180,0,1,2
19216,4,3,67183,67183,67186,0,3,3
19217,5,3,67188,67188,67191,0,3,2
19218,4,3,67192,67192,67195,0,3,1
19219,2,2,67194,67195,67197,1,3,0
19220,4,1,67198,67198,67199,0,1,1
19221,2,3,67200,67200,67203,0,3,1
19222,2,2,67202,67203,67205,1,3,0
19223,4,3,67206,67206,67209,0,3,1
19224,1,3,67207,67209,67212,2,5,0
19225,4,3,67211,67212,67215,1,4,0
19226,5,3,67216,67216,67219,0,3,1
19227,2,3,67218,67219,67222,1,4,0
19228,6,3,67224,67224,67227,0,3,2
19229,2,1,67226,67227,67228,1,2,0
19230,4,1,67230,67230,67231,0,1,2
19231,4,1,67234,67234,67235,0,1,3
19232,5,1,67239,67239,67240,0,1,4
19233,6,2,67245,67245,67247,0,2,5
19234,6,3,67251,67251,67254,0,3,4
19235,5,2,67256,67256,67258,0,2,2
19236,1,1,67257,67258,67259,1,2,0
19237,2,2,67259,67259,67261,0,2,0
19238,4,2,67263,67263,67265,0,2,2
19239,5,1,67268,67268,67269,0,1,3
19240,3,2,67271,67271,67273,0,2,2
19241,5,2,67276,67276,67278,0,2,3
19242,2,1,67278,67278,67279,0,1,0
19243,1,2,67279,67279,67281,0,2,0
19244,6,3,67285,67285,67288,0,3,4
19245,3,1,67288,67288,67289,0,1,0
19246,4,2,67292,67292,67294,0,2,3
19247,2,3,67294,67294,67297,0,3,0
19248,4,1,67298,67298,67299,0,1,1
19249,1,1,67299,67299,67300,0,1,0
19250,6,2,67305,67305,67307,0,2,5
19251,2,3,67307,67307,67310,0,3,0
19252,6,1,67313,67313,67314,0,1,3
19253,4,2,67317,67317,67319,0,2,3
19254,2,2,67319,67319,67321,0,2,0
19255,1,3,67320,67321,67324,1,4,0
19256,1,3,67321,67324,67327,3,6,0
19257,3,2,67324,67327,67329,3,5,0
19258,5,1,67329,67329,67330,0,1,0
19259,1,3,67330,67330,67333,0,3,0
19260,6,2,67336,67336,67338,0,2,3
19261,2,1,67338,67338,67339,0,1,0
19262,3,1,67341,67341,67342,0,1,2
19263,3,1,67344,67344,67345,0,1,2
19264,6,1,67350,67350,67351,0,1,5
19265,5,1,67355,67355,67356,0,1,4
19266,6,3,67361,67361,67364,0,3,5
19267,6,2,67367,67367,67369,0,2,3
19268,3,3,67370,67370,67373,0,3,1
19269,2,1,67372,67373,67374,1,2,0
19270,5,2,67377,67377,67379,0,2,3
19271,6,2,67383,67383,67385,0,2,4
19272,3,1,67386,67386,67387,0,1,1
19273,5,3,67391,67391,67394,0,3,4
19274,1,2,67392,67394,67396,2,4,0
19275,5,2,67397,67397,67399,0,2,1
19276,6,1,67403,67403,67404,0,1,4
19277,1,2,67404,67404,67406,0,2,0
19278,3,2,67407,67407,67409,0,2,1
19279,6,2,67413,67413,67415,0,2,4
19280,2,2,67415,67415,67417,0,2,0
19281,3,3,67418,67418,67421,0,3,1
19282,5,2,67423,67423,67425,0,2,2
19283,1,2,67424,67425,67427,1,3,0
19284,5,1,67429,67429,67430,0,1,2
19285,3,1,67432,67432,67433,0,1,2
19286,4,3,67436,67436,67439,0,3,3
19287,4,1,67440,67440,67441,0,1,1
19288,4,3,67444,67444,67447,0,3,3
19289,3,1,67447,67447,67448,0,1,0
19290,3,3,67450,67450,67453,0,3,2
19291,1,1,67451,67453,67454,2,3,0
19292,1,1,67452,67454,67455,2,3,0
19293,4,3,67456,67456,67459,0,3,1
19294,6,3,67462,67462,67465,0,3,3
19295,5,3,67467,67467,67470,0,3,2
19296,2,1,67469,67470,67471,1,2,0
19297,4,1,67473,67473,67474,0,1,2
19298,2,2,67475,67475,67477,0,2,1
19299,6,2,67481,67481,67483,0,2,4
19300,2,1,67483,67483,67484,0,1,0
19301,5,3,67488,67488,67491,0,3,4
19302,1,3,67489,67491,67494,2,5,0
19303,1,2,67490,67494,67496,4,6,0
19304,3,2,67493,67496,67498,3,5,0
19305,1,3,67494,67498,67501,4,7,0
19306,6,1,67500,67501,67502,1,2,0
19307,2,2,67502,67502,67504,0,2,0
19308,4,1,67506,67506,67507,0,1,2
19309,1,2,67507,67507,67509,0,2,0
19310,4,3,67511,67511,67514,0,3,2
19311,3,1,67514,67514,67515,0,1,0
19312,1,3,67515,67515,67518,0,3,0
19313,5,3,67520,67520,67523,0,3,2
19314,1,1,67521,67523,67524,2,3,0
19315,2,3,67523,67524,67527,1,4,0
19316,5,3,67528,67528,67531,0,3,1
19317,3,1,67531,67531,67532,0,1,0
19318,2,1,67533,67533,67534,0,1,1
19319,6,3,67539,67539,67542,0,3,5
19320,1,3,67540,67542,67545,2,5,0
19321,4,1,67544,67545,67546,1,2,0
19322,3,2,67547,67547,67549,0,2,1
19323,4,1,67551,67551,67552,0,1,2
19324,2,1,67553,67553,67554,0,1,1
19325,4,2,67557,67557,67559,0,2,3
19326,5,1,67562,67562,67563,0,1,3
19327,5,1,67567,67567,67568,0,1,4
19328,3,2,67570,67570,67572,0,2,2
19329,5,1,67575,67575,67576,0,1,3
19330,5,3,67580,67580,67583,0,3,4
19331,5,1,67585,67585,67586,0,1,2
19332,3,3,67588,67588,67591,0,3,2
19333,5,2,67593,67593,67595,0,2,2
19334,2,1,67595,67595,67596,0,1,0
19335,1,2,67596,67596,67598,0,2,0
19336,1,3,67597,67598,67601,1,4,0
19337,1,1,67598,67601,67602,3,4,0
19338,6,2,67604,67604,67606,0,2,2
19339,4,1,67608,67608,67609,0,1,2
19340,1,2,67609,67609,67611,0,2,0
19341,5,2,67614,67614,67616,0,2,3
19342,5,2,67619,67619,67621,0,2,3
19343,5,3,67624,67624,67627,0,3,3
19344,2,1,67626,67627,67628,1,2,0
19345,1,1,67627,67628,67629,1,2,0
19346,5,1,67632,67632,67633,0,1,3
19347,1,2,67633,67633,67635,0,2,0
19348,1,3,67634,67635,67638,1,4,0
19349,6,2,67640,67640,67642,0,2,2
19350,3,2,67643,67643,67645,0,2,1
19351,6,2,67649,67649,67651,0,2,4
19352,1,2,67650,67651,67653,1,3,0
19353,1,2,67651,67653,67655,2,4,0
19354,5,3,67656,67656,67659,0,3,1
19355,3,1,67659,67659,67660,0,1,0
19356,4,2,67663,67663,67665,0,2,3
19357,1,1,67664,67665,67666,1,2,0
19358,6,1,67670,67670,67671,0,1,4
19359,6,3,67676,67676,67679,0,3,5
19360,5,3,67681,67681,67684,0,3,2
19361,4,3,67685,67685,67688,0,3,1
19362,6,2,67691,67691,67693,0,2,3
19363,4,1,67695,67695,67696,0,1,2
19364,3,1,67698,67698,67699,0,1,2
19365,1,1,67699,67699,67700,0,1,0
19366,2,1,67701,67701,67702,0,1,1
19367,1,1,67702,67702,67703,0,1,0
19368,1,2,67703,67703,67705,0,2,0
19369,3,1,67706,67706,67707,0,1,1
19370,5,2,67711,67711,67713,0,2,4
19371,3,2,67714,67714,67716,0,2,1
19372,4,1,67718,67718,67719,0,1,2
19373,1,2,67719,67719,67721,0,2,0
19374,3,3,67722,67722,67725,0,3,1
19375,2,1,67724,67725,67726,1,2,0
19376,2,3,67726,67726,67729,0,3,0
19377,1,2,67727,67729,67731,2,4,0
19378,4,1,67731,67731,67732,0,1,0
19379,4,1,67735,67735,67736,0,1,3
19380,6,2,67741,67741,67743,0,2,5
19381,4,3,67745,67745,67748,0,3,2
19382,1,2,67746,67748,67750,2,4,0
19383,1,2,67747,67750,67752,3,5,0
19384,6,1,67753,67753,67754,0,1,1
19385,4,3,67757,67757,67760,0,3,3
19386,2,2,67759,67760,67762,1,3,0
19387,3,1,67762,67762,67763,0,1,0
19388,5,1,67767,67767,67768,0,1,4
19389,1,2,67768,67768,67770,0,2,0
19390,1,2,67769,67770,67772,1,3,0
19391,1,1,67770,67772,67773,2,3,0
19392,3,2,67773,67773,67775,0,2,0
19393,6,2,67779,67779,67781,0,2,4
19394,2,3,67781,67781,67784,0,3,0
19395,3,2,67784,67784,67786,0,2,0
19396,6,3,67790,67790,67793,0,3,4
19397,6,1,67796,67796,67797,0,1,3
19398,1,1,67797,67797,67798,0,1,0
19399,5,2,67802,67802,67804,0,2,4
19400,3,2,67805,67805,67807,0,2,1
19401,3,1,67808,67808,67809,0,1,1
19402,6,1,67814,67814,67815,0,1,5
19403,6,1,67820,67820,67821,0,1,5
19404,5,3,67825,67825,67828,0,3,4
19405,2,2,67827,67828,67830,1,3,0
19406,2,2,67829,67830,67832,1,3,0
19407,2,3,67831,67832,67835,1,4,0
19408,3,1,67834,67835,67836,1,2,0
19409,3,2,67837,67837,67839,0,2,1
19410,4,2,67841,67841,67843,0,2,2
19411,3,1,67844,67844,67845,0,1,1
19412,5,2,67849,67849,67851,0,2,4
19413,2,1,67851,67851,67852,0,1,0
19414,3,2,67854,67854,67856,0,2,2
19415,5,3,67859,67859,67862,0,3,3
19416,6,3,67865,67865,67868,0,3,3
19417,4,1,67869,67869,67870,0,1,1
19418,4,1,67873,67873,67874,0,1,3
19419,5,3,67878,67878,67881,0,3,4
19420,3,2,67881,67881,67883,0,2,0
19421,6,1,67887,67887,67888,0,1,4
19422,6,2,67893,67893,67895,0,2,5
19423,5,1,67898,67898,67899,0,1,3
19424,3,1,67901,67901,67902,0,1,2
19425,2,2,67903,67903,67905,0,2,1
19426,6,2,67909,67909,67911,0,2,4
19427,1,2,67910,67911,67913,1,3,0
19428,2,1,67912,67913,67914,1,2,0
19429,5,1,67917,67917,67918,0,1,3
19430,6,3,67923,67923,67926,0,3,5
19431,5,2,67928,67928,67930,0,2,2
19432,2,2,67930,67930,67932,0,2,0
19433,5,2,67935,67935,67937,0,2,3
19434,1,2,67936,67937,67939,1,3,0
19435,2,2,67938,67939,67941,1,3,0
19436,6,1,67944,67944,67945,0,1,3
19437,1,1,67945,67945,67946,0,1,0
19438,2,1,67947,67947,67948,0,1,1
19439,5,3,67952,67952,67955,0,3,4
19440,2,2,67954,67955,67957,1,3,0
19441,3,3,67957,67957,67960,0,3,0
19442,4,1,67961,67961,67962,0,1,1
19443,6,2,67967,67967,67969,0,2,5
19444,2,1,67969,67969,67970,0,1,0
19445,3,1,67972,67972,67973,0,1,2
19446,2,1,67974,67974,67975,0,1,1
19447,2,3,67976,67976,67979,0,3,1
19448,2,2,67978,67979,67981,1,3,0
19449,4,2,67982,67982,67984,0,2,1
19450,2,1,67984,67984,67985,0,1,0
19451,1,3,67985,67985,67988,0,3,0
19452,6,2,67991,67991,67993,0,2,3
19453,2,3,67993,67993,67996,0,3,0
19454,5,3,67998,67998,68001,0,3,2
19455,4,2,68002,68002,68004,0,2,1
19456,1,1,68003,68004,68005,1,2,0
19457,6,2,68009,68009,68011,0,2,4
19458,6,3,68015,68015,68018,0,3,4
19459,1,1,68016,68018,68019,2,3,0
19460,3,2,68019,68019,68021,0,2,0
19461,2,1,68021,68021,68022,0,1,0
19462,3,1,68024,68024,68025,0,1,2
19463,5,2,68029,68029,68031,0,2,4
19464,6,2,68035,68035,68037,0,2,4
19465,6,1,68041,68041,68042,0,1,4
19466,4,1,68045,68045,68046,0,1,3
19467,2,2,68047,68047,68049,0,2,1
19468,1,3,68048,68049,68052,1,4,0
19469,1,2,68049,68052,68054,3,5,0
19470,4,3,68053,68054,68057,1,4,0
19471,3,1,68056,68057,68058,1,2,0
19472,2,1,68058,68058,68059,0,1,0
19473,1,2,68059,68059,68061,0,2,0
19474,5,2,68064,68064,68066,0,2,3
19475,5,3,68069,68069,68072,0,3,3
19476,6,2,68075,68075,68077,0,2,3
19477,2,1,68077,68077,68078,0,1,0
19478,5,3,68082,68082,68085,0,3,4
19479,6,2,68088,68088,68090,0,2,3
19480,3,2,68091,68091,68093,0,2,1
19481,3,2,68094,68094,68096,0,2,1
19482,1,3,68095,68096,68099,1,4,0
19483,6,1,68101,68101,68102,0,1,2
19484,5,1,68106,68106,68107,0,1,4
19485,5,3,68111,68111,68114,0,3,4
19486,4,2,68115,68115,68117,0,2,1
19487,6,2,68121,68121,68123,0,2,4
19488,3,2,68124,68124,68126,0,2,1
19489,2,1,68126,68126,68127,0,1,0
19490,6,2,68132,68132,68134,0,2,5
19491,4,1,68136,68136,68137,0,1,2
19492,3,2,68139,68139,68141,0,2,2
19493,6,1,68145,68145,68146,0,1,4
19494,5,3,68150,68150,68153,0,3,4
19495,3,3,68153,68153,68156,0,3,0
19496,2,2,68155,68156,68158,1,3,0
19497,1,2,68156,68158,68160,2,4,0
19498,2,3,68158,68160,68163,2,5,0
19499,3,3,68161,68163,68166,2,5,0
19500,6,3,68167,68167,68170,0,3,1
19501,4,1,68171,68171,68172,0,1,1
19502,4,3,68175,68175,68178,0,3,3
19503,1,1,68176,68178,68179,2,3,0
19504,2,2,68178,68179,68181,1,3,0
19505,3,2,68181,68181,68183,0,2,0
19506,4,1,68185,68185,68186,0,1,2
19507,5,2,68190,68190,68192,0,2,4
19508,2,1,68192,68192,68193,0,1,0
19509,1,1,68193,68193,68194,0,1,0
19510,2,3,68195,68195,68198,0,3,1
19511,3,2,68198,68198,68200,0,2,0
19512,4,1,68202,68202,68203,0,1,2
19513,2,3,68204,68204,68207,0,3,1
19514,2,3,68206,68207,68210,1,4,0
19515,4,1,68210,68210,68211,0,1,0
19516,3,3,68213,68213,68216,0,3,2
19517,1,1,68214,68216,68217,2,3,0
19518,2,1,68216,68217,68218,1,2,0
19519,2,2,68218,68218,68220,0,2,0
19520,4,2,68222,68222,68224,0,2,2
19521,3,3,68225,68225,68228,0,3,1
19522,6,2,68231,68231,68233,0,2,3
19523,6,3,68237,68237,68240,0,3,4
19524,6,3,68243,68243,68246,0,3,3
19525,3,1,68246,68246,68247,0,1,0
19526,6,3,68252,68252,68255,0,3,5
19527,6,1,68258,68258,68259,0,1,3
19528,3,1,68261,68261,68262,0,1,2
19529,3,2,68264,68264,68266,0,2,2
19530,3,3,68267,68267,68270,0,3,1
19531,3,3,68270,68270,68273,0,3,0
19532,5,1,68275,68275,68276,0,1,2
19533,1,3,68276,68276,68279,0,3,0
19534,6,2,68282,68282,68284,0,2,3
19535,5,2,68287,68287,68289,0,2,3
19536,6,3,68293,68293,68296,0,3,4
19537,3,3,68296,68296,68299,0,3,0
19538,5,1,68301,68301,68302,0,1,2
19539,4,2,68305,68305,68307,0,2,3
19540,3,3,68308,68308,68311,0,3,1
19541,2,2,68310,68311,68313,1,3,0
19542,5,1,68315,68315,68316,0,1,2
19543,2,3,68317,68317,68320,0,3,1
19544,5,3,68322,68322,68325,0,3,2
19545,2,3,68324,68325,68328,1,4,0
19546,5,3,68329,68329,68332,0,3,1
19547,6,3,68335,68335,68338,0,3,3
19548,6,1,68341,68341,68342,0,1,3
19549,2,2,68343,68343,68345,0,2,1
19550,6,2,68349,68349,68351,0,2,4
19551,2,1,68351,68351,68352,0,1,0
19552,4,1,68355,68355,68356,0,1,3
19553,1,3,68356,68356,68359,0,3,0
19554,4,3,68360,68360,68363,0,3,1
19555,3,1,68363,68363,68364,0,1,0
19556,2,1,68365,68365,68366,0,1,1
19557,6,3,68371,68371,68374,0,3,5
19558,3,2,68374,68374,68376,0,2,0
19559,6,3,68380,68380,68383,0,3,4
19560,2,3,68382,68383,68386,1,4,0
19561,6,1,68388,68388,68389,0,1,2
19562,2,2,68390,68390,68392,0,2,1
19563,5,3,68395,68395,68398,0,3,3
19564,1,1,68396,68398,68399,2,3,0
19565,1,1,68397,68399,68400,2,3,0
19566,3,1,68400,68400,68401,0,1,0
19567,3,1,68403,68403,68404,0,1,2
19568,1,3,68404,68404,68407,0,3,0
19569,2,1,68406,68407,68408,1,2,0
19570,1,3,68407,68408,68411,1,4,0
19571,6,1,68413,68413,68414,0,1,2
19572,1,3,68414,68414,68417,0,3,0
19573,6,2,68420,68420,68422,0,2,3
19574,1,1,68421,68422,68423,1,2,0
19575,5,1,68426,68426,68427,0,1,3
19576,4,3,68430,68430,68433,0,3,3
19577,5,2,68435,68435,68437,0,2,2
19578,2,3,68437,68437,68440,0,3,0
19579,2,3,68439,68440,68443,1,4,0
19580,4,1,68443,68443,68444,0,1,0
19581,3,2,68446,68446,68448,0,2,2
19582,6,2,68452,68452,68454,0,2,4
19583,6,1,68458,68458,68459,0,1,4
19584,2,1,68460,68460,68461,0,1,1
19585,1,2,68461,68461,68463,0,2,0
19586,3,1,68464,68464,68465,0,1,1
19587,4,3,68468,68468,68471,0,3,3
19588,6,1,68474,68474,68475,0,1,3
19589,5,2,68479,68479,68481,0,2,4
19590,5,1,68484,68484,68485,0,1,3
19591,6,2,68490,68490,68492,0,2,5
19592,6,2,68496,68496,68498,0,2,4
19593,3,1,68499,68499,68500,0,1,1
19594,4,2,68503,68503,68505,0,2,3
19595,2,2,68505,68505,68507,0,2,0
19596,1,1,68506,68507,68508,1,2,0
19597,1,2,68507,68508,68510,1,3,0
19598,4,3,68511,68511,68514,0,3,1
19599,1,3,68512,68514,68517,2,5,0
19600,2,3,68514,68517,68520,3,6,0
19601,4,3,68518,68520,68523,2,5,0
19602,6,1,68524,68524,68525,0,1,1
19603,6,2,68530,68530,68532,0,2,5
19604,6,2,68536,68536,68538,0,2,4
19605,4,2,68540,68540,68542,0,2,2
19606,2,1,68542,68542,68543,0,1,0
19607,2,1,68544,68544,68545,0,1,1
19608,5,1,68549,68549,68550,0,1,4
19609,2,2,68551,68551,68553,0,2,1
19610,2,2,68553,68553,68555,0,2,0
19611,5,1,68558,68558,68559,0,1,3
19612,3,1,68561,68561,68562,0,1,2
19613,4,2,68565,68565,68567,0,2,3
19614,2,2,68567,68567,68569,0,2,0
19615,3,3,68570,68570,68573,0,3,1
19616,2,1,68572,68573,68574,1,2,0
19617,6,3,68578,68578,68581,0,3,4
19618,5,1,68583,68583,68584,0,1,2
19619,3,3,68586,68586,68589,0,3,2
19620,6,1,68592,68592,68593,0,1,3
19621,6,2,68598,68598,68600,0,2,5
19622,4,1,68602,68602,68603,0,1,2
19623,4,2,68606,68606,68608,0,2,3
19624,5,2,68611,68611,68613,0,2,3
19625,4,3,68615,68615,68618,0,3,2
19626,2,3,68617,68618,68621,1,4,0
19627,3,2,68620,68621,68623,1,3,0
19628,1,3,68621,68623,68626,2,5,0
19629,5,2,68626,68626,68628,0,2,0
19630,5,2,68631,68631,68633,0,2,3
19631,6,3,68637,68637,68640,0,3,4
19632,6,3,68643,68643,68646,0,3,3
19633,6,3,68649,68649,68652,0,3,3
19634,4,1,68653,68653,68654,0,1,1
19635,4,3,68657,68657,68660,0,3,3
19636,4,2,68661,68661,68663,0,2,1
19637,1,2,68662,68663,68665,1,3,0
19638,1,2,68663,68665,68667,2,4,0
19639,5,3,68668,68668,68671,0,3,1
19640,5,2,68673,68673,68675,0,2,2
19641,2,2,68675,68675,68677,0,2,0
19642,4,1,68679,68679,68680,0,1,2
19643,3,3,68682,68682,68685,0,3,2
19644,6,1,68688,68688,68689,0,1,3
19645,4,1,68692,68692,68693,0,1,3
19646,2,2,68694,68694,68696,0,2,1
19647,3,2,68697,68697,68699,0,2,1
19648,1,3,68698,68699,68702,1,4,0
19649,5,1,68703,68703,68704,0,1,1
19650,1,1,68704,68704,68705,0,1,0
19651,3,2,68707,68707,68709,0,2,2
19652,4,1,68711,68711,68712,0,1,2
19653,2,2,68713,68713,68715,0,2,1
19654,3,3,68716,68716,68719,0,3,1
19655,3,3,68719,68719,68722,0,3,0
19656,4,1,68723,68723,68724,0,1,1
19657,2,2,68725,68725,68727,0,2,1
19658,3,3,68728,68728,68731,0,3,1
19659,1,3,68729,68731,68734,2,5,0
19660,3,1,68732,68734,68735,2,3,0
19661,6,3,68738,68738,68741,0,3,3
19662,3,3,68741,68741,68744,0,3,0
19663,5,2,68746,68746,68748,0,2,2
19664,1,1,68747,68748,68749,1,2,0
19665,3,3,68750,68750,68753,0,3,1
19666,3,3,68753,68753,68756,0,3,0
19667,5,2,68758,68758,68760,0,2,2
19668,5,1,68763,68763,68764,0,1,3
19669,4,1,68767,68767,68768,0,1,3
19670,5,2,68772,68772,68774,0,2,4
19671,3,3,68775,68775,68778,0,3,1
19672,3,2,68778,68778,68780,0,2,0
19673,1,2,68779,68780,68782,1,3,0
19674,5,3,68784,68784,68787,0,3,2
19675,2,3,68786,68787,68790,1,4,0
19676,2,3,68788,68790,68793,2,5,0
19677,6,1,68794,68794,68795,0,1,1
19678,4,3,68798,68798,68801,0,3,3
19679,1,2,68799,68801,68803,2,4,0
19680,2,1,68801,68803,68804,2,3,0
19681,6,2,68807,68807,68809,0,2,3
19682,6,1,68813,68813,68814,0,1,4
19683,1,3,68814,68814,68817,0,3,0
19684,6,1,68820,68820,68821,0,1,3
19685,1,3,68821,68821,68824,0,3,0
19686,3,3,68824,68824,68827,0,3,0
19687,6,1,68830,68830,68831,0,1,3
19688,6,1,68836,68836,68837,0,1,5
19689,4,2,68840,68840,68842,0,2,3
19690,4,3,68844,68844,68847,0,3,2
19691,6,2,68850,68850,68852,0,2,3
19692,6,2,68856,68856,68858,0,2,4
19693,2,2,68858,68858,68860,0,2,0
19694,1,3,68859,68860,68863,1,4,0
19695,3,1,68862,68863,68864,1,2,0
19696,4,2,68866,68866,68868,0,2,2
19697,4,1,68870,68870,68871,0,1,2
19698,3,3,68873,68873,68876,0,3,2
19699,5,1,68878,68878,68879,0,1,2
19700,3,2,68881,68881,68883,0,2,2
19701,4,2,68885,68885,68887,0,2,2
19702,2,3,68887,68887,68890,0,3,0
19703,4,3,68891,68891,68894,0,3,1
19704,1,3,68892,68894,68897,2,5,0
19705,1,3,68893,68897,68900,4,7,0
19706,5,2,68898,68900,68902,2,4,0
19707,2,3,68900,68902,68905,2,5,0
19708,6,1,68906,68906,68907,0,1,1
19709,5,2,68911,68911,68913,0,2,4
19710,2,2,68913,68913,68915,0,2,0
19711,1,2,68914,68915,68917,1,3,0
19712,3,2,68917,68917,68919,0,2,0
19713,2,1,68919,68919,68920,0,1,0
19714,2,2,68921,68921,68923,0,2,1
19715,2,1,68923,68923,68924,0,1,0
19716,5,2,68928,68928,68930,0,2,4
19717,4,3,68932,68932,68935,0,3,2
19718,6,2,68938,68938,68940,0,2,3
19719,6,3,68944,68944,68947,0,3,4
19720,2,2,68946,68947,68949,1,3,0
19721,6,2,68952,68952,68954,0,2,3
19722,4,3,68956,68956,68959,0,3,2
19723,4,3,68960,68960,68963,0,3,1
19724,5,1,68965,68965,68966,0,1,2
19725,2,3,68967,68967,68970,0,3,1
19726,5,1,68972,68972,68973,0,1,2
19727,5,3,68977,68977,68980,0,3,4
19728,5,2,68982,68982,68984,0,2,2
19729,5,3,68987,68987,68990,0,3,3
19730,3,2,68990,68990,68992,0,2,0
19731,2,2,68992,68992,68994,0,2,0
19732,6,2,68998,68998,69000,0,2,4
19733,2,1,69000,69000,69001,0,1,0
19734,5,3,69005,69005,69008,0,3,4
19735,6,2,69011,69011,69013,0,2,3
19736,1,3,69012,69013,69016,1,4,0
19737,5,2,69017,69017,69019,0,2,1
19738,1,3,69018,69019,69022,1,4,0
19739,5,1,69023,69023,69024,0,1,1
19740,1,1,69024,69024,69025,0,1,0
19741,3,2,69027,69027,69029,0,2,2
19742,6,3,69033,69033,69036,0,3,4
19743,2,3,69035,69036,69039,1,4,0
19744,3,2,69038,69039,69041,1,3,0
19745,2,1,69040,69041,69042,1,2,0
19746,6,2,69046,69046,69048,0,2,4
19747,1,3,69047,69048,69051,1,4,0
19748,4,2,69051,69051,69053,0,2,0
19749,2,2,69053,69053,69055,0,2,0
19750,3,2,69056,69056,69058,0,2,1
19751,5,3,69061,69061,69064,0,3,3
19752,4,3,69065,69065,69068,0,3,1
19753,4,2,69069,69069,69071,0,2,1
19754,6,2,69075,69075,69077,0,2,4
19755,2,3,69077,69077,69080,0,3,0
19756,1,2,69078,69080,69082,2,4,0
19757,5,1,69083,69083,69084,0,1,1
19758,5,2,69088,69088,69090,0,2,4
19759,3,1,69091,69091,69092,0,1,1
19760,3,3,69094,69094,69097,0,3,2
19761,2,2,69096,69097,69099,1,3,0
19762,4,1,69100,69100,69101,0,1,1
19763,6,1,69106,69106,69107,0,1,5
19764,3,1,69109,69109,69110,0,1,2
19765,2,1,69111,69111,69112,0,1,1
19766,6,1,69117,69117,69118,0,1,5
19767,2,2,69119,69119,69121,0,2,1
19768,3,1,69122,69122,69123,0,1,1
19769,2,2,69124,69124,69126,0,2,1
19770,6,1,69130,69130,69131,0,1,4
19771,2,2,69132,69132,69134,0,2,1
19772,1,2,69133,69134,69136,1,3,0
19773,6,3,69139,69139,69142,0,3,3
19774,3,2,69142,69142,69144,0,2,0
19775,3,3,69145,69145,69148,0,3,1
19776,1,3,69146,69148,69151,2,5,0
19777,3,2,69149,69151,69153,2,4,0
19778,3,1,69152,69153,69154,1,2,0
19779,6,2,69158,69158,69160,0,2,4
19780,6,2,69164,69164,69166,0,2,4
19781,6,3,69170,69170,69173,0,3,4
19782,3,2,69173,69173,69175,0,2,0
19783,6,1,69179,69179,69180,0,1,4
19784,2,1,69181,69181,69182,0,1,1
19785,3,2,69184,69184,69186,0,2,2
19786,6,2,69190,69190,69192,0,2,4
19787,3,3,69193,69193,69196,0,3,1
19788,3,1,69196,69196,69197,0,1,0
19789,5,2,69201,69201,69203,0,2,4
19790,6,2,69207,69207,69209,0,2,4
19791,3,2,69210,69210,69212,0,2,1
19792,5,3,69215,69215,69218,0,3,3
19793,1,3,69216,69218,69221,2,5,0
19794,3,2,69219,69221,69223,2,4,0
19795,3,2,69222,69223,69225,1,3,0
19796,4,1,69226,69226,69227,0,1,1
19797,1,1,69227,69227,69228,0,1,0
19798,6,1,69233,69233,69234,0,1,5
19799,6,1,69239,69239,69240,0,1,5
19800,6,2,69245,69245,69247,0,2,5
19801,2,3,69247,69247,69250,0,3,0
19802,1,2,69248,69250,69252,2,4,0
19803,2,3,69250,69252,69255,2,5,0
19804,2,2,69252,69255,69257,3,5,0
19805,6,2,69258,69258,69260,0,2,1
19806,3,3,69261,69261,69264,0,3,1
19807,5,2,69266,69266,69268,0,2,2
19808,3,3,69269,69269,69272,0,3,1
19809,3,3,69272,69272,69275,0,3,0
19810,2,3,69274,69275,69278,1,4,0
19811,2,3,69276,69278,69281,2,5,0
19812,3,1,69279,69281,69282,2,3,0
19813,5,3,69284,69284,69287,0,3,2
19814,6,1,69290,69290,69291,0,1,3
19815,3,3,69293,69293,69296,0,3,2
19816,4,1,69297,69297,69298,0,1,1
19817,3,1,69300,69300,69301,0,1,2
19818,3,1,69303,69303,69304,0,1,2
19819,1,2,69304,69304,69306,0,2,0
19820,2,1,69306,69306,69307,0,1,0
19821,6,1,69312,69312,69313,0,1,5
19822,5,2,69317,69317,69319,0,2,4
19823,5,3,69322,69322,69325,0,3,3
19824,4,2,69326,69326,69328,0,2,1
19825,2,3,69328,69328,69331,0,3,0
19826,5,1,69333,69333,69334,0,1,2
19827,3,2,69336,69336,69338,0,2,2
19828,2,2,69338,69338,69340,0,2,0
19829,6,3,69344,69344,69347,0,3,4
19830,2,3,69346,69347,69350,1,4,0
19831,5,2,69351,69351,69353,0,2,1
19832,5,3,69356,69356,69359,0,3,3
19833,6,2,69362,69362,69364,0,2,3
19834,4,2,69366,69366,69368,0,2,2
19835,1,3,69367,69368,69371,1,4,0
19836,1,1,69368,69371,69372,3,4,0
19837,4,1,69372,69372,69373,0,1,0
19838,3,3,69375,69375,69378,0,3,2
19839,6,1,69381,69381,69382,0,1,3
19840,2,2,69383,69383,69385,0,2,1
19841,6,3,69389,69389,69392,0,3,4
19842,2,3,69391,69392,69395,1,4,0
19843,4,3,69395,69395,69398,0,3,0
19844,1,2,69396,69398,69400,2,4,0
19845,6,3,69402,69402,69405,0,3,2
19846,2,1,69404,69405,69406,1,2,0
19847,5,3,69409,69409,69412,0,3,3
19848,2,2,69411,69412,69414,1,3,0
19849,6,2,69417,69417,69419,0,2,3
19850,4,2,69421,69421,69423,0,2,2
19851,4,1,69425,69425,69426,0,1,2
19852,1,3,69426,69426,69429,0,3,0
19853,1,1,69427,69429,69430,2,3,0
19854,5,1,69432,69432,69433,0,1,2
19855,1,2,69433,69433,69435,0,2,0
19856,1,2,69434,69435,69437,1,3,0
19857,2,3,69436,69437,69440,1,4,0
19858,1,2,69437,69440,69442,3,5,0
19859,1,3,69438,69442,69445,4,7,0
19860,4,2,69442,69445,69447,3,5,0
19861,5,2,69447,69447,69449,0,2,0
19862,5,2,69452,69452,69454,0,2,3
19863,1,3,69453,69454,69457,1,4,0
19864,2,3,69455,69457,69460,2,5,0
19865,5,1,69460,69460,69461,0,1,0
19866,3,3,69463,69463,69466,0,3,2
19867,1,2,69464,69466,69468,2,4,0
19868,4,1,69468,69468,69469,0,1,0
19869,2,3,69470,69470,69473,0,3,1
19870,5,2,69475,69475,69477,0,2,2
19871,1,1,69476,69477,69478,1,2,0
19872,1,2,69477,69478,69480,1,3,0
19873,3,3,69480,69480,69483,0,3,0
19874,1,2,69481,69483,69485,2,4,0
19875,3,2,69484,69485,69487,1,3,0
19876,6,1,69490,69490,69491,0,1,3
19877,2,3,69492,69492,69495,0,3,1
19878,4,3,69496,69496,69499,0,3,1
19879,3,3,69499,69499,69502,0,3,0
19880,6,2,69505,69505,69507,0,2,3
19881,1,1,69506,69507,69508,1,2,0
19882,2,3,69508,69508,69511,0,3,0
19883,1,2,69509,69511,69513,2,4,0
19884,3,1,69512,69513,69514,1,2,0
19885,5,2,69517,69517,69519,0,2,3
19886,3,3,69520,69520,69523,0,3,1
19887,1,2,69521,69523,69525,2,4,0
19888,2,1,69523,69525,69526,2,3,0
19889,5,1,69528,69528,69529,0,1,2
19890,6,2,69534,69534,69536,0,2,5
19891,4,2,69538,69538,69540,0,2,2
19892,3,2,69541,69541,69543,0,2,1
19893,1,1,69542,69543,69544,1,2,0
19894,2,3,69544,69544,69547,0,3,0
19895,3,3,69547,69547,69550,0,3,0
19896,1,1,69548,69550,69551,2,3,0
19897,1,1,69549,69551,69552,2,3,0
19898,2,2,69551,69552,69554,1,3,0
19899,6,2,69557,69557,69559,0,2,3
19900,4,3,69561,69561,69564,0,3,2
19901,5,2,69566,69566,69568,0,2,2
19902,1,2,69567,69568,69570,1,3,0
19903,1,3,69568,69570,69573,2,5,0
19904,6,3,69574,69574,69577,0,3,1
19905,2,1,69576,69577,69578,1,2,0
19906,2,3,69578,69578,69581,0,3,0
19907,2,1,69580,69581,69582,1,2,0
19908,1,2,69581,69582,69584,1,3,0
19909,2,2,69583,69584,69586,1,3,0
19910,5,3,69588,69588,69591,0,3,2
19911,4,3,69592,69592,69595,0,3,1
19912,6,2,69598,69598,69600,0,2,3
19913,2,3,69600,69600,69603,0,3,0
19914,3,2,69603,69603,69605,0,2,0
19915,1,1,69604,69605,69606,1,2,0
19916,6,1,69610,69610,69611,0,1,4
19917,5,1,69615,69615,69616,0,1,4
19918,6,2,69621,69621,69623,0,2,5
19919,5,1,69626,69626,69627,0,1,3
19920,6,2,69632,69632,69634,0,2,5
19921,2,2,69634,69634,69636,0,2,0
19922,6,3,69640,69640,69643,0,3,4
19923,4,1,69644,69644,69645,0,1,1
19924,3,3,69647,69647,69650,0,3,2
19925,1,1,69648,69650,69651,2,3,0
19926,1,2,69649,69651,69653,2,4,0
19927,2,3,69651,69653,69656,2,5,0
19928,3,1,69654,69656,69657,2,3,0
19929,2,1,69656,69657,69658,1,2,0
19930,5,1,69661,69661,69662,0,1,3
19931,2,1,69663,69663,69664,0,1,1
19932,2,1,69665,69665,69666,0,1,1
19933,6,2,69671,69671,69673,0,2,5
19934,1,3,69672,69673,69676,1,4,0
19935,3,1,69675,69676,69677,1,2,0
19936,2,3,69677,69677,69680,0,3,0
19937,1,2,69678,69680,69682,2,4,0
19938,1,3,69679,69682,69685,3,6,0
19939,6,2,69685,69685,69687,0,2,0
19940,5,3,69690,69690,69693,0,3,3
19941,4,1,69694,69694,69695,0,1,1
19942,5,1,69699,69699,69700,0,1,4
19943,3,3,69702,69702,69705,0,3,2
19944,4,3,69706,69706,69709,0,3,1
19945,5,2,69711,69711,69713,0,2,2
19946,5,2,69716,69716,69718,0,2,3
19947,6,2,69722,69722,69724,0,2,4
19948,6,2,69728,69728,69730,0,2,4
19949,3,3,69731,69731,69734,0,3,1
19950,2,1,69733,69734,69735,1,2,0
19951,6,1,69739,69739,69740,0,1,4
19952,5,3,69744,69744,69747,0,3,4
19953,1,1,69745,69747,69748,2,3,0
19954,5,1,69750,69750,69751,0,1,2
19955,4,2,69754,69754,69756,0,2,3
19956,5,1,69759,69759,69760,0,1,3
19957,2,3,69761,69761,69764,0,3,1
19958,5,2,69766,69766,69768,0,2,2
19959,5,3,69771,69771,69774,0,3,3
19960,4,2,69775,69775,69777,0,2,1
19961,3,1,69778,69778,69779,0,1,1
19962,6,3,69784,69784,69787,0,3,5
19963,5,3,69789,69789,69792,0,3,2
19964,6,3,69795,69795,69798,0,3,3
19965,6,3,69801,69801,69804,0,3,3
19966,4,3,69805,69805,69808,0,3,1
19967,1,2,69806,69808,69810,2,4,0
19968,4,2,69810,69810,69812,0,2,0
19969,4,2,69814,69814,69816,0,2,2
19970,6,2,69820,69820,69822,0,2,4
19971,2,3,69822,69822,69825,0,3,0
19972,2,2,69824,69825,69827,1,3,0
19973,6,3,69830,69830,69833,0,3,3
19974,2,2,69832,69833,69835,1,3,0
19975,5,2,69837,69837,69839,0,2,2
19976,3,1,69840,69840,69841,0,1,1
19977,3,2,69843,69843,69845,0,2,2
19978,5,2,69848,69848,69850,0,2,3
19979,1,2,69849,69850,69852,1,3,0
19980,2,1,69851,69852,69853,1,2,0
19981,4,3,69855,69855,69858,0,3,2
19982,1,3,69856,69858,69861,2,5,0
19983,4,3,69860,69861,69864,1,4,0
19984,2,1,69862,69864,69865,2,3,0
19985,1,2,69863,69865,69867,2,4,0
19986,2,1,69865,69867,69868,2,3,0
19987,1,1,69866,69868,69869,2,3,0
19988,4,3,69870,69870,69873,0,3,1
19989,4,1,69874,69874,69875,0,1,1
19990,5,2,69879,69879,69881,0,2,4
19991,1,2,69880,69881,69883,1,3,0
19992,6,3,69886,69886,69889,0,3,3
19993,5,2,69891,69891,69893,0,2,2
19994,3,1,69894,69894,69895,0,1,1
19995,5,1,69899,69899,69900,0,1,4
19996,1,1,69900,69900,69901,0,1,0
19997,6,3,69906,69906,69909,0,3,5
19998,4,3,69910,69910,69913,0,3,1
19999,1,3,69911,69913,69916,2,5,0
20000,6,1,69917,69917,69918,0,1,1
20001,4,1,69921,69921,69922,0,1,3
20002,1,3,69922,69922,69925,0,3,0
20003,4,3,69926,69926,69929,0,3,1
20004,6,3,69932,69932,69935,0,3,3
20005,6,3,69938,69938,69941,0,3,3
20006,1,2,69939,69941,69943,2,4,0
20007,2,2,69941,69943,69945,2,4,0
20008,1,3,69942,69945,69948,3,6,0
20009,2,2,69944,69948,69950,4,6,0
20010,5,3,69949,69950,69953,1,4,0
20011,3,3,69952,69953,69956,1,4,0
20012,4,1,69956,69956,69957,0,1,0
20013,1,1,69957,69957,69958,0,1,0
20014,1,2,69958,69958,69960,0,2,0
20015,3,3,69961,69961,69964,0,3,1
20016,2,3,69963,69964,69967,1,4,0
20017,4,2,69967,69967,69969,0,2,0
20018,2,2,69969,69969,69971,0,2,0
20019,6,1,69975,69975,69976,0,1,4
20020,6,1,69981,69981,69982,0,1,5
20021,6,3,69987,69987,69990,0,3,5
20022,2,2,69989,69990,69992,1,3,0
20023,2,3,69991,69992,69995,1,4,0
20024,3,1,69994,69995,69996,1,2,0
20025,1,2,69995,69996,69998,1,3,0
20026,1,1,69996,69998,69999,2,3,0
20027,2,3,69998,69999,70002,1,4,0
20028,3,1,70001,70002,70003,1,2,0
20029,3,1,70004,70004,70005,0,1,1
20030,4,1,70008,70008,70009,0,1,3
20031,6,2,70014,70014,70016,0,2,5
20032,3,3,70017,70017,70020,0,3,1
20033,5,2,70022,70022,70024,0,2,2
20034,4,2,70026,70026,70028,0,2,2
20035,4,3,70030,70030,70033,0,3,2
20036,4,3,70034,70034,70037,0,3,1
20037,2,2,70036,70037,70039,1,3,0
20038,4,3,70040,70040,70043,0,3,1
20039,5,3,70045,70045,70048,0,3,2
20040,5,3,70050,70050,70053,0,3,2
20041,5,1,70055,70055,70056,0,1,2
20042,1,2,70056,70056,70058,0,2,0
20043,2,2,70058,70058,70060,0,2,0
20044,5,2,70063,70063,70065,0,2,3
20045,2,2,70065,70065,70067,0,2,0
20046,4,1,70069,70069,70070,0,1,2
20047,4,3,70073,70073,70076,0,3,3
20048,6,1,70079,70079,70080,0,1,3
20049,2,2,70081,70081,70083,0,2,1
20050,6,3,70087,70087,70090,0,3,4
20051,4,3,70091,70091,70094,0,3,1
20052,3,3,70094,70094,70097,0,3,0
20053,2,3,70096,70097,70100,1,4,0
20054,1,1,70097,70100,70101,3,4,0
20055,2,3,70099,70101,70104,2,5,0
20056,5,2,70104,70104,70106,0,2,0
20057,4,1,70108,70108,70109,0,1,2
20058,4,3,70112,70112,70115,0,3,3
20059,3,2,70115,70115,70117,0,2,0
20060,6,2,70121,70121,70123,0,2,4
20061,4,1,70125,70125,70126,0,1,2
20062,5,2,70130,70130,70132,0,2,4
20063,4,3,70134,70134,70137,0,3,2
20064,6,3,70140,70140,70143,0,3,3
20065,1,3,70141,70143,70146,2,5,0
20066,1,1,70142,70146,70147,4,5,0
20067,4,1,70146,70147,70148,1,2,0
20068,2,2,70148,70148,70150,0,2,0
20069,4,2,70152,70152,70154,0,2,2
20070,4,2,70156,70156,70158,0,2,2
20071,1,2,70157,70158,70160,1,3,0
20072,5,2,70162,70162,70164,0,2,2
20073,1,1,70163,70164,70165,1,2,0
20074,3,1,70166,70166,70167,0,1,1
20075,3,3,70169,70169,70172,0,3,2
20076,6,1,70175,70175,70176,0,1,3
20077,6,2,70181,70181,70183,0,2,5
20078,4,2,70185,70185,70187,0,2,2
20079,4,1,70189,70189,70190,0,1,2
20080,5,3,70194,70194,70197,0,3,4
20081,5,2,70199,70199,70201,0,2,2
20082,5,3,70204,70204,70207,0,3,3
20083,1,2,70205,70207,70209,2,4,0
20084,2,1,70207,70209,70210,2,3,0
20085,2,2,70209,70210,70212,1,3,0
20086,2,1,70211,70212,70213,1,2,0
20087,4,1,70215,70215,70216,0,1,2
20088,3,1,70218,70218,70219,0,1,2
20089,5,1,70223,70223,70224,0,1,4
20090,6,3,70229,70229,70232,0,3,5
20091,6,2,70235,70235,70237,0,2,3
20092,6,2,70241,70241,70243,0,2,4
20093,4,3,70245,70245,70248,0,3,2
20094,6,2,70251,70251,70253,0,2,3
20095,1,1,70252,70253,70254,1,2,0
20096,1,3,70253,70254,70257,1,4,0
20097,4,1,70257,70257,70258,0,1,0
20098,1,3,70258,70258,70261,0,3,0
20099,3,3,70261,70261,70264,0,3,0
20100,2,1,70263,70264,70265,1,2,0
20101,6,3,70269,70269,70272,0,3,4
20102,6,2,70275,70275,70277,0,2,3
20103,2,1,70277,70277,70278,0,1,0
20104,5,2,70282,70282,70284,0,2,4
20105,3,1,70285,70285,70286,0,1,1
20106,4,1,70289,70289,70290,0,1,3
20107,5,1,70294,70294,70295,0,1,4
20108,4,3,70298,70298,70301,0,3,3
20109,1,1,70299,70301,70302,2,3,0
20110,5,3,70304,70304,70307,0,3,2
20111,6,2,70310,70310,70312,0,2,3
20112,1,3,70311,70312,70315,1,4,0
20113,2,2,70313,70315,70317,2,4,0
20114,4,3,70317,70317,70320,0,3,0
20115,3,2,70320,70320,70322,0,2,0
20116,5,2,70325,70325,70327,0,2,3
20117,1,3,70326,70327,70330,1,4,0
20118,4,1,70330,70330,70331,0,1,0
20119,1,1,70331,70331,70332,0,1,0
20120,1,3,70332,70332,70335,0,3,0
20121,6,1,70338,70338,70339,0,1,3
20122,4,1,70342,70342,70343,0,1,3
20123,5,2,70347,70347,70349,0,2,4
20124,3,3,70350,70350,70353,0,3,1
20125,3,1,70353,70353,70354,0,1,0
20126,4,2,70357,70357,70359,0,2,3
20127,5,1,70362,70362,70363,0,1,3
20128,3,3,70365,70365,70368,0,3,2
20129,2,1,70367,70368,70369,1,2,0
20130,2,1,70369,70369,70370,0,1,0
20131,1,2,70370,70370,70372,0,2,0
20132,5,2,70375,70375,70377,0,2,3
20133,5,1,70380,70380,70381,0,1,3
20134,1,2,70381,70381,70383,0,2,0
20135,5,1,70386,70386,70387,0,1,3
20136,3,1,70389,70389,70390,0,1,2
20137,1,2,70390,70390,70392,0,2,0
20138,3,2,70393,70393,70395,0,2,1
20139,2,1,70395,70395,70396,0,1,0
20140,6,3,70401,70401,70404,0,3,5
20141,3,2,70404,70404,70406,0,2,0
20142,3,2,70407,70407,70409,0,2,1
20143,2,2,70409,70409,70411,0,2,0
20144,5,2,70414,70414,70416,0,2,3
20145,4,2,70418,70418,70420,0,2,2
20146,6,3,70424,70424,70427,0,3,4
20147,3,2,70427,70427,70429,0,2,0
20148,3,2,70430,70430,70432,0,2,1
20149,5,3,70435,70435,70438,0,3,3
20150,1,2,70436,70438,70440,2,4,0
20151,2,2,70438,70440,70442,2,4,0
20152,2,1,70440,70442,70443,2,3,0
20153,6,2,70446,70446,70448,0,2,3
20154,3,3,70449,70449,70452,0,3,1
20155,6,1,70455,70455,70456,0,1,3
20156,4,1,70459,70459,70460,0,1,3
20157,3,2,70462,70462,70464,0,2,2
20158,4,1,70466,70466,70467,0,1,2
20159,4,2,70470,70470,70472,0,2,3
20160,3,2,70473,70473,70475,0,2,1
20161,6,3,70479,70479,70482,0,3,4
20162,6,2,70485,70485,70487,0,2,3
20163,2,3,70487,70487,70490,0,3,0
20164,3,2,70490,70490,70492,0,2,0
20165,6,3,70496,70496,70499,0,3,4
20166,4,3,70500,70500,70503,0,3,1
20167,4,2,70504,70504,70506,0,2,1
20168,5,1,70509,70509,70510,0,1,3
20169,1,3,70510,70510,70513,0,3,0
20170,2,1,70512,70513,70514,1,2,0
20171,4,3,70516,70516,70519,0,3,2
20172,3,2,70519,70519,70521,0,2,0
20173,3,3,70522,70522,70525,0,3,1
20174,6,2,70528,70528,70530,0,2,3
20175,3,1,70531,70531,70532,0,1,1
20176,4,2,70535,70535,70537,0,2,3
20177,2,3,70537,70537,70540,0,3,0
20178,3,3,70540,70540,70543,0,3,0
20179,4,2,70544,70544,70546,0,2,1
20180,6,3,70550,70550,70553,0,3,4
20181,1,1,70551,70553,70554,2,3,0
20182,2,1,70553,70554,70555,1,2,0
20183,3,2,70556,70556,70558,0,2,1
20184,1,2,70557,70558,70560,1,3,0
20185,3,3,70560,70560,70563,0,3,0
20186,1,1,70561,70563,70564,2,3,0
20187,6,3,70567,70567,70570,0,3,3
20188,5,2,70572,70572,70574,0,2,2
20189,2,1,70574,70574,70575,0,1,0
20190,1,3,70575,70575,70578,0,3,0
20191,6,3,70581,70581,70584,0,3,3
20192,5,3,70586,70586,70589,0,3,2
20193,2,1,70588,70589,70590,1,2,0
20194,4,1,70592,70592,70593,0,1,2
20195,2,3,70594,70594,70597,0,3,1
20196,1,2,70595,70597,70599,2,4,0
20197,1,1,70596,70599,70600,3,4,0
20198,1,2,70597,70600,70602,3,5,0
20199,2,1,70599,70602,70603,3,4,0
20200,3,2,70602,70603,70605,1,3,0
20201,1,1,70603,70605,70606,2,3,0
20202,1,3,70604,70606,70609,2,5,0
20203,2,1,70606,70609,70610,3,4,0
20204,5,2,70611,70611,70613,0,2,1
20205,5,3,70616,70616,70619,0,3,3
20206,6,3,70622,70622,70625,0,3,3
20207,3,1,70625,70625,70626,0,1,0
20208,6,3,70631,70631,70634,0,3,5
20209,6,2,70637,70637,70639,0,2,3
20210,3,1,70640,70640,70641,0,1,1
20211,1,3,70641,70641,70644,0,3,0
20212,6,1,70647,70647,70648,0,1,3
20213,3,3,70650,70650,70653,0,3,2
20214,1,3,70651,70653,70656,2,5,0
20215,4,1,70655,70656,70657,1,2,0
20216,2,1,70657,70657,70658,0,1,0
20217,4,1,70661,70661,70662,0,1,3
20218,2,2,70663,70663,70665,0,2,1
20219,2,3,70665,70665,70668,0,3,0
20220,6,2,70671,70671,70673,0,2,3
20221,3,2,70674,70674,70676,0,2,1
20222,3,2,70677,70677,70679,0,2,1
20223,6,1,70683,70683,70684,0,1,4
20224,5,2,70688,70688,70690,0,2,4
20225,4,1,70692,70692,70693,0,1,2
20226,2,2,70694,70694,70696,0,2,1
20227,2,1,70696,70696,70697,0,1,0
20228,4,1,70700,70700,70701,0,1,3
20229,5,2,70705,70705,70707,0,2,4
20230,4,3,70709,70709,70712,0,3,2
20231,6,3,70715,70715,70718,0,3,3
20232,6,1,70721,70721,70722,0,1,3
20233,3,1,70724,70724,70725,0,1,2
20234,5,3,70729,70729,70732,0,3,4
20235,5,2,70734,70734,70736,0,2,2
20236,1,3,70735,70736,70739,1,4,0
20237,6,2,70741,70741,70743,0,2,2
20238,6,2,70747,70747,70749,0,2,4
20239,1,3,70748,70749,70752,1,4,0
20240,6,2,70754,70754,70756,0,2,2
20241,6,2,70760,70760,70762,0,2,4
20242,4,1,70764,70764,70765,0,1,2
20243,5,1,70769,70769,70770,0,1,4
20244,6,2,70775,70775,70777,0,2,5
20245,6,1,70781,70781,70782,0,1,4
20246,5,2,70786,70786,70788,0,2,4
20247,3,3,70789,70789,70792,0,3,1
20248,4,3,70793,70793,70796,0,3,1
20249,5,1,70798,70798,70799,0,1,2
20250,1,3,70799,70799,70802,0,3,0
20251,1,1,70800,70802,70803,2,3,0
20252,2,1,70802,70803,70804,1,2,0
20253,3,1,70805,70805,70806,0,1,1
20254,6,3,70811,70811,70814,0,3,5
20255,3,1,70814,70814,70815,0,1,0
20256,1,2,70815,70815,70817,0,2,0
20257,6,3,70821,70821,70824,0,3,4
20258,1,2,70822,70824,70826,2,4,0
20259,3,3,70825,70826,70829,1,4,0
20260,3,2,70828,70829,70831,1,3,0
20261,1,3,70829,70831,70834,2,5,0
20262,4,3,70833,70834,70837,1,4,0
20263,5,1,70838,70838,70839,0,1,1
20264,3,1,70841,70841,70842,0,1,2
20265,3,2,70844,70844,70846,0,2,2
20266,1,2,70845,70846,70848,1,3,0
20267,5,2,70850,70850,70852,0,2,2
20268,4,2,70854,70854,70856,0,2,2
20269,6,3,70860,70860,70863,0,3,4
20270,6,2,70866,70866,70868,0,2,3
20271,6,1,70872,70872,70873,0,1,4
20272,4,2,70876,70876,70878,0,2,3
20273,5,3,70881,70881,70884,0,3,3
20274,5,3,70886,70886,70889,0,3,2
20275,2,2,70888,70889,70891,1,3,0
20276,6,2,70894,70894,70896,0,2,3
20277,5,3,70899,70899,70902,0,3,3
20278,5,2,70904,70904,70906,0,2,2
20279,4,2,70908,70908,70910,0,2,2
20280,6,2,70914,70914,70916,0,2,4
20281,4,1,70918,70918,70919,0,1,2
20282,5,1,70923,70923,70924,0,1,4
20283,3,1,70926,70926,70927,0,1,2
20284,3,2,70929,70929,70931,0,2,2
20285,6,2,70935,70935,70937,0,2,4
20286,2,1,70937,70937,70938,0,1,0
20287,4,3,70941,70941,70944,0,3,3
20288,3,1,70944,70944,70945,0,1,0
20289,5,1,70949,70949,70950,0,1,4
20290,4,2,70953,70953,70955,0,2,3
20291,1,3,70954,70955,70958,1,4,0
20292,2,2,70956,70958,70960,2,4,0
20293,5,1,70961,70961,70962,0,1,1
20294,5,3,70966,70966,70969,0,3,4
20295,1,2,70967,70969,70971,2,4,0
20296,3,3,70970,70971,70974,1,4,0
20297,1,1,70971,70974,70975,3,4,0
20298,5,3,70976,70976,70979,0,3,1
20299,6,2,70982,70982,70984,0,2,3
20300,5,1,70987,70987,70988,0,1,3
20301,2,2,70989,70989,70991,0,2,1
20302,5,1,70994,70994,70995,0,1,3
20303,2,3,70996,70996,70999,0,3,1
20304,5,3,71001,71001,71004,0,3,2
20305,2,2,71003,71004,71006,1,3,0
20306,2,3,71005,71006,71009,1,4,0
20307,1,1,71006,71009,71010,3,4,0
20308,6,2,71012,71012,71014,0,2,2
20309,3,1,71015,71015,71016,0,1,1
20310,4,1,71019,71019,71020,0,1,3
20311,4,2,71023,71023,71025,0,2,3
20312,6,1,71029,71029,71030,0,1,4
20313,3,2,71032,71032,71034,0,2,2
20314,2,1,71034,71034,71035,0,1,0
20315,2,3,71036,71036,71039,0,3,1
20316,3,1,71039,71039,71040,0,1,0
20317,4,1,71043,71043,71044,0,1,3
20318,2,3,71045,71045,71048,0,3,1
20319,6,2,71051,71051,71053,0,2,3
20320,1,3,71052,71053,71056,1,4,0
20321,1,2,71053,71056,71058,3,5,0
20322,5,3,71058,71058,71061,0,3,0
20323,3,1,71061,71061,71062,0,1,0
20324,4,2,71065,71065,71067,0,2,3
20325,3,3,71068,71068,71071,0,3,1
20326,6,1,71074,71074,71075,0,1,3
20327,5,3,71079,71079,71082,0,3,4
20328,3,1,71082,71082,71083,0,1,0
20329,5,3,71087,71087,71090,0,3,4
20330,1,3,71088,71090,71093,2,5,0
20331,5,1,71093,71093,71094,0,1,0
20332,6,3,71099,71099,71102,0,3,5
20333,6,3,71105,71105,71108,0,3,3
20334,2,2,71107,71108,71110,1,3,0
20335,3,1,71110,71110,71111,0,1,0
20336,2,3,71112,71112,71115,0,3,1
20337,2,1,71114,71115,71116,1,2,0
20338,2,2,71116,71116,71118,0,2,0
20339,4,1,71120,71120,71121,0,1,2
20340,4,3,71124,71124,71127,0,3,3
20341,4,2,71128,71128,71130,0,2,1
20342,4,1,71132,71132,71133,0,1,2
20343,1,1,71133,71133,71134,0,1,0
20344,5,3,71138,71138,71141,0,3,4
20345,1,2,71139,71141,71143,2,4,0
20346,2,3,71141,71143,71146,2,5,0
20347,4,3,71145,71146,71149,1,4,0
20348,3,3,71148,71149,71152,1,4,0
20349,2,3,71150,71152,71155,2,5,0
20350,5,1,71155,71155,71156,0,1,0
20351,5,1,71160,71160,71161,0,1,4
20352,4,1,71164,71164,71165,0,1,3
20353,4,3,71168,71168,71171,0,3,3
20354,5,3,71173,71173,71176,0,3,2
20355,6,1,71179,71179,71180,0,1,3
20356,4,1,71183,71183,71184,0,1,3
20357,6,3,71189,71189,71192,0,3,5
20358,6,3,71195,71195,71198,0,3,3
20359,2,1,71197,71198,71199,1,2,0
20360,2,2,71199,71199,71201,0,2,0
20361,1,1,71200,71201,71202,1,2,0
20362,1,2,71201,71202,71204,1,3,0
20363,6,1,71207,71207,71208,0,1,3
20364,2,1,71209,71209,71210,0,1,1
20365,4,1,71213,71213,71214,0,1,3
20366,5,2,71218,71218,71220,0,2,4
20367,6,2,71224,71224,71226,0,2,4
20368,5,3,71229,71229,71232,0,3,3
20369,6,2,71235,71235,71237,0,2,3
20370,5,3,71240,71240,71243,0,3,3
20371,1,1,71241,71243,71244,2,3,0
20372,5,2,71246,71246,71248,0,2,2
20373,5,1,71251,71251,71252,0,1,3
20374,4,2,71255,71255,71257,0,2,3
20375,1,1,71256,71257,71258,1,2,0
20376,5,1,71261,71261,71262,0,1,3
20377,5,3,71266,71266,71269,0,3,4
20378,1,3,71267,71269,71272,2,5,0
20379,1,1,71268,71272,71273,4,5,0
20380,4,2,71272,71273,71275,1,3,0
20381,5,3,71277,71277,71280,0,3,2
20382,3,1,71280,71280,71281,0,1,0
20383,2,2,71282,71282,71284,0,2,1
20384,6,3,71288,71288,71291,0,3,4
20385,1,1,71289,71291,71292,2,3,0
20386,1,1,71290,71292,71293,2,3,0
20387,3,3,71293,71293,71296,0,3,0
20388,6,2,71299,71299,71301,0,2,3
20389,4,2,71303,71303,71305,0,2,2
20390,3,3,71306,71306,71309,0,3,1
20391,1,3,71307,71309,71312,2,5,0
20392,3,3,71310,71312,71315,2,5,0
20393,2,3,71312,71315,71318,3,6,0
20394,5,1,71317,71318,71319,1,2,0
20395,4,2,71321,71321,71323,0,2,2
20396,5,1,71326,71326,71327,0,1,3
20397,2,1,71328,71328,71329,0,1,1
20398,6,1,71334,71334,71335,0,1,5
20399,2,2,71336,71336,71338,0,2,1
20400,5,2,71341,71341,71343,0,2,3
20401,1,2,71342,71343,71345,1,3,0
20402,6,1,71348,71348,71349,0,1,3
20403,5,3,71353,71353,71356,0,3,4
20404,5,1,71358,71358,71359,0,1,2
20405,2,2,71360,71360,71362,0,2,1
20406,4,2,71364,71364,71366,0,2,2
20407,3,2,71367,71367,71369,0,2,1
20408,5,1,71372,71372,71373,0,1,3
20409,4,1,71376,71376,71377,0,1,3
20410,5,2,71381,71381,71383,0,2,4
20411,6,2,71387,71387,71389,0,2,4
20412,4,3,71391,71391,71394,0,3,2
20413,5,3,71396,71396,71399,0,3,2
20414,4,1,71400,71400,71401,0,1,1
20415,1,2,71401,71401,71403,0,2,0
20416,5,3,71406,71406,71409,0,3,3
20417,5,1,71411,71411,71412,0,1,2
20418,4,1,71415,71415,71416,0,1,3
20419,1,3,71416,71416,71419,0,3,0
20420,4,2,71420,71420,71422,0,2,1
20421,3,2,71423,71423,71425,0,2,1
20422,2,2,71425,71425,71427,0,2,0
20423,2,1,71427,71427,71428,0,1,0
20424,5,2,71432,71432,71434,0,2,4
20425,1,1,71433,71434,71435,1,2,0
20426,2,3,71435,71435,71438,0,3,0
20427,2,3,71437,71438,71441,1,4,0
20428,3,3,71440,71441,71444,1,4,0
20429,6,1,71446,71446,71447,0,1,2
20430,1,2,71447,71447,71449,0,2,0
20431,5,2,71452,71452,71454,0,2,3
20432,1,2,71453,71454,71456,1,3,0
20433,3,3,71456,71456,71459,0,3,0
20434,6,1,71462,71462,71463,0,1,3
20435,3,2,71465,71465,71467,0,2,2
20436,4,2,71469,71469,71471,0,2,2
20437,1,1,71470,71471,71472,1,2,0
20438,5,2,71475,71475,71477,0,2,3
20439,3,2,71478,71478,71480,0,2,1
20440,4,1,71482,71482,71483,0,1,2
20441,2,1,71484,71484,71485,0,1,1
20442,2,2,71486,71486,71488,0,2,1
20443,3,1,71489,71489,71490,0,1,1
20444,4,2,71493,71493,71495,0,2,3
20445,5,1,71498,71498,71499,0,1,3
20446,2,3,71500,71500,71503,0,3,1
20447,1,3,71501,71503,71506,2,5,0
20448,2,2,71503,71506,71508,3,5,0
20449,5,2,71508,71508,71510,0,2,0
20450,4,3,71512,71512,71515,0,3,2
20451,5,1,71517,71517,71518,0,1,2
20452,3,1,71520,71520,71521,0,1,2
20453,2,2,71522,71522,71524,0,2,1
20454,1,1,71523,71524,71525,1,2,0
20455,5,3,71528,71528,71531,0,3,3
20456,4,2,71532,71532,71534,0,2,1
20457,5,3,71537,71537,71540,0,3,3
20458,6,3,71543,71543,71546,0,3,3
20459,1,3,71544,71546,71549,2,5,0
20460,3,2,71547,71549,71551,2,4,0
20461,2,1,71549,71551,71552,2,3,0
20462,4,2,71553,71553,71555,0,2,1
20463,6,2,71559,71559,71561,0,2,4
20464,5,2,71564,71564,71566,0,2,3
20465,3,3,71567,71567,71570,0,3,1
20466,3,3,71570,71570,71573,0,3,0
20467,3,1,71573,71573,71574,0,1,0
20468,2,1,71575,71575,71576,0,1,1
20469,3,2,71578,71578,71580,0,2,2
20470,5,2,71583,71583,71585,0,2,3
20471,3,1,71586,71586,71587,0,1,1
20472,4,2,71590,71590,71592,0,2,3
20473,6,2,71596,71596,71598,0,2,4
20474,4,2,71600,71600,71602,0,2,2
20475,6,1,71606,71606,71607,0,1,4
20476,4,3,71610,71610,71613,0,3,3
20477,2,2,71612,71613,71615,1,3,0
20478,1,3,71613,71615,71618,2,5,0
20479,2,2,71615,71618,71620,3,5,0
20480,4,1,71619,71620,71621,1,2,0
20481,3,3,71622,71622,71625,0,3,1
20482,5,2,71627,71627,71629,0,2,2
20483,3,1,71630,71630,71631,0,1,1
20484,2,3,71632,71632,71635,0,3,1
20485,5,1,71637,71637,71638,0,1,2
20486,6,3,71643,71643,71646,0,3,5
20487,4,3,71647,71647,71650,0,3,1
20488,3,1,71650,71650,71651,0,1,0
20489,3,2,71653,71653,71655,0,2,2
20490,1,1,71654,71655,71656,1,2,0
20491,6,1,71660,71660,71661,0,1,4
20492,3,3,71663,71663,71666,0,3,2
20493,1,1,71664,71666,71667,2,3,0
20494,1,2,71665,71667,71669,2,4,0
20495,4,1,71669,71669,71670,0,1,0
20496,4,1,71673,71673,71674,0,1,3
20497,6,2,71679,71679,71681,0,2,5
20498,5,3,71684,71684,71687,0,3,3
20499,1,2,71685,71687,71689,2,4,0
20500,5,1,71690,71690,71691,0,1,1
20501,4,1,71694,71694,71695,0,1,3
20502,2,2,71696,71696,71698,0,2,1
20503,6,3,71702,71702,71705,0,3,4
20504,4,2,71706,71706,71708,0,2,1
20505,4,1,71710,71710,71711,0,1,2
20506,2,1,71712,71712,71713,0,1,1
20507,6,3,71718,71718,71721,0,3,5
20508,2,1,71720,71721,71722,1,2,0
20509,2,3,71722,71722,71725,0,3,0
20510,6,2,71728,71728,71730,0,2,3
20511,2,2,71730,71730,71732,0,2,0
20512,4,2,71734,71734,71736,0,2,2
20513,1,3,71735,71736,71739,1,4,0
20514,1,2,71736,71739,71741,3,5,0
20515,3,3,71739,71741,71744,2,5,0
20516,1,2,71740,71744,71746,4,6,0
20517,3,3,71743,71746,71749,3,6,0
20518,4,1,71747,71749,71750,2,3,0
20519,4,1,71751,71751,71752,0,1,1
20520,2,2,71753,71753,71755,0,2,1
20521,2,2,71755,71755,71757,0,2,0
20522,3,1,71758,71758,71759,0,1,1
20523,5,3,71763,71763,71766,0,3,4
20524,1,1,71764,71766,71767,2,3,0
20525,4,2,71768,71768,71770,0,2,1
20526,2,2,71770,71770,71772,0,2,0
20527,1,3,71771,71772,71775,1,4,0
20528,6,1,71777,71777,71778,0,1,2
20529,2,1,71779,71779,71780,0,1,1
20530,3,2,71782,71782,71784,0,2,2
20531,2,1,71784,71784,71785,0,1,0
20532,1,3,71785,71785,71788,0,3,0
20533,6,3,71791,71791,71794,0,3,3
20534,2,2,71793,71794,71796,1,3,0
20535,5,2,71798,71798,71800,0,2,2
20536,3,1,71801,71801,71802,0,1,1
20537,5,2,71806,71806,71808,0,2,4
20538,2,2,71808,71808,71810,0,2,0
20539,1,3,71809,71810,71813,1,4,0
20540,5,3,71814,71814,71817,0,3,1
20541,5,2,71819,71819,71821,0,2,2
20542,1,2,71820,71821,71823,1,3,0
20543,4,1,71824,71824,71825,0,1,1
20544,3,1,71827,71827,71828,0,1,2
20545,2,1,71829,71829,71830,0,1,1
20546,3,3,71832,71832,71835,0,3,2
20547,1,2,71833,71835,71837,2,4,0
20548,3,2,71836,71837,71839,1,3,0
20549,5,2,71841,71841,71843,0,2,2
20550,4,1,71845,71845,71846,0,1,2
20551,1,3,71846,71846,71849,0,3,0
20552,3,3,71849,71849,71852,0,3,0
20553,1,3,71850,71852,71855,2,5,0
20554,3,3,71853,71855,71858,2,5,0
20555,1,2,71854,71858,71860,4,6,0
20556,5,2,71859,71860,71862,1,3,0
20557,6,1,71865,71865,71866,0,1,3
20558,4,1,71869,71869,71870,0,1,3
20559,6,1,71875,71875,71876,0,1,5
20560,1,3,71876,71876,71879,0,3,0
20561,3,3,71879,71879,71882,0,3,0
20562,1,1,71880,71882,71883,2,3,0
20563,3,3,71883,71883,71886,0,3,0
20564,2,1,71885,71886,71887,1,2,0
20565,6,1,71891,71891,71892,0,1,4
20566,6,3,71897,71897,71900,0,3,5
20567,3,1,71900,71900,71901,0,1,0
20568,5,1,71905,71905,71906,0,1,4
20569,3,1,71908,71908,71909,0,1,2
20570,5,1,71913,71913,71914,0,1,4
20571,6,1,71919,71919,71920,0,1,5
20572,6,1,71925,71925,71926,0,1,5
20573,1,1,71926,71926,71927,0,1,0
20574,2,2,71928,71928,71930,0,2,1
20575,6,3,71934,71934,71937,0,3,4
20576,6,1,71940,71940,71941,0,1,3
20577,5,2,71945,71945,71947,0,2,4
20578,6,1,71951,71951,71952,0,1,4
20579,6,3,71957,71957,71960,0,3,5
20580,1,3,71958,71960,71963,2,5,0
20581,4,3,71962,71963,71966,1,4,0
20582,5,1,71967,71967,71968,0,1,1
20583,2,3,71969,71969,71972,0,3,1
20584,1,3,71970,71972,71975,2,5,0
20585,4,1,71974,71975,71976,1,2,0
20586,5,3,71979,71979,71982,0,3,3
20587,2,1,71981,71982,71983,1,2,0
20588,2,2,71983,71983,71985,0,2,0
20589,3,2,71986,71986,71988,0,2,1
20590,5,3,71991,71991,71994,0,3,3
20591,5,2,71996,71996,71998,0,2,2
20592,4,1,72000,72000,72001,0,1,2
20593,4,1,72004,72004,72005,0,1,3
20594,3,3,72007,72007,72010,0,3,2
20595,1,3,72008,72010,72013,2,5,0
20596,2,1,72010,72013,72014,3,4,0
20597,2,2,72012,72014,72016,2,4,0
20598,6,3,72018,72018,72021,0,3,2
20599,4,2,72022,72022,72024,0,2,1
20600,3,1,72025,72025,72026,0,1,1
20601,6,2,72031,72031,72033,0,2,5
20602,5,1,72036,72036,72037,0,1,3
20603,2,1,72038,72038,72039,0,1,1
20604,3,3,72041,72041,72044,0,3,2
20605,1,1,72042,72044,72045,2,3,0
20606,2,1,72044,72045,72046,1,2,0
20607,5,1,72049,72049,72050,0,1,3
20608,5,1,72054,72054,72055,0,1,4
20609,1,2,72055,72055,72057,0,2,0
20610,2,3,72057,72057,72060,0,3,0
20611,3,3,72060,72060,72063,0,3,0
20612,6,2,72066,72066,72068,0,2,3
20613,3,3,72069,72069,72072,0,3,1
20614,4,3,72073,72073,72076,0,3,1
20615,6,3,72079,72079,72082,0,3,3
20616,6,3,72085,72085,72088,0,3,3
20617,2,1,72087,72088,72089,1,2,0
20618,6,2,72093,72093,72095,0,2,4
20619,2,1,72095,72095,72096,0,1,0
20620,2,3,72097,72097,72100,0,3,1
20621,2,1,72099,72100,72101,1,2,0
20622,4,3,72103,72103,72106,0,3,2
20623,6,1,72109,72109,72110,0,1,3
20624,3,3,72112,72112,72115,0,3,2
20625,1,3,72113,72115,72118,2,5,0
20626,4,3,72117,72118,72121,1,4,0
20627,6,1,72123,72123,72124,0,1,2
20628,4,2,72127,72127,72129,0,2,3
20629,3,3,72130,72130,72133,0,3,1
20630,6,2,72136,72136,72138,0,2,3
20631,6,2,72142,72142,72144,0,2,4
20632,3,3,72145,72145,72148,0,3,1
20633,6,3,72151,72151,72154,0,3,3
20634,1,2,72152,72154,72156,2,4,0
20635,4,2,72156,72156,72158,0,2,0
20636,2,2,72158,72158,72160,0,2,0
20637,5,3,72163,72163,72166,0,3,3
20638,4,3,72167,72167,72170,0,3,1
20639,1,3,72168,72170,72173,2,5,0
20640,6,1,72174,72174,72175,0,1,1
20641,1,3,72175,72175,72178,0,3,0
20642,5,2,72180,72180,72182,0,2,2
20643,2,3,72182,72182,72185,0,3,0
20644,6,3,72188,72188,72191,0,3,3
20645,6,1,72194,72194,72195,0,1,3
20646,5,2,72199,72199,72201,0,2,4
20647,6,2,72205,72205,72207,0,2,4
20648,6,3,72211,72211,72214,0,3,4
20649,1,2,72212,72214,72216,2,4,0
20650,3,2,72215,72216,72218,1,3,0
20651,5,3,72220,72220,72223,0,3,2
20652,2,1,72222,72223,72224,1,2,0
20653,4,1,72226,72226,72227,0,1,2
20654,4,2,72230,72230,72232,0,2,3
20655,4,2,72234,72234,72236,0,2,2
20656,6,2,72240,72240,72242,0,2,4
20657,6,1,72246,72246,72247,0,1,4
20658,1,1,72247,72247,72248,0,1,0
20659,4,3,72251,72251,72254,0,3,3
20660,2,2,72253,72254,72256,1,3,0
20661,2,1,72255,72256,72257,1,2,0
20662,3,3,72258,72258,72261,0,3,1
20663,4,3,72262,72262,72265,0,3,1
20664,6,3,72268,72268,72271,0,3,3
20665,4,1,72272,72272,72273,0,1,1
20666,1,3,72273,72273,72276,0,3,0
20667,5,3,72278,72278,72281,0,3,2
20668,4,3,72282,72282,72285,0,3,1
20669,5,3,72287,72287,72290,0,3,2
20670,4,1,72291,72291,72292,0,1,1
20671,6,3,72297,72297,72300,0,3,5
20672,4,1,72301,72301,72302,0,1,1
20673,4,3,72305,72305,72308,0,3,3
20674,6,1,72311,72311,72312,0,1,3
20675,5,2,72316,72316,72318,0,2,4
20676,6,2,72322,72322,72324,0,2,4
20677,6,3,72328,72328,72331,0,3,4
20678,4,3,72332,72332,72335,0,3,1
20679,5,1,72337,72337,72338,0,1,2
20680,2,1,72339,72339,72340,0,1,1
20681,3,2,72342,72342,72344,0,2,2
20682,3,3,72345,72345,72348,0,3,1
20683,3,1,72348,72348,72349,0,1,0
20684,6,2,72354,72354,72356,0,2,5
20685,1,1,72355,72356,72357,1,2,0
20686,5,2,72360,72360,72362,0,2,3
20687,5,2,72365,72365,72367,0,2,3
20688,4,2,72369,72369,72371,0,2,2
20689,4,2,72373,72373,72375,0,2,2
20690,2,3,72375,72375,72378,0,3,0
20691,2,3,72377,72378,72381,1,4,0
20692,4,2,72381,72381,72383,0,2,0
20693,2,3,72383,72383,72386,0,3,0
20694,5,2,72388,72388,72390,0,2,2
20695,3,3,72391,72391,72394,0,3,1
20696,2,1,72393,72394,72395,1,2,0
20697,6,3,72399,72399,72402,0,3,4
20698,5,2,72404,72404,72406,0,2,2
20699,6,2,72410,72410,72412,0,2,4
20700,3,3,72413,72413,72416,0,3,1
20701,6,2,72419,72419,72421,0,2,3
20702,6,2,72425,72425,72427,0,2,4
20703,5,3,72430,72430,72433,0,3,3
20704,5,2,72435,72435,72437,0,2,2
20705,6,3,72441,72441,72444,0,3,4
20706,6,2,72447,72447,72449,0,2,3
20707,4,1,72451,72451,72452,0,1,2
20708,5,2,72456,72456,72458,0,2,4
20709,6,3,72462,72462,72465,0,3,4
20710,6,1,72468,72468,72469,0,1,3
20711,2,3,72470,72470,72473,0,3,1
20712,1,1,72471,72473,72474,2,3,0
20713,4,3,72475,72475,72478,0,3,1
20714,5,1,72480,72480,72481,0,1,2
20715,4,2,72484,72484,72486,0,2,3
20716,6,3,72490,72490,72493,0,3,4
20717,3,2,72493,72493,72495,0,2,0
20718,4,3,72497,72497,72500,0,3,2
20719,5,3,72502,72502,72505,0,3,2
20720,4,1,72506,72506,72507,0,1,1
20721,6,3,72512,72512,72515,0,3,5
20722,3,3,72515,72515,72518,0,3,0
20723,4,3,72519,72519,72522,0,3,1
20724,3,3,72522,72522,72525,0,3,0
20725,4,2,72526,72526,72528,0,2,1
20726,6,1,72532,72532,72533,0,1,4
20727,1,3,72533,72533,72536,0,3,0
20728,6,3,72539,72539,72542,0,3,3
20729,1,2,72540,72542,72544,2,4,0
20730,6,3,72546,72546,72549,0,3,2
20731,3,3,72549,72549,72552,0,3,0
20732,2,3,72551,72552,72555,1,4,0
20733,3,3,72554,72555,72558,1,4,0
20734,1,3,72555,72558,72561,3,6,0
20735,6,2,72561,72561,72563,0,2,0
20736,4,1,72565,72565,72566,0,1,2
20737,6,2,72571,72571,72573,0,2,5
20738,6,2,72577,72577,72579,0,2,4
20739,5,3,72582,72582,72585,0,3,3
20740,5,3,72587,72587,72590,0,3,2
20741,1,2,72588,72590,72592,2,4,0
20742,5,2,72593,72593,72595,0,2,1
20743,3,3,72596,72596,72599,0,3,1
20744,3,2,72599,72599,72601,0,2,0
20745,5,1,72604,72604,72605,0,1,3
20746,6,2,72610,72610,72612,0,2,5
20747,2,2,72612,72612,72614,0,2,0
20748,6,2,72618,72618,72620,0,2,4
20749,3,1,72621,72621,72622,0,1,1
20750,3,2,72624,72624,72626,0,2,2
20751,6,3,72630,72630,72633,0,3,4
20752,5,1,72635,72635,72636,0,1,2
20753,2,1,72637,72637,72638,0,1,1
20754,6,3,72643,72643,72646,0,3,5
20755,1,1,72644,72646,72647,2,3,0
20756,4,1,72648,72648,72649,0,1,1
20757,3,1,72651,72651,72652,0,1,2
20758,1,1,72652,72652,72653,0,1,0
20759,1,1,72653,72653,72654,0,1,0
20760,2,3,72655,72655,72658,0,3,1
20761,4,2,72659,72659,72661,0,2,1
20762,6,3,72665,72665,72668,0,3,4
20763,4,2,72669,72669,72671,0,2,1
20764,6,1,72675,72675,72676,0,1,4
20765,6,3,72681,72681,72684,0,3,5
20766,5,3,72686,72686,72689,0,3,2
20767,1,1,72687,72689,72690,2,3,0
20768,1,3,72688,72690,72693,2,5,0
20769,4,3,72692,72693,72696,1,4,0
20770,4,2,72696,72696,72698,0,2,0
20771,3,1,72699,72699,72700,0,1,1
20772,4,1,72703,72703,72704,0,1,3
20773,1,3,72704,72704,72707,0,3,0
20774,4,1,72708,72708,72709,0,1,1
20775,4,1,72712,72712,72713,0,1,3
20776,2,2,72714,72714,72716,0,2,1
20777,4,1,72718,72718,72719,0,1,2
20778,2,3,72720,72720,72723,0,3,1
20779,4,3,72724,72724,72727,0,3,1
20780,4,3,72728,72728,72731,0,3,1
20781,1,3,72729,72731,72734,2,5,0
20782,6,3,72735,72735,72738,0,3,1
20783,5,2,72740,72740,72742,0,2,2
20784,5,1,72745,72745,72746,0,1,3
20785,1,3,72746,72746,72749,0,3,0
20786,5,3,72751,72751,72754,0,3,2
20787,3,1,72754,72754,72755,0,1,0
20788,5,1,72759,72759,72760,0,1,4
20789,2,1,72761,72761,72762,0,1,1
20790,6,3,72767,72767,72770,0,3,5
20791,4,1,72771,72771,72772,0,1,1
20792,2,2,72773,72773,72775,0,2,1
20793,4,3,72777,72777,72780,0,3,2
20794,6,3,72783,72783,72786,0,3,3
20795,4,2,72787,72787,72789,0,2,1
20796,1,2,72788,72789,72791,1,3,0
20797,5,2,72793,72793,72795,0,2,2
20798,6,2,72799,72799,72801,0,2,4
20799,3,3,72802,72802,72805,0,3,1
20800,2,2,72804,72805,72807,1,3,0
20801,2,1,72806,72807,72808,1,2,0
20802,6,2,72812,72812,72814,0,2,4
20803,3,2,72815,72815,72817,0,2,1
20804,4,3,72819,72819,72822,0,3,2
20805,3,2,72822,72822,72824,0,2,0
20806,3,2,72825,72825,72827,0,2,1
20807,6,1,72831,72831,72832,0,1,4
20808,1,2,72832,72832,72834,0,2,0
20809,5,2,72837,72837,72839,0,2,3
20810,2,1,72839,72839,72840,0,1,0
20811,4,1,72843,72843,72844,0,1,3
20812,2,3,72845,72845,72848,0,3,1
20813,2,1,72847,72848,72849,1,2,0
20814,4,3,72851,72851,72854,0,3,2
20815,1,2,72852,72854,72856,2,4,0
20816,6,2,72858,72858,72860,0,2,2
20817,4,2,72862,72862,72864,0,2,2
20818,5,3,72867,72867,72870,0,3,3
20819,2,3,72869,72870,72873,1,4,0
20820,3,2,72872,72873,72875,1,3,0
20821,5,2,72877,72877,72879,0,2,2
20822,4,2,72881,72881,72883,0,2,2
20823,1,2,72882,72883,72885,1,3,0
20824,5,1,72887,72887,72888,0,1,2
20825,4,1,72891,72891,72892,0,1,3
20826,3,1,72894,72894,72895,0,1,2
20827,1,1,72895,72895,72896,0,1,0
20828,1,2,72896,72896,72898,0,2,0
20829,5,2,72901,72901,72903,0,2,3
20830,2,3,72903,72903,72906,0,3,0
20831,2,3,72905,72906,72909,1,4,0
20832,3,2,72908,72909,72911,1,3,0
20833,4,1,72912,72912,72913,0,1,1
20834,5,3,72917,72917,72920,0,3,4
20835,5,3,72922,72922,72925,0,3,2
20836,5,1,72927,72927,72928,0,1,2
20837,4,2,72931,72931,72933,0,2,3
20838,1,1,72932,72933,72934,1,2,0
20839,4,1,72936,72936,72937,0,1,2
20840,1,1,72937,72937,72938,0,1,0
20841,6,1,72943,72943,72944,0,1,5
20842,1,3,72944,72944,72947,0,3,0
20843,5,3,72949,72949,72952,0,3,2
20844,6,1,72955,72955,72956,0,1,3
20845,3,2,72958,72958,72960,0,2,2
20846,5,1,72963,72963,72964,0,1,3
20847,5,1,72968,72968,72969,0,1,4
20848,1,3,72969,72969,72972,0,3,0
20849,2,3,72971,72972,72975,1,4,0
20850,3,1,72974,72975,72976,1,2,0
20851,6,1,72980,72980,72981,0,1,4
20852,5,3,72985,72985,72988,0,3,4
20853,6,1,72991,72991,72992,0,1,3
20854,1,3,72992,72992,72995,0,3,0
20855,6,2,72998,72998,73000,0,2,3
20856,2,3,73000,73000,73003,0,3,0
20857,3,3,73003,73003,73006,0,3,0
20858,3,3,73006,73006,73009,0,3,0
20859,6,3,73012,73012,73015,0,3,3
20860,6,3,73018,73018,73021,0,3,3
20861,1,3,73019,73021,73024,2,5,0
20862,3,2,73022,73024,73026,2,4,0
20863,2,1,73024,73026,73027,2,3,0
20864,5,2,73029,73029,73031,0,2,2
20865,6,1,73035,73035,73036,0,1,4
20866,2,2,73037,73037,73039,0,2,1
20867,2,1,73039,73039,73040,0,1,0
20868,4,2,73043,73043,73045,0,2,3
20869,3,2,73046,73046,73048,0,2,1
20870,4,1,73050,73050,73051,0,1,2
20871,1,3,73051,73051,73054,0,3,0
20872,3,1,73054,73054,73055,0,1,0
20873,6,3,73060,73060,73063,0,3,5
20874,4,2,73064,73064,73066,0,2,1
20875,3,2,73067,73067,73069,0,2,1
20876,5,2,73072,73072,73074,0,2,3
20877,6,2,73078,73078,73080,0,2,4
20878,1,3,73079,73080,73083,1,4,0
20879,3,3,73082,73083,73086,1,4,0
20880,6,1,73088,73088,73089,0,1,2
20881,5,3,73093,73093,73096,0,3,4
20882,6,1,73099,73099,73100,0,1,3
20883,4,3,73103,73103,73106,0,3,3
20884,2,3,73105,73106,73109,1,4,0
20885,3,2,73108,73109,73111,1,3,0
20886,1,1,73109,73111,73112,2,3,0
20887,5,2,73114,73114,73116,0,2,2
20888,1,3,73115,73116,73119,1,4,0
20889,3,2,73118,73119,73121,1,3,0
20890,4,2,73122,73122,73124,0,2,1
20891,5,3,73127,73127,73130,0,3,3
20892,2,2,73129,73130,73132,1,3,0
20893,1,2,73130,73132,73134,2,4,0
20894,2,2,73132,73134,73136,2,4,0
20895,5,3,73137,73137,73140,0,3,1
20896,1,1,73138,73140,73141,2,3,0
20897,1,3,73139,73141,73144,2,5,0
20898,4,2,73143,73144,73146,1,3,0
20899,1,2,73144,73146,73148,2,4,0
20900,3,3,73147,73148,73151,1,4,0
20901,2,3,73149,73151,73154,2,5,0
20902,2,3,73151,73154,73157,3,6,0
20903,2,3,73153,73157,73160,4,7,0
20904,1,2,73154,73160,73162,6,8,0
20905,3,2,73157,73162,73164,5,7,0
20906,1,2,73158,73164,73166,6,8,0
20907,6,2,73164,73166,73168,2,4,0
20908,6,1,73170,73170,73171,0,1,2
20909,1,2,73171,73171,73173,0,2,0
20910,3,2,73174,73174,73176,0,2,1
20911,1,1,73175,73176,73177,1,2,0
20912,6,3,73181,73181,73184,0,3,4
20913,6,2,73187,73187,73189,0,2,3
20914,4,1,73191,73191,73192,0,1,2
20915,6,3,73197,73197,73200,0,3,5
20916,2,3,73199,73200,73203,1,4,0
20917,1,1,73200,73203,73204,3,4,0
20918,1,1,73201,73204,73205,3,4,0
20919,5,2,73206,73206,73208,0,2,1
20920,4,3,73210,73210,73213,0,3,2
20921,6,2,73216,73216,73218,0,2,3
20922,5,1,73221,73221,73222,0,1,3
20923,2,2,73223,73223,73225,0,2,1
20924,3,2,73226,73226,73228,0,2,1
20925,3,2,73229,73229,73231,0,2,1
20926,4,2,73233,73233,73235,0,2,2
20927,6,2,73239,73239,73241,0,2,4
20928,4,1,73243,73243,73244,0,1,2
20929,5,1,73248,73248,73249,0,1,4
20930,1,3,73249,73249,73252,0,3,0
20931,6,3,73255,73255,73258,0,3,3
20932,4,2,73259,73259,73261,0,2,1
20933,4,2,73263,73263,73265,0,2,2
20934,5,3,73268,73268,73271,0,3,3
20935,3,2,73271,73271,73273,0,2,0
20936,3,1,73274,73274,73275,0,1,1
20937,3,2,73277,73277,73279,0,2,2
20938,5,3,73282,73282,73285,0,3,3
20939,2,3,73284,73285,73288,1,4,0
20940,2,1,73286,73288,73289,2,3,0
20941,4,1,73290,73290,73291,0,1,1
20942,3,2,73293,73293,73295,0,2,2
20943,1,1,73294,73295,73296,1,2,0
20944,1,3,73295,73296,73299,1,4,0
20945,6,2,73301,73301,73303,0,2,2
20946,2,2,73303,73303,73305,0,2,0
20947,1,1,73304,73305,73306,1,2,0
20948,4,3,73308,73308,73311,0,3,2
20949,1,2,73309,73311,73313,2,4,0
20950,2,3,73311,73313,73316,2,5,0
20951,2,3,73313,73316,73319,3,6,0
20952,3,2,73316,73319,73321,3,5,0
20953,4,2,73320,73321,73323,1,3,0
20954,5,3,73325,73325,73328,0,3,2
20955,4,3,73329,73329,73332,0,3,1
20956,4,3,73333,73333,73336,0,3,1
20957,4,1,73337,73337,73338,0,1,1
20958,2,1,73339,73339,73340,0,1,1
20959,2,1,73341,73341,73342,0,1,1
20960,4,3,73345,73345,73348,0,3,3
20961,6,1,73351,73351,73352,0,1,3
20962,3,2,73354,73354,73356,0,2,2
20963,3,3,73357,73357,73360,0,3,1
20964,2,1,73359,73360,73361,1,2,0
20965,6,3,73365,73365,73368,0,3,4
20966,5,3,73370,73370,73373,0,3,2
20967,5,2,73375,73375,73377,0,2,2
20968,6,1,73381,73381,73382,0,1,4
20969,1,2,73382,73382,73384,0,2,0
20970,3,3,73385,73385,73388,0,3,1
20971,5,1,73390,73390,73391,0,1,2
20972,1,2,73391,73391,73393,0,2,0
20973,6,3,73397,73397,73400,0,3,4
20974,6,2,73403,73403,73405,0,2,3
20975,1,2,73404,73405,73407,1,3,0
20976,5,2,73409,73409,73411,0,2,2
20977,3,3,73412,73412,73415,0,3,1
20978,6,2,73418,73418,73420,0,2,3
20979,4,2,73422,73422,73424,0,2,2
20980,2,3,73424,73424,73427,0,3,0
20981,3,2,73427,73427,73429,0,2,0
20982,6,2,73433,73433,73435,0,2,4
20983,3,2,73436,73436,73438,0,2,1
20984,2,3,73438,73438,73441,0,3,0
20985,3,1,73441,73441,73442,0,1,0
20986,1,2,73442,73442,73444,0,2,0
20987,1,3,73443,73444,73447,1,4,0
20988,4,1,73447,73447,73448,0,1,0
20989,4,3,73451,73451,73454,0,3,3
20990,2,3,73453,73454,73457,1,4,0
20991,2,3,73455,73457,73460,2,5,0
20992,2,2,73457,73460,73462,3,5,0
20993,6,1,73463,73463,73464,0,1,1
20994,2,3,73465,73465,73468,0,3,1
20995,5,2,73470,73470,73472,0,2,2
20996,6,2,73476,73476,73478,0,2,4
20997,2,1,73478,73478,73479,0,1,0
20998,5,1,73483,73483,73484,0,1,4
20999,6,1,73489,73489,73490,0,1,5
21000,4,2,73493,73493,73495,0,2,3
21001,1,2,73494,73495,73497,1,3,0
21002,3,3,73497,73497,73500,0,3,0
21003,5,2,73502,73502,73504,0,2,2
21004,3,2,73505,73505,73507,0,2,1
21005,5,2,73510,73510,73512,0,2,3
21006,2,3,73512,73512,73515,0,3,0
21007,5,3,73517,73517,73520,0,3,2
21008,4,3,73521,73521,73524,0,3,1
21009,1,2,73522,73524,73526,2,4,0
21010,2,3,73524,73526,73529,2,5,0
21011,3,3,73527,73529,73532,2,5,0
21012,3,2,73530,73532,73534,2,4,0
21013,6,3,73536,73536,73539,0,3,2
21014,3,1,73539,73539,73540,0,1,0
21015,2,2,73541,73541,73543,0,2,1
21016,5,3,73546,73546,73549,0,3,3
21017,1,2,73547,73549,73551,2,4,0
21018,5,3,73552,73552,73555,0,3,1
21019,3,3,73555,73555,73558,0,3,0
21020,6,3,73561,73561,73564,0,3,3
21021,3,1,73564,73564,73565,0,1,0
21022,3,3,73567,73567,73570,0,3,2
21023,5,2,73572,73572,73574,0,2,2
21024,6,2,73578,73578,73580,0,2,4
21025,2,1,73580,73580,73581,0,1,0
21026,6,2,73586,73586,73588,0,2,5
21027,3,2,73589,73589,73591,0,2,1
21028,5,2,73594,73594,73596,0,2,3
21029,6,1,73600,73600,73601,0,1,4
21030,4,2,73604,73604,73606,0,2,3
21031,1,3,73605,73606,73609,1,4,0
21032,4,2,73609,73609,73611,0,2,0
21033,6,3,73615,73615,73618,0,3,4
21034,3,1,73618,73618,73619,0,1,0
21035,5,2,73623,73623,73625,0,2,4
21036,6,2,73629,73629,73631,0,2,4
21037,4,2,73633,73633,73635,0,2,2
21038,4,3,73637,73637,73640,0,3,2
21039,4,3,73641,73641,73644,0,3,1
21040,2,1,73643,73644,73645,1,2,0
21041,5,3,73648,73648,73651,0,3,3
21042,5,3,73653,73653,73656,0,3,2
21043,3,2,73656,73656,73658,0,2,0
21044,1,1,73657,73658,73659,1,2,0
21045,2,1,73659,73659,73660,0,1,0
21046,2,3,73661,73661,73664,0,3,1
21047,6,1,73667,73667,73668,0,1,3
21048,3,1,73670,73670,73671,0,1,2
21049,1,2,73671,73671,73673,0,2,0
21050,6,2,73677,73677,73679,0,2,4
21051,6,1,73683,73683,73684,0,1,4
21052,2,3,73685,73685,73688,0,3,1
21053,5,3,73690,73690,73693,0,3,2
21054,3,3,73693,73693,73696,0,3,0
21055,2,2,73695,73696,73698,1,3,0
21056,5,1,73700,73700,73701,0,1,2
21057,2,1,73702,73702,73703,0,1,1
21058,6,1,73708,73708,73709,0,1,5
21059,4,2,73712,73712,73714,0,2,3
21060,2,2,73714,73714,73716,0,2,0
21061,2,3,73716,73716,73719,0,3,0
21062,5,1,73721,73721,73722,0,1,2
21063,6,3,73727,73727,73730,0,3,5
21064,3,3,73730,73730,73733,0,3,0
21065,5,2,73735,73735,73737,0,2,2
21066,4,2,73739,73739,73741,0,2,2
21067,6,3,73745,73745,73748,0,3,4
21068,2,2,73747,73748,73750,1,3,0
21069,2,3,73749,73750,73753,1,4,0
21070,3,1,73752,73753,73754,1,2,0
21071,1,3,73753,73754,73757,1,4,0
21072,4,1,73757,73757,73758,0,1,0
21073,4,3,73761,73761,73764,0,3,3
21074,2,3,73763,73764,73767,1,4,0
21075,1,2,73764,73767,73769,3,5,0
21076,6,3,73770,73770,73773,0,3,1
21077,2,1,73772,73773,73774,1,2,0
21078,6,3,73778,73778,73781,0,3,4
21079,6,2,73784,73784,73786,0,2,3
21080,2,2,73786,73786,73788,0,2,0
21081,3,3,73789,73789,73792,0,3,1
21082,4,1,73793,73793,73794,0,1,1
21083,4,3,73797,73797,73800,0,3,3
21084,2,1,73799,73800,73801,1,2,0
21085,4,2,73803,73803,73805,0,2,2
21086,6,1,73809,73809,73810,0,1,4
21087,4,3,73813,73813,73816,0,3,3
21088,1,2,73814,73816,73818,2,4,0
21089,4,2,73818,73818,73820,0,2,0
21090,3,3,73821,73821,73824,0,3,1
21091,3,1,73824,73824,73825,0,1,0
21092,5,2,73829,73829,73831,0,2,4
21093,3,2,73832,73832,73834,0,2,1
21094,5,3,73837,73837,73840,0,3,3
21095,5,1,73842,73842,73843,0,1,2
21096,6,1,73848,73848,73849,0,1,5
21097,3,1,73851,73851,73852,0,1,2
21098,5,3,73856,73856,73859,0,3,4
21099,5,2,73861,73861,73863,0,2,2
21100,5,2,73866,73866,73868,0,2,3
21101,2,2,73868,73868,73870,0,2,0
21102,4,1,73872,73872,73873,0,1,2
21103,2,1,73874,73874,73875,0,1,1
21104,1,3,73875,73875,73878,0,3,0
21105,6,1,73881,73881,73882,0,1,3
21106,2,2,73883,73883,73885,0,2,1
21107,4,1,73887,73887,73888,0,1,2
21108,1,2,73888,73888,73890,0,2,0
21109,3,3,73891,73891,73894,0,3,1
21110,3,3,73894,73894,73897,0,3,0
21111,3,3,73897,73897,73900,0,3,0
21112,6,3,73903,73903,73906,0,3,3
21113,3,3,73906,73906,73909,0,3,0
21114,1,2,73907,73909,73911,2,4,0
21115,2,2,73909,73911,73913,2,4,0
21116,6,3,73915,73915,73918,0,3,2
21117,2,3,73917,73918,73921,1,4,0
21118,5,1,73922,73922,73923,0,1,1
21119,1,1,73923,73923,73924,0,1,0
21120,4,3,73927,73927,73930,0,3,3
21121,1,3,73928,73930,73933,2,5,0
21122,1,1,73929,73933,73934,4,5,0
21123,3,2,73932,73934,73936,2,4,0
21124,1,2,73933,73936,73938,3,5,0
21125,3,3,73936,73938,73941,2,5,0
21126,2,2,73938,73941,73943,3,5,0
21127,2,1,73940,73943,73944,3,4,0
21128,4,2,73944,73944,73946,0,2,0
21129,5,1,73949,73949,73950,0,1,3
21130,5,3,73954,73954,73957,0,3,4
21131,1,2,73955,73957,73959,2,4,0
21132,2,3,73957,73959,73962,2,5,0
21133,4,2,73961,73962,73964,1,3,0
21134,4,1,73965,73965,73966,0,1,1
21135,5,2,73970,73970,73972,0,2,4
21136,5,3,73975,73975,73978,0,3,3
21137,6,2,73981,73981,73983,0,2,3
21138,5,1,73986,73986,73987,0,1,3
21139,1,1,73987,73987,73988,0,1,0
21140,3,3,73990,73990,73993,0,3,2
21141,2,2,73992,73993,73995,1,3,0
21142,2,3,73994,73995,73998,1,4,0
21143,1,1,73995,73998,73999,3,4,0
21144,4,1,73999,73999,74000,0,1,0
21145,4,3,74003,74003,74006,0,3,3
21146,2,2,74005,74006,74008,1,3,0
21147,1,3,74006,74008,74011,2,5,0
21148,5,3,74011,74011,74014,0,3,0
21149,3,3,74014,74014,74017,0,3,0
21150,1,2,74015,74017,74019,2,4,0
21151,6,2,74021,74021,74023,0,2,2
21152,4,1,74025,74025,74026,0,1,2
21153,6,2,74031,74031,74033,0,2,5
21154,4,3,74035,74035,74038,0,3,2
21155,6,1,74041,74041,74042,0,1,3
21156,1,1,74042,74042,74043,0,1,0
21157,1,1,74043,74043,74044,0,1,0
21158,6,3,74049,74049,74052,0,3,5
21159,5,2,74054,74054,74056,0,2,2
21160,5,1,74059,74059,74060,0,1,3
21161,1,2,74060,74060,74062,0,2,0
21162,5,2,74065,74065,74067,0,2,3
21163,6,1,74071,74071,74072,0,1,4
21164,4,1,74075,74075,74076,0,1,3
21165,6,1,74081,74081,74082,0,1,5
21166,5,2,74086,74086,74088,0,2,4
21167,5,1,74091,74091,74092,0,1,3
21168,1,2,74092,74092,74094,0,2,0
21169,2,2,74094,74094,74096,0,2,0
21170,6,1,74100,74100,74101,0,1,4
21171,4,1,74104,74104,74105,0,1,3
21172,4,2,74108,74108,74110,0,2,3
21173,6,1,74114,74114,74115,0,1,4
21174,2,1,74116,74116,74117,0,1,1
21175,5,3,74121,74121,74124,0,3,4
21176,4,2,74125,74125,74127,0,2,1
21177,4,1,74129,74129,74130,0,1,2
21178,6,3,74135,74135,74138,0,3,5
21179,3,2,74138,74138,74140,0,2,0
21180,1,1,74139,74140,74141,1,2,0
21181,6,1,74145,74145,74146,0,1,4
21182,2,1,74147,74147,74148,0,1,1
21183,5,2,74152,74152,74154,0,2,4
21184,6,2,74158,74158,74160,0,2,4
21185,5,1,74163,74163,74164,0,1,3
21186,6,1,74169,74169,74170,0,1,5
21187,3,2,74172,74172,74174,0,2,2
21188,5,2,74177,74177,74179,0,2,3
21189,4,3,74181,74181,74184,0,3,2
21190,2,3,74183,74184,74187,1,4,0
21191,2,3,74185,74187,74190,2,5,0
21192,1,2,74186,74190,74192,4,6,0
21193,2,2,74188,74192,74194,4,6,0
21194,5,2,74193,74194,74196,1,3,0
21195,3,1,74196,74196,74197,0,1,0
21196,4,2,74200,74200,74202,0,2,3
21197,1,3,74201,74202,74205,1,4,0
21198,6,1,74207,74207,74208,0,1,2
21199,2,2,74209,74209,74211,0,2,1
21200,6,1,74215,74215,74216,0,1,4
21201,1,1,74216,74216,74217,0,1,0
21202,3,1,74219,74219,74220,0,1,2
21203,2,2,74221,74221,74223,0,2,1
21204,2,2,74223,74223,74225,0,2,0
21205,4,1,74227,74227,74228,0,1,2
21206,3,2,74230,74230,74232,0,2,2
21207,4,1,74234,74234,74235,0,1,2
21208,1,3,74235,74235,74238,0,3,0
21209,1,2,74236,74238,74240,2,4,0
21210,1,3,74237,74240,74243,3,6,0
21211,6,3,74243,74243,74246,0,3,0
21212,4,3,74247,74247,74250,0,3,1
21213,3,1,74250,74250,74251,0,1,0
21214,3,3,74253,74253,74256,0,3,2
21215,2,3,74255,74256,74259,1,4,0
21216,1,2,74256,74259,74261,3,5,0
21217,2,2,74258,74261,74263,3,5,0
21218,4,3,74262,74263,74266,1,4,0
21219,5,3,74267,74267,74270,0,3,1
21220,2,1,74269,74270,74271,1,2,0
21221,4,3,74273,74273,74276,0,3,2
21222,1,3,74274,74276,74279,2,5,0
21223,3,1,74277,74279,74280,2,3,0
21224,4,1,74281,74281,74282,0,1,1
21225,5,2,74286,74286,74288,0,2,4
21226,4,2,74290,74290,74292,0,2,2
21227,5,2,74295,74295,74297,0,2,3
21228,1,2,74296,74297,74299,1,3,0
21229,6,1,74302,74302,74303,0,1,3
21230,6,2,74308,74308,74310,0,2,5
21231,5,1,74313,74313,74314,0,1,3
21232,4,1,74317,74317,74318,0,1,3
21233,4,2,74321,74321,74323,0,2,3
21234,3,1,74324,74324,74325,0,1,1
21235,4,3,74328,74328,74331,0,3,3
21236,6,3,74334,74334,74337,0,3,3
21237,1,2,74335,74337,74339,2,4,0
21238,6,3,74341,74341,74344,0,3,2
21239,4,3,74345,74345,74348,0,3,1
21240,6,1,74351,74351,74352,0,1,3
21241,6,3,74357,74357,74360,0,3,5
21242,2,1,74359,74360,74361,1,2,0
21243,4,2,74363,74363,74365,0,2,2
21244,4,3,74367,74367,74370,0,3,2
21245,5,2,74372,74372,74374,0,2,2
21246,3,3,74375,74375,74378,0,3,1
21247,6,2,74381,74381,74383,0,2,3
21248,1,2,74382,74383,74385,1,3,0
21249,6,2,74388,74388,74390,0,2,3
21250,6,3,74394,74394,74397,0,3,4
21251,1,3,74395,74397,74400,2,5,0
21252,2,2,74397,74400,74402,3,5,0
21253,2,1,74399,74402,74403,3,4,0
21254,6,1,74405,74405,74406,0,1,2
21255,6,3,74411,74411,74414,0,3,5
21256,5,2,74416,74416,74418,0,2,2
21257,2,2,74418,74418,74420,0,2,0
21258,3,2,74421,74421,74423,0,2,1
21259,5,2,74426,74426,74428,0,2,3
21260,4,3,74430,74430,74433,0,3,2
21261,2,1,74432,74433,74434,1,2,0
21262,1,2,74433,74434,74436,1,3,0
21263,4,2,74437,74437,74439,0,2,1
21264,2,1,74439,74439,74440,0,1,0
21265,5,3,74444,74444,74447,0,3,4
21266,4,2,74448,74448,74450,0,2,1
21267,1,1,74449,74450,74451,1,2,0
21268,4,1,74453,74453,74454,0,1,2
21269,6,3,74459,74459,74462,0,3,5
21270,3,2,74462,74462,74464,0,2,0
21271,6,3,74468,74468,74471,0,3,4
21272,1,2,74469,74471,74473,2,4,0
21273,1,1,74470,74473,74474,3,4,0
21274,3,3,74473,74474,74477,1,4,0
21275,4,2,74477,74477,74479,0,2,0
21276,1,1,74478,74479,74480,1,2,0
21277,5,3,74483,74483,74486,0,3,3
21278,1,1,74484,74486,74487,2,3,0
21279,1,1,74485,74487,74488,2,3,0
21280,4,2,74489,74489,74491,0,2,1
21281,2,1,74491,74491,74492,0,1,0
21282,1,1,74492,74492,74493,0,1,0
21283,1,3,74493,74493,74496,0,3,0
21284,3,2,74496,74496,74498,0,2,0
21285,3,2,74499,74499,74501,0,2,1
21286,6,2,74505,74505,74507,0,2,4
21287,1,2,74506,74507,74509,1,3,0
21288,2,1,74508,74509,74510,1,2,0
21289,2,1,74510,74510,74511,0,1,0
21290,3,1,74513,74513,74514,0,1,2
21291,4,1,74517,74517,74518,0,1,3
21292,4,3,74521,74521,74524,0,3,3
21293,3,1,74524,74524,74525,0,1,0
21294,6,3,74530,74530,74533,0,3,5
21295,1,2,74531,74533,74535,2,4,0
21296,4,3,74535,74535,74538,0,3,0
21297,3,3,74538,74538,74541,0,3,0
21298,6,1,74544,74544,74545,0,1,3
21299,6,2,74550,74550,74552,0,2,5
21300,6,1,74556,74556,74557,0,1,4
21301,1,1,74557,74557,74558,0,1,0
21302,6,2,74563,74563,74565,0,2,5
21303,1,3,74564,74565,74568,1,4,0
21304,4,2,74568,74568,74570,0,2,0
21305,5,3,74573,74573,74576,0,3,3
21306,6,3,74579,74579,74582,0,3,3
21307,3,3,74582,74582,74585,0,3,0
21308,2,2,74584,74585,74587,1,3,0
21309,5,1,74589,74589,74590,0,1,2
21310,3,3,74592,74592,74595,0,3,2
21311,3,2,74595,74595,74597,0,2,0
21312,6,1,74601,74601,74602,0,1,4
21313,5,1,74606,74606,74607,0,1,4
21314,4,3,74610,74610,74613,0,3,3
21315,2,1,74612,74613,74614,1,2,0
21316,1,3,74613,74614,74617,1,4,0
21317,4,2,74617,74617,74619,0,2,0
21318,2,1,74619,74619,74620,0,1,0
21319,2,2,74621,74621,74623,0,2,1
21320,3,2,74624,74624,74626,0,2,1
21321,5,3,74629,74629,74632,0,3,3
21322,6,3,74635,74635,74638,0,3,3
21323,6,2,74641,74641,74643,0,2,3
21324,3,1,74644,74644,74645,0,1,1
21325,4,1,74648,74648,74649,0,1,3
21326,3,3,74651,74651,74654,0,3,2
21327,3,2,74654,74654,74656,0,2,0
21328,5,1,74659,74659,74660,0,1,3
21329,6,3,74665,74665,74668,0,3,5
21330,3,3,74668,74668,74671,0,3,0
21331,5,1,74673,74673,74674,0,1,2
21332,1,1,74674,74674,74675,0,1,0
21333,4,3,74678,74678,74681,0,3,3
21334,2,1,74680,74681,74682,1,2,0
21335,5,1,74685,74685,74686,0,1,3
21336,4,3,74689,74689,74692,0,3,3
21337,4,1,74693,74693,74694,0,1,1
21338,3,3,74696,74696,74699,0,3,2
21339,1,3,74697,74699,74702,2,5,0
21340,2,3,74699,74702,74705,3,6,0
21341,4,3,74703,74705,74708,2,5,0
21342,1,3,74704,74708,74711,4,7,0
21343,5,2,74709,74711,74713,2,4,0
21344,5,1,74714,74714,74715,0,1,1
21345,5,2,74719,74719,74721,0,2,4
21346,4,2,74723,74723,74725,0,2,2
21347,1,3,74724,74725,74728,1,4,0
21348,2,1,74726,74728,74729,2,3,0
21349,3,3,74729,74729,74732,0,3,0
21350,2,3,74731,74732,74735,1,4,0
21351,2,1,74733,74735,74736,2,3,0
21352,5,3,74738,74738,74741,0,3,2
21353,1,2,74739,74741,74743,2,4,0
21354,3,1,74742,74743,74744,1,2,0
21355,5,2,74747,74747,74749,0,2,3
21356,2,1,74749,74749,74750,0,1,0
21357,5,2,74754,74754,74756,0,2,4
21358,5,3,74759,74759,74762,0,3,3
21359,5,2,74764,74764,74766,0,2,2
21360,2,2,74766,74766,74768,0,2,0
21361,6,2,74772,74772,74774,0,2,4
21362,5,2,74777,74777,74779,0,2,3
21363,4,2,74781,74781,74783,0,2,2
21364,2,3,74783,74783,74786,0,3,0
21365,4,1,74787,74787,74788,0,1,1
21366,1,1,74788,74788,74789,0,1,0
21367,3,2,74791,74791,74793,0,2,2
21368,2,3,74793,74793,74796,0,3,0
21369,3,1,74796,74796,74797,0,1,0
21370,3,1,74799,74799,74800,0,1,2
21371,2,1,74801,74801,74802,0,1,1
21372,5,2,74806,74806,74808,0,2,4
21373,3,3,74809,74809,74812,0,3,1
21374,3,2,74812,74812,74814,0,2,0
21375,2,3,74814,74814,74817,0,3,0
21376,2,3,74816,74817,74820,1,4,0
21377,2,2,74818,74820,74822,2,4,0
21378,2,3,74820,74822,74825,2,5,0
21379,5,2,74825,74825,74827,0,2,0
21380,3,2,74828,74828,74830,0,2,1
21381,2,3,74830,74830,74833,0,3,0
21382,1,1,74831,74833,74834,2,3,0
21383,6,3,74837,74837,74840,0,3,3
21384,6,1,74843,74843,74844,0,1,3
21385,6,1,74849,74849,74850,0,1,5
21386,2,1,74851,74851,74852,0,1,1
21387,2,2,74853,74853,74855,0,2,1
21388,4,2,74857,74857,74859,0,2,2
21389,5,3,74862,74862,74865,0,3,3
21390,5,3,74867,74867,74870,0,3,2
21391,5,1,74872,74872,74873,0,1,2
21392,4,2,74876,74876,74878,0,2,3
21393,2,2,74878,74878,74880,0,2,0
21394,4,2,74882,74882,74884,0,2,2
21395,4,3,74886,74886,74889,0,3,2
21396,3,2,74889,74889,74891,0,2,0
21397,2,1,74891,74891,74892,0,1,0
21398,2,2,74893,74893,74895,0,2,1
21399,4,3,74897,74897,74900,0,3,2
21400,1,3,74898,74900,74903,2,5,0
21401,5,1,74903,74903,74904,0,1,0
21402,5,1,74908,74908,74909,0,1,4
21403,5,2,74913,74913,74915,0,2,4
21404,6,2,74919,74919,74921,0,2,4
21405,3,3,74922,74922,74925,0,3,1
21406,4,1,74926,74926,74927,0,1,1
21407,3,3,74929,74929,74932,0,3,2
21408,5,3,74934,74934,74937,0,3,2
21409,3,1,74937,74937,74938,0,1,0
21410,3,2,74940,74940,74942,0,2,2
21411,4,3,74944,74944,74947,0,3,2
21412,6,2,74950,74950,74952,0,2,3
21413,6,2,74956,74956,74958,0,2,4
21414,4,2,74960,74960,74962,0,2,2
21415,2,2,74962,74962,74964,0,2,0
21416,1,2,74963,74964,74966,1,3,0
21417,6,1,74969,74969,74970,0,1,3
21418,4,2,74973,74973,74975,0,2,3
21419,5,1,74978,74978,74979,0,1,3
21420,1,1,74979,74979,74980,0,1,0
21421,6,2,74985,74985,74987,0,2,5
21422,4,1,74989,74989,74990,0,1,2
21423,3,2,74992,74992,74994,0,2,2
21424,2,1,74994,74994,74995,0,1,0
21425,6,1,75000,75000,75001,0,1,5
21426,5,2,75005,75005,75007,0,2,4
21427,5,2,75010,75010,75012,0,2,3
21428,2,3,75012,75012,75015,0,3,0
21429,1,2,75013,75015,75017,2,4,0
21430,2,2,75015,75017,75019,2,4,0
21431,4,1,75019,75019,75020,0,1,0
21432,6,3,75025,75025,75028,0,3,5
21433,5,1,75030,75030,75031,0,1,2
21434,5,1,75035,75035,75036,0,1,4
21435,5,1,75040,75040,75041,0,1,4
21436,2,2,75042,75042,75044,0,2,1
21437,5,3,75047,75047,75050,0,3,3
21438,6,2,75053,75053,75055,0,2,3
21439,3,3,75056,75056,75059,0,3,1
21440,2,3,75058,75059,75062,1,4,0
21441,3,1,75061,75062,75063,1,2,0
21442,1,2,75062,75063,75065,1,3,0
21443,5,3,75067,75067,75070,0,3,2
21444,2,2,75069,75070,75072,1,3,0
21445,4,1,75073,75073,75074,0,1,1
21446,5,2,75078,75078,75080,0,2,4
21447,4,2,75082,75082,75084,0,2,2
21448,4,3,75086,75086,75089,0,3,2
21449,2,2,75088,75089,75091,1,3,0
21450,1,1,75089,75091,75092,2,3,0
21451,2,1,75091,75092,75093,1,2,0
21452,6,2,75097,75097,75099,0,2,4
21453,4,2,75101,75101,75103,0,2,2
21454,5,2,75106,75106,75108,0,2,3
21455,1,3,75107,75108,75111,1,4,0
21456,4,3,75111,75111,75114,0,3,0
21457,2,1,75113,75114,75115,1,2,0
21458,3,3,75116,75116,75119,0,3,1
21459,5,2,75121,75121,75123,0,2,2
21460,6,1,75127,75127,75128,0,1,4
21461,1,2,75128,75128,75130,0,2,0
21462,1,3,75129,75130,75133,1,4,0
21463,6,2,75135,75135,75137,0,2,2
21464,4,1,75139,75139,75140,0,1,2
21465,3,1,75142,75142,75143,0,1,2
21466,6,3,75148,75148,75151,0,3,5
21467,6,2,75154,75154,75156,0,2,3
21468,2,2,75156,75156,75158,0,2,0
21469,1,3,75157,75158,75161,1,4,0
21470,4,1,75161,75161,75162,0,1,0
21471,4,3,75165,75165,75168,0,3,3
21472,4,1,75169,75169,75170,0,1,1
21473,3,1,75172,75172,75173,0,1,2
21474,1,1,75173,75173,75174,0,1,0
21475,2,2,75175,75175,75177,0,2,1
21476,2,1,75177,75177,75178,0,1,0
21477,3,1,75180,75180,75181,0,1,2
21478,4,2,75184,75184,75186,0,2,3
21479,3,1,75187,75187,75188,0,1,1
21480,4,1,75191,75191,75192,0,1,3
21481,6,3,75197,75197,75200,0,3,5
21482,3,1,75200,75200,75201,0,1,0
21483,4,1,75204,75204,75205,0,1,3
21484,5,2,75209,75209,75211,0,2,4
21485,2,3,75211,75211,75214,0,3,0
21486,6,1,75217,75217,75218,0,1,3
21487,2,2,75219,75219,75221,0,2,1
21488,5,3,75224,75224,75227,0,3,3
21489,3,3,75227,75227,75230,0,3,0
21490,4,3,75231,75231,75234,0,3,1
21491,3,2,75234,75234,75236,0,2,0
21492,2,3,75236,75236,75239,0,3,0
21493,2,3,75238,75239,75242,1,4,0
21494,3,1,75241,75242,75243,1,2,0
21495,5,3,75246,75246,75249,0,3,3
21496,1,1,75247,75249,75250,2,3,0
21497,4,1,75251,75251,75252,0,1,1
21498,2,2,75253,75253,75255,0,2,1
21499,2,2,75255,75255,75257,0,2,0
21500,2,1,75257,75257,75258,0,1,0
21501,1,3,75258,75258,75261,0,3,0
21502,1,1,75259,75261,75262,2,3,0
21503,4,3,75263,75263,75266,0,3,1
21504,3,2,75266,75266,75268,0,2,0
21505,4,1,75270,75270,75271,0,1,2
21506,4,2,75274,75274,75276,0,2,3
21507,4,3,75278,75278,75281,0,3,2
21508,6,2,75284,75284,75286,0,2,3
21509,4,3,75288,75288,75291,0,3,2
21510,6,3,75294,75294,75297,0,3,3
21511,4,3,75298,75298,75301,0,3,1
21512,4,3,75302,75302,75305,0,3,1
21513,6,3,75308,75308,75311,0,3,3
21514,3,2,75311,75311,75313,0,2,0
21515,5,2,75316,75316,75318,0,2,3
21516,5,1,75321,75321,75322,0,1,3
21517,6,1,75327,75327,75328,0,1,5
21518,4,2,75331,75331,75333,0,2,3
21519,4,2,75335,75335,75337,0,2,2
21520,2,1,75337,75337,75338,0,1,0
21521,3,2,75340,75340,75342,0,2,2
21522,1,2,75341,75342,75344,1,3,0
21523,1,2,75342,75344,75346,2,4,0
21524,3,1,75345,75346,75347,1,2,0
21525,3,2,75348,75348,75350,0,2,1
21526,4,3,75352,75352,75355,0,3,2
21527,3,3,75355,75355,75358,0,3,0
21528,3,3,75358,75358,75361,0,3,0
21529,3,1,75361,75361,75362,0,1,0
21530,5,2,75366,75366,75368,0,2,4
21531,6,1,75372,75372,75373,0,1,4
21532,4,2,75376,75376,75378,0,2,3
21533,2,1,75378,75378,75379,0,1,0
21534,5,2,75383,75383,75385,0,2,4
21535,2,1,75385,75385,75386,0,1,0
21536,3,3,75388,75388,75391,0,3,2
21537,5,3,75393,75393,75396,0,3,2
21538,1,1,75394,75396,75397,2,3,0
21539,5,3,75399,75399,75402,0,3,2
21540,6,2,75405,75405,75407,0,2,3
21541,5,1,75410,75410,75411,0,1,3
21542,4,3,75414,75414,75417,0,3,3
21543,6,2,75420,75420,75422,0,2,3
21544,2,3,75422,75422,75425,0,3,0
21545,1,2,75423,75425,75427,2,4,0
21546,4,3,75427,75427,75430,0,3,0
21547,4,2,75431,75431,75433,0,2,1
21548,1,3,75432,75433,75436,1,4,0
21549,4,1,75436,75436,75437,0,1,0
21550,6,3,75442,75442,75445,0,3,5
21551,4,1,75446,75446,75447,0,1,1
21552,6,3,75452,75452,75455,0,3,5
21553,4,1,75456,75456,75457,0,1,1
21554,6,1,75462,75462,75463,0,1,5
21555,5,2,75467,75467,75469,0,2,4
21556,5,1,75472,75472,75473,0,1,3
21557,2,3,75474,75474,75477,0,3,1
21558,2,1,75476,75477,75478,1,2,0
21559,6,1,75482,75482,75483,0,1,4
21560,1,2,75483,75483,75485,0,2,0
21561,4,2,75487,75487,75489,0,2,2
21562,4,3,75491,75491,75494,0,3,2
21563,6,1,75497,75497,75498,0,1,3
21564,4,1,75501,75501,75502,0,1,3
21565,1,2,75502,75502,75504,0,2,0
21566,6,2,75508,75508,75510,0,2,4
21567,6,3,75514,75514,75517,0,3,4
21568,6,2,75520,75520,75522,0,2,3
21569,2,2,75522,75522,75524,0,2,0
21570,4,3,75526,75526,75529,0,3,2
21571,2,1,75528,75529,75530,1,2,0
21572,4,3,75532,75532,75535,0,3,2
21573,3,2,75535,75535,75537,0,2,0
21574,1,1,75536,75537,75538,1,2,0
21575,5,3,75541,75541,75544,0,3,3
21576,3,1,75544,75544,75545,0,1,0
21577,6,3,75550,75550,75553,0,3,5
21578,6,1,75556,75556,75557,0,1,3
21579,4,3,75560,75560,75563,0,3,3
21580,2,1,75562,75563,75564,1,2,0
21581,1,2,75563,75564,75566,1,3,0
21582,3,1,75566,75566,75567,0,1,0
21583,2,2,75568,75568,75570,0,2,1
21584,2,3,75570,75570,75573,0,3,0
21585,3,2,75573,75573,75575,0,2,0
21586,1,1,75574,75575,75576,1,2,0
21587,2,2,75576,75576,75578,0,2,0
21588,2,2,75578,75578,75580,0,2,0
21589,3,3,75581,75581,75584,0,3,1
21590,4,2,75585,75585,75587,0,2,1
21591,5,3,75590,75590,75593,0,3,3
21592,4,1,75594,75594,75595,0,1,1
21593,2,2,75596,75596,75598,0,2,1
21594,5,1,75601,75601,75602,0,1,3
21595,2,2,75603,75603,75605,0,2,1
21596,4,2,75607,75607,75609,0,2,2
21597,2,2,75609,75609,75611,0,2,0
21598,4,2,75613,75613,75615,0,2,2
21599,1,1,75614,75615,75616,1,2,0
21600,2,2,75616,75616,75618,0,2,0
21601,6,1,75622,75622,75623,0,1,4
21602,1,3,75623,75623,75626,0,3,0
21603,6,1,75629,75629,75630,0,1,3
21604,2,2,75631,75631,75633,0,2,1
21605,2,1,75633,75633,75634,0,1,0
21606,2,1,75635,75635,75636,0,1,1
21607,4,1,75639,75639,75640,0,1,3
21608,5,1,75644,75644,75645,0,1,4
21609,3,3,75647,75647,75650,0,3,2
21610,5,1,75652,75652,75653,0,1,2
21611,3,1,75655,75655,75656,0,1,2
21612,6,3,75661,75661,75664,0,3,5
21613,2,1,75663,75664,75665,1,2,0
21614,5,1,75668,75668,75669,0,1,3
21615,2,1,75670,75670,75671,0,1,1
21616,6,2,75676,75676,75678,0,2,5
21617,5,3,75681,75681,75684,0,3,3
21618,2,1,75683,75684,75685,1,2,0
21619,1,2,75684,75685,75687,1,3,0
21620,3,1,75687,75687,75688,0,1,0
21621,5,2,75692,75692,75694,0,2,4
21622,2,1,75694,75694,75695,0,1,0
21623,6,2,75700,75700,75702,0,2,5
21624,1,2,75701,75702,75704,1,3,0
21625,4,3,75705,75705,75708,0,3,1
21626,4,3,75709,75709,75712,0,3,1
21627,4,1,75713,75713,75714,0,1,1
21628,6,3,75719,75719,75722,0,3,5
21629,2,3,75721,75722,75725,1,4,0
21630,5,1,75726,75726,75727,0,1,1
21631,6,1,75732,75732,75733,0,1,5
21632,3,1,75735,75735,75736,0,1,2
21633,3,1,75738,75738,75739,0,1,2
21634,1,1,75739,75739,75740,0,1,0
21635,3,1,75742,75742,75743,0,1,2
21636,5,3,75747,75747,75750,0,3,4
21637,2,2,75749,75750,75752,1,3,0
21638,1,3,75750,75752,75755,2,5,0
21639,6,3,75756,75756,75759,0,3,1
21640,3,3,75759,75759,75762,0,3,0
21641,1,1,75760,75762,75763,2,3,0
21642,2,3,75762,75763,75766,1,4,0
21643,5,1,75767,75767,75768,0,1,1
21644,1,3,75768,75768,75771,0,3,0
21645,1,3,75769,75771,75774,2,5,0
21646,3,2,75772,75774,75776,2,4,0
21647,3,2,75775,75776,75778,1,3,0
21648,5,3,75780,75780,75783,0,3,2
21649,3,3,75783,75783,75786,0,3,0
21650,1,1,75784,75786,75787,2,3,0
21651,1,2,75785,75787,75789,2,4,0
21652,5,3,75790,75790,75793,0,3,1
21653,2,3,75792,75793,75796,1,4,0
21654,1,2,75793,75796,75798,3,5,0
21655,4,1,75797,75798,75799,1,2,0
21656,4,2,75801,75801,75803,0,2,2
21657,6,3,75807,75807,75810,0,3,4
21658,2,1,75809,75810,75811,1,2,0
21659,6,3,75815,75815,75818,0,3,4
21660,5,2,75820,75820,75822,0,2,2
21661,3,1,75823,75823,75824,0,1,1
21662,1,2,75824,75824,75826,0,2,0
21663,1,1,75825,75826,75827,1,2,0
21664,5,2,75830,75830,75832,0,2,3
21665,6,3,75836,75836,75839,0,3,4
21666,6,2,75842,75842,75844,0,2,3
21667,5,1,75847,75847,75848,0,1,3
21668,4,3,75851,75851,75854,0,3,3
21669,4,1,75855,75855,75856,0,1,1
21670,1,2,75856,75856,75858,0,2,0
21671,2,2,75858,75858,75860,0,2,0
21672,4,2,75862,75862,75864,0,2,2
21673,2,2,75864,75864,75866,0,2,0
21674,6,3,75870,75870,75873,0,3,4
21675,2,2,75872,75873,75875,1,3,0
21676,2,1,75874,75875,75876,1,2,0
21677,2,2,75876,75876,75878,0,2,0
21678,4,2,75880,75880,75882,0,2,2
21679,6,3,75886,75886,75889,0,3,4
21680,6,3,75892,75892,75895,0,3,3
21681,6,3,75898,75898,75901,0,3,3
21682,4,1,75902,75902,75903,0,1,1
21683,3,2,75905,75905,75907,0,2,2
21684,6,1,75911,75911,75912,0,1,4
21685,2,1,75913,75913,75914,0,1,1
21686,1,1,75914,75914,75915,0,1,0
21687,3,2,75917,75917,75919,0,2,2
21688,6,1,75923,75923,75924,0,1,4
21689,1,2,75924,75924,75926,0,2,0
21690,2,2,75926,75926,75928,0,2,0
21691,4,3,75930,75930,75933,0,3,2
21692,2,1,75932,75933,75934,1,2,0
21693,2,2,75934,75934,75936,0,2,0
21694,4,3,75938,75938,75941,0,3,2
21695,6,1,75944,75944,75945,0,1,3
21696,4,3,75948,75948,75951,0,3,3
21697,2,3,75950,75951,75954,1,4,0
21698,5,3,75955,75955,75958,0,3,1
21699,4,1,75959,75959,75960,0,1,1
21700,4,3,75963,75963,75966,0,3,3
21701,6,3,75969,75969,75972,0,3,3
21702,5,3,75974,75974,75977,0,3,2
21703,2,3,75976,75977,75980,1,4,0
21704,1,3,75977,75980,75983,3,6,0
21705,3,1,75980,75983,75984,3,4,0
21706,6,1,75986,75986,75987,0,1,2
21707,2,1,75988,75988,75989,0,1,1
21708,6,1,75994,75994,75995,0,1,5
21709,4,1,75998,75998,75999,0,1,3
21710,2,2,76000,76000,76002,0,2,1
21711,6,1,76006,76006,76007,0,1,4
21712,6,1,76012,76012,76013,0,1,5
21713,6,2,76018,76018,76020,0,2,5
21714,2,1,76020,76020,76021,0,1,0
21715,2,2,76022,76022,76024,0,2,1
21716,3,1,76025,76025,76026,0,1,1
21717,6,1,76031,76031,76032,0,1,5
21718,1,1,76032,76032,76033,0,1,0
21719,3,2,76035,76035,76037,0,2,2
21720,1,2,76036,76037,76039,1,3,0
21721,3,3,76039,76039,76042,0,3,0
21722,1,2,76040,76042,76044,2,4,0
21723,1,1,76041,76044,76045,3,4,0
21724,5,1,76046,76046,76047,0,1,1
21725,5,1,76051,76051,76052,0,1,4
21726,1,3,76052,76052,76055,0,3,0
21727,6,3,76058,76058,76061,0,3,3
21728,3,1,76061,76061,76062,0,1,0
21729,6,1,76067,76067,76068,0,1,5
21730,4,3,76071,76071,76074,0,3,3
21731,1,1,76072,76074,76075,2,3,0
21732,5,1,76077,76077,76078,0,1,2
21733,5,3,76082,76082,76085,0,3,4
21734,2,1,76084,76085,76086,1,2,0
21735,4,2,76088,76088,76090,0,2,2
21736,1,3,76089,76090,76093,1,4,0
21737,6,3,76095,76095,76098,0,3,2
21738,1,3,76096,76098,76101,2,5,0
21739,3,1,76099,76101,76102,2,3,0
21740,5,1,76104,76104,76105,0,1,2
21741,6,2,76110,76110,76112,0,2,5
21742,6,1,76116,76116,76117,0,1,4
21743,4,1,76120,76120,76121,0,1,3
21744,4,3,76124,76124,76127,0,3,3
21745,4,3,76128,76128,76131,0,3,1
21746,4,3,76132,76132,76135,0,3,1
21747,2,3,76134,76135,76138,1,4,0
21748,4,1,76138,76138,76139,0,1,0
21749,5,2,76143,76143,76145,0,2,4
21750,2,1,76145,76145,76146,0,1,0
21751,2,2,76147,76147,76149,0,2,1
21752,4,2,76151,76151,76153,0,2,2
21753,2,3,76153,76153,76156,0,3,0
21754,5,1,76158,76158,76159,0,1,2
21755,5,3,76163,76163,76166,0,3,4
21756,3,3,76166,76166,76169,0,3,0
21757,6,3,76172,76172,76175,0,3,3
21758,5,2,76177,76177,76179,0,2,2
21759,2,2,76179,76179,76181,0,2,0
21760,6,3,76185,76185,76188,0,3,4
21761,6,2,76191,76191,76193,0,2,3
21762,5,1,76196,76196,76197,0,1,3
21763,6,1,76202,76202,76203,0,1,5
21764,1,1,76203,76203,76204,0,1,0
21765,4,1,76207,76207,76208,0,1,3
21766,3,2,76210,76210,76212,0,2,2
21767,4,3,76214,76214,76217,0,3,2
21768,2,3,76216,76217,76220,1,4,0
21769,1,2,76217,76220,76222,3,5,0
21770,5,2,76222,76222,76224,0,2,0
21771,3,3,76225,76225,76228,0,3,1
21772,5,1,76230,76230,76231,0,1,2
21773,3,3,76233,76233,76236,0,3,2
21774,2,3,76235,76236,76239,1,4,0
21775,6,2,76241,76241,76243,0,2,2
21776,3,1,76244,76244,76245,0,1,1
21777,4,2,76248,76248,76250,0,2,3
21778,2,1,76250,76250,76251,0,1,0
21779,3,2,76253,76253,76255,0,2,2
21780,1,2,76254,76255,76257,1,3,0
21781,1,2,76255,76257,76259,2,4,0
21782,4,3,76259,76259,76262,0,3,0
21783,6,1,76265,76265,76266,0,1,3
21784,6,2,76271,76271,76273,0,2,5
21785,6,3,76277,76277,76280,0,3,4
21786,1,1,76278,76280,76281,2,3,0
21787,3,1,76281,76281,76282,0,1,0
21788,4,1,76285,76285,76286,0,1,3
21789,1,2,76286,76286,76288,0,2,0
21790,1,2,76287,76288,76290,1,3,0
21791,4,3,76291,76291,76294,0,3,1
21792,3,1,76294,76294,76295,0,1,0
21793,3,2,76297,76297,76299,0,2,2
21794,2,3,76299,76299,76302,0,3,0
21795,2,2,76301,76302,76304,1,3,0
21796,5,3,76306,76306,76309,0,3,2
21797,1,1,76307,76309,76310,2,3,0
21798,3,2,76310,76310,76312,0,2,0
21799,4,2,76314,76314,76316,0,2,2
21800,2,1,76316,76316,76317,0,1,0
21801,3,1,76319,76319,76320,0,1,2
21802,6,1,76325,76325,76326,0,1,5
21803,5,3,76330,76330,76333,0,3,4
21804,3,1,76333,76333,76334,0,1,0
21805,2,2,76335,76335,76337,0,2,1
21806,4,3,76339,76339,76342,0,3,2
21807,6,1,76345,76345,76346,0,1,3
21808,3,2,76348,76348,76350,0,2,2
21809,4,2,76352,76352,76354,0,2,2
21810,5,3,76357,76357,76360,0,3,3
21811,5,1,76362,76362,76363,0,1,2
21812,2,2,76364,76364,76366,0,2,1
21813,5,1,76369,76369,76370,0,1,3
21814,1,2,76370,76370,76372,0,2,0
21815,5,1,76375,76375,76376,0,1,3
21816,5,3,76380,76380,76383,0,3,4
21817,3,3,76383,76383,76386,0,3,0
21818,3,1,76386,76386,76387,0,1,0
21819,2,3,76388,76388,76391,0,3,1
21820,6,1,76394,76394,76395,0,1,3
21821,5,3,76399,76399,76402,0,3,4
21822,6,3,76405,76405,76408,0,3,3
21823,2,1,76407,76408,76409,1,2,0
21824,4,3,76411,76411,76414,0,3,2
21825,3,2,76414,76414,76416,0,2,0
21826,4,3,76418,76418,76421,0,3,2
21827,5,3,76423,76423,76426,0,3,2
21828,5,1,76428,76428,76429,0,1,2
21829,2,1,76430,76430,76431,0,1,1
21830,1,3,76431,76431,76434,0,3,0
21831,3,1,76434,76434,76435,0,1,0
21832,1,2,76435,76435,76437,0,2,0
21833,3,3,76438,76438,76441,0,3,1
21834,5,3,76443,76443,76446,0,3,2
21835,2,1,76445,76446,76447,1,2,0
21836,2,3,76447,76447,76450,0,3,0
21837,3,2,76450,76450,76452,0,2,0
21838,1,2,76451,76452,76454,1,3,0
21839,6,2,76457,76457,76459,0,2,3
21840,4,2,76461,76461,76463,0,2,2
21841,4,3,76465,76465,76468,0,3,2
21842,1,1,76466,76468,76469,2,3,0
21843,2,3,76468,76469,76472,1,4,0
21844,2,1,76470,76472,76473,2,3,0
21845,1,2,76471,76473,76475,2,4,0
21846,6,3,76477,76477,76480,0,3,2
21847,5,3,76482,76482,76485,0,3,2
21848,2,3,76484,76485,76488,1,4,0
21849,3,1,76487,76488,76489,1,2,0
21850,1,3,76488,76489,76492,1,4,0
21851,2,1,76490,76492,76493,2,3,0
21852,4,2,76494,76494,76496,0,2,1
21853,4,3,76498,76498,76501,0,3,2
21854,1,2,76499,76501,76503,2,4,0
21855,1,3,76500,76503,76506,3,6,0
21856,3,3,76503,76506,76509,3,6,0
21857,5,2,76508,76509,76511,1,3,0
21858,5,3,76513,76513,76516,0,3,2
21859,6,3,76519,76519,76522,0,3,3
21860,1,1,76520,76522,76523,2,3,0
21861,5,1,76525,76525,76526,0,1,2
21862,2,1,76527,76527,76528,0,1,1
21863,1,3,76528,76528,76531,0,3,0
21864,5,2,76533,76533,76535,0,2,2
21865,1,2,76534,76535,76537,1,3,0
21866,1,1,76535,76537,76538,2,3,0
21867,4,3,76539,76539,76542,0,3,1
21868,1,2,76540,76542,76544,2,4,0
21869,1,2,76541,76544,76546,3,5,0
21870,5,2,76546,76546,76548,0,2,0
21871,5,2,76551,76551,76553,0,2,3
21872,4,2,76555,76555,76557,0,2,2
21873,5,3,76560,76560,76563,0,3,3
21874,3,2,76563,76563,76565,0,2,0
21875,4,1,76567,76567,76568,0,1,2
21876,6,3,76573,76573,76576,0,3,5
21877,2,1,76575,76576,76577,1,2,0
21878,4,1,76579,76579,76580,0,1,2
21879,5,2,76584,76584,76586,0,2,4
21880,2,3,76586,76586,76589,0,3,0
21881,4,2,76590,76590,76592,0,2,1
21882,6,1,76596,76596,76597,0,1,4
21883,4,2,76600,76600,76602,0,2,3
21884,1,1,76601,76602,76603,1,2,0
21885,6,2,76607,76607,76609,0,2,4
21886,6,3,76613,76613,76616,0,3,4
21887,6,1,76619,76619,76620,0,1,3
21888,4,1,76623,76623,76624,0,1,3
21889,3,2,76626,76626,76628,0,2,2
21890,6,1,76632,76632,76633,0,1,4
21891,4,2,76636,76636,76638,0,2,3
21892,2,3,76638,76638,76641,0,3,0
21893,5,2,76643,76643,76645,0,2,2
21894,2,3,76645,76645,76648,0,3,0
21895,3,1,76648,76648,76649,0,1,0
21896,6,1,76654,76654,76655,0,1,5
21897,3,3,76657,76657,76660,0,3,2
21898,4,2,76661,76661,76663,0,2,1
21899,6,3,76667,76667,76670,0,3,4
21900,2,3,76669,76670,76673,1,4,0
21901,5,3,76674,76674,76677,0,3,1
21902,1,3,76675,76677,76680,2,5,0
21903,3,2,76678,76680,76682,2,4,0
21904,3,3,76681,76682,76685,1,4,0
21905,5,3,76686,76686,76689,0,3,1
21906,1,3,76687,76689,76692,2,5,0
21907,3,3,76690,76692,76695,2,5,0
21908,6,2,76696,76696,76698,0,2,1
21909,3,3,76699,76699,76702,0,3,1
21910,3,3,76702,76702,76705,0,3,0
21911,3,1,76705,76705,76706,0,1,0
21912,3,3,76708,76708,76711,0,3,2
21913,6,2,76714,76714,76716,0,2,3
21914,6,1,76720,76720,76721,0,1,4
21915,4,3,76724,76724,76727,0,3,3
21916,2,1,76726,76727,76728,1,2,0
21917,3,1,76729,76729,76730,0,1,1
21918,3,1,76732,76732,76733,0,1,2
21919,4,1,76736,76736,76737,0,1,3
21920,5,2,76741,76741,76743,0,2,4
21921,1,3,76742,76743,76746,1,4,0
21922,5,2,76747,76747,76749,0,2,1
21923,2,1,76749,76749,76750,0,1,0
21924,4,3,76753,76753,76756,0,3,3
21925,6,3,76759,76759,76762,0,3,3
21926,1,2,76760,76762,76764,2,4,0
21927,5,1,76765,76765,76766,0,1,1
21928,6,2,76771,76771,76773,0,2,5
21929,6,3,76777,76777,76780,0,3,4
21930,5,1,76782,76782,76783,0,1,2
21931,5,3,76787,76787,76790,0,3,4
21932,5,3,76792,76792,76795,0,3,2
21933,1,3,76793,76795,76798,2,5,0
21934,5,3,76798,76798,76801,0,3,0
21935,6,1,76804,76804,76805,0,1,3
21936,3,2,76807,76807,76809,0,2,2
21937,6,2,76813,76813,76815,0,2,4
21938,2,1,76815,76815,76816,0,1,0
21939,6,1,76821,76821,76822,0,1,5
21940,3,3,76824,76824,76827,0,3,2
21941,4,2,76828,76828,76830,0,2,1
21942,1,1,76829,76830,76831,1,2,0
21943,3,3,76832,76832,76835,0,3,1
21944,1,1,76833,76835,76836,2,3,0
21945,2,3,76835,76836,76839,1,4,0
21946,6,2,76841,76841,76843,0,2,2
21947,5,3,76846,76846,76849,0,3,3
21948,3,3,76849,76849,76852,0,3,0
21949,4,1,76853,76853,76854,0,1,1
21950,1,2,76854,76854,76856,0,2,0
21951,2,1,76856,76856,76857,0,1,0
21952,1,1,76857,76857,76858,0,1,0
21953,3,1,76860,76860,76861,0,1,2
21954,2,2,76862,76862,76864,0,2,1
21955,4,3,76866,76866,76869,0,3,2
21956,5,2,76871,76871,76873,0,2,2
21957,4,1,76875,76875,76876,0,1,2
21958,6,3,76881,76881,76884,0,3,5
21959,3,3,76884,76884,76887,0,3,0
21960,4,3,76888,76888,76891,0,3,1
21961,2,3,76890,76891,76894,1,4,0
21962,6,1,76896,76896,76897,0,1,2
21963,4,1,76900,76900,76901,0,1,3
21964,3,1,76903,76903,76904,0,1,2
21965,4,1,76907,76907,76908,0,1,3
21966,4,2,76911,76911,76913,0,2,3
21967,2,3,76913,76913,76916,0,3,0
21968,5,1,76918,76918,76919,0,1,2
21969,4,3,76922,76922,76925,0,3,3
21970,2,2,76924,76925,76927,1,3,0
21971,2,1,76926,76927,76928,1,2,0
21972,5,3,76931,76931,76934,0,3,3
21973,1,3,76932,76934,76937,2,5,0
21974,4,3,76936,76937,76940,1,4,0
21975,3,2,76939,76940,76942,1,3,0
21976,1,3,76940,76942,76945,2,5,0
21977,3,3,76943,76945,76948,2,5,0
21978,6,1,76949,76949,76950,0,1,1
21979,4,2,76953,76953,76955,0,2,3
21980,5,3,76958,76958,76961,0,3,3
21981,6,3,76964,76964,76967,0,3,3
21982,6,1,76970,76970,76971,0,1,3
21983,2,3,76972,76972,76975,0,3,1
21984,4,3,76976,76976,76979,0,3,1
21985,3,1,76979,76979,76980,0,1,0
21986,4,3,76983,76983,76986,0,3,3
21987,4,3,76987,76987,76990,0,3,1
21988,5,3,76992,76992,76995,0,3,2
21989,5,2,76997,76997,76999,0,2,2
21990,5,1,77002,77002,77003,0,1,3
21991,1,3,77003,77003,77006,0,3,0
21992,1,3,77004,77006,77009,2,5,0
21993,6,3,77010,77010,77013,0,3,1
21994,1,1,77011,77013,77014,2,3,0
21995,3,3,77014,77014,77017,0,3,0
21996,2,1,77016,77017,77018,1,2,0
21997,1,2,77017,77018,77020,1,3,0
21998,1,3,77018,77020,77023,2,5,0
21999,3,3,77021,77023,77026,2,5,0
22000,6,2,77027,77027,77029,0,2,1
22001,4,1,77031,77031,77032,0,1,2
22002,3,1,77034,77034,77035,0,1,2
22003,1,3,77035,77035,77038,0,3,0
22004,3,2,77038,77038,77040,0,2,0
22005,6,3,77044,77044,77047,0,3,4
22006,1,2,77045,77047,77049,2,4,0
22007,1,1,77046,77049,77050,3,4,0
22008,2,2,77048,77050,77052,2,4,0
22009,5,1,77053,77053,77054,0,1,1
22010,6,1,77059,77059,77060,0,1,5
22011,4,2,77063,77063,77065,0,2,3
22012,2,2,77065,77065,77067,0,2,0
22013,5,2,77070,77070,77072,0,2,3
22014,1,2,77071,77072,77074,1,3,0
22015,6,1,77077,77077,77078,0,1,3
22016,2,1,77079,77079,77080,0,1,1
22017,6,3,77085,77085,77088,0,3,5
22018,1,1,77086,77088,77089,2,3,0
22019,5,1,77091,77091,77092,0,1,2
22020,4,1,77095,77095,77096,0,1,3
22021,3,3,77098,77098,77101,0,3,2
22022,1,1,77099,77101,77102,2,3,0
22023,6,1,77105,77105,77106,0,1,3
22024,3,1,77108,77108,77109,0,1,2
22025,5,3,77113,77113,77116,0,3,4
22026,6,2,77119,77119,77121,0,2,3
22027,5,1,77124,77124,77125,0,1,3
22028,4,3,77128,77128,77131,0,3,3
22029,4,3,77132,77132,77135,0,3,1
22030,6,1,77138,77138,77139,0,1,3
22031,3,2,77141,77141,77143,0,2,2
22032,1,2,77142,77143,77145,1,3,0
22033,4,3,77146,77146,77149,0,3,1
22034,2,3,77148,77149,77152,1,4,0
22035,3,3,77151,77152,77155,1,4,0
22036,5,3,77156,77156,77159,0,3,1
22037,3,1,77159,77159,77160,0,1,0
22038,2,1,77161,77161,77162,0,1,1
22039,1,1,77162,77162,77163,0,1,0
22040,2,3,77164,77164,77167,0,3,1
22041,3,3,77167,77167,77170,0,3,0
22042,1,3,77168,77170,77173,2,5,0
22043,4,2,77172,77173,77175,1,3,0
22044,5,2,77177,77177,77179,0,2,2
22045,2,3,77179,77179,77182,0,3,0
22046,5,2,77184,77184,77186,0,2,2
22047,5,3,77189,77189,77192,0,3,3
22048,2,3,77191,77192,77195,1,4,0
22049,5,2,77196,77196,77198,0,2,1
22050,1,2,77197,77198,77200,1,3,0
22051,4,2,77201,77201,77203,0,2,1
22052,5,2,77206,77206,77208,0,2,3
22053,6,3,77212,77212,77215,0,3,4
22054,1,1,77213,77215,77216,2,3,0
22055,2,3,77215,77216,77219,1,4,0
22056,3,1,77218,77219,77220,1,2,0
22057,4,3,77222,77222,77225,0,3,2
22058,5,1,77227,77227,77228,0,1,2
22059,6,2,77233,77233,77235,0,2,5
22060,2,2,77235,77235,77237,0,2,0
22061,5,3,77240,77240,77243,0,3,3
22062,5,3,77245,77245,77248,0,3,2
22063,6,3,77251,77251,77254,0,3,3
22064,4,1,77255,77255,77256,0,1,1
22065,5,3,77260,77260,77263,0,3,4
22066,4,3,77264,77264,77267,0,3,1
22067,5,1,77269,77269,77270,0,1,2
22068,5,1,77274,77274,77275,0,1,4
22069,6,1,77280,77280,77281,0,1,5
22070,5,3,77285,77285,77288,0,3,4
22071,2,2,77287,77288,77290,1,3,0
22072,3,1,77290,77290,77291,0,1,0
22073,3,1,77293,77293,77294,0,1,2
22074,5,1,77298,77298,77299,0,1,4
22075,2,3,77300,77300,77303,0,3,1
22076,1,1,77301,77303,77304,2,3,0
22077,4,1,77305,77305,77306,0,1,1
22078,6,2,77311,77311,77313,0,2,5
22079,1,1,77312,77313,77314,1,2,0
22080,2,1,77314,77314,77315,0,1,0
22081,1,3,77315,77315,77318,0,3,0
22082,4,3,77319,77319,77322,0,3,1
22083,3,3,77322,77322,77325,0,3,0
22084,3,2,77325,77325,77327,0,2,0
22085,3,2,77328,77328,77330,0,2,1
22086,6,2,77334,77334,77336,0,2,4
22087,2,1,77336,77336,77337,0,1,0
22088,1,2,77337,77337,77339,0,2,0
22089,2,3,77339,77339,77342,0,3,0
22090,6,2,77345,77345,77347,0,2,3
22091,4,2,77349,77349,77351,0,2,2
22092,2,3,77351,77351,77354,0,3,0
22093,1,3,77352,77354,77357,2,5,0
22094,5,1,77357,77357,77358,0,1,0
22095,4,2,77361,77361,77363,0,2,3
22096,3,2,77364,77364,77366,0,2,1
22097,3,2,77367,77367,77369,0,2,1
22098,6,2,77373,77373,77375,0,2,4
22099,1,3,77374,77375,77378,1,4,0
22100,6,1,77380,77380,77381,0,1,2
22101,2,1,77382,77382,77383,0,1,1
22102,6,1,77388,77388,77389,0,1,5
22103,6,1,77394,77394,77395,0,1,5
22104,6,3,77400,77400,77403,0,3,5
22105,3,2,77403,77403,77405,0,2,0
22106,1,3,77404,77405,77408,1,4,0
22107,6,2,77410,77410,77412,0,2,2
22108,3,1,77413,77413,77414,0,1,1
22109,5,1,77418,77418,77419,0,1,4
22110,4,1,77422,77422,77423,0,1,3
22111,2,2,77424,77424,77426,0,2,1
22112,2,3,77426,77426,77429,0,3,0
22113,6,3,77432,77432,77435,0,3,3
22114,6,2,77438,77438,77440,0,2,3
22115,2,1,77440,77440,77441,0,1,0
22116,2,1,77442,77442,77443,0,1,1
22117,4,3,77446,77446,77449,0,3,3
22118,1,2,77447,77449,77451,2,4,0
22119,5,1,77452,77452,77453,0,1,1
22120,4,1,77456,77456,77457,0,1,3
22121,2,3,77458,77458,77461,0,3,1
22122,3,2,77461,77461,77463,0,2,0
22123,1,2,77462,77463,77465,1,3,0
22124,2,3,77464,77465,77468,1,4,0
22125,1,3,77465,77468,77471,3,6,0
22126,6,3,77471,77471,77474,0,3,0
22127,6,2,77477,77477,77479,0,2,3
22128,3,2,77480,77480,77482,0,2,1
22129,6,2,77486,77486,77488,0,2,4
22130,1,1,77487,77488,77489,1,2,0
22131,4,2,77491,77491,77493,0,2,2
22132,3,2,77494,77494,77496,0,2,1
22133,4,1,77498,77498,77499,0,1,2
22134,2,2,77500,77500,77502,0,2,1
22135,4,1,77504,77504,77505,0,1,2
22136,3,1,77507,77507,77508,0,1,2
22137,6,3,77513,77513,77516,0,3,5
22138,1,3,77514,77516,77519,2,5,0
22139,4,2,77518,77519,77521,1,3,0
22140,4,3,77522,77522,77525,0,3,1
22141,3,3,77525,77525,77528,0,3,0
22142,1,2,77526,77528,77530,2,4,0
22143,4,1,77530,77530,77531,0,1,0
22144,6,2,77536,77536,77538,0,2,5
22145,2,3,77538,77538,77541,0,3,0
22146,4,3,77542,77542,77545,0,3,1
22147,5,2,77547,77547,77549,0,2,2
22148,5,1,77552,77552,77553,0,1,3
22149,4,1,77556,77556,77557,0,1,3
22150,4,1,77560,77560,77561,0,1,3
22151,3,2,77563,77563,77565,0,2,2
22152,1,2,77564,77565,77567,1,3,0
22153,2,1,77566,77567,77568,1,2,0
22154,6,3,77572,77572,77575,0,3,4
22155,1,2,77573,77575,77577,2,4,0
22156,4,2,77577,77577,77579,0,2,0
22157,1,3,77578,77579,77582,1,4,0
22158,6,2,77584,77584,77586,0,2,2
22159,3,2,77587,77587,77589,0,2,1
22160,5,3,77592,77592,77595,0,3,3
22161,1,1,77593,77595,77596,2,3,0
22162,1,2,77594,77596,77598,2,4,0
22163,4,1,77598,77598,77599,0,1,0
22164,3,1,77601,77601,77602,0,1,2
22165,4,3,77605,77605,77608,0,3,3
22166,2,3,77607,77608,77611,1,4,0
22167,5,2,77612,77612,77614,0,2,1
22168,4,2,77616,77616,77618,0,2,2
22169,1,1,77617,77618,77619,1,2,0
22170,1,1,77618,77619,77620,1,2,0
22171,4,1,77622,77622,77623,0,1,2
22172,5,3,77627,77627,77630,0,3,4
22173,2,3,77629,77630,77633,1,4,0
22174,5,3,77634,77634,77637,0,3,1
22175,4,1,77638,77638,77639,0,1,1
22176,6,3,77644,77644,77647,0,3,5
22177,4,2,77648,77648,77650,0,2,1
22178,4,1,77652,77652,77653,0,1,2
22179,6,3,77658,77658,77661,0,3,5
22180,5,2,77663,77663,77665,0,2,2
22181,4,1,77667,77667,77668,0,1,2
22182,4,1,77671,77671,77672,0,1,3
22183,2,3,77673,77673,77676,0,3,1
22184,1,2,77674,77676,77678,2,4,0
22185,3,2,77677,77678,77680,1,3,0
22186,3,2,77680,77680,77682,0,2,0
22187,3,3,77683,77683,77686,0,3,1
22188,2,2,77685,77686,77688,1,3,0
22189,4,2,77689,77689,77691,0,2,1
22190,4,2,77693,77693,77695,0,2,2
22191,6,1,77699,77699,77700,0,1,4
22192,4,1,77703,77703,77704,0,1,3
22193,1,2,77704,77704,77706,0,2,0
22194,5,3,77709,77709,77712,0,3,3
22195,4,3,77713,77713,77716,0,3,1
22196,4,3,77717,77717,77720,0,3,1
22197,5,2,77722,77722,77724,0,2,2
22198,6,2,77728,77728,77730,0,2,4
22199,6,1,77734,77734,77735,0,1,4
22200,1,1,77735,77735,77736,0,1,0
22201,1,3,77736,77736,77739,0,3,0
22202,5,2,77741,77741,77743,0,2,2
22203,3,2,77744,77744,77746,0,2,1
22204,3,2,77747,77747,77749,0,2,1
22205,5,2,77752,77752,77754,0,2,3
22206,1,2,77753,77754,77756,1,3,0
22207,4,2,77757,77757,77759,0,2,1
22208,5,2,77762,77762,77764,0,2,3
22209,4,3,77766,77766,77769,0,3,2
22210,4,3,77770,77770,77773,0,3,1
22211,6,1,77776,77776,77777,0,1,3
22212,5,2,77781,77781,77783,0,2,4
22213,3,1,77784,77784,77785,0,1,1
22214,2,2,77786,77786,77788,0,2,1
22215,1,1,77787,77788,77789,1,2,0
22216,2,1,77789,77789,77790,0,1,0
22217,6,2,77795,77795,77797,0,2,5
22218,4,2,77799,77799,77801,0,2,2
22219,6,3,77805,77805,77808,0,3,4
22220,4,3,77809,77809,77812,0,3,1
22221,5,1,77814,77814,77815,0,1,2
22222,6,2,77820,77820,77822,0,2,5
22223,4,1,77824,77824,77825,0,1,2
22224,5,1,77829,77829,77830,0,1,4
22225,1,3,77830,77830,77833,0,3,0
22226,3,2,77833,77833,77835,0,2,0
22227,4,3,77837,77837,77840,0,3,2
22228,1,2,77838,77840,77842,2,4,0
22229,3,2,77841,77842,77844,1,3,0
22230,1,2,77842,77844,77846,2,4,0
22231,5,3,77847,77847,77850,0,3,1
22232,6,1,77853,77853,77854,0,1,3
22233,3,2,77856,77856,77858,0,2,2
22234,6,1,77862,77862,77863,0,1,4
22235,4,1,77866,77866,77867,0,1,3
22236,5,3,77871,77871,77874,0,3,4
22237,6,2,77877,77877,77879,0,2,3
22238,5,1,77882,77882,77883,0,1,3
22239,5,1,77887,77887,77888,0,1,4
22240,5,3,77892,77892,77895,0,3,4
22241,3,2,77895,77895,77897,0,2,0
22242,1,3,77896,77897,77900,1,4,0
22243,1,1,77897,77900,77901,3,4,0
22244,6,2,77903,77903,77905,0,2,2
22245,3,2,77906,77906,77908,0,2,1
22246,1,2,77907,77908,77910,1,3,0
22247,3,2,77910,77910,77912,0,2,0
22248,5,3,77915,77915,77918,0,3,3
22249,3,2,77918,77918,77920,0,2,0
22250,4,2,77922,77922,77924,0,2,2
22251,5,2,77927,77927,77929,0,2,3
22252,6,3,77933,77933,77936,0,3,4
22253,2,1,77935,77936,77937,1,2,0
22254,1,2,77936,77937,77939,1,3,0
22255,4,1,77940,77940,77941,0,1,1
22256,3,1,77943,77943,77944,0,1,2
22257,4,2,77947,77947,77949,0,2,3
22258,2,2,77949,77949,77951,0,2,0
22259,3,3,77952,77952,77955,0,3,1
22260,4,1,77956,77956,77957,0,1,1
22261,4,2,77960,77960,77962,0,2,3
22262,3,3,77963,77963,77966,0,3,1
22263,3,1,77966,77966,77967,0,1,0
22264,2,1,77968,77968,77969,0,1,1
22265,5,3,77973,77973,77976,0,3,4
22266,2,3,77975,77976,77979,1,4,0
22267,4,1,77979,77979,77980,0,1,0
22268,2,3,77981,77981,77984,0,3,1
22269,1,1,77982,77984,77985,2,3,0
22270,5,2,77987,77987,77989,0,2,2
22271,3,3,77990,77990,77993,0,3,1
22272,2,2,77992,77993,77995,1,3,0
22273,5,1,77997,77997,77998,0,1,2
22274,2,2,77999,77999,78001,0,2,1
22275,3,3,78002,78002,78005,0,3,1
22276,1,1,78003,78005,78006,2,3,0
22277,4,1,78007,78007,78008,0,1,1
22278,1,3,78008,78008,78011,0,3,0
22279,1,2,78009,78011,78013,2,4,0
22280,5,2,78014,78014,78016,0,2,1
22281,2,2,78016,78016,78018,0,2,0
22282,6,1,78022,78022,78023,0,1,4
22283,6,1,78028,78028,78029,0,1,5
22284,3,1,78031,78031,78032,0,1,2
22285,1,1,78032,78032,78033,0,1,0
22286,6,2,78038,78038,78040,0,2,5
22287,5,2,78043,78043,78045,0,2,3
22288,1,3,78044,78045,78048,1,4,0
22289,4,1,78048,78048,78049,0,1,0
22290,6,1,78054,78054,78055,0,1,5
22291,2,1,78056,78056,78057,0,1,1
22292,2,3,78058,78058,78061,0,3,1
22293,3,2,78061,78061,78063,0,2,0
22294,4,1,78065,78065,78066,0,1,2
22295,1,2,78066,78066,78068,0,2,0
22296,3,2,78069,78069,78071,0,2,1
22297,2,3,78071,78071,78074,0,3,0
22298,2,1,78073,78074,78075,1,2,0
22299,5,1,78078,78078,78079,0,1,3
22300,3,2,78081,78081,78083,0,2,2
22301,2,3,78083,78083,78086,0,3,0
22302,3,2,78086,78086,78088,0,2,0
22303,4,2,78090,78090,78092,0,2,2
22304,6,2,78096,78096,78098,0,2,4
22305,4,1,78100,78100,78101,0,1,2
22306,2,1,78102,78102,78103,0,1,1
22307,1,1,78103,78103,78104,0,1,0
22308,4,2,78107,78107,78109,0,2,3
22309,4,1,78111,78111,78112,0,1,2
22310,4,3,78115,78115,78118,0,3,3
22311,4,2,78119,78119,78121,0,2,1
22312,6,2,78125,78125,78127,0,2,4
22313,1,1,78126,78127,78128,1,2,0
22314,2,2,78128,78128,78130,0,2,0
22315,3,1,78131,78131,78132,0,1,1
22316,1,1,78132,78132,78133,0,1,0
22317,2,2,78134,78134,78136,0,2,1
22318,6,1,78140,78140,78141,0,1,4
22319,4,3,78144,78144,78147,0,3,3
22320,1,2,78145,78147,78149,2,4,0
22321,5,3,78150,78150,78153,0,3,1
22322,4,3,78154,78154,78157,0,3,1
22323,5,1,78159,78159,78160,0,1,2
22324,4,3,78163,78163,78166,0,3,3
22325,1,1,78164,78166,78167,2,3,0
22326,2,3,78166,78167,78170,1,4,0
22327,6,1,78172,78172,78173,0,1,2
22328,4,2,78176,78176,78178,0,2,3
22329,5,3,78181,78181,78184,0,3,3
22330,2,3,78183,78184,78187,1,4,0
22331,5,1,78188,78188,78189,0,1,1
22332,5,1,78193,78193,78194,0,1,4
22333,2,1,78195,78195,78196,0,1,1
22334,3,3,78198,78198,78201,0,3,2
22335,5,1,78203,78203,78204,0,1,2
22336,6,1,78209,78209,78210,0,1,5
22337,4,1,78213,78213,78214,0,1,3
22338,2,2,78215,78215,78217,0,2,1
22339,4,2,78219,78219,78221,0,2,2
22340,6,3,78225,78225,78228,0,3,4
22341,1,1,78226,78228,78229,2,3,0
22342,6,2,78232,78232,78234,0,2,3
22343,4,2,78236,78236,78238,0,2,2
22344,4,3,78240,78240,78243,0,3,2
22345,1,3,78241,78243,78246,2,5,0
22346,1,2,78242,78246,78248,4,6,0
22347,3,2,78245,78248,78250,3,5,0
22348,6,3,78251,78251,78254,0,3,1
22349,3,3,78254,78254,78257,0,3,0
22350,4,3,78258,78258,78261,0,3,1
22351,3,3,78261,78261,78264,0,3,0
22352,5,3,78266,78266,78269,0,3,2
22353,2,2,78268,78269,78271,1,3,0
22354,2,3,78270,78271,78274,1,4,0
22355,4,1,78274,78274,78275,0,1,0
22356,2,2,78276,78276,78278,0,2,1
22357,5,1,78281,78281,78282,0,1,3
22358,5,1,78286,78286,78287,0,1,4
22359,1,1,78287,78287,78288,0,1,0
22360,1,1,78288,78288,78289,0,1,0
22361,6,2,78294,78294,78296,0,2,5
22362,3,2,78297,78297,78299,0,2,1
22363,2,1,78299,78299,78300,0,1,0
22364,2,1,78301,78301,78302,0,1,1
22365,5,1,78306,78306,78307,0,1,4
22366,3,2,78309,78309,78311,0,2,2
22367,1,1,78310,78311,78312,1,2,0
22368,2,3,78312,78312,78315,0,3,0
22369,3,1,78315,78315,78316,0,1,0
22370,6,1,78321,78321,78322,0,1,5
22371,2,1,78323,78323,78324,0,1,1
22372,6,1,78329,78329,78330,0,1,5
22373,1,1,78330,78330,78331,0,1,0
22374,5,2,78335,78335,78337,0,2,4
22375,3,1,78338,78338,78339,0,1,1
22376,6,3,78344,78344,78347,0,3,5
22377,5,2,78349,78349,78351,0,2,2
22378,3,1,78352,78352,78353,0,1,1
22379,5,1,78357,78357,78358,0,1,4
22380,6,3,78363,78363,78366,0,3,5
22381,4,1,78367,78367,78368,0,1,1
22382,3,2,78370,78370,78372,0,2,2
22383,4,1,78374,78374,78375,0,1,2
22384,3,1,78377,78377,78378,0,1,2
22385,6,2,78383,78383,78385,0,2,5
22386,2,1,78385,78385,78386,0,1,0
22387,1,2,78386,78386,78388,0,2,0
22388,6,2,78392,78392,78394,0,2,4
22389,6,3,78398,78398,78401,0,3,4
22390,6,2,78404,78404,78406,0,2,3
22391,4,2,78408,78408,78410,0,2,2
22392,3,1,78411,78411,78412,0,1,1
22393,3,3,78414,78414,78417,0,3,2
22394,4,2,78418,78418,78420,0,2,1
22395,4,1,78422,78422,78423,0,1,2
22396,2,3,78424,78424,78427,0,3,1
22397,1,3,78425,78427,78430,2,5,0
22398,5,1,78430,78430,78431,0,1,0
22399,4,3,78434,78434,78437,0,3,3
22400,2,2,78436,78437,78439,1,3,0
22401,4,1,78440,78440,78441,0,1,1
22402,6,1,78446,78446,78447,0,1,5
22403,1,3,78447,78447,78450,0,3,0
22404,2,3,78449,78450,78453,1,4,0
22405,1,2,78450,78453,78455,3,5,0
22406,3,2,78453,78455,78457,2,4,0
22407,2,3,78455,78457,78460,2,5,0
22408,6,1,78461,78461,78462,0,1,1
22409,4,1,78465,78465,78466,0,1,3
22410,5,3,78470,78470,78473,0,3,4
22411,5,1,78475,78475,78476,0,1,2
22412,4,3,78479,78479,78482,0,3,3
22413,6,1,78485,78485,78486,0,1,3
22414,4,2,78489,78489,78491,0,2,3
22415,1,3,78490,78491,78494,1,4,0
22416,5,1,78495,78495,78496,0,1,1
22417,1,2,78496,78496,78498,0,2,0
22418,1,3,78497,78498,78501,1,4,0
22419,6,2,78503,78503,78505,0,2,2
22420,2,1,78505,78505,78506,0,1,0
22421,6,2,78511,78511,78513,0,2,5
22422,4,3,78515,78515,78518,0,3,2
22423,5,1,78520,78520,78521,0,1,2
22424,4,1,78524,78524,78525,0,1,3
22425,2,2,78526,78526,78528,0,2,1
22426,2,3,78528,78528,78531,0,3,0
22427,4,1,78532,78532,78533,0,1,1
22428,6,1,78538,78538,78539,0,1,5
22429,4,3,78542,78542,78545,0,3,3
22430,2,3,78544,78545,78548,1,4,0
22431,4,1,78548,78548,78549,0,1,0
22432,2,3,78550,78550,78553,0,3,1
22433,1,1,78551,78553,78554,2,3,0
22434,3,1,78554,78554,78555,0,1,0
22435,2,3,78556,78556,78559,0,3,1
22436,5,2,78561,78561,78563,0,2,2
22437,1,1,78562,78563,78564,1,2,0
22438,5,1,78567,78567,78568,0,1,3
22439,6,2,78573,78573,78575,0,2,5
22440,1,1,78574,78575,78576,1,2,0
22441,5,2,78579,78579,78581,0,2,3
22442,6,3,78585,78585,78588,0,3,4
22443,1,3,78586,78588,78591,2,5,0
22444,4,1,78590,78591,78592,1,2,0
22445,6,1,78596,78596,78597,0,1,4
22446,4,2,78600,78600,78602,0,2,3
22447,6,3,78606,78606,78609,0,3,4
22448,4,1,78610,78610,78611,0,1,1
22449,1,2,78611,78611,78613,0,2,0
22450,6,3,78617,78617,78620,0,3,4
22451,2,2,78619,78620,78622,1,3,0
22452,1,1,78620,78622,78623,2,3,0
22453,1,3,78621,78623,78626,2,5,0
22454,1,1,78622,78626,78627,4,5,0
22455,1,3,78623,78627,78630,4,7,0
22456,2,2,78625,78630,78632,5,7,0
22457,6,1,78631,78632,78633,1,2,0
22458,5,2,78636,78636,78638,0,2,3
22459,3,3,78639,78639,78642,0,3,1
22460,6,3,78645,78645,78648,0,3,3
22461,3,3,78648,78648,78651,0,3,0
22462,5,2,78653,78653,78655,0,2,2
22463,5,2,78658,78658,78660,0,2,3
22464,3,3,78661,78661,78664,0,3,1
22465,1,1,78662,78664,78665,2,3,0
22466,4,2,78666,78666,78668,0,2,1
22467,4,2,78670,78670,78672,0,2,2
22468,2,2,78672,78672,78674,0,2,0
22469,3,1,78675,78675,78676,0,1,1
22470,6,2,78681,78681,78683,0,2,5
22471,5,1,78686,78686,78687,0,1,3
22472,5,1,78691,78691,78692,0,1,4
22473,4,1,78695,78695,78696,0,1,3
22474,6,1,78701,78701,78702,0,1,5
22475,4,2,78705,78705,78707,0,2,3
22476,1,1,78706,78707,78708,1,2,0
22477,1,2,78707,78708,78710,1,3,0
22478,6,3,78713,78713,78716,0,3,3
22479,5,1,78718,78718,78719,0,1,2
22480,1,3,78719,78719,78722,0,3,0
22481,4,2,78723,78723,78725,0,2,1
22482,4,3,78727,78727,78730,0,3,2
22483,1,3,78728,78730,78733,2,5,0
22484,2,2,78730,78733,78735,3,5,0
22485,1,2,78731,78735,78737,4,6,0
22486,2,3,78733,78737,78740,4,7,0
22487,3,2,78736,78740,78742,4,6,0
22488,1,3,78737,78742,78745,5,8,0
22489,4,1,78741,78745,78746,4,5,0
22490,2,2,78743,78746,78748,3,5,0
22491,2,1,78745,78748,78749,3,4,0
22492,2,2,78747,78749,78751,2,4,0
22493,2,2,78749,78751,78753,2,4,0
22494,3,1,78752,78753,78754,1,2,0
22495,1,2,78753,78754,78756,1,3,0
22496,3,1,78756,78756,78757,0,1,0
22497,5,1,78761,78761,78762,0,1,4
22498,6,1,78767,78767,78768,0,1,5
22499,5,3,78772,78772,78775,0,3,4
22500,5,3,78777,78777,78780,0,3,2
22501,2,3,78779,78780,78783,1,4,0
22502,1,2,78780,78783,78785,3,5,0
22503,5,2,78785,78785,78787,0,2,0
22504,2,1,78787,78787,78788,0,1,0
22505,3,3,78790,78790,78793,0,3,2
22506,1,1,78791,78793,78794,2,3,0
22507,3,1,78794,78794,78795,0,1,0
22508,5,1,78799,78799,78800,0,1,4
22509,5,3,78804,78804,78807,0,3,4
22510,4,1,78808,78808,78809,0,1,1
22511,1,1,78809,78809,78810,0,1,0
22512,6,3,78815,78815,78818,0,3,5
22513,3,2,78818,78818,78820,0,2,0
22514,2,1,78820,78820,78821,0,1,0
22515,6,3,78826,78826,78829,0,3,5
22516,4,1,78830,78830,78831,0,1,1
22517,1,1,78831,78831,78832,0,1,0
22518,2,3,78833,78833,78836,0,3,1
22519,6,3,78839,78839,78842,0,3,3
22520,4,2,78843,78843,78845,0,2,1
22521,6,2,78849,78849,78851,0,2,4
22522,6,1,78855,78855,78856,0,1,4
22523,6,3,78861,78861,78864,0,3,5
22524,3,3,78864,78864,78867,0,3,0
22525,1,1,78865,78867,78868,2,3,0
22526,4,1,78869,78869,78870,0,1,1
22527,6,3,78875,78875,78878,0,3,5
22528,5,3,78880,78880,78883,0,3,2
22529,3,2,78883,78883,78885,0,2,0
22530,6,3,78889,78889,78892,0,3,4
22531,3,3,78892,78892,78895,0,3,0
22532,4,1,78896,78896,78897,0,1,1
22533,1,1,78897,78897,78898,0,1,0
22534,6,2,78903,78903,78905,0,2,5
22535,5,1,78908,78908,78909,0,1,3
22536,6,1,78914,78914,78915,0,1,5
22537,1,3,78915,78915,78918,0,3,0
22538,1,2,78916,78918,78920,2,4,0
22539,1,3,78917,78920,78923,3,6,0
22540,3,3,78920,78923,78926,3,6,0
22541,4,3,78924,78926,78929,2,5,0
22542,6,1,78930,78930,78931,0,1,1
22543,6,1,78936,78936,78937,0,1,5
22544,6,3,78942,78942,78945,0,3,5
22545,3,1,78945,78945,78946,0,1,0
22546,2,3,78947,78947,78950,0,3,1
22547,6,2,78953,78953,78955,0,2,3
22548,2,2,78955,78955,78957,0,2,0
22549,1,2,78956,78957,78959,1,3,0
22550,4,2,78960,78960,78962,0,2,1
22551,6,3,78966,78966,78969,0,3,4
22552,6,1,78972,78972,78973,0,1,3
22553,3,3,78975,78975,78978,0,3,2
22554,3,2,78978,78978,78980,0,2,0
22555,5,2,78983,78983,78985,0,2,3
22556,1,2,78984,78985,78987,1,3,0
22557,4,3,78988,78988,78991,0,3,1
22558,4,1,78992,78992,78993,0,1,1
22559,6,3,78998,78998,79001,0,3,5
22560,2,3,79000,79001,79004,1,4,0
22561,6,1,79006,79006,79007,0,1,2
22562,1,3,79007,79007,79010,0,3,0
22563,1,3,79008,79010,79013,2,5,0
22564,5,1,79013,79013,79014,0,1,0
22565,1,3,79014,79014,79017,0,3,0
22566,3,3,79017,79017,79020,0,3,0
22567,4,3,79021,79021,79024,0,3,1
22568,2,1,79023,79024,79025,1,2,0
22569,3,3,79026,79026,79029,0,3,1
22570,3,3,79029,79029,79032,0,3,0
22571,3,3,79032,79032,79035,0,3,0
22572,5,3,79037,79037,79040,0,3,2
22573,2,2,79039,79040,79042,1,3,0
22574,3,1,79042,79042,79043,0,1,0
22575,6,3,79048,79048,79051,0,3,5
22576,5,2,79053,79053,79055,0,2,2
22577,5,3,79058,79058,79061,0,3,3
22578,3,3,79061,79061,79064,0,3,0
22579,3,1,79064,79064,79065,0,1,0
22580,1,1,79065,79065,79066,0,1,0
22581,3,2,79068,79068,79070,0,2,2
22582,4,2,79072,79072,79074,0,2,2
22583,5,1,79077,79077,79078,0,1,3
22584,4,1,79081,79081,79082,0,1,3
22585,2,3,79083,79083,79086,0,3,1
22586,6,2,79089,79089,79091,0,2,3
22587,2,3,79091,79091,79094,0,3,0
22588,6,2,79097,79097,79099,0,2,3
22589,1,1,79098,79099,79100,1,2,0
22590,5,1,79103,79103,79104,0,1,3
22591,2,1,79105,79105,79106,0,1,1
22592,5,1,79110,79110,79111,0,1,4
22593,1,1,79111,79111,79112,0,1,0
22594,5,2,79116,79116,79118,0,2,4
22595,5,2,79121,79121,79123,0,2,3
22596,3,3,79124,79124,79127,0,3,1
22597,2,3,79126,79127,79130,1,4,0
22598,1,3,79127,79130,79133,3,6,0
22599,6,3,79133,79133,79136,0,3,0
22600,3,1,79136,79136,79137,0,1,0
22601,1,3,79137,79137,79140,0,3,0
22602,3,1,79140,79140,79141,0,1,0
22603,3,3,79143,79143,79146,0,3,2
22604,2,1,79145,79146,79147,1,2,0
22605,1,1,79146,79147,79148,1,2,0
22606,3,3,79149,79149,79152,0,3,1
22607,5,2,79154,79154,79156,0,2,2
22608,5,2,79159,79159,79161,0,2,3
22609,1,2,79160,79161,79163,1,3,0
22610,1,2,79161,79163,79165,2,4,0
22611,6,3,79167,79167,79170,0,3,2
22612,5,3,79172,79172,79175,0,3,2
22613,3,3,79175,79175,79178,0,3,0
22614,5,3,79180,79180,79183,0,3,2
22615,4,2,79184,79184,79186,0,2,1
22616,5,1,79189,79189,79190,0,1,3
22617,6,1,79195,79195,79196,0,1,5
22618,1,1,79196,79196,79197,0,1,0
22619,6,2,79202,79202,79204,0,2,5
22620,4,3,79206,79206,79209,0,3,2
22621,5,3,79211,79211,79214,0,3,2
22622,2,1,79213,79214,79215,1,2,0
22623,4,2,79217,79217,79219,0,2,2
22624,4,3,79221,79221,79224,0,3,2
22625,1,1,79222,79224,79225,2,3,0
22626,1,2,79223,79225,79227,2,4,0
22627,6,2,79229,79229,79231,0,2,2
22628,4,1,79233,79233,79234,0,1,2
22629,5,2,79238,79238,79240,0,2,4
22630,2,3,79240,79240,79243,0,3,0
22631,3,3,79243,79243,79246,0,3,0
22632,4,1,79247,79247,79248,0,1,1
22633,3,1,79250,79250,79251,0,1,2
22634,5,2,79255,79255,79257,0,2,4
22635,6,2,79261,79261,79263,0,2,4
22636,3,2,79264,79264,79266,0,2,1
22637,5,1,79269,79269,79270,0,1,3
22638,6,3,79275,79275,79278,0,3,5
22639,5,3,79280,79280,79283,0,3,2
22640,4,3,79284,79284,79287,0,3,1
22641,1,3,79285,79287,79290,2,5,0
22642,6,3,79291,79291,79294,0,3,1
22643,5,2,79296,79296,79298,0,2,2
22644,5,2,79301,79301,79303,0,2,3
22645,1,2,79302,79303,79305,1,3,0
22646,4,2,79306,79306,79308,0,2,1
22647,5,1,79311,79311,79312,0,1,3
22648,2,3,79313,79313,79316,0,3,1
22649,2,3,79315,79316,79319,1,4,0
22650,6,2,79321,79321,79323,0,2,2
22651,1,3,79322,79323,79326,1,4,0
22652,3,2,79325,79326,79328,1,3,0
22653,2,1,79327,79328,79329,1,2,0
22654,4,3,79331,79331,79334,0,3,2
22655,2,3,79333,79334,79337,1,4,0
22656,3,3,79336,79337,79340,1,4,0
22657,1,2,79337,79340,79342,3,5,0
22658,5,3,79342,79342,79345,0,3,0
22659,3,3,79345,79345,79348,0,3,0
22660,1,1,79346,79348,79349,2,3,0
22661,4,2,79350,79350,79352,0,2,1
22662,5,2,79355,79355,79357,0,2,3
22663,4,3,79359,79359,79362,0,3,2
22664,4,3,79363,79363,79366,0,3,1
22665,6,3,79369,79369,79372,0,3,3
22666,6,1,79375,79375,79376,0,1,3
22667,1,1,79376,79376,79377,0,1,0
22668,4,3,79380,79380,79383,0,3,3
22669,5,3,79385,79385,79388,0,3,2
22670,2,1,79387,79388,79389,1,2,0
22671,3,2,79390,79390,79392,0,2,1
22672,3,2,79393,79393,79395,0,2,1
22673,3,2,79396,79396,79398,0,2,1
22674,2,1,79398,79398,79399,0,1,0
22675,5,1,79403,79403,79404,0,1,4
22676,2,2,79405,79405,79407,0,2,1
22677,4,2,79409,79409,79411,0,2,2
22678,2,1,79411,79411,79412,0,1,0
22679,4,1,79415,79415,79416,0,1,3
22680,6,1,79421,79421,79422,0,1,5
22681,4,1,79425,79425,79426,0,1,3
22682,3,1,79428,79428,79429,0,1,2
22683,5,1,79433,79433,79434,0,1,4
22684,5,2,79438,79438,79440,0,2,4
22685,2,2,79440,79440,79442,0,2,0
22686,6,3,79446,79446,79449,0,3,4
22687,6,1,79452,79452,79453,0,1,3
22688,6,1,79458,79458,79459,0,1,5
22689,3,3,79461,79461,79464,0,3,2
22690,4,1,79465,79465,79466,0,1,1
22691,2,1,79467,79467,79468,0,1,1
22692,3,1,79470,79470,79471,0,1,2
22693,6,2,79476,79476,79478,0,2,5
22694,2,2,79478,79478,79480,0,2,0
22695,3,2,79481,79481,79483,0,2,1
22696,6,2,79487,79487,79489,0,2,4
22697,1,1,79488,79489,79490,1,2,0
22698,5,2,79493,79493,79495,0,2,3
22699,6,2,79499,79499,79501,0,2,4
22700,3,2,79502,79502,79504,0,2,1
22701,3,1,79505,79505,79506,0,1,1
22702,2,1,79507,79507,79508,0,1,1
22703,2,3,79509,79509,79512,0,3,1
22704,6,3,79515,79515,79518,0,3,3
22705,3,3,79518,79518,79521,0,3,0
22706,6,3,79524,79524,79527,0,3,3
22707,2,1,79526,79527,79528,1,2,0
22708,1,1,79527,79528,79529,1,2,0
22709,2,1,79529,79529,79530,0,1,0
22710,6,2,79535,79535,79537,0,2,5
22711,1,3,79536,79537,79540,1,4,0
22712,1,2,79537,79540,79542,3,5,0
22713,2,2,79539,79542,79544,3,5,0
22714,5,1,79544,79544,79545,0,1,0
22715,6,1,79550,79550,79551,0,1,5
22716,5,3,79555,79555,79558,0,3,4
22717,5,2,79560,79560,79562,0,2,2
22718,4,2,79564,79564,79566,0,2,2
22719,4,2,79568,79568,79570,0,2,2
22720,6,2,79574,79574,79576,0,2,4
22721,5,2,79579,79579,79581,0,2,3
22722,6,3,79585,79585,79588,0,3,4
22723,3,2,79588,79588,79590,0,2,0
22724,2,1,79590,79590,79591,0,1,0
22725,2,1,79592,79592,79593,0,1,1
22726,1,1,79593,79593,79594,0,1,0
22727,4,2,79597,79597,79599,0,2,3
22728,6,3,79603,79603,79606,0,3,4
22729,1,2,79604,79606,79608,2,4,0
22730,5,1,79609,79609,79610,0,1,1
22731,1,2,79610,79610,79612,0,2,0
22732,5,3,79615,79615,79618,0,3,3
22733,1,1,79616,79618,79619,2,3,0
22734,6,3,79622,79622,79625,0,3,3
22735,2,3,79624,79625,79628,1,4,0
22736,6,1,79630,79630,79631,0,1,2
22737,4,3,79634,79634,79637,0,3,3
22738,6,2,79640,79640,79642,0,2,3
22739,1,1,79641,79642,79643,1,2,0
22740,5,2,79646,79646,79648,0,2,3
22741,2,3,79648,79648,79651,0,3,0
22742,1,3,79649,79651,79654,2,5,0
22743,2,3,79651,79654,79657,3,6,0
22744,6,3,79657,79657,79660,0,3,0
22745,3,1,79660,79660,79661,0,1,0
22746,2,1,79662,79662,79663,0,1,1
22747,2,2,79664,79664,79666,0,2,1
22748,3,1,79667,79667,79668,0,1,1
22749,3,2,79670,79670,79672,0,2,2
22750,5,3,79675,79675,79678,0,3,3
22751,4,2,79679,79679,79681,0,2,1
22752,2,2,79681,79681,79683,0,2,0
22753,2,2,79683,79683,79685,0,2,0
22754,1,2,79684,79685,79687,1,3,0
22755,6,3,79690,79690,79693,0,3,3
22756,3,3,79693,79693,79696,0,3,0
22757,3,2,79696,79696,79698,0,2,0
22758,6,2,79702,79702,79704,0,2,4
22759,1,1,79703,79704,79705,1,2,0
22760,1,2,79704,79705,79707,1,3,0
22761,2,2,79706,79707,79709,1,3,0
22762,6,3,79712,79712,79715,0,3,3
22763,4,1,79716,79716,79717,0,1,1
22764,2,1,79718,79718,79719,0,1,1
22765,5,2,79723,79723,79725,0,2,4
22766,2,3,79725,79725,79728,0,3,0
22767,5,1,79730,79730,79731,0,1,2
22768,1,1,79731,79731,79732,0,1,0
22769,6,1,79737,79737,79738,0,1,5
22770,5,3,79742,79742,79745,0,3,4
22771,4,1,79746,79746,79747,0,1,1
22772,2,1,79748,79748,79749,0,1,1
22773,4,3,79752,79752,79755,0,3,3
22774,3,3,79755,79755,79758,0,3,0
22775,6,1,79761,79761,79762,0,1,3
22776,6,1,79767,79767,79768,0,1,5
22777,1,2,79768,79768,79770,0,2,0
22778,5,3,79773,79773,79776,0,3,3
22779,6,2,79779,79779,79781,0,2,3
22780,5,1,79784,79784,79785,0,1,3
22781,1,2,79785,79785,79787,0,2,0
22782,4,3,79789,79789,79792,0,3,2
22783,6,2,79795,79795,79797,0,2,3
22784,1,3,79796,79797,79800,1,4,0
22785,5,2,79801,79801,79803,0,2,1
22786,2,1,79803,79803,79804,0,1,0
22787,6,3,79809,79809,79812,0,3,5
22788,1,3,79810,79812,79815,2,5,0
22789,2,1,79812,79815,79816,3,4,0
22790,4,1,79816,79816,79817,0,1,0
22791,3,3,79819,79819,79822,0,3,2
22792,5,3,79824,79824,79827,0,3,2
22793,4,3,79828,79828,79831,0,3,1
22794,1,2,79829,79831,79833,2,4,0
22795,2,3,79831,79833,79836,2,5,0
22796,3,2,79834,79836,79838,2,4,0
22797,4,2,79838,79838,79840,0,2,0
22798,3,2,79841,79841,79843,0,2,1
22799,2,1,79843,79843,79844,0,1,0
22800,4,1,79847,79847,79848,0,1,3
22801,4,1,79851,79851,79852,0,1,3
22802,5,2,79856,79856,79858,0,2,4
22803,2,2,79858,79858,79860,0,2,0
22804,5,3,79863,79863,79866,0,3,3
22805,3,1,79866,79866,79867,0,1,0
22806,6,2,79872,79872,79874,0,2,5
22807,2,3,79874,79874,79877,0,3,0
22808,6,1,79880,79880,79881,0,1,3
22809,6,1,79886,79886,79887,0,1,5
22810,2,2,79888,79888,79890,0,2,1
22811,6,1,79894,79894,79895,0,1,4
22812,2,1,79896,79896,79897,0,1,1
22813,5,2,79901,79901,79903,0,2,4
22814,2,1,79903,79903,79904,0,1,0
22815,4,1,79907,79907,79908,0,1,3
22816,3,1,79910,79910,79911,0,1,2
22817,2,2,79912,79912,79914,0,2,1
22818,3,1,79915,79915,79916,0,1,1
22819,6,1,79921,79921,79922,0,1,5
22820,3,2,79924,79924,79926,0,2,2
22821,6,3,79930,79930,79933,0,3,4
22822,2,1,79932,79933,79934,1,2,0
22823,6,1,79938,79938,79939,0,1,4
22824,2,1,79940,79940,79941,0,1,1
22825,4,1,79944,79944,79945,0,1,3
22826,3,3,79947,79947,79950,0,3,2
22827,3,3,79950,79950,79953,0,3,0
22828,5,3,79955,79955,79958,0,3,2
22829,6,3,79961,79961,79964,0,3,3
22830,6,1,79967,79967,79968,0,1,3
22831,3,1,79970,79970,79971,0,1,2
22832,5,3,79975,79975,79978,0,3,4
22833,4,1,79979,79979,79980,0,1,1
22834,6,3,79985,79985,79988,0,3,5
22835,4,3,79989,79989,79992,0,3,1
22836,4,1,79993,79993,79994,0,1,1
22837,6,3,79999,79999,80002,0,3,5
22838,2,3,80001,80002,80005,1,4,0
22839,6,1,80007,80007,80008,0,1,2
22840,1,3,80008,80008,80011,0,3,0
22841,1,2,80009,80011,80013,2,4,0
22842,1,1,80010,80013,80014,3,4,0
22843,2,1,80012,80014,80015,2,3,0
22844,3,2,80015,80015,80017,0,2,0
22845,2,3,80017,80017,80020,0,3,0
22846,4,1,80021,80021,80022,0,1,1
22847,3,3,80024,80024,80027,0,3,2
22848,6,2,80030,80030,80032,0,2,3
22849,4,2,80034,80034,80036,0,2,2
22850,5,3,80039,80039,80042,0,3,3
22851,6,2,80045,80045,80047,0,2,3
22852,5,3,80050,80050,80053,0,3,3
22853,3,3,80053,80053,80056,0,3,0
22854,2,1,80055,80056,80057,1,2,0
22855,3,3,80058,80058,80061,0,3,1
22856,3,2,80061,80061,80063,0,2,0
22857,6,2,80067,80067,80069,0,2,4
22858,5,1,80072,80072,80073,0,1,3
22859,3,3,80075,80075,80078,0,3,2
22860,5,3,80080,80080,80083,0,3,2
22861,6,1,80086,80086,80087,0,1,3
22862,1,3,80087,80087,80090,0,3,0
22863,2,3,80089,80090,80093,1,4,0
22864,2,2,80091,80093,80095,2,4,0
22865,6,1,80097,80097,80098,0,1,2
22866,5,1,80102,80102,80103,0,1,4
22867,3,3,80105,80105,80108,0,3,2
22868,2,2,80107,80108,80110,1,3,0
22869,4,1,80111,80111,80112,0,1,1
22870,4,1,80115,80115,80116,0,1,3
22871,5,1,80120,80120,80121,0,1,4
22872,4,2,80124,80124,80126,0,2,3
22873,1,2,80125,80126,80128,1,3,0
22874,2,1,80127,80128,80129,1,2,0
22875,1,3,80128,80129,80132,1,4,0
22876,1,3,80129,80132,80135,3,6,0
22877,3,3,80132,80135,80138,3,6,0
22878,4,1,80136,80138,80139,2,3,0
22879,1,1,80137,80139,80140,2,3,0
22880,1,3,80138,80140,80143,2,5,0
22881,5,3,80143,80143,80146,0,3,0
22882,5,1,80148,80148,80149,0,1,2
22883,3,2,80151,80151,80153,0,2,2
22884,5,2,80156,80156,80158,0,2,3
22885,4,2,80160,80160,80162,0,2,2
22886,3,2,80163,80163,80165,0,2,1
22887,5,1,80168,80168,80169,0,1,3
22888,6,1,80174,80174,80175,0,1,5
22889,3,3,80177,80177,80180,0,3,2
22890,1,2,80178,80180,80182,2,4,0
22891,4,3,80182,80182,80185,0,3,0
22892,2,2,80184,80185,80187,1,3,0
22893,1,2,80185,80187,80189,2,4,0
22894,5,3,80190,80190,80193,0,3,1
22895,5,2,80195,80195,80197,0,2,2
22896,4,2,80199,80199,80201,0,2,2
22897,3,2,80202,80202,80204,0,2,1
22898,5,2,80207,80207,80209,0,2,3
22899,6,3,80213,80213,80216,0,3,4
22900,4,1,80217,80217,80218,0,1,1
22901,2,3,80219,80219,80222,0,3,1
22902,2,2,80221,80222,80224,1,3,0
22903,4,1,80225,80225,80226,0,1,1
22904,4,3,80229,80229,80232,0,3,3
22905,1,2,80230,80232,80234,2,4,0
22906,6,1,80236,80236,80237,0,1,2
22907,5,1,80241,80241,80242,0,1,4
22908,3,1,80244,80244,80245,0,1,2
22909,1,1,80245,80245,80246,0,1,0
22910,3,3,80248,80248,80251,0,3,2
22911,2,2,80250,80251,80253,1,3,0
22912,4,3,80254,80254,80257,0,3,1
22913,4,1,80258,80258,80259,0,1,1
22914,6,2,80264,80264,80266,0,2,5
22915,6,2,80270,80270,80272,0,2,4
22916,2,3,80272,80272,80275,0,3,0
22917,3,3,80275,80275,80278,0,3,0
22918,4,3,80279,80279,80282,0,3,1
22919,2,2,80281,80282,80284,1,3,0
22920,4,2,80285,80285,80287,0,2,1
22921,1,1,80286,80287,80288,1,2,0
22922,4,3,80290,80290,80293,0,3,2
22923,6,3,80296,80296,80299,0,3,3
22924,3,3,80299,80299,80302,0,3,0
22925,6,3,80305,80305,80308,0,3,3
22926,3,2,80308,80308,80310,0,2,0
22927,2,3,80310,80310,80313,0,3,0
22928,1,2,80311,80313,80315,2,4,0
22929,6,3,80317,80317,80320,0,3,2
22930,2,3,80319,80320,80323,1,4,0
22931,4,1,80323,80323,80324,0,1,0
22932,4,1,80327,80327,80328,0,1,3
22933,6,3,80333,80333,80336,0,3,5
22934,3,3,80336,80336,80339,0,3,0
22935,2,2,80338,80339,80341,1,3,0
22936,6,2,80344,80344,80346,0,2,3
22937,3,2,80347,80347,80349,0,2,1
22938,5,2,80352,80352,80354,0,2,3
22939,2,1,80354,80354,80355,0,1,0
22940,1,3,80355,80355,80358,0,3,0
22941,2,2,80357,80358,80360,1,3,0
22942,5,2,80362,80362,80364,0,2,2
22943,5,2,80367,80367,80369,0,2,3
22944,4,2,80371,80371,80373,0,2,2
22945,4,2,80375,80375,80377,0,2,2
22946,6,3,80381,80381,80384,0,3,4
22947,2,3,80383,80384,80387,1,4,0
22948,3,3,80386,80387,80390,1,4,0
22949,4,3,80390,80390,80393,0,3,0
22950,1,1,80391,80393,80394,2,3,0
22951,6,3,80397,80397,80400,0,3,3
22952,4,1,80401,80401,80402,0,1,1
22953,3,3,80404,80404,80407,0,3,2
22954,6,3,80410,80410,80413,0,3,3
22955,4,1,80414,80414,80415,0,1,1
22956,2,3,80416,80416,80419,0,3,1
22957,2,3,80418,80419,80422,1,4,0
22958,1,3,80419,80422,80425,3,6,0
22959,3,2,80422,80425,80427,3,5,0
22960,4,3,80426,80427,80430,1,4,0
22961,4,1,80430,80430,80431,0,1,0
22962,6,2,80436,80436,80438,0,2,5
22963,6,3,80442,80442,80445,0,3,4
22964,6,1,80448,80448,80449,0,1,3
22965,4,1,80452,80452,80453,0,1,3
22966,1,3,80453,80453,80456,0,3,0
22967,1,2,80454,80456,80458,2,4,0
22968,1,2,80455,80458,80460,3,5,0
22969,6,2,80461,80461,80463,0,2,1
22970,6,1,80467,80467,80468,0,1,4
22971,1,1,80468,80468,80469,0,1,0
22972,1,1,80469,80469,80470,0,1,0
22973,5,2,80474,80474,80476,0,2,4
22974,4,2,80478,80478,80480,0,2,2
22975,3,3,80481,80481,80484,0,3,1
22976,6,1,80487,80487,80488,0,1,3
22977,1,1,80488,80488,80489,0,1,0
22978,2,2,80490,80490,80492,0,2,1
22979,2,2,80492,80492,80494,0,2,0
22980,1,2,80493,80494,80496,1,3,0
22981,5,1,80498,80498,80499,0,1,2
22982,1,2,80499,80499,80501,0,2,0
22983,2,3,80501,80501,80504,0,3,0
22984,1,3,80502,80504,80507,2,5,0
22985,1,3,80503,80507,80510,4,7,0
22986,6,1,80509,80510,80511,1,2,0
22987,2,2,80511,80511,80513,0,2,0
22988,6,2,80517,80517,80519,0,2,4
22989,1,2,80518,80519,80521,1,3,0
22990,3,3,80521,80521,80524,0,3,0
22991,1,2,80522,80524,80526,2,4,0
22992,6,1,80528,80528,80529,0,1,2
22993,1,1,80529,80529,80530,0,1,0
22994,2,3,80531,80531,80534,0,3,1
22995,2,3,80533,80534,80537,1,4,0
22996,4,2,80537,80537,80539,0,2,0
22997,4,3,80541,80541,80544,0,3,2
22998,2,2,80543,80544,80546,1,3,0
22999,2,1,80545,80546,80547,1,2,0
23000,6,3,80551,80551,80554,0,3,4
23001,2,1,80553,80554,80555,1,2,0
23002,4,3,80557,80557,80560,0,3,2
23003,4,1,80561,80561,80562,0,1,1
23004,5,1,80566,80566,80567,0,1,4
23005,2,3,80568,80568,80571,0,3,1
23006,1,1,80569,80571,80572,2,3,0
23007,4,1,80573,80573,80574,0,1,1
23008,3,2,80576,80576,80578,0,2,2
23009,6,1,80582,80582,80583,0,1,4
23010,4,2,80586,80586,80588,0,2,3
23011,2,3,80588,80588,80591,0,3,0
23012,6,3,80594,80594,80597,0,3,3
23013,2,1,80596,80597,80598,1,2,0
23014,4,1,80600,80600,80601,0,1,2
23015,5,1,80605,80605,80606,0,1,4
23016,1,1,80606,80606,80607,0,1,0
23017,6,1,80612,80612,80613,0,1,5
23018,3,3,80615,80615,80618,0,3,2
23019,3,2,80618,80618,80620,0,2,0
23020,5,3,80623,80623,80626,0,3,3
23021,3,1,80626,80626,80627,0,1,0
23022,2,2,80628,80628,80630,0,2,1
23023,2,1,80630,80630,80631,0,1,0
23024,1,1,80631,80631,80632,0,1,0
23025,5,2,80636,80636,80638,0,2,4
23026,5,1,80641,80641,80642,0,1,3
23027,5,2,80646,80646,80648,0,2,4
23028,1,2,80647,80648,80650,1,3,0
23029,5,2,80652,80652,80654,0,2,2
23030,2,1,80654,80654,80655,0,1,0
23031,3,2,80657,80657,80659,0,2,2
23032,3,1,80660,80660,80661,0,1,1
23033,5,2,80665,80665,80667,0,2,4
23034,5,2,80670,80670,80672,0,2,3
23035,6,1,80676,80676,80677,0,1,4
23036,3,3,80679,80679,80682,0,3,2
23037,3,3,80682,80682,80685,0,3,0
23038,4,2,80686,80686,80688,0,2,1
23039,5,2,80691,80691,80693,0,2,3
23040,2,3,80693,80693,80696,0,3,0
23041,4,2,80697,80697,80699,0,2,1
23042,2,2,80699,80699,80701,0,2,0
23043,1,3,80700,80701,80704,1,4,0
23044,5,2,80705,80705,80707,0,2,1
23045,3,2,80708,80708,80710,0,2,1
23046,6,3,80714,80714,80717,0,3,4
23047,4,3,80718,80718,80721,0,3,1
23048,3,2,80721,80721,80723,0,2,0
23049,2,3,80723,80723,80726,0,3,0
23050,5,3,80728,80728,80731,0,3,2
23051,5,2,80733,80733,80735,0,2,2
23052,6,2,80739,80739,80741,0,2,4
23053,2,3,80741,80741,80744,0,3,0
23054,4,3,80745,80745,80748,0,3,1
23055,2,1,80747,80748,80749,1,2,0
23056,3,3,80750,80750,80753,0,3,1
23057,6,3,80756,80756,80759,0,3,3
23058,4,2,80760,80760,80762,0,2,1
23059,1,3,80761,80762,80765,1,4,0
23060,4,2,80765,80765,80767,0,2,0
23061,6,2,80771,80771,80773,0,2,4
23062,1,2,80772,80773,80775,1,3,0
23063,2,2,80774,80775,80777,1,3,0
23064,6,1,80780,80780,80781,0,1,3
23065,2,1,80782,80782,80783,0,1,1
23066,6,3,80788,80788,80791,0,3,5
23067,6,3,80794,80794,80797,0,3,3
23068,2,1,80796,80797,80798,1,2,0
23069,5,2,80801,80801,80803,0,2,3
23070,2,1,80803,80803,80804,0,1,0
23071,3,2,80806,80806,80808,0,2,2
23072,1,3,80807,80808,80811,1,4,0
23073,6,3,80813,80813,80816,0,3,2
23074,4,1,80817,80817,80818,0,1,1
23075,6,1,80823,80823,80824,0,1,5
23076,2,1,80825,80825,80826,0,1,1
23077,4,1,80829,80829,80830,0,1,3
23078,3,2,80832,80832,80834,0,2,2
23079,5,2,80837,80837,80839,0,2,3
23080,4,3,80841,80841,80844,0,3,2
23081,4,1,80845,80845,80846,0,1,1
23082,1,3,80846,80846,80849,0,3,0
23083,1,3,80847,80849,80852,2,5,0
23084,3,1,80850,80852,80853,2,3,0
23085,2,3,80852,80853,80856,1,4,0
23086,4,1,80856,80856,80857,0,1,0
23087,1,1,80857,80857,80858,0,1,0
23088,4,1,80861,80861,80862,0,1,3
23089,5,3,80866,80866,80869,0,3,4
23090,1,1,80867,80869,80870,2,3,0
23091,2,1,80869,80870,80871,1,2,0
23092,4,1,80873,80873,80874,0,1,2
23093,4,3,80877,80877,80880,0,3,3
23094,4,3,80881,80881,80884,0,3,1
23095,6,2,80887,80887,80889,0,2,3
23096,3,3,80890,80890,80893,0,3,1
23097,3,3,80893,80893,80896,0,3,0
23098,2,3,80895,80896,80899,1,4,0
23099,5,1,80900,80900,80901,0,1,1
23100,5,3,80905,80905,80908,0,3,4
23101,4,1,80909,80909,80910,0,1,1
23102,4,2,80913,80913,80915,0,2,3
23103,1,3,80914,80915,80918,1,4,0
23104,2,3,80916,80918,80921,2,5,0
23105,1,3,80917,80921,80924,4,7,0
23106,5,3,80922,80924,80927,2,5,0
23107,5,2,80927,80927,80929,0,2,0
23108,4,2,80931,80931,80933,0,2,2
23109,6,1,80937,80937,80938,0,1,4
23110,5,1,80942,80942,80943,0,1,4
23111,5,2,80947,80947,80949,0,2,4
23112,4,1,80951,80951,80952,0,1,2
23113,1,3,80952,80952,80955,0,3,0
23114,5,1,80957,80957,80958,0,1,2
23115,4,2,80961,80961,80963,0,2,3
23116,1,1,80962,80963,80964,1,2,0
23117,6,2,80968,80968,80970,0,2,4
23118,1,2,80969,80970,80972,1,3,0
23119,5,2,80974,80974,80976,0,2,2
23120,1,1,80975,80976,80977,1,2,0
23121,4,3,80979,80979,80982,0,3,2
23122,5,3,80984,80984,80987,0,3,2
23123,4,3,80988,80988,80991,0,3,1
23124,6,3,80994,80994,80997,0,3,3
23125,2,3,80996,80997,81000,1,4,0
23126,5,1,81001,81001,81002,0,1,1
23127,2,3,81003,81003,81006,0,3,1
23128,1,2,81004,81006,81008,2,4,0
23129,3,2,81007,81008,81010,1,3,0
23130,5,3,81012,81012,81015,0,3,2
23131,3,1,81015,81015,81016,0,1,0
23132,1,1,81016,81016,81017,0,1,0
23133,4,1,81020,81020,81021,0,1,3
23134,5,3,81025,81025,81028,0,3,4
23135,3,2,81028,81028,81030,0,2,0
23136,2,2,81030,81030,81032,0,2,0
23137,4,3,81034,81034,81037,0,3,2
23138,2,3,81036,81037,81040,1,4,0
23139,2,3,81038,81040,81043,2,5,0
23140,3,1,81041,81043,81044,2,3,0
23141,5,1,81046,81046,81047,0,1,2
23142,2,1,81048,81048,81049,0,1,1
23143,3,1,81051,81051,81052,0,1,2
23144,6,3,81057,81057,81060,0,3,5
23145,1,3,81058,81060,81063,2,5,0
23146,5,2,81063,81063,81065,0,2,0
23147,4,2,81067,81067,81069,0,2,2
23148,6,2,81073,81073,81075,0,2,4
23149,2,3,81075,81075,81078,0,3,0
23150,5,3,81080,81080,81083,0,3,2
23151,1,3,81081,81083,81086,2,5,0
23152,2,1,81083,81086,81087,3,4,0
23153,3,1,81086,81087,81088,1,2,0
23154,3,1,81089,81089,81090,0,1,1
23155,3,1,81092,81092,81093,0,1,2
23156,4,2,81096,81096,81098,0,2,3
23157,6,3,81102,81102,81105,0,3,4
23158,1,1,81103,81105,81106,2,3,0
23159,4,3,81107,81107,81110,0,3,1
23160,3,2,81110,81110,81112,0,2,0
23161,2,2,81112,81112,81114,0,2,0
23162,4,2,81116,81116,81118,0,2,2
23163,6,2,81122,81122,81124,0,2,4
23164,1,1,81123,81124,81125,1,2,0
23165,2,1,81125,81125,81126,0,1,0
23166,2,1,81127,81127,81128,0,1,1
23167,2,2,81129,81129,81131,0,2,1
23168,5,1,81134,81134,81135,0,1,3
23169,2,2,81136,81136,81138,0,2,1
23170,2,3,81138,81138,81141,0,3,0
23171,5,1,81143,81143,81144,0,1,2
23172,3,2,81146,81146,81148,0,2,2
23173,6,2,81152,81152,81154,0,2,4
23174,2,3,81154,81154,81157,0,3,0
23175,1,2,81155,81157,81159,2,4,0
23176,5,2,81160,81160,81162,0,2,1
23177,1,3,81161,81162,81165,1,4,0
23178,2,2,81163,81165,81167,2,4,0
23179,4,3,81167,81167,81170,0,3,0
23180,5,1,81172,81172,81173,0,1,2
23181,6,1,81178,81178,81179,0,1,5
23182,6,2,81184,81184,81186,0,2,5
23183,3,2,81187,81187,81189,0,2,1
23184,4,2,81191,81191,81193,0,2,2
23185,6,2,81197,81197,81199,0,2,4
23186,1,3,81198,81199,81202,1,4,0
23187,5,3,81203,81203,81206,0,3,1
23188,2,3,81205,81206,81209,1,4,0
23189,6,3,81211,81211,81214,0,3,2
23190,2,1,81213,81214,81215,1,2,0
23191,4,1,81217,81217,81218,0,1,2
23192,2,1,81219,81219,81220,0,1,1
23193,1,1,81220,81220,81221,0,1,0
23194,3,3,81223,81223,81226,0,3,2
23195,2,1,81225,81226,81227,1,2,0
23196,3,1,81228,81228,81229,0,1,1
23197,4,3,81232,81232,81235,0,3,3
23198,6,1,81238,81238,81239,0,1,3
23199,4,2,81242,81242,81244,0,2,3
23200,6,3,81248,81248,81251,0,3,4
23201,1,2,81249,81251,81253,2,4,0
23202,3,2,81252,81253,81255,1,3,0
23203,4,3,81256,81256,81259,0,3,1
23204,4,3,81260,81260,81263,0,3,1
23205,6,2,81266,81266,81268,0,2,3
23206,2,2,81268,81268,81270,0,2,0
23207,3,1,81271,81271,81272,0,1,1
23208,4,3,81275,81275,81278,0,3,3
23209,5,3,81280,81280,81283,0,3,2
23210,1,1,81281,81283,81284,2,3,0
23211,4,3,81285,81285,81288,0,3,1
23212,5,2,81290,81290,81292,0,2,2
23213,2,3,81292,81292,81295,0,3,0
23214,4,2,81296,81296,81298,0,2,1
23215,4,3,81300,81300,81303,0,3,2
23216,3,1,81303,81303,81304,0,1,0
23217,1,3,81304,81304,81307,0,3,0
23218,5,2,81309,81309,81311,0,2,2
23219,4,3,81313,81313,81316,0,3,2
23220,1,2,81314,81316,81318,2,4,0
23221,1,2,81315,81318,81320,3,5,0
23222,2,1,81317,81320,81321,3,4,0
23223,4,2,81321,81321,81323,0,2,0
23224,1,2,81322,81323,81325,1,3,0
23225,6,1,81328,81328,81329,0,1,3
23226,2,3,81330,81330,81333,0,3,1
23227,5,3,81335,81335,81338,0,3,2
23228,5,2,81340,81340,81342,0,2,2
23229,6,3,81346,81346,81349,0,3,4
23230,5,2,81351,81351,81353,0,2,2
23231,3,1,81354,81354,81355,0,1,1
23232,1,2,81355,81355,81357,0,2,0
23233,2,3,81357,81357,81360,0,3,0
23234,5,3,81362,81362,81365,0,3,2
23235,6,1,81368,81368,81369,0,1,3
23236,5,3,81373,81373,81376,0,3,4
23237,4,2,81377,81377,81379,0,2,1
23238,3,1,81380,81380,81381,0,1,1
23239,1,3,81381,81381,81384,0,3,0
23240,3,1,81384,81384,81385,0,1,0
23241,2,1,81386,81386,81387,0,1,1
23242,3,3,81389,81389,81392,0,3,2
23243,6,1,81395,81395,81396,0,1,3
23244,5,3,81400,81400,81403,0,3,4
23245,1,1,81401,81403,81404,2,3,0
23246,6,1,81407,81407,81408,0,1,3
23247,1,2,81408,81408,81410,0,2,0
23248,4,1,81412,81412,81413,0,1,2
23249,3,2,81415,81415,81417,0,2,2
23250,3,2,81418,81418,81420,0,2,1
23251,5,2,81423,81423,81425,0,2,3
23252,3,3,81426,81426,81429,0,3,1
23253,2,1,81428,81429,81430,1,2,0
23254,4,1,81432,81432,81433,0,1,2
23255,1,2,81433,81433,81435,0,2,0
23256,6,1,81439,81439,81440,0,1,4
23257,3,2,81442,81442,81444,0,2,2
23258,2,1,81444,81444,81445,0,1,0
23259,4,3,81448,81448,81451,0,3,3
23260,5,3,81453,81453,81456,0,3,2
23261,5,3,81458,81458,81461,0,3,2
23262,4,2,81462,81462,81464,0,2,1
23263,2,3,81464,81464,81467,0,3,0
23264,1,1,81465,81467,81468,2,3,0
23265,2,1,81467,81468,81469,1,2,0
23266,1,3,81468,81469,81472,1,4,0
23267,5,1,81473,81473,81474,0,1,1
23268,6,1,81479,81479,81480,0,1,5
23269,2,1,81481,81481,81482,0,1,1
23270,4,1,81485,81485,81486,0,1,3
23271,5,3,81490,81490,81493,0,3,4
23272,6,1,81496,81496,81497,0,1,3
23273,2,2,81498,81498,81500,0,2,1
23274,5,3,81503,81503,81506,0,3,3
23275,1,1,81504,81506,81507,2,3,0
23276,3,1,81507,81507,81508,0,1,0
23277,2,2,81509,81509,81511,0,2,1
23278,2,1,81511,81511,81512,0,1,0
23279,1,2,81512,81512,81514,0,2,0
23280,2,3,81514,81514,81517,0,3,0
23281,6,3,81520,81520,81523,0,3,3
23282,6,2,81526,81526,81528,0,2,3
23283,2,2,81528,81528,81530,0,2,0
23284,5,2,81533,81533,81535,0,2,3
23285,6,3,81539,81539,81542,0,3,4
23286,4,3,81543,81543,81546,0,3,1
23287,1,2,81544,81546,81548,2,4,0
23288,4,1,81548,81548,81549,0,1,0
23289,1,2,81549,81549,81551,0,2,0
23290,5,3,81554,81554,81557,0,3,3
23291,2,2,81556,81557,81559,1,3,0
23292,3,3,81559,81559,81562,0,3,0
23293,6,2,81565,81565,81567,0,2,3
23294,3,3,81568,81568,81571,0,3,1
23295,2,2,81570,81571,81573,1,3,0
23296,5,2,81575,81575,81577,0,2,2
23297,6,1,81581,81581,81582,0,1,4
23298,6,1,81587,81587,81588,0,1,5
23299,1,2,81588,81588,81590,0,2,0
23300,6,2,81594,81594,81596,0,2,4
23301,6,1,81600,81600,81601,0,1,4
23302,4,1,81604,81604,81605,0,1,3
23303,3,2,81607,81607,81609,0,2,2
23304,6,1,81613,81613,81614,0,1,4
23305,2,1,81615,81615,81616,0,1,1
23306,6,2,81621,81621,81623,0,2,5
23307,5,1,81626,81626,81627,0,1,3
23308,6,2,81632,81632,81634,0,2,5
23309,2,1,81634,81634,81635,0,1,0
23310,1,1,81635,81635,81636,0,1,0
23311,4,2,81639,81639,81641,0,2,3
23312,4,2,81643,81643,81645,0,2,2
23313,4,3,81647,81647,81650,0,3,2
23314,5,3,81652,81652,81655,0,3,2
23315,1,2,81653,81655,81657,2,4,0
23316,6,2,81659,81659,81661,0,2,2
23317,4,1,81663,81663,81664,0,1,2
23318,3,2,81666,81666,81668,0,2,2
23319,2,1,81668,81668,81669,0,1,0
23320,2,1,81670,81670,81671,0,1,1
23321,1,2,81671,81671,81673,0,2,0
23322,3,1,81674,81674,81675,0,1,1
23323,4,2,81678,81678,81680,0,2,3
23324,1,1,81679,81680,81681,1,2,0
23325,1,2,81680,81681,81683,1,3,0
23326,2,3,81682,81683,81686,1,4,0
23327,6,2,81688,81688,81690,0,2,2
23328,2,3,81690,81690,81693,0,3,0
23329,1,1,81691,81693,81694,2,3,0
23330,1,2,81692,81694,81696,2,4,0
23331,3,1,81695,81696,81697,1,2,0
23332,2,2,81697,81697,81699,0,2,0
23333,6,2,81703,81703,81705,0,2,4
23334,4,1,81707,81707,81708,0,1,2
23335,1,1,81708,81708,81709,0,1,0
23336,5,2,81713,81713,81715,0,2,4
23337,3,3,81716,81716,81719,0,3,1
23338,3,1,81719,81719,81720,0,1,0
23339,1,1,81720,81720,81721,0,1,0
23340,4,2,81724,81724,81726,0,2,3
23341,5,3,81729,81729,81732,0,3,3
23342,4,3,81733,81733,81736,0,3,1
23343,1,2,81734,81736,81738,2,4,0
23344,2,2,81736,81738,81740,2,4,0
23345,5,2,81741,81741,81743,0,2,1
23346,4,1,81745,81745,81746,0,1,2
23347,1,3,81746,81746,81749,0,3,0
23348,4,3,81750,81750,81753,0,3,1
23349,3,1,81753,81753,81754,0,1,0
23350,4,1,81757,81757,81758,0,1,3
23351,1,2,81758,81758,81760,0,2,0
23352,1,2,81759,81760,81762,1,3,0
23353,6,3,81765,81765,81768,0,3,3
23354,1,2,81766,81768,81770,2,4,0
23355,3,2,81769,81770,81772,1,3,0
23356,6,3,81775,81775,81778,0,3,3
23357,2,1,81777,81778,81779,1,2,0
23358,3,2,81780,81780,81782,0,2,1
23359,1,1,81781,81782,81783,1,2,0
23360,1,2,81782,81783,81785,1,3,0
23361,2,1,81784,81785,81786,1,2,0
23362,1,3,81785,81786,81789,1,4,0
23363,6,2,81791,81791,81793,0,2,2
23364,4,1,81795,81795,81796,0,1,2
23365,1,1,81796,81796,81797,0,1,0
23366,3,1,81799,81799,81800,0,1,2
23367,5,2,81804,81804,81806,0,2,4
23368,4,2,81808,81808,81810,0,2,2
23369,1,2,81809,81810,81812,1,3,0
23370,3,1,81812,81812,81813,0,1,0
23371,6,1,81818,81818,81819,0,1,5
23372,1,2,81819,81819,81821,0,2,0
23373,2,3,81821,81821,81824,0,3,0
23374,4,3,81825,81825,81828,0,3,1
23375,3,2,81828,81828,81830,0,2,0
23376,6,1,81834,81834,81835,0,1,4
23377,1,3,81835,81835,81838,0,3,0
23378,1,1,81836,81838,81839,2,3,0
23379,3,3,81839,81839,81842,0,3,0
23380,6,3,81845,81845,81848,0,3,3
23381,2,1,81847,81848,81849,1,2,0
23382,4,2,81851,81851,81853,0,2,2
23383,2,1,81853,81853,81854,0,1,0
23384,3,1,81856,81856,81857,0,1,2
23385,5,2,81861,81861,81863,0,2,4
23386,2,2,81863,81863,81865,0,2,0
23387,2,2,81865,81865,81867,0,2,0
23388,4,2,81869,81869,81871,0,2,2
23389,6,2,81875,81875,81877,0,2,4
23390,6,1,81881,81881,81882,0,1,4
23391,4,3,81885,81885,81888,0,3,3
23392,3,3,81888,81888,81891,0,3,0
23393,3,2,81891,81891,81893,0,2,0
23394,1,3,81892,81893,81896,1,4,0
23395,6,1,81898,81898,81899,0,1,2
23396,1,3,81899,81899,81902,0,3,0
23397,5,2,81904,81904,81906,0,2,2
23398,5,3,81909,81909,81912,0,3,3
23399,3,1,81912,81912,81913,0,1,0
23400,6,2,81918,81918,81920,0,2,5
23401,5,1,81923,81923,81924,0,1,3
23402,1,2,81924,81924,81926,0,2,0
23403,6,2,81930,81930,81932,0,2,4
23404,1,1,81931,81932,81933,1,2,0
23405,1,2,81932,81933,81935,1,3,0
23406,1,2,81933,81935,81937,2,4,0
23407,4,1,81937,81937,81938,0,1,0
23408,5,3,81942,81942,81945,0,3,4
23409,5,1,81947,81947,81948,0,1,2
23410,1,1,81948,81948,81949,0,1,0
23411,1,3,81949,81949,81952,0,3,0
23412,3,1,81952,81952,81953,0,1,0
23413,5,3,81957,81957,81960,0,3,4
23414,5,2,81962,81962,81964,0,2,2
23415,4,1,81966,81966,81967,0,1,2
23416,3,2,81969,81969,81971,0,2,2
23417,6,3,81975,81975,81978,0,3,4
23418,1,2,81976,81978,81980,2,4,0
23419,2,3,81978,81980,81983,2,5,0
23420,3,3,81981,81983,81986,2,5,0
23421,1,3,81982,81986,81989,4,7,0
23422,5,3,81987,81989,81992,2,5,0
23423,6,2,81993,81993,81995,0,2,1
23424,5,2,81998,81998,82000,0,2,3
23425,4,2,82002,82002,82004,0,2,2
23426,4,1,82006,82006,82007,0,1,2
23427,3,1,82009,82009,82010,0,1,2
23428,1,3,82010,82010,82013,0,3,0
23429,5,2,82015,82015,82017,0,2,2
23430,5,2,82020,82020,82022,0,2,3
23431,1,2,82021,82022,82024,1,3,0
23432,4,1,82025,82025,82026,0,1,1
23433,5,2,82030,82030,82032,0,2,4
23434,1,1,82031,82032,82033,1,2,0
23435,2,2,82033,82033,82035,0,2,0
23436,4,1,82037,82037,82038,0,1,2
23437,4,3,82041,82041,82044,0,3,3
23438,5,2,82046,82046,82048,0,2,2
23439,1,3,82047,82048,82051,1,4,0
23440,3,1,82050,82051,82052,1,2,0
23441,4,2,82054,82054,82056,0,2,2
23442,3,1,82057,82057,82058,0,1,1
23443,5,3,82062,82062,82065,0,3,4
23444,1,3,82063,82065,82068,2,5,0
23445,4,1,82067,82068,82069,1,2,0
23446,3,1,82070,82070,82071,0,1,1
23447,5,2,82075,82075,82077,0,2,4
23448,5,3,82080,82080,82083,0,3,3
23449,2,2,82082,82083,82085,1,3,0
23450,2,2,82084,82085,82087,1,3,0
23451,6,2,82090,82090,82092,0,2,3
23452,5,3,82095,82095,82098,0,3,3
23453,5,3,82100,82100,82103,0,3,2
23454,4,3,82104,82104,82107,0,3,1
23455,3,3,82107,82107,82110,0,3,0
23456,6,2,82113,82113,82115,0,2,3
23457,2,2,82115,82115,82117,0,2,0
23458,6,3,82121,82121,82124,0,3,4
23459,5,2,82126,82126,82128,0,2,2
23460,5,3,82131,82131,82134,0,3,3
23461,2,3,82133,82134,82137,1,4,0
23462,3,2,82136,82137,82139,1,3,0
23463,1,3,82137,82139,82142,2,5,0
23464,4,2,82141,82142,82144,1,3,0
23465,6,2,82147,82147,82149,0,2,3
23466,5,3,82152,82152,82155,0,3,3
23467,6,2,82158,82158,82160,0,2,3
23468,1,3,82159,82160,82163,1,4,0
23469,3,3,82162,82163,82166,1,4,0
23470,1,3,82163,82166,82169,3,6,0
23471,4,3,82167,82169,82172,2,5,0
23472,3,3,82170,82172,82175,2,5,0
23473,1,2,82171,82175,82177,4,6,0
23474,5,3,82176,82177,82180,1,4,0
23475,6,3,82182,82182,82185,0,3,2
23476,3,3,82185,82185,82188,0,3,0
23477,4,3,82189,82189,82192,0,3,1
23478,1,3,82190,82192,82195,2,5,0
23479,3,2,82193,82195,82197,2,4,0
23480,1,1,82194,82197,82198,3,4,0
23481,5,3,82199,82199,82202,0,3,1
23482,1,2,82200,82202,82204,2,4,0
23483,6,2,82206,82206,82208,0,2,2
23484,3,3,82209,82209,82212,0,3,1
23485,1,1,82210,82212,82213,2,3,0
23486,2,1,82212,82213,82214,1,2,0
23487,4,3,82216,82216,82219,0,3,2
23488,2,2,82218,82219,82221,1,3,0
23489,4,1,82222,82222,82223,0,1,1
23490,2,2,82224,82224,82226,0,2,1
23491,3,1,82227,82227,82228,0,1,1
23492,5,3,82232,82232,82235,0,3,4
23493,2,3,82234,82235,82238,1,4,0
23494,5,1,82239,82239,82240,0,1,1
23495,3,2,82242,82242,82244,0,2,2
23496,2,1,82244,82244,82245,0,1,0
23497,1,2,82245,82245,82247,0,2,0
23498,5,1,82250,82250,82251,0,1,3
23499,3,2,82253,82253,82255,0,2,2
23500,5,2,82258,82258,82260,0,2,3
23501,2,3,82260,82260,82263,0,3,0
23502,2,1,82262,82263,82264,1,2,0
23503,1,3,82263,82264,82267,1,4,0
23504,6,2,82269,82269,82271,0,2,2
23505,4,3,82273,82273,82276,0,3,2
23506,4,3,82277,82277,82280,0,3,1
23507,5,1,82282,82282,82283,0,1,2
23508,5,3,82287,82287,82290,0,3,4
23509,5,2,82292,82292,82294,0,2,2
23510,3,1,82295,82295,82296,0,1,1
23511,5,3,82300,82300,82303,0,3,4
23512,2,3,82302,82303,82306,1,4,0
23513,5,1,82307,82307,82308,0,1,1
23514,2,2,82309,82309,82311,0,2,1
23515,1,1,82310,82311,82312,1,2,0
23516,3,2,82313,82313,82315,0,2,1
23517,5,3,82318,82318,82321,0,3,3
23518,2,1,82320,82321,82322,1,2,0
23519,3,1,82323,82323,82324,0,1,1
23520,6,1,82329,82329,82330,0,1,5
23521,1,3,82330,82330,82333,0,3,0
23522,5,3,82335,82335,82338,0,3,2
23523,1,3,82336,82338,82341,2,5,0
23524,1,1,82337,82341,82342,4,5,0
23525,2,2,82339,82342,82344,3,5,0
23526,3,3,82342,82344,82347,2,5,0
23527,6,2,82348,82348,82350,0,2,1
23528,3,2,82351,82351,82353,0,2,1
23529,4,1,82355,82355,82356,0,1,2
23530,4,3,82359,82359,82362,0,3,3
23531,5,3,82364,82364,82367,0,3,2
23532,1,2,82365,82367,82369,2,4,0
23533,2,2,82367,82369,82371,2,4,0
23534,4,2,82371,82371,82373,0,2,0
23535,4,3,82375,82375,82378,0,3,2
23536,6,2,82381,82381,82383,0,2,3
23537,4,2,82385,82385,82387,0,2,2
23538,6,1,82391,82391,82392,0,1,4
23539,1,1,82392,82392,82393,0,1,0
23540,4,1,82396,82396,82397,0,1,3
23541,2,2,82398,82398,82400,0,2,1
23542,2,1,82400,82400,82401,0,1,0
23543,3,2,82403,82403,82405,0,2,2
23544,1,2,82404,82405,82407,1,3,0
23545,3,3,82407,82407,82410,0,3,0
23546,3,3,82410,82410,82413,0,3,0
23547,5,3,82415,82415,82418,0,3,2
23548,3,3,82418,82418,82421,0,3,0
23549,6,2,82424,82424,82426,0,2,3
23550,4,3,82428,82428,82431,0,3,2
23551,6,3,82434,82434,82437,0,3,3
23552,1,2,82435,82437,82439,2,4,0
23553,2,1,82437,82439,82440,2,3,0
23554,3,2,82440,82440,82442,0,2,0
23555,4,2,82444,82444,82446,0,2,2
23556,2,3,82446,82446,82449,0,3,0
23557,1,3,82447,82449,82452,2,5,0
23558,5,3,82452,82452,82455,0,3,0
23559,5,1,82457,82457,82458,0,1,2
23560,4,2,82461,82461,82463,0,2,3
23561,4,3,82465,82465,82468,0,3,2
23562,1,2,82466,82468,82470,2,4,0
23563,3,1,82469,82470,82471,1,2,0
23564,6,2,82475,82475,82477,0,2,4
23565,6,3,82481,82481,82484,0,3,4
23566,1,3,82482,82484,82487,2,5,0
23567,1,2,82483,82487,82489,4,6,0
23568,5,1,82488,82489,82490,1,2,0
23569,3,1,82491,82491,82492,0,1,1
23570,2,1,82493,82493,82494,0,1,1
23571,5,3,82498,82498,82501,0,3,4
23572,6,1,82504,82504,82505,0,1,3
23573,3,2,82507,82507,82509,0,2,2
23574,5,2,82512,82512,82514,0,2,3
23575,4,1,82516,82516,82517,0,1,2
23576,2,3,82518,82518,82521,0,3,1
23577,3,2,82521,82521,82523,0,2,0
23578,6,2,82527,82527,82529,0,2,4
23579,5,1,82532,82532,82533,0,1,3
23580,6,1,82538,82538,82539,0,1,5
23581,1,1,82539,82539,82540,0,1,0
23582,6,1,82545,82545,82546,0,1,5
23583,3,2,82548,82548,82550,0,2,2
23584,3,2,82551,82551,82553,0,2,1
23585,3,2,82554,82554,82556,0,2,1
23586,2,3,82556,82556,82559,0,3,0
23587,4,1,82560,82560,82561,0,1,1
23588,3,1,82563,82563,82564,0,1,2
23589,2,2,82565,82565,82567,0,2,1
23590,2,1,82567,82567,82568,0,1,0
23591,1,2,82568,82568,82570,0,2,0
23592,4,1,82572,82572,82573,0,1,2
23593,6,1,82578,82578,82579,0,1,5
23594,1,2,82579,82579,82581,0,2,0
23595,5,3,82584,82584,82587,0,3,3
23596,6,2,82590,82590,82592,0,2,3
23597,4,1,82594,82594,82595,0,1,2
23598,5,1,82599,82599,82600,0,1,4
23599,6,2,82605,82605,82607,0,2,5
23600,4,1,82609,82609,82610,0,1,2
23601,5,3,82614,82614,82617,0,3,4
23602,6,1,82620,82620,82621,0,1,3
23603,3,1,82623,82623,82624,0,1,2
23604,2,2,82625,82625,82627,0,2,1
23605,6,2,82631,82631,82633,0,2,4
23606,1,3,82632,82633,82636,1,4,0
23607,1,3,82633,82636,82639,3,6,0
23608,5,3,82638,82639,82642,1,4,0
23609,6,2,82644,82644,82646,0,2,2
23610,3,2,82647,82647,82649,0,2,1
23611,2,3,82649,82649,82652,0,3,0
23612,5,2,82654,82654,82656,0,2,2
23613,5,1,82659,82659,82660,0,1,3
23614,2,3,82661,82661,82664,0,3,1
23615,2,2,82663,82664,82666,1,3,0
23616,1,1,82664,82666,82667,2,3,0
23617,6,2,82670,82670,82672,0,2,3
23618,2,1,82672,82672,82673,0,1,0
23619,3,2,82675,82675,82677,0,2,2
23620,5,2,82680,82680,82682,0,2,3
23621,6,2,82686,82686,82688,0,2,4
23622,3,1,82689,82689,82690,0,1,1
23623,3,2,82692,82692,82694,0,2,2
23624,1,1,82693,82694,82695,1,2,0
23625,5,1,82698,82698,82699,0,1,3
23626,4,1,82702,82702,82703,0,1,3
23627,3,1,82705,82705,82706,0,1,2
23628,1,3,82706,82706,82709,0,3,0
23629,2,1,82708,82709,82710,1,2,0
23630,5,2,82713,82713,82715,0,2,3
23631,4,3,82717,82717,82720,0,3,2
23632,2,1,82719,82720,82721,1,2,0
23633,4,1,82723,82723,82724,0,1,2
23634,3,2,82726,82726,82728,0,2,2
23635,3,1,82729,82729,82730,0,1,1
23636,5,3,82734,82734,82737,0,3,4
23637,5,1,82739,82739,82740,0,1,2
23638,4,3,82743,82743,82746,0,3,3
23639,4,2,82747,82747,82749,0,2,1
23640,3,3,82750,82750,82753,0,3,1
23641,4,2,82754,82754,82756,0,2,1
23642,2,3,82756,82756,82759,0,3,0
23643,1,1,82757,82759,82760,2,3,0
23644,5,3,82762,82762,82765,0,3,2
23645,2,1,82764,82765,82766,1,2,0
23646,2,2,82766,82766,82768,0,2,0
23647,3,2,82769,82769,82771,0,2,1
23648,6,2,82775,82775,82777,0,2,4
23649,1,3,82776,82777,82780,1,4,0
23650,4,2,82780,82780,82782,0,2,0
23651,5,1,82785,82785,82786,0,1,3
23652,6,1,82791,82791,82792,0,1,5
23653,6,1,82797,82797,82798,0,1,5
23654,3,2,82800,82800,82802,0,2,2
23655,3,1,82803,82803,82804,0,1,1
23656,1,1,82804,82804,82805,0,1,0
23657,4,3,82808,82808,82811,0,3,3
23658,3,3,82811,82811,82814,0,3,0
23659,4,3,82815,82815,82818,0,3,1
23660,4,3,82819,82819,82822,0,3,1
23661,6,2,82825,82825,82827,0,2,3
23662,3,3,82828,82828,82831,0,3,1
23663,2,2,82830,82831,82833,1,3,0
23664,3,1,82833,82833,82834,0,1,0
23665,6,3,82839,82839,82842,0,3,5
23666,6,1,82845,82845,82846,0,1,3
23667,1,3,82846,82846,82849,0,3,0
23668,5,3,82851,82851,82854,0,3,2
23669,3,3,82854,82854,82857,0,3,0
23670,5,2,82859,82859,82861,0,2,2
23671,4,3,82863,82863,82866,0,3,2
23672,2,2,82865,82866,82868,1,3,0
23673,1,3,82866,82868,82871,2,5,0
23674,3,3,82869,82871,82874,2,5,0
23675,3,1,82872,82874,82875,2,3,0
23676,4,1,82876,82876,82877,0,1,1
23677,6,3,82882,82882,82885,0,3,5
23678,2,2,82884,82885,82887,1,3,0
23679,6,3,82890,82890,82893,0,3,3
23680,6,2,82896,82896,82898,0,2,3
23681,5,2,82901,82901,82903,0,2,3
23682,1,2,82902,82903,82905,1,3,0
23683,2,1,82904,82905,82906,1,2,0
23684,6,2,82910,82910,82912,0,2,4
23685,6,3,82916,82916,82919,0,3,4
23686,5,1,82921,82921,82922,0,1,2
23687,5,3,82926,82926,82929,0,3,4
23688,4,3,82930,82930,82933,0,3,1
23689,3,2,82933,82933,82935,0,2,0
23690,5,1,82938,82938,82939,0,1,3
23691,4,1,82942,82942,82943,0,1,3
23692,2,1,82944,82944,82945,0,1,1
23693,6,2,82950,82950,82952,0,2,5
23694,5,1,82955,82955,82956,0,1,3
23695,2,2,82957,82957,82959,0,2,1
23696,1,2,82958,82959,82961,1,3,0
23697,4,2,82962,82962,82964,0,2,1
23698,1,2,82963,82964,82966,1,3,0
23699,4,2,82967,82967,82969,0,2,1
23700,5,2,82972,82972,82974,0,2,3
23701,3,1,82975,82975,82976,0,1,1
23702,6,1,82981,82981,82982,0,1,5
23703,1,3,82982,82982,82985,0,3,0
23704,4,3,82986,82986,82989,0,3,1
23705,5,3,82991,82991,82994,0,3,2
23706,2,3,82993,82994,82997,1,4,0
23707,6,1,82999,82999,83000,0,1,2
23708,6,3,83005,83005,83008,0,3,5
23709,2,2,83007,83008,83010,1,3,0
23710,2,3,83009,83010,83013,1,4,0
23711,1,3,83010,83013,83016,3,6,0
23712,5,3,83015,83016,83019,1,4,0
23713,1,3,83016,83019,83022,3,6,0
23714,2,2,83018,83022,83024,4,6,0
23715,6,2,83024,83024,83026,0,2,0
23716,2,2,83026,83026,83028,0,2,0
23717,5,1,83031,83031,83032,0,1,3
23718,4,2,83035,83035,83037,0,2,3
23719,6,3,83041,83041,83044,0,3,4
23720,2,1,83043,83044,83045,1,2,0
23721,5,2,83048,83048,83050,0,2,3
23722,6,3,83054,83054,83057,0,3,4
23723,6,2,83060,83060,83062,0,2,3
23724,1,2,83061,83062,83064,1,3,0
23725,4,3,83065,83065,83068,0,3,1
23726,3,3,83068,83068,83071,0,3,0
23727,5,3,83073,83073,83076,0,3,2
23728,5,1,83078,83078,83079,0,1,2
23729,3,1,83081,83081,83082,0,1,2
23730,5,2,83086,83086,83088,0,2,4
23731,4,2,83090,83090,83092,0,2,2
23732,1,3,83091,83092,83095,1,4,0
23733,4,1,83095,83095,83096,0,1,0
23734,1,3,83096,83096,83099,0,3,0
23735,5,2,83101,83101,83103,0,2,2
23736,2,3,83103,83103,83106,0,3,0
23737,5,3,83108,83108,83111,0,3,2
23738,1,3,83109,83111,83114,2,5,0
23739,3,3,83112,83114,83117,2,5,0
23740,4,2,83116,83117,83119,1,3,0
23741,2,3,83118,83119,83122,1,4,0
23742,1,2,83119,83122,83124,3,5,0
23743,3,1,83122,83124,83125,2,3,0
23744,6,1,83128,83128,83129,0,1,3
23745,2,2,83130,83130,83132,0,2,1
23746,6,3,83136,83136,83139,0,3,4
23747,5,1,83141,83141,83142,0,1,2
23748,6,3,83147,83147,83150,0,3,5
23749,1,2,83148,83150,83152,2,4,0
23750,5,2,83153,83153,83155,0,2,1
23751,4,3,83157,83157,83160,0,3,2
23752,3,2,83160,83160,83162,0,2,0
23753,3,2,83163,83163,83165,0,2,1
23754,6,1,83169,83169,83170,0,1,4
23755,3,1,83172,83172,83173,0,1,2
23756,3,1,83175,83175,83176,0,1,2
23757,2,2,83177,83177,83179,0,2,1
23758,4,2,83181,83181,83183,0,2,2
23759,2,1,83183,83183,83184,0,1,0
23760,1,2,83184,83184,83186,0,2,0
23761,1,3,83185,83186,83189,1,4,0
23762,2,3,83187,83189,83192,2,5,0
23763,3,2,83190,83192,83194,2,4,0
23764,3,2,83193,83194,83196,1,3,0
23765,4,2,83197,83197,83199,0,2,1
23766,5,3,83202,83202,83205,0,3,3
23767,1,2,83203,83205,83207,2,4,0
23768,5,2,83208,83208,83210,0,2,1
23769,5,3,83213,83213,83216,0,3,3
23770,2,2,83215,83216,83218,1,3,0
23771,1,1,83216,83218,83219,2,3,0
23772,2,2,83218,83219,83221,1,3,0
23773,3,2,83221,83221,83223,0,2,0
23774,6,3,83227,83227,83230,0,3,4
23775,1,1,83228,83230,83231,2,3,0
23776,3,1,83231,83231,83232,0,1,0
23777,4,3,83235,83235,83238,0,3,3
23778,3,1,83238,83238,83239,0,1,0
23779,6,3,83244,83244,83247,0,3,5
23780,3,3,83247,83247,83250,0,3,0
23781,4,2,83251,83251,83253,0,2,1
23782,6,3,83257,83257,83260,0,3,4
23783,2,1,83259,83260,83261,1,2,0
23784,4,2,83263,83263,83265,0,2,2
23785,5,1,83268,83268,83269,0,1,3
23786,3,1,83271,83271,83272,0,1,2
23787,1,2,83272,83272,83274,0,2,0
23788,5,2,83277,83277,83279,0,2,3
23789,5,3,83282,83282,83285,0,3,3
23790,4,1,83286,83286,83287,0,1,1
23791,5,2,83291,83291,83293,0,2,4
23792,3,1,83294,83294,83295,0,1,1
23793,4,3,83298,83298,83301,0,3,3
23794,6,1,83304,83304,83305,0,1,3
23795,1,1,83305,83305,83306,0,1,0
23796,5,3,83310,83310,83313,0,3,4
23797,5,2,83315,83315,83317,0,2,2
23798,4,2,83319,83319,83321,0,2,2
23799,6,3,83325,83325,83328,0,3,4
23800,3,2,83328,83328,83330,0,2,0
23801,3,1,83331,83331,83332,0,1,1
23802,4,1,83335,83335,83336,0,1,3
23803,6,1,83341,83341,83342,0,1,5
23804,4,3,83345,83345,83348,0,3,3
23805,3,2,83348,83348,83350,0,2,0
23806,1,1,83349,83350,83351,1,2,0
23807,1,1,83350,83351,83352,1,2,0
23808,1,3,83351,83352,83355,1,4,0
23809,2,3,83353,83355,83358,2,5,0
23810,6,1,83359,83359,83360,0,1,1
23811,5,2,83364,83364,83366,0,2,4
23812,5,3,83369,83369,83372,0,3,3
23813,1,2,83370,83372,83374,2,4,0
23814,4,1,83374,83374,83375,0,1,0
23815,1,2,83375,83375,83377,0,2,0
23816,1,3,83376,83377,83380,1,4,0
23817,6,1,83382,83382,83383,0,1,2
23818,1,1,83383,83383,83384,0,1,0
23819,1,3,83384,83384,83387,0,3,0
23820,4,1,83388,83388,83389,0,1,1
23821,4,2,83392,83392,83394,0,2,3
23822,4,2,83396,83396,83398,0,2,2
23823,6,1,83402,83402,83403,0,1,4
23824,6,1,83408,83408,83409,0,1,5
23825,5,3,83413,83413,83416,0,3,4
23826,2,3,83415,83416,83419,1,4,0
23827,5,2,83420,83420,83422,0,2,1
23828,1,2,83421,83422,83424,1,3,0
23829,5,3,83426,83426,83429,0,3,2
23830,6,1,83432,83432,83433,0,1,3
23831,3,3,83435,83435,83438,0,3,2
23832,5,2,83440,83440,83442,0,2,2
23833,4,2,83444,83444,83446,0,2,2
23834,1,2,83445,83446,83448,1,3,0
23835,1,1,83446,83448,83449,2,3,0
23836,2,3,83448,83449,83452,1,4,0
23837,3,2,83451,83452,83454,1,3,0
23838,4,3,83455,83455,83458,0,3,1
23839,4,3,83459,83459,83462,0,3,1
23840,4,2,83463,83463,83465,0,2,1
23841,2,1,83465,83465,83466,0,1,0
23842,1,1,83466,83466,83467,0,1,0
23843,5,2,83471,83471,83473,0,2,4
23844,4,3,83475,83475,83478,0,3,2
23845,6,3,83481,83481,83484,0,3,3
23846,6,1,83487,83487,83488,0,1,3
23847,1,3,83488,83488,83491,0,3,0
23848,2,2,83490,83491,83493,1,3,0
23849,3,2,83493,83493,83495,0,2,0
23850,5,3,83498,83498,83501,0,3,3
23851,3,1,83501,83501,83502,0,1,0
23852,3,2,83504,83504,83506,0,2,2
23853,3,2,83507,83507,83509,0,2,1
23854,3,3,83510,83510,83513,0,3,1
23855,1,2,83511,83513,83515,2,4,0
23856,5,2,83516,83516,83518,0,2,1
23857,4,1,83520,83520,83521,0,1,2
23858,4,1,83524,83524,83525,0,1,3
23859,2,3,83526,83526,83529,0,3,1
23860,1,3,83527,83529,83532,2,5,0
23861,2,3,83529,83532,83535,3,6,0
23862,3,1,83532,83535,83536,3,4,0
23863,3,2,83535,83536,83538,1,3,0
23864,2,2,83537,83538,83540,1,3,0
23865,2,3,83539,83540,83543,1,4,0
23866,2,3,83541,83543,83546,2,5,0
23867,5,1,83546,83546,83547,0,1,0
23868,2,1,83548,83548,83549,0,1,1
23869,5,1,83553,83553,83554,0,1,4
23870,1,2,83554,83554,83556,0,2,0
23871,5,1,83559,83559,83560,0,1,3
23872,1,1,83560,83560,83561,0,1,0
23873,1,2,83561,83561,83563,0,2,0
23874,6,3,83567,83567,83570,0,3,4
23875,6,3,83573,83573,83576,0,3,3
23876,1,2,83574,83576,83578,2,4,0
23877,1,3,83575,83578,83581,3,6,0
23878,1,3,83576,83581,83584,5,8,0
23879,5,1,83581,83584,83585,3,4,0
23880,5,1,83586,83586,83587,0,1,1
23881,2,3,83588,83588,83591,0,3,1
23882,5,1,83593,83593,83594,0,1,2
23883,5,2,83598,83598,83600,0,2,4
23884,4,2,83602,83602,83604,0,2,2
23885,5,3,83607,83607,83610,0,3,3
23886,1,2,83608,83610,83612,2,4,0
23887,4,2,83612,83612,83614,0,2,0
23888,3,1,83615,83615,83616,0,1,1
23889,4,2,83619,83619,83621,0,2,3
23890,1,1,83620,83621,83622,1,2,0
23891,6,1,83626,83626,83627,0,1,4
23892,1,1,83627,83627,83628,0,1,0
23893,3,1,83630,83630,83631,0,1,2
23894,1,2,83631,83631,83633,0,2,0
23895,1,1,83632,83633,83634,1,2,0
23896,1,3,83633,83634,83637,1,4,0
23897,2,1,83635,83637,83638,2,3,0
23898,5,3,83640,83640,83643,0,3,2
23899,1,1,83641,83643,83644,2,3,0
23900,2,3,83643,83644,83647,1,4,0
23901,6,2,83649,83649,83651,0,2,2
23902,4,2,83653,83653,83655,0,2,2
23903,6,2,83659,83659,83661,0,2,4
23904,5,3,83664,83664,83667,0,3,3
23905,3,3,83667,83667,83670,0,3,0
23906,4,2,83671,83671,83673,0,2,1
23907,4,2,83675,83675,83677,0,2,2
23908,3,1,83678,83678,83679,0,1,1
23909,1,3,83679,83679,83682,0,3,0
23910,1,2,83680,83682,83684,2,4,0
23911,3,2,83683,83684,83686,1,3,0
23912,6,3,83689,83689,83692,0,3,3
23913,5,1,83694,83694,83695,0,1,2
23914,3,1,83697,83697,83698,0,1,2
23915,6,1,83703,83703,83704,0,1,5
23916,3,3,83706,83706,83709,0,3,2
23917,5,1,83711,83711,83712,0,1,2
23918,6,1,83717,83717,83718,0,1,5
23919,5,2,83722,83722,83724,0,2,4
23920,5,1,83727,83727,83728,0,1,3
23921,2,3,83729,83729,83732,0,3,1
23922,5,2,83734,83734,83736,0,2,2
23923,4,1,83738,83738,83739,0,1,2
23924,5,3,83743,83743,83746,0,3,4
23925,2,1,83745,83746,83747,1,2,0
23926,3,3,83748,83748,83751,0,3,1
23927,1,2,83749,83751,83753,2,4,0
23928,3,3,83752,83753,83756,1,4,0
23929,1,2,83753,83756,83758,3,5,0
23930,4,1,83757,83758,83759,1,2,0
23931,6,1,83763,83763,83764,0,1,4
23932,6,1,83769,83769,83770,0,1,5
23933,2,2,83771,83771,83773,0,2,1
23934,1,3,83772,83773,83776,1,4,0
23935,2,2,83774,83776,83778,2,4,0
23936,1,1,83775,83778,83779,3,4,0
23937,6,1,83781,83781,83782,0,1,2
23938,5,2,83786,83786,83788,0,2,4
23939,2,3,83788,83788,83791,0,3,0
23940,6,3,83794,83794,83797,0,3,3
23941,5,2,83799,83799,83801,0,2,2
23942,4,2,83803,83803,83805,0,2,2
23943,2,1,83805,83805,83806,0,1,0
23944,5,1,83810,83810,83811,0,1,4
23945,6,3,83816,83816,83819,0,3,5
23946,3,3,83819,83819,83822,0,3,0
23947,1,2,83820,83822,83824,2,4,0
23948,6,1,83826,83826,83827,0,1,2
23949,5,2,83831,83831,83833,0,2,4
23950,1,3,83832,83833,83836,1,4,0
23951,1,2,83833,83836,83838,3,5,0
23952,6,1,83839,83839,83840,0,1,1
23953,6,3,83845,83845,83848,0,3,5
23954,3,2,83848,83848,83850,0,2,0
23955,1,3,83849,83850,83853,1,4,0
23956,4,2,83853,83853,83855,0,2,0
23957,3,2,83856,83856,83858,0,2,1
23958,2,1,83858,83858,83859,0,1,0
23959,4,3,83862,83862,83865,0,3,3
23960,4,2,83866,83866,83868,0,2,1
23961,5,1,83871,83871,83872,0,1,3
23962,4,2,83875,83875,83877,0,2,3
23963,6,3,83881,83881,83884,0,3,4
23964,6,3,83887,83887,83890,0,3,3
23965,1,3,83888,83890,83893,2,5,0
23966,6,3,83894,83894,83897,0,3,1
23967,6,1,83900,83900,83901,0,1,3
23968,4,2,83904,83904,83906,0,2,3
23969,1,1,83905,83906,83907,1,2,0
23970,2,2,83907,83907,83909,0,2,0
23971,3,2,83910,83910,83912,0,2,1
23972,5,1,83915,83915,83916,0,1,3
23973,5,3,83920,83920,83923,0,3,4
23974,3,1,83923,83923,83924,0,1,0
23975,4,1,83927,83927,83928,0,1,3
23976,6,2,83933,83933,83935,0,2,5
23977,1,2,83934,83935,83937,1,3,0
23978,2,1,83936,83937,83938,1,2,0
23979,1,2,83937,83938,83940,1,3,0
23980,3,3,83940,83940,83943,0,3,0
23981,2,3,83942,83943,83946,1,4,0
23982,6,1,83948,83948,83949,0,1,2
23983,6,3,83954,83954,83957,0,3,5
23984,5,3,83959,83959,83962,0,3,2
23985,4,1,83963,83963,83964,0,1,1
23986,3,2,83966,83966,83968,0,2,2
23987,2,3,83968,83968,83971,0,3,0
23988,5,1,83973,83973,83974,0,1,2
23989,4,3,83977,83977,83980,0,3,3
23990,3,1,83980,83980,83981,0,1,0
23991,4,3,83984,83984,83987,0,3,3
23992,4,3,83988,83988,83991,0,3,1
23993,2,1,83990,83991,83992,1,2,0
23994,4,2,83994,83994,83996,0,2,2
23995,5,2,83999,83999,84001,0,2,3
23996,4,3,84003,84003,84006,0,3,2
23997,5,2,84008,84008,84010,0,2,2
23998,1,3,84009,84010,84013,1,4,0
23999,3,3,84012,84013,84016,1,4,0
24000,2,1,84014,84016,84017,2,3,0
24001,1,2,84015,84017,84019,2,4,0
24002,5,2,84020,84020,84022,0,2,1
24003,2,2,84022,84022,84024,0,2,0
24004,1,2,84023,84024,84026,1,3,0
24005,3,2,84026,84026,84028,0,2,0
24006,1,3,84027,84028,84031,1,4,0
24007,5,2,84032,84032,84034,0,2,1
24008,4,2,84036,84036,84038,0,2,2
24009,2,3,84038,84038,84041,0,3,0
24010,6,3,84044,84044,84047,0,3,3
24011,4,2,84048,84048,84050,0,2,1
24012,4,3,84052,84052,84055,0,3,2
24013,4,1,84056,84056,84057,0,1,1
24014,4,1,84060,84060,84061,0,1,3
24015,5,1,84065,84065,84066,0,1,4
24016,5,3,84070,84070,84073,0,3,4
24017,5,3,84075,84075,84078,0,3,2
24018,3,3,84078,84078,84081,0,3,0
24019,6,1,84084,84084,84085,0,1,3
24020,1,3,84085,84085,84088,0,3,0
24021,5,3,84090,84090,84093,0,3,2
24022,2,3,84092,84093,84096,1,4,0
24023,6,1,84098,84098,84099,0,1,2
24024,3,2,84101,84101,84103,0,2,2
24025,3,1,84104,84104,84105,0,1,1
24026,5,2,84109,84109,84111,0,2,4
24027,3,1,84112,84112,84113,0,1,1
24028,6,1,84118,84118,84119,0,1,5
24029,6,1,84124,84124,84125,0,1,5
24030,3,3,84127,84127,84130,0,3,2
24031,6,1,84133,84133,84134,0,1,3
24032,5,3,84138,84138,84141,0,3,4
24033,5,1,84143,84143,84144,0,1,2
24034,1,1,84144,84144,84145,0,1,0
24035,5,1,84149,84149,84150,0,1,4
24036,6,2,84155,84155,84157,0,2,5
24037,3,3,84158,84158,84161,0,3,1
24038,4,3,84162,84162,84165,0,3,1
24039,1,3,84163,84165,84168,2,5,0
24040,4,1,84167,84168,84169,1,2,0
24041,2,1,84169,84169,84170,0,1,0
24042,1,1,84170,84170,84171,0,1,0
24043,2,3,84172,84172,84175,0,3,1
24044,4,2,84176,84176,84178,0,2,1
24045,5,2,84181,84181,84183,0,2,3
24046,1,3,84182,84183,84186,1,4,0
24047,6,3,84188,84188,84191,0,3,2
24048,3,2,84191,84191,84193,0,2,0
24049,2,2,84193,84193,84195,0,2,0
24050,4,2,84197,84197,84199,0,2,2
24051,4,1,84201,84201,84202,0,1,2
24052,2,1,84203,84203,84204,0,1,1
24053,6,2,84209,84209,84211,0,2,5
24054,6,1,84215,84215,84216,0,1,4
24055,1,1,84216,84216,84217,0,1,0
24056,3,1,84219,84219,84220,0,1,2
24057,3,2,84222,84222,84224,0,2,2
24058,6,2,84228,84228,84230,0,2,4
24059,6,2,84234,84234,84236,0,2,4
24060,1,2,84235,84236,84238,1,3,0
24061,4,3,84239,84239,84242,0,3,1
24062,5,1,84244,84244,84245,0,1,2
24063,1,1,84245,84245,84246,0,1,0
24064,4,1,84249,84249,84250,0,1,3
24065,5,2,84254,84254,84256,0,2,4
24066,1,1,84255,84256,84257,1,2,0
24067,2,1,84257,84257,84258,0,1,0
24068,2,2,84259,84259,84261,0,2,1
24069,2,2,84261,84261,84263,0,2,0
24070,4,3,84265,84265,84268,0,3,2
24071,1,1,84266,84268,84269,2,3,0
24072,1,3,84267,84269,84272,2,5,0
24073,4,2,84271,84272,84274,1,3,0
24074,4,3,84275,84275,84278,0,3,1
24075,4,2,84279,84279,84281,0,2,1
24076,5,1,84284,84284,84285,0,1,3
24077,3,1,84287,84287,84288,0,1,2
24078,4,2,84291,84291,84293,0,2,3
24079,1,1,84292,84293,84294,1,2,0
24080,1,2,84293,84294,84296,1,3,0
24081,6,2,84299,84299,84301,0,2,3
24082,3,3,84302,84302,84305,0,3,1
24083,3,2,84305,84305,84307,0,2,0
24084,1,2,84306,84307,84309,1,3,0
24085,6,3,84312,84312,84315,0,3,3
24086,4,3,84316,84316,84319,0,3,1
24087,3,1,84319,84319,84320,0,1,0
24088,2,1,84321,84321,84322,0,1,1
24089,4,1,84325,84325,84326,0,1,3
24090,2,2,84327,84327,84329,0,2,1
24091,4,1,84331,84331,84332,0,1,2
24092,5,1,84336,84336,84337,0,1,4
24093,3,1,84339,84339,84340,0,1,2
24094,4,2,84343,84343,84345,0,2,3
24095,6,1,84349,84349,84350,0,1,4
24096,3,2,84352,84352,84354,0,2,2
24097,6,1,84358,84358,84359,0,1,4
24098,6,1,84364,84364,84365,0,1,5
24099,2,1,84366,84366,84367,0,1,1
24100,4,1,84370,84370,84371,0,1,3
24101,1,2,84371,84371,84373,0,2,0
24102,5,3,84376,84376,84379,0,3,3
24103,3,3,84379,84379,84382,0,3,0
24104,4,1,84383,84383,84384,0,1,1
24105,1,2,84384,84384,84386,0,2,0
24106,1,1,84385,84386,84387,1,2,0
24107,5,2,84390,84390,84392,0,2,3
24108,4,3,84394,84394,84397,0,3,2
24109,4,2,84398,84398,84400,0,2,1
24110,3,3,84401,84401,84404,0,3,1
24111,3,1,84404,84404,84405,0,1,0
24112,2,2,84406,84406,84408,0,2,1
24113,3,1,84409,84409,84410,0,1,1
24114,1,3,84410,84410,84413,0,3,0
24115,1,2,84411,84413,84415,2,4,0
24116,1,2,84412,84415,84417,3,5,0
24117,2,1,84414,84417,84418,3,4,0
24118,2,2,84416,84418,84420,2,4,0
24119,5,3,84421,84421,84424,0,3,1
24120,6,1,84427,84427,84428,0,1,3
24121,3,1,84430,84430,84431,0,1,2
24122,6,3,84436,84436,84439,0,3,5
24123,6,1,84442,84442,84443,0,1,3
24124,3,3,84445,84445,84448,0,3,2
24125,2,2,84447,84448,84450,1,3,0
24126,1,2,84448,84450,84452,2,4,0
24127,6,1,84454,84454,84455,0,1,2
24128,4,1,84458,84458,84459,0,1,3
24129,2,2,84460,84460,84462,0,2,1
24130,4,3,84464,84464,84467,0,3,2
24131,6,2,84470,84470,84472,0,2,3
24132,3,3,84473,84473,84476,0,3,1
24133,3,2,84476,84476,84478,0,2,0
24134,2,2,84478,84478,84480,0,2,0
24135,2,1,84480,84480,84481,0,1,0
24136,6,1,84486,84486,84487,0,1,5
24137,4,1,84490,84490,84491,0,1,3
24138,1,3,84491,84491,84494,0,3,0
24139,6,2,84497,84497,84499,0,2,3
24140,6,3,84503,84503,84506,0,3,4
24141,5,2,84508,84508,84510,0,2,2
24142,4,1,84512,84512,84513,0,1,2
24143,2,2,84514,84514,84516,0,2,1
24144,4,3,84518,84518,84521,0,3,2
24145,2,3,84520,84521,84524,1,4,0
24146,5,3,84525,84525,84528,0,3,1
24147,4,1,84529,84529,84530,0,1,1
24148,5,1,84534,84534,84535,0,1,4
24149,4,2,84538,84538,84540,0,2,3
24150,2,2,84540,84540,84542,0,2,0
24151,6,3,84546,84546,84549,0,3,4
24152,1,3,84547,84549,84552,2,5,0
24153,5,1,84552,84552,84553,0,1,0
24154,5,1,84557,84557,84558,0,1,4
24155,2,1,84559,84559,84560,0,1,1
24156,2,3,84561,84561,84564,0,3,1
24157,4,3,84565,84565,84568,0,3,1
24158,1,1,84566,84568,84569,2,3,0
24159,2,2,84568,84569,84571,1,3,0
24160,4,1,84572,84572,84573,0,1,1
24161,3,1,84575,84575,84576,0,1,2
24162,3,1,84578,84578,84579,0,1,2
24163,4,2,84582,84582,84584,0,2,3
24164,3,1,84585,84585,84586,0,1,1
24165,6,1,84591,84591,84592,0,1,5
24166,2,2,84593,84593,84595,0,2,1
24167,1,3,84594,84595,84598,1,4,0
24168,4,1,84598,84598,84599,0,1,0
24169,1,3,84599,84599,84602,0,3,0
24170,2,1,84601,84602,84603,1,2,0
24171,4,2,84605,84605,84607,0,2,2
24172,5,3,84610,84610,84613,0,3,3
24173,6,3,84616,84616,84619,0,3,3
24174,3,2,84619,84619,84621,0,2,0
24175,3,3,84622,84622,84625,0,3,1
24176,5,2,84627,84627,84629,0,2,2
24177,5,2,84632,84632,84634,0,2,3
24178,3,1,84635,84635,84636,0,1,1
24179,5,1,84640,84640,84641,0,1,4
24180,6,2,84646,84646,84648,0,2,5
24181,5,1,84651,84651,84652,0,1,3
24182,2,1,84653,84653,84654,0,1,1
24183,4,2,84657,84657,84659,0,2,3
24184,2,1,84659,84659,84660,0,1,0
24185,4,1,84663,84663,84664,0,1,3
24186,6,1,84669,84669,84670,0,1,5
24187,4,3,84673,84673,84676,0,3,3
24188,5,3,84678,84678,84681,0,3,2
24189,4,2,84682,84682,84684,0,2,1
24190,1,2,84683,84684,84686,1,3,0
24191,3,1,84686,84686,84687,0,1,0
24192,4,1,84690,84690,84691,0,1,3
24193,2,2,84692,84692,84694,0,2,1
24194,5,3,84697,84697,84700,0,3,3
24195,3,3,84700,84700,84703,0,3,0
24196,4,1,84704,84704,84705,0,1,1
24197,1,3,84705,84705,84708,0,3,0
24198,2,2,84707,84708,84710,1,3,0
24199,6,3,84713,84713,84716,0,3,3
24200,1,3,84714,84716,84719,2,5,0
24201,3,3,84717,84719,84722,2,5,0
24202,5,1,84722,84722,84723,0,1,0
24203,3,2,84725,84725,84727,0,2,2
24204,4,1,84729,84729,84730,0,1,2
24205,2,1,84731,84731,84732,0,1,1
24206,4,3,84735,84735,84738,0,3,3
24207,3,3,84738,84738,84741,0,3,0
24208,6,3,84744,84744,84747,0,3,3
24209,5,2,84749,84749,84751,0,2,2
24210,3,1,84752,84752,84753,0,1,1
24211,3,1,84755,84755,84756,0,1,2
24212,1,1,84756,84756,84757,0,1,0
24213,5,2,84761,84761,84763,0,2,4
24214,1,3,84762,84763,84766,1,4,0
24215,2,2,84764,84766,84768,2,4,0
24216,4,1,84768,84768,84769,0,1,0
24217,2,2,84770,84770,84772,0,2,1
24218,6,2,84776,84776,84778,0,2,4
24219,2,2,84778,84778,84780,0,2,0
24220,5,1,84783,84783,84784,0,1,3
24221,1,1,84784,84784,84785,0,1,0
24222,3,1,84787,84787,84788,0,1,2
24223,2,3,84789,84789,84792,0,3,1
24224,1,3,84790,84792,84795,2,5,0
24225,6,2,84796,84796,84798,0,2,1
24226,5,3,84801,84801,84804,0,3,3
24227,2,2,84803,84804,84806,1,3,0
24228,5,3,84808,84808,84811,0,3,2
24229,4,2,84812,84812,84814,0,2,1
24230,3,1,84815,84815,84816,0,1,1
24231,5,3,84820,84820,84823,0,3,4
24232,4,3,84824,84824,84827,0,3,1
24233,3,1,84827,84827,84828,0,1,0
24234,3,3,84830,84830,84833,0,3,2
24235,5,1,84835,84835,84836,0,1,2
24236,3,1,84838,84838,84839,0,1,2
24237,2,1,84840,84840,84841,0,1,1
24238,4,3,84844,84844,84847,0,3,3
24239,4,1,84848,84848,84849,0,1,1
24240,3,3,84851,84851,84854,0,3,2
24241,6,3,84857,84857,84860,0,3,3
24242,3,3,84860,84860,84863,0,3,0
24243,5,2,84865,84865,84867,0,2,2
24244,3,2,84868,84868,84870,0,2,1
24245,4,1,84872,84872,84873,0,1,2
24246,1,3,84873,84873,84876,0,3,0
24247,4,2,84877,84877,84879,0,2,1
24248,4,3,84881,84881,84884,0,3,2
24249,3,3,84884,84884,84887,0,3,0
24250,4,1,84888,84888,84889,0,1,1
24251,2,1,84890,84890,84891,0,1,1
24252,6,3,84896,84896,84899,0,3,5
24253,1,2,84897,84899,84901,2,4,0
24254,4,3,84901,84901,84904,0,3,0
24255,4,1,84905,84905,84906,0,1,1
24256,3,1,84908,84908,84909,0,1,2
24257,2,1,84910,84910,84911,0,1,1
24258,3,1,84913,84913,84914,0,1,2
24259,3,1,84916,84916,84917,0,1,2
24260,1,3,84917,84917,84920,0,3,0
24261,6,1,84923,84923,84924,0,1,3
24262,5,3,84928,84928,84931,0,3,4
24263,4,3,84932,84932,84935,0,3,1
24264,5,1,84937,84937,84938,0,1,2
24265,5,1,84942,84942,84943,0,1,4
24266,2,3,84944,84944,84947,0,3,1
24267,6,3,84950,84950,84953,0,3,3
24268,6,1,84956,84956,84957,0,1,3
24269,5,2,84961,84961,84963,0,2,4
24270,6,2,84967,84967,84969,0,2,4
24271,2,3,84969,84969,84972,0,3,0
24272,5,3,84974,84974,84977,0,3,2
24273,2,2,84976,84977,84979,1,3,0
24274,2,1,84978,84979,84980,1,2,0
24275,3,2,84981,84981,84983,0,2,1
24276,6,3,84987,84987,84990,0,3,4
24277,1,1,84988,84990,84991,2,3,0
24278,1,2,84989,84991,84993,2,4,0
24279,3,3,84992,84993,84996,1,4,0
24280,4,1,84996,84996,84997,0,1,0
24281,4,2,85000,85000,85002,0,2,3
24282,2,3,85002,85002,85005,0,3,0
24283,1,3,85003,85005,85008,2,5,0
24284,2,3,85005,85008,85011,3,6,0
24285,3,3,85008,85011,85014,3,6,0
24286,2,3,85010,85014,85017,4,7,0
24287,6,3,85016,85017,85020,1,4,0
24288,6,1,85022,85022,85023,0,1,2
24289,3,3,85025,85025,85028,0,3,2
24290,2,3,85027,85028,85031,1,4,0
24291,5,3,85032,85032,85035,0,3,1
24292,3,2,85035,85035,85037,0,2,0
24293,3,3,85038,85038,85041,0,3,1
24294,3,2,85041,85041,85043,0,2,0
24295,4,2,85045,85045,85047,0,2,2
24296,4,3,85049,85049,85052,0,3,2
24297,4,2,85053,85053,85055,0,2,1
24298,2,1,85055,85055,85056,0,1,0
24299,6,1,85061,85061,85062,0,1,5
24300,4,2,85065,85065,85067,0,2,3
24301,4,3,85069,85069,85072,0,3,2
24302,4,3,85073,85073,85076,0,3,1
24303,1,3,85074,85076,85079,2,5,0
24304,4,1,85078,85079,85080,1,2,0
24305,4,2,85082,85082,85084,0,2,2
24306,4,3,85086,85086,85089,0,3,2
24307,6,3,85092,85092,85095,0,3,3
24308,4,2,85096,85096,85098,0,2,1
24309,1,3,85097,85098,85101,1,4,0
24310,3,1,85100,85101,85102,1,2,0
24311,2,3,85102,85102,85105,0,3,0
24312,4,3,85106,85106,85109,0,3,1
24313,5,3,85111,85111,85114,0,3,2
24314,5,1,85116,85116,85117,0,1,2
24315,6,1,85122,85122,85123,0,1,5
24316,2,3,85124,85124,85127,0,3,1
24317,4,3,85128,85128,85131,0,3,1
24318,4,1,85132,85132,85133,0,1,1
24319,5,3,85137,85137,85140,0,3,4
24320,5,1,85142,85142,85143,0,1,2
24321,1,1,85143,85143,85144,0,1,0
24322,3,3,85146,85146,85149,0,3,2
24323,6,2,85152,85152,85154,0,2,3
24324,5,1,85157,85157,85158,0,1,3
24325,3,3,85160,85160,85163,0,3,2
24326,1,1,85161,85163,85164,2,3,0
24327,6,2,85167,85167,85169,0,2,3
24328,6,3,85173,85173,85176,0,3,4
24329,3,3,85176,85176,85179,0,3,0
24330,3,3,85179,85179,85182,0,3,0
24331,2,3,85181,85182,85185,1,4,0
24332,1,2,85182,85185,85187,3,5,0
24333,6,2,85188,85188,85190,0,2,1
24334,5,3,85193,85193,85196,0,3,3
24335,3,2,85196,85196,85198,0,2,0
24336,2,1,85198,85198,85199,0,1,0
24337,6,3,85204,85204,85207,0,3,5
24338,3,3,85207,85207,85210,0,3,0
24339,6,1,85213,85213,85214,0,1,3
24340,2,3,85215,85215,85218,0,3,1
24341,6,1,85221,85221,85222,0,1,3
24342,3,1,85224,85224,85225,0,1,2
24343,2,2,85226,85226,85228,0,2,1
24344,6,2,85232,85232,85234,0,2,4
24345,3,2,85235,85235,85237,0,2,1
24346,3,3,85238,85238,85241,0,3,1
24347,6,3,85244,85244,85247,0,3,3
24348,1,3,85245,85247,85250,2,5,0
24349,2,2,85247,85250,85252,3,5,0
24350,1,3,85248,85252,85255,4,7,0
24351,6,3,85254,85255,85258,1,4,0
24352,6,3,85260,85260,85263,0,3,2
24353,1,2,85261,85263,85265,2,4,0
24354,6,1,85267,85267,85268,0,1,2
24355,2,1,85269,85269,85270,0,1,1
24356,1,3,85270,85270,85273,0,3,0
24357,3,3,85273,85273,85276,0,3,0
24358,6,2,85279,85279,85281,0,2,3
24359,1,2,85280,85281,85283,1,3,0
24360,6,3,85286,85286,85289,0,3,3
24361,1,3,85287,85289,85292,2,5,0
24362,2,3,85289,85292,85295,3,6,0
24363,6,1,85295,85295,85296,0,1,0
24364,4,1,85299,85299,85300,0,1,3
24365,1,2,85300,85300,85302,0,2,0
24366,2,2,85302,85302,85304,0,2,0
24367,3,1,85305,85305,85306,0,1,1
24368,4,3,85309,85309,85312,0,3,3
24369,6,3,85315,85315,85318,0,3,3
24370,1,1,85316,85318,85319,2,3,0
24371,4,1,85320,85320,85321,0,1,1
24372,5,3,85325,85325,85328,0,3,4
24373,6,3,85331,85331,85334,0,3,3
24374,4,2,85335,85335,85337,0,2,1
24375,1,1,85336,85337,85338,1,2,0
24376,3,2,85339,85339,85341,0,2,1
24377,2,3,85341,85341,85344,0,3,0
24378,4,3,85345,85345,85348,0,3,1
24379,6,2,85351,85351,85353,0,2,3
24380,6,3,85357,85357,85360,0,3,4
24381,4,3,85361,85361,85364,0,3,1
24382,1,3,85362,85364,85367,2,5,0
24383,1,1,85363,85367,85368,4,5,0
24384,5,1,85368,85368,85369,0,1,0
24385,1,2,85369,85369,85371,0,2,0
24386,2,1,85371,85371,85372,0,1,0
24387,6,1,85377,85377,85378,0,1,5
24388,4,1,85381,85381,85382,0,1,3
24389,3,2,85384,85384,85386,0,2,2
24390,1,1,85385,85386,85387,1,2,0
24391,2,1,85387,85387,85388,0,1,0
24392,4,1,85391,85391,85392,0,1,3
24393,4,2,85395,85395,85397,0,2,3
24394,3,2,85398,85398,85400,0,2,1
24395,1,2,85399,85400,85402,1,3,0
24396,5,2,85404,85404,85406,0,2,2
24397,2,3,85406,85406,85409,0,3,0
24398,4,2,85410,85410,85412,0,2,1
24399,5,3,85415,85415,85418,0,3,3
24400,4,1,85419,85419,85420,0,1,1
24401,3,3,85422,85422,85425,0,3,2
24402,1,2,85423,85425,85427,2,4,0
24403,5,2,85428,85428,85430,0,2,1
24404,3,3,85431,85431,85434,0,3,1
24405,5,3,85436,85436,85439,0,3,2
24406,3,3,85439,85439,85442,0,3,0
24407,1,3,85440,85442,85445,2,5,0
24408,1,3,85441,85445,85448,4,7,0
24409,4,2,85445,85448,85450,3,5,0
24410,1,1,85446,85450,85451,4,5,0
24411,1,3,85447,85451,85454,4,7,0
24412,5,1,85452,85454,85455,2,3,0
24413,2,3,85454,85455,85458,1,4,0
24414,5,1,85459,85459,85460,0,1,1
24415,2,3,85461,85461,85464,0,3,1
24416,2,2,85463,85464,85466,1,3,0
24417,5,1,85468,85468,85469,0,1,2
24418,5,1,85473,85473,85474,0,1,4
24419,3,3,85476,85476,85479,0,3,2
24420,3,3,85479,85479,85482,0,3,0
24421,3,3,85482,85482,85485,0,3,0
24422,5,3,85487,85487,85490,0,3,2
24423,5,2,85492,85492,85494,0,2,2
24424,6,1,85498,85498,85499,0,1,4
24425,5,1,85503,85503,85504,0,1,4
24426,2,1,85505,85505,85506,0,1,1
24427,3,1,85508,85508,85509,0,1,2
24428,2,3,85510,85510,85513,0,3,1
24429,3,3,85513,85513,85516,0,3,0
24430,4,2,85517,85517,85519,0,2,1
24431,6,2,85523,85523,85525,0,2,4
24432,5,3,85528,85528,85531,0,3,3
24433,1,3,85529,85531,85534,2,5,0
24434,3,1,85532,85534,85535,2,3,0
24435,6,1,85538,85538,85539,0,1,3
24436,5,1,85543,85543,85544,0,1,4
24437,3,2,85546,85546,85548,0,2,2
24438,5,2,85551,85551,85553,0,2,3
24439,4,1,85555,85555,85556,0,1,2
24440,3,1,85558,85558,85559,0,1,2
24441,3,3,85561,85561,85564,0,3,2
24442,2,2,85563,85564,85566,1,3,0
24443,4,1,85567,85567,85568,0,1,1
24444,4,3,85571,85571,85574,0,3,3
24445,3,2,85574,85574,85576,0,2,0
24446,6,3,85580,85580,85583,0,3,4
24447,1,1,85581,85583,85584,2,3,0
24448,4,2,85585,85585,85587,0,2,1
24449,1,3,85586,85587,85590,1,4,0
24450,2,3,85588,85590,85593,2,5,0
24451,1,3,85589,85593,85596,4,7,0
24452,2,1,85591,85596,85597,5,6,0
24453,5,1,85596,85597,85598,1,2,0
24454,4,3,85600,85600,85603,0,3,2
24455,6,3,85606,85606,85609,0,3,3
24456,6,2,85612,85612,85614,0,2,3
24457,6,1,85618,85618,85619,0,1,4
24458,6,3,85624,85624,85627,0,3,5
24459,4,2,85628,85628,85630,0,2,1
24460,3,1,85631,85631,85632,0,1,1
24461,5,1,85636,85636,85637,0,1,4
24462,2,3,85638,85638,85641,0,3,1
24463,3,3,85641,85641,85644,0,3,0
24464,5,3,85646,85646,85649,0,3,2
24465,5,2,85651,85651,85653,0,2,2
24466,6,2,85657,85657,85659,0,2,4
24467,3,2,85660,85660,85662,0,2,1
24468,5,1,85665,85665,85666,0,1,3
24469,1,2,85666,85666,85668,0,2,0
24470,6,1,85672,85672,85673,0,1,4
24471,2,3,85674,85674,85677,0,3,1
24472,3,3,85677,85677,85680,0,3,0
24473,2,3,85679,85680,85683,1,4,0
24474,4,3,85683,85683,85686,0,3,0
24475,2,2,85685,85686,85688,1,3,0
24476,5,3,85690,85690,85693,0,3,2
24477,4,2,85694,85694,85696,0,2,1
24478,2,2,85696,85696,85698,0,2,0
24479,6,3,85702,85702,85705,0,3,4
24480,2,1,85704,85705,85706,1,2,0
24481,1,3,85705,85706,85709,1,4,0
24482,1,2,85706,85709,85711,3,5,0
24483,5,1,85711,85711,85712,0,1,0
24484,1,3,85712,85712,85715,0,3,0
24485,1,2,85713,85715,85717,2,4,0
24486,6,3,85719,85719,85722,0,3,2
24487,3,2,85722,85722,85724,0,2,0
24488,4,3,85726,85726,85729,0,3,2
24489,4,1,85730,85730,85731,0,1,1
24490,1,2,85731,85731,85733,0,2,0
24491,6,2,85737,85737,85739,0,2,4
24492,3,2,85740,85740,85742,0,2,1
24493,4,2,85744,85744,85746,0,2,2
24494,1,2,85745,85746,85748,1,3,0
24495,5,3,85750,85750,85753,0,3,2
24496,2,3,85752,85753,85756,1,4,0
24497,4,2,85756,85756,85758,0,2,0
24498,3,3,85759,85759,85762,0,3,1
24499,4,3,85763,85763,85766,0,3,1
24500,5,1,85768,85768,85769,0,1,2
24501,2,1,85770,85770,85771,0,1,1
24502,5,1,85775,85775,85776,0,1,4
24503,6,2,85781,85781,85783,0,2,5
24504,4,1,85785,85785,85786,0,1,2
24505,2,2,85787,85787,85789,0,2,1
24506,3,1,85790,85790,85791,0,1,1
24507,6,3,85796,85796,85799,0,3,5
24508,1,1,85797,85799,85800,2,3,0
24509,3,1,85800,85800,85801,0,1,0
24510,4,1,85804,85804,85805,0,1,3
24511,4,2,85808,85808,85810,0,2,3
24512,2,1,85810,85810,85811,0,1,0
24513,4,2,85814,85814,85816,0,2,3
24514,6,3,85820,85820,85823,0,3,4
24515,1,1,85821,85823,85824,2,3,0
24516,1,1,85822,85824,85825,2,3,0
24517,6,2,85828,85828,85830,0,2,3
24518,6,1,85834,85834,85835,0,1,4
24519,4,2,85838,85838,85840,0,2,3
24520,3,3,85841,85841,85844,0,3,1
24521,1,1,85842,85844,85845,2,3,0
24522,3,2,85845,85845,85847,0,2,0
24523,6,3,85851,85851,85854,0,3,4
24524,5,2,85856,85856,85858,0,2,2
24525,2,2,85858,85858,85860,0,2,0
24526,3,3,85861,85861,85864,0,3,1
24527,3,2,85864,85864,85866,0,2,0
24528,1,1,85865,85866,85867,1,2,0
24529,3,1,85868,85868,85869,0,1,1
24530,6,1,85874,85874,85875,0,1,5
24531,5,3,85879,85879,85882,0,3,4
24532,5,2,85884,85884,85886,0,2,2
24533,2,2,85886,85886,85888,0,2,0
24534,2,2,85888,85888,85890,0,2,0
24535,2,1,85890,85890,85891,0,1,0
24536,6,2,85896,85896,85898,0,2,5
24537,6,2,85902,85902,85904,0,2,4
24538,2,2,85904,85904,85906,0,2,0
24539,1,1,85905,85906,85907,1,2,0
24540,3,2,85908,85908,85910,0,2,1
24541,2,2,85910,85910,85912,0,2,0
24542,5,3,85915,85915,85918,0,3,3
24543,4,3,85919,85919,85922,0,3,1
24544,6,3,85925,85925,85928,0,3,3
24545,6,1,85931,85931,85932,0,1,3
24546,1,3,85932,85932,85935,0,3,0
24547,2,2,85934,85935,85937,1,3,0
24548,4,3,85938,85938,85941,0,3,1
24549,1,2,85939,85941,85943,2,4,0
24550,3,2,85942,85943,85945,1,3,0
24551,4,2,85946,85946,85948,0,2,1
24552,2,1,85948,85948,85949,0,1,0
24553,1,3,85949,85949,85952,0,3,0
24554,5,2,85954,85954,85956,0,2,2
24555,2,1,85956,85956,85957,0,1,0
24556,5,2,85961,85961,85963,0,2,4
24557,1,3,85962,85963,85966,1,4,0
24558,1,2,85963,85966,85968,3,5,0
24559,1,3,85964,85968,85971,4,7,0
24560,6,1,85970,85971,85972,1,2,0
24561,2,2,85972,85972,85974,0,2,0
24562,5,1,85977,85977,85978,0,1,3
24563,6,1,85983,85983,85984,0,1,5
24564,5,2,85988,85988,85990,0,2,4
24565,5,2,85993,85993,85995,0,2,3
24566,1,1,85994,85995,85996,1,2,0
24567,3,1,85997,85997,85998,0,1,1
24568,6,1,86003,86003,86004,0,1,5
24569,6,1,86009,86009,86010,0,1,5
24570,4,2,86013,86013,86015,0,2,3
24571,6,2,86019,86019,86021,0,2,4
24572,4,2,86023,86023,86025,0,2,2
24573,2,1,86025,86025,86026,0,1,0
24574,2,2,86027,86027,86029,0,2,1
24575,4,2,86031,86031,86033,0,2,2
24576,3,3,86034,86034,86037,0,3,1
24577,5,1,86039,86039,86040,0,1,2
24578,4,3,86043,86043,86046,0,3,3
24579,5,2,86048,86048,86050,0,2,2
24580,3,2,86051,86051,86053,0,2,1
24581,2,1,86053,86053,86054,0,1,0
24582,5,1,86058,86058,86059,0,1,4
24583,3,1,86061,86061,86062,0,1,2
24584,2,3,86063,86063,86066,0,3,1
24585,1,3,86064,86066,86069,2,5,0
24586,1,1,86065,86069,86070,4,5,0
24587,3,2,86068,86070,86072,2,4,0
24588,5,3,86073,86073,86076,0,3,1
24589,2,1,86075,86076,86077,1,2,0
24590,1,2,86076,86077,86079,1,3,0
24591,3,2,86079,86079,86081,0,2,0
24592,5,2,86084,86084,86086,0,2,3
24593,6,3,86090,86090,86093,0,3,4
24594,6,1,86096,86096,86097,0,1,3
24595,4,2,86100,86100,86102,0,2,3
24596,2,1,86102,86102,86103,0,1,0
24597,4,1,86106,86106,86107,0,1,3
24598,1,1,86107,86107,86108,0,1,0
24599,4,1,86111,86111,86112,0,1,3
24600,4,2,86115,86115,86117,0,2,3
24601,3,2,86118,86118,86120,0,2,1
24602,5,1,86123,86123,86124,0,1,3
24603,1,2,86124,86124,86126,0,2,0
24604,1,1,86125,86126,86127,1,2,0
24605,2,3,86127,86127,86130,0,3,0
24606,4,3,86131,86131,86134,0,3,1
24607,1,3,86132,86134,86137,2,5,0
24608,3,1,86135,86137,86138,2,3,0
24609,4,2,86139,86139,86141,0,2,1
24610,6,2,86145,86145,86147,0,2,4
24611,6,3,86151,86151,86154,0,3,4
24612,2,3,86153,86154,86157,1,4,0
24613,6,3,86159,86159,86162,0,3,2
24614,3,1,86162,86162,86163,0,1,0
24615,1,2,86163,86163,86165,0,2,0
24616,3,2,86166,86166,86168,0,2,1
24617,2,3,86168,86168,86171,0,3,0
24618,1,2,86169,86171,86173,2,4,0
24619,2,3,86171,86173,86176,2,5,0
24620,1,3,86172,86176,86179,4,7,0
24621,3,3,86175,86179,86182,4,7,0
24622,5,3,86180,86182,86185,2,5,0
24623,6,2,86186,86186,86188,0,2,1
24624,5,3,86191,86191,86194,0,3,3
24625,1,3,86192,86194,86197,2,5,0
24626,2,2,86194,86197,86199,3,5,0
24627,1,3,86195,86199,86202,4,7,0
24628,3,3,86198,86202,86205,4,7,0
24629,6,2,86204,86205,86207,1,3,0
24630,5,2,86209,86209,86211,0,2,2
24631,6,1,86215,86215,86216,0,1,4
24632,6,1,86221,86221,86222,0,1,5
24633,1,3,86222,86222,86225,0,3,0
24634,3,2,86225,86225,86227,0,2,0
24635,3,3,86228,86228,86231,0,3,1
24636,1,2,86229,86231,86233,2,4,0
24637,5,2,86234,86234,86236,0,2,1
24638,3,2,86237,86237,86239,0,2,1
24639,3,3,86240,86240,86243,0,3,1
24640,2,2,86242,86243,86245,1,3,0
24641,2,3,86244,86245,86248,1,4,0
24642,2,1,86246,86248,86249,2,3,0
24643,2,2,86248,86249,86251,1,3,0
24644,3,1,86251,86251,86252,0,1,0
24645,1,3,86252,86252,86255,0,3,0
24646,1,1,86253,86255,86256,2,3,0
24647,5,2,86258,86258,86260,0,2,2
24648,5,3,86263,86263,86266,0,3,3
24649,2,2,86265,86266,86268,1,3,0
24650,1,3,86266,86268,86271,2,5,0
24651,4,1,86270,86271,86272,1,2,0
24652,1,3,86271,86272,86275,1,4,0
24653,4,1,86275,86275,86276,0,1,0
24654,4,1,86279,86279,86280,0,1,3
24655,4,2,86283,86283,86285,0,2,3
24656,2,3,86285,86285,86288,0,3,0
24657,2,1,86287,86288,86289,1,2,0
24658,2,3,86289,86289,86292,0,3,0
24659,2,1,86291,86292,86293,1,2,0
24660,1,3,86292,86293,86296,1,4,0
24661,2,2,86294,86296,86298,2,4,0
24662,6,3,86300,86300,86303,0,3,2
24663,1,2,86301,86303,86305,2,4,0
24664,5,1,86306,86306,86307,0,1,1
24665,5,3,86311,86311,86314,0,3,4
24666,6,2,86317,86317,86319,0,2,3
24667,5,3,86322,86322,86325,0,3,3
24668,5,3,86327,86327,86330,0,3,2
24669,4,3,86331,86331,86334,0,3,1
24670,1,2,86332,86334,86336,2,4,0
24671,2,2,86334,86336,86338,2,4,0
24672,3,2,86337,86338,86340,1,3,0
24673,6,3,86343,86343,86346,0,3,3
24674,3,1,86346,86346,86347,0,1,0
24675,5,2,86351,86351,86353,0,2,4
24676,5,3,86356,86356,86359,0,3,3
24677,6,2,86362,86362,86364,0,2,3
24678,2,1,86364,86364,86365,0,1,0
24679,6,3,86370,86370,86373,0,3,5
24680,3,2,86373,86373,86375,0,2,0
24681,6,2,86379,86379,86381,0,2,4
24682,2,2,86381,86381,86383,0,2,0
24683,4,1,86385,86385,86386,0,1,2
24684,4,2,86389,86389,86391,0,2,3
24685,3,1,86392,86392,86393,0,1,1
24686,5,2,86397,86397,86399,0,2,4
24687,4,3,86401,86401,86404,0,3,2
24688,2,2,86403,86404,86406,1,3,0
24689,6,1,86409,86409,86410,0,1,3
24690,6,2,86415,86415,86417,0,2,5
24691,6,2,86421,86421,86423,0,2,4
24692,2,2,86423,86423,86425,0,2,0
24693,2,2,86425,86425,86427,0,2,0
24694,1,2,86426,86427,86429,1,3,0
24695,6,1,86432,86432,86433,0,1,3
24696,3,3,86435,86435,86438,0,3,2
24697,6,2,86441,86441,86443,0,2,3
24698,5,3,86446,86446,86449,0,3,3
24699,1,3,86447,86449,86452,2,5,0
24700,5,3,86452,86452,86455,0,3,0
24701,2,1,86454,86455,86456,1,2,0
24702,1,1,86455,86456,86457,1,2,0
24703,4,3,86459,86459,86462,0,3,2
24704,4,2,86463,86463,86465,0,2,1
24705,1,2,86464,86465,86467,1,3,0
24706,3,3,86467,86467,86470,0,3,0
24707,6,2,86473,86473,86475,0,2,3
24708,2,3,86475,86475,86478,0,3,0
24709,3,1,86478,86478,86479,0,1,0
24710,6,3,86484,86484,86487,0,3,5
24711,6,2,86490,86490,86492,0,2,3
24712,1,3,86491,86492,86495,1,4,0
24713,2,2,86493,86495,86497,2,4,0
24714,3,2,86496,86497,86499,1,3,0
24715,2,1,86498,86499,86500,1,2,0
24716,2,2,86500,86500,86502,0,2,0
24717,2,1,86502,86502,86503,0,1,0
24718,5,3,86507,86507,86510,0,3,4
24719,4,1,86511,86511,86512,0,1,1
24720,5,3,86516,86516,86519,0,3,4
24721,5,1,86521,86521,86522,0,1,2
24722,5,1,86526,86526,86527,0,1,4
24723,4,3,86530,86530,86533,0,3,3
24724,3,2,86533,86533,86535,0,2,0
24725,6,1,86539,86539,86540,0,1,4
24726,4,3,86543,86543,86546,0,3,3
24727,1,3,86544,86546,86549,2,5,0
24728,6,3,86550,86550,86553,0,3,1
24729,1,1,86551,86553,86554,2,3,0
24730,5,1,86556,86556,86557,0,1,2
24731,3,2,86559,86559,86561,0,2,2
24732,5,1,86564,86564,86565,0,1,3
24733,6,2,86570,86570,86572,0,2,5
24734,1,3,86571,86572,86575,1,4,0
24735,2,3,86573,86575,86578,2,5,0
24736,5,3,86578,86578,86581,0,3,0
24737,6,1,86584,86584,86585,0,1,3
24738,5,2,86589,86589,86591,0,2,4
24739,4,2,86593,86593,86595,0,2,2
24740,4,1,86597,86597,86598,0,1,2
24741,4,2,86601,86601,86603,0,2,3
24742,4,2,86605,86605,86607,0,2,2
24743,5,1,86610,86610,86611,0,1,3
24744,4,1,86614,86614,86615,0,1,3
24745,2,2,86616,86616,86618,0,2,1
24746,5,1,86621,86621,86622,0,1,3
24747,4,3,86625,86625,86628,0,3,3
24748,4,1,86629,86629,86630,0,1,1
24749,6,1,86635,86635,86636,0,1,5
24750,5,2,86640,86640,86642,0,2,4
24751,6,2,86646,86646,86648,0,2,4
24752,2,1,86648,86648,86649,0,1,0
24753,4,3,86652,86652,86655,0,3,3
24754,3,3,86655,86655,86658,0,3,0
24755,4,2,86659,86659,86661,0,2,1
24756,5,1,86664,86664,86665,0,1,3
24757,3,2,86667,86667,86669,0,2,2
24758,3,3,86670,86670,86673,0,3,1
24759,1,2,86671,86673,86675,2,4,0
24760,4,2,86675,86675,86677,0,2,0
24761,2,3,86677,86677,86680,0,3,0
24762,1,3,86678,86680,86683,2,5,0
24763,2,1,86680,86683,86684,3,4,0
24764,4,2,86684,86684,86686,0,2,0
24765,3,1,86687,86687,86688,0,1,1
24766,6,1,86693,86693,86694,0,1,5
24767,3,1,86696,86696,86697,0,1,2
24768,1,3,86697,86697,86700,0,3,0
24769,2,3,86699,86700,86703,1,4,0
24770,1,2,86700,86703,86705,3,5,0
24771,1,2,86701,86705,86707,4,6,0
24772,6,1,86707,86707,86708,0,1,0
24773,5,3,86712,86712,86715,0,3,4
24774,3,1,86715,86715,86716,0,1,0
24775,4,1,86719,86719,86720,0,1,3
24776,6,3,86725,86725,86728,0,3,5
24777,5,3,86730,86730,86733,0,3,2
24778,5,1,86735,86735,86736,0,1,2
24779,1,1,86736,86736,86737,0,1,0
24780,1,3,86737,86737,86740,0,3,0
24781,5,1,86742,86742,86743,0,1,2
24782,2,1,86744,86744,86745,0,1,1
24783,3,1,86747,86747,86748,0,1,2
24784,3,1,86750,86750,86751,0,1,2
24785,2,2,86752,86752,86754,0,2,1
24786,6,3,86758,86758,86761,0,3,4
24787,5,2,86763,86763,86765,0,2,2
24788,2,1,86765,86765,86766,0,1,0
24789,6,1,86771,86771,86772,0,1,5
24790,5,1,86776,86776,86777,0,1,4
24791,2,3,86778,86778,86781,0,3,1
24792,4,3,86782,86782,86785,0,3,1
24793,2,2,86784,86785,86787,1,3,0
24794,3,3,86787,86787,86790,0,3,0
24795,6,2,86793,86793,86795,0,2,3
24796,1,1,86794,86795,86796,1,2,0
24797,3,1,86797,86797,86798,0,1,1
24798,5,2,86802,86802,86804,0,2,4
24799,6,2,86808,86808,86810,0,2,4
24800,1,1,86809,86810,86811,1,2,0
24801,4,3,86813,86813,86816,0,3,2
24802,6,3,86819,86819,86822,0,3,3
24803,5,3,86824,86824,86827,0,3,2
24804,4,1,86828,86828,86829,0,1,1
24805,4,1,86832,86832,86833,0,1,3
24806,6,1,86838,86838,86839,0,1,5
24807,4,1,86842,86842,86843,0,1,3
24808,2,2,86844,86844,86846,0,2,1
24809,6,1,86850,86850,86851,0,1,4
24810,1,3,86851,86851,86854,0,3,0
24811,1,1,86852,86854,86855,2,3,0
24812,5,1,86857,86857,86858,0,1,2
24813,5,2,86862,86862,86864,0,2,4
24814,2,2,86864,86864,86866,0,2,0
24815,1,2,86865,86866,86868,1,3,0
24816,4,2,86869,86869,86871,0,2,1
24817,5,3,86874,86874,86877,0,3,3
24818,4,2,86878,86878,86880,0,2,1
24819,4,3,86882,86882,86885,0,3,2
24820,5,3,86887,86887,86890,0,3,2
24821,5,3,86892,86892,86895,0,3,2
24822,2,2,86894,86895,86897,1,3,0
24823,1,1,86895,86897,86898,2,3,0
24824,1,1,86896,86898,86899,2,3,0
24825,3,2,86899,86899,86901,0,2,0
24826,5,2,86904,86904,86906,0,2,3
24827,5,1,86909,86909,86910,0,1,3
24828,6,3,86915,86915,86918,0,3,5
24829,2,1,86917,86918,86919,1,2,0
24830,2,1,86919,86919,86920,0,1,0
24831,6,2,86925,86925,86927,0,2,5
24832,3,2,86928,86928,86930,0,2,1
24833,6,3,86934,86934,86937,0,3,4
24834,3,3,86937,86937,86940,0,3,0
24835,6,3,86943,86943,86946,0,3,3
24836,3,2,86946,86946,86948,0,2,0
24837,2,2,86948,86948,86950,0,2,0
24838,6,3,86954,86954,86957,0,3,4
24839,1,3,86955,86957,86960,2,5,0
24840,1,2,86956,86960,86962,4,6,0
24841,2,2,86958,86962,86964,4,6,0
24842,6,1,86964,86964,86965,0,1,0
24843,4,1,86968,86968,86969,0,1,3
24844,1,1,86969,86969,86970,0,1,0
24845,3,3,86972,86972,86975,0,3,2
24846,3,2,86975,86975,86977,0,2,0
24847,1,2,86976,86977,86979,1,3,0
24848,6,1,86982,86982,86983,0,1,3
24849,5,1,86987,86987,86988,0,1,4
24850,2,2,86989,86989,86991,0,2,1
24851,2,2,86991,86991,86993,0,2,0
24852,1,1,86992,86993,86994,1,2,0
24853,5,2,86997,86997,86999,0,2,3
24854,2,2,86999,86999,87001,0,2,0
24855,5,3,87004,87004,87007,0,3,3
24856,5,1,87009,87009,87010,0,1,2
24857,4,1,87013,87013,87014,0,1,3
24858,5,3,87018,87018,87021,0,3,4
24859,5,2,87023,87023,87025,0,2,2
24860,5,2,87028,87028,87030,0,2,3
24861,2,2,87030,87030,87032,0,2,0
24862,6,3,87036,87036,87039,0,3,4
24863,6,1,87042,87042,87043,0,1,3
24864,1,2,87043,87043,87045,0,2,0
24865,2,3,87045,87045,87048,0,3,0
24866,5,1,87050,87050,87051,0,1,2
24867,1,2,87051,87051,87053,0,2,0
24868,3,2,87054,87054,87056,0,2,1
24869,5,2,87059,87059,87061,0,2,3
24870,3,2,87062,87062,87064,0,2,1
24871,2,3,87064,87064,87067,0,3,0
24872,6,3,87070,87070,87073,0,3,3
24873,1,2,87071,87073,87075,2,4,0
24874,6,2,87077,87077,87079,0,2,2
24875,4,1,87081,87081,87082,0,1,2
24876,6,2,87087,87087,87089,0,2,5
24877,5,3,87092,87092,87095,0,3,3
24878,5,2,87097,87097,87099,0,2,2
24879,3,2,87100,87100,87102,0,2,1
24880,2,1,87102,87102,87103,0,1,0
24881,2,3,87104,87104,87107,0,3,1
24882,3,1,87107,87107,87108,0,1,0
24883,6,1,87113,87113,87114,0,1,5
24884,1,2,87114,87114,87116,0,2,0
24885,1,3,87115,87116,87119,1,4,0
24886,3,3,87118,87119,87122,1,4,0
24887,3,1,87121,87122,87123,1,2,0
24888,4,3,87125,87125,87128,0,3,2
24889,5,3,87130,87130,87133,0,3,2
24890,5,2,87135,87135,87137,0,2,2
24891,1,3,87136,87137,87140,1,4,0
24892,1,2,87137,87140,87142,3,5,0
24893,4,3,87141,87142,87145,1,4,0
24894,4,3,87145,87145,87148,0,3,0
24895,2,3,87147,87148,87151,1,4,0
24896,5,3,87152,87152,87155,0,3,1
24897,3,2,87155,87155,87157,0,2,0
24898,2,1,87157,87157,87158,0,1,0
24899,1,3,87158,87158,87161,0,3,0
24900,2,2,87160,87161,87163,1,3,0
24901,1,3,87161,87163,87166,2,5,0
24902,6,3,87167,87167,87170,0,3,1
24903,5,1,87172,87172,87173,0,1,2
24904,1,3,87173,87173,87176,0,3,0
24905,2,3,87175,87176,87179,1,4,0
24906,2,2,87177,87179,87181,2,4,0
24907,4,1,87181,87181,87182,0,1,0
24908,6,3,87187,87187,87190,0,3,5
24909,3,3,87190,87190,87193,0,3,0
24910,3,1,87193,87193,87194,0,1,0
24911,6,3,87199,87199,87202,0,3,5
24912,5,2,87204,87204,87206,0,2,2
24913,1,2,87205,87206,87208,1,3,0
24914,6,1,87211,87211,87212,0,1,3
24915,1,2,87212,87212,87214,0,2,0
24916,5,3,87217,87217,87220,0,3,3
24917,2,3,87219,87220,87223,1,4,0
24918,4,1,87223,87223,87224,0,1,0
24919,4,2,87227,87227,87229,0,2,3
24920,3,3,87230,87230,87233,0,3,1
24921,4,3,87234,87234,87237,0,3,1
24922,2,3,87236,87237,87240,1,4,0
24923,5,1,87241,87241,87242,0,1,1
24924,4,3,87245,87245,87248,0,3,3
24925,3,2,87248,87248,87250,0,2,0
24926,5,3,87253,87253,87256,0,3,3
24927,1,2,87254,87256,87258,2,4,0
24928,4,1,87258,87258,87259,0,1,0
24929,4,2,87262,87262,87264,0,2,3
24930,3,1,87265,87265,87266,0,1,1
24931,1,1,87266,87266,87267,0,1,0
24932,6,3,87272,87272,87275,0,3,5
24933,3,1,87275,87275,87276,0,1,0
24934,1,1,87276,87276,87277,0,1,0
24935,4,1,87280,87280,87281,0,1,3
24936,6,2,87286,87286,87288,0,2,5
24937,1,3,87287,87288,87291,1,4,0
24938,2,2,87289,87291,87293,2,4,0
24939,3,3,87292,87293,87296,1,4,0
24940,3,3,87295,87296,87299,1,4,0
24941,4,2,87299,87299,87301,0,2,0
24942,3,2,87302,87302,87304,0,2,1
24943,2,3,87304,87304,87307,0,3,0
24944,2,1,87306,87307,87308,1,2,0
24945,1,2,87307,87308,87310,1,3,0
24946,5,3,87312,87312,87315,0,3,2
24947,6,1,87318,87318,87319,0,1,3
24948,3,3,87321,87321,87324,0,3,2
24949,5,2,87326,87326,87328,0,2,2
24950,4,1,87330,87330,87331,0,1,2
24951,6,1,87336,87336,87337,0,1,5
24952,3,3,87339,87339,87342,0,3,2
24953,1,2,87340,87342,87344,2,4,0
24954,5,3,87345,87345,87348,0,3,1
24955,1,3,87346,87348,87351,2,5,0
24956,1,1,87347,87351,87352,4,5,0
24957,3,2,87350,87352,87354,2,4,0
24958,2,3,87352,87354,87357,2,5,0
24959,2,1,87354,87357,87358,3,4,0
24960,5,2,87359,87359,87361,0,2,1
24961,5,2,87364,87364,87366,0,2,3
24962,4,2,87368,87368,87370,0,2,2
24963,6,3,87374,87374,87377,0,3,4
24964,3,3,87377,87377,87380,0,3,0
24965,2,3,87379,87380,87383,1,4,0
24966,5,1,87384,87384,87385,0,1,1
24967,2,1,87386,87386,87387,0,1,1
24968,6,3,87392,87392,87395,0,3,5
24969,2,1,87394,87395,87396,1,2,0
24970,1,3,87395,87396,87399,1,4,0
24971,2,2,87397,87399,87401,2,4,0
24972,6,2,87403,87403,87405,0,2,2
24973,6,1,87409,87409,87410,0,1,4
24974,4,1,87413,87413,87414,0,1,3
24975,4,1,87417,87417,87418,0,1,3
24976,2,3,87419,87419,87422,0,3,1
24977,3,1,87422,87422,87423,0,1,0
24978,1,3,87423,87423,87426,0,3,0
24979,3,2,87426,87426,87428,0,2,0
24980,1,1,87427,87428,87429,1,2,0
24981,5,3,87432,87432,87435,0,3,3
24982,5,3,87437,87437,87440,0,3,2
24983,5,3,87442,87442,87445,0,3,2
24984,5,1,87447,87447,87448,0,1,2
24985,6,2,87453,87453,87455,0,2,5
24986,4,3,87457,87457,87460,0,3,2
24987,2,2,87459,87460,87462,1,3,0
24988,5,3,87464,87464,87467,0,3,2
24989,2,2,87466,87467,87469,1,3,0
24990,4,2,87470,87470,87472,0,2,1
24991,2,2,87472,87472,87474,0,2,0
24992,6,3,87478,87478,87481,0,3,4
24993,4,2,87482,87482,87484,0,2,1
24994,6,2,87488,87488,87490,0,2,4
24995,6,1,87494,87494,87495,0,1,4
24996,5,3,87499,87499,87502,0,3,4
24997,3,2,87502,87502,87504,0,2,0
24998,3,2,87505,87505,87507,0,2,1
24999,5,3,87510,87510,87513,0,3,3
25000,5,1,87515,87515,87516,0,1,2
25001,1,1,87516,87516,87517,0,1,0
25002,1,2,87517,87517,87519,0,2,0
25003,6,1,87523,87523,87524,0,1,4
25004,4,2,87527,87527,87529,0,2,3
25005,2,1,87529,87529,87530,0,1,0
25006,4,2,87533,87533,87535,0,2,3
25007,4,3,87537,87537,87540,0,3,2
25008,5,1,87542,87542,87543,0,1,2
25009,3,3,87545,87545,87548,0,3,2
25010,2,2,87547,87548,87550,1,3,0
25011,5,1,87552,87552,87553,0,1,2
25012,3,3,87555,87555,87558,0,3,2
25013,6,1,87561,87561,87562,0,1,3
25014,6,3,87567,87567,87570,0,3,5
25015,6,3,87573,87573,87576,0,3,3
25016,5,3,87578,87578,87581,0,3,2
25017,6,1,87584,87584,87585,0,1,3
25018,4,3,87588,87588,87591,0,3,3
25019,5,2,87593,87593,87595,0,2,2
25020,6,2,87599,87599,87601,0,2,4
25021,6,2,87605,87605,87607,0,2,4
25022,1,1,87606,87607,87608,1,2,0
25023,1,3,87607,87608,87611,1,4,0
25024,5,2,87612,87612,87614,0,2,1
25025,2,3,87614,87614,87617,0,3,0
25026,5,3,87619,87619,87622,0,3,2
25027,1,1,87620,87622,87623,2,3,0
25028,2,1,87622,87623,87624,1,2,0
25029,2,3,87624,87624,87627,0,3,0
25030,1,3,87625,87627,87630,2,5,0
25031,5,1,87630,87630,87631,0,1,0
25032,3,1,87633,87633,87634,0,1,2
25033,4,3,87637,87637,87640,0,3,3
25034,2,3,87639,87640,87643,1,4,0
25035,3,2,87642,87643,87645,1,3,0
25036,1,3,87643,87645,87648,2,5,0
25037,3,1,87646,87648,87649,2,3,0
25038,3,3,87649,87649,87652,0,3,0
25039,5,2,87654,87654,87656,0,2,2
25040,3,3,87657,87657,87660,0,3,1
25041,4,3,87661,87661,87664,0,3,1
25042,6,2,87667,87667,87669,0,2,3
25043,3,2,87670,87670,87672,0,2,1
25044,2,2,87672,87672,87674,0,2,0
25045,3,3,87675,87675,87678,0,3,1
25046,5,2,87680,87680,87682,0,2,2
25047,3,2,87683,87683,87685,0,2,1
25048,5,2,87688,87688,87690,0,2,3
25049,4,3,87692,87692,87695,0,3,2
25050,4,3,87696,87696,87699,0,3,1
25051,6,3,87702,87702,87705,0,3,3
25052,2,1,87704,87705,87706,1,2,0
25053,4,1,87708,87708,87709,0,1,2
25054,5,3,87713,87713,87716,0,3,4
25055,3,1,87716,87716,87717,0,1,0
25056,2,2,87718,87718,87720,0,2,1
25057,3,3,87721,87721,87724,0,3,1
25058,2,3,87723,87724,87727,1,4,0
25059,6,2,87729,87729,87731,0,2,2
25060,1,1,87730,87731,87732,1,2,0
25061,5,1,87735,87735,87736,0,1,3
25062,5,3,87740,87740,87743,0,3,4
25063,4,3,87744,87744,87747,0,3,1
25064,2,1,87746,87747,87748,1,2,0
25065,3,1,87749,87749,87750,0,1,1
25066,4,3,87753,87753,87756,0,3,3
25067,5,1,87758,87758,87759,0,1,2
25068,2,3,87760,87760,87763,0,3,1
25069,2,3,87762,87763,87766,1,4,0
25070,2,3,87764,87766,87769,2,5,0
25071,5,1,87769,87769,87770,0,1,0
25072,3,1,87772,87772,87773,0,1,2
25073,1,2,87773,87773,87775,0,2,0
25074,3,2,87776,87776,87778,0,2,1
25075,5,2,87781,87781,87783,0,2,3
25076,3,2,87784,87784,87786,0,2,1
25077,3,1,87787,87787,87788,0,1,1
25078,3,3,87790,87790,87793,0,3,2
25079,4,1,87794,87794,87795,0,1,1
25080,4,1,87798,87798,87799,0,1,3
25081,2,2,87800,87800,87802,0,2,1
25082,6,1,87806,87806,87807,0,1,4
25083,5,3,87811,87811,87814,0,3,4
25084,1,1,87812,87814,87815,2,3,0
25085,2,3,87814,87815,87818,1,4,0
25086,6,3,87820,87820,87823,0,3,2
25087,4,1,87824,87824,87825,0,1,1
25088,5,1,87829,87829,87830,0,1,4
25089,1,3,87830,87830,87833,0,3,0
25090,3,3,87833,87833,87836,0,3,0
25091,4,2,87837,87837,87839,0,2,1
25092,4,3,87841,87841,87844,0,3,2
25093,5,3,87846,87846,87849,0,3,2
25094,6,3,87852,87852,87855,0,3,3
25095,3,2,87855,87855,87857,0,2,0
25096,1,1,87856,87857,87858,1,2,0
25097,4,2,87860,87860,87862,0,2,2
25098,3,1,87863,87863,87864,0,1,1
25099,4,2,87867,87867,87869,0,2,3
25100,2,3,87869,87869,87872,0,3,0
25101,1,2,87870,87872,87874,2,4,0
25102,6,3,87876,87876,87879,0,3,2
25103,1,3,87877,87879,87882,2,5,0
25104,5,3,87882,87882,87885,0,3,0
25105,6,1,87888,87888,87889,0,1,3
25106,1,3,87889,87889,87892,0,3,0
25107,3,1,87892,87892,87893,0,1,0
25108,1,1,87893,87893,87894,0,1,0
25109,6,1,87899,87899,87900,0,1,5
25110,4,1,87903,87903,87904,0,1,3
25111,5,1,87908,87908,87909,0,1,4
25112,3,1,87911,87911,87912,0,1,2
25113,3,3,87914,87914,87917,0,3,2
25114,5,2,87919,87919,87921,0,2,2
25115,4,1,87923,87923,87924,0,1,2
25116,3,1,87926,87926,87927,0,1,2
25117,1,1,87927,87927,87928,0,1,0
25118,4,3,87931,87931,87934,0,3,3
25119,3,1,87934,87934,87935,0,1,0
25120,2,3,87936,87936,87939,0,3,1
25121,1,2,87937,87939,87941,2,4,0
25122,2,1,87939,87941,87942,2,3,0
25123,2,1,87941,87942,87943,1,2,0
25124,4,1,87945,87945,87946,0,1,2
25125,1,1,87946,87946,87947,0,1,0
25126,2,3,87948,87948,87951,0,3,1
25127,1,2,87949,87951,87953,2,4,0
25128,5,2,87954,87954,87956,0,2,1
25129,4,2,87958,87958,87960,0,2,2
25130,4,2,87962,87962,87964,0,2,2
25131,6,1,87968,87968,87969,0,1,4
25132,2,1,87970,87970,87971,0,1,1
25133,6,1,87976,87976,87977,0,1,5
25134,3,1,87979,87979,87980,0,1,2
25135,5,3,87984,87984,87987,0,3,4
25136,1,1,87985,87987,87988,2,3,0
25137,4,1,87989,87989,87990,0,1,1
25138,4,2,87993,87993,87995,0,2,3
25139,5,1,87998,87998,87999,0,1,3
25140,1,2,87999,87999,88001,0,2,0
25141,3,2,88002,88002,88004,0,2,1
25142,4,3,88006,88006,88009,0,3,2
25143,2,1,88008,88009,88010,1,2,0
25144,3,2,88011,88011,88013,0,2,1
25145,1,3,88012,88013,88016,1,4,0
25146,1,2,88013,88016,88018,3,5,0
25147,2,3,88015,88018,88021,3,6,0
25148,5,1,88020,88021,88022,1,2,0
25149,1,3,88021,88022,88025,1,4,0
25150,4,2,88025,88025,88027,0,2,0
25151,5,2,88030,88030,88032,0,2,3
25152,6,1,88036,88036,88037,0,1,4
25153,1,2,88037,88037,88039,0,2,0
25154,6,1,88043,88043,88044,0,1,4
25155,4,2,88047,88047,88049,0,2,3
25156,2,1,88049,88049,88050,0,1,0
25157,4,1,88053,88053,88054,0,1,3
25158,2,3,88055,88055,88058,0,3,1
25159,5,3,88060,88060,88063,0,3,2
25160,6,3,88066,88066,88069,0,3,3
25161,3,3,88069,88069,88072,0,3,0
25162,4,2,88073,88073,88075,0,2,1
25163,6,1,88079,88079,88080,0,1,4
25164,3,2,88082,88082,88084,0,2,2
25165,6,3,88088,88088,88091,0,3,4
25166,6,3,88094,88094,88097,0,3,3
25167,6,1,88100,88100,88101,0,1,3
25168,6,2,88106,88106,88108,0,2,5
25169,1,1,88107,88108,88109,1,2,0
25170,5,2,88112,88112,88114,0,2,3
25171,5,2,88117,88117,88119,0,2,3
25172,4,2,88121,88121,88123,0,2,2
25173,1,2,88122,88123,88125,1,3,0
25174,4,1,88126,88126,88127,0,1,1
25175,2,3,88128,88128,88131,0,3,1
25176,2,2,88130,88131,88133,1,3,0
25177,2,3,88132,88133,88136,1,4,0
25178,5,2,88137,88137,88139,0,2,1
25179,5,2,88142,88142,88144,0,2,3
25180,2,3,88144,88144,88147,0,3,0
25181,1,2,88145,88147,88149,2,4,0
25182,6,1,88151,88151,88152,0,1,2
25183,6,2,88157,88157,88159,0,2,5
25184,1,2,88158,88159,88161,1,3,0
25185,3,2,88161,88161,88163,0,2,0
25186,5,3,88166,88166,88169,0,3,3
25187,2,1,88168,88169,88170,1,2,0
25188,3,1,88171,88171,88172,0,1,1
25189,2,2,88173,88173,88175,0,2,1
25190,2,3,88175,88175,88178,0,3,0
25191,2,1,88177,88178,88179,1,2,0
25192,4,1,88181,88181,88182,0,1,2
25193,5,2,88186,88186,88188,0,2,4
25194,3,1,88189,88189,88190,0,1,1
25195,3,3,88192,88192,88195,0,3,2
25196,4,1,88196,88196,88197,0,1,1
25197,3,2,88199,88199,88201,0,2,2
25198,2,1,88201,88201,88202,0,1,0
25199,6,2,88207,88207,88209,0,2,5
25200,3,1,88210,88210,88211,0,1,1
25201,6,2,88216,88216,88218,0,2,5
25202,4,1,88220,88220,88221,0,1,2
25203,6,1,88226,88226,88227,0,1,5
25204,1,2,88227,88227,88229,0,2,0
25205,1,3,88228,88229,88232,1,4,0
25206,6,3,88234,88234,88237,0,3,2
25207,5,3,88239,88239,88242,0,3,2
25208,4,2,88243,88243,88245,0,2,1
25209,4,3,88247,88247,88250,0,3,2
25210,1,1,88248,88250,88251,2,3,0
25211,2,1,88250,88251,88252,1,2,0
25212,2,3,88252,88252,88255,0,3,0
25213,6,1,88258,88258,88259,0,1,3
25214,4,2,88262,88262,88264,0,2,3
25215,5,1,88267,88267,88268,0,1,3
25216,6,1,88273,88273,88274,0,1,5
25217,4,2,88277,88277,88279,0,2,3
25218,3,2,88280,88280,88282,0,2,1
25219,1,3,88281,88282,88285,1,4,0
25220,6,3,88287,88287,88290,0,3,2
25221,5,2,88292,88292,88294,0,2,2
25222,2,3,88294,88294,88297,0,3,0
25223,4,3,88298,88298,88301,0,3,1
25224,3,3,88301,88301,88304,0,3,0
25225,5,3,88306,88306,88309,0,3,2
25226,3,2,88309,88309,88311,0,2,0
25227,4,3,88313,88313,88316,0,3,2
25228,5,2,88318,88318,88320,0,2,2
25229,6,2,88324,88324,88326,0,2,4
25230,2,2,88326,88326,88328,0,2,0
25231,2,2,88328,88328,88330,0,2,0
25232,1,1,88329,88330,88331,1,2,0
25233,4,1,88333,88333,88334,0,1,2
25234,2,3,88335,88335,88338,0,3,1
25235,1,2,88336,88338,88340,2,4,0
25236,4,1,88340,88340,88341,0,1,0
25237,6,1,88346,88346,88347,0,1,5
25238,6,1,88352,88352,88353,0,1,5
25239,2,2,88354,88354,88356,0,2,1
25240,4,2,88358,88358,88360,0,2,2
25241,5,1,88363,88363,88364,0,1,3
25242,6,1,88369,88369,88370,0,1,5
25243,5,3,88374,88374,88377,0,3,4
25244,5,3,88379,88379,88382,0,3,2
25245,4,2,88383,88383,88385,0,2,1
25246,2,3,88385,88385,88388,0,3,0
25247,3,1,88388,88388,88389,0,1,0
25248,5,1,88393,88393,88394,0,1,4
25249,3,3,88396,88396,88399,0,3,2
25250,2,1,88398,88399,88400,1,2,0
25251,1,1,88399,88400,88401,1,2,0
25252,2,2,88401,88401,88403,0,2,0
25253,1,2,88402,88403,88405,1,3,0
25254,3,2,88405,88405,88407,0,2,0
25255,2,2,88407,88407,88409,0,2,0
25256,4,1,88411,88411,88412,0,1,2
25257,1,1,88412,88412,88413,0,1,0
25258,6,3,88418,88418,88421,0,3,5
25259,6,3,88424,88424,88427,0,3,3
25260,1,1,88425,88427,88428,2,3,0
25261,4,3,88429,88429,88432,0,3,1
25262,5,2,88434,88434,88436,0,2,2
25263,1,1,88435,88436,88437,1,2,0
25264,3,2,88438,88438,88440,0,2,1
25265,4,2,88442,88442,88444,0,2,2
25266,2,1,88444,88444,88445,0,1,0
25267,2,1,88446,88446,88447,0,1,1
25268,3,1,88449,88449,88450,0,1,2
25269,4,3,88453,88453,88456,0,3,3
25270,1,1,88454,88456,88457,2,3,0
25271,4,2,88458,88458,88460,0,2,1
25272,6,3,88464,88464,88467,0,3,4
25273,5,2,88469,88469,88471,0,2,2
25274,4,2,88473,88473,88475,0,2,2
25275,3,2,88476,88476,88478,0,2,1
25276,1,1,88477,88478,88479,1,2,0
25277,6,1,88483,88483,88484,0,1,4
25278,4,3,88487,88487,88490,0,3,3
25279,2,2,88489,88490,88492,1,3,0
25280,1,2,88490,88492,88494,2,4,0
25281,2,3,88492,88494,88497,2,5,0
25282,3,3,88495,88497,88500,2,5,0
25283,6,2,88501,88501,88503,0,2,1
25284,4,3,88505,88505,88508,0,3,2
25285,6,2,88511,88511,88513,0,2,3
25286,4,2,88515,88515,88517,0,2,2
25287,1,2,88516,88517,88519,1,3,0
25288,4,1,88520,88520,88521,0,1,1
25289,3,2,88523,88523,88525,0,2,2
25290,2,3,88525,88525,88528,0,3,0
25291,4,3,88529,88529,88532,0,3,1
25292,3,1,88532,88532,88533,0,1,0
25293,6,3,88538,88538,88541,0,3,5
25294,1,2,88539,88541,88543,2,4,0
25295,2,1,88541,88543,88544,2,3,0
25296,3,2,88544,88544,88546,0,2,0
25297,3,2,88547,88547,88549,0,2,1
25298,5,2,88552,88552,88554,0,2,3
25299,1,3,88553,88554,88557,1,4,0
25300,5,2,88558,88558,88560,0,2,1
25301,1,3,88559,88560,88563,1,4,0
25302,2,2,88561,88563,88565,2,4,0
25303,2,2,88563,88565,88567,2,4,0
25304,4,2,88567,88567,88569,0,2,0
25305,4,2,88571,88571,88573,0,2,2
25306,4,1,88575,88575,88576,0,1,2
25307,6,1,88581,88581,88582,0,1,5
25308,1,3,88582,88582,88585,0,3,0
25309,6,1,88588,88588,88589,0,1,3
25310,3,1,88591,88591,88592,0,1,2
25311,2,2,88593,88593,88595,0,2,1
25312,5,2,88598,88598,88600,0,2,3
25313,6,1,88604,88604,88605,0,1,4
25314,5,1,88609,88609,88610,0,1,4
25315,4,3,88613,88613,88616,0,3,3
25316,2,2,88615,88616,88618,1,3,0
25317,3,1,88618,88618,88619,0,1,0
25318,2,2,88620,88620,88622,0,2,1
25319,2,3,88622,88622,88625,0,3,0
25320,6,1,88628,88628,88629,0,1,3
25321,1,2,88629,88629,88631,0,2,0
25322,1,1,88630,88631,88632,1,2,0
25323,6,2,88636,88636,88638,0,2,4
25324,4,2,88640,88640,88642,0,2,2
25325,4,1,88644,88644,88645,0,1,2
25326,6,1,88650,88650,88651,0,1,5
25327,5,2,88655,88655,88657,0,2,4
25328,1,2,88656,88657,88659,1,3,0
25329,1,3,88657,88659,88662,2,5,0
25330,3,3,88660,88662,88665,2,5,0
25331,5,1,88665,88665,88666,0,1,0
25332,3,1,88668,88668,88669,0,1,2
25333,5,1,88673,88673,88674,0,1,4
25334,5,3,88678,88678,88681,0,3,4
25335,6,1,88684,88684,88685,0,1,3
25336,4,1,88688,88688,88689,0,1,3
25337,6,3,88694,88694,88697,0,3,5
25338,5,3,88699,88699,88702,0,3,2
25339,3,3,88702,88702,88705,0,3,0
25340,5,2,88707,88707,88709,0,2,2
25341,2,3,88709,88709,88712,0,3,0
25342,2,2,88711,88712,88714,1,3,0
25343,5,2,88716,88716,88718,0,2,2
25344,5,1,88721,88721,88722,0,1,3
25345,1,3,88722,88722,88725,0,3,0
25346,1,2,88723,88725,88727,2,4,0
25347,4,2,88727,88727,88729,0,2,0
25348,1,1,88728,88729,88730,1,2,0
25349,3,3,88731,88731,88734,0,3,1
25350,2,1,88733,88734,88735,1,2,0
25351,6,1,88739,88739,88740,0,1,4
25352,5,1,88744,88744,88745,0,1,4
25353,1,1,88745,88745,88746,0,1,0
25354,2,2,88747,88747,88749,0,2,1
25355,2,2,88749,88749,88751,0,2,0
25356,4,1,88753,88753,88754,0,1,2
25357,6,3,88759,88759,88762,0,3,5
25358,2,1,88761,88762,88763,1,2,0
25359,5,1,88766,88766,88767,0,1,3
25360,3,2,88769,88769,88771,0,2,2
25361,5,1,88774,88774,88775,0,1,3
25362,1,3,88775,88775,88778,0,3,0
25363,3,2,88778,88778,88780,0,2,0
25364,4,2,88782,88782,88784,0,2,2
25365,3,1,88785,88785,88786,0,1,1
25366,4,1,88789,88789,88790,0,1,3
25367,2,2,88791,88791,88793,0,2,1
25368,4,1,88795,88795,88796,0,1,2
25369,3,3,88798,88798,88801,0,3,2
25370,4,2,88802,88802,88804,0,2,1
25371,1,2,88803,88804,88806,1,3,0
25372,5,3,88808,88808,88811,0,3,2
25373,4,3,88812,88812,88815,0,3,1
25374,5,1,88817,88817,88818,0,1,2
25375,6,3,88823,88823,88826,0,3,5
25376,3,1,88826,88826,88827,0,1,0
25377,1,3,88827,88827,88830,0,3,0
25378,4,2,88831,88831,88833,0,2,1
25379,4,3,88835,88835,88838,0,3,2
25380,3,3,88838,88838,88841,0,3,0
25381,3,1,88841,88841,88842,0,1,0
25382,1,2,88842,88842,88844,0,2,0
25383,3,1,88845,88845,88846,0,1,1
25384,6,1,88851,88851,88852,0,1,5
25385,2,3,88853,88853,88856,0,3,1
25386,5,1,88858,88858,88859,0,1,2
25387,1,2,88859,88859,88861,0,2,0
25388,4,3,88863,88863,88866,0,3,2
25389,5,3,88868,88868,88871,0,3,2
25390,4,3,88872,88872,88875,0,3,1
25391,3,2,88875,88875,88877,0,2,0
25392,5,3,88880,88880,88883,0,3,3
25393,2,2,88882,88883,88885,1,3,0
25394,2,2,88884,88885,88887,1,3,0
25395,2,3,88886,88887,88890,1,4,0
25396,4,2,88890,88890,88892,0,2,0
25397,2,2,88892,88892,88894,0,2,0
25398,2,3,88894,88894,88897,0,3,0
25399,6,3,88900,88900,88903,0,3,3
25400,4,3,88904,88904,88907,0,3,1
25401,5,3,88909,88909,88912,0,3,2
25402,2,3,88911,88912,88915,1,4,0
25403,6,3,88917,88917,88920,0,3,2
25404,2,3,88919,88920,88923,1,4,0
25405,5,1,88924,88924,88925,0,1,1
25406,4,3,88928,88928,88931,0,3,3
25407,4,3,88932,88932,88935,0,3,1
25408,1,1,88933,88935,88936,2,3,0
25409,4,3,88937,88937,88940,0,3,1
25410,3,3,88940,88940,88943,0,3,0
25411,2,3,88942,88943,88946,1,4,0
25412,1,3,88943,88946,88949,3,6,0
25413,2,1,88945,88949,88950,4,5,0
25414,6,3,88951,88951,88954,0,3,1
25415,5,2,88956,88956,88958,0,2,2
25416,1,1,88957,88958,88959,1,2,0
25417,1,2,88958,88959,88961,1,3,0
25418,3,1,88961,88961,88962,0,1,0
25419,6,1,88967,88967,88968,0,1,5
25420,4,2,88971,88971,88973,0,2,3
25421,1,3,88972,88973,88976,1,4,0
25422,2,1,88974,88976,88977,2,3,0
25423,1,1,88975,88977,88978,2,3,0
25424,5,1,88980,88980,88981,0,1,2
25425,3,3,88983,88983,88986,0,3,2
25426,5,2,88988,88988,88990,0,2,2
25427,6,2,88994,88994,88996,0,2,4
25428,2,2,88996,88996,88998,0,2,0
25429,2,2,88998,88998,89000,0,2,0
25430,6,2,89004,89004,89006,0,2,4
25431,1,2,89005,89006,89008,1,3,0
25432,4,2,89009,89009,89011,0,2,1
25433,1,2,89010,89011,89013,1,3,0
25434,6,2,89016,89016,89018,0,2,3
25435,2,3,89018,89018,89021,0,3,0
25436,3,1,89021,89021,89022,0,1,0
25437,1,3,89022,89022,89025,0,3,0
25438,5,3,89027,89027,89030,0,3,2
25439,4,1,89031,89031,89032,0,1,1
25440,2,3,89033,89033,89036,0,3,1
25441,2,1,89035,89036,89037,1,2,0
25442,6,1,89041,89041,89042,0,1,4
25443,2,2,89043,89043,89045,0,2,1
25444,4,2,89047,89047,89049,0,2,2
25445,2,2,89049,89049,89051,0,2,0
25446,3,1,89052,89052,89053,0,1,1
25447,6,1,89058,89058,89059,0,1,5
25448,6,3,89064,89064,89067,0,3,5
25449,5,2,89069,89069,89071,0,2,2
25450,6,1,89075,89075,89076,0,1,4
25451,4,2,89079,89079,89081,0,2,3
25452,2,2,89081,89081,89083,0,2,0
25453,4,1,89085,89085,89086,0,1,2
25454,6,2,89091,89091,89093,0,2,5
25455,3,2,89094,89094,89096,0,2,1
25456,4,3,89098,89098,89101,0,3,2
25457,4,1,89102,89102,89103,0,1,1
25458,5,3,89107,89107,89110,0,3,4
25459,2,1,89109,89110,89111,1,2,0
25460,4,1,89113,89113,89114,0,1,2
25461,6,2,89119,89119,89121,0,2,5
25462,2,1,89121,89121,89122,0,1,0
25463,3,1,89124,89124,89125,0,1,2
25464,4,1,89128,89128,89129,0,1,3
25465,1,3,89129,89129,89132,0,3,0
25466,2,1,89131,89132,89133,1,2,0
25467,1,2,89132,89133,89135,1,3,0
25468,3,1,89135,89135,89136,0,1,0
25469,4,3,89139,89139,89142,0,3,3
25470,3,1,89142,89142,89143,0,1,0
25471,4,3,89146,89146,89149,0,3,3
25472,1,2,89147,89149,89151,2,4,0
25473,3,1,89150,89151,89152,1,2,0
25474,6,1,89156,89156,89157,0,1,4
25475,1,3,89157,89157,89160,0,3,0
25476,3,2,89160,89160,89162,0,2,0
25477,2,1,89162,89162,89163,0,1,0
25478,6,1,89168,89168,89169,0,1,5
25479,6,1,89174,89174,89175,0,1,5
25480,6,3,89180,89180,89183,0,3,5
25481,2,1,89182,89183,89184,1,2,0
25482,3,3,89185,89185,89188,0,3,1
25483,6,2,89191,89191,89193,0,2,3
25484,6,3,89197,89197,89200,0,3,4
25485,4,2,89201,89201,89203,0,2,1
25486,5,2,89206,89206,89208,0,2,3
25487,5,2,89211,89211,89213,0,2,3
25488,2,3,89213,89213,89216,0,3,0
25489,6,1,89219,89219,89220,0,1,3
25490,4,3,89223,89223,89226,0,3,3
25491,1,1,89224,89226,89227,2,3,0
25492,1,1,89225,89227,89228,2,3,0
25493,3,1,89228,89228,89229,0,1,0
25494,2,2,89230,89230,89232,0,2,1
25495,6,2,89236,89236,89238,0,2,4
25496,3,2,89239,89239,89241,0,2,1
25497,3,3,89242,89242,89245,0,3,1
25498,1,1,89243,89245,89246,2,3,0
25499,5,3,89248,89248,89251,0,3,2
25500,6,1,89254,89254,89255,0,1,3
25501,6,3,89260,89260,89263,0,3,5
25502,1,1,89261,89263,89264,2,3,0
25503,4,1,89265,89265,89266,0,1,1
25504,6,1,89271,89271,89272,0,1,5
25505,1,3,89272,89272,89275,0,3,0
25506,6,3,89278,89278,89281,0,3,3
25507,2,1,89280,89281,89282,1,2,0
25508,1,2,89281,89282,89284,1,3,0
25509,4,1,89285,89285,89286,0,1,1
25510,2,3,89287,89287,89290,0,3,1
25511,2,2,89289,89290,89292,1,3,0
25512,4,1,89293,89293,89294,0,1,1
25513,5,3,89298,89298,89301,0,3,4
25514,6,2,89304,89304,89306,0,2,3
25515,2,3,89306,89306,89309,0,3,0
25516,5,2,89311,89311,89313,0,2,2
25517,5,2,89316,89316,89318,0,2,3
25518,2,3,89318,89318,89321,0,3,0
25519,5,2,89323,89323,89325,0,2,2
25520,1,2,89324,89325,89327,1,3,0
25521,5,2,89329,89329,89331,0,2,2
25522,4,2,89333,89333,89335,0,2,2
25523,2,1,89335,89335,89336,0,1,0
25524,3,2,89338,89338,89340,0,2,2
25525,1,2,89339,89340,89342,1,3,0
25526,6,1,89345,89345,89346,0,1,3
25527,4,2,89349,89349,89351,0,2,3
25528,4,2,89353,89353,89355,0,2,2
25529,3,2,89356,89356,89358,0,2,1
25530,3,1,89359,89359,89360,0,1,1
25531,4,1,89363,89363,89364,0,1,3
25532,1,3,89364,89364,89367,0,3,0
25533,1,1,89365,89367,89368,2,3,0
25534,1,1,89366,89368,89369,2,3,0
25535,6,2,89372,89372,89374,0,2,3
25536,3,2,89375,89375,89377,0,2,1
25537,3,2,89378,89378,89380,0,2,1
25538,2,3,89380,89380,89383,0,3,0
25539,3,2,89383,89383,89385,0,2,0
25540,4,2,89387,89387,89389,0,2,2
25541,6,2,89393,89393,89395,0,2,4
25542,5,3,89398,89398,89401,0,3,3
25543,4,3,89402,89402,89405,0,3,1
25544,2,3,89404,89405,89408,1,4,0
25545,2,2,89406,89408,89410,2,4,0
25546,4,1,89410,89410,89411,0,1,0
25547,1,3,89411,89411,89414,0,3,0
25548,4,2,89415,89415,89417,0,2,1
25549,1,1,89416,89417,89418,1,2,0
25550,3,3,89419,89419,89422,0,3,1
25551,5,1,89424,89424,89425,0,1,2
25552,4,2,89428,89428,89430,0,2,3
25553,3,1,89431,89431,89432,0,1,1
25554,2,1,89433,89433,89434,0,1,1
25555,1,2,89434,89434,89436,0,2,0
25556,2,2,89436,89436,89438,0,2,0
25557,3,1,89439,89439,89440,0,1,1
25558,6,1,89445,89445,89446,0,1,5
25559,2,2,89447,89447,89449,0,2,1
25560,1,1,89448,89449,89450,1,2,0
25561,4,2,89452,89452,89454,0,2,2
25562,4,3,89456,89456,89459,0,3,2
25563,3,2,89459,89459,89461,0,2,0
25564,5,1,89464,89464,89465,0,1,3
25565,5,3,89469,89469,89472,0,3,4
25566,4,2,89473,89473,89475,0,2,1
25567,4,1,89477,89477,89478,0,1,2
25568,3,1,89480,89480,89481,0,1,2
25569,3,2,89483,89483,89485,0,2,2
25570,5,3,89488,89488,89491,0,3,3
25571,2,3,89490,89491,89494,1,4,0
25572,2,3,89492,89494,89497,2,5,0
25573,6,3,89498,89498,89501,0,3,1
25574,3,2,89501,89501,89503,0,2,0
25575,5,1,89506,89506,89507,0,1,3
25576,3,2,89509,89509,89511,0,2,2
25577,6,1,89515,89515,89516,0,1,4
25578,2,3,89517,89517,89520,0,3,1
25579,4,3,89521,89521,89524,0,3,1
25580,3,3,89524,89524,89527,0,3,0
25581,2,1,89526,89527,89528,1,2,0
25582,6,2,89532,89532,89534,0,2,4
25583,6,3,89538,89538,89541,0,3,4
25584,3,2,89541,89541,89543,0,2,0
25585,6,2,89547,89547,89549,0,2,4
25586,6,3,89553,89553,89556,0,3,4
25587,5,1,89558,89558,89559,0,1,2
25588,4,3,89562,89562,89565,0,3,3
25589,2,3,89564,89565,89568,1,4,0
25590,1,2,89565,89568,89570,3,5,0
25591,4,3,89569,89570,89573,1,4,0
25592,1,3,89570,89573,89576,3,6,0
25593,3,1,89573,89576,89577,3,4,0
25594,6,1,89579,89579,89580,0,1,2
25595,3,2,89582,89582,89584,0,2,2
25596,1,3,89583,89584,89587,1,4,0
25597,6,2,89589,89589,89591,0,2,2
25598,5,1,89594,89594,89595,0,1,3
25599,4,1,89598,89598,89599,0,1,3
25600,2,1,89600,89600,89601,0,1,1
25601,6,2,89606,89606,89608,0,2,5
25602,4,2,89610,89610,89612,0,2,2
25603,6,1,89616,89616,89617,0,1,4
25604,5,1,89621,89621,89622,0,1,4
25605,4,1,89625,89625,89626,0,1,3
25606,1,1,89626,89626,89627,0,1,0
25607,3,3,89629,89629,89632,0,3,2
25608,2,2,89631,89632,89634,1,3,0
25609,4,1,89635,89635,89636,0,1,1
25610,2,1,89637,89637,89638,0,1,1
25611,6,1,89643,89643,89644,0,1,5
25612,3,2,89646,89646,89648,0,2,2
25613,1,2,89647,89648,89650,1,3,0
25614,4,3,89651,89651,89654,0,3,1
25615,1,1,89652,89654,89655,2,3,0
25616,1,2,89653,89655,89657,2,4,0
25617,2,1,89655,89657,89658,2,3,0
25618,5,2,89660,89660,89662,0,2,2
25619,5,2,89665,89665,89667,0,2,3
25620,2,1,89667,89667,89668,0,1,0
25621,1,3,89668,89668,89671,0,3,0
25622,1,3,89669,89671,89674,2,5,0
25623,1,3,89670,89674,89677,4,7,0
25624,3,2,89673,89677,89679,4,6,0
25625,4,1,89677,89679,89680,2,3,0
25626,6,2,89683,89683,89685,0,2,3
25627,3,2,89686,89686,89688,0,2,1
25628,3,3,89689,89689,89692,0,3,1
25629,3,1,89692,89692,89693,0,1,0
25630,2,1,89694,89694,89695,0,1,1
25631,2,1,89696,89696,89697,0,1,1
25632,4,1,89700,89700,89701,0,1,3
25633,2,2,89702,89702,89704,0,2,1
25634,3,3,89705,89705,89708,0,3,1
25635,6,2,89711,89711,89713,0,2,3
25636,5,2,89716,89716,89718,0,2,3
25637,5,2,89721,89721,89723,0,2,3
25638,4,3,89725,89725,89728,0,3,2
25639,2,2,89727,89728,89730,1,3,0
25640,2,3,89729,89730,89733,1,4,0
25641,2,2,89731,89733,89735,2,4,0
25642,3,1,89734,89735,89736,1,2,0
25643,5,3,89739,89739,89742,0,3,3
25644,3,1,89742,89742,89743,0,1,0
25645,1,1,89743,89743,89744,0,1,0
25646,4,3,89747,89747,89750,0,3,3
25647,4,3,89751,89751,89754,0,3,1
25648,2,1,89753,89754,89755,1,2,0
25649,1,1,89754,89755,89756,1,2,0
25650,6,1,89760,89760,89761,0,1,4
25651,6,1,89766,89766,89767,0,1,5
25652,6,3,89772,89772,89775,0,3,5
25653,1,3,89773,89775,89778,2,5,0
25654,2,3,89775,89778,89781,3,6,0
25655,2,2,89777,89781,89783,4,6,0
25656,2,3,89779,89783,89786,4,7,0
25657,6,1,89785,89786,89787,1,2,0
25658,1,2,89786,89787,89789,1,3,0
25659,1,1,89787,89789,89790,2,3,0
25660,4,3,89791,89791,89794,0,3,1
25661,6,1,89797,89797,89798,0,1,3
25662,1,1,89798,89798,89799,0,1,0
25663,1,2,89799,89799,89801,0,2,0
25664,5,3,89804,89804,89807,0,3,3
25665,3,3,89807,89807,89810,0,3,0
25666,3,1,89810,89810,89811,0,1,0
25667,4,1,89814,89814,89815,0,1,3
25668,6,2,89820,89820,89822,0,2,5
25669,3,2,89823,89823,89825,0,2,1
25670,4,2,89827,89827,89829,0,2,2
25671,1,2,89828,89829,89831,1,3,0
25672,1,2,89829,89831,89833,2,4,0
25673,2,3,89831,89833,89836,2,5,0
25674,2,3,89833,89836,89839,3,6,0
25675,1,2,89834,89839,89841,5,7,0
25676,4,2,89838,89841,89843,3,5,0
25677,5,2,89843,89843,89845,0,2,0
25678,1,3,89844,89845,89848,1,4,0
25679,1,1,89845,89848,89849,3,4,0
25680,5,2,89850,89850,89852,0,2,1
25681,1,3,89851,89852,89855,1,4,0
25682,3,1,89854,89855,89856,1,2,0
25683,5,3,89859,89859,89862,0,3,3
25684,1,2,89860,89862,89864,2,4,0
25685,1,1,89861,89864,89865,3,4,0
25686,1,2,89862,89865,89867,3,5,0
25687,3,1,89865,89867,89868,2,3,0
25688,1,3,89866,89868,89871,2,5,0
25689,6,1,89872,89872,89873,0,1,1
25690,2,2,89874,89874,89876,0,2,1
25691,6,3,89880,89880,89883,0,3,4
25692,3,3,89883,89883,89886,0,3,0
25693,2,3,89885,89886,89889,1,4,0
25694,5,1,89890,89890,89891,0,1,1
25695,3,3,89893,89893,89896,0,3,2
25696,2,1,89895,89896,89897,1,2,0
25697,3,1,89898,89898,89899,0,1,1
25698,6,1,89904,89904,89905,0,1,5
25699,3,1,89907,89907,89908,0,1,2
25700,5,2,89912,89912,89914,0,2,4
25701,6,1,89918,89918,89919,0,1,4
25702,3,3,89921,89921,89924,0,3,2
25703,4,1,89925,89925,89926,0,1,1
25704,6,1,89931,89931,89932,0,1,5
25705,1,1,89932,89932,89933,0,1,0
25706,3,3,89935,89935,89938,0,3,2
25707,3,3,89938,89938,89941,0,3,0
25708,5,1,89943,89943,89944,0,1,2
25709,3,2,89946,89946,89948,0,2,2
25710,1,3,89947,89948,89951,1,4,0
25711,2,2,89949,89951,89953,2,4,0
25712,4,2,89953,89953,89955,0,2,0
25713,2,2,89955,89955,89957,0,2,0
25714,5,2,89960,89960,89962,0,2,3
25715,5,3,89965,89965,89968,0,3,3
25716,6,2,89971,89971,89973,0,2,3
25717,5,2,89976,89976,89978,0,2,3
25718,1,3,89977,89978,89981,1,4,0
25719,3,3,89980,89981,89984,1,4,0
25720,5,3,89985,89985,89988,0,3,1
25721,6,3,89991,89991,89994,0,3,3
25722,4,2,89995,89995,89997,0,2,1
25723,5,2,90000,90000,90002,0,2,3
25724,3,1,90003,90003,90004,0,1,1
25725,5,2,90008,90008,90010,0,2,4
25726,2,3,90010,90010,90013,0,3,0
25727,4,1,90014,90014,90015,0,1,1
25728,1,3,90015,90015,90018,0,3,0
25729,5,3,90020,90020,90023,0,3,2
25730,5,2,90025,90025,90027,0,2,2
25731,3,3,90028,90028,90031,0,3,1
25732,2,3,90030,90031,90034,1,4,0
25733,4,2,90034,90034,90036,0,2,0
25734,5,1,90039,90039,90040,0,1,3
25735,1,1,90040,90040,90041,0,1,0
25736,3,2,90043,90043,90045,0,2,2
25737,4,2,90047,90047,90049,0,2,2
25738,5,1,90052,90052,90053,0,1,3
25739,2,1,90054,90054,90055,0,1,1
25740,3,2,90057,90057,90059,0,2,2
25741,2,1,90059,90059,90060,0,1,0
25742,2,1,90061,90061,90062,0,1,1
25743,1,1,90062,90062,90063,0,1,0
25744,1,3,90063,90063,90066,0,3,0
25745,4,3,90067,90067,90070,0,3,1
25746,1,2,90068,90070,90072,2,4,0
25747,6,2,90074,90074,90076,0,2,2
25748,4,2,90078,90078,90080,0,2,2
25749,1,2,90079,90080,90082,1,3,0
25750,6,2,90085,90085,90087,0,2,3
25751,5,1,90090,90090,90091,0,1,3
25752,3,3,90093,90093,90096,0,3,2
25753,1,2,90094,90096,90098,2,4,0
25754,3,1,90097,90098,90099,1,2,0
25755,6,3,90103,90103,90106,0,3,4
25756,5,1,90108,90108,90109,0,1,2
25757,5,2,90113,90113,90115,0,2,4
25758,5,3,90118,90118,90121,0,3,3
25759,1,1,90119,90121,90122,2,3,0
25760,4,2,90123,90123,90125,0,2,1
25761,5,3,90128,90128,90131,0,3,3
25762,5,2,90133,90133,90135,0,2,2
25763,4,2,90137,90137,90139,0,2,2
25764,6,3,90143,90143,90146,0,3,4
25765,4,2,90147,90147,90149,0,2,1
25766,3,1,90150,90150,90151,0,1,1
25767,2,1,90152,90152,90153,0,1,1
25768,5,3,90157,90157,90160,0,3,4
25769,3,1,90160,90160,90161,0,1,0
25770,4,3,90164,90164,90167,0,3,3
25771,3,2,90167,90167,90169,0,2,0
25772,1,1,90168,90169,90170,1,2,0
25773,1,2,90169,90170,90172,1,3,0
25774,2,2,90171,90172,90174,1,3,0
25775,4,3,90175,90175,90178,0,3,1
25776,1,3,90176,90178,90181,2,5,0
25777,3,3,90179,90181,90184,2,5,0
25778,2,1,90181,90184,90185,3,4,0
25779,1,3,90182,90185,90188,3,6,0
25780,1,1,90183,90188,90189,5,6,0
25781,5,1,90188,90189,90190,1,2,0
25782,1,1,90189,90190,90191,1,2,0
25783,3,1,90192,90192,90193,0,1,1
25784,2,2,90194,90194,90196,0,2,1
25785,2,1,90196,90196,90197,0,1,0
25786,2,2,90198,90198,90200,0,2,1
25787,3,2,90201,90201,90203,0,2,1
25788,3,1,90204,90204,90205,0,1,1
25789,3,1,90207,90207,90208,0,1,2
25790,4,1,90211,90211,90212,0,1,3
25791,2,2,90213,90213,90215,0,2,1
25792,4,1,90217,90217,90218,0,1,2
25793,5,2,90222,90222,90224,0,2,4
25794,1,2,90223,90224,90226,1,3,0
25795,6,2,90229,90229,90231,0,2,3
25796,1,3,90230,90231,90234,1,4,0
25797,6,2,90236,90236,90238,0,2,2
25798,5,1,90241,90241,90242,0,1,3
25799,6,1,90247,90247,90248,0,1,5
25800,2,1,90249,90249,90250,0,1,1
25801,5,2,90254,90254,90256,0,2,4
25802,6,1,90260,90260,90261,0,1,4
25803,1,3,90261,90261,90264,0,3,0
25804,3,3,90264,90264,90267,0,3,0
25805,6,1,90270,90270,90271,0,1,3
25806,3,1,90273,90273,90274,0,1,2
25807,6,1,90279,90279,90280,0,1,5
25808,2,1,90281,90281,90282,0,1,1
25809,1,1,90282,90282,90283,0,1,0
25810,6,1,90288,90288,90289,0,1,5
25811,2,3,90290,90290,90293,0,3,1
25812,4,2,90294,90294,90296,0,2,1
25813,1,3,90295,90296,90299,1,4,0
25814,2,3,90297,90299,90302,2,5,0
25815,5,3,90302,90302,90305,0,3,0
25816,4,2,90306,90306,90308,0,2,1
25817,2,1,90308,90308,90309,0,1,0
25818,2,2,90310,90310,90312,0,2,1
25819,6,3,90316,90316,90319,0,3,4
25820,6,2,90322,90322,90324,0,2,3
25821,2,1,90324,90324,90325,0,1,0
25822,4,1,90328,90328,90329,0,1,3
25823,3,1,90331,90331,90332,0,1,2
25824,3,1,90334,90334,90335,0,1,2
25825,6,3,90340,90340,90343,0,3,5
25826,5,3,90345,90345,90348,0,3,2
25827,2,1,90347,90348,90349,1,2,0
25828,4,3,90351,90351,90354,0,3,2
25829,4,1,90355,90355,90356,0,1,1
25830,4,3,90359,90359,90362,0,3,3
25831,2,1,90361,90362,90363,1,2,0
25832,1,3,90362,90363,90366,1,4,0
25833,5,2,90367,90367,90369,0,2,1
25834,1,3,90368,90369,90372,1,4,0
25835,3,2,90371,90372,90374,1,3,0
25836,4,3,90375,90375,90378,0,3,1
25837,1,1,90376,90378,90379,2,3,0
25838,2,1,90378,90379,90380,1,2,0
25839,4,3,90382,90382,90385,0,3,2
25840,2,3,90384,90385,90388,1,4,0
25841,5,2,90389,90389,90391,0,2,1
25842,4,2,90393,90393,90395,0,2,2
25843,1,2,90394,90395,90397,1,3,0
25844,2,2,90396,90397,90399,1,3,0
25845,6,2,90402,90402,90404,0,2,3
25846,2,1,90404,90404,90405,0,1,0
25847,3,2,90407,90407,90409,0,2,2
25848,4,1,90411,90411,90412,0,1,2
25849,6,3,90417,90417,90420,0,3,5
25850,2,3,90419,90420,90423,1,4,0
25851,5,2,90424,90424,90426,0,2,1
25852,3,1,90427,90427,90428,0,1,1
25853,5,3,90432,90432,90435,0,3,4
25854,3,1,90435,90435,90436,0,1,0
25855,4,1,90439,90439,90440,0,1,3
25856,5,1,90444,90444,90445,0,1,4
25857,3,2,90447,90447,90449,0,2,2
25858,4,2,90451,90451,90453,0,2,2
25859,1,1,90452,90453,90454,1,2,0
25860,2,2,90454,90454,90456,0,2,0
25861,4,1,90458,90458,90459,0,1,2
25862,3,2,90461,90461,90463,0,2,2
25863,4,3,90465,90465,90468,0,3,2
25864,2,3,90467,90468,90471,1,4,0
25865,4,1,90471,90471,90472,0,1,0
25866,3,2,90474,90474,90476,0,2,2
25867,2,3,90476,90476,90479,0,3,0
25868,4,2,90480,90480,90482,0,2,1
25869,5,2,90485,90485,90487,0,2,3
25870,5,2,90490,90490,90492,0,2,3
25871,2,3,90492,90492,90495,0,3,0
25872,3,3,90495,90495,90498,0,3,0
25873,5,3,90500,90500,90503,0,3,2
25874,4,3,90504,90504,90507,0,3,1
25875,4,3,90508,90508,90511,0,3,1
25876,2,3,90510,90511,90514,1,4,0
25877,3,3,90513,90514,90517,1,4,0
25878,1,1,90514,90517,90518,3,4,0
25879,1,1,90515,90518,90519,3,4,0
25880,6,2,90521,90521,90523,0,2,2
25881,3,3,90524,90524,90527,0,3,1
25882,6,1,90530,90530,90531,0,1,3
25883,4,1,90534,90534,90535,0,1,3
25884,3,1,90537,90537,90538,0,1,2
25885,2,3,90539,90539,90542,0,3,1
25886,5,3,90544,90544,90547,0,3,2
25887,5,2,90549,90549,90551,0,2,2
25888,5,3,90554,90554,90557,0,3,3
25889,6,3,90560,90560,90563,0,3,3
25890,1,2,90561,90563,90565,2,4,0
25891,2,3,90563,90565,90568,2,5,0
25892,1,1,90564,90568,90569,4,5,0
25893,4,2,90568,90569,90571,1,3,0
25894,5,2,90573,90573,90575,0,2,2
25895,6,2,90579,90579,90581,0,2,4
25896,3,2,90582,90582,90584,0,2,1
25897,5,3,90587,90587,90590,0,3,3
25898,2,2,90589,90590,90592,1,3,0
25899,5,2,90594,90594,90596,0,2,2
25900,1,2,90595,90596,90598,1,3,0
25901,5,2,90600,90600,90602,0,2,2
25902,1,3,90601,90602,90605,1,4,0
25903,4,3,90605,90605,90608,0,3,0
25904,5,3,90610,90610,90613,0,3,2
25905,1,1,90611,90613,90614,2,3,0
25906,5,1,90616,90616,90617,0,1,2
25907,1,2,90617,90617,90619,0,2,0
25908,2,2,90619,90619,90621,0,2,0
25909,1,1,90620,90621,90622,1,2,0
25910,2,2,90622,90622,90624,0,2,0
25911,5,1,90627,90627,90628,0,1,3
25912,2,1,90629,90629,90630,0,1,1
25913,2,2,90631,90631,90633,0,2,1
25914,3,2,90634,90634,90636,0,2,1
25915,5,2,90639,90639,90641,0,2,3
25916,1,3,90640,90641,90644,1,4,0
25917,3,2,90643,90644,90646,1,3,0
25918,1,2,90644,90646,90648,2,4,0
25919,6,1,90650,90650,90651,0,1,2
25920,1,1,90651,90651,90652,0,1,0
25921,5,2,90656,90656,90658,0,2,4
25922,3,1,90659,90659,90660,0,1,1
25923,6,3,90665,90665,90668,0,3,5
25924,2,2,90667,90668,90670,1,3,0
25925,6,1,90673,90673,90674,0,1,3
25926,2,1,90675,90675,90676,0,1,1
25927,1,2,90676,90676,90678,0,2,0
25928,5,2,90681,90681,90683,0,2,3
25929,2,1,90683,90683,90684,0,1,0
25930,3,3,90686,90686,90689,0,3,2
25931,3,1,90689,90689,90690,0,1,0
25932,6,1,90695,90695,90696,0,1,5
25933,6,1,90701,90701,90702,0,1,5
25934,2,3,90703,90703,90706,0,3,1
25935,1,2,90704,90706,90708,2,4,0
25936,1,1,90705,90708,90709,3,4,0
25937,4,3,90709,90709,90712,0,3,0
25938,3,2,90712,90712,90714,0,2,0
25939,6,3,90718,90718,90721,0,3,4
25940,6,2,90724,90724,90726,0,2,3
25941,3,1,90727,90727,90728,0,1,1
25942,6,1,90733,90733,90734,0,1,5
25943,1,3,90734,90734,90737,0,3,0
25944,5,1,90739,90739,90740,0,1,2
25945,4,2,90743,90743,90745,0,2,3
25946,1,2,90744,90745,90747,1,3,0
25947,6,1,90750,90750,90751,0,1,3
25948,6,1,90756,90756,90757,0,1,5
25949,4,3,90760,90760,90763,0,3,3
25950,6,1,90766,90766,90767,0,1,3
25951,6,1,90772,90772,90773,0,1,5
25952,2,3,90774,90774,90777,0,3,1
25953,3,3,90777,90777,90780,0,3,0
25954,6,1,90783,90783,90784,0,1,3
25955,4,2,90787,90787,90789,0,2,3
25956,4,2,90791,90791,90793,0,2,2
25957,4,3,90795,90795,90798,0,3,2
25958,4,3,90799,90799,90802,0,3,1
25959,6,1,90805,90805,90806,0,1,3
25960,4,2,90809,90809,90811,0,2,3
25961,3,3,90812,90812,90815,0,3,1
25962,1,1,90813,90815,90816,2,3,0
25963,6,2,90819,90819,90821,0,2,3
25964,6,3,90825,90825,90828,0,3,4
25965,3,1,90828,90828,90829,0,1,0
25966,6,1,90834,90834,90835,0,1,5
25967,6,3,90840,90840,90843,0,3,5
25968,6,1,90846,90846,90847,0,1,3
25969,2,1,90848,90848,90849,0,1,1
25970,5,1,90853,90853,90854,0,1,4
25971,4,1,90857,90857,90858,0,1,3
25972,6,3,90863,90863,90866,0,3,5
25973,5,3,90868,90868,90871,0,3,2
25974,4,1,90872,90872,90873,0,1,1
25975,5,1,90877,90877,90878,0,1,4
25976,4,1,90881,90881,90882,0,1,3
25977,2,3,90883,90883,90886,0,3,1
25978,2,2,90885,90886,90888,1,3,0
25979,5,3,90890,90890,90893,0,3,2
25980,3,3,90893,90893,90896,0,3,0
25981,2,2,90895,90896,90898,1,3,0
25982,3,2,90898,90898,90900,0,2,0
25983,5,3,90903,90903,90906,0,3,3
25984,5,1,90908,90908,90909,0,1,2
25985,3,2,90911,90911,90913,0,2,2
25986,5,2,90916,90916,90918,0,2,3
25987,6,1,90922,90922,90923,0,1,4
25988,4,1,90926,90926,90927,0,1,3
25989,3,3,90929,90929,90932,0,3,2
25990,5,2,90934,90934,90936,0,2,2
25991,1,1,90935,90936,90937,1,2,0
25992,2,3,90937,90937,90940,0,3,0
25993,3,2,90940,90940,90942,0,2,0
25994,6,1,90946,90946,90947,0,1,4
25995,3,1,90949,90949,90950,0,1,2
25996,2,3,90951,90951,90954,0,3,1
25997,3,1,90954,90954,90955,0,1,0
25998,4,3,90958,90958,90961,0,3,3
25999,2,1,90960,90961,90962,1,2,0
26000,2,2,90962,90962,90964,0,2,0
26001,4,2,90966,90966,90968,0,2,2
26002,4,3,90970,90970,90973,0,3,2
26003,3,3,90973,90973,90976,0,3,0
26004,1,2,90974,90976,90978,2,4,0
26005,6,2,90980,90980,90982,0,2,2
26006,4,2,90984,90984,90986,0,2,2
26007,5,2,90989,90989,90991,0,2,3
26008,1,2,90990,90991,90993,1,3,0
26009,2,3,90992,90993,90996,1,4,0
26010,3,2,90995,90996,90998,1,3,0
26011,3,3,90998,90998,91001,0,3,0
26012,1,2,90999,91001,91003,2,4,0
26013,1,1,91000,91003,91004,3,4,0
26014,6,2,91006,91006,91008,0,2,2
26015,2,3,91008,91008,91011,0,3,0
26016,4,2,91012,91012,91014,0,2,1
26017,3,1,91015,91015,91016,0,1,1
26018,5,1,91020,91020,91021,0,1,4
26019,5,2,91025,91025,91027,0,2,4
26020,4,3,91029,91029,91032,0,3,2
26021,5,3,91034,91034,91037,0,3,2
26022,1,3,91035,91037,91040,2,5,0
26023,2,2,91037,91040,91042,3,5,0
26024,6,3,91043,91043,91046,0,3,1
26025,3,2,91046,91046,91048,0,2,0
26026,5,3,91051,91051,91054,0,3,3
26027,2,2,91053,91054,91056,1,3,0
26028,5,1,91058,91058,91059,0,1,2
26029,1,1,91059,91059,91060,0,1,0
26030,1,1,91060,91060,91061,0,1,0
26031,6,2,91066,91066,91068,0,2,5
26032,2,2,91068,91068,91070,0,2,0
26033,1,1,91069,91070,91071,1,2,0
26034,1,3,91070,91071,91074,1,4,0
26035,2,2,91072,91074,91076,2,4,0
26036,2,1,91074,91076,91077,2,3,0
26037,1,1,91075,91077,91078,2,3,0
26038,1,3,91076,91078,91081,2,5,0
26039,4,3,91080,91081,91084,1,4,0
26040,6,2,91086,91086,91088,0,2,2
26041,3,1,91089,91089,91090,0,1,1
26042,3,2,91092,91092,91094,0,2,2
26043,3,3,91095,91095,91098,0,3,1
26044,1,3,91096,91098,91101,2,5,0
26045,2,2,91098,91101,91103,3,5,0
26046,4,3,91102,91103,91106,1,4,0
26047,3,1,91105,91106,91107,1,2,0
26048,4,2,91109,91109,91111,0,2,2
26049,4,3,91113,91113,91116,0,3,2
26050,1,1,91114,91116,91117,2,3,0
26051,4,1,91118,91118,91119,0,1,1
26052,5,1,91123,91123,91124,0,1,4
26053,2,3,91125,91125,91128,0,3,1
26054,2,3,91127,91128,91131,1,4,0
26055,6,3,91133,91133,91136,0,3,2
26056,3,2,91136,91136,91138,0,2,0
26057,1,2,91137,91138,91140,1,3,0
26058,6,2,91143,91143,91145,0,2,3
26059,4,2,91147,91147,91149,0,2,2
26060,1,3,91148,91149,91152,1,4,0
26061,2,3,91150,91152,91155,2,5,0
26062,3,3,91153,91155,91158,2,5,0
26063,2,2,91155,91158,91160,3,5,0
26064,3,3,91158,91160,91163,2,5,0
26065,6,2,91164,91164,91166,0,2,1
26066,6,2,91170,91170,91172,0,2,4
26067,5,2,91175,91175,91177,0,2,3
26068,1,2,91176,91177,91179,1,3,0
26069,4,3,91180,91180,91183,0,3,1
26070,6,1,91186,91186,91187,0,1,3
26071,3,3,91189,91189,91192,0,3,2
26072,5,3,91194,91194,91197,0,3,2
26073,1,2,91195,91197,91199,2,4,0
26074,5,2,91200,91200,91202,0,2,1
26075,6,1,91206,91206,91207,0,1,4
26076,6,3,91212,91212,91215,0,3,5
26077,2,3,91214,91215,91218,1,4,0
26078,4,3,91218,91218,91221,0,3,0
26079,6,2,91224,91224,91226,0,2,3
26080,6,1,91230,91230,91231,0,1,4
26081,2,1,91232,91232,91233,0,1,1
26082,4,3,91236,91236,91239,0,3,3
26083,2,1,91238,91239,91240,1,2,0
26084,6,1,91244,91244,91245,0,1,4
26085,6,2,91250,91250,91252,0,2,5
26086,3,1,91253,91253,91254,0,1,1
26087,5,3,91258,91258,91261,0,3,4
26088,3,2,91261,91261,91263,0,2,0
26089,5,3,91266,91266,91269,0,3,3
26090,6,1,91272,91272,91273,0,1,3
26091,4,3,91276,91276,91279,0,3,3
26092,4,2,91280,91280,91282,0,2,1
26093,2,3,91282,91282,91285,0,3,0
26094,1,2,91283,91285,91287,2,4,0
26095,3,1,91286,91287,91288,1,2,0
26096,1,2,91287,91288,91290,1,3,0
26097,1,2,91288,91290,91292,2,4,0
26098,6,2,91294,91294,91296,0,2,2
26099,5,1,91299,91299,91300,0,1,3
26100,3,2,91302,91302,91304,0,2,2
26101,6,3,91308,91308,91311,0,3,4
26102,2,1,91310,91311,91312,1,2,0
26103,5,2,91315,91315,91317,0,2,3
26104,3,3,91318,91318,91321,0,3,1
26105,5,2,91323,91323,91325,0,2,2
26106,6,1,91329,91329,91330,0,1,4
26107,1,3,91330,91330,91333,0,3,0
26108,3,2,91333,91333,91335,0,2,0
26109,5,2,91338,91338,91340,0,2,3
26110,2,2,91340,91340,91342,0,2,0
26111,3,2,91343,91343,91345,0,2,1
26112,6,1,91349,91349,91350,0,1,4
26113,4,2,91353,91353,91355,0,2,3
26114,3,2,91356,91356,91358,0,2,1
26115,3,3,91359,91359,91362,0,3,1
26116,4,2,91363,91363,91365,0,2,1
26117,4,3,91367,91367,91370,0,3,2
26118,6,1,91373,91373,91374,0,1,3
26119,1,3,91374,91374,91377,0,3,0
26120,5,1,91379,91379,91380,0,1,2
26121,5,2,91384,91384,91386,0,2,4
26122,1,2,91385,91386,91388,1,3,0
26123,5,1,91390,91390,91391,0,1,2
26124,2,1,91392,91392,91393,0,1,1
26125,5,2,91397,91397,91399,0,2,4
26126,3,2,91400,91400,91402,0,2,1
26127,4,3,91404,91404,91407,0,3,2
26128,3,2,91407,91407,91409,0,2,0
26129,4,2,91411,91411,91413,0,2,2
26130,4,2,91415,91415,91417,0,2,2
26131,1,2,91416,91417,91419,1,3,0
26132,2,1,91418,91419,91420,1,2,0
26133,6,3,91424,91424,91427,0,3,4
26134,6,3,91430,91430,91433,0,3,3
26135,2,3,91432,91433,91436,1,4,0
26136,6,3,91438,91438,91441,0,3,2
26137,1,3,91439,91441,91444,2,5,0
26138,1,3,91440,91444,91447,4,7,0
26139,4,1,91444,91447,91448,3,4,0
26140,2,2,91446,91448,91450,2,4,0
26141,4,1,91450,91450,91451,0,1,0
26142,6,2,91456,91456,91458,0,2,5
26143,3,1,91459,91459,91460,0,1,1
26144,6,1,91465,91465,91466,0,1,5
26145,6,1,91471,91471,91472,0,1,5
26146,6,3,91477,91477,91480,0,3,5
26147,3,1,91480,91480,91481,0,1,0
26148,6,1,91486,91486,91487,0,1,5
26149,2,2,91488,91488,91490,0,2,1
26150,1,2,91489,91490,91492,1,3,0
26151,6,1,91495,91495,91496,0,1,3
26152,1,3,91496,91496,91499,0,3,0
26153,4,1,91500,91500,91501,0,1,1
26154,6,3,91506,91506,91509,0,3,5
26155,1,1,91507,91509,91510,2,3,0
26156,6,2,91513,91513,91515,0,2,3
26157,2,2,91515,91515,91517,0,2,0
26158,6,3,91521,91521,91524,0,3,4
26159,6,3,91527,91527,91530,0,3,3
26160,2,3,91529,91530,91533,1,4,0
26161,3,1,91532,91533,91534,1,2,0
26162,5,2,91537,91537,91539,0,2,3
26163,5,1,91542,91542,91543,0,1,3
26164,2,1,91544,91544,91545,0,1,1
26165,4,2,91548,91548,91550,0,2,3
26166,3,2,91551,91551,91553,0,2,1
26167,4,2,91555,91555,91557,0,2,2
26168,6,3,91561,91561,91564,0,3,4
26169,2,3,91563,91564,91567,1,4,0
26170,6,1,91569,91569,91570,0,1,2
26171,1,2,91570,91570,91572,0,2,0
26172,3,1,91573,91573,91574,0,1,1
26173,1,1,91574,91574,91575,0,1,0
26174,2,3,91576,91576,91579,0,3,1
26175,3,3,91579,91579,91582,0,3,0
26176,5,3,91584,91584,91587,0,3,2
26177,4,3,91588,91588,91591,0,3,1
26178,4,1,91592,91592,91593,0,1,1
26179,1,2,91593,91593,91595,0,2,0
26180,6,3,91599,91599,91602,0,3,4
26181,1,2,91600,91602,91604,2,4,0
26182,5,1,91605,91605,91606,0,1,1
26183,4,1,91609,91609,91610,0,1,3
26184,6,2,91615,91615,91617,0,2,5
26185,6,2,91621,91621,91623,0,2,4
26186,1,2,91622,91623,91625,1,3,0
26187,6,1,91628,91628,91629,0,1,3
26188,4,1,91632,91632,91633,0,1,3
26189,1,2,91633,91633,91635,0,2,0
26190,5,1,91638,91638,91639,0,1,3
26191,4,1,91642,91642,91643,0,1,3
26192,6,1,91648,91648,91649,0,1,5
26193,2,3,91650,91650,91653,0,3,1
26194,3,3,91653,91653,91656,0,3,0
26195,6,1,91659,91659,91660,0,1,3
26196,3,3,91662,91662,91665,0,3,2
26197,4,1,91666,91666,91667,0,1,1
26198,2,1,91668,91668,91669,0,1,1
26199,6,3,91674,91674,91677,0,3,5
26200,6,2,91680,91680,91682,0,2,3
26201,3,3,91683,91683,91686,0,3,1
26202,5,1,91688,91688,91689,0,1,2
26203,1,2,91689,91689,91691,0,2,0
26204,2,1,91691,91691,91692,0,1,0
26205,5,2,91696,91696,91698,0,2,4
26206,2,3,91698,91698,91701,0,3,0
26207,3,1,91701,91701,91702,0,1,0
26208,5,3,91706,91706,91709,0,3,4
26209,3,1,91709,91709,91710,0,1,0
26210,1,1,91710,91710,91711,0,1,0
26211,5,3,91715,91715,91718,0,3,4
26212,2,3,91717,91718,91721,1,4,0
26213,5,3,91722,91722,91725,0,3,1
26214,6,2,91728,91728,91730,0,2,3
26215,2,1,91730,91730,91731,0,1,0
26216,5,2,91735,91735,91737,0,2,4
26217,2,1,91737,91737,91738,0,1,0
26218,5,1,91742,91742,91743,0,1,4
26219,3,3,91745,91745,91748,0,3,2
26220,3,3,91748,91748,91751,0,3,0
26221,6,2,91754,91754,91756,0,2,3
26222,5,2,91759,91759,91761,0,2,3
26223,3,2,91762,91762,91764,0,2,1
26224,5,2,91767,91767,91769,0,2,3
26225,5,3,91772,91772,91775,0,3,3
26226,6,1,91778,91778,91779,0,1,3
26227,4,1,91782,91782,91783,0,1,3
26228,1,2,91783,91783,91785,0,2,0
26229,3,1,91786,91786,91787,0,1,1
26230,5,3,91791,91791,91794,0,3,4
26231,4,2,91795,91795,91797,0,2,1
26232,6,2,91801,91801,91803,0,2,4
26233,4,2,91805,91805,91807,0,2,2
26234,1,2,91806,91807,91809,1,3,0
26235,3,1,91809,91809,91810,0,1,0
26236,6,2,91815,91815,91817,0,2,5
26237,1,2,91816,91817,91819,1,3,0
26238,3,2,91819,91819,91821,0,2,0
26239,1,3,91820,91821,91824,1,4,0
26240,4,2,91824,91824,91826,0,2,0
26241,3,3,91827,91827,91830,0,3,1
26242,6,1,91833,91833,91834,0,1,3
26243,1,1,91834,91834,91835,0,1,0
26244,5,2,91839,91839,91841,0,2,4
26245,2,1,91841,91841,91842,0,1,0
26246,5,2,91846,91846,91848,0,2,4
26247,6,2,91852,91852,91854,0,2,4
26248,3,1,91855,91855,91856,0,1,1
26249,5,2,91860,91860,91862,0,2,4
26250,5,3,91865,91865,91868,0,3,3
26251,1,2,91866,91868,91870,2,4,0
26252,3,2,91869,91870,91872,1,3,0
26253,4,1,91873,91873,91874,0,1,1
26254,4,1,91877,91877,91878,0,1,3
26255,1,3,91878,91878,91881,0,3,0
26256,4,2,91882,91882,91884,0,2,1
26257,3,3,91885,91885,91888,0,3,1
26258,3,1,91888,91888,91889,0,1,0
26259,3,3,91891,91891,91894,0,3,2
26260,5,3,91896,91896,91899,0,3,2
26261,6,1,91902,91902,91903,0,1,3
26262,5,1,91907,91907,91908,0,1,4
26263,4,3,91911,91911,91914,0,3,3
26264,2,3,91913,91914,91917,1,4,0
26265,6,1,91919,91919,91920,0,1,2
26266,2,3,91921,91921,91924,0,3,1
26267,3,1,91924,91924,91925,0,1,0
26268,4,3,91928,91928,91931,0,3,3
26269,3,3,91931,91931,91934,0,3,0
26270,1,2,91932,91934,91936,2,4,0
26271,3,2,91935,91936,91938,1,3,0
26272,5,2,91940,91940,91942,0,2,2
26273,3,2,91943,91943,91945,0,2,1
26274,1,2,91944,91945,91947,1,3,0
26275,4,2,91948,91948,91950,0,2,1
26276,6,1,91954,91954,91955,0,1,4
26277,2,1,91956,91956,91957,0,1,1
26278,4,2,91960,91960,91962,0,2,3
26279,1,3,91961,91962,91965,1,4,0
26280,2,1,91963,91965,91966,2,3,0
26281,1,2,91964,91966,91968,2,4,0
26282,6,3,91970,91970,91973,0,3,2
26283,3,2,91973,91973,91975,0,2,0
26284,5,2,91978,91978,91980,0,2,3
26285,5,2,91983,91983,91985,0,2,3
26286,2,1,91985,91985,91986,0,1,0
26287,1,3,91986,91986,91989,0,3,0
26288,3,2,91989,91989,91991,0,2,0
26289,5,1,91994,91994,91995,0,1,3
26290,3,1,91997,91997,91998,0,1,2
26291,4,1,92001,92001,92002,0,1,3
26292,2,3,92003,92003,92006,0,3,1
26293,2,2,92005,92006,92008,1,3,0
26294,5,1,92010,92010,92011,0,1,2
26295,6,1,92016,92016,92017,0,1,5
26296,4,3,92020,92020,92023,0,3,3
26297,3,1,92023,92023,92024,0,1,0
26298,4,3,92027,92027,92030,0,3,3
26299,3,1,92030,92030,92031,0,1,0
26300,3,2,92033,92033,92035,0,2,2
26301,6,2,92039,92039,92041,0,2,4
26302,5,1,92044,92044,92045,0,1,3
26303,2,3,92046,92046,92049,0,3,1
26304,5,3,92051,92051,92054,0,3,2
26305,3,1,92054,92054,92055,0,1,0
26306,1,1,92055,92055,92056,0,1,0
26307,3,1,92058,92058,92059,0,1,2
26308,6,1,92064,92064,92065,0,1,5
26309,1,1,92065,92065,92066,0,1,0
26310,2,1,92067,92067,92068,0,1,1
26311,6,2,92073,92073,92075,0,2,5
26312,5,3,92078,92078,92081,0,3,3
26313,2,1,92080,92081,92082,1,2,0
26314,2,3,92082,92082,92085,0,3,0
26315,6,2,92088,92088,92090,0,2,3
26316,3,3,92091,92091,92094,0,3,1
26317,6,3,92097,92097,92100,0,3,3
26318,6,1,92103,92103,92104,0,1,3
26319,3,3,92106,92106,92109,0,3,2
26320,4,2,92110,92110,92112,0,2,1
26321,6,1,92116,92116,92117,0,1,4
26322,3,3,92119,92119,92122,0,3,2
26323,4,2,92123,92123,92125,0,2,1
26324,2,1,92125,92125,92126,0,1,0
26325,1,1,92126,92126,92127,0,1,0
26326,6,3,92132,92132,92135,0,3,5
26327,2,2,92134,92135,92137,1,3,0
26328,2,1,92136,92137,92138,1,2,0
26329,2,1,92138,92138,92139,0,1,0
26330,1,1,92139,92139,92140,0,1,0
26331,5,1,92144,92144,92145,0,1,4
26332,5,2,92149,92149,92151,0,2,4
26333,1,1,92150,92151,92152,1,2,0
26334,6,3,92156,92156,92159,0,3,4
26335,1,2,92157,92159,92161,2,4,0
26336,4,1,92161,92161,92162,0,1,0
26337,5,1,92166,92166,92167,0,1,4
26338,1,2,92167,92167,92169,0,2,0
26339,4,3,92171,92171,92174,0,3,2
26340,2,3,92173,92174,92177,1,4,0
26341,1,2,92174,92177,92179,3,5,0
26342,3,2,92177,92179,92181,2,4,0
26343,4,2,92181,92181,92183,0,2,0
26344,1,3,92182,92183,92186,1,4,0
26345,1,3,92183,92186,92189,3,6,0
26346,6,2,92189,92189,92191,0,2,0
26347,6,2,92195,92195,92197,0,2,4
26348,6,3,92201,92201,92204,0,3,4
26349,3,3,92204,92204,92207,0,3,0
26350,4,2,92208,92208,92210,0,2,1
26351,1,2,92209,92210,92212,1,3,0
26352,3,3,92212,92212,92215,0,3,0
26353,5,3,92217,92217,92220,0,3,2
26354,5,3,92222,92222,92225,0,3,2
26355,4,3,92226,92226,92229,0,3,1
26356,4,2,92230,92230,92232,0,2,1
26357,5,2,92235,92235,92237,0,2,3
26358,2,1,92237,92237,92238,0,1,0
26359,6,1,92243,92243,92244,0,1,5
26360,2,3,92245,92245,92248,0,3,1
26361,4,1,92249,92249,92250,0,1,1
26362,6,3,92255,92255,92258,0,3,5
26363,5,1,92260,92260,92261,0,1,2
26364,4,2,92264,92264,92266,0,2,3
26365,3,3,92267,92267,92270,0,3,1
26366,3,3,92270,92270,92273,0,3,0
26367,3,3,92273,92273,92276,0,3,0
26368,2,2,92275,92276,92278,1,3,0
26369,2,3,92277,92278,92281,1,4,0
26370,5,1,92282,92282,92283,0,1,1
26371,3,3,92285,92285,92288,0,3,2
26372,4,1,92289,92289,92290,0,1,1
26373,4,3,92293,92293,92296,0,3,3
26374,2,3,92295,92296,92299,1,4,0
26375,3,2,92298,92299,92301,1,3,0
26376,5,1,92303,92303,92304,0,1,2
26377,3,3,92306,92306,92309,0,3,2
26378,6,2,92312,92312,92314,0,2,3
26379,4,1,92316,92316,92317,0,1,2
26380,3,1,92319,92319,92320,0,1,2
26381,3,3,92322,92322,92325,0,3,2
26382,4,3,92326,92326,92329,0,3,1
26383,5,1,92331,92331,92332,0,1,2
26384,6,3,92337,92337,92340,0,3,5
26385,2,1,92339,92340,92341,1,2,0
26386,1,3,92340,92341,92344,1,4,0
26387,3,2,92343,92344,92346,1,3,0
26388,3,3,92346,92346,92349,0,3,0
26389,2,2,92348,92349,92351,1,3,0
26390,5,1,92353,92353,92354,0,1,2
26391,4,1,92357,92357,92358,0,1,3
26392,4,1,92361,92361,92362,0,1,3
26393,2,2,92363,92363,92365,0,2,1
26394,4,3,92367,92367,92370,0,3,2
26395,6,3,92373,92373,92376,0,3,3
26396,1,2,92374,92376,92378,2,4,0
26397,3,3,92377,92378,92381,1,4,0
26398,1,3,92378,92381,92384,3,6,0
26399,2,3,92380,92384,92387,4,7,0
26400,1,3,92381,92387,92390,6,9,0
26401,1,1,92382,92390,92391,8,9,0
26402,2,1,92384,92391,92392,7,8,0
26403,3,2,92387,92392,92394,5,7,0
26404,5,2,92392,92394,92396,2,4,0
26405,6,3,92398,92398,92401,0,3,2
26406,3,2,92401,92401,92403,0,2,0
26407,1,2,92402,92403,92405,1,3,0
26408,3,2,92405,92405,92407,0,2,0
26409,6,1,92411,92411,92412,0,1,4
26410,1,2,92412,92412,92414,0,2,0
26411,5,1,92417,92417,92418,0,1,3
26412,2,1,92419,92419,92420,0,1,1
26413,1,1,92420,92420,92421,0,1,0
26414,2,3,92422,92422,92425,0,3,1
26415,4,2,92426,92426,92428,0,2,1
26416,1,2,92427,92428,92430,1,3,0
26417,5,1,92432,92432,92433,0,1,2
26418,1,3,92433,92433,92436,0,3,0
26419,2,3,92435,92436,92439,1,4,0
26420,6,1,92441,92441,92442,0,1,2
26421,2,2,92443,92443,92445,0,2,1
26422,5,1,92448,92448,92449,0,1,3
26423,2,1,92450,92450,92451,0,1,1
26424,3,2,92453,92453,92455,0,2,2
26425,4,2,92457,92457,92459,0,2,2
26426,4,2,92461,92461,92463,0,2,2
26427,1,3,92462,92463,92466,1,4,0
26428,4,3,92466,92466,92469,0,3,0
26429,3,2,92469,92469,92471,0,2,0
26430,3,1,92472,92472,92473,0,1,1
26431,1,2,92473,92473,92475,0,2,0
26432,1,2,92474,92475,92477,1,3,0
26433,3,2,92477,92477,92479,0,2,0
26434,1,2,92478,92479,92481,1,3,0
26435,3,1,92481,92481,92482,0,1,0
26436,4,2,92485,92485,92487,0,2,3
26437,1,1,92486,92487,92488,1,2,0
26438,3,3,92489,92489,92492,0,3,1
26439,6,1,92495,92495,92496,0,1,3
26440,3,2,92498,92498,92500,0,2,2
26441,3,3,92501,92501,92504,0,3,1
26442,5,1,92506,92506,92507,0,1,2
26443,5,2,92511,92511,92513,0,2,4
26444,3,1,92514,92514,92515,0,1,1
26445,1,1,92515,92515,92516,0,1,0
26446,3,1,92518,92518,92519,0,1,2
26447,2,1,92520,92520,92521,0,1,1
26448,6,2,92526,92526,92528,0,2,5
26449,5,3,92531,92531,92534,0,3,3
26450,5,3,92536,92536,92539,0,3,2
26451,3,1,92539,92539,92540,0,1,0
26452,2,1,92541,92541,92542,0,1,1
26453,5,2,92546,92546,92548,0,2,4
26454,3,2,92549,92549,92551,0,2,1
26455,4,2,92553,92553,92555,0,2,2
26456,4,2,92557,92557,92559,0,2,2
26457,3,2,92560,92560,92562,0,2,1
26458,4,1,92564,92564,92565,0,1,2
26459,5,3,92569,92569,92572,0,3,4
26460,1,1,92570,92572,92573,2,3,0
26461,5,1,92575,92575,92576,0,1,2
26462,6,1,92581,92581,92582,0,1,5
26463,5,1,92586,92586,92587,0,1,4
26464,3,1,92589,92589,92590,0,1,2
26465,2,1,92591,92591,92592,0,1,1
26466,6,3,92597,92597,92600,0,3,5
26467,1,3,92598,92600,92603,2,5,0
26468,1,2,92599,92603,92605,4,6,0
26469,1,3,92600,92605,92608,5,8,0
26470,4,2,92604,92608,92610,4,6,0
26471,6,2,92610,92610,92612,0,2,0
26472,1,2,92611,92612,92614,1,3,0
26473,6,1,92617,92617,92618,0,1,3
26474,3,2,92620,92620,92622,0,2,2
26475,2,3,92622,92622,92625,0,3,0
26476,2,2,92624,92625,92627,1,3,0
26477,2,1,92626,92627,92628,1,2,0
26478,2,3,92628,92628,92631,0,3,0
26479,6,2,92634,92634,92636,0,2,3
26480,4,2,92638,92638,92640,0,2,2
26481,3,1,92641,92641,92642,0,1,1
26482,1,2,92642,92642,92644,0,2,0
26483,4,2,92646,92646,92648,0,2,2
26484,5,1,92651,92651,92652,0,1,3
26485,1,1,92652,92652,92653,0,1,0
26486,2,1,92654,92654,92655,0,1,1
26487,4,2,92658,92658,92660,0,2,3
26488,3,3,92661,92661,92664,0,3,1
26489,2,3,92663,92664,92667,1,4,0
26490,1,3,92664,92667,92670,3,6,0
26491,1,2,92665,92670,92672,5,7,0
26492,5,2,92670,92672,92674,2,4,0
26493,5,3,92675,92675,92678,0,3,1
26494,6,2,92681,92681,92683,0,2,3
26495,2,1,92683,92683,92684,0,1,0
26496,2,1,92685,92685,92686,0,1,1
26497,3,2,92688,92688,92690,0,2,2
26498,1,2,92689,92690,92692,1,3,0
26499,6,2,92695,92695,92697,0,2,3
26500,6,3,92701,92701,92704,0,3,4
26501,3,3,92704,92704,92707,0,3,0
26502,1,3,92705,92707,92710,2,5,0
26503,3,1,92708,92710,92711,2,3,0
26504,3,3,92711,92711,92714,0,3,0
26505,3,2,92714,92714,92716,0,2,0
26506,1,2,92715,92716,92718,1,3,0
26507,5,3,92720,92720,92723,0,3,2
26508,5,3,92725,92725,92728,0,3,2
26509,5,3,92730,92730,92733,0,3,2
26510,1,2,92731,92733,92735,2,4,0
26511,4,2,92735,92735,92737,0,2,0
26512,4,1,92739,92739,92740,0,1,2
26513,2,2,92741,92741,92743,0,2,1
26514,1,3,92742,92743,92746,1,4,0
26515,4,2,92746,92746,92748,0,2,0
26516,6,2,92752,92752,92754,0,2,4
26517,4,2,92756,92756,92758,0,2,2
26518,4,2,92760,92760,92762,0,2,2
26519,6,2,92766,92766,92768,0,2,4
26520,3,1,92769,92769,92770,0,1,1
26521,5,1,92774,92774,92775,0,1,4
26522,1,1,92775,92775,92776,0,1,0
26523,6,3,92781,92781,92784,0,3,5
26524,2,3,92783,92784,92787,1,4,0
26525,2,3,92785,92787,92790,2,5,0
26526,5,2,92790,92790,92792,0,2,0
26527,5,3,92795,92795,92798,0,3,3
26528,4,2,92799,92799,92801,0,2,1
26529,1,2,92800,92801,92803,1,3,0
26530,5,1,92805,92805,92806,0,1,2
26531,4,2,92809,92809,92811,0,2,3
26532,1,3,92810,92811,92814,1,4,0
26533,1,1,92811,92814,92815,3,4,0
26534,4,1,92815,92815,92816,0,1,0
26535,3,2,92818,92818,92820,0,2,2
26536,5,1,92823,92823,92824,0,1,3
26537,6,1,92829,92829,92830,0,1,5
26538,1,2,92830,92830,92832,0,2,0
26539,3,2,92833,92833,92835,0,2,1
26540,1,2,92834,92835,92837,1,3,0
26541,5,2,92839,92839,92841,0,2,2
26542,3,2,92842,92842,92844,0,2,1
26543,6,3,92848,92848,92851,0,3,4
26544,4,1,92852,92852,92853,0,1,1
26545,5,2,92857,92857,92859,0,2,4
26546,6,2,92863,92863,92865,0,2,4
26547,6,3,92869,92869,92872,0,3,4
26548,5,2,92874,92874,92876,0,2,2
26549,6,2,92880,92880,92882,0,2,4
26550,5,3,92885,92885,92888,0,3,3
26551,2,3,92887,92888,92891,1,4,0
26552,3,1,92890,92891,92892,1,2,0
26553,5,2,92895,92895,92897,0,2,3
26554,6,1,92901,92901,92902,0,1,4
26555,6,3,92907,92907,92910,0,3,5
26556,4,1,92911,92911,92912,0,1,1
26557,1,2,92912,92912,92914,0,2,0
26558,5,1,92917,92917,92918,0,1,3
26559,3,2,92920,92920,92922,0,2,2
26560,5,3,92925,92925,92928,0,3,3
26561,2,2,92927,92928,92930,1,3,0
26562,3,2,92930,92930,92932,0,2,0
26563,3,3,92933,92933,92936,0,3,1
26564,2,1,92935,92936,92937,1,2,0
26565,1,2,92936,92937,92939,1,3,0
26566,1,1,92937,92939,92940,2,3,0
26567,6,2,92943,92943,92945,0,2,3
26568,2,1,92945,92945,92946,0,1,0
26569,1,1,92946,92946,92947,0,1,0
26570,1,1,92947,92947,92948,0,1,0
26571,4,2,92951,92951,92953,0,2,3
26572,2,3,92953,92953,92956,0,3,0
26573,1,2,92954,92956,92958,2,4,0
26574,3,1,92957,92958,92959,1,2,0
26575,2,1,92959,92959,92960,0,1,0
26576,4,1,92963,92963,92964,0,1,3
26577,1,2,92964,92964,92966,0,2,0
26578,1,1,92965,92966,92967,1,2,0
26579,1,3,92966,92967,92970,1,4,0
26580,6,3,92972,92972,92975,0,3,2
26581,6,2,92978,92978,92980,0,2,3
26582,1,3,92979,92980,92983,1,4,0
26583,5,1,92984,92984,92985,0,1,1
26584,3,2,92987,92987,92989,0,2,2
26585,3,3,92990,92990,92993,0,3,1
26586,1,3,92991,92993,92996,2,5,0
26587,5,2,92996,92996,92998,0,2,0
26588,6,2,93002,93002,93004,0,2,4
26589,1,2,93003,93004,93006,1,3,0
26590,2,1,93005,93006,93007,1,2,0
26591,5,3,93010,93010,93013,0,3,3
26592,5,1,93015,93015,93016,0,1,2
26593,5,2,93020,93020,93022,0,2,4
26594,3,3,93023,93023,93026,0,3,1
26595,6,3,93029,93029,93032,0,3,3
26596,2,3,93031,93032,93035,1,4,0
26597,5,1,93036,93036,93037,0,1,1
26598,6,1,93042,93042,93043,0,1,5
26599,3,2,93045,93045,93047,0,2,2
26600,4,3,93049,93049,93052,0,3,2
26601,3,3,93052,93052,93055,0,3,0
26602,5,3,93057,93057,93060,0,3,2
26603,3,2,93060,93060,93062,0,2,0
26604,2,1,93062,93062,93063,0,1,0
26605,1,2,93063,93063,93065,0,2,0
26606,1,1,93064,93065,93066,1,2,0
26607,6,2,93070,93070,93072,0,2,4
26608,4,3,93074,93074,93077,0,3,2
26609,3,2,93077,93077,93079,0,2,0
26610,5,2,93082,93082,93084,0,2,3
26611,3,2,93085,93085,93087,0,2,1
26612,3,1,93088,93088,93089,0,1,1
26613,4,2,93092,93092,93094,0,2,3
26614,1,2,93093,93094,93096,1,3,0
26615,6,2,93099,93099,93101,0,2,3
26616,3,2,93102,93102,93104,0,2,1
26617,1,2,93103,93104,93106,1,3,0
26618,6,1,93109,93109,93110,0,1,3
26619,4,2,93113,93113,93115,0,2,3
26620,1,2,93114,93115,93117,1,3,0
26621,5,1,93119,93119,93120,0,1,2
26622,5,1,93124,93124,93125,0,1,4
26623,3,1,93127,93127,93128,0,1,2
26624,5,3,93132,93132,93135,0,3,4
26625,1,2,93133,93135,93137,2,4,0
26626,6,2,93139,93139,93141,0,2,2
26627,4,1,93143,93143,93144,0,1,2
26628,3,2,93146,93146,93148,0,2,2
26629,1,1,93147,93148,93149,1,2,0
26630,2,3,93149,93149,93152,0,3,0
26631,5,2,93154,93154,93156,0,2,2
26632,3,1,93157,93157,93158,0,1,1
26633,1,3,93158,93158,93161,0,3,0
26634,3,2,93161,93161,93163,0,2,0
26635,5,2,93166,93166,93168,0,2,3
26636,3,3,93169,93169,93172,0,3,1
26637,1,1,93170,93172,93173,2,3,0
26638,1,3,93171,93173,93176,2,5,0
26639,3,2,93174,93176,93178,2,4,0
26640,1,2,93175,93178,93180,3,5,0
26641,4,2,93179,93180,93182,1,3,0
26642,3,2,93182,93182,93184,0,2,0
26643,4,1,93186,93186,93187,0,1,2
26644,2,3,93188,93188,93191,0,3,1
26645,4,2,93192,93192,93194,0,2,1
26646,4,2,93196,93196,93198,0,2,2
26647,4,2,93200,93200,93202,0,2,2
26648,6,3,93206,93206,93209,0,3,4
26649,6,3,93212,93212,93215,0,3,3
26650,3,2,93215,93215,93217,0,2,0
26651,6,3,93221,93221,93224,0,3,4
26652,5,3,93226,93226,93229,0,3,2
26653,5,2,93231,93231,93233,0,2,2
26654,5,3,93236,93236,93239,0,3,3
26655,2,1,93238,93239,93240,1,2,0
26656,2,1,93240,93240,93241,0,1,0
26657,6,3,93246,93246,93249,0,3,5
26658,1,1,93247,93249,93250,2,3,0
26659,2,3,93249,93250,93253,1,4,0
26660,1,3,93250,93253,93256,3,6,0
26661,3,3,93253,93256,93259,3,6,0
26662,1,1,93254,93259,93260,5,6,0
26663,1,2,93255,93260,93262,5,7,0
26664,4,1,93259,93262,93263,3,4,0
26665,4,2,93263,93263,93265,0,2,0
26666,3,3,93266,93266,93269,0,3,1
26667,4,2,93270,93270,93272,0,2,1
26668,1,1,93271,93272,93273,1,2,0
26669,6,3,93277,93277,93280,0,3,4
26670,3,2,93280,93280,93282,0,2,0
26671,6,3,93286,93286,93289,0,3,4
26672,2,2,93288,93289,93291,1,3,0
26673,5,2,93293,93293,93295,0,2,2
26674,2,1,93295,93295,93296,0,1,0
26675,5,3,93300,93300,93303,0,3,4
26676,4,1,93304,93304,93305,0,1,1
26677,6,2,93310,93310,93312,0,2,5
26678,1,1,93311,93312,93313,1,2,0
26679,6,3,93317,93317,93320,0,3,4
26680,3,2,93320,93320,93322,0,2,0
26681,4,2,93324,93324,93326,0,2,2
26682,2,3,93326,93326,93329,0,3,0
26683,1,1,93327,93329,93330,2,3,0
26684,2,2,93329,93330,93332,1,3,0
26685,6,1,93335,93335,93336,0,1,3
26686,1,2,93336,93336,93338,0,2,0
26687,4,2,93340,93340,93342,0,2,2
26688,5,2,93345,93345,93347,0,2,3
26689,4,3,93349,93349,93352,0,3,2
26690,3,1,93352,93352,93353,0,1,0
26691,3,1,93355,93355,93356,0,1,2
26692,6,2,93361,93361,93363,0,2,5
26693,1,2,93362,93363,93365,1,3,0
26694,1,2,93363,93365,93367,2,4,0
26695,4,3,93367,93367,93370,0,3,0
26696,4,2,93371,93371,93373,0,2,1
26697,6,3,93377,93377,93380,0,3,4
26698,4,3,93381,93381,93384,0,3,1
26699,5,1,93386,93386,93387,0,1,2
26700,4,1,93390,93390,93391,0,1,3
26701,2,3,93392,93392,93395,0,3,1
26702,1,2,93393,93395,93397,2,4,0
26703,6,3,93399,93399,93402,0,3,2
26704,4,1,93403,93403,93404,0,1,1
26705,1,1,93404,93404,93405,0,1,0
26706,6,3,93410,93410,93413,0,3,5
26707,2,1,93412,93413,93414,1,2,0
26708,6,1,93418,93418,93419,0,1,4
26709,3,3,93421,93421,93424,0,3,2
26710,6,1,93427,93427,93428,0,1,3
26711,5,1,93432,93432,93433,0,1,4
26712,6,2,93438,93438,93440,0,2,5
26713,5,1,93443,93443,93444,0,1,3
26714,6,1,93449,93449,93450,0,1,5
26715,2,1,93451,93451,93452,0,1,1
26716,3,2,93454,93454,93456,0,2,2
26717,1,1,93455,93456,93457,1,2,0
26718,4,2,93459,93459,93461,0,2,2
26719,4,1,93463,93463,93464,0,1,2
26720,6,1,93469,93469,93470,0,1,5
26721,4,2,93473,93473,93475,0,2,3
26722,3,3,93476,93476,93479,0,3,1
26723,6,3,93482,93482,93485,0,3,3
26724,6,2,93488,93488,93490,0,2,3
26725,4,2,93492,93492,93494,0,2,2
26726,1,3,93493,93494,93497,1,4,0
26727,3,1,93496,93497,93498,1,2,0
26728,2,2,93498,93498,93500,0,2,0
26729,1,2,93499,93500,93502,1,3,0
26730,5,2,93504,93504,93506,0,2,2
26731,5,2,93509,93509,93511,0,2,3
26732,2,2,93511,93511,93513,0,2,0
26733,1,1,93512,93513,93514,1,2,0
26734,1,2,93513,93514,93516,1,3,0
26735,3,1,93516,93516,93517,0,1,0
26736,2,2,93518,93518,93520,0,2,1
26737,1,1,93519,93520,93521,1,2,0
26738,3,3,93522,93522,93525,0,3,1
26739,6,3,93528,93528,93531,0,3,3
26740,1,1,93529,93531,93532,2,3,0
26741,1,3,93530,93532,93535,2,5,0
26742,1,1,93531,93535,93536,4,5,0
26743,5,1,93536,93536,93537,0,1,0
26744,4,2,93540,93540,93542,0,2,3
26745,3,3,93543,93543,93546,0,3,1
26746,2,2,93545,93546,93548,1,3,0
26747,6,3,93551,93551,93554,0,3,3
26748,2,1,93553,93554,93555,1,2,0
26749,4,3,93557,93557,93560,0,3,2
26750,4,3,93561,93561,93564,0,3,1
26751,2,1,93563,93564,93565,1,2,0
26752,2,2,93565,93565,93567,0,2,0
26753,2,2,93567,93567,93569,0,2,0
26754,5,2,93572,93572,93574,0,2,3
26755,2,1,93574,93574,93575,0,1,0
26756,5,1,93579,93579,93580,0,1,4
26757,3,1,93582,93582,93583,0,1,2
26758,5,1,93587,93587,93588,0,1,4
26759,1,1,93588,93588,93589,0,1,0
26760,1,3,93589,93589,93592,0,3,0
26761,3,3,93592,93592,93595,0,3,0
26762,1,2,93593,93595,93597,2,4,0
26763,2,3,93595,93597,93600,2,5,0
26764,6,1,93601,93601,93602,0,1,1
26765,4,1,93605,93605,93606,0,1,3
26766,5,3,93610,93610,93613,0,3,4
26767,1,1,93611,93613,93614,2,3,0
26768,2,3,93613,93614,93617,1,4,0
26769,2,2,93615,93617,93619,2,4,0
26770,4,1,93619,93619,93620,0,1,0
26771,2,3,93621,93621,93624,0,3,1
26772,4,1,93625,93625,93626,0,1,1
26773,4,1,93629,93629,93630,0,1,3
26774,5,2,93634,93634,93636,0,2,4
26775,3,1,93637,93637,93638,0,1,1
26776,4,2,93641,93641,93643,0,2,3
26777,4,2,93645,93645,93647,0,2,2
26778,2,2,93647,93647,93649,0,2,0
26779,2,3,93649,93649,93652,0,3,0
26780,4,3,93653,93653,93656,0,3,1
26781,3,2,93656,93656,93658,0,2,0
26782,5,2,93661,93661,93663,0,2,3
26783,2,3,93663,93663,93666,0,3,0
26784,1,2,93664,93666,93668,2,4,0
26785,2,1,93666,93668,93669,2,3,0
26786,5,1,93671,93671,93672,0,1,2
26787,1,3,93672,93672,93675,0,3,0
26788,5,1,93677,93677,93678,0,1,2
26789,4,2,93681,93681,93683,0,2,3
26790,3,1,93684,93684,93685,0,1,1
26791,4,3,93688,93688,93691,0,3,3
26792,2,1,93690,93691,93692,1,2,0
26793,1,1,93691,93692,93693,1,2,0
26794,5,1,93696,93696,93697,0,1,3
26795,5,3,93701,93701,93704,0,3,4
26796,1,3,93702,93704,93707,2,5,0
26797,3,2,93705,93707,93709,2,4,0
26798,1,2,93706,93709,93711,3,5,0
26799,4,3,93710,93711,93714,1,4,0
26800,5,3,93715,93715,93718,0,3,1
26801,2,1,93717,93718,93719,1,2,0
26802,4,2,93721,93721,93723,0,2,2
26803,1,2,93722,93723,93725,1,3,0
26804,6,1,93728,93728,93729,0,1,3
26805,2,2,93730,93730,93732,0,2,1
26806,3,2,93733,93733,93735,0,2,1
26807,6,1,93739,93739,93740,0,1,4
26808,3,2,93742,93742,93744,0,2,2
26809,1,1,93743,93744,93745,1,2,0
26810,4,3,93747,93747,93750,0,3,2
26811,5,3,93752,93752,93755,0,3,2
26812,2,1,93754,93755,93756,1,2,0
26813,5,1,93759,93759,93760,0,1,3
26814,5,3,93764,93764,93767,0,3,4
26815,5,2,93769,93769,93771,0,2,2
26816,4,1,93773,93773,93774,0,1,2
26817,4,1,93777,93777,93778,0,1,3
26818,2,3,93779,93779,93782,0,3,1
26819,6,2,93785,93785,93787,0,2,3
26820,4,1,93789,93789,93790,0,1,2
26821,4,3,93793,93793,93796,0,3,3
26822,5,1,93798,93798,93799,0,1,2
26823,5,2,93803,93803,93805,0,2,4
26824,4,1,93807,93807,93808,0,1,2
26825,4,1,93811,93811,93812,0,1,3
26826,1,1,93812,93812,93813,0,1,0
26827,2,1,93814,93814,93815,0,1,1
26828,4,1,93818,93818,93819,0,1,3
26829,1,1,93819,93819,93820,0,1,0
26830,5,2,93824,93824,93826,0,2,4
26831,1,3,93825,93826,93829,1,4,0
26832,3,3,93828,93829,93832,1,4,0
26833,6,1,93834,93834,93835,0,1,2
26834,1,3,93835,93835,93838,0,3,0
26835,4,3,93839,93839,93842,0,3,1
26836,5,2,93844,93844,93846,0,2,2
26837,5,1,93849,93849,93850,0,1,3
26838,2,2,93851,93851,93853,0,2,1
26839,5,2,93856,93856,93858,0,2,3
26840,1,1,93857,93858,93859,1,2,0
26841,6,2,93863,93863,93865,0,2,4
26842,4,1,93867,93867,93868,0,1,2
26843,3,1,93870,93870,93871,0,1,2
26844,5,1,93875,93875,93876,0,1,4
26845,4,3,93879,93879,93882,0,3,3
26846,2,1,93881,93882,93883,1,2,0
26847,3,3,93884,93884,93887,0,3,1
26848,6,2,93890,93890,93892,0,2,3
26849,2,2,93892,93892,93894,0,2,0
26850,3,2,93895,93895,93897,0,2,1
26851,1,3,93896,93897,93900,1,4,0
26852,2,1,93898,93900,93901,2,3,0
26853,3,2,93901,93901,93903,0,2,0
26854,6,1,93907,93907,93908,0,1,4
26855,3,1,93910,93910,93911,0,1,2
26856,1,2,93911,93911,93913,0,2,0
26857,4,3,93915,93915,93918,0,3,2
26858,1,2,93916,93918,93920,2,4,0
26859,1,2,93917,93920,93922,3,5,0
26860,2,2,93919,93922,93924,3,5,0
26861,6,3,93925,93925,93928,0,3,1
26862,4,1,93929,93929,93930,0,1,1
26863,5,3,93934,93934,93937,0,3,4
26864,3,3,93937,93937,93940,0,3,0
26865,1,3,93938,93940,93943,2,5,0
26866,1,3,93939,93943,93946,4,7,0
26867,2,2,93941,93946,93948,5,7,0
26868,2,3,93943,93948,93951,5,8,0
26869,3,1,93946,93951,93952,5,6,0
26870,5,2,93951,93952,93954,1,3,0
26871,6,1,93957,93957,93958,0,1,3
26872,1,1,93958,93958,93959,0,1,0
26873,6,1,93964,93964,93965,0,1,5
26874,3,2,93967,93967,93969,0,2,2
26875,2,1,93969,93969,93970,0,1,0
26876,1,2,93970,93970,93972,0,2,0
26877,3,2,93973,93973,93975,0,2,1
26878,2,3,93975,93975,93978,0,3,0
26879,3,3,93978,93978,93981,0,3,0
26880,2,1,93980,93981,93982,1,2,0
26881,4,3,93984,93984,93987,0,3,2
26882,6,1,93990,93990,93991,0,1,3
26883,6,1,93996,93996,93997,0,1,5
26884,4,3,94000,94000,94003,0,3,3
26885,4,2,94004,94004,94006,0,2,1
26886,3,3,94007,94007,94010,0,3,1
26887,1,1,94008,94010,94011,2,3,0
26888,2,2,94010,94011,94013,1,3,0
26889,1,2,94011,94013,94015,2,4,0
26890,5,1,94016,94016,94017,0,1,1
26891,3,2,94019,94019,94021,0,2,2
26892,1,2,94020,94021,94023,1,3,0
26893,3,1,94023,94023,94024,0,1,0
26894,3,3,94026,94026,94029,0,3,2
26895,1,2,94027,94029,94031,2,4,0
26896,1,1,94028,94031,94032,3,4,0
26897,5,1,94033,94033,94034,0,1,1
26898,1,2,94034,94034,94036,0,2,0
26899,5,2,94039,94039,94041,0,2,3
26900,5,3,94044,94044,94047,0,3,3
26901,4,1,94048,94048,94049,0,1,1
26902,5,2,94053,94053,94055,0,2,4
26903,6,2,94059,94059,94061,0,2,4
26904,3,3,94062,94062,94065,0,3,1
26905,4,3,94066,94066,94069,0,3,1
26906,3,1,94069,94069,94070,0,1,0
26907,1,3,94070,94070,94073,0,3,0
26908,6,2,94076,94076,94078,0,2,3
26909,1,2,94077,94078,94080,1,3,0
26910,6,3,94083,94083,94086,0,3,3
26911,1,2,94084,94086,94088,2,4,0
26912,1,2,94085,94088,94090,3,5,0
26913,2,2,94087,94090,94092,3,5,0
26914,1,1,94088,94092,94093,4,5,0
26915,4,1,94092,94093,94094,1,2,0
26916,1,2,94093,94094,94096,1,3,0
26917,3,3,94096,94096,94099,0,3,0
26918,4,3,94100,94100,94103,0,3,1
26919,5,1,94105,94105,94106,0,1,2
26920,4,2,94109,94109,94111,0,2,3
26921,2,3,94111,94111,94114,0,3,0
26922,5,2,94116,94116,94118,0,2,2
26923,4,1,94120,94120,94121,0,1,2
26924,1,1,94121,94121,94122,0,1,0
26925,2,2,94123,94123,94125,0,2,1
26926,4,1,94127,94127,94128,0,1,2
26927,3,2,94130,94130,94132,0,2,2
26928,6,3,94136,94136,94139,0,3,4
26929,6,3,94142,94142,94145,0,3,3
26930,4,2,94146,94146,94148,0,2,1
26931,1,3,94147,94148,94151,1,4,0
26932,3,3,94150,94151,94154,1,4,0
26933,4,2,94154,94154,94156,0,2,0
26934,2,2,94156,94156,94158,0,2,0
26935,5,2,94161,94161,94163,0,2,3
26936,3,3,94164,94164,94167,0,3,1
26937,6,1,94170,94170,94171,0,1,3
26938,6,3,94176,94176,94179,0,3,5
26939,6,1,94182,94182,94183,0,1,3
26940,3,3,94185,94185,94188,0,3,2
26941,3,2,94188,94188,94190,0,2,0
26942,5,1,94193,94193,94194,0,1,3
26943,4,2,94197,94197,94199,0,2,3
26944,5,1,94202,94202,94203,0,1,3
26945,4,2,94206,94206,94208,0,2,3
26946,3,3,94209,94209,94212,0,3,1
26947,3,1,94212,94212,94213,0,1,0
26948,2,3,94214,94214,94217,0,3,1
26949,5,1,94219,94219,94220,0,1,2
26950,1,3,94220,94220,94223,0,3,0
26951,2,2,94222,94223,94225,1,3,0
26952,3,2,94225,94225,94227,0,2,0
26953,6,2,94231,94231,94233,0,2,4
26954,6,2,94237,94237,94239,0,2,4
26955,2,3,94239,94239,94242,0,3,0
26956,5,3,94244,94244,94247,0,3,2
26957,1,3,94245,94247,94250,2,5,0
26958,5,2,94250,94250,94252,0,2,0
26959,1,3,94251,94252,94255,1,4,0
26960,1,1,94252,94255,94256,3,4,0
26961,5,1,94257,94257,94258,0,1,1
26962,5,1,94262,94262,94263,0,1,4
26963,1,2,94263,94263,94265,0,2,0
26964,2,2,94265,94265,94267,0,2,0
26965,6,1,94271,94271,94272,0,1,4
26966,3,2,94274,94274,94276,0,2,2
26967,5,1,94279,94279,94280,0,1,3
26968,4,1,94283,94283,94284,0,1,3
26969,5,1,94288,94288,94289,0,1,4
26970,1,3,94289,94289,94292,0,3,0
26971,5,1,94294,94294,94295,0,1,2
26972,5,1,94299,94299,94300,0,1,4
26973,1,3,94300,94300,94303,0,3,0
26974,1,2,94301,94303,94305,2,4,0
26975,4,1,94305,94305,94306,0,1,0
26976,1,2,94306,94306,94308,0,2,0
26977,3,3,94309,94309,94312,0,3,1
26978,1,2,94310,94312,94314,2,4,0
26979,2,3,94312,94314,94317,2,5,0
26980,1,2,94313,94317,94319,4,6,0
26981,4,2,94317,94319,94321,2,4,0
26982,6,1,94323,94323,94324,0,1,2
26983,2,3,94325,94325,94328,0,3,1
26984,5,3,94330,94330,94333,0,3,2
26985,3,3,94333,94333,94336,0,3,0
26986,4,2,94337,94337,94339,0,2,1
26987,1,3,94338,94339,94342,1,4,0
26988,5,3,94343,94343,94346,0,3,1
26989,3,3,94346,94346,94349,0,3,0
26990,2,3,94348,94349,94352,1,4,0
26991,6,3,94354,94354,94357,0,3,2
26992,2,3,94356,94357,94360,1,4,0
26993,3,3,94359,94360,94363,1,4,0
26994,2,1,94361,94363,94364,2,3,0
26995,3,2,94364,94364,94366,0,2,0
26996,2,2,94366,94366,94368,0,2,0
26997,4,1,94370,94370,94371,0,1,2
26998,6,1,94376,94376,94377,0,1,5
26999,3,1,94379,94379,94380,0,1,2
27000,4,2,94383,94383,94385,0,2,3
27001,3,2,94386,94386,94388,0,2,1
27002,6,3,94392,94392,94395,0,3,4
27003,5,1,94397,94397,94398,0,1,2
27004,3,1,94400,94400,94401,0,1,2
27005,5,2,94405,94405,94407,0,2,4
27006,2,1,94407,94407,94408,0,1,0
27007,2,2,94409,94409,94411,0,2,1
27008,2,1,94411,94411,94412,0,1,0
27009,6,1,94417,94417,94418,0,1,5
27010,3,3,94420,94420,94423,0,3,2
27011,4,3,94424,94424,94427,0,3,1
27012,4,2,94428,94428,94430,0,2,1
27013,1,2,94429,94430,94432,1,3,0
27014,5,1,94434,94434,94435,0,1,2
27015,4,2,94438,94438,94440,0,2,3
27016,4,1,94442,94442,94443,0,1,2
27017,6,3,94448,94448,94451,0,3,5
27018,5,1,94453,94453,94454,0,1,2
27019,5,1,94458,94458,94459,0,1,4
27020,3,2,94461,94461,94463,0,2,2
27021,6,2,94467,94467,94469,0,2,4
27022,5,2,94472,94472,94474,0,2,3
27023,5,1,94477,94477,94478,0,1,3
27024,1,2,94478,94478,94480,0,2,0
27025,6,1,94484,94484,94485,0,1,4
27026,2,3,94486,94486,94489,0,3,1
27027,1,1,94487,94489,94490,2,3,0
27028,6,1,94493,94493,94494,0,1,3
27029,3,2,94496,94496,94498,0,2,2
27030,6,2,94502,94502,94504,0,2,4
27031,4,3,94506,94506,94509,0,3,2
27032,1,3,94507,94509,94512,2,5,0
27033,4,3,94511,94512,94515,1,4,0
27034,4,3,94515,94515,94518,0,3,0
27035,3,3,94518,94518,94521,0,3,0
27036,2,3,94520,94521,94524,1,4,0
27037,3,1,94523,94524,94525,1,2,0
27038,3,3,94526,94526,94529,0,3,1
27039,2,3,94528,94529,94532,1,4,0
27040,6,1,94534,94534,94535,0,1,2
27041,1,3,94535,94535,94538,0,3,0
27042,3,3,94538,94538,94541,0,3,0
27043,5,2,94543,94543,94545,0,2,2
27044,2,2,94545,94545,94547,0,2,0
27045,6,3,94551,94551,94554,0,3,4
27046,3,3,94554,94554,94557,0,3,0
27047,3,1,94557,94557,94558,0,1,0
27048,6,1,94563,94563,94564,0,1,5
27049,5,3,94568,94568,94571,0,3,4
27050,4,1,94572,94572,94573,0,1,1
27051,5,1,94577,94577,94578,0,1,4
27052,5,2,94582,94582,94584,0,2,4
27053,5,3,94587,94587,94590,0,3,3
27054,2,3,94589,94590,94593,1,4,0
27055,5,2,94594,94594,94596,0,2,1
27056,4,3,94598,94598,94601,0,3,2
27057,5,3,94603,94603,94606,0,3,2
27058,2,2,94605,94606,94608,1,3,0
27059,5,1,94610,94610,94611,0,1,2
27060,5,3,94615,94615,94618,0,3,4
27061,5,2,94620,94620,94622,0,2,2
27062,4,1,94624,94624,94625,0,1,2
27063,1,3,94625,94625,94628,0,3,0
27064,5,3,94630,94630,94633,0,3,2
27065,2,2,94632,94633,94635,1,3,0
27066,3,2,94635,94635,94637,0,2,0
27067,4,3,94639,94639,94642,0,3,2
27068,6,3,94645,94645,94648,0,3,3
27069,5,2,94650,94650,94652,0,2,2
27070,2,1,94652,94652,94653,0,1,0
27071,6,2,94658,94658,94660,0,2,5
27072,4,3,94662,94662,94665,0,3,2
27073,4,1,94666,94666,94667,0,1,1
27074,6,1,94672,94672,94673,0,1,5
27075,5,3,94677,94677,94680,0,3,4
27076,6,2,94683,94683,94685,0,2,3
27077,1,3,94684,94685,94688,1,4,0
27078,1,3,94685,94688,94691,3,6,0
27079,1,2,94686,94691,94693,5,7,0
27080,5,2,94691,94693,94695,2,4,0
27081,2,3,94693,94695,94698,2,5,0
27082,1,1,94694,94698,94699,4,5,0
27083,5,1,94699,94699,94700,0,1,0
27084,5,2,94704,94704,94706,0,2,4
27085,6,2,94710,94710,94712,0,2,4
27086,4,3,94714,94714,94717,0,3,2
27087,6,1,94720,94720,94721,0,1,3
27088,2,2,94722,94722,94724,0,2,1
27089,2,1,94724,94724,94725,0,1,0
27090,3,1,94727,94727,94728,0,1,2
27091,4,1,94731,94731,94732,0,1,3
27092,3,1,94734,94734,94735,0,1,2
27093,2,2,94736,94736,94738,0,2,1
27094,4,2,94740,94740,94742,0,2,2
27095,4,3,94744,94744,94747,0,3,2
27096,1,2,94745,94747,94749,2,4,0
27097,2,3,94747,94749,94752,2,5,0
27098,2,2,94749,94752,94754,3,5,0
27099,4,3,94753,94754,94757,1,4,0
27100,1,3,94754,94757,94760,3,6,0
27101,3,2,94757,94760,94762,3,5,0
27102,2,1,94759,94762,94763,3,4,0
27103,4,2,94763,94763,94765,0,2,0
27104,3,2,94766,94766,94768,0,2,1
27105,6,1,94772,94772,94773,0,1,4
27106,4,3,94776,94776,94779,0,3,3
27107,6,1,94782,94782,94783,0,1,3
27108,3,3,94785,94785,94788,0,3,2
27109,2,3,94787,94788,94791,1,4,0
27110,3,1,94790,94791,94792,1,2,0
27111,1,1,94791,94792,94793,1,2,0
27112,5,2,94796,94796,94798,0,2,3
27113,5,3,94801,94801,94804,0,3,3
27114,2,3,94803,94804,94807,1,4,0
27115,2,1,94805,94807,94808,2,3,0
27116,4,2,94809,94809,94811,0,2,1
27117,5,3,94814,94814,94817,0,3,3
27118,5,3,94819,94819,94822,0,3,2
27119,6,2,94825,94825,94827,0,2,3
27120,1,2,94826,94827,94829,1,3,0
27121,6,2,94832,94832,94834,0,2,3
27122,4,3,94836,94836,94839,0,3,2
27123,2,1,94838,94839,94840,1,2,0
27124,1,2,94839,94840,94842,1,3,0
27125,5,3,94844,94844,94847,0,3,2
27126,1,3,94845,94847,94850,2,5,0
27127,2,2,94847,94850,94852,3,5,0
27128,6,3,94853,94853,94856,0,3,1
27129,3,2,94856,94856,94858,0,2,0
27130,2,2,94858,94858,94860,0,2,0
27131,3,3,94861,94861,94864,0,3,1
27132,4,2,94865,94865,94867,0,2,1
27133,2,1,94867,94867,94868,0,1,0
27134,2,2,94869,94869,94871,0,2,1
27135,5,2,94874,94874,94876,0,2,3
27136,2,2,94876,94876,94878,0,2,0
27137,6,3,94882,94882,94885,0,3,4
27138,2,2,94884,94885,94887,1,3,0
27139,1,1,94885,94887,94888,2,3,0
27140,4,3,94889,94889,94892,0,3,1
27141,4,2,94893,94893,94895,0,2,1
27142,4,3,94897,94897,94900,0,3,2
27143,6,2,94903,94903,94905,0,2,3
27144,1,1,94904,94905,94906,1,2,0
27145,2,3,94906,94906,94909,0,3,0
27146,3,2,94909,94909,94911,0,2,0
27147,5,3,94914,94914,94917,0,3,3
27148,3,2,94917,94917,94919,0,2,0
27149,1,3,94918,94919,94922,1,4,0
27150,4,2,94922,94922,94924,0,2,0
27151,5,2,94927,94927,94929,0,2,3
27152,5,3,94932,94932,94935,0,3,3
27153,3,1,94935,94935,94936,0,1,0
27154,3,3,94938,94938,94941,0,3,2
27155,1,3,94939,94941,94944,2,5,0
27156,3,3,94942,94944,94947,2,5,0
27157,1,3,94943,94947,94950,4,7,0
27158,6,2,94949,94950,94952,1,3,0
27159,1,1,94950,94952,94953,2,3,0
27160,2,3,94952,94953,94956,1,4,0
27161,4,1,94956,94956,94957,0,1,0
27162,3,1,94959,94959,94960,0,1,2
27163,1,2,94960,94960,94962,0,2,0
27164,2,1,94962,94962,94963,0,1,0
27165,4,3,94966,94966,94969,0,3,3
27166,1,1,94967,94969,94970,2,3,0
27167,5,1,94972,94972,94973,0,1,2
27168,1,2,94973,94973,94975,0,2,0
27169,3,2,94976,94976,94978,0,2,1
27170,1,3,94977,94978,94981,1,4,0
27171,3,3,94980,94981,94984,1,4,0
27172,2,1,94982,94984,94985,2,3,0
27173,4,1,94986,94986,94987,0,1,1
27174,6,2,94992,94992,94994,0,2,5
27175,2,1,94994,94994,94995,0,1,0
27176,5,2,94999,94999,95001,0,2,4
27177,6,3,95005,95005,95008,0,3,4
27178,1,3,95006,95008,95011,2,5,0
27179,4,2,95010,95011,95013,1,3,0
27180,3,1,95013,95013,95014,0,1,0
27181,1,2,95014,95014,95016,0,2,0
27182,1,3,95015,95016,95019,1,4,0
27183,6,1,95021,95021,95022,0,1,2
27184,2,1,95023,95023,95024,0,1,1
27185,1,2,95024,95024,95026,0,2,0
27186,5,3,95029,95029,95032,0,3,3
27187,4,1,95033,95033,95034,0,1,1
27188,5,3,95038,95038,95041,0,3,4
27189,6,3,95044,95044,95047,0,3,3
27190,1,1,95045,95047,95048,2,3,0
27191,5,2,95050,95050,95052,0,2,2
27192,4,1,95054,95054,95055,0,1,2
27193,4,2,95058,95058,95060,0,2,3
27194,6,3,95064,95064,95067,0,3,4
27195,4,3,95068,95068,95071,0,3,1
27196,2,1,95070,95071,95072,1,2,0
27197,1,2,95071,95072,95074,1,3,0
27198,4,1,95075,95075,95076,0,1,1
27199,1,1,95076,95076,95077,0,1,0
27200,1,3,95077,95077,95080,0,3,0
27201,5,2,95082,95082,95084,0,2,2
27202,4,3,95086,95086,95089,0,3,2
27203,4,2,95090,95090,95092,0,2,1
27204,5,1,95095,95095,95096,0,1,3
27205,6,1,95101,95101,95102,0,1,5
27206,3,3,95104,95104,95107,0,3,2
27207,1,2,95105,95107,95109,2,4,0
27208,6,1,95111,95111,95112,0,1,2
27209,6,1,95117,95117,95118,0,1,5
27210,1,3,95118,95118,95121,0,3,0
27211,2,2,95120,95121,95123,1,3,0
27212,2,1,95122,95123,95124,1,2,0
27213,2,3,95124,95124,95127,0,3,0
27214,5,2,95129,95129,95131,0,2,2
27215,4,2,95133,95133,95135,0,2,2
27216,3,3,95136,95136,95139,0,3,1
27217,6,3,95142,95142,95145,0,3,3
27218,1,2,95143,95145,95147,2,4,0
27219,1,1,95144,95147,95148,3,4,0
27220,1,3,95145,95148,95151,3,6,0
27221,5,2,95150,95151,95153,1,3,0
27222,4,1,95154,95154,95155,0,1,1
27223,1,1,95155,95155,95156,0,1,0
27224,5,2,95160,95160,95162,0,2,4
27225,3,1,95163,95163,95164,0,1,1
27226,2,3,95165,95165,95168,0,3,1
27227,2,1,95167,95168,95169,1,2,0
27228,4,3,95171,95171,95174,0,3,2
27229,4,1,95175,95175,95176,0,1,1
27230,6,2,95181,95181,95183,0,2,5
27231,5,3,95186,95186,95189,0,3,3
27232,2,2,95188,95189,95191,1,3,0
27233,3,1,95191,95191,95192,0,1,0
27234,2,1,95193,95193,95194,0,1,1
27235,3,3,95196,95196,95199,0,3,2
27236,2,2,95198,95199,95201,1,3,0
27237,2,1,95200,95201,95202,1,2,0
27238,4,1,95204,95204,95205,0,1,2
27239,3,1,95207,95207,95208,0,1,2
27240,3,3,95210,95210,95213,0,3,2
27241,1,1,95211,95213,95214,2,3,0
27242,5,3,95216,95216,95219,0,3,2
27243,3,3,95219,95219,95222,0,3,0
27244,2,3,95221,95222,95225,1,4,0
27245,4,1,95225,95225,95226,0,1,0
27246,2,1,95227,95227,95228,0,1,1
27247,4,1,95231,95231,95232,0,1,3
27248,3,1,95234,95234,95235,0,1,2
27249,3,2,95237,95237,95239,0,2,2
27250,3,3,95240,95240,95243,0,3,1
27251,3,1,95243,95243,95244,0,1,0
27252,5,2,95248,95248,95250,0,2,4
27253,5,3,95253,95253,95256,0,3,3
27254,1,2,95254,95256,95258,2,4,0
27255,6,2,95260,95260,95262,0,2,2
27256,2,1,95262,95262,95263,0,1,0
27257,3,1,95265,95265,95266,0,1,2
27258,5,1,95270,95270,95271,0,1,4
27259,2,3,95272,95272,95275,0,3,1
27260,4,3,95276,95276,95279,0,3,1
27261,6,3,95282,95282,95285,0,3,3
27262,2,2,95284,95285,95287,1,3,0
27263,6,3,95290,95290,95293,0,3,3
27264,5,1,95295,95295,95296,0,1,2
27265,6,3,95301,95301,95304,0,3,5
27266,1,1,95302,95304,95305,2,3,0
27267,4,3,95306,95306,95309,0,3,1
27268,5,3,95311,95311,95314,0,3,2
27269,3,3,95314,95314,95317,0,3,0
27270,2,3,95316,95317,95320,1,4,0
27271,2,2,95318,95320,95322,2,4,0
27272,5,3,95323,95323,95326,0,3,1
27273,3,3,95326,95326,95329,0,3,0
27274,5,3,95331,95331,95334,0,3,2
27275,2,3,95333,95334,95337,1,4,0
27276,6,1,95339,95339,95340,0,1,2
27277,2,1,95341,95341,95342,0,1,1
27278,1,3,95342,95342,95345,0,3,0
27279,3,2,95345,95345,95347,0,2,0
27280,4,3,95349,95349,95352,0,3,2
27281,5,2,95354,95354,95356,0,2,2
27282,3,2,95357,95357,95359,0,2,1
27283,2,3,95359,95359,95362,0,3,0
27284,6,2,95365,95365,95367,0,2,3
27285,5,1,95370,95370,95371,0,1,3
27286,6,3,95376,95376,95379,0,3,5
27287,2,1,95378,95379,95380,1,2,0
27288,4,3,95382,95382,95385,0,3,2
27289,2,3,95384,95385,95388,1,4,0
27290,1,3,95385,95388,95391,3,6,0
27291,3,2,95388,95391,95393,3,5,0
27292,2,2,95390,95393,95395,3,5,0
27293,2,1,95392,95395,95396,3,4,0
27294,5,3,95397,95397,95400,0,3,1
27295,1,2,95398,95400,95402,2,4,0
27296,2,2,95400,95402,95404,2,4,0
27297,4,1,95404,95404,95405,0,1,0
27298,3,3,95407,95407,95410,0,3,2
27299,6,3,95413,95413,95416,0,3,3
27300,4,1,95417,95417,95418,0,1,1
27301,1,1,95418,95418,95419,0,1,0
27302,5,1,95423,95423,95424,0,1,4
27303,1,1,95424,95424,95425,0,1,0
27304,6,1,95430,95430,95431,0,1,5
27305,4,3,95434,95434,95437,0,3,3
27306,5,3,95439,95439,95442,0,3,2
27307,3,1,95442,95442,95443,0,1,0
27308,3,3,95445,95445,95448,0,3,2
27309,2,2,95447,95448,95450,1,3,0
27310,2,3,95449,95450,95453,1,4,0
27311,3,1,95452,95453,95454,1,2,0
27312,4,2,95456,95456,95458,0,2,2
27313,3,3,95459,95459,95462,0,3,1
27314,6,2,95465,95465,95467,0,2,3
27315,3,2,95468,95468,95470,0,2,1
27316,1,1,95469,95470,95471,1,2,0
27317,3,3,95472,95472,95475,0,3,1
27318,5,1,95477,95477,95478,0,1,2
27319,6,1,95483,95483,95484,0,1,5
27320,1,2,95484,95484,95486,0,2,0
27321,6,2,95490,95490,95492,0,2,4
27322,4,3,95494,95494,95497,0,3,2
27323,5,3,95499,95499,95502,0,3,2
27324,5,3,95504,95504,95507,0,3,2
27325,5,1,95509,95509,95510,0,1,2
27326,6,1,95515,95515,95516,0,1,5
27327,1,3,95516,95516,95519,0,3,0
27328,1,1,95517,95519,95520,2,3,0
27329,6,2,95523,95523,95525,0,2,3
27330,5,3,95528,95528,95531,0,3,3
27331,3,1,95531,95531,95532,0,1,0
27332,6,2,95537,95537,95539,0,2,5
27333,5,2,95542,95542,95544,0,2,3
27334,3,2,95545,95545,95547,0,2,1
27335,5,2,95550,95550,95552,0,2,3
27336,5,2,95555,95555,95557,0,2,3
27337,3,1,95558,95558,95559,0,1,1
27338,4,2,95562,95562,95564,0,2,3
27339,2,2,95564,95564,95566,0,2,0
27340,4,2,95568,95568,95570,0,2,2
27341,5,2,95573,95573,95575,0,2,3
27342,1,1,95574,95575,95576,1,2,0
27343,2,2,95576,95576,95578,0,2,0
27344,6,1,95582,95582,95583,0,1,4
27345,5,3,95587,95587,95590,0,3,4
27346,1,2,95588,95590,95592,2,4,0
27347,1,1,95589,95592,95593,3,4,0
27348,2,3,95591,95593,95596,2,5,0
27349,3,1,95594,95596,95597,2,3,0
27350,3,3,95597,95597,95600,0,3,0
27351,5,1,95602,95602,95603,0,1,2
27352,4,2,95606,95606,95608,0,2,3
27353,6,3,95612,95612,95615,0,3,4
27354,2,2,95614,95615,95617,1,3,0
27355,3,2,95617,95617,95619,0,2,0
27356,5,2,95622,95622,95624,0,2,3
27357,2,3,95624,95624,95627,0,3,0
27358,6,3,95630,95630,95633,0,3,3
27359,1,2,95631,95633,95635,2,4,0
27360,5,1,95636,95636,95637,0,1,1
27361,1,2,95637,95637,95639,0,2,0
27362,3,1,95640,95640,95641,0,1,1
27363,5,3,95645,95645,95648,0,3,4
27364,2,1,95647,95648,95649,1,2,0
27365,5,3,95652,95652,95655,0,3,3
27366,1,2,95653,95655,95657,2,4,0
27367,2,2,95655,95657,95659,2,4,0
27368,2,3,95657,95659,95662,2,5,0
27369,4,2,95661,95662,95664,1,3,0
27370,2,2,95663,95664,95666,1,3,0
27371,1,1,95664,95666,95667,2,3,0
27372,2,2,95666,95667,95669,1,3,0
27373,3,2,95669,95669,95671,0,2,0
27374,2,3,95671,95671,95674,0,3,0
27375,1,1,95672,95674,95675,2,3,0
27376,4,3,95676,95676,95679,0,3,1
27377,5,1,95681,95681,95682,0,1,2
27378,5,1,95686,95686,95687,0,1,4
27379,6,1,95692,95692,95693,0,1,5
27380,6,1,95698,95698,95699,0,1,5
27381,2,3,95700,95700,95703,0,3,1
27382,2,3,95702,95703,95706,1,4,0
27383,2,2,95704,95706,95708,2,4,0
27384,4,3,95708,95708,95711,0,3,0
27385,3,3,95711,95711,95714,0,3,0
27386,1,2,95712,95714,95716,2,4,0
27387,2,2,95714,95716,95718,2,4,0
27388,4,3,95718,95718,95721,0,3,0
27389,1,3,95719,95721,95724,2,5,0
27390,5,3,95724,95724,95727,0,3,0
27391,3,2,95727,95727,95729,0,2,0
27392,2,1,95729,95729,95730,0,1,0
27393,3,2,95732,95732,95734,0,2,2
27394,5,1,95737,95737,95738,0,1,3
27395,5,1,95742,95742,95743,0,1,4
27396,4,1,95746,95746,95747,0,1,3
27397,2,1,95748,95748,95749,0,1,1
27398,3,2,95751,95751,95753,0,2,2
27399,4,2,95755,95755,95757,0,2,2
27400,3,3,95758,95758,95761,0,3,1
27401,6,1,95764,95764,95765,0,1,3
27402,4,1,95768,95768,95769,0,1,3
27403,4,2,95772,95772,95774,0,2,3
27404,5,1,95777,95777,95778,0,1,3
27405,2,2,95779,95779,95781,0,2,1
27406,4,3,95783,95783,95786,0,3,2
27407,1,3,95784,95786,95789,2,5,0
27408,6,2,95790,95790,95792,0,2,1
27409,5,2,95795,95795,95797,0,2,3
27410,1,1,95796,95797,95798,1,2,0
27411,6,1,95802,95802,95803,0,1,4
27412,3,3,95805,95805,95808,0,3,2
27413,6,1,95811,95811,95812,0,1,3
27414,5,3,95816,95816,95819,0,3,4
27415,5,2,95821,95821,95823,0,2,2
27416,5,2,95826,95826,95828,0,2,3
27417,4,2,95830,95830,95832,0,2,2
27418,2,1,95832,95832,95833,0,1,0
27419,4,3,95836,95836,95839,0,3,3
27420,2,3,95838,95839,95842,1,4,0
27421,3,1,95841,95842,95843,1,2,0
27422,5,1,95846,95846,95847,0,1,3
27423,1,3,95847,95847,95850,0,3,0
27424,1,3,95848,95850,95853,2,5,0
27425,4,3,95852,95853,95856,1,4,0
27426,1,2,95853,95856,95858,3,5,0
27427,6,3,95859,95859,95862,0,3,1
27428,6,2,95865,95865,95867,0,2,3
27429,2,2,95867,95867,95869,0,2,0
27430,1,3,95868,95869,95872,1,4,0
27431,2,1,95870,95872,95873,2,3,0
27432,1,3,95871,95873,95876,2,5,0
27433,1,2,95872,95876,95878,4,6,0
27434,5,3,95877,95878,95881,1,4,0
27435,2,3,95879,95881,95884,2,5,0
27436,4,2,95883,95884,95886,1,3,0
27437,4,3,95887,95887,95890,0,3,1
27438,1,3,95888,95890,95893,2,5,0
27439,6,1,95894,95894,95895,0,1,1
27440,4,3,95898,95898,95901,0,3,3
27441,4,1,95902,95902,95903,0,1,1
27442,5,1,95907,95907,95908,0,1,4
27443,2,2,95909,95909,95911,0,2,1
27444,6,1,95915,95915,95916,0,1,4
27445,3,3,95918,95918,95921,0,3,2
27446,5,1,95923,95923,95924,0,1,2
27447,6,3,95929,95929,95932,0,3,5
27448,3,3,95932,95932,95935,0,3,0
27449,1,2,95933,95935,95937,2,4,0
27450,6,1,95939,95939,95940,0,1,2
27451,6,1,95945,95945,95946,0,1,5
27452,6,1,95951,95951,95952,0,1,5
27453,6,3,95957,95957,95960,0,3,5
27454,1,2,95958,95960,95962,2,4,0
27455,3,3,95961,95962,95965,1,4,0
27456,5,2,95966,95966,95968,0,2,1
27457,1,2,95967,95968,95970,1,3,0
27458,3,2,95970,95970,95972,0,2,0
27459,5,3,95975,95975,95978,0,3,3
27460,5,1,95980,95980,95981,0,1,2
27461,2,1,95982,95982,95983,0,1,1
27462,4,1,95986,95986,95987,0,1,3
27463,4,1,95990,95990,95991,0,1,3
27464,3,1,95993,95993,95994,0,1,2
27465,3,2,95996,95996,95998,0,2,2
27466,1,1,95997,95998,95999,1,2,0
27467,2,1,95999,95999,96000,0,1,0
27468,1,2,96000,96000,96002,0,2,0
27469,6,3,96006,96006,96009,0,3,4
27470,5,2,96011,96011,96013,0,2,2
27471,2,3,96013,96013,96016,0,3,0
27472,4,2,96017,96017,96019,0,2,1
27473,2,3,96019,96019,96022,0,3,0
27474,5,3,96024,96024,96027,0,3,2
27475,5,3,96029,96029,96032,0,3,2
27476,5,3,96034,96034,96037,0,3,2
27477,1,2,96035,96037,96039,2,4,0
27478,1,2,96036,96039,96041,3,5,0
27479,5,3,96041,96041,96044,0,3,0
27480,5,3,96046,96046,96049,0,3,2
27481,3,3,96049,96049,96052,0,3,0
27482,6,3,96055,96055,96058,0,3,3
27483,6,3,96061,96061,96064,0,3,3
27484,3,1,96064,96064,96065,0,1,0
27485,4,2,96068,96068,96070,0,2,3
27486,4,1,96072,96072,96073,0,1,2
27487,4,3,96076,96076,96079,0,3,3
27488,4,3,96080,96080,96083,0,3,1
27489,5,3,96085,96085,96088,0,3,2
27490,1,2,96086,96088,96090,2,4,0
27491,1,1,96087,96090,96091,3,4,0
27492,5,1,96092,96092,96093,0,1,1
27493,5,2,96097,96097,96099,0,2,4
27494,1,1,96098,96099,96100,1,2,0
27495,4,2,96102,96102,96104,0,2,2
27496,4,3,96106,96106,96109,0,3,2
27497,4,2,96110,96110,96112,0,2,1
27498,2,1,96112,96112,96113,0,1,0
27499,4,3,96116,96116,96119,0,3,3
27500,5,1,96121,96121,96122,0,1,2
27501,3,3,96124,96124,96127,0,3,2
27502,2,3,96126,96127,96130,1,4,0
27503,6,2,96132,96132,96134,0,2,2
27504,3,1,96135,96135,96136,0,1,1
27505,2,2,96137,96137,96139,0,2,1
27506,4,3,96141,96141,96144,0,3,2
27507,2,3,96143,96144,96147,1,4,0
27508,6,3,96149,96149,96152,0,3,2
27509,2,1,96151,96152,96153,1,2,0
27510,2,2,96153,96153,96155,0,2,0
27511,4,3,96157,96157,96160,0,3,2
27512,5,1,96162,96162,96163,0,1,2
27513,4,1,96166,96166,96167,0,1,3
27514,2,1,96168,96168,96169,0,1,1
27515,4,3,96172,96172,96175,0,3,3
27516,6,2,96178,96178,96180,0,2,3
27517,2,2,96180,96180,96182,0,2,0
27518,2,3,96182,96182,96185,0,3,0
27519,5,3,96187,96187,96190,0,3,2
27520,1,2,96188,96190,96192,2,4,0
27521,4,3,96192,96192,96195,0,3,0
27522,4,2,96196,96196,96198,0,2,1
27523,3,2,96199,96199,96201,0,2,1
27524,4,3,96203,96203,96206,0,3,2
27525,2,1,96205,96206,96207,1,2,0
27526,5,1,96210,96210,96211,0,1,3
27527,6,1,96216,96216,96217,0,1,5
27528,3,3,96219,96219,96222,0,3,2
27529,6,3,96225,96225,96228,0,3,3
27530,2,1,96227,96228,96229,1,2,0
27531,4,2,96231,96231,96233,0,2,2
27532,3,2,96234,96234,96236,0,2,1
27533,4,3,96238,96238,96241,0,3,2
27534,4,3,96242,96242,96245,0,3,1
27535,4,1,96246,96246,96247,0,1,1
27536,1,3,96247,96247,96250,0,3,0
27537,6,1,96253,96253,96254,0,1,3
27538,2,1,96255,96255,96256,0,1,1
27539,2,2,96257,96257,96259,0,2,1
27540,6,3,96263,96263,96266,0,3,4
27541,1,2,96264,96266,96268,2,4,0
27542,2,3,96266,96268,96271,2,5,0
27543,2,3,96268,96271,96274,3,6,0
27544,4,1,96272,96274,96275,2,3,0
27545,1,1,96273,96275,96276,2,3,0
27546,2,3,96275,96276,96279,1,4,0
27547,3,1,96278,96279,96280,1,2,0
27548,3,1,96281,96281,96282,0,1,1
27549,2,3,96283,96283,96286,0,3,1
27550,3,2,96286,96286,96288,0,2,0
27551,5,2,96291,96291,96293,0,2,3
27552,1,2,96292,96293,96295,1,3,0
27553,5,3,96297,96297,96300,0,3,2
27554,1,3,96298,96300,96303,2,5,0
27555,6,2,96304,96304,96306,0,2,1
27556,3,3,96307,96307,96310,0,3,1
27557,1,2,96308,96310,96312,2,4,0
27558,4,3,96312,96312,96315,0,3,0
27559,5,2,96317,96317,96319,0,2,2
27560,6,1,96323,96323,96324,0,1,4
27561,1,1,96324,96324,96325,0,1,0
27562,6,3,96330,96330,96333,0,3,5
27563,4,1,96334,96334,96335,0,1,1
27564,6,1,96340,96340,96341,0,1,5
27565,5,3,96345,96345,96348,0,3,4
27566,5,2,96350,96350,96352,0,2,2
27567,5,3,96355,96355,96358,0,3,3
27568,4,2,96359,96359,96361,0,2,1
27569,3,2,96362,96362,96364,0,2,1
27570,6,3,96368,96368,96371,0,3,4
27571,1,1,96369,96371,96372,2,3,0
27572,5,3,96374,96374,96377,0,3,2
27573,3,1,96377,96377,96378,0,1,0
27574,5,1,96382,96382,96383,0,1,4
27575,5,3,96387,96387,96390,0,3,4
27576,1,3,96388,96390,96393,2,5,0
27577,2,2,96390,96393,96395,3,5,0
27578,3,1,96393,96395,96396,2,3,0
27579,2,2,96395,96396,96398,1,3,0
27580,1,2,96396,96398,96400,2,4,0
27581,2,2,96398,96400,96402,2,4,0
27582,1,1,96399,96402,96403,3,4,0
27583,5,3,96404,96404,96407,0,3,1
27584,2,1,96406,96407,96408,1,2,0
27585,1,3,96407,96408,96411,1,4,0
27586,5,1,96412,96412,96413,0,1,1
27587,5,1,96417,96417,96418,0,1,4
27588,4,1,96421,96421,96422,0,1,3
27589,6,2,96427,96427,96429,0,2,5
27590,5,2,96432,96432,96434,0,2,3
27591,3,2,96435,96435,96437,0,2,1
27592,6,2,96441,96441,96443,0,2,4
27593,2,3,96443,96443,96446,0,3,0
27594,4,2,96447,96447,96449,0,2,1
27595,4,2,96451,96451,96453,0,2,2
27596,2,2,96453,96453,96455,0,2,0
27597,4,3,96457,96457,96460,0,3,2
27598,4,2,96461,96461,96463,0,2,1
27599,2,2,96463,96463,96465,0,2,0
27600,2,3,96465,96465,96468,0,3,0
27601,5,1,96470,96470,96471,0,1,2
27602,6,2,96476,96476,96478,0,2,5
27603,6,2,96482,96482,96484,0,2,4
27604,3,2,96485,96485,96487,0,2,1
27605,1,1,96486,96487,96488,1,2,0
27606,6,3,96492,96492,96495,0,3,4
27607,3,3,96495,96495,96498,0,3,0
27608,3,3,96498,96498,96501,0,3,0
27609,6,3,96504,96504,96507,0,3,3
27610,2,3,96506,96507,96510,1,4,0
27611,4,2,96510,96510,96512,0,2,0
27612,1,1,96511,96512,96513,1,2,0
27613,6,3,96517,96517,96520,0,3,4
27614,3,2,96520,96520,96522,0,2,0
27615,5,3,96525,96525,96528,0,3,3
27616,2,1,96527,96528,96529,1,2,0
27617,3,2,96530,96530,96532,0,2,1
27618,1,1,96531,96532,96533,1,2,0
27619,6,3,96537,96537,96540,0,3,4
27620,6,3,96543,96543,96546,0,3,3
27621,1,1,96544,96546,96547,2,3,0
27622,6,1,96550,96550,96551,0,1,3
27623,3,1,96553,96553,96554,0,1,2
27624,6,1,96559,96559,96560,0,1,5
27625,5,3,96564,96564,96567,0,3,4
27626,4,1,96568,96568,96569,0,1,1
27627,1,2,96569,96569,96571,0,2,0
27628,3,3,96572,96572,96575,0,3,1
27629,3,3,96575,96575,96578,0,3,0
27630,6,2,96581,96581,96583,0,2,3
27631,1,3,96582,96583,96586,1,4,0
27632,5,3,96587,96587,96590,0,3,1
27633,1,3,96588,96590,96593,2,5,0
27634,4,3,96592,96593,96596,1,4,0
27635,3,3,96595,96596,96599,1,4,0
27636,2,3,96597,96599,96602,2,5,0
27637,6,2,96603,96603,96605,0,2,1
27638,6,1,96609,96609,96610,0,1,4
27639,3,1,96612,96612,96613,0,1,2
27640,5,1,96617,96617,96618,0,1,4
27641,6,3,96623,96623,96626,0,3,5
27642,4,2,96627,96627,96629,0,2,1
27643,5,1,96632,96632,96633,0,1,3
27644,6,3,96638,96638,96641,0,3,5
27645,2,2,96640,96641,96643,1,3,0
27646,5,2,96645,96645,96647,0,2,2
27647,1,3,96646,96647,96650,1,4,0
27648,1,3,96647,96650,96653,3,6,0
27649,4,2,96651,96653,96655,2,4,0
27650,2,1,96653,96655,96656,2,3,0
27651,6,2,96659,96659,96661,0,2,3
27652,6,3,96665,96665,96668,0,3,4
27653,2,1,96667,96668,96669,1,2,0
27654,4,3,96671,96671,96674,0,3,2
27655,2,2,96673,96674,96676,1,3,0
27656,3,3,96676,96676,96679,0,3,0
27657,4,2,96680,96680,96682,0,2,1
27658,4,2,96684,96684,96686,0,2,2
27659,1,1,96685,96686,96687,1,2,0
27660,5,3,96690,96690,96693,0,3,3
27661,3,1,96693,96693,96694,0,1,0
27662,1,2,96694,96694,96696,0,2,0
27663,2,3,96696,96696,96699,0,3,0
27664,1,3,96697,96699,96702,2,5,0
27665,4,2,96701,96702,96704,1,3,0
27666,1,2,96702,96704,96706,2,4,0
27667,5,2,96707,96707,96709,0,2,1
27668,2,2,96709,96709,96711,0,2,0
27669,1,1,96710,96711,96712,1,2,0
27670,1,1,96711,96712,96713,1,2,0
27671,1,2,96712,96713,96715,1,3,0
27672,5,2,96717,96717,96719,0,2,2
27673,3,3,96720,96720,96723,0,3,1
27674,1,1,96721,96723,96724,2,3,0
27675,5,1,96726,96726,96727,0,1,2
27676,5,3,96731,96731,96734,0,3,4
27677,5,1,96736,96736,96737,0,1,2
27678,1,3,96737,96737,96740,0,3,0
27679,1,3,96738,96740,96743,2,5,0
27680,2,3,96740,96743,96746,3,6,0
27681,6,2,96746,96746,96748,0,2,0
27682,4,1,96750,96750,96751,0,1,2
27683,3,1,96753,96753,96754,0,1,2
27684,6,2,96759,96759,96761,0,2,5
27685,4,1,96763,96763,96764,0,1,2
27686,6,2,96769,96769,96771,0,2,5
27687,2,3,96771,96771,96774,0,3,0
27688,1,1,96772,96774,96775,2,3,0
27689,1,2,96773,96775,96777,2,4,0
27690,3,3,96776,96777,96780,1,4,0
27691,2,2,96778,96780,96782,2,4,0
27692,2,3,96780,96782,96785,2,5,0
27693,4,3,96784,96785,96788,1,4,0
27694,3,3,96787,96788,96791,1,4,0
27695,1,1,96788,96791,96792,3,4,0
27696,2,2,96790,96792,96794,2,4,0
27697,5,2,96795,96795,96797,0,2,1
27698,4,2,96799,96799,96801,0,2,2
27699,3,2,96802,96802,96804,0,2,1
27700,6,2,96808,96808,96810,0,2,4
27701,4,1,96812,96812,96813,0,1,2
27702,4,3,96816,96816,96819,0,3,3
27703,3,1,96819,96819,96820,0,1,0
27704,1,1,96820,96820,96821,0,1,0
27705,6,2,96826,96826,96828,0,2,5
27706,2,3,96828,96828,96831,0,3,0
27707,6,3,96834,96834,96837,0,3,3
27708,3,1,96837,96837,96838,0,1,0
27709,4,1,96841,96841,96842,0,1,3
27710,6,3,96847,96847,96850,0,3,5
27711,1,3,96848,96850,96853,2,5,0
27712,6,1,96854,96854,96855,0,1,1
27713,4,2,96858,96858,96860,0,2,3
27714,1,2,96859,96860,96862,1,3,0
27715,4,2,96863,96863,96865,0,2,1
27716,1,3,96864,96865,96868,1,4,0
27717,3,2,96867,96868,96870,1,3,0
27718,5,3,96872,96872,96875,0,3,2
27719,6,2,96878,96878,96880,0,2,3
27720,6,3,96884,96884,96887,0,3,4
27721,3,1,96887,96887,96888,0,1,0
27722,1,3,96888,96888,96891,0,3,0
27723,1,2,96889,96891,96893,2,4,0
27724,6,2,96895,96895,96897,0,2,2
27725,6,2,96901,96901,96903,0,2,4
27726,3,2,96904,96904,96906,0,2,1
27727,2,2,96906,96906,96908,0,2,0
27728,4,1,96910,96910,96911,0,1,2
27729,2,2,96912,96912,96914,0,2,1
27730,3,2,96915,96915,96917,0,2,1
27731,3,3,96918,96918,96921,0,3,1
27732,2,1,96920,96921,96922,1,2,0
27733,6,1,96926,96926,96927,0,1,4
27734,1,2,96927,96927,96929,0,2,0
27735,6,3,96933,96933,96936,0,3,4
27736,6,3,96939,96939,96942,0,3,3
27737,2,3,96941,96942,96945,1,4,0
27738,2,3,96943,96945,96948,2,5,0
27739,4,1,96947,96948,96949,1,2,0
27740,4,2,96951,96951,96953,0,2,2
27741,4,3,96955,96955,96958,0,3,2
27742,6,3,96961,96961,96964,0,3,3
27743,2,3,96963,96964,96967,1,4,0
27744,6,3,96969,96969,96972,0,3,2
27745,4,2,96973,96973,96975,0,2,1
27746,4,1,96977,96977,96978,0,1,2
27747,5,2,96982,96982,96984,0,2,4
27748,5,2,96987,96987,96989,0,2,3
27749,3,2,96990,96990,96992,0,2,1
27750,1,1,96991,96992,96993,1,2,0
27751,5,2,96996,96996,96998,0,2,3
27752,5,3,97001,97001,97004,0,3,3
27753,3,1,97004,97004,97005,0,1,0
27754,2,3,97006,97006,97009,0,3,1
27755,2,2,97008,97009,97011,1,3,0
27756,1,3,97009,97011,97014,2,5,0
27757,6,2,97015,97015,97017,0,2,1
27758,3,3,97018,97018,97021,0,3,1
27759,2,2,97020,97021,97023,1,3,0
27760,2,2,97022,97023,97025,1,3,0
27761,5,3,97027,97027,97030,0,3,2
27762,5,3,97032,97032,97035,0,3,2
27763,6,1,97038,97038,97039,0,1,3
27764,2,3,97040,97040,97043,0,3,1
27765,4,1,97044,97044,97045,0,1,1
27766,1,1,97045,97045,97046,0,1,0
27767,2,1,97047,97047,97048,0,1,1
27768,5,2,97052,97052,97054,0,2,4
27769,5,2,97057,97057,97059,0,2,3
27770,2,1,97059,97059,97060,0,1,0
27771,1,3,97060,97060,97063,0,3,0
27772,2,1,97062,97063,97064,1,2,0
27773,1,1,97063,97064,97065,1,2,0
27774,2,3,97065,97065,97068,0,3,0
27775,6,2,97071,97071,97073,0,2,3
27776,1,1,97072,97073,97074,1,2,0
27777,3,3,97075,97075,97078,0,3,1
27778,3,3,97078,97078,97081,0,3,0
27779,2,1,97080,97081,97082,1,2,0
27780,3,2,97083,97083,97085,0,2,1
27781,6,1,97089,97089,97090,0,1,4
27782,5,2,97094,97094,97096,0,2,4
27783,3,2,97097,97097,97099,0,2,1
27784,6,1,97103,97103,97104,0,1,4
27785,4,3,97107,97107,97110,0,3,3
27786,1,3,97108,97110,97113,2,5,0
27787,6,1,97114,97114,97115,0,1,1
27788,5,1,97119,97119,97120,0,1,4
27789,3,1,97122,97122,97123,0,1,2
27790,5,3,97127,97127,97130,0,3,4
27791,5,1,97132,97132,97133,0,1,2
27792,1,1,97133,97133,97134,0,1,0
27793,2,2,97135,97135,97137,0,2,1
27794,2,3,97137,97137,97140,0,3,0
27795,5,1,97142,97142,97143,0,1,2
27796,6,2,97148,97148,97150,0,2,5
27797,3,1,97151,97151,97152,0,1,1
27798,2,2,97153,97153,97155,0,2,1
27799,5,1,97158,97158,97159,0,1,3
27800,1,2,97159,97159,97161,0,2,0
27801,1,1,97160,97161,97162,1,2,0
27802,1,1,97161,97162,97163,1,2,0
27803,5,1,97166,97166,97167,0,1,3
27804,2,2,97168,97168,97170,0,2,1
27805,1,3,97169,97170,97173,1,4,0
27806,6,1,97175,97175,97176,0,1,2
27807,1,3,97176,97176,97179,0,3,0
27808,3,2,97179,97179,97181,0,2,0
27809,2,3,97181,97181,97184,0,3,0
27810,6,1,97187,97187,97188,0,1,3
27811,4,2,97191,97191,97193,0,2,3
27812,1,2,97192,97193,97195,1,3,0
27813,4,3,97196,97196,97199,0,3,1
27814,2,1,97198,97199,97200,1,2,0
27815,5,3,97203,97203,97206,0,3,3
27816,1,1,97204,97206,97207,2,3,0
27817,1,3,97205,97207,97210,2,5,0
27818,1,2,97206,97210,97212,4,6,0
27819,5,3,97211,97212,97215,1,4,0
27820,6,2,97217,97217,97219,0,2,2
27821,5,1,97222,97222,97223,0,1,3
27822,4,2,97226,97226,97228,0,2,3
27823,3,3,97229,97229,97232,0,3,1
27824,1,2,97230,97232,97234,2,4,0
27825,2,3,97232,97234,97237,2,5,0
27826,6,1,97238,97238,97239,0,1,1
27827,6,3,97244,97244,97247,0,3,5
27828,4,2,97248,97248,97250,0,2,1
27829,5,3,97253,97253,97256,0,3,3
27830,6,2,97259,97259,97261,0,2,3
27831,6,3,97265,97265,97268,0,3,4
27832,5,2,97270,97270,97272,0,2,2
27833,6,3,97276,97276,97279,0,3,4
27834,5,3,97281,97281,97284,0,3,2
27835,2,3,97283,97284,97287,1,4,0
27836,3,1,97286,97287,97288,1,2,0
27837,1,3,97287,97288,97291,1,4,0
27838,6,2,97293,97293,97295,0,2,2
27839,6,1,97299,97299,97300,0,1,4
27840,1,1,97300,97300,97301,0,1,0
27841,5,3,97305,97305,97308,0,3,4
27842,6,3,97311,97311,97314,0,3,3
27843,3,2,97314,97314,97316,0,2,0
27844,2,3,97316,97316,97319,0,3,0
27845,4,1,97320,97320,97321,0,1,1
27846,3,1,97323,97323,97324,0,1,2
27847,2,3,97325,97325,97328,0,3,1
27848,3,1,97328,97328,97329,0,1,0
27849,5,1,97333,97333,97334,0,1,4
27850,3,3,97336,97336,97339,0,3,2
27851,4,2,97340,97340,97342,0,2,1
27852,1,3,97341,97342,97345,1,4,0
27853,2,2,97343,97345,97347,2,4,0
27854,3,1,97346,97347,97348,1,2,0
27855,1,1,97347,97348,97349,1,2,0
27856,1,1,97348,97349,97350,1,2,0
27857,4,3,97352,97352,97355,0,3,2
27858,2,2,97354,97355,97357,1,3,0
27859,2,3,97356,97357,97360,1,4,0
27860,3,1,97359,97360,97361,1,2,0
27861,3,1,97362,97362,97363,0,1,1
27862,4,1,97366,97366,97367,0,1,3
27863,1,2,97367,97367,97369,0,2,0
27864,5,3,97372,97372,97375,0,3,3
27865,4,3,97376,97376,97379,0,3,1
27866,3,2,97379,97379,97381,0,2,0
27867,3,2,97382,97382,97384,0,2,1
27868,6,2,97388,97388,97390,0,2,4
27869,2,3,97390,97390,97393,0,3,0
27870,3,3,97393,97393,97396,0,3,0
27871,5,3,97398,97398,97401,0,3,2
27872,1,1,97399,97401,97402,2,3,0
27873,4,3,97403,97403,97406,0,3,1
27874,6,3,97409,97409,97412,0,3,3
27875,2,1,97411,97412,97413,1,2,0
27876,3,2,97414,97414,97416,0,2,1
27877,6,2,97420,97420,97422,0,2,4
27878,5,1,97425,97425,97426,0,1,3
27879,3,3,97428,97428,97431,0,3,2
27880,6,2,97434,97434,97436,0,2,3
27881,5,1,97439,97439,97440,0,1,3
27882,4,2,97443,97443,97445,0,2,3
27883,4,3,97447,97447,97450,0,3,2
27884,6,1,97453,97453,97454,0,1,3
27885,5,2,97458,97458,97460,0,2,4
27886,2,3,97460,97460,97463,0,3,0
27887,2,1,97462,97463,97464,1,2,0
27888,4,1,97466,97466,97467,0,1,2
27889,5,2,97471,97471,97473,0,2,4
27890,2,3,97473,97473,97476,0,3,0
27891,3,1,97476,97476,97477,0,1,0
27892,1,2,97477,97477,97479,0,2,0
27893,3,3,97480,97480,97483,0,3,1
27894,1,2,97481,97483,97485,2,4,0
27895,5,2,97486,97486,97488,0,2,1
27896,1,2,97487,97488,97490,1,3,0
27897,4,1,97491,97491,97492,0,1,1
27898,4,1,97495,97495,97496,0,1,3
27899,6,3,97501,97501,97504,0,3,5
27900,5,2,97506,97506,97508,0,2,2
27901,3,3,97509,97509,97512,0,3,1
27902,4,2,97513,97513,97515,0,2,1
27903,6,1,97519,97519,97520,0,1,4
27904,5,1,97524,97524,97525,0,1,4
27905,3,2,97527,97527,97529,0,2,2
27906,6,1,97533,97533,97534,0,1,4
27907,2,3,97535,97535,97538,0,3,1
27908,4,3,97539,97539,97542,0,3,1
27909,1,1,97540,97542,97543,2,3,0
27910,6,2,97546,97546,97548,0,2,3
27911,2,3,97548,97548,97551,0,3,0
27912,3,3,97551,97551,97554,0,3,0
27913,1,2,97552,97554,97556,2,4,0
27914,3,3,97555,97556,97559,1,4,0
27915,1,2,97556,97559,97561,3,5,0
27916,1,2,97557,97561,97563,4,6,0
27917,6,3,97563,97563,97566,0,3,0
27918,6,1,97569,97569,97570,0,1,3
27919,5,1,97574,97574,97575,0,1,4
27920,4,3,97578,97578,97581,0,3,3
27921,6,2,97584,97584,97586,0,2,3
27922,2,1,97586,97586,97587,0,1,0
27923,1,1,97587,97587,97588,0,1,0
27924,5,1,97592,97592,97593,0,1,4
27925,3,2,97595,97595,97597,0,2,2
27926,1,3,97596,97597,97600,1,4,0
27927,3,1,97599,97600,97601,1,2,0
27928,6,2,97605,97605,97607,0,2,4
27929,4,2,97609,97609,97611,0,2,2
27930,1,2,97610,97611,97613,1,3,0
27931,1,3,97611,97613,97616,2,5,0
27932,1,3,97612,97616,97619,4,7,0
27933,5,3,97617,97619,97622,2,5,0
27934,6,1,97623,97623,97624,0,1,1
27935,6,3,97629,97629,97632,0,3,5
27936,6,1,97635,97635,97636,0,1,3
27937,4,1,97639,97639,97640,0,1,3
27938,3,2,97642,97642,97644,0,2,2
27939,5,1,97647,97647,97648,0,1,3
27940,5,3,97652,97652,97655,0,3,4
27941,3,1,97655,97655,97656,0,1,0
27942,5,3,97660,97660,97663,0,3,4
27943,5,1,97665,97665,97666,0,1,2
27944,6,2,97671,97671,97673,0,2,5
27945,4,2,97675,97675,97677,0,2,2
27946,5,3,97680,97680,97683,0,3,3
27947,2,1,97682,97683,97684,1,2,0
27948,2,2,97684,97684,97686,0,2,0
27949,1,1,97685,97686,97687,1,2,0
27950,1,2,97686,97687,97689,1,3,0
27951,1,1,97687,97689,97690,2,3,0
27952,4,2,97691,97691,97693,0,2,1
27953,6,1,97697,97697,97698,0,1,4
27954,4,3,97701,97701,97704,0,3,3
27955,5,1,97706,97706,97707,0,1,2
27956,6,2,97712,97712,97714,0,2,5
27957,6,3,97718,97718,97721,0,3,4
27958,1,1,97719,97721,97722,2,3,0
27959,5,3,97724,97724,97727,0,3,2
27960,5,3,97729,97729,97732,0,3,2
27961,1,3,97730,97732,97735,2,5,0
27962,4,2,97734,97735,97737,1,3,0
27963,4,1,97738,97738,97739,0,1,1
27964,3,3,97741,97741,97744,0,3,2
27965,5,3,97746,97746,97749,0,3,2
27966,3,3,97749,97749,97752,0,3,0
27967,1,2,97750,97752,97754,2,4,0
27968,4,3,97754,97754,97757,0,3,0
27969,6,3,97760,97760,97763,0,3,3
27970,3,1,97763,97763,97764,0,1,0
27971,4,2,97767,97767,97769,0,2,3
27972,4,1,97771,97771,97772,0,1,2
27973,6,2,97777,97777,97779,0,2,5
27974,2,2,97779,97779,97781,0,2,0
27975,5,1,97784,97784,97785,0,1,3
27976,2,2,97786,97786,97788,0,2,1
27977,3,1,97789,97789,97790,0,1,1
27978,1,1,97790,97790,97791,0,1,0
27979,4,1,97794,97794,97795,0,1,3
27980,3,2,97797,97797,97799,0,2,2
27981,2,1,97799,97799,97800,0,1,0
27982,1,3,97800,97800,97803,0,3,0
27983,5,2,97805,97805,97807,0,2,2
27984,3,1,97808,97808,97809,0,1,1
27985,3,1,97811,97811,97812,0,1,2
27986,6,3,97817,97817,97820,0,3,5
27987,5,2,97822,97822,97824,0,2,2
27988,5,1,97827,97827,97828,0,1,3
27989,5,3,97832,97832,97835,0,3,4
27990,4,1,97836,97836,97837,0,1,1
27991,3,3,97839,97839,97842,0,3,2
27992,6,2,97845,97845,97847,0,2,3
27993,1,3,97846,97847,97850,1,4,0
27994,3,3,97849,97850,97853,1,4,0
27995,1,1,97850,97853,97854,3,4,0
27996,4,3,97854,97854,97857,0,3,0
27997,4,2,97858,97858,97860,0,2,1
27998,1,3,97859,97860,97863,1,4,0
27999,6,1,97865,97865,97866,0,1,2
28000,1,3,97866,97866,97869,0,3,0
28001,4,2,97870,97870,97872,0,2,1
28002,5,2,97875,97875,97877,0,2,3
28003,6,2,97881,97881,97883,0,2,4
28004,1,1,97882,97883,97884,1,2,0
28005,4,1,97886,97886,97887,0,1,2
28006,5,1,97891,97891,97892,0,1,4
28007,1,1,97892,97892,97893,0,1,0
28008,1,2,97893,97893,97895,0,2,0
28009,4,3,97897,97897,97900,0,3,2
28010,5,1,97902,97902,97903,0,1,2
28011,1,1,97903,97903,97904,0,1,0
28012,5,2,97908,97908,97910,0,2,4
28013,5,2,97913,97913,97915,0,2,3
28014,1,2,97914,97915,97917,1,3,0
28015,1,1,97915,97917,97918,2,3,0
28016,4,3,97919,97919,97922,0,3,1
28017,4,1,97923,97923,97924,0,1,1
28018,3,3,97926,97926,97929,0,3,2
28019,4,1,97930,97930,97931,0,1,1
28020,5,3,97935,97935,97938,0,3,4
28021,2,2,97937,97938,97940,1,3,0
28022,3,3,97940,97940,97943,0,3,0
28023,4,1,97944,97944,97945,0,1,1
28024,4,3,97948,97948,97951,0,3,3
28025,3,2,97951,97951,97953,0,2,0
28026,2,3,97953,97953,97956,0,3,0
28027,3,2,97956,97956,97958,0,2,0
28028,2,1,97958,97958,97959,0,1,0
28029,5,1,97963,97963,97964,0,1,4
28030,1,1,97964,97964,97965,0,1,0
28031,1,1,97965,97965,97966,0,1,0
28032,3,2,97968,97968,97970,0,2,2
28033,5,2,97973,97973,97975,0,2,3
28034,5,2,97978,97978,97980,0,2,3
28035,2,1,97980,97980,97981,0,1,0
28036,2,2,97982,97982,97984,0,2,1
28037,4,3,97986,97986,97989,0,3,2
28038,4,2,97990,97990,97992,0,2,1
28039,5,2,97995,97995,97997,0,2,3
28040,3,2,97998,97998,98000,0,2,1
28041,5,3,98003,98003,98006,0,3,3
28042,4,1,98007,98007,98008,0,1,1
28043,4,3,98011,98011,98014,0,3,3
28044,2,2,98013,98014,98016,1,3,0
28045,4,2,98017,98017,98019,0,2,1
28046,4,2,98021,98021,98023,0,2,2
28047,4,1,98025,98025,98026,0,1,2
28048,4,3,98029,98029,98032,0,3,3
28049,4,2,98033,98033,98035,0,2,1
28050,6,1,98039,98039,98040,0,1,4
28051,6,1,98045,98045,98046,0,1,5
28052,4,1,98049,98049,98050,0,1,3
28053,1,2,98050,98050,98052,0,2,0
28054,2,2,98052,98052,98054,0,2,0
28055,1,2,98053,98054,98056,1,3,0
28056,2,1,98055,98056,98057,1,2,0
28057,1,1,98056,98057,98058,1,2,0
28058,3,3,98059,98059,98062,0,3,1
28059,5,1,98064,98064,98065,0,1,2
28060,6,2,98070,98070,98072,0,2,5
28061,2,3,98072,98072,98075,0,3,0
28062,6,1,98078,98078,98079,0,1,3
28063,6,1,98084,98084,98085,0,1,5
28064,2,1,98086,98086,98087,0,1,1
28065,5,3,98091,98091,98094,0,3,4
28066,6,3,98097,98097,98100,0,3,3
28067,1,1,98098,98100,98101,2,3,0
28068,3,2,98101,98101,98103,0,2,0
28069,6,2,98107,98107,98109,0,2,4
28070,1,2,98108,98109,98111,1,3,0
28071,4,1,98112,98112,98113,0,1,1
28072,3,1,98115,98115,98116,0,1,2
28073,2,3,98117,98117,98120,0,3,1
28074,5,1,98122,98122,98123,0,1,2
28075,5,2,98127,98127,98129,0,2,4
28076,5,3,98132,98132,98135,0,3,3
28077,1,2,98133,98135,98137,2,4,0
28078,6,2,98139,98139,98141,0,2,2
28079,3,2,98142,98142,98144,0,2,1
28080,2,2,98144,98144,98146,0,2,0
28081,3,2,98147,98147,98149,0,2,1
28082,1,2,98148,98149,98151,1,3,0
28083,5,1,98153,98153,98154,0,1,2
28084,3,2,98156,98156,98158,0,2,2
28085,5,2,98161,98161,98163,0,2,3
28086,2,2,98163,98163,98165,0,2,0
28087,6,2,98169,98169,98171,0,2,4
28088,2,1,98171,98171,98172,0,1,0
28089,4,1,98175,98175,98176,0,1,3
28090,2,3,98177,98177,98180,0,3,1
28091,3,3,98180,98180,98183,0,3,0
28092,4,2,98184,98184,98186,0,2,1
28093,5,2,98189,98189,98191,0,2,3
28094,1,3,98190,98191,98194,1,4,0
28095,5,1,98195,98195,98196,0,1,1
28096,5,2,98200,98200,98202,0,2,4
28097,2,2,98202,98202,98204,0,2,0
28098,3,2,98205,98205,98207,0,2,1
28099,6,1,98211,98211,98212,0,1,4
28100,6,1,98217,98217,98218,0,1,5
28101,1,2,98218,98218,98220,0,2,0
28102,4,3,98222,98222,98225,0,3,2
28103,6,2,98228,98228,98230,0,2,3
28104,5,2,98233,98233,98235,0,2,3
28105,6,3,98239,98239,98242,0,3,4
28106,6,2,98245,98245,98247,0,2,3
28107,1,3,98246,98247,98250,1,4,0
28108,6,1,98252,98252,98253,0,1,2
28109,6,3,98258,98258,98261,0,3,5
28110,2,1,98260,98261,98262,1,2,0
28111,5,3,98265,98265,98268,0,3,3
28112,2,1,98267,98268,98269,1,2,0
28113,5,2,98272,98272,98274,0,2,3
28114,6,1,98278,98278,98279,0,1,4
28115,3,3,98281,98281,98284,0,3,2
28116,3,1,98284,98284,98285,0,1,0
28117,6,2,98290,98290,98292,0,2,5
28118,1,3,98291,98292,98295,1,4,0
28119,1,3,98292,98295,98298,3,6,0
28120,2,3,98294,98298,98301,4,7,0
28121,4,1,98298,98301,98302,3,4,0
28122,5,2,98303,98303,98305,0,2,1
28123,1,3,98304,98305,98308,1,4,0
28124,4,2,98308,98308,98310,0,2,0
28125,4,1,98312,98312,98313,0,1,2
28126,5,1,98317,98317,98318,0,1,4
28127,2,1,98319,98319,98320,0,1,1
28128,1,2,98320,98320,98322,0,2,0
28129,2,2,98322,98322,98324,0,2,0
28130,3,1,98325,98325,98326,0,1,1
28131,6,2,98331,98331,98333,0,2,5
28132,3,1,98334,98334,98335,0,1,1
28133,2,2,98336,98336,98338,0,2,1
28134,6,3,98342,98342,98345,0,3,4
28135,3,1,98345,98345,98346,0,1,0
28136,5,1,98350,98350,98351,0,1,4
28137,1,1,98351,98351,98352,0,1,0
28138,2,2,98353,98353,98355,0,2,1
28139,6,2,98359,98359,98361,0,2,4
28140,1,2,98360,98361,98363,1,3,0
28141,3,2,98363,98363,98365,0,2,0
28142,1,1,98364,98365,98366,1,2,0
28143,3,2,98367,98367,98369,0,2,1
28144,2,2,98369,98369,98371,0,2,0
28145,3,1,98372,98372,98373,0,1,1
28146,4,1,98376,98376,98377,0,1,3
28147,2,3,98378,98378,98381,0,3,1
28148,6,2,98384,98384,98386,0,2,3
28149,3,1,98387,98387,98388,0,1,1
28150,5,3,98392,98392,98395,0,3,4
28151,5,1,98397,98397,98398,0,1,2
28152,2,1,98399,98399,98400,0,1,1
28153,6,2,98405,98405,98407,0,2,5
28154,4,1,98409,98409,98410,0,1,2
28155,6,1,98415,98415,98416,0,1,5
28156,4,1,98419,98419,98420,0,1,3
28157,4,1,98423,98423,98424,0,1,3
28158,5,3,98428,98428,98431,0,3,4
28159,4,1,98432,98432,98433,0,1,1
28160,2,2,98434,98434,98436,0,2,1
28161,6,2,98440,98440,98442,0,2,4
28162,4,1,98444,98444,98445,0,1,2
28163,4,1,98448,98448,98449,0,1,3
28164,4,1,98452,98452,98453,0,1,3
28165,6,3,98458,98458,98461,0,3,5
28166,6,1,98464,98464,98465,0,1,3
28167,3,1,98467,98467,98468,0,1,2
28168,1,3,98468,98468,98471,0,3,0
28169,3,1,98471,98471,98472,0,1,0
28170,3,1,98474,98474,98475,0,1,2
28171,1,1,98475,98475,98476,0,1,0
28172,6,3,98481,98481,98484,0,3,5
28173,3,1,98484,98484,98485,0,1,0
28174,6,3,98490,98490,98493,0,3,5
28175,3,3,98493,98493,98496,0,3,0
28176,3,1,98496,98496,98497,0,1,0
28177,6,1,98502,98502,98503,0,1,5
28178,4,3,98506,98506,98509,0,3,3
28179,1,2,98507,98509,98511,2,4,0
28180,5,2,98512,98512,98514,0,2,1
28181,3,3,98515,98515,98518,0,3,1
28182,1,2,98516,98518,98520,2,4,0
28183,5,3,98521,98521,98524,0,3,1
28184,2,1,98523,98524,98525,1,2,0
28185,4,2,98527,98527,98529,0,2,2
28186,2,1,98529,98529,98530,0,1,0
28187,2,3,98531,98531,98534,0,3,1
28188,1,2,98532,98534,98536,2,4,0
28189,6,2,98538,98538,98540,0,2,2
28190,6,1,98544,98544,98545,0,1,4
28191,6,3,98550,98550,98553,0,3,5
28192,6,3,98556,98556,98559,0,3,3
28193,4,3,98560,98560,98563,0,3,1
28194,2,2,98562,98563,98565,1,3,0
28195,1,2,98563,98565,98567,2,4,0
28196,6,2,98569,98569,98571,0,2,2
28197,2,3,98571,98571,98574,0,3,0
28198,1,2,98572,98574,98576,2,4,0
28199,5,1,98577,98577,98578,0,1,1
28200,1,1,98578,98578,98579,0,1,0
28201,4,2,98582,98582,98584,0,2,3
28202,5,2,98587,98587,98589,0,2,3
28203,2,1,98589,98589,98590,0,1,0
28204,5,3,98594,98594,98597,0,3,4
28205,1,1,98595,98597,98598,2,3,0
28206,2,3,98597,98598,98601,1,4,0
28207,6,3,98603,98603,98606,0,3,2
28208,2,2,98605,98606,98608,1,3,0
28209,1,1,98606,98608,98609,2,3,0
28210,1,1,98607,98609,98610,2,3,0
28211,5,1,98612,98612,98613,0,1,2
28212,1,1,98613,98613,98614,0,1,0
28213,6,1,98619,98619,98620,0,1,5
28214,3,2,98622,98622,98624,0,2,2
28215,4,3,98626,98626,98629,0,3,2
28216,5,1,98631,98631,98632,0,1,2
28217,2,2,98633,98633,98635,0,2,1
28218,3,3,98636,98636,98639,0,3,1
28219,1,1,98637,98639,98640,2,3,0
28220,1,3,98638,98640,98643,2,5,0
28221,4,3,98642,98643,98646,1,4,0
28222,2,3,98644,98646,98649,2,5,0
28223,5,3,98649,98649,98652,0,3,0
28224,5,2,98654,98654,98656,0,2,2
28225,4,3,98658,98658,98661,0,3,2
28226,2,3,98660,98661,98664,1,4,0
28227,6,1,98666,98666,98667,0,1,2
28228,2,2,98668,98668,98670,0,2,1
28229,5,2,98673,98673,98675,0,2,3
28230,6,3,98679,98679,98682,0,3,4
28231,1,2,98680,98682,98684,2,4,0
28232,6,2,98686,98686,98688,0,2,2
28233,4,1,98690,98690,98691,0,1,2
28234,5,2,98695,98695,98697,0,2,4
28235,5,3,98700,98700,98703,0,3,3
28236,2,1,98702,98703,98704,1,2,0
28237,1,2,98703,98704,98706,1,3,0
28238,4,1,98707,98707,98708,0,1,1
28239,4,1,98711,98711,98712,0,1,3
28240,2,2,98713,98713,98715,0,2,1
28241,4,3,98717,98717,98720,0,3,2
28242,1,2,98718,98720,98722,2,4,0
28243,3,3,98721,98722,98725,1,4,0
28244,6,1,98727,98727,98728,0,1,2
28245,5,2,98732,98732,98734,0,2,4
28246,4,3,98736,98736,98739,0,3,2
28247,2,1,98738,98739,98740,1,2,0
28248,4,2,98742,98742,98744,0,2,2
28249,6,2,98748,98748,98750,0,2,4
28250,1,3,98749,98750,98753,1,4,0
28251,4,3,98753,98753,98756,0,3,0
28252,1,2,98754,98756,98758,2,4,0
28253,6,3,98760,98760,98763,0,3,2
28254,3,2,98763,98763,98765,0,2,0
28255,1,1,98764,98765,98766,1,2,0
28256,3,3,98767,98767,98770,0,3,1
28257,5,3,98772,98772,98775,0,3,2
28258,3,1,98775,98775,98776,0,1,0
28259,6,2,98781,98781,98783,0,2,5
28260,3,2,98784,98784,98786,0,2,1
28261,3,2,98787,98787,98789,0,2,1
28262,6,1,98793,98793,98794,0,1,4
28263,5,3,98798,98798,98801,0,3,4
28264,4,2,98802,98802,98804,0,2,1
28265,4,3,98806,98806,98809,0,3,2
28266,6,1,98812,98812,98813,0,1,3
28267,3,3,98815,98815,98818,0,3,2
28268,6,2,98821,98821,98823,0,2,3
28269,1,2,98822,98823,98825,1,3,0
28270,3,1,98825,98825,98826,0,1,0
28271,1,2,98826,98826,98828,0,2,0
28272,3,2,98829,98829,98831,0,2,1
28273,5,3,98834,98834,98837,0,3,3
28274,4,3,98838,98838,98841,0,3,1
28275,6,3,98844,98844,98847,0,3,3
28276,5,2,98849,98849,98851,0,2,2
28277,2,3,98851,98851,98854,0,3,0
28278,3,1,98854,98854,98855,0,1,0
28279,1,3,98855,98855,98858,0,3,0
28280,4,3,98859,98859,98862,0,3,1
28281,2,1,98861,98862,98863,1,2,0
28282,6,2,98867,98867,98869,0,2,4
28283,3,3,98870,98870,98873,0,3,1
28284,1,1,98871,98873,98874,2,3,0
28285,1,1,98872,98874,98875,2,3,0
28286,2,1,98874,98875,98876,1,2,0
28287,4,3,98878,98878,98881,0,3,2
28288,6,3,98884,98884,98887,0,3,3
28289,1,2,98885,98887,98889,2,4,0
28290,3,3,98888,98889,98892,1,4,0
28291,1,2,98889,98892,98894,3,5,0
28292,2,1,98891,98894,98895,3,4,0
28293,4,2,98895,98895,98897,0,2,0
28294,4,2,98899,98899,98901,0,2,2
28295,5,3,98904,98904,98907,0,3,3
28296,3,1,98907,98907,98908,0,1,0
28297,1,1,98908,98908,98909,0,1,0
28298,3,1,98911,98911,98912,0,1,2
28299,5,1,98916,98916,98917,0,1,4
28300,4,2,98920,98920,98922,0,2,3
28301,4,1,98924,98924,98925,0,1,2
28302,2,1,98926,98926,98927,0,1,1
28303,4,3,98930,98930,98933,0,3,3
28304,3,3,98933,98933,98936,0,3,0
28305,2,2,98935,98936,98938,1,3,0
28306,5,3,98940,98940,98943,0,3,2
28307,4,3,98944,98944,98947,0,3,1
28308,5,3,98949,98949,98952,0,3,2
28309,6,2,98955,98955,98957,0,2,3
28310,5,1,98960,98960,98961,0,1,3
28311,4,3,98964,98964,98967,0,3,3
28312,5,2,98969,98969,98971,0,2,2
28313,4,3,98973,98973,98976,0,3,2
28314,1,1,98974,98976,98977,2,3,0
28315,6,3,98980,98980,98983,0,3,3
28316,6,3,98986,98986,98989,0,3,3
28317,2,2,98988,98989,98991,1,3,0
28318,2,3,98990,98991,98994,1,4,0
28319,3,1,98993,98994,98995,1,2,0
28320,5,1,98998,98998,98999,0,1,3
28321,2,1,99000,99000,99001,0,1,1
28322,6,1,99006,99006,99007,0,1,5
28323,1,3,99007,99007,99010,0,3,0
28324,5,2,99012,99012,99014,0,2,2
28325,4,1,99016,99016,99017,0,1,2
28326,4,3,99020,99020,99023,0,3,3
28327,4,2,99024,99024,99026,0,2,1
28328,2,1,99026,99026,99027,0,1,0
28329,5,2,99031,99031,99033,0,2,4
28330,5,1,99036,99036,99037,0,1,3
28331,5,3,99041,99041,99044,0,3,4
28332,2,2,99043,99044,99046,1,3,0
28333,1,1,99044,99046,99047,2,3,0
28334,1,1,99045,99047,99048,2,3,0
28335,3,2,99048,99048,99050,0,2,0
28336,2,2,99050,99050,99052,0,2,0
28337,1,2,99051,99052,99054,1,3,0
28338,5,1,99056,99056,99057,0,1,2
28339,5,3,99061,99061,99064,0,3,4
28340,3,1,99064,99064,99065,0,1,0
28341,5,2,99069,99069,99071,0,2,4
28342,4,3,99073,99073,99076,0,3,2
28343,4,1,99077,99077,99078,0,1,1
28344,4,3,99081,99081,99084,0,3,3
28345,4,1,99085,99085,99086,0,1,1
28346,6,2,99091,99091,99093,0,2,5
28347,6,1,99097,99097,99098,0,1,4
28348,5,2,99102,99102,99104,0,2,4
28349,2,2,99104,99104,99106,0,2,0
28350,5,3,99109,99109,99112,0,3,3
28351,5,2,99114,99114,99116,0,2,2
28352,5,1,99119,99119,99120,0,1,3
28353,2,3,99121,99121,99124,0,3,1
28354,1,2,99122,99124,99126,2,4,0
28355,4,1,99126,99126,99127,0,1,0
28356,2,2,99128,99128,99130,0,2,1
28357,6,1,99134,99134,99135,0,1,4
28358,2,1,99136,99136,99137,0,1,1
28359,2,3,99138,99138,99141,0,3,1
28360,2,1,99140,99141,99142,1,2,0
28361,4,3,99144,99144,99147,0,3,2
28362,5,3,99149,99149,99152,0,3,2
28363,5,2,99154,99154,99156,0,2,2
28364,5,3,99159,99159,99162,0,3,3
28365,4,2,99163,99163,99165,0,2,1
28366,4,1,99167,99167,99168,0,1,2
28367,1,1,99168,99168,99169,0,1,0
28368,3,2,99171,99171,99173,0,2,2
28369,5,1,99176,99176,99177,0,1,3
28370,3,2,99179,99179,99181,0,2,2
28371,5,1,99184,99184,99185,0,1,3
28372,5,2,99189,99189,99191,0,2,4
28373,1,3,99190,99191,99194,1,4,0
28374,5,3,99195,99195,99198,0,3,1
28375,3,3,99198,99198,99201,0,3,0
28376,4,3,99202,99202,99205,0,3,1
28377,1,3,99203,99205,99208,2,5,0
28378,2,2,99205,99208,99210,3,5,0
28379,2,2,99207,99210,99212,3,5,0
28380,4,2,99211,99212,99214,1,3,0
28381,4,3,99215,99215,99218,0,3,1
28382,5,3,99220,99220,99223,0,3,2
28383,4,1,99224,99224,99225,0,1,1
28384,2,2,99226,99226,99228,0,2,1
28385,3,3,99229,99229,99232,0,3,1
28386,3,1,99232,99232,99233,0,1,0
28387,2,1,99234,99234,99235,0,1,1
28388,6,2,99240,99240,99242,0,2,5
28389,3,3,99243,99243,99246,0,3,1
28390,4,2,99247,99247,99249,0,2,1
28391,6,3,99253,99253,99256,0,3,4
28392,4,1,99257,99257,99258,0,1,1
28393,4,1,99261,99261,99262,0,1,3
28394,3,3,99264,99264,99267,0,3,2
28395,5,1,99269,99269,99270,0,1,2
28396,1,2,99270,99270,99272,0,2,0
28397,2,1,99272,99272,99273,0,1,0
28398,1,2,99273,99273,99275,0,2,0
28399,1,1,99274,99275,99276,1,2,0
28400,1,2,99275,99276,99278,1,3,0
28401,4,2,99279,99279,99281,0,2,1
28402,1,1,99280,99281,99282,1,2,0
28403,3,2,99283,99283,99285,0,2,1
28404,4,3,99287,99287,99290,0,3,2
28405,2,3,99289,99290,99293,1,4,0
28406,1,2,99290,99293,99295,3,5,0
28407,6,3,99296,99296,99299,0,3,1
28408,5,3,99301,99301,99304,0,3,2
28409,5,3,99306,99306,99309,0,3,2
28410,2,2,99308,99309,99311,1,3,0
28411,2,3,99310,99311,99314,1,4,0
28412,6,1,99316,99316,99317,0,1,2
28413,4,1,99320,99320,99321,0,1,3
28414,6,1,99326,99326,99327,0,1,5
28415,1,1,99327,99327,99328,0,1,0
28416,4,3,99331,99331,99334,0,3,3
28417,2,1,99333,99334,99335,1,2,0
28418,6,2,99339,99339,99341,0,2,4
28419,4,3,99343,99343,99346,0,3,2
28420,3,3,99346,99346,99349,0,3,0
28421,2,2,99348,99349,99351,1,3,0
28422,2,1,99350,99351,99352,1,2,0
28423,3,3,99353,99353,99356,0,3,1
28424,1,2,99354,99356,99358,2,4,0
28425,2,3,99356,99358,99361,2,5,0
28426,6,3,99362,99362,99365,0,3,1
28427,5,3,99367,99367,99370,0,3,2
28428,3,2,99370,99370,99372,0,2,0
28429,2,2,99372,99372,99374,0,2,0
28430,6,3,99378,99378,99381,0,3,4
28431,5,3,99383,99383,99386,0,3,2
28432,1,3,99384,99386,99389,2,5,0
28433,1,2,99385,99389,99391,4,6,0
28434,1,3,99386,99391,99394,5,8,0
28435,4,2,99390,99394,99396,4,6,0
28436,6,2,99396,99396,99398,0,2,0
28437,4,1,99400,99400,99401,0,1,2
28438,6,1,99406,99406,99407,0,1,5
28439,4,3,99410,99410,99413,0,3,3
28440,4,1,99414,99414,99415,0,1,1
28441,2,3,99416,99416,99419,0,3,1
28442,6,1,99422,99422,99423,0,1,3
28443,4,3,99426,99426,99429,0,3,3
28444,3,2,99429,99429,99431,0,2,0
28445,1,2,99430,99431,99433,1,3,0
28446,1,3,99431,99433,99436,2,5,0
28447,1,1,99432,99436,99437,4,5,0
28448,2,3,99434,99437,99440,3,6,0
28449,3,2,99437,99440,99442,3,5,0
28450,5,3,99442,99442,99445,0,3,0
28451,3,1,99445,99445,99446,0,1,0
28452,4,2,99449,99449,99451,0,2,3
28453,4,2,99453,99453,99455,0,2,2
28454,1,1,99454,99455,99456,1,2,0
28455,5,1,99459,99459,99460,0,1,3
28456,5,3,99464,99464,99467,0,3,4
28457,3,2,99467,99467,99469,0,2,0
28458,1,3,99468,99469,99472,1,4,0
28459,2,2,99470,99472,99474,2,4,0
28460,1,3,99471,99474,99477,3,6,0
28461,5,2,99476,99477,99479,1,3,0
28462,4,3,99480,99480,99483,0,3,1
28463,2,1,99482,99483,99484,1,2,0
28464,4,3,99486,99486,99489,0,3,2
28465,2,1,99488,99489,99490,1,2,0
28466,4,1,99492,99492,99493,0,1,2
28467,5,1,99497,99497,99498,0,1,4
28468,3,2,99500,99500,99502,0,2,2
28469,2,1,99502,99502,99503,0,1,0
28470,5,3,99507,99507,99510,0,3,4
28471,6,1,99513,99513,99514,0,1,3
28472,3,3,99516,99516,99519,0,3,2
28473,6,2,99522,99522,99524,0,2,3
28474,2,1,99524,99524,99525,0,1,0
28475,3,2,99527,99527,99529,0,2,2
28476,3,1,99530,99530,99531,0,1,1
28477,3,1,99533,99533,99534,0,1,2
28478,2,2,99535,99535,99537,0,2,1
28479,4,2,99539,99539,99541,0,2,2
28480,3,2,99542,99542,99544,0,2,1
28481,1,1,99543,99544,99545,1,2,0
28482,6,3,99549,99549,99552,0,3,4
28483,6,1,99555,99555,99556,0,1,3
28484,2,1,99557,99557,99558,0,1,1
28485,3,3,99560,99560,99563,0,3,2
28486,1,1,99561,99563,99564,2,3,0
28487,5,3,99566,99566,99569,0,3,2
28488,6,3,99572,99572,99575,0,3,3
28489,3,1,99575,99575,99576,0,1,0
28490,5,2,99580,99580,99582,0,2,4
28491,5,3,99585,99585,99588,0,3,3
28492,1,3,99586,99588,99591,2,5,0
28493,6,3,99592,99592,99595,0,3,1
28494,5,2,99597,99597,99599,0,2,2
28495,6,1,99603,99603,99604,0,1,4
28496,5,2,99608,99608,99610,0,2,4
28497,4,2,99612,99612,99614,0,2,2
28498,6,3,99618,99618,99621,0,3,4
28499,5,3,99623,99623,99626,0,3,2
28500,1,2,99624,99626,99628,2,4,0
28501,1,3,99625,99628,99631,3,6,0
28502,6,1,99631,99631,99632,0,1,0
28503,5,1,99636,99636,99637,0,1,4
28504,3,3,99639,99639,99642,0,3,2
28505,6,3,99645,99645,99648,0,3,3
28506,1,2,99646,99648,99650,2,4,0
28507,3,3,99649,99650,99653,1,4,0
28508,1,3,99650,99653,99656,3,6,0
28509,5,2,99655,99656,99658,1,3,0
28510,1,1,99656,99658,99659,2,3,0
28511,3,3,99659,99659,99662,0,3,0
28512,1,2,99660,99662,99664,2,4,0
28513,4,2,99664,99664,99666,0,2,0
28514,6,1,99670,99670,99671,0,1,4
28515,2,3,99672,99672,99675,0,3,1
28516,1,2,99673,99675,99677,2,4,0
28517,4,2,99677,99677,99679,0,2,0
28518,1,3,99678,99679,99682,1,4,0
28519,6,2,99684,99684,99686,0,2,2
28520,5,3,99689,99689,99692,0,3,3
28521,3,2,99692,99692,99694,0,2,0
28522,2,2,99694,99694,99696,0,2,0
28523,6,2,99700,99700,99702,0,2,4
28524,4,3,99704,99704,99707,0,3,2
28525,3,3,99707,99707,99710,0,3,0
28526,3,3,99710,99710,99713,0,3,0
28527,1,1,99711,99713,99714,2,3,0
28528,2,3,99713,99714,99717,1,4,0
28529,3,2,99716,99717,99719,1,3,0
28530,1,2,99717,99719,99721,2,4,0
28531,6,1,99723,99723,99724,0,1,2
28532,2,3,99725,99725,99728,0,3,1
28533,4,3,99729,99729,99732,0,3,1
28534,3,2,99732,99732,99734,0,2,0
28535,4,1,99736,99736,99737,0,1,2
28536,1,1,99737,99737,99738,0,1,0
28537,3,3,99740,99740,99743,0,3,2
28538,4,1,99744,99744,99745,0,1,1
28539,6,3,99750,99750,99753,0,3,5
28540,5,1,99755,99755,99756,0,1,2
28541,4,3,99759,99759,99762,0,3,3
28542,6,3,99765,99765,99768,0,3,3
28543,2,1,99767,99768,99769,1,2,0
28544,4,1,99771,99771,99772,0,1,2
28545,1,2,99772,99772,99774,0,2,0
28546,1,2,99773,99774,99776,1,3,0
28547,1,3,99774,99776,99779,2,5,0
28548,4,2,99778,99779,99781,1,3,0
28549,1,1,99779,99781,99782,2,3,0
28550,6,2,99785,99785,99787,0,2,3
28551,2,1,99787,99787,99788,0,1,0
28552,4,3,99791,99791,99794,0,3,3
28553,4,1,99795,99795,99796,0,1,1
28554,6,2,99801,99801,99803,0,2,5
28555,5,2,99806,99806,99808,0,2,3
28556,3,2,99809,99809,99811,0,2,1
28557,1,1,99810,99811,99812,1,2,0
28558,4,3,99814,99814,99817,0,3,2
28559,6,1,99820,99820,99821,0,1,3
28560,1,3,99821,99821,99824,0,3,0
28561,5,2,99826,99826,99828,0,2,2
28562,2,1,99828,99828,99829,0,1,0
28563,3,1,99831,99831,99832,0,1,2
28564,5,2,99836,99836,99838,0,2,4
28565,6,3,99842,99842,99845,0,3,4
28566,1,1,99843,99845,99846,2,3,0
28567,5,3,99848,99848,99851,0,3,2
28568,2,2,99850,99851,99853,1,3,0
28569,2,2,99852,99853,99855,1,3,0
28570,3,3,99855,99855,99858,0,3,0
28571,4,2,99859,99859,99861,0,2,1
28572,4,3,99863,99863,99866,0,3,2
28573,2,3,99865,99866,99869,1,4,0
28574,1,1,99866,99869,99870,3,4,0
28575,2,2,99868,99870,99872,2,4,0
28576,2,1,99870,99872,99873,2,3,0
28577,6,1,99876,99876,99877,0,1,3
28578,6,1,99882,99882,99883,0,1,5
28579,3,2,99885,99885,99887,0,2,2
28580,4,3,99889,99889,99892,0,3,2
28581,3,1,99892,99892,99893,0,1,0
28582,6,3,99898,99898,99901,0,3,5
28583,2,1,99900,99901,99902,1,2,0
28584,5,2,99905,99905,99907,0,2,3
28585,1,2,99906,99907,99909,1,3,0
28586,2,3,99908,99909,99912,1,4,0
28587,4,1,99912,99912,99913,0,1,0
28588,4,1,99916,99916,99917,0,1,3
28589,1,1,99917,99917,99918,0,1,0
28590,3,2,99920,99920,99922,0,2,2
28591,3,3,99923,99923,99926,0,3,1
28592,3,2,99926,99926,99928,0,2,0
28593,4,2,99930,99930,99932,0,2,2
28594,1,1,99931,99932,99933,1,2,0
28595,4,2,99935,99935,99937,0,2,2
28596,6,2,99941,99941,99943,0,2,4
28597,1,2,99942,99943,99945,1,3,0
28598,4,2,99946,99946,99948,0,2,1
28599,2,1,99948,99948,99949,0,1,0
28600,5,1,99953,99953,99954,0,1,4
28601,3,3,99956,99956,99959,0,3,2
28602,6,3,99962,99962,99965,0,3,3
28603,5,2,99967,99967,99969,0,2,2
28604,2,3,99969,99969,99972,0,3,0
28605,5,2,99974,99974,99976,0,2,2
28606,4,3,99978,99978,99981,0,3,2
28607,1,2,99979,99981,99983,2,4,0
28608,4,3,99983,99983,99986,0,3,0
28609,4,1,99987,99987,99988,0,1,1
28610,5,1,99992,99992,99993,0,1,4
28611,1,3,99993,99993,99996,0,3,0
28612,5,2,99998,99998,100000,0,2,2
28613,3,1,100001,100001,100002,0,1,1
28614,4,3,100005,100005,100008,0,3,3
28615,3,2,100008,100008,100010,0,2,0
28616,3,1,100011,100011,100012,0,1,1
28617,3,1,100014,100014,100015,0,1,2
28618,2,1,100016,100016,100017,0,1,1
28619,3,3,100019,100019,100022,0,3,2
28620,2,3,100021,100022,100025,1,4,0
28621,2,1,100023,100025,100026,2,3,0
28622,6,1,100029,100029,100030,0,1,3
28623,4,2,100033,100033,100035,0,2,3
28624,3,3,100036,100036,100039,0,3,1
28625,6,2,100042,100042,100044,0,2,3
28626,5,1,100047,100047,100048,0,1,3
28627,3,3,100050,100050,100053,0,3,2
28628,2,3,100052,100053,100056,1,4,0
28629,5,2,100057,100057,100059,0,2,1
28630,5,2,100062,100062,100064,0,2,3
28631,6,3,100068,100068,100071,0,3,4
28632,3,2,100071,100071,100073,0,2,0
28633,5,3,100076,100076,100079,0,3,3
28634,5,3,100081,100081,100084,0,3,2
28635,4,3,100085,100085,100088,0,3,1
28636,4,3,100089,100089,100092,0,3,1
28637,6,1,100095,100095,100096,0,1,3
28638,4,3,100099,100099,100102,0,3,3
28639,4,2,100103,100103,100105,0,2,1
28640,5,2,100108,100108,100110,0,2,3
28641,4,3,100112,100112,100115,0,3,2
28642,5,3,100117,100117,100120,0,3,2
28643,4,2,100121,100121,100123,0,2,1
28644,5,3,100126,100126,100129,0,3,3
28645,2,1,100128,100129,100130,1,2,0
28646,4,3,100132,100132,100135,0,3,2
28647,5,1,100137,100137,100138,0,1,2
28648,6,3,100143,100143,100146,0,3,5
28649,5,2,100148,100148,100150,0,2,2
28650,1,1,100149,100150,100151,1,2,0
28651,1,3,100150,100151,100154,1,4,0
28652,2,3,100152,100154,100157,2,5,0
28653,6,2,100158,100158,100160,0,2,1
28654,4,3,100162,100162,100165,0,3,2
28655,1,1,100163,100165,100166,2,3,0
28656,3,3,100166,100166,100169,0,3,0
28657,4,1,100170,100170,100171,0,1,1
28658,6,3,100176,100176,100179,0,3,5
28659,5,1,100181,100181,100182,0,1,2
28660,1,3,100182,100182,100185,0,3,0
28661,6,1,100188,100188,100189,0,1,3
28662,4,1,100192,100192,100193,0,1,3
28663,4,1,100196,100196,100197,0,1,3
28664,3,2,100199,100199,100201,0,2,2
28665,3,3,100202,100202,100205,0,3,1
28666,6,2,100208,100208,100210,0,2,3
28667,4,3,100212,100212,100215,0,3,2
28668,6,3,100218,100218,100221,0,3,3
28669,3,2,100221,100221,100223,0,2,0
28670,1,2,100222,100223,100225,1,3,0
28671,3,3,100225,100225,100228,0,3,0
28672,6,3,100231,100231,100234,0,3,3
28673,1,1,100232,100234,100235,2,3,0
28674,4,2,100236,100236,100238,0,2,1
28675,2,2,100238,100238,100240,0,2,0
28676,6,1,100244,100244,100245,0,1,4
28677,2,1,100246,100246,100247,0,1,1
28678,1,3,100247,100247,100250,0,3,0
28679,4,2,100251,100251,100253,0,2,1
28680,3,2,100254,100254,100256,0,2,1
28681,5,3,100259,100259,100262,0,3,3
28682,4,3,100263,100263,100266,0,3,1
28683,5,2,100268,100268,100270,0,2,2
28684,1,3,100269,100270,100273,1,4,0
28685,1,2,100270,100273,100275,3,5,0
28686,6,3,100276,100276,100279,0,3,1
28687,4,1,100280,100280,100281,0,1,1
28688,3,2,100283,100283,100285,0,2,2
28689,6,1,100289,100289,100290,0,1,4
28690,2,1,100291,100291,100292,0,1,1
28691,2,3,100293,100293,100296,0,3,1
28692,6,1,100299,100299,100300,0,1,3
28693,4,1,100303,100303,100304,0,1,3
28694,1,2,100304,100304,100306,0,2,0
28695,2,1,100306,100306,100307,0,1,0
28696,6,3,100312,100312,100315,0,3,5
28697,5,3,100317,100317,100320,0,3,2
28698,3,3,100320,100320,100323,0,3,0
28699,4,1,100324,100324,100325,0,1,1
28700,1,2,100325,100325,100327,0,2,0
28701,1,3,100326,100327,100330,1,4,0
28702,1,3,100327,100330,100333,3,6,0
28703,5,3,100332,100333,100336,1,4,0
28704,5,1,100337,100337,100338,0,1,1
28705,2,2,100339,100339,100341,0,2,1
28706,1,3,100340,100341,100344,1,4,0
28707,6,3,100346,100346,100349,0,3,2
28708,3,2,100349,100349,100351,0,2,0
28709,2,2,100351,100351,100353,0,2,0
28710,4,2,100355,100355,100357,0,2,2
28711,6,1,100361,100361,100362,0,1,4
28712,2,2,100363,100363,100365,0,2,1
28713,1,1,100364,100365,100366,1,2,0
28714,6,3,100370,100370,100373,0,3,4
28715,4,1,100374,100374,100375,0,1,1
28716,1,1,100375,100375,100376,0,1,0
28717,1,3,100376,100376,100379,0,3,0
28718,1,2,100377,100379,100381,2,4,0
28719,5,2,100382,100382,100384,0,2,1
28720,5,1,100387,100387,100388,0,1,3
28721,5,1,100392,100392,100393,0,1,4
28722,2,1,100394,100394,100395,0,1,1
28723,3,2,100397,100397,100399,0,2,2
28724,5,2,100402,100402,100404,0,2,3
28725,1,1,100403,100404,100405,1,2,0
28726,5,2,100408,100408,100410,0,2,3
28727,6,1,100414,100414,100415,0,1,4
28728,2,1,100416,100416,100417,0,1,1
28729,4,1,100420,100420,100421,0,1,3
28730,1,1,100421,100421,100422,0,1,0
28731,5,3,100426,100426,100429,0,3,4
28732,2,2,100428,100429,100431,1,3,0
28733,4,3,100432,100432,100435,0,3,1
28734,1,2,100433,100435,100437,2,4,0
28735,6,3,100439,100439,100442,0,3,2
28736,3,2,100442,100442,100444,0,2,0
28737,3,3,100445,100445,100448,0,3,1
28738,3,3,100448,100448,100451,0,3,0
28739,1,3,100449,100451,100454,2,5,0
28740,3,3,100452,100454,100457,2,5,0
28741,4,3,100456,100457,100460,1,4,0
28742,4,3,100460,100460,100463,0,3,0
28743,5,2,100465,100465,100467,0,2,2
28744,2,1,100467,100467,100468,0,1,0
28745,1,3,100468,100468,100471,0,3,0
28746,2,1,100470,100471,100472,1,2,0
28747,6,2,100476,100476,100478,0,2,4
28748,6,1,100482,100482,100483,0,1,4
28749,5,3,100487,100487,100490,0,3,4
28750,5,3,100492,100492,100495,0,3,2
28751,2,2,100494,100495,100497,1,3,0
28752,2,1,100496,100497,100498,1,2,0
28753,2,3,100498,100498,100501,0,3,0
28754,6,1,100504,100504,100505,0,1,3
28755,1,3,100505,100505,100508,0,3,0
28756,4,1,100509,100509,100510,0,1,1
28757,1,3,100510,100510,100513,0,3,0
28758,6,3,100516,100516,100519,0,3,3
28759,2,2,100518,100519,100521,1,3,0
28760,5,2,100523,100523,100525,0,2,2
28761,6,3,100529,100529,100532,0,3,4
28762,6,3,100535,100535,100538,0,3,3
28763,3,1,100538,100538,100539,0,1,0
28764,1,2,100539,100539,100541,0,2,0
28765,3,1,100542,100542,100543,0,1,1
28766,5,1,100547,100547,100548,0,1,4
28767,1,3,100548,100548,100551,0,3,0
28768,1,2,100549,100551,100553,2,4,0
28769,4,3,100553,100553,100556,0,3,0
28770,3,3,100556,100556,100559,0,3,0
28771,1,1,100557,100559,100560,2,3,0
28772,5,2,100562,100562,100564,0,2,2
28773,3,2,100565,100565,100567,0,2,1
28774,1,2,100566,100567,100569,1,3,0
28775,2,1,100568,100569,100570,1,2,0
28776,5,2,100573,100573,100575,0,2,3
28777,2,1,100575,100575,100576,0,1,0
28778,1,3,100576,100576,100579,0,3,0
28779,5,3,100581,100581,100584,0,3,2
28780,2,1,100583,100584,100585,1,2,0
28781,5,2,100588,100588,100590,0,2,3
28782,3,2,100591,100591,100593,0,2,1
28783,2,2,100593,100593,100595,0,2,0
28784,1,3,100594,100595,100598,1,4,0
28785,1,3,100595,100598,100601,3,6,0
28786,4,3,100599,100601,100604,2,5,0
28787,1,1,100600,100604,100605,4,5,0
28788,1,2,100601,100605,100607,4,6,0
28789,1,1,100602,100607,100608,5,6,0
28790,6,1,100608,100608,100609,0,1,0
28791,4,3,100612,100612,100615,0,3,3
28792,1,3,100613,100615,100618,2,5,0
28793,6,1,100619,100619,100620,0,1,1
28794,1,3,100620,100620,100623,0,3,0
28795,1,3,100621,100623,100626,2,5,0
28796,4,3,100625,100626,100629,1,4,0
28797,5,3,100630,100630,100633,0,3,1
28798,4,1,100634,100634,100635,0,1,1
28799,2,3,100636,100636,100639,0,3,1
28800,1,3,100637,100639,100642,2,5,0
28801,5,2,100642,100642,100644,0,2,0
28802,5,1,100647,100647,100648,0,1,3
28803,2,2,100649,100649,100651,0,2,1
28804,6,1,100655,100655,100656,0,1,4
28805,6,1,100661,100661,100662,0,1,5
28806,1,3,100662,100662,100665,0,3,0
28807,3,2,100665,100665,100667,0,2,0
28808,3,2,100668,100668,100670,0,2,1
28809,6,2,100674,100674,100676,0,2,4
28810,6,3,100680,100680,100683,0,3,4
28811,4,3,100684,100684,100687,0,3,1
28812,6,1,100690,100690,100691,0,1,3
28813,2,3,100692,100692,100695,0,3,1
28814,2,3,100694,100695,100698,1,4,0
28815,4,2,100698,100698,100700,0,2,0
28816,6,2,100704,100704,100706,0,2,4
28817,6,1,100710,100710,100711,0,1,4
28818,2,3,100712,100712,100715,0,3,1
28819,5,3,100717,100717,100720,0,3,2
28820,1,1,100718,100720,100721,2,3,0
28821,6,3,100724,100724,100727,0,3,3
28822,5,2,100729,100729,100731,0,2,2
28823,3,2,100732,100732,100734,0,2,1
28824,5,3,100737,100737,100740,0,3,3
28825,6,1,100743,100743,100744,0,1,3
28826,2,3,100745,100745,100748,0,3,1
28827,4,1,100749,100749,100750,0,1,1
28828,5,2,100754,100754,100756,0,2,4
28829,3,2,100757,100757,100759,0,2,1
28830,3,2,100760,100760,100762,0,2,1
28831,2,3,100762,100762,100765,0,3,0
28832,4,3,100766,100766,100769,0,3,1
28833,6,3,100772,100772,100775,0,3,3
28834,1,1,100773,100775,100776,2,3,0
28835,1,3,100774,100776,100779,2,5,0
28836,4,2,100778,100779,100781,1,3,0
28837,2,1,100780,100781,100782,1,2,0
28838,2,2,100782,100782,100784,0,2,0
28839,6,3,100788,100788,100791,0,3,4
28840,6,2,100794,100794,100796,0,2,3
28841,5,1,100799,100799,100800,0,1,3
28842,4,3,100803,100803,100806,0,3,3
28843,1,1,100804,100806,100807,2,3,0
28844,2,1,100806,100807,100808,1,2,0
28845,6,3,100812,100812,100815,0,3,4
28846,6,3,100818,100818,100821,0,3,3
28847,3,3,100821,100821,100824,0,3,0
28848,2,2,100823,100824,100826,1,3,0
28849,1,3,100824,100826,100829,2,5,0
28850,2,3,100826,100829,100832,3,6,0
28851,3,1,100829,100832,100833,3,4,0
28852,5,1,100834,100834,100835,0,1,1
28853,6,2,100840,100840,100842,0,2,5
28854,1,3,100841,100842,100845,1,4,0
28855,3,1,100844,100845,100846,1,2,0
28856,6,3,100850,100850,100853,0,3,4
28857,3,2,100853,100853,100855,0,2,0
28858,3,1,100856,100856,100857,0,1,1
28859,3,2,100859,100859,100861,0,2,2
28860,4,1,100863,100863,100864,0,1,2
28861,5,1,100868,100868,100869,0,1,4
28862,6,2,100874,100874,100876,0,2,5
28863,1,3,100875,100876,100879,1,4,0
28864,4,3,100879,100879,100882,0,3,0
28865,4,2,100883,100883,100885,0,2,1
28866,2,1,100885,100885,100886,0,1,0
28867,6,2,100891,100891,100893,0,2,5
28868,1,1,100892,100893,100894,1,2,0
28869,6,2,100898,100898,100900,0,2,4
28870,5,3,100903,100903,100906,0,3,3
28871,1,1,100904,100906,100907,2,3,0
28872,6,2,100910,100910,100912,0,2,3
28873,3,3,100913,100913,100916,0,3,1
28874,2,1,100915,100916,100917,1,2,0
28875,1,1,100916,100917,100918,1,2,0
28876,6,3,100922,100922,100925,0,3,4
28877,6,2,100928,100928,100930,0,2,3
28878,5,1,100933,100933,100934,0,1,3
28879,5,3,100938,100938,100941,0,3,4
28880,5,2,100943,100943,100945,0,2,2
28881,4,1,100947,100947,100948,0,1,2
28882,5,1,100952,100952,100953,0,1,4
28883,3,1,100955,100955,100956,0,1,2
28884,3,2,100958,100958,100960,0,2,2
28885,2,3,100960,100960,100963,0,3,0
28886,3,1,100963,100963,100964,0,1,0
28887,6,2,100969,100969,100971,0,2,5
28888,3,2,100972,100972,100974,0,2,1
28889,5,2,100977,100977,100979,0,2,3
28890,2,1,100979,100979,100980,0,1,0
28891,1,3,100980,100980,100983,0,3,0
28892,4,3,100984,100984,100987,0,3,1
28893,2,1,100986,100987,100988,1,2,0
28894,1,1,100987,100988,100989,1,2,0
28895,3,2,100990,100990,100992,0,2,1
28896,2,1,100992,100992,100993,0,1,0
28897,2,1,100994,100994,100995,0,1,1
28898,3,2,100997,100997,100999,0,2,2
28899,4,3,101001,101001,101004,0,3,2
28900,2,2,101003,101004,101006,1,3,0
28901,4,2,101007,101007,101009,0,2,1
28902,2,1,101009,101009,101010,0,1,0
28903,5,3,101014,101014,101017,0,3,4
28904,5,3,101019,101019,101022,0,3,2
28905,1,1,101020,101022,101023,2,3,0
28906,2,3,101022,101023,101026,1,4,0
28907,3,2,101025,101026,101028,1,3,0
28908,4,3,101029,101029,101032,0,3,1
28909,2,3,101031,101032,101035,1,4,0
28910,5,2,101036,101036,101038,0,2,1
28911,3,1,101039,101039,101040,0,1,1
28912,5,1,101044,101044,101045,0,1,4
28913,5,3,101049,101049,101052,0,3,4
28914,6,3,101055,101055,101058,0,3,3
28915,4,1,101059,101059,101060,0,1,1
28916,6,1,101065,101065,101066,0,1,5
28917,2,3,101067,101067,101070,0,3,1
28918,2,1,101069,101070,101071,1,2,0
28919,5,1,101074,101074,101075,0,1,3
28920,3,2,101077,101077,101079,0,2,2
28921,5,1,101082,101082,101083,0,1,3
28922,2,1,101084,101084,101085,0,1,1
28923,3,3,101087,101087,101090,0,3,2
28924,3,3,101090,101090,101093,0,3,0
28925,1,1,101091,101093,101094,2,3,0
28926,3,2,101094,101094,101096,0,2,0
28927,1,2,101095,101096,101098,1,3,0
28928,5,2,101100,101100,101102,0,2,2
28929,5,3,101105,101105,101108,0,3,3
28930,4,3,101109,101109,101112,0,3,1
28931,3,1,101112,101112,101113,0,1,0
28932,1,1,101113,101113,101114,0,1,0
28933,3,1,101116,101116,101117,0,1,2
28934,6,1,101122,101122,101123,0,1,5
28935,1,1,101123,101123,101124,0,1,0
28936,5,2,101128,101128,101130,0,2,4
28937,3,1,101131,101131,101132,0,1,1
28938,2,2,101133,101133,101135,0,2,1
28939,1,1,101134,101135,101136,1,2,0
28940,3,2,101137,101137,101139,0,2,1
28941,1,1,101138,101139,101140,1,2,0
28942,6,1,101144,101144,101145,0,1,4
28943,1,1,101145,101145,101146,0,1,0
28944,3,1,101148,101148,101149,0,1,2
28945,2,3,101150,101150,101153,0,3,1
28946,5,1,101155,101155,101156,0,1,2
28947,3,3,101158,101158,101161,0,3,2
28948,3,2,101161,101161,101163,0,2,0
28949,1,1,101162,101163,101164,1,2,0
28950,6,3,101168,101168,101171,0,3,4
28951,6,3,101174,101174,101177,0,3,3
28952,6,3,101180,101180,101183,0,3,3
28953,5,2,101185,101185,101187,0,2,2
28954,3,2,101188,101188,101190,0,2,1
28955,6,3,101194,101194,101197,0,3,4
28956,4,2,101198,101198,101200,0,2,1
28957,6,3,101204,101204,101207,0,3,4
28958,3,2,101207,101207,101209,0,2,0
28959,5,1,101212,101212,101213,0,1,3
28960,5,1,101217,101217,101218,0,1,4
28961,2,1,101219,101219,101220,0,1,1
28962,6,2,101225,101225,101227,0,2,5
28963,1,2,101226,101227,101229,1,3,0
28964,1,2,101227,101229,101231,2,4,0
28965,6,1,101233,101233,101234,0,1,2
28966,1,2,101234,101234,101236,0,2,0
28967,1,3,101235,101236,101239,1,4,0
28968,2,2,101237,101239,101241,2,4,0
28969,6,1,101243,101243,101244,0,1,2
28970,4,1,101247,101247,101248,0,1,3
28971,6,3,101253,101253,101256,0,3,5
28972,6,3,101259,101259,101262,0,3,3
28973,2,1,101261,101262,101263,1,2,0
28974,1,2,101262,101263,101265,1,3,0
28975,4,2,101266,101266,101268,0,2,1
28976,2,2,101268,101268,101270,0,2,0
28977,1,2,101269,101270,101272,1,3,0
28978,6,3,101275,101275,101278,0,3,3
28979,4,2,101279,101279,101281,0,2,1
28980,1,3,101280,101281,101284,1,4,0
28981,1,2,101281,101284,101286,3,5,0
28982,3,3,101284,101286,101289,2,5,0
28983,4,1,101288,101289,101290,1,2,0
28984,4,2,101292,101292,101294,0,2,2
28985,5,3,101297,101297,101300,0,3,3
28986,5,3,101302,101302,101305,0,3,2
28987,5,3,101307,101307,101310,0,3,2
28988,5,1,101312,101312,101313,0,1,2
28989,3,1,101315,101315,101316,0,1,2
28990,4,2,101319,101319,101321,0,2,3
28991,6,3,101325,101325,101328,0,3,4
28992,5,3,101330,101330,101333,0,3,2
28993,1,3,101331,101333,101336,2,5,0
28994,1,3,101332,101336,101339,4,7,0
28995,5,1,101337,101339,101340,2,3,0
28996,1,3,101338,101340,101343,2,5,0
28997,5,2,101343,101343,101345,0,2,0
28998,6,1,101349,101349,101350,0,1,4
28999,2,1,101351,101351,101352,0,1,1
29000,6,3,101357,101357,101360,0,3,5
29001,4,3,101361,101361,101364,0,3,1
29002,6,2,101367,101367,101369,0,2,3
29003,6,1,101373,101373,101374,0,1,4
29004,5,2,101378,101378,101380,0,2,4
29005,3,2,101381,101381,101383,0,2,1
29006,5,2,101386,101386,101388,0,2,3
29007,3,1,101389,101389,101390,0,1,1
29008,5,1,101394,101394,101395,0,1,4
29009,5,2,101399,101399,101401,0,2,4
29010,2,3,101401,101401,101404,0,3,0
29011,2,3,101403,101404,101407,1,4,0
29012,3,3,101406,101407,101410,1,4,0
29013,6,2,101412,101412,101414,0,2,2
29014,1,2,101413,101414,101416,1,3,0
29015,2,2,101415,101416,101418,1,3,0
29016,2,3,101417,101418,101421,1,4,0
29017,3,1,101420,101421,101422,1,2,0
29018,2,1,101422,101422,101423,0,1,0
29019,2,2,101424,101424,101426,0,2,1
29020,4,2,101428,101428,101430,0,2,2
29021,3,2,101431,101431,101433,0,2,1
29022,2,1,101433,101433,101434,0,1,0
29023,6,3,101439,101439,101442,0,3,5
29024,3,2,101442,101442,101444,0,2,0
29025,3,1,101445,101445,101446,0,1,1
29026,3,1,101448,101448,101449,0,1,2
29027,6,1,101454,101454,101455,0,1,5
29028,6,2,101460,101460,101462,0,2,5
29029,6,1,101466,101466,101467,0,1,4
29030,4,3,101470,101470,101473,0,3,3
29031,6,3,101476,101476,101479,0,3,3
29032,3,3,101479,101479,101482,0,3,0
29033,2,1,101481,101482,101483,1,2,0
29034,3,2,101484,101484,101486,0,2,1
29035,3,1,101487,101487,101488,0,1,1
29036,2,3,101489,101489,101492,0,3,1
29037,5,1,101494,101494,101495,0,1,2
29038,4,1,101498,101498,101499,0,1,3
29039,5,1,101503,101503,101504,0,1,4
29040,5,1,101508,101508,101509,0,1,4
29041,5,3,101513,101513,101516,0,3,4
29042,6,1,101519,101519,101520,0,1,3
29043,2,3,101521,101521,101524,0,3,1
29044,1,2,101522,101524,101526,2,4,0
29045,1,3,101523,101526,101529,3,6,0
29046,3,3,101526,101529,101532,3,6,0
29047,2,3,101528,101532,101535,4,7,0
29048,1,3,101529,101535,101538,6,9,0
29049,2,2,101531,101538,101540,7,9,0
29050,6,1,101537,101540,101541,3,4,0
29051,4,1,101541,101541,101542,0,1,0
29052,3,2,101544,101544,101546,0,2,2
29053,5,3,101549,101549,101552,0,3,3
29054,3,3,101552,101552,101555,0,3,0
29055,2,1,101554,101555,101556,1,2,0
29056,2,2,101556,101556,101558,0,2,0
29057,6,1,101562,101562,101563,0,1,4
29058,2,2,101564,101564,101566,0,2,1
29059,3,2,101567,101567,101569,0,2,1
29060,6,3,101573,101573,101576,0,3,4
29061,5,1,101578,101578,101579,0,1,2
29062,1,2,101579,101579,101581,0,2,0
29063,5,1,101584,101584,101585,0,1,3
29064,5,1,101589,101589,101590,0,1,4
29065,3,3,101592,101592,101595,0,3,2
29066,3,2,101595,101595,101597,0,2,0
29067,1,2,101596,101597,101599,1,3,0
29068,6,2,101602,101602,101604,0,2,3
29069,5,1,101607,101607,101608,0,1,3
29070,4,3,101611,101611,101614,0,3,3
29071,2,3,101613,101614,101617,1,4,0
29072,5,2,101618,101618,101620,0,2,1
29073,1,2,101619,101620,101622,1,3,0
29074,1,1,101620,101622,101623,2,3,0
29075,6,3,101626,101626,101629,0,3,3
29076,2,1,101628,101629,101630,1,2,0
29077,6,1,101634,101634,101635,0,1,4
29078,2,1,101636,101636,101637,0,1,1
29079,2,1,101638,101638,101639,0,1,1
29080,6,2,101644,101644,101646,0,2,5
29081,5,2,101649,101649,101651,0,2,3
29082,2,2,101651,101651,101653,0,2,0
29083,5,3,101656,101656,101659,0,3,3
29084,4,2,101660,101660,101662,0,2,1
29085,6,1,101666,101666,101667,0,1,4
29086,2,1,101668,101668,101669,0,1,1
29087,2,3,101670,101670,101673,0,3,1
29088,1,1,101671,101673,101674,2,3,0
29089,3,3,101674,101674,101677,0,3,0
29090,6,2,101680,101680,101682,0,2,3
29091,2,1,101682,101682,101683,0,1,0
29092,3,2,101685,101685,101687,0,2,2
29093,5,2,101690,101690,101692,0,2,3
29094,1,2,101691,101692,101694,1,3,0
29095,1,3,101692,101694,101697,2,5,0
29096,6,3,101698,101698,101701,0,3,1
29097,2,2,101700,101701,101703,1,3,0
29098,1,3,101701,101703,101706,2,5,0
29099,4,2,101705,101706,101708,1,3,0
29100,1,3,101706,101708,101711,2,5,0
29101,3,3,101709,101711,101714,2,5,0
29102,5,3,101714,101714,101717,0,3,0
29103,4,3,101718,101718,101721,0,3,1
29104,3,3,101721,101721,101724,0,3,0
29105,3,1,101724,101724,101725,0,1,0
29106,5,1,101729,101729,101730,0,1,4
29107,4,1,101733,101733,101734,0,1,3
29108,4,1,101737,101737,101738,0,1,3
29109,5,2,101742,101742,101744,0,2,4
29110,2,3,101744,101744,101747,0,3,0
29111,5,3,101749,101749,101752,0,3,2
29112,5,3,101754,101754,101757,0,3,2
29113,5,3,101759,101759,101762,0,3,2
29114,6,1,101765,101765,101766,0,1,3
29115,6,1,101771,101771,101772,0,1,5
29116,6,2,101777,101777,101779,0,2,5
29117,3,1,101780,101780,101781,0,1,1
29118,1,1,101781,101781,101782,0,1,0
29119,1,3,101782,101782,101785,0,3,0
29120,5,2,101787,101787,101789,0,2,2
29121,5,3,101792,101792,101795,0,3,3
29122,1,1,101793,101795,101796,2,3,0
29123,5,1,101798,101798,101799,0,1,2
29124,4,3,101802,101802,101805,0,3,3
29125,2,2,101804,101805,101807,1,3,0
29126,2,3,101806,101807,101810,1,4,0
29127,2,2,101808,101810,101812,2,4,0
29128,2,2,101810,101812,101814,2,4,0
29129,2,3,101812,101814,101817,2,5,0
29130,2,2,101814,101817,101819,3,5,0
29131,2,2,101816,101819,101821,3,5,0
29132,5,1,101821,101821,101822,0,1,0
29133,6,2,101827,101827,101829,0,2,5
29134,3,3,101830,101830,101833,0,3,1
29135,6,3,101836,101836,101839,0,3,3
29136,3,3,101839,101839,101842,0,3,0
29137,4,2,101843,101843,101845,0,2,1
29138,2,3,101845,101845,101848,0,3,0
29139,4,3,101849,101849,101852,0,3,1
29140,2,1,101851,101852,101853,1,2,0
29141,2,1,101853,101853,101854,0,1,0
29142,4,1,101857,101857,101858,0,1,3
29143,2,3,101859,101859,101862,0,3,1
29144,3,2,101862,101862,101864,0,2,0
29145,1,1,101863,101864,101865,1,2,0
29146,1,1,101864,101865,101866,1,2,0
29147,3,3,101867,101867,101870,0,3,1
29148,3,3,101870,101870,101873,0,3,0
29149,6,2,101876,101876,101878,0,2,3
29150,6,1,101882,101882,101883,0,1,4
29151,6,3,101888,101888,101891,0,3,5
29152,4,2,101892,101892,101894,0,2,1
29153,6,3,101898,101898,101901,0,3,4
29154,4,3,101902,101902,101905,0,3,1
29155,3,1,101905,101905,101906,0,1,0
29156,3,1,101908,101908,101909,0,1,2
29157,2,3,101910,101910,101913,0,3,1
29158,1,1,101911,101913,101914,2,3,0
29159,2,2,101913,101914,101916,1,3,0
29160,5,3,101918,101918,101921,0,3,2
29161,5,2,101923,101923,101925,0,2,2
29162,5,3,101928,101928,101931,0,3,3
29163,3,2,101931,101931,101933,0,2,0
29164,4,1,101935,101935,101936,0,1,2
29165,4,1,101939,101939,101940,0,1,3
29166,6,2,101945,101945,101947,0,2,5
29167,1,2,101946,101947,101949,1,3,0
29168,2,3,101948,101949,101952,1,4,0
29169,1,3,101949,101952,101955,3,6,0
29170,2,3,101951,101955,101958,4,7,0
29171,6,1,101957,101958,101959,1,2,0
29172,6,2,101963,101963,101965,0,2,4
29173,2,3,101965,101965,101968,0,3,0
29174,6,1,101971,101971,101972,0,1,3
29175,4,2,101975,101975,101977,0,2,3
29176,2,1,101977,101977,101978,0,1,0
29177,4,3,101981,101981,101984,0,3,3
29178,6,3,101987,101987,101990,0,3,3
29179,5,2,101992,101992,101994,0,2,2
29180,6,2,101998,101998,102000,0,2,4
29181,1,3,101999,102000,102003,1,4,0
29182,6,2,102005,102005,102007,0,2,2
29183,1,1,102006,102007,102008,1,2,0
29184,2,1,102008,102008,102009,0,1,0
29185,2,2,102010,102010,102012,0,2,1
29186,2,3,102012,102012,102015,0,3,0
29187,3,2,102015,102015,102017,0,2,0
29188,4,2,102019,102019,102021,0,2,2
29189,3,3,102022,102022,102025,0,3,1
29190,3,3,102025,102025,102028,0,3,0
29191,3,1,102028,102028,102029,0,1,0
29192,5,1,102033,102033,102034,0,1,4
29193,3,2,102036,102036,102038,0,2,2
29194,6,2,102042,102042,102044,0,2,4
29195,2,1,102044,102044,102045,0,1,0
29196,6,1,102050,102050,102051,0,1,5
29197,2,1,102052,102052,102053,0,1,1
29198,6,3,102058,102058,102061,0,3,5
29199,3,1,102061,102061,102062,0,1,0
29200,1,2,102062,102062,102064,0,2,0
29201,1,3,102063,102064,102067,1,4,0
29202,4,3,102067,102067,102070,0,3,0
29203,2,2,102069,102070,102072,1,3,0
29204,3,3,102072,102072,102075,0,3,0
29205,1,3,102073,102075,102078,2,5,0
29206,1,3,102074,102078,102081,4,7,0
29207,6,3,102080,102081,102084,1,4,0
29208,3,3,102083,102084,102087,1,4,0
29209,6,2,102089,102089,102091,0,2,2
29210,4,3,102093,102093,102096,0,3,2
29211,2,3,102095,102096,102099,1,4,0
29212,2,1,102097,102099,102100,2,3,0
29213,6,1,102103,102103,102104,0,1,3
29214,6,3,102109,102109,102112,0,3,5
29215,3,1,102112,102112,102113,0,1,0
29216,6,2,102118,102118,102120,0,2,5
29217,1,1,102119,102120,102121,1,2,0
29218,5,1,102124,102124,102125,0,1,3
29219,2,2,102126,102126,102128,0,2,1
29220,6,2,102132,102132,102134,0,2,4
29221,4,2,102136,102136,102138,0,2,2
29222,6,2,102142,102142,102144,0,2,4
29223,3,1,102145,102145,102146,0,1,1
29224,3,2,102148,102148,102150,0,2,2
29225,2,2,102150,102150,102152,0,2,0
29226,6,1,102156,102156,102157,0,1,4
29227,3,3,102159,102159,102162,0,3,2
29228,4,2,102163,102163,102165,0,2,1
29229,3,2,102166,102166,102168,0,2,1
29230,6,2,102172,102172,102174,0,2,4
29231,1,2,102173,102174,102176,1,3,0
29232,1,1,102174,102176,102177,2,3,0
29233,4,1,102178,102178,102179,0,1,1
29234,3,2,102181,102181,102183,0,2,2
29235,3,1,102184,102184,102185,0,1,1
29236,4,2,102188,102188,102190,0,2,3
29237,2,3,102190,102190,102193,0,3,0
29238,2,3,102192,102193,102196,1,4,0
29239,3,1,102195,102196,102197,1,2,0
29240,3,3,102198,102198,102201,0,3,1
29241,2,1,102200,102201,102202,1,2,0
29242,6,3,102206,102206,102209,0,3,4
29243,5,2,102211,102211,102213,0,2,2
29244,3,1,102214,102214,102215,0,1,1
29245,3,3,102217,102217,102220,0,3,2
29246,3,3,102220,102220,102223,0,3,0
29247,4,2,102224,102224,102226,0,2,1
29248,5,1,102229,102229,102230,0,1,3
29249,2,2,102231,102231,102233,0,2,1
29250,2,2,102233,102233,102235,0,2,0
29251,6,2,102239,102239,102241,0,2,4
29252,4,1,102243,102243,102244,0,1,2
29253,3,1,102246,102246,102247,0,1,2
29254,5,1,102251,102251,102252,0,1,4
29255,3,3,102254,102254,102257,0,3,2
29256,2,2,102256,102257,102259,1,3,0
29257,4,3,102260,102260,102263,0,3,1
29258,1,3,102261,102263,102266,2,5,0
29259,5,1,102266,102266,102267,0,1,0
29260,6,3,102272,102272,102275,0,3,5
29261,1,2,102273,102275,102277,2,4,0
29262,4,1,102277,102277,102278,0,1,0
29263,4,2,102281,102281,102283,0,2,3
29264,6,2,102287,102287,102289,0,2,4
29265,4,2,102291,102291,102293,0,2,2
29266,4,2,102295,102295,102297,0,2,2
29267,6,3,102301,102301,102304,0,3,4
29268,3,3,102304,102304,102307,0,3,0
29269,3,2,102307,102307,102309,0,2,0
29270,6,3,102313,102313,102316,0,3,4
29271,1,3,102314,102316,102319,2,5,0
29272,3,2,102317,102319,102321,2,4,0
29273,4,3,102321,102321,102324,0,3,0
29274,6,2,102327,102327,102329,0,2,3
29275,3,2,102330,102330,102332,0,2,1
29276,2,1,102332,102332,102333,0,1,0
29277,3,1,102335,102335,102336,0,1,2
29278,3,2,102338,102338,102340,0,2,2
29279,2,3,102340,102340,102343,0,3,0
29280,5,1,102345,102345,102346,0,1,2
29281,5,3,102350,102350,102353,0,3,4
29282,4,2,102354,102354,102356,0,2,1
29283,2,1,102356,102356,102357,0,1,0
29284,1,2,102357,102357,102359,0,2,0
29285,5,2,102362,102362,102364,0,2,3
29286,3,3,102365,102365,102368,0,3,1
29287,2,1,102367,102368,102369,1,2,0
29288,6,1,102373,102373,102374,0,1,4
29289,5,1,102378,102378,102379,0,1,4
29290,2,2,102380,102380,102382,0,2,1
29291,5,1,102385,102385,102386,0,1,3
29292,6,3,102391,102391,102394,0,3,5
29293,6,3,102397,102397,102400,0,3,3
29294,5,2,102402,102402,102404,0,2,2
29295,5,2,102407,102407,102409,0,2,3
29296,5,2,102412,102412,102414,0,2,3
29297,1,2,102413,102414,102416,1,3,0
29298,2,2,102415,102416,102418,1,3,0
29299,5,3,102420,102420,102423,0,3,2
29300,2,3,102422,102423,102426,1,4,0
29301,2,3,102424,102426,102429,2,5,0
29302,3,3,102427,102429,102432,2,5,0
29303,2,3,102429,102432,102435,3,6,0
29304,2,2,102431,102435,102437,4,6,0
29305,6,1,102437,102437,102438,0,1,0
29306,4,1,102441,102441,102442,0,1,3
29307,6,1,102447,102447,102448,0,1,5
29308,1,1,102448,102448,102449,0,1,0
29309,6,3,102454,102454,102457,0,3,5
29310,2,2,102456,102457,102459,1,3,0
29311,5,3,102461,102461,102464,0,3,2
29312,5,1,102466,102466,102467,0,1,2
29313,1,2,102467,102467,102469,0,2,0
29314,6,3,102473,102473,102476,0,3,4
29315,3,2,102476,102476,102478,0,2,0
29316,5,2,102481,102481,102483,0,2,3
29317,3,3,102484,102484,102487,0,3,1
29318,4,1,102488,102488,102489,0,1,1
29319,3,3,102491,102491,102494,0,3,2
29320,3,3,102494,102494,102497,0,3,0
29321,3,2,102497,102497,102499,0,2,0
29322,4,1,102501,102501,102502,0,1,2
29323,2,1,102503,102503,102504,0,1,1
29324,4,1,102507,102507,102508,0,1,3
29325,5,3,102512,102512,102515,0,3,4
29326,1,3,102513,102515,102518,2,5,0
29327,2,2,102515,102518,102520,3,5,0
29328,6,3,102521,102521,102524,0,3,1
29329,6,2,102527,102527,102529,0,2,3
29330,5,1,102532,102532,102533,0,1,3
29331,3,1,102535,102535,102536,0,1,2
29332,1,3,102536,102536,102539,0,3,0
29333,2,3,102538,102539,102542,1,4,0
29334,6,2,102544,102544,102546,0,2,2
29335,1,1,102545,102546,102547,1,2,0
29336,1,2,102546,102547,102549,1,3,0
29337,5,2,102551,102551,102553,0,2,2
29338,6,3,102557,102557,102560,0,3,4
29339,1,3,102558,102560,102563,2,5,0
29340,3,2,102561,102563,102565,2,4,0
29341,6,2,102567,102567,102569,0,2,2
29342,4,1,102571,102571,102572,0,1,2
29343,4,3,102575,102575,102578,0,3,3
29344,5,2,102580,102580,102582,0,2,2
29345,3,2,102583,102583,102585,0,2,1
29346,5,1,102588,102588,102589,0,1,3
29347,6,1,102594,102594,102595,0,1,5
29348,5,1,102599,102599,102600,0,1,4
29349,4,3,102603,102603,102606,0,3,3
29350,1,1,102604,102606,102607,2,3,0
29351,4,3,102608,102608,102611,0,3,1
29352,6,3,102614,102614,102617,0,3,3
29353,4,3,102618,102618,102621,0,3,1
29354,6,1,102624,102624,102625,0,1,3
29355,4,1,102628,102628,102629,0,1,3
29356,5,3,102633,102633,102636,0,3,4
29357,3,3,102636,102636,102639,0,3,0
29358,2,3,102638,102639,102642,1,4,0
29359,1,3,102639,102642,102645,3,6,0
29360,1,2,102640,102645,102647,5,7,0
29361,1,1,102641,102647,102648,6,7,0
29362,2,1,102643,102648,102649,5,6,0
29363,3,3,102646,102649,102652,3,6,0
29364,6,2,102652,102652,102654,0,2,0
29365,5,1,102657,102657,102658,0,1,3
29366,2,2,102659,102659,102661,0,2,1
29367,5,2,102664,102664,102666,0,2,3
29368,2,3,102666,102666,102669,0,3,0
29369,3,3,102669,102669,102672,0,3,0
29370,4,3,102673,102673,102676,0,3,1
29371,2,3,102675,102676,102679,1,4,0
29372,2,2,102677,102679,102681,2,4,0
29373,2,1,102679,102681,102682,2,3,0
29374,5,3,102684,102684,102687,0,3,2
29375,1,2,102685,102687,102689,2,4,0
29376,4,3,102689,102689,102692,0,3,0
29377,4,1,102693,102693,102694,0,1,1
29378,4,1,102697,102697,102698,0,1,3
29379,5,3,102702,102702,102705,0,3,4
29380,6,2,102708,102708,102710,0,2,3
29381,3,2,102711,102711,102713,0,2,1
29382,5,2,102716,102716,102718,0,2,3
29383,2,2,102718,102718,102720,0,2,0
29384,1,2,102719,102720,102722,1,3,0
29385,4,1,102723,102723,102724,0,1,1
29386,5,3,102728,102728,102731,0,3,4
29387,5,2,102733,102733,102735,0,2,2
29388,5,2,102738,102738,102740,0,2,3
29389,5,2,102743,102743,102745,0,2,3
29390,3,3,102746,102746,102749,0,3,1
29391,2,2,102748,102749,102751,1,3,0
29392,6,3,102754,102754,102757,0,3,3
29393,6,3,102760,102760,102763,0,3,3
29394,1,1,102761,102763,102764,2,3,0
29395,1,3,102762,102764,102767,2,5,0
29396,3,3,102765,102767,102770,2,5,0
29397,5,3,102770,102770,102773,0,3,0
29398,4,3,102774,102774,102777,0,3,1
29399,4,3,102778,102778,102781,0,3,1
29400,5,1,102783,102783,102784,0,1,2
29401,5,2,102788,102788,102790,0,2,4
29402,3,2,102791,102791,102793,0,2,1
29403,4,1,102795,102795,102796,0,1,2
29404,2,3,102797,102797,102800,0,3,1
29405,4,2,102801,102801,102803,0,2,1
29406,3,1,102804,102804,102805,0,1,1
29407,6,1,102810,102810,102811,0,1,5
29408,2,2,102812,102812,102814,0,2,1
29409,6,3,102818,102818,102821,0,3,4
29410,2,3,102820,102821,102824,1,4,0
29411,1,1,102821,102824,102825,3,4,0
29412,5,3,102826,102826,102829,0,3,1
29413,5,1,102831,102831,102832,0,1,2
29414,4,1,102835,102835,102836,0,1,3
29415,4,1,102839,102839,102840,0,1,3
29416,1,2,102840,102840,102842,0,2,0
29417,3,3,102843,102843,102846,0,3,1
29418,1,1,102844,102846,102847,2,3,0
29419,1,2,102845,102847,102849,2,4,0
29420,1,3,102846,102849,102852,3,6,0
29421,5,3,102851,102852,102855,1,4,0
29422,6,2,102857,102857,102859,0,2,2
29423,6,1,102863,102863,102864,0,1,4
29424,4,3,102867,102867,102870,0,3,3
29425,6,2,102873,102873,102875,0,2,3
29426,4,1,102877,102877,102878,0,1,2
29427,6,1,102883,102883,102884,0,1,5
29428,1,2,102884,102884,102886,0,2,0
29429,5,3,102889,102889,102892,0,3,3
29430,3,1,102892,102892,102893,0,1,0
29431,3,3,102895,102895,102898,0,3,2
29432,4,1,102899,102899,102900,0,1,1
29433,4,2,102903,102903,102905,0,2,3
29434,5,3,102908,102908,102911,0,3,3
29435,6,3,102914,102914,102917,0,3,3
29436,1,1,102915,102917,102918,2,3,0
29437,6,1,102921,102921,102922,0,1,3
29438,2,2,102923,102923,102925,0,2,1
29439,2,2,102925,102925,102927,0,2,0
29440,3,2,102928,102928,102930,0,2,1
29441,1,1,102929,102930,102931,1,2,0
29442,3,1,102932,102932,102933,0,1,1
29443,3,3,102935,102935,102938,0,3,2
29444,2,3,102937,102938,102941,1,4,0
29445,6,1,102943,102943,102944,0,1,2
29446,3,3,102946,102946,102949,0,3,2
29447,6,3,102952,102952,102955,0,3,3
29448,1,2,102953,102955,102957,2,4,0
29449,4,1,102957,102957,102958,0,1,0
29450,4,2,102961,102961,102963,0,2,3
29451,5,2,102966,102966,102968,0,2,3
29452,5,1,102971,102971,102972,0,1,3
29453,1,3,102972,102972,102975,0,3,0
29454,6,1,102978,102978,102979,0,1,3
29455,4,1,102982,102982,102983,0,1,3
29456,5,1,102987,102987,102988,0,1,4
29457,3,3,102990,102990,102993,0,3,2
29458,6,1,102996,102996,102997,0,1,3
29459,4,3,103000,103000,103003,0,3,3
29460,4,1,103004,103004,103005,0,1,1
29461,6,2,103010,103010,103012,0,2,5
29462,2,2,103012,103012,103014,0,2,0
29463,1,2,103013,103014,103016,1,3,0
29464,4,1,103017,103017,103018,0,1,1
29465,4,2,103021,103021,103023,0,2,3
29466,4,3,103025,103025,103028,0,3,2
29467,1,1,103026,103028,103029,2,3,0
29468,3,1,103029,103029,103030,0,1,0
29469,6,3,103035,103035,103038,0,3,5
29470,4,3,103039,103039,103042,0,3,1
29471,3,2,103042,103042,103044,0,2,0
29472,2,2,103044,103044,103046,0,2,0
29473,5,3,103049,103049,103052,0,3,3
29474,3,3,103052,103052,103055,0,3,0
29475,4,2,103056,103056,103058,0,2,1
29476,5,2,103061,103061,103063,0,2,3
29477,2,3,103063,103063,103066,0,3,0
29478,2,3,103065,103066,103069,1,4,0
29479,4,2,103069,103069,103071,0,2,0
29480,6,2,103075,103075,103077,0,2,4
29481,6,3,103081,103081,103084,0,3,4
29482,2,3,103083,103084,103087,1,4,0
29483,5,3,103088,103088,103091,0,3,1
29484,6,1,103094,103094,103095,0,1,3
29485,1,1,103095,103095,103096,0,1,0
29486,2,2,103097,103097,103099,0,2,1
29487,6,1,103103,103103,103104,0,1,4
29488,5,1,103108,103108,103109,0,1,4
29489,3,3,103111,103111,103114,0,3,2
29490,6,1,103117,103117,103118,0,1,3
29491,2,1,103119,103119,103120,0,1,1
29492,3,2,103122,103122,103124,0,2,2
29493,2,2,103124,103124,103126,0,2,0
29494,2,2,103126,103126,103128,0,2,0
29495,1,3,103127,103128,103131,1,4,0
29496,5,1,103132,103132,103133,0,1,1
29497,6,3,103138,103138,103141,0,3,5
29498,2,2,103140,103141,103143,1,3,0
29499,3,1,103143,103143,103144,0,1,0
29500,5,3,103148,103148,103151,0,3,4
29501,4,1,103152,103152,103153,0,1,1
29502,2,1,103154,103154,103155,0,1,1
29503,3,2,103157,103157,103159,0,2,2
29504,6,3,103163,103163,103166,0,3,4
29505,5,3,103168,103168,103171,0,3,2
29506,6,3,103174,103174,103177,0,3,3
29507,4,3,103178,103178,103181,0,3,1
29508,5,1,103183,103183,103184,0,1,2
29509,6,2,103189,103189,103191,0,2,5
29510,3,1,103192,103192,103193,0,1,1
29511,2,1,103194,103194,103195,0,1,1
29512,1,3,103195,103195,103198,0,3,0
29513,2,2,103197,103198,103200,1,3,0
29514,6,2,103203,103203,103205,0,2,3
29515,3,2,103206,103206,103208,0,2,1
29516,4,1,103210,103210,103211,0,1,2
29517,5,1,103215,103215,103216,0,1,4
29518,5,2,103220,103220,103222,0,2,4
29519,6,1,103226,103226,103227,0,1,4
29520,6,2,103232,103232,103234,0,2,5
29521,2,1,103234,103234,103235,0,1,0
29522,5,1,103239,103239,103240,0,1,4
29523,6,3,103245,103245,103248,0,3,5
29524,2,1,103247,103248,103249,1,2,0
29525,3,3,103250,103250,103253,0,3,1
29526,2,1,103252,103253,103254,1,2,0
29527,4,3,103256,103256,103259,0,3,2
29528,2,1,103258,103259,103260,1,2,0
29529,5,3,103263,103263,103266,0,3,3
29530,3,2,103266,103266,103268,0,2,0
29531,2,1,103268,103268,103269,0,1,0
29532,4,1,103272,103272,103273,0,1,3
29533,3,3,103275,103275,103278,0,3,2
29534,1,1,103276,103278,103279,2,3,0
29535,6,2,103282,103282,103284,0,2,3
29536,4,1,103286,103286,103287,0,1,2
29537,6,2,103292,103292,103294,0,2,5
29538,5,3,103297,103297,103300,0,3,3
29539,2,2,103299,103300,103302,1,3,0
29540,5,1,103304,103304,103305,0,1,2
29541,1,3,103305,103305,103308,0,3,0
29542,3,1,103308,103308,103309,0,1,0
29543,3,3,103311,103311,103314,0,3,2
29544,5,3,103316,103316,103319,0,3,2
29545,3,2,103319,103319,103321,0,2,0
29546,3,1,103322,103322,103323,0,1,1
29547,5,1,103327,103327,103328,0,1,4
29548,5,1,103332,103332,103333,0,1,4
29549,5,3,103337,103337,103340,0,3,4
29550,4,3,103341,103341,103344,0,3,1
29551,5,1,103346,103346,103347,0,1,2
29552,2,1,103348,103348,103349,0,1,1
29553,2,2,103350,103350,103352,0,2,1
29554,1,2,103351,103352,103354,1,3,0
29555,6,1,103357,103357,103358,0,1,3
29556,5,1,103362,103362,103363,0,1,4
29557,4,3,103366,103366,103369,0,3,3
29558,1,3,103367,103369,103372,2,5,0
29559,4,3,103371,103372,103375,1,4,0
29560,2,1,103373,103375,103376,2,3,0
29561,4,2,103377,103377,103379,0,2,1
29562,2,3,103379,103379,103382,0,3,0
29563,2,3,103381,103382,103385,1,4,0
29564,3,1,103384,103385,103386,1,2,0
29565,3,1,103387,103387,103388,0,1,1
29566,5,2,103392,103392,103394,0,2,4
29567,5,1,103397,103397,103398,0,1,3
29568,3,2,103400,103400,103402,0,2,2
29569,4,1,103404,103404,103405,0,1,2
29570,1,2,103405,103405,103407,0,2,0
29571,6,2,103411,103411,103413,0,2,4
29572,3,2,103414,103414,103416,0,2,1
29573,2,3,103416,103416,103419,0,3,0
29574,2,3,103418,103419,103422,1,4,0
29575,3,1,103421,103422,103423,1,2,0
29576,2,3,103423,103423,103426,0,3,0
29577,5,2,103428,103428,103430,0,2,2
29578,3,2,103431,103431,103433,0,2,1
29579,4,1,103435,103435,103436,0,1,2
29580,2,3,103437,103437,103440,0,3,1
29581,6,3,103443,103443,103446,0,3,3
29582,6,2,103449,103449,103451,0,2,3
29583,6,2,103455,103455,103457,0,2,4
29584,4,2,103459,103459,103461,0,2,2
29585,6,1,103465,103465,103466,0,1,4
29586,5,1,103470,103470,103471,0,1,4
29587,3,1,103473,103473,103474,0,1,2
29588,2,3,103475,103475,103478,0,3,1
29589,3,2,103478,103478,103480,0,2,0
29590,6,1,103484,103484,103485,0,1,4
29591,4,3,103488,103488,103491,0,3,3
29592,1,1,103489,103491,103492,2,3,0
29593,4,2,103493,103493,103495,0,2,1
29594,6,1,103499,103499,103500,0,1,4
29595,3,2,103502,103502,103504,0,2,2
29596,4,1,103506,103506,103507,0,1,2
29597,2,1,103508,103508,103509,0,1,1
29598,6,1,103514,103514,103515,0,1,5
29599,6,2,103520,103520,103522,0,2,5
29600,1,2,103521,103522,103524,1,3,0
29601,4,3,103525,103525,103528,0,3,1
29602,3,3,103528,103528,103531,0,3,0
29603,6,2,103534,103534,103536,0,2,3
29604,4,3,103538,103538,103541,0,3,2
29605,2,2,103540,103541,103543,1,3,0
29606,5,2,103545,103545,103547,0,2,2
29607,1,3,103546,103547,103550,1,4,0
29608,1,2,103547,103550,103552,3,5,0
29609,6,2,103553,103553,103555,0,2,1
29610,4,3,103557,103557,103560,0,3,2
29611,2,1,103559,103560,103561,1,2,0
29612,2,1,103561,103561,103562,0,1,0
29613,5,2,103566,103566,103568,0,2,4
29614,5,3,103571,103571,103574,0,3,3
29615,2,2,103573,103574,103576,1,3,0
29616,3,1,103576,103576,103577,0,1,0
29617,1,3,103577,103577,103580,0,3,0
29618,4,1,103581,103581,103582,0,1,1
29619,1,3,103582,103582,103585,0,3,0
29620,1,2,103583,103585,103587,2,4,0
29621,5,3,103588,103588,103591,0,3,1
29622,5,1,103593,103593,103594,0,1,2
29623,6,3,103599,103599,103602,0,3,5
29624,5,1,103604,103604,103605,0,1,2
29625,3,1,103607,103607,103608,0,1,2
29626,6,1,103613,103613,103614,0,1,5
29627,6,1,103619,103619,103620,0,1,5
29628,3,1,103622,103622,103623,0,1,2
29629,6,3,103628,103628,103631,0,3,5
29630,6,1,103634,103634,103635,0,1,3
29631,1,2,103635,103635,103637,0,2,0
29632,5,1,103640,103640,103641,0,1,3
29633,3,2,103643,103643,103645,0,2,2
29634,4,2,103647,103647,103649,0,2,2
29635,3,1,103650,103650,103651,0,1,1
29636,3,3,103653,103653,103656,0,3,2
29637,6,2,103659,103659,103661,0,2,3
29638,4,2,103663,103663,103665,0,2,2
29639,6,3,103669,103669,103672,0,3,4
29640,3,3,103672,103672,103675,0,3,0
29641,5,2,103677,103677,103679,0,2,2
29642,2,2,103679,103679,103681,0,2,0
29643,5,1,103684,103684,103685,0,1,3
29644,4,3,103688,103688,103691,0,3,3
29645,3,1,103691,103691,103692,0,1,0
29646,1,1,103692,103692,103693,0,1,0
29647,5,2,103697,103697,103699,0,2,4
29648,3,3,103700,103700,103703,0,3,1
29649,2,2,103702,103703,103705,1,3,0
29650,5,2,103707,103707,103709,0,2,2
29651,4,1,103711,103711,103712,0,1,2
29652,4,1,103715,103715,103716,0,1,3
29653,2,3,103717,103717,103720,0,3,1
29654,3,1,103720,103720,103721,0,1,0
29655,3,2,103723,103723,103725,0,2,2
29656,2,2,103725,103725,103727,0,2,0
29657,6,2,103731,103731,103733,0,2,4
29658,4,3,103735,103735,103738,0,3,2
29659,3,1,103738,103738,103739,0,1,0
29660,5,3,103743,103743,103746,0,3,4
29661,3,2,103746,103746,103748,0,2,0
29662,1,2,103747,103748,103750,1,3,0
29663,2,1,103749,103750,103751,1,2,0
29664,4,1,103753,103753,103754,0,1,2
29665,6,2,103759,103759,103761,0,2,5
29666,2,3,103761,103761,103764,0,3,0
29667,2,3,103763,103764,103767,1,4,0
29668,5,1,103768,103768,103769,0,1,1
29669,2,1,103770,103770,103771,0,1,1
29670,4,1,103774,103774,103775,0,1,3
29671,2,3,103776,103776,103779,0,3,1
29672,6,3,103782,103782,103785,0,3,3
29673,6,1,103788,103788,103789,0,1,3
29674,1,3,103789,103789,103792,0,3,0
29675,6,1,103795,103795,103796,0,1,3
29676,1,2,103796,103796,103798,0,2,0
29677,2,3,103798,103798,103801,0,3,0
29678,4,3,103802,103802,103805,0,3,1
29679,5,2,103807,103807,103809,0,2,2
29680,5,1,103812,103812,103813,0,1,3
29681,3,3,103815,103815,103818,0,3,2
29682,6,3,103821,103821,103824,0,3,3
29683,6,2,103827,103827,103829,0,2,3
29684,4,2,103831,103831,103833,0,2,2
29685,6,2,103837,103837,103839,0,2,4
29686,4,3,103841,103841,103844,0,3,2
29687,5,1,103846,103846,103847,0,1,2
29688,1,3,103847,103847,103850,0,3,0
29689,2,2,103849,103850,103852,1,3,0
29690,3,2,103852,103852,103854,0,2,0
29691,1,2,103853,103854,103856,1,3,0
29692,4,1,103857,103857,103858,0,1,1
29693,6,2,103863,103863,103865,0,2,5
29694,2,1,103865,103865,103866,0,1,0
29695,3,2,103868,103868,103870,0,2,2
29696,2,1,103870,103870,103871,0,1,0
29697,2,3,103872,103872,103875,0,3,1
29698,2,2,103874,103875,103877,1,3,0
29699,3,2,103877,103877,103879,0,2,0
29700,6,1,103883,103883,103884,0,1,4
29701,2,3,103885,103885,103888,0,3,1
29702,3,1,103888,103888,103889,0,1,0
29703,6,3,103894,103894,103897,0,3,5
29704,6,3,103900,103900,103903,0,3,3
29705,6,1,103906,103906,103907,0,1,3
29706,6,2,103912,103912,103914,0,2,5
29707,2,2,103914,103914,103916,0,2,0
29708,6,3,103920,103920,103923,0,3,4
29709,2,2,103922,103923,103925,1,3,0
29710,1,3,103923,103925,103928,2,5,0
29711,3,2,103926,103928,103930,2,4,0
29712,4,1,103930,103930,103931,0,1,0
29713,6,2,103936,103936,103938,0,2,5
29714,1,1,103937,103938,103939,1,2,0
29715,4,1,103941,103941,103942,0,1,2
29716,6,3,103947,103947,103950,0,3,5
29717,3,3,103950,103950,103953,0,3,0
29718,6,1,103956,103956,103957,0,1,3
29719,5,1,103961,103961,103962,0,1,4
29720,3,3,103964,103964,103967,0,3,2
29721,3,3,103967,103967,103970,0,3,0
29722,6,3,103973,103973,103976,0,3,3
29723,2,2,103975,103976,103978,1,3,0
29724,2,3,103977,103978,103981,1,4,0
29725,3,1,103980,103981,103982,1,2,0
29726,4,1,103984,103984,103985,0,1,2
29727,5,2,103989,103989,103991,0,2,4
29728,5,2,103994,103994,103996,0,2,3
29729,1,2,103995,103996,103998,1,3,0
29730,2,1,103997,103998,103999,1,2,0
29731,1,2,103998,103999,104001,1,3,0
29732,6,3,104004,104004,104007,0,3,3
29733,5,2,104009,104009,104011,0,2,2
29734,5,2,104014,104014,104016,0,2,3
29735,1,1,104015,104016,104017,1,2,0
29736,1,2,104016,104017,104019,1,3,0
29737,6,3,104022,104022,104025,0,3,3
29738,3,2,104025,104025,104027,0,2,0
29739,2,3,104027,104027,104030,0,3,0
29740,2,3,104029,104030,104033,1,4,0
29741,5,2,104034,104034,104036,0,2,1
29742,4,1,104038,104038,104039,0,1,2
29743,3,3,104041,104041,104044,0,3,2
29744,5,2,104046,104046,104048,0,2,2
29745,6,1,104052,104052,104053,0,1,4
29746,6,1,104058,104058,104059,0,1,5
29747,6,1,104064,104064,104065,0,1,5
29748,4,1,104068,104068,104069,0,1,3
29749,3,1,104071,104071,104072,0,1,2
29750,3,3,104074,104074,104077,0,3,2
29751,3,2,104077,104077,104079,0,2,0
29752,5,2,104082,104082,104084,0,2,3
29753,3,3,104085,104085,104088,0,3,1
29754,1,1,104086,104088,104089,2,3,0
29755,2,1,104088,104089,104090,1,2,0
29756,5,3,104093,104093,104096,0,3,3
29757,2,3,104095,104096,104099,1,4,0
29758,4,3,104099,104099,104102,0,3,0
29759,6,2,104105,104105,104107,0,2,3
29760,4,1,104109,104109,104110,0,1,2
29761,6,3,104115,104115,104118,0,3,5
29762,2,1,104117,104118,104119,1,2,0
29763,1,3,104118,104119,104122,1,4,0
29764,5,1,104123,104123,104124,0,1,1
29765,6,2,104129,104129,104131,0,2,5
29766,3,2,104132,104132,104134,0,2,1
29767,3,1,104135,104135,104136,0,1,1
29768,1,2,104136,104136,104138,0,2,0
29769,4,2,104140,104140,104142,0,2,2
29770,3,1,104143,104143,104144,0,1,1
29771,2,3,104145,104145,104148,0,3,1
29772,2,3,104147,104148,104151,1,4,0
29773,6,2,104153,104153,104155,0,2,2
29774,1,3,104154,104155,104158,1,4,0
29775,2,2,104156,104158,104160,2,4,0
29776,4,1,104160,104160,104161,0,1,0
29777,6,1,104166,104166,104167,0,1,5
29778,3,1,104169,104169,104170,0,1,2
29779,2,3,104171,104171,104174,0,3,1
29780,6,2,104177,104177,104179,0,2,3
29781,3,3,104180,104180,104183,0,3,1
29782,3,1,104183,104183,104184,0,1,0
29783,6,1,104189,104189,104190,0,1,5
29784,5,2,104194,104194,104196,0,2,4
29785,3,1,104197,104197,104198,0,1,1
29786,1,2,104198,104198,104200,0,2,0
29787,1,1,104199,104200,104201,1,2,0
29788,1,1,104200,104201,104202,1,2,0
29789,3,3,104203,104203,104206,0,3,1
29790,6,3,104209,104209,104212,0,3,3
29791,6,2,104215,104215,104217,0,2,3
29792,6,3,104221,104221,104224,0,3,4
29793,4,2,104225,104225,104227,0,2,1
29794,2,3,104227,104227,104230,0,3,0
29795,2,2,104229,104230,104232,1,3,0
29796,5,2,104234,104234,104236,0,2,2
29797,1,3,104235,104236,104239,1,4,0
29798,3,3,104238,104239,104242,1,4,0
29799,3,1,104241,104242,104243,1,2,0
29800,4,3,104245,104245,104248,0,3,2
29801,1,2,104246,104248,104250,2,4,0
29802,2,3,104248,104250,104253,2,5,0
29803,2,2,104250,104253,104255,3,5,0
29804,4,3,104254,104255,104258,1,4,0
29805,2,1,104256,104258,104259,2,3,0
29806,3,2,104259,104259,104261,0,2,0
29807,5,1,104264,104264,104265,0,1,3
29808,6,1,104270,104270,104271,0,1,5
29809,5,3,104275,104275,104278,0,3,4
29810,4,3,104279,104279,104282,0,3,1
29811,3,3,104282,104282,104285,0,3,0
29812,1,2,104283,104285,104287,2,4,0
29813,4,2,104287,104287,104289,0,2,0
29814,4,1,104291,104291,104292,0,1,2
29815,6,1,104297,104297,104298,0,1,5
29816,3,1,104300,104300,104301,0,1,2
29817,2,2,104302,104302,104304,0,2,1
29818,4,3,104306,104306,104309,0,3,2
29819,6,1,104312,104312,104313,0,1,3
29820,5,2,104317,104317,104319,0,2,4
29821,3,3,104320,104320,104323,0,3,1
29822,2,2,104322,104323,104325,1,3,0
29823,4,2,104326,104326,104328,0,2,1
29824,2,2,104328,104328,104330,0,2,0
29825,1,1,104329,104330,104331,1,2,0
29826,1,3,104330,104331,104334,1,4,0
29827,6,1,104336,104336,104337,0,1,2
29828,3,3,104339,104339,104342,0,3,2
29829,2,2,104341,104342,104344,1,3,0
29830,3,1,104344,104344,104345,0,1,0
29831,5,3,104349,104349,104352,0,3,4
29832,4,2,104353,104353,104355,0,2,1
29833,5,2,104358,104358,104360,0,2,3
29834,6,1,104364,104364,104365,0,1,4
29835,2,1,104366,104366,104367,0,1,1
29836,3,3,104369,104369,104372,0,3,2
29837,4,1,104373,104373,104374,0,1,1
29838,4,2,104377,104377,104379,0,2,3
29839,6,3,104383,104383,104386,0,3,4
29840,1,3,104384,104386,104389,2,5,0
29841,6,1,104390,104390,104391,0,1,1
29842,6,1,104396,104396,104397,0,1,5
29843,6,1,104402,104402,104403,0,1,5
29844,3,1,104405,104405,104406,0,1,2
29845,2,2,104407,104407,104409,0,2,1
29846,3,3,104410,104410,104413,0,3,1
29847,1,1,104411,104413,104414,2,3,0
29848,5,1,104416,104416,104417,0,1,2
29849,2,3,104418,104418,104421,0,3,1
29850,2,1,104420,104421,104422,1,2,0
29851,4,1,104424,104424,104425,0,1,2
29852,3,1,104427,104427,104428,0,1,2
29853,2,3,104429,104429,104432,0,3,1
29854,5,3,104434,104434,104437,0,3,2
29855,1,3,104435,104437,104440,2,5,0
29856,1,1,104436,104440,104441,4,5,0
29857,2,1,104438,104441,104442,3,4,0
29858,5,3,104443,104443,104446,0,3,1
29859,1,1,104444,104446,104447,2,3,0
29860,1,1,104445,104447,104448,2,3,0
29861,2,3,104447,104448,104451,1,4,0
29862,4,2,104451,104451,104453,0,2,0
29863,4,1,104455,104455,104456,0,1,2
29864,5,3,104460,104460,104463,0,3,4
29865,4,1,104464,104464,104465,0,1,1
29866,1,3,104465,104465,104468,0,3,0
29867,3,1,104468,104468,104469,0,1,0
29868,4,3,104472,104472,104475,0,3,3
29869,6,2,104478,104478,104480,0,2,3
29870,4,3,104482,104482,104485,0,3,2
29871,2,3,104484,104485,104488,1,4,0
29872,2,2,104486,104488,104490,2,4,0
29873,4,1,104490,104490,104491,0,1,0
29874,3,3,104493,104493,104496,0,3,2
29875,6,2,104499,104499,104501,0,2,3
29876,3,3,104502,104502,104505,0,3,1
29877,5,1,104507,104507,104508,0,1,2
29878,5,3,104512,104512,104515,0,3,4
29879,3,2,104515,104515,104517,0,2,0
29880,1,1,104516,104517,104518,1,2,0
29881,6,1,104522,104522,104523,0,1,4
29882,3,3,104525,104525,104528,0,3,2
29883,6,3,104531,104531,104534,0,3,3
29884,1,1,104532,104534,104535,2,3,0
29885,5,1,104537,104537,104538,0,1,2
29886,4,2,104541,104541,104543,0,2,3
29887,2,1,104543,104543,104544,0,1,0
29888,1,1,104544,104544,104545,0,1,0
29889,6,3,104550,104550,104553,0,3,5
29890,1,2,104551,104553,104555,2,4,0
29891,5,1,104556,104556,104557,0,1,1
29892,6,3,104562,104562,104565,0,3,5
29893,1,1,104563,104565,104566,2,3,0
29894,5,2,104568,104568,104570,0,2,2
29895,3,2,104571,104571,104573,0,2,1
29896,5,1,104576,104576,104577,0,1,3
29897,6,1,104582,104582,104583,0,1,5
29898,4,2,104586,104586,104588,0,2,3
29899,6,3,104592,104592,104595,0,3,4
29900,5,1,104597,104597,104598,0,1,2
29901,2,1,104599,104599,104600,0,1,1
29902,3,1,104602,104602,104603,0,1,2
29903,5,3,104607,104607,104610,0,3,4
29904,5,3,104612,104612,104615,0,3,2
29905,1,1,104613,104615,104616,2,3,0
29906,2,1,104615,104616,104617,1,2,0
29907,4,2,104619,104619,104621,0,2,2
29908,3,1,104622,104622,104623,0,1,1
29909,2,3,104624,104624,104627,0,3,1
29910,2,2,104626,104627,104629,1,3,0
29911,4,1,104630,104630,104631,0,1,1
29912,3,1,104633,104633,104634,0,1,2
29913,3,2,104636,104636,104638,0,2,2
29914,2,2,104638,104638,104640,0,2,0
29915,5,3,104643,104643,104646,0,3,3
29916,1,1,104644,104646,104647,2,3,0
29917,2,1,104646,104647,104648,1,2,0
29918,5,1,104651,104651,104652,0,1,3
29919,4,2,104655,104655,104657,0,2,3
29920,1,3,104656,104657,104660,1,4,0
29921,1,1,104657,104660,104661,3,4,0
29922,2,1,104659,104661,104662,2,3,0
29923,2,2,104661,104662,104664,1,3,0
29924,4,3,104665,104665,104668,0,3,1
29925,5,1,104670,104670,104671,0,1,2
29926,6,2,104676,104676,104678,0,2,5
29927,4,3,104680,104680,104683,0,3,2
29928,1,1,104681,104683,104684,2,3,0
29929,1,3,104682,104684,104687,2,5,0
29930,4,2,104686,104687,104689,1,3,0
29931,5,3,104691,104691,104694,0,3,2
29932,2,2,104693,104694,104696,1,3,0
29933,1,2,104694,104696,104698,2,4,0
29934,2,1,104696,104698,104699,2,3,0
29935,5,3,104701,104701,104704,0,3,2
29936,3,2,104704,104704,104706,0,2,0
29937,5,2,104709,104709,104711,0,2,3
29938,1,2,104710,104711,104713,1,3,0
29939,4,1,104714,104714,104715,0,1,1
29940,1,1,104715,104715,104716,0,1,0
29941,5,1,104720,104720,104721,0,1,4
29942,6,1,104726,104726,104727,0,1,5
29943,3,3,104729,104729,104732,0,3,2
29944,6,3,104735,104735,104738,0,3,3
29945,5,2,104740,104740,104742,0,2,2
29946,4,1,104744,104744,104745,0,1,2
29947,3,1,104747,104747,104748,0,1,2
29948,2,2,104749,104749,104751,0,2,1
29949,2,2,104751,104751,104753,0,2,0
29950,4,2,104755,104755,104757,0,2,2
29951,4,1,104759,104759,104760,0,1,2
29952,4,3,104763,104763,104766,0,3,3
29953,6,2,104769,104769,104771,0,2,3
29954,4,3,104773,104773,104776,0,3,2
29955,6,1,104779,104779,104780,0,1,3
29956,6,2,104785,104785,104787,0,2,5
29957,5,3,104790,104790,104793,0,3,3
29958,1,3,104791,104793,104796,2,5,0
29959,5,2,104796,104796,104798,0,2,0
29960,4,1,104800,104800,104801,0,1,2
29961,6,2,104806,104806,104808,0,2,5
29962,2,2,104808,104808,104810,0,2,0
29963,1,2,104809,104810,104812,1,3,0
29964,3,2,104812,104812,104814,0,2,0
29965,4,1,104816,104816,104817,0,1,2
29966,4,1,104820,104820,104821,0,1,3
29967,6,3,104826,104826,104829,0,3,5
29968,3,3,104829,104829,104832,0,3,0
29969,5,1,104834,104834,104835,0,1,2
29970,2,1,104836,104836,104837,0,1,1
29971,2,1,104838,104838,104839,0,1,1
29972,3,1,104841,104841,104842,0,1,2
29973,2,3,104843,104843,104846,0,3,1
29974,6,2,104849,104849,104851,0,2,3
29975,2,2,104851,104851,104853,0,2,0
29976,3,3,104854,104854,104857,0,3,1
29977,6,1,104860,104860,104861,0,1,3
29978,4,1,104864,104864,104865,0,1,3
29979,3,1,104867,104867,104868,0,1,2
29980,5,2,104872,104872,104874,0,2,4
29981,5,3,104877,104877,104880,0,3,3
29982,4,2,104881,104881,104883,0,2,1
29983,4,1,104885,104885,104886,0,1,2
29984,6,2,104891,104891,104893,0,2,5
29985,4,1,104895,104895,104896,0,1,2
29986,4,1,104899,104899,104900,0,1,3
29987,4,2,104903,104903,104905,0,2,3
29988,5,2,104908,104908,104910,0,2,3
29989,4,1,104912,104912,104913,0,1,2
29990,1,2,104913,104913,104915,0,2,0
29991,4,2,104917,104917,104919,0,2,2
29992,1,3,104918,104919,104922,1,4,0
29993,6,2,104924,104924,104926,0,2,2
29994,4,1,104928,104928,104929,0,1,2
29995,5,1,104933,104933,104934,0,1,4
29996,5,2,104938,104938,104940,0,2,4
29997,1,3,104939,104940,104943,1,4,0
29998,1,3,104940,104943,104946,3,6,0
29999,6,3,104946,104946,104949,0,3,0
30000,3,1,104949,104949,104950,0,1,0
30001,6,2,104955,104955,104957,0,2,5
30002,2,1,104957,104957,104958,0,1,0
30003,5,3,104962,104962,104965,0,3,4
30004,5,3,104967,104967,104970,0,3,2
30005,5,1,104972,104972,104973,0,1,2
30006,3,2,104975,104975,104977,0,2,2
30007,6,2,104981,104981,104983,0,2,4
30008,3,3,104984,104984,104987,0,3,1
30009,1,3,104985,104987,104990,2,5,0
30010,2,3,104987,104990,104993,3,6,0
30011,3,1,104990,104993,104994,3,4,0
30012,6,2,104996,104996,104998,0,2,2
30013,6,1,105002,105002,105003,0,1,4
30014,2,1,105004,105004,105005,0,1,1
30015,5,2,105009,105009,105011,0,2,4
30016,3,3,105012,105012,105015,0,3,1
30017,4,1,105016,105016,105017,0,1,1
30018,5,1,105021,105021,105022,0,1,4
30019,4,3,105025,105025,105028,0,3,3
30020,1,2,105026,105028,105030,2,4,0
30021,1,1,105027,105030,105031,3,4,0
30022,1,1,105028,105031,105032,3,4,0
30023,6,1,105034,105034,105035,0,1,2
30024,5,3,105039,105039,105042,0,3,4
30025,4,1,105043,105043,105044,0,1,1
30026,4,1,105047,105047,105048,0,1,3
30027,1,3,105048,105048,105051,0,3,0
30028,1,3,105049,105051,105054,2,5,0
30029,5,1,105054,105054,105055,0,1,0
30030,6,2,105060,105060,105062,0,2,5
30031,3,1,105063,105063,105064,0,1,1
30032,4,3,105067,105067,105070,0,3,3
30033,4,1,105071,105071,105072,0,1,1
30034,2,2,105073,105073,105075,0,2,1
30035,5,2,105078,105078,105080,0,2,3
30036,6,2,105084,105084,105086,0,2,4
30037,3,2,105087,105087,105089,0,2,1
30038,6,1,105093,105093,105094,0,1,4
30039,2,1,105095,105095,105096,0,1,1
30040,5,2,105100,105100,105102,0,2,4
30041,6,1,105106,105106,105107,0,1,4
30042,2,1,105108,105108,105109,0,1,1
30043,2,2,105110,105110,105112,0,2,1
30044,4,1,105114,105114,105115,0,1,2
30045,1,3,105115,105115,105118,0,3,0
30046,2,1,105117,105118,105119,1,2,0
30047,4,3,105121,105121,105124,0,3,2
30048,6,1,105127,105127,105128,0,1,3
30049,4,1,105131,105131,105132,0,1,3
30050,2,1,105133,105133,105134,0,1,1
30051,1,3,105134,105134,105137,0,3,0
30052,1,3,105135,105137,105140,2,5,0
30053,4,1,105139,105140,105141,1,2,0
30054,3,1,105142,105142,105143,0,1,1
30055,2,3,105144,105144,105147,0,3,1
30056,2,3,105146,105147,105150,1,4,0
30057,1,1,105147,105150,105151,3,4,0
30058,5,2,105152,105152,105154,0,2,1
30059,6,2,105158,105158,105160,0,2,4
30060,3,2,105161,105161,105163,0,2,1
30061,4,3,105165,105165,105168,0,3,2
30062,1,2,105166,105168,105170,2,4,0
30063,5,2,105171,105171,105173,0,2,1
30064,5,3,105176,105176,105179,0,3,3
30065,6,3,105182,105182,105185,0,3,3
30066,2,3,105184,105185,105188,1,4,0
30067,5,3,105189,105189,105192,0,3,1
30068,5,2,105194,105194,105196,0,2,2
30069,6,2,105200,105200,105202,0,2,4
30070,2,1,105202,105202,105203,0,1,0
30071,3,2,105205,105205,105207,0,2,2
30072,1,3,105206,105207,105210,1,4,0
30073,4,1,105210,105210,105211,0,1,0
30074,6,1,105216,105216,105217,0,1,5
30075,5,1,105221,105221,105222,0,1,4
30076,5,2,105226,105226,105228,0,2,4
30077,4,3,105230,105230,105233,0,3,2
30078,6,1,105236,105236,105237,0,1,3
30079,5,1,105241,105241,105242,0,1,4
30080,5,2,105246,105246,105248,0,2,4
30081,3,1,105249,105249,105250,0,1,1
30082,1,1,105250,105250,105251,0,1,0
30083,6,1,105256,105256,105257,0,1,5
30084,3,3,105259,105259,105262,0,3,2
30085,6,2,105265,105265,105267,0,2,3
30086,1,3,105266,105267,105270,1,4,0
30087,2,3,105268,105270,105273,2,5,0
30088,1,2,105269,105273,105275,4,6,0
30089,1,2,105270,105275,105277,5,7,0
30090,3,2,105273,105277,105279,4,6,0
30091,5,2,105278,105279,105281,1,3,0
30092,2,2,105280,105281,105283,1,3,0
30093,6,2,105286,105286,105288,0,2,3
30094,4,3,105290,105290,105293,0,3,2
30095,6,1,105296,105296,105297,0,1,3
30096,3,2,105299,105299,105301,0,2,2
30097,2,1,105301,105301,105302,0,1,0
30098,5,2,105306,105306,105308,0,2,4
30099,1,1,105307,105308,105309,1,2,0
30100,6,3,105313,105313,105316,0,3,4
30101,2,1,105315,105316,105317,1,2,0
30102,6,1,105321,105321,105322,0,1,4
30103,2,2,105323,105323,105325,0,2,1
30104,2,2,105325,105325,105327,0,2,0
30105,3,1,105328,105328,105329,0,1,1
30106,2,1,105330,105330,105331,0,1,1
30107,1,2,105331,105331,105333,0,2,0
30108,3,1,105334,105334,105335,0,1,1
30109,5,3,105339,105339,105342,0,3,4
30110,1,3,105340,105342,105345,2,5,0
30111,6,1,105346,105346,105347,0,1,1
30112,3,1,105349,105349,105350,0,1,2
30113,3,2,105352,105352,105354,0,2,2
30114,5,1,105357,105357,105358,0,1,3
30115,3,1,105360,105360,105361,0,1,2
30116,5,1,105365,105365,105366,0,1,4
30117,2,3,105367,105367,105370,0,3,1
30118,1,2,105368,105370,105372,2,4,0
30119,4,3,105372,105372,105375,0,3,0
30120,1,1,105373,105375,105376,2,3,0
30121,2,2,105375,105376,105378,1,3,0
30122,6,2,105381,105381,105383,0,2,3
30123,4,1,105385,105385,105386,0,1,2
30124,5,1,105390,105390,105391,0,1,4
30125,2,1,105392,105392,105393,0,1,1
30126,2,3,105394,105394,105397,0,3,1
30127,5,1,105399,105399,105400,0,1,2
30128,5,1,105404,105404,105405,0,1,4
30129,6,2,105410,105410,105412,0,2,5
30130,4,1,105414,105414,105415,0,1,2
30131,1,2,105415,105415,105417,0,2,0
30132,3,2,105418,105418,105420,0,2,1
30133,6,2,105424,105424,105426,0,2,4
30134,5,3,105429,105429,105432,0,3,3
30135,3,3,105432,105432,105435,0,3,0
30136,2,3,105434,105435,105438,1,4,0
30137,3,3,105437,105438,105441,1,4,0
30138,5,3,105442,105442,105445,0,3,1
30139,3,3,105445,105445,105448,0,3,0
30140,6,3,105451,105451,105454,0,3,3
30141,5,2,105456,105456,105458,0,2,2
30142,6,2,105462,105462,105464,0,2,4
30143,4,2,105466,105466,105468,0,2,2
30144,2,2,105468,105468,105470,0,2,0
30145,6,3,105474,105474,105477,0,3,4
30146,4,1,105478,105478,105479,0,1,1
30147,5,1,105483,105483,105484,0,1,4
30148,5,3,105488,105488,105491,0,3,4
30149,3,3,105491,105491,105494,0,3,0
30150,5,3,105496,105496,105499,0,3,2
30151,4,2,105500,105500,105502,0,2,1
30152,6,1,105506,105506,105507,0,1,4
30153,4,2,105510,105510,105512,0,2,3
30154,4,2,105514,105514,105516,0,2,2
30155,2,2,105516,105516,105518,0,2,0
30156,1,3,105517,105518,105521,1,4,0
30157,3,2,105520,105521,105523,1,3,0
30158,1,2,105521,105523,105525,2,4,0
30159,5,2,105526,105526,105528,0,2,1
30160,4,1,105530,105530,105531,0,1,2
30161,4,2,105534,105534,105536,0,2,3
30162,5,1,105539,105539,105540,0,1,3
30163,5,3,105544,105544,105547,0,3,4
30164,3,3,105547,105547,105550,0,3,0
30165,5,1,105552,105552,105553,0,1,2
30166,6,3,105558,105558,105561,0,3,5
30167,4,1,105562,105562,105563,0,1,1
30168,6,2,105568,105568,105570,0,2,5
30169,2,1,105570,105570,105571,0,1,0
30170,1,1,105571,105571,105572,0,1,0
30171,6,3,105577,105577,105580,0,3,5
30172,4,3,105581,105581,105584,0,3,1
30173,6,1,105587,105587,105588,0,1,3
30174,5,1,105592,105592,105593,0,1,4
30175,6,2,105598,105598,105600,0,2,5
30176,4,1,105602,105602,105603,0,1,2
30177,4,2,105606,105606,105608,0,2,3
30178,5,2,105611,105611,105613,0,2,3
30179,3,1,105614,105614,105615,0,1,1
30180,3,2,105617,105617,105619,0,2,2
30181,1,2,105618,105619,105621,1,3,0
30182,5,2,105623,105623,105625,0,2,2
30183,4,2,105627,105627,105629,0,2,2
30184,5,1,105632,105632,105633,0,1,3
30185,6,1,105638,105638,105639,0,1,5
30186,3,1,105641,105641,105642,0,1,2
30187,5,3,105646,105646,105649,0,3,4
30188,1,3,105647,105649,105652,2,5,0
30189,3,3,105650,105652,105655,2,5,0
30190,2,1,105652,105655,105656,3,4,0
30191,4,1,105656,105656,105657,0,1,0
30192,2,1,105658,105658,105659,0,1,1
30193,2,3,105660,105660,105663,0,3,1
30194,2,3,105662,105663,105666,1,4,0
30195,3,1,105665,105666,105667,1,2,0
30196,5,1,105670,105670,105671,0,1,3
30197,6,3,105676,105676,105679,0,3,5
30198,4,2,105680,105680,105682,0,2,1
30199,5,3,105685,105685,105688,0,3,3
30200,3,2,105688,105688,105690,0,2,0
30201,6,1,105694,105694,105695,0,1,4
30202,1,2,105695,105695,105697,0,2,0
30203,6,2,105701,105701,105703,0,2,4
30204,6,3,105707,105707,105710,0,3,4
30205,3,2,105710,105710,105712,0,2,0
30206,6,1,105716,105716,105717,0,1,4
30207,4,2,105720,105720,105722,0,2,3
30208,6,3,105726,105726,105729,0,3,4
30209,4,1,105730,105730,105731,0,1,1
30210,4,1,105734,105734,105735,0,1,3
30211,5,2,105739,105739,105741,0,2,4
30212,5,3,105744,105744,105747,0,3,3
30213,4,1,105748,105748,105749,0,1,1
30214,2,2,105750,105750,105752,0,2,1
30215,3,1,105753,105753,105754,0,1,1
30216,3,1,105756,105756,105757,0,1,2
30217,5,1,105761,105761,105762,0,1,4
30218,2,3,105763,105763,105766,0,3,1
30219,4,1,105767,105767,105768,0,1,1
30220,5,1,105772,105772,105773,0,1,4
30221,6,2,105778,105778,105780,0,2,5
30222,5,3,105783,105783,105786,0,3,3
30223,1,1,105784,105786,105787,2,3,0
30224,3,1,105787,105787,105788,0,1,0
30225,1,3,105788,105788,105791,0,3,0
30226,3,2,105791,105791,105793,0,2,0
30227,3,1,105794,105794,105795,0,1,1
30228,2,3,105796,105796,105799,0,3,1
30229,3,2,105799,105799,105801,0,2,0
30230,3,2,105802,105802,105804,0,2,1
30231,5,1,105807,105807,105808,0,1,3
30232,1,1,105808,105808,105809,0,1,0
30233,3,1,105811,105811,105812,0,1,2
30234,4,1,105815,105815,105816,0,1,3
30235,6,1,105821,105821,105822,0,1,5
30236,3,1,105824,105824,105825,0,1,2
30237,1,3,105825,105825,105828,0,3,0
30238,5,2,105830,105830,105832,0,2,2
30239,3,3,105833,105833,105836,0,3,1
30240,2,1,105835,105836,105837,1,2,0
30241,6,3,105841,105841,105844,0,3,4
30242,1,3,105842,105844,105847,2,5,0
30243,6,3,105848,105848,105851,0,3,1
30244,1,3,105849,105851,105854,2,5,0
30245,4,1,105853,105854,105855,1,2,0
30246,1,3,105854,105855,105858,1,4,0
30247,3,1,105857,105858,105859,1,2,0
30248,2,3,105859,105859,105862,0,3,0
30249,3,2,105862,105862,105864,0,2,0
30250,3,3,105865,105865,105868,0,3,1
30251,3,1,105868,105868,105869,0,1,0
30252,6,3,105874,105874,105877,0,3,5
30253,5,1,105879,105879,105880,0,1,2
30254,2,1,105881,105881,105882,0,1,1
30255,2,2,105883,105883,105885,0,2,1
30256,3,1,105886,105886,105887,0,1,1
30257,1,3,105887,105887,105890,0,3,0
30258,6,1,105893,105893,105894,0,1,3
30259,5,1,105898,105898,105899,0,1,4
30260,3,1,105901,105901,105902,0,1,2
30261,3,2,105904,105904,105906,0,2,2
30262,6,1,105910,105910,105911,0,1,4
30263,6,1,105916,105916,105917,0,1,5
30264,2,1,105918,105918,105919,0,1,1
30265,3,1,105921,105921,105922,0,1,2
30266,5,2,105926,105926,105928,0,2,4
30267,4,2,105930,105930,105932,0,2,2
30268,4,1,105934,105934,105935,0,1,2
30269,2,1,105936,105936,105937,0,1,1
30270,6,1,105942,105942,105943,0,1,5
30271,2,3,105944,105944,105947,0,3,1
30272,6,1,105950,105950,105951,0,1,3
30273,2,2,105952,105952,105954,0,2,1
30274,1,1,105953,105954,105955,1,2,0
30275,2,1,105955,105955,105956,0,1,0
30276,6,1,105961,105961,105962,0,1,5
30277,1,2,105962,105962,105964,0,2,0
30278,4,3,105966,105966,105969,0,3,2
30279,1,1,105967,105969,105970,2,3,0
30280,2,3,105969,105970,105973,1,4,0
30281,1,2,105970,105973,105975,3,5,0
30282,6,2,105976,105976,105978,0,2,1
30283,5,1,105981,105981,105982,0,1,3
30284,3,1,105984,105984,105985,0,1,2
30285,1,3,105985,105985,105988,0,3,0
30286,3,1,105988,105988,105989,0,1,0
30287,5,2,105993,105993,105995,0,2,4
30288,5,3,105998,105998,106001,0,3,3
30289,2,3,106000,106001,106004,1,4,0
30290,4,3,106004,106004,106007,0,3,0
30291,5,1,106009,106009,106010,0,1,2
30292,3,1,106012,106012,106013,0,1,2
30293,5,1,106017,106017,106018,0,1,4
30294,3,3,106020,106020,106023,0,3,2
30295,5,3,106025,106025,106028,0,3,2
30296,3,3,106028,106028,106031,0,3,0
30297,4,2,106032,106032,106034,0,2,1
30298,4,1,106036,106036,106037,0,1,2
30299,3,1,106039,106039,106040,0,1,2
30300,3,3,106042,106042,106045,0,3,2
30301,3,1,106045,106045,106046,0,1,0
30302,2,3,106047,106047,106050,0,3,1
30303,2,3,106049,106050,106053,1,4,0
30304,5,3,106054,106054,106057,0,3,1
30305,2,1,106056,106057,106058,1,2,0
30306,4,1,106060,106060,106061,0,1,2
30307,3,2,106063,106063,106065,0,2,2
30308,6,3,106069,106069,106072,0,3,4
30309,1,1,106070,106072,106073,2,3,0
30310,2,2,106072,106073,106075,1,3,0
30311,2,1,106074,106075,106076,1,2,0
30312,6,3,106080,106080,106083,0,3,4
30313,3,1,106083,106083,106084,0,1,0
30314,6,2,106089,106089,106091,0,2,5
30315,4,1,106093,106093,106094,0,1,2
30316,3,2,106096,106096,106098,0,2,2
30317,1,2,106097,106098,106100,1,3,0
30318,3,3,106100,106100,106103,0,3,0
30319,2,2,106102,106103,106105,1,3,0
30320,5,3,106107,106107,106110,0,3,2
30321,5,2,106112,106112,106114,0,2,2
30322,5,2,106117,106117,106119,0,2,3
30323,2,3,106119,106119,106122,0,3,0
30324,1,1,106120,106122,106123,2,3,0
30325,6,3,106126,106126,106129,0,3,3
30326,5,1,106131,106131,106132,0,1,2
30327,1,2,106132,106132,106134,0,2,0
30328,2,2,106134,106134,106136,0,2,0
30329,1,3,106135,106136,106139,1,4,0
30330,6,1,106141,106141,106142,0,1,2
30331,4,1,106145,106145,106146,0,1,3
30332,2,1,106147,106147,106148,0,1,1
30333,6,1,106153,106153,106154,0,1,5
30334,4,3,106157,106157,106160,0,3,3
30335,6,2,106163,106163,106165,0,2,3
30336,6,1,106169,106169,106170,0,1,4
30337,3,2,106172,106172,106174,0,2,2
30338,4,1,106176,106176,106177,0,1,2
30339,6,1,106182,106182,106183,0,1,5
30340,6,3,106188,106188,106191,0,3,5
30341,3,2,106191,106191,106193,0,2,0
30342,5,2,106196,106196,106198,0,2,3
30343,1,3,106197,106198,106201,1,4,0
30344,6,1,106203,106203,106204,0,1,2
30345,2,1,106205,106205,106206,0,1,1
30346,5,1,106210,106210,106211,0,1,4
30347,2,2,106212,106212,106214,0,2,1
30348,5,2,106217,106217,106219,0,2,3
30349,5,1,106222,106222,106223,0,1,3
30350,5,2,106227,106227,106229,0,2,4
30351,3,1,106230,106230,106231,0,1,1
30352,5,2,106235,106235,106237,0,2,4
30353,2,2,106237,106237,106239,0,2,0
30354,4,2,106241,106241,106243,0,2,2
30355,1,1,106242,106243,106244,1,2,0
30356,2,1,106244,106244,106245,0,1,0
30357,1,2,106245,106245,106247,0,2,0
30358,5,2,106250,106250,106252,0,2,3
30359,1,2,106251,106252,106254,1,3,0
30360,6,3,106257,106257,106260,0,3,3
30361,5,1,106262,106262,106263,0,1,2
30362,3,3,106265,106265,106268,0,3,2
30363,4,1,106269,106269,106270,0,1,1
30364,4,2,106273,106273,106275,0,2,3
30365,1,2,106274,106275,106277,1,3,0
30366,6,3,106280,106280,106283,0,3,3
30367,3,2,106283,106283,106285,0,2,0
30368,5,2,106288,106288,106290,0,2,3
30369,3,3,106291,106291,106294,0,3,1
30370,2,2,106293,106294,106296,1,3,0
30371,3,1,106296,106296,106297,0,1,0
30372,5,3,106301,106301,106304,0,3,4
30373,2,1,106303,106304,106305,1,2,0
30374,2,2,106305,106305,106307,0,2,0
30375,6,2,106311,106311,106313,0,2,4
30376,2,3,106313,106313,106316,0,3,0
30377,1,3,106314,106316,106319,2,5,0
30378,4,2,106318,106319,106321,1,3,0
30379,1,1,106319,106321,106322,2,3,0
30380,2,1,106321,106322,106323,1,2,0
30381,4,1,106325,106325,106326,0,1,2
30382,1,3,106326,106326,106329,0,3,0
30383,6,1,106332,106332,106333,0,1,3
30384,2,3,106334,106334,106337,0,3,1
30385,4,3,106338,106338,106341,0,3,1
30386,5,1,106343,106343,106344,0,1,2
30387,4,2,106347,106347,106349,0,2,3
30388,3,2,106350,106350,106352,0,2,1
30389,5,2,106355,106355,106357,0,2,3
30390,5,2,106360,106360,106362,0,2,3
30391,1,1,106361,106362,106363,1,2,0
30392,6,1,106367,106367,106368,0,1,4
30393,3,3,106370,106370,106373,0,3,2
30394,5,1,106375,106375,106376,0,1,2
30395,4,3,106379,106379,106382,0,3,3
30396,6,1,106385,106385,106386,0,1,3
30397,4,1,106389,106389,106390,0,1,3
30398,5,3,106394,106394,106397,0,3,4
30399,4,3,106398,106398,106401,0,3,1
30400,3,1,106401,106401,106402,0,1,0
30401,5,1,106406,106406,106407,0,1,4
30402,3,2,106409,106409,106411,0,2,2
30403,5,2,106414,106414,106416,0,2,3
30404,3,2,106417,106417,106419,0,2,1
30405,4,2,106421,106421,106423,0,2,2
30406,2,1,106423,106423,106424,0,1,0
30407,1,2,106424,106424,106426,0,2,0
30408,5,3,106429,106429,106432,0,3,3
30409,5,3,106434,106434,106437,0,3,2
30410,2,3,106436,106437,106440,1,4,0
30411,6,3,106442,106442,106445,0,3,2
30412,4,3,106446,106446,106449,0,3,1
30413,5,1,106451,106451,106452,0,1,2
30414,4,2,106455,106455,106457,0,2,3
30415,3,3,106458,106458,106461,0,3,1
30416,2,3,106460,106461,106464,1,4,0
30417,6,1,106466,106466,106467,0,1,2
30418,5,3,106471,106471,106474,0,3,4
30419,1,1,106472,106474,106475,2,3,0
30420,3,1,106475,106475,106476,0,1,0
30421,5,3,106480,106480,106483,0,3,4
30422,3,3,106483,106483,106486,0,3,0
30423,4,2,106487,106487,106489,0,2,1
30424,6,2,106493,106493,106495,0,2,4
30425,2,3,106495,106495,106498,0,3,0
30426,4,2,106499,106499,106501,0,2,1
30427,6,2,106505,106505,106507,0,2,4
30428,4,2,106509,106509,106511,0,2,2
30429,2,1,106511,106511,106512,0,1,0
30430,2,2,106513,106513,106515,0,2,1
30431,2,3,106515,106515,106518,0,3,0
30432,5,3,106520,106520,106523,0,3,2
30433,4,2,106524,106524,106526,0,2,1
30434,2,2,106526,106526,106528,0,2,0
30435,1,1,106527,106528,106529,1,2,0
30436,3,3,106530,106530,106533,0,3,1
30437,3,1,106533,106533,106534,0,1,0
30438,6,1,106539,106539,106540,0,1,5
30439,6,2,106545,106545,106547,0,2,5
30440,5,3,106550,106550,106553,0,3,3
30441,4,3,106554,106554,106557,0,3,1
30442,1,2,106555,106557,106559,2,4,0
30443,4,2,106559,106559,106561,0,2,0
30444,1,3,106560,106561,106564,1,4,0
30445,2,2,106562,106564,106566,2,4,0
30446,2,1,106564,106566,106567,2,3,0
30447,1,2,106565,106567,106569,2,4,0
30448,1,1,106566,106569,106570,3,4,0
30449,6,1,106572,106572,106573,0,1,2
30450,4,3,106576,106576,106579,0,3,3
30451,6,2,106582,106582,106584,0,2,3
30452,4,2,106586,106586,106588,0,2,2
30453,6,2,106592,106592,106594,0,2,4
30454,3,2,106595,106595,106597,0,2,1
30455,5,2,106600,106600,106602,0,2,3
30456,3,1,106603,106603,106604,0,1,1
30457,2,1,106605,106605,106606,0,1,1
30458,6,3,106611,106611,106614,0,3,5
30459,2,3,106613,106614,106617,1,4,0
30460,3,2,106616,106617,106619,1,3,0
30461,5,1,106621,106621,106622,0,1,2
30462,2,1,106623,106623,106624,0,1,1
30463,3,1,106626,106626,106627,0,1,2
30464,1,1,106627,106627,106628,0,1,0
30465,6,2,106633,106633,106635,0,2,5
30466,1,3,106634,106635,106638,1,4,0
30467,2,1,106636,106638,106639,2,3,0
30468,1,2,106637,106639,106641,2,4,0
30469,2,1,106639,106641,106642,2,3,0
30470,5,1,106644,106644,106645,0,1,2
30471,6,1,106650,106650,106651,0,1,5
30472,6,3,106656,106656,106659,0,3,5
30473,2,3,106658,106659,106662,1,4,0
30474,5,2,106663,106663,106665,0,2,1
30475,5,2,106668,106668,106670,0,2,3
30476,1,1,106669,106670,106671,1,2,0
30477,2,2,106671,106671,106673,0,2,0
30478,2,3,106673,106673,106676,0,3,0
30479,6,3,106679,106679,106682,0,3,3
30480,6,1,106685,106685,106686,0,1,3
30481,5,2,106690,106690,106692,0,2,4
30482,5,3,106695,106695,106698,0,3,3
30483,2,2,106697,106698,106700,1,3,0
30484,6,2,106703,106703,106705,0,2,3
30485,5,1,106708,106708,106709,0,1,3
30486,5,1,106713,106713,106714,0,1,4
30487,1,2,106714,106714,106716,0,2,0
30488,6,1,106720,106720,106721,0,1,4
30489,4,3,106724,106724,106727,0,3,3
30490,1,3,106725,106727,106730,2,5,0
30491,3,3,106728,106730,106733,2,5,0
30492,4,3,106732,106733,106736,1,4,0
30493,3,2,106735,106736,106738,1,3,0
30494,1,2,106736,106738,106740,2,4,0
30495,6,3,106742,106742,106745,0,3,2
30496,3,2,106745,106745,106747,0,2,0
30497,6,3,106751,106751,106754,0,3,4
30498,3,2,106754,106754,106756,0,2,0
30499,2,2,106756,106756,106758,0,2,0
30500,3,3,106759,106759,106762,0,3,1
30501,6,2,106765,106765,106767,0,2,3
30502,6,2,106771,106771,106773,0,2,4
30503,3,2,106774,106774,106776,0,2,1
30504,5,2,106779,106779,106781,0,2,3
30505,3,1,106782,106782,106783,0,1,1
30506,1,1,106783,106783,106784,0,1,0
30507,3,3,106786,106786,106789,0,3,2
30508,6,3,106792,106792,106795,0,3,3
30509,5,1,106797,106797,106798,0,1,2
30510,2,1,106799,106799,106800,0,1,1
30511,4,1,106803,106803,106804,0,1,3
30512,2,1,106805,106805,106806,0,1,1
30513,3,3,106808,106808,106811,0,3,2
30514,4,2,106812,106812,106814,0,2,1
30515,1,1,106813,106814,106815,1,2,0
30516,1,2,106814,106815,106817,1,3,0
30517,5,2,106819,106819,106821,0,2,2
30518,1,2,106820,106821,106823,1,3,0
30519,3,3,106823,106823,106826,0,3,0
30520,6,3,106829,106829,106832,0,3,3
30521,3,2,106832,106832,106834,0,2,0
30522,2,2,106834,106834,106836,0,2,0
30523,3,2,106837,106837,106839,0,2,1
30524,2,1,106839,106839,106840,0,1,0
30525,3,2,106842,106842,106844,0,2,2
30526,4,3,106846,106846,106849,0,3,2
30527,2,2,106848,106849,106851,1,3,0
30528,5,1,106853,106853,106854,0,1,2
30529,1,1,106854,106854,106855,0,1,0
30530,5,2,106859,106859,106861,0,2,4
30531,3,2,106862,106862,106864,0,2,1
30532,3,1,106865,106865,106866,0,1,1
30533,1,2,106866,106866,106868,0,2,0
30534,3,1,106869,106869,106870,0,1,1
30535,3,3,106872,106872,106875,0,3,2
30536,4,2,106876,106876,106878,0,2,1
30537,4,3,106880,106880,106883,0,3,2
30538,1,3,106881,106883,106886,2,5,0
30539,4,3,106885,106886,106889,1,4,0
30540,2,1,106887,106889,106890,2,3,0
30541,2,1,106889,106890,106891,1,2,0
30542,2,1,106891,106891,106892,0,1,0
30543,4,2,106895,106895,106897,0,2,3
30544,1,2,106896,106897,106899,1,3,0
30545,3,3,106899,106899,106902,0,3,0
30546,6,1,106905,106905,106906,0,1,3
30547,3,3,106908,106908,106911,0,3,2
30548,2,1,106910,106911,106912,1,2,0
30549,1,1,106911,106912,106913,1,2,0
30550,5,1,106916,106916,106917,0,1,3
30551,3,2,106919,106919,106921,0,2,2
30552,1,2,106920,106921,106923,1,3,0
30553,4,2,106924,106924,106926,0,2,1
30554,6,1,106930,106930,106931,0,1,4
30555,6,1,106936,106936,106937,0,1,5
30556,1,2,106937,106937,106939,0,2,0
30557,1,3,106938,106939,106942,1,4,0
30558,1,1,106939,106942,106943,3,4,0
30559,1,3,106940,106943,106946,3,6,0
30560,1,3,106941,106946,106949,5,8,0
30561,2,1,106943,106949,106950,6,7,0
30562,2,2,106945,106950,106952,5,7,0
30563,4,2,106949,106952,106954,3,5,0
30564,2,3,106951,106954,106957,3,6,0
30565,5,3,106956,106957,106960,1,4,0
30566,4,3,106960,106960,106963,0,3,0
30567,1,2,106961,106963,106965,2,4,0
30568,6,1,106967,106967,106968,0,1,2
30569,5,1,106972,106972,106973,0,1,4
30570,4,3,106976,106976,106979,0,3,3
30571,4,1,106980,106980,106981,0,1,1
30572,2,3,106982,106982,106985,0,3,1
30573,3,2,106985,106985,106987,0,2,0
30574,1,3,106986,106987,106990,1,4,0
30575,3,1,106989,106990,106991,1,2,0
30576,1,1,106990,106991,106992,1,2,0
30577,1,1,106991,106992,106993,1,2,0
30578,5,3,106996,106996,106999,0,3,3
30579,4,1,107000,107000,107001,0,1,1
30580,4,3,107004,107004,107007,0,3,3
30581,4,1,107008,107008,107009,0,1,1
30582,3,3,107011,107011,107014,0,3,2
30583,6,3,107017,107017,107020,0,3,3
30584,4,3,107021,107021,107024,0,3,1
30585,6,2,107027,107027,107029,0,2,3
30586,1,3,107028,107029,107032,1,4,0
30587,1,2,107029,107032,107034,3,5,0
30588,3,3,107032,107034,107037,2,5,0
30589,2,3,107034,107037,107040,3,6,0
30590,5,2,107039,107040,107042,1,3,0
30591,1,3,107040,107042,107045,2,5,0
30592,1,3,107041,107045,107048,4,7,0
30593,6,2,107047,107048,107050,1,3,0
30594,4,1,107051,107051,107052,0,1,1
30595,5,3,107056,107056,107059,0,3,4
30596,6,2,107062,107062,107064,0,2,3
30597,2,3,107064,107064,107067,0,3,0
30598,5,2,107069,107069,107071,0,2,2
30599,2,2,107071,107071,107073,0,2,0
30600,1,1,107072,107073,107074,1,2,0
30601,4,2,107076,107076,107078,0,2,2
30602,5,2,107081,107081,107083,0,2,3
30603,1,2,107082,107083,107085,1,3,0
30604,1,3,107083,107085,107088,2,5,0
30605,4,3,107087,107088,107091,1,4,0
30606,1,3,107088,107091,107094,3,6,0
30607,1,3,107089,107094,107097,5,8,0
30608,6,2,107095,107097,107099,2,4,0
30609,4,3,107099,107099,107102,0,3,0
30610,1,3,107100,107102,107105,2,5,0
30611,6,1,107106,107106,107107,0,1,1
30612,2,3,107108,107108,107111,0,3,1
30613,4,1,107112,107112,107113,0,1,1
30614,4,3,107116,107116,107119,0,3,3
30615,1,1,107117,107119,107120,2,3,0
30616,6,3,107123,107123,107126,0,3,3
30617,6,2,107129,107129,107131,0,2,3
30618,1,1,107130,107131,107132,1,2,0
30619,4,2,107134,107134,107136,0,2,2
30620,4,1,107138,107138,107139,0,1,2
30621,5,3,107143,107143,107146,0,3,4
30622,1,2,107144,107146,107148,2,4,0
30623,2,2,107146,107148,107150,2,4,0
30624,4,2,107150,107150,107152,0,2,0
30625,1,1,107151,107152,107153,1,2,0
30626,1,3,107152,107153,107156,1,4,0
30627,1,3,107153,107156,107159,3,6,0
30628,1,3,107154,107159,107162,5,8,0
30629,2,2,107156,107162,107164,6,8,0
30630,3,1,107159,107164,107165,5,6,0
30631,2,3,107161,107165,107168,4,7,0
30632,5,3,107166,107168,107171,2,5,0
30633,2,2,107168,107171,107173,3,5,0
30634,6,3,107174,107174,107177,0,3,1
30635,3,2,107177,107177,107179,0,2,0
30636,4,1,107181,107181,107182,0,1,2
30637,1,1,107182,107182,107183,0,1,0
30638,6,1,107188,107188,107189,0,1,5
30639,3,1,107191,107191,107192,0,1,2
30640,1,3,107192,107192,107195,0,3,0
30641,2,1,107194,107195,107196,1,2,0
30642,6,1,107200,107200,107201,0,1,4
30643,2,2,107202,107202,107204,0,2,1
30644,6,2,107208,107208,107210,0,2,4
30645,5,2,107213,107213,107215,0,2,3
30646,6,1,107219,107219,107220,0,1,4
30647,5,1,107224,107224,107225,0,1,4
30648,1,2,107225,107225,107227,0,2,0
30649,4,3,107229,107229,107232,0,3,2
30650,3,3,107232,107232,107235,0,3,0
30651,3,1,107235,107235,107236,0,1,0
30652,1,2,107236,107236,107238,0,2,0
30653,6,3,107242,107242,107245,0,3,4
30654,1,2,107243,107245,107247,2,4,0
30655,4,3,107247,107247,107250,0,3,0
30656,5,1,107252,107252,107253,0,1,2
30657,3,3,107255,107255,107258,0,3,2
30658,1,1,107256,107258,107259,2,3,0
30659,6,2,107262,107262,107264,0,2,3
30660,6,1,107268,107268,107269,0,1,4
30661,6,1,107274,107274,107275,0,1,5
30662,2,3,107276,107276,107279,0,3,1
30663,4,2,107280,107280,107282,0,2,1
30664,4,2,107284,107284,107286,0,2,2
30665,2,3,107286,107286,107289,0,3,0
30666,2,3,107288,107289,107292,1,4,0
30667,3,2,107291,107292,107294,1,3,0
30668,5,1,107296,107296,107297,0,1,2
30669,4,3,107300,107300,107303,0,3,3
30670,5,3,107305,107305,107308,0,3,2
30671,6,1,107311,107311,107312,0,1,3
30672,1,1,107312,107312,107313,0,1,0
30673,2,2,107314,107314,107316,0,2,1
30674,6,3,107320,107320,107323,0,3,4
30675,6,3,107326,107326,107329,0,3,3
30676,1,1,107327,107329,107330,2,3,0
30677,2,3,107329,107330,107333,1,4,0
30678,3,1,107332,107333,107334,1,2,0
30679,6,1,107338,107338,107339,0,1,4
30680,4,1,107342,107342,107343,0,1,3
30681,6,2,107348,107348,107350,0,2,5
30682,1,3,107349,107350,107353,1,4,0
30683,6,2,107355,107355,107357,0,2,2
30684,1,1,107356,107357,107358,1,2,0
30685,3,2,107359,107359,107361,0,2,1
30686,5,2,107364,107364,107366,0,2,3
30687,5,2,107369,107369,107371,0,2,3
30688,5,2,107374,107374,107376,0,2,3
30689,2,1,107376,107376,107377,0,1,0
30690,3,1,107379,107379,107380,0,1,2
30691,2,2,107381,107381,107383,0,2,1
30692,6,3,107387,107387,107390,0,3,4
30693,5,2,107392,107392,107394,0,2,2
30694,2,1,107394,107394,107395,0,1,0
30695,6,1,107400,107400,107401,0,1,5
30696,3,1,107403,107403,107404,0,1,2
30697,4,3,107407,107407,107410,0,3,3
30698,5,1,107412,107412,107413,0,1,2
30699,1,3,107413,107413,107416,0,3,0
30700,2,1,107415,107416,107417,1,2,0
30701,1,2,107416,107417,107419,1,3,0
30702,2,1,107418,107419,107420,1,2,0
30703,2,2,107420,107420,107422,0,2,0
30704,5,1,107425,107425,107426,0,1,3
30705,5,3,107430,107430,107433,0,3,4
30706,5,2,107435,107435,107437,0,2,2
30707,5,1,107440,107440,107441,0,1,3
30708,5,1,107445,107445,107446,0,1,4
30709,6,3,107451,107451,107454,0,3,5
30710,1,1,107452,107454,107455,2,3,0
30711,2,2,107454,107455,107457,1,3,0
30712,6,2,107460,107460,107462,0,2,3
30713,2,1,107462,107462,107463,0,1,0
30714,2,2,107464,107464,107466,0,2,1
30715,6,2,107470,107470,107472,0,2,4
30716,1,3,107471,107472,107475,1,4,0
30717,3,2,107474,107475,107477,1,3,0
30718,1,3,107475,107477,107480,2,5,0
30719,4,1,107479,107480,107481,1,2,0
30720,1,1,107480,107481,107482,1,2,0
30721,1,3,107481,107482,107485,1,4,0
30722,2,1,107483,107485,107486,2,3,0
30723,2,1,107485,107486,107487,1,2,0
30724,4,1,107489,107489,107490,0,1,2
30725,5,1,107494,107494,107495,0,1,4
30726,6,2,107500,107500,107502,0,2,5
30727,3,2,107503,107503,107505,0,2,1
30728,3,2,107506,107506,107508,0,2,1
30729,2,3,107508,107508,107511,0,3,0
30730,2,3,107510,107511,107514,1,4,0
30731,1,3,107511,107514,107517,3,6,0
30732,2,3,107513,107517,107520,4,7,0
30733,5,1,107518,107520,107521,2,3,0
30734,4,3,107522,107522,107525,0,3,1
30735,4,1,107526,107526,107527,0,1,1
30736,5,3,107531,107531,107534,0,3,4
30737,5,1,107536,107536,107537,0,1,2
30738,6,3,107542,107542,107545,0,3,5
30739,6,1,107548,107548,107549,0,1,3
30740,5,2,107553,107553,107555,0,2,4
30741,2,1,107555,107555,107556,0,1,0
30742,2,3,107557,107557,107560,0,3,1
30743,2,2,107559,107560,107562,1,3,0
30744,4,3,107563,107563,107566,0,3,1
30745,1,1,107564,107566,107567,2,3,0
30746,5,2,107569,107569,107571,0,2,2
30747,6,2,107575,107575,107577,0,2,4
30748,1,1,107576,107577,107578,1,2,0
30749,5,2,107581,107581,107583,0,2,3
30750,5,3,107586,107586,107589,0,3,3
30751,1,2,107587,107589,107591,2,4,0
30752,6,3,107593,107593,107596,0,3,2
30753,4,1,107597,107597,107598,0,1,1
30754,6,2,107603,107603,107605,0,2,5
30755,5,1,107608,107608,107609,0,1,3
30756,3,3,107611,107611,107614,0,3,2
30757,3,3,107614,107614,107617,0,3,0
30758,5,2,107619,107619,107621,0,2,2
30759,4,1,107623,107623,107624,0,1,2
30760,1,2,107624,107624,107626,0,2,0
30761,2,1,107626,107626,107627,0,1,0
30762,6,3,107632,107632,107635,0,3,5
30763,4,2,107636,107636,107638,0,2,1
30764,2,1,107638,107638,107639,0,1,0
30765,1,3,107639,107639,107642,0,3,0
30766,2,1,107641,107642,107643,1,2,0
30767,4,1,107645,107645,107646,0,1,2
30768,4,2,107649,107649,107651,0,2,3
30769,6,1,107655,107655,107656,0,1,4
30770,2,3,107657,107657,107660,0,3,1
30771,1,2,107658,107660,107662,2,4,0
30772,2,2,107660,107662,107664,2,4,0
30773,1,3,107661,107664,107667,3,6,0
30774,2,3,107663,107667,107670,4,7,0
30775,1,1,107664,107670,107671,6,7,0
30776,1,3,107665,107671,107674,6,9,0
30777,6,2,107671,107674,107676,3,5,0
30778,6,2,107677,107677,107679,0,2,1
30779,1,2,107678,107679,107681,1,3,0
30780,6,2,107684,107684,107686,0,2,3
30781,2,3,107686,107686,107689,0,3,0
30782,1,1,107687,107689,107690,2,3,0
30783,3,1,107690,107690,107691,0,1,0
30784,2,1,107692,107692,107693,0,1,1
30785,4,3,107696,107696,107699,0,3,3
30786,2,2,107698,107699,107701,1,3,0
30787,1,3,107699,107701,107704,2,5,0
30788,4,1,107703,107704,107705,1,2,0
30789,3,2,107706,107706,107708,0,2,1
30790,4,2,107710,107710,107712,0,2,2
30791,3,2,107713,107713,107715,0,2,1
30792,4,3,107717,107717,107720,0,3,2
30793,5,1,107722,107722,107723,0,1,2
30794,1,3,107723,107723,107726,0,3,0
30795,6,1,107729,107729,107730,0,1,3
30796,4,3,107733,107733,107736,0,3,3
30797,1,1,107734,107736,107737,2,3,0
30798,2,3,107736,107737,107740,1,4,0
30799,5,1,107741,107741,107742,0,1,1
30800,4,1,107745,107745,107746,0,1,3
30801,2,3,107747,107747,107750,0,3,1
30802,2,1,107749,107750,107751,1,2,0
30803,5,2,107754,107754,107756,0,2,3
30804,2,2,107756,107756,107758,0,2,0
30805,5,2,107761,107761,107763,0,2,3
30806,3,3,107764,107764,107767,0,3,1
30807,4,1,107768,107768,107769,0,1,1
30808,5,3,107773,107773,107776,0,3,4
30809,2,3,107775,107776,107779,1,4,0
30810,2,2,107777,107779,107781,2,4,0
30811,1,2,107778,107781,107783,3,5,0
30812,1,3,107779,107783,107786,4,7,0
30813,3,1,107782,107786,107787,4,5,0
30814,4,2,107786,107787,107789,1,3,0
30815,1,3,107787,107789,107792,2,5,0
30816,4,2,107791,107792,107794,1,3,0
30817,4,3,107795,107795,107798,0,3,1
30818,1,1,107796,107798,107799,2,3,0
30819,6,2,107802,107802,107804,0,2,3
30820,2,1,107804,107804,107805,0,1,0
30821,3,3,107807,107807,107810,0,3,2
30822,3,3,107810,107810,107813,0,3,0
30823,3,1,107813,107813,107814,0,1,0
30824,3,3,107816,107816,107819,0,3,2
30825,1,3,107817,107819,107822,2,5,0
30826,2,1,107819,107822,107823,3,4,0
30827,3,1,107822,107823,107824,1,2,0
30828,5,3,107827,107827,107830,0,3,3
30829,1,3,107828,107830,107833,2,5,0
30830,4,3,107832,107833,107836,1,4,0
30831,6,1,107838,107838,107839,0,1,2
30832,3,1,107841,107841,107842,0,1,2
30833,2,2,107843,107843,107845,0,2,1
30834,3,3,107846,107846,107849,0,3,1
30835,3,3,107849,107849,107852,0,3,0
30836,3,3,107852,107852,107855,0,3,0
30837,3,1,107855,107855,107856,0,1,0
30838,3,3,107858,107858,107861,0,3,2
30839,2,1,107860,107861,107862,1,2,0
30840,5,1,107865,107865,107866,0,1,3
30841,4,3,107869,107869,107872,0,3,3
30842,6,3,107875,107875,107878,0,3,3
30843,5,3,107880,107880,107883,0,3,2
30844,1,2,107881,107883,107885,2,4,0
30845,5,3,107886,107886,107889,0,3,1
30846,6,3,107892,107892,107895,0,3,3
30847,6,1,107898,107898,107899,0,1,3
30848,1,1,107899,107899,107900,0,1,0
30849,2,3,107901,107901,107904,0,3,1
30850,6,3,107907,107907,107910,0,3,3
30851,2,3,107909,107910,107913,1,4,0
30852,5,1,107914,107914,107915,0,1,1
30853,4,3,107918,107918,107921,0,3,3
30854,6,1,107924,107924,107925,0,1,3
30855,6,3,107930,107930,107933,0,3,5
30856,4,3,107934,107934,107937,0,3,1
30857,1,3,107935,107937,107940,2,5,0
30858,5,3,107940,107940,107943,0,3,0
30859,5,3,107945,107945,107948,0,3,2
30860,4,2,107949,107949,107951,0,2,1
30861,4,2,107953,107953,107955,0,2,2
30862,6,2,107959,107959,107961,0,2,4
30863,5,3,107964,107964,107967,0,3,3
30864,6,3,107970,107970,107973,0,3,3
30865,3,2,107973,107973,107975,0,2,0
30866,2,3,107975,107975,107978,0,3,0
30867,1,2,107976,107978,107980,2,4,0
30868,1,1,107977,107980,107981,3,4,0
30869,4,2,107981,107981,107983,0,2,0
30870,2,2,107983,107983,107985,0,2,0
30871,6,3,107989,107989,107992,0,3,4
30872,1,2,107990,107992,107994,2,4,0
30873,4,3,107994,107994,107997,0,3,0
30874,4,1,107998,107998,107999,0,1,1
30875,2,1,108000,108000,108001,0,1,1
30876,4,2,108004,108004,108006,0,2,3
30877,1,3,108005,108006,108009,1,4,0
30878,3,3,108008,108009,108012,1,4,0
30879,4,2,108012,108012,108014,0,2,0
30880,1,3,108013,108014,108017,1,4,0
30881,3,1,108016,108017,108018,1,2,0
30882,4,3,108020,108020,108023,0,3,2
30883,3,3,108023,108023,108026,0,3,0
30884,4,3,108027,108027,108030,0,3,1
30885,1,1,108028,108030,108031,2,3,0
30886,1,1,108029,108031,108032,2,3,0
30887,6,3,108035,108035,108038,0,3,3
30888,6,3,108041,108041,108044,0,3,3
30889,3,2,108044,108044,108046,0,2,0
30890,6,2,108050,108050,108052,0,2,4
30891,6,1,108056,108056,108057,0,1,4
30892,4,3,108060,108060,108063,0,3,3
30893,6,1,108066,108066,108067,0,1,3
30894,4,2,108070,108070,108072,0,2,3
30895,1,1,108071,108072,108073,1,2,0
30896,4,2,108075,108075,108077,0,2,2
30897,5,2,108080,108080,108082,0,2,3
30898,4,1,108084,108084,108085,0,1,2
30899,3,1,108087,108087,108088,0,1,2
30900,2,3,108089,108089,108092,0,3,1
30901,5,2,108094,108094,108096,0,2,2
30902,6,3,108100,108100,108103,0,3,4
30903,1,3,108101,108103,108106,2,5,0
30904,6,1,108107,108107,108108,0,1,1
30905,1,1,108108,108108,108109,0,1,0
30906,4,1,108112,108112,108113,0,1,3
30907,6,3,108118,108118,108121,0,3,5
30908,2,2,108120,108121,108123,1,3,0
30909,4,1,108124,108124,108125,0,1,1
30910,4,3,108128,108128,108131,0,3,3
30911,1,1,108129,108131,108132,2,3,0
30912,5,2,108134,108134,108136,0,2,2
30913,5,2,108139,108139,108141,0,2,3
30914,5,3,108144,108144,108147,0,3,3
30915,2,3,108146,108147,108150,1,4,0
30916,2,2,108148,108150,108152,2,4,0
30917,2,2,108150,108152,108154,2,4,0
30918,4,2,108154,108154,108156,0,2,0
30919,4,3,108158,108158,108161,0,3,2
30920,2,3,108160,108161,108164,1,4,0
30921,2,1,108162,108164,108165,2,3,0
30922,1,3,108163,108165,108168,2,5,0
30923,1,1,108164,108168,108169,4,5,0
30924,2,2,108166,108169,108171,3,5,0
30925,2,3,108168,108171,108174,3,6,0
30926,4,1,108172,108174,108175,2,3,0
30927,6,2,108178,108178,108180,0,2,3
30928,2,2,108180,108180,108182,0,2,0
30929,2,1,108182,108182,108183,0,1,0
30930,6,2,108188,108188,108190,0,2,5
30931,2,2,108190,108190,108192,0,2,0
30932,2,3,108192,108192,108195,0,3,0
30933,2,1,108194,108195,108196,1,2,0
30934,3,2,108197,108197,108199,0,2,1
30935,6,3,108203,108203,108206,0,3,4
30936,3,2,108206,108206,108208,0,2,0
30937,4,3,108210,108210,108213,0,3,2
30938,6,1,108216,108216,108217,0,1,3
30939,3,3,108219,108219,108222,0,3,2
30940,5,2,108224,108224,108226,0,2,2
30941,5,1,108229,108229,108230,0,1,3
30942,2,2,108231,108231,108233,0,2,1
30943,5,1,108236,108236,108237,0,1,3
30944,2,1,108238,108238,108239,0,1,1
30945,6,2,108244,108244,108246,0,2,5
30946,5,2,108249,108249,108251,0,2,3
30947,5,2,108254,108254,108256,0,2,3
30948,2,1,108256,108256,108257,0,1,0
30949,4,1,108260,108260,108261,0,1,3
30950,3,3,108263,108263,108266,0,3,2
30951,2,3,108265,108266,108269,1,4,0
30952,1,3,108266,108269,108272,3,6,0
30953,2,2,108268,108272,108274,4,6,0
30954,1,1,108269,108274,108275,5,6,0
30955,1,2,108270,108275,108277,5,7,0
30956,6,2,108276,108277,108279,1,3,0
30957,1,1,108277,108279,108280,2,3,0
30958,6,1,108283,108283,108284,0,1,3
30959,4,1,108287,108287,108288,0,1,3
30960,4,1,108291,108291,108292,0,1,3
30961,4,1,108295,108295,108296,0,1,3
30962,6,1,108301,108301,108302,0,1,5
30963,1,1,108302,108302,108303,0,1,0
30964,1,2,108303,108303,108305,0,2,0
30965,1,3,108304,108305,108308,1,4,0
30966,6,1,108310,108310,108311,0,1,2
30967,1,2,108311,108311,108313,0,2,0
30968,2,2,108313,108313,108315,0,2,0
30969,2,2,108315,108315,108317,0,2,0
30970,1,3,108316,108317,108320,1,4,0
30971,5,2,108321,108321,108323,0,2,1
30972,5,1,108326,108326,108327,0,1,3
30973,5,1,108331,108331,108332,0,1,4
30974,5,2,108336,108336,108338,0,2,4
30975,6,2,108342,108342,108344,0,2,4
30976,1,1,108343,108344,108345,1,2,0
30977,2,1,108345,108345,108346,0,1,0
30978,5,1,108350,108350,108351,0,1,4
30979,2,3,108352,108352,108355,0,3,1
30980,3,3,108355,108355,108358,0,3,0
30981,2,1,108357,108358,108359,1,2,0
30982,2,1,108359,108359,108360,0,1,0
30983,3,3,108362,108362,108365,0,3,2
30984,5,2,108367,108367,108369,0,2,2
30985,3,1,108370,108370,108371,0,1,1
30986,2,2,108372,108372,108374,0,2,1
30987,1,2,108373,108374,108376,1,3,0
30988,6,3,108379,108379,108382,0,3,3
30989,5,3,108384,108384,108387,0,3,2
30990,2,3,108386,108387,108390,1,4,0
30991,2,1,108388,108390,108391,2,3,0
30992,4,3,108392,108392,108395,0,3,1
30993,1,1,108393,108395,108396,2,3,0
30994,5,2,108398,108398,108400,0,2,2
30995,3,1,108401,108401,108402,0,1,1
30996,6,1,108407,108407,108408,0,1,5
30997,5,1,108412,108412,108413,0,1,4
30998,3,3,108415,108415,108418,0,3,2
30999,4,2,108419,108419,108421,0,2,1
31000,5,3,108424,108424,108427,0,3,3
31001,4,1,108428,108428,108429,0,1,1
31002,4,3,108432,108432,108435,0,3,3
31003,3,3,108435,108435,108438,0,3,0
31004,2,2,108437,108438,108440,1,3,0
31005,3,2,108440,108440,108442,0,2,0
31006,5,1,108445,108445,108446,0,1,3
31007,3,2,108448,108448,108450,0,2,2
31008,5,1,108453,108453,108454,0,1,3
31009,5,2,108458,108458,108460,0,2,4
31010,3,2,108461,108461,108463,0,2,1
31011,6,3,108467,108467,108470,0,3,4
31012,4,2,108471,108471,108473,0,2,1
31013,4,1,108475,108475,108476,0,1,2
31014,5,2,108480,108480,108482,0,2,4
31015,1,3,108481,108482,108485,1,4,0
31016,6,2,108487,108487,108489,0,2,2
31017,1,2,108488,108489,108491,1,3,0
31018,3,1,108491,108491,108492,0,1,0
31019,3,2,108494,108494,108496,0,2,2
31020,3,2,108497,108497,108499,0,2,1
31021,3,2,108500,108500,108502,0,2,1
31022,3,3,108503,108503,108506,0,3,1
31023,6,1,108509,108509,108510,0,1,3
31024,6,1,108515,108515,108516,0,1,5
31025,4,1,108519,108519,108520,0,1,3
31026,3,3,108522,108522,108525,0,3,2
31027,4,1,108526,108526,108527,0,1,1
31028,2,3,108528,108528,108531,0,3,1
31029,2,2,108530,108531,108533,1,3,0
31030,2,1,108532,108533,108534,1,2,0
31031,4,1,108536,108536,108537,0,1,2
31032,1,2,108537,108537,108539,0,2,0
31033,2,3,108539,108539,108542,0,3,0
31034,4,3,108543,108543,108546,0,3,1
31035,1,3,108544,108546,108549,2,5,0
31036,6,1,108550,108550,108551,0,1,1
31037,5,3,108555,108555,108558,0,3,4
31038,4,2,108559,108559,108561,0,2,1
31039,2,3,108561,108561,108564,0,3,0
31040,4,2,108565,108565,108567,0,2,1
31041,1,2,108566,108567,108569,1,3,0
31042,4,3,108570,108570,108573,0,3,1
31043,2,2,108572,108573,108575,1,3,0
31044,5,1,108577,108577,108578,0,1,2
31045,2,3,108579,108579,108582,0,3,1
31046,2,1,108581,108582,108583,1,2,0
31047,4,3,108585,108585,108588,0,3,2
31048,3,2,108588,108588,108590,0,2,0
31049,6,3,108594,108594,108597,0,3,4
31050,6,1,108600,108600,108601,0,1,3
31051,5,2,108605,108605,108607,0,2,4
31052,6,1,108611,108611,108612,0,1,4
31053,3,3,108614,108614,108617,0,3,2
31054,3,2,108617,108617,108619,0,2,0
31055,1,3,108618,108619,108622,1,4,0
31056,5,1,108623,108623,108624,0,1,1
31057,4,3,108627,108627,108630,0,3,3
31058,4,2,108631,108631,108633,0,2,1
31059,3,1,108634,108634,108635,0,1,1
31060,2,2,108636,108636,108638,0,2,1
31061,2,3,108638,108638,108641,0,3,0
31062,6,1,108644,108644,108645,0,1,3
31063,4,3,108648,108648,108651,0,3,3
31064,6,2,108654,108654,108656,0,2,3
31065,1,3,108655,108656,108659,1,4,0
31066,1,3,108656,108659,108662,3,6,0
31067,6,2,108662,108662,108664,0,2,0
31068,5,3,108667,108667,108670,0,3,3
31069,5,1,108672,108672,108673,0,1,2
31070,5,2,108677,108677,108679,0,2,4
31071,1,2,108678,108679,108681,1,3,0
31072,2,2,108680,108681,108683,1,3,0
31073,1,2,108681,108683,108685,2,4,0
31074,4,3,108685,108685,108688,0,3,0
31075,2,2,108687,108688,108690,1,3,0
31076,5,1,108692,108692,108693,0,1,2
31077,6,1,108698,108698,108699,0,1,5
31078,5,3,108703,108703,108706,0,3,4
31079,2,2,108705,108706,108708,1,3,0
31080,6,1,108711,108711,108712,0,1,3
31081,3,2,108714,108714,108716,0,2,2
31082,5,2,108719,108719,108721,0,2,3
31083,5,1,108724,108724,108725,0,1,3
31084,5,3,108729,108729,108732,0,3,4
31085,5,3,108734,108734,108737,0,3,2
31086,5,2,108739,108739,108741,0,2,2
31087,2,2,108741,108741,108743,0,2,0
31088,4,1,108745,108745,108746,0,1,2
31089,4,2,108749,108749,108751,0,2,3
31090,6,3,108755,108755,108758,0,3,4
31091,3,2,108758,108758,108760,0,2,0
31092,4,2,108762,108762,108764,0,2,2
31093,2,1,108764,108764,108765,0,1,0
31094,2,1,108766,108766,108767,0,1,1
31095,3,1,108769,108769,108770,0,1,2
31096,1,3,108770,108770,108773,0,3,0
31097,1,2,108771,108773,108775,2,4,0
31098,5,2,108776,108776,108778,0,2,1
31099,4,1,108780,108780,108781,0,1,2
31100,6,2,108786,108786,108788,0,2,5
31101,1,1,108787,108788,108789,1,2,0
31102,6,3,108793,108793,108796,0,3,4
31103,5,1,108798,108798,108799,0,1,2
31104,4,1,108802,108802,108803,0,1,3
31105,4,2,108806,108806,108808,0,2,3
31106,2,2,108808,108808,108810,0,2,0
31107,6,2,108814,108814,108816,0,2,4
31108,6,1,108820,108820,108821,0,1,4
31109,1,1,108821,108821,108822,0,1,0
31110,6,2,108827,108827,108829,0,2,5
31111,6,1,108833,108833,108834,0,1,4
31112,2,3,108835,108835,108838,0,3,1
31113,1,1,108836,108838,108839,2,3,0
31114,4,2,108840,108840,108842,0,2,1
31115,1,1,108841,108842,108843,1,2,0
31116,4,3,108845,108845,108848,0,3,2
31117,2,2,108847,108848,108850,1,3,0
31118,6,3,108853,108853,108856,0,3,3
31119,6,3,108859,108859,108862,0,3,3
31120,6,1,108865,108865,108866,0,1,3
31121,2,3,108867,108867,108870,0,3,1
31122,6,2,108873,108873,108875,0,2,3
31123,4,1,108877,108877,108878,0,1,2
31124,6,3,108883,108883,108886,0,3,5
31125,6,1,108889,108889,108890,0,1,3
31126,1,3,108890,108890,108893,0,3,0
31127,6,1,108896,108896,108897,0,1,3
31128,2,1,108898,108898,108899,0,1,1
31129,1,2,108899,108899,108901,0,2,0
31130,4,2,108903,108903,108905,0,2,2
31131,1,1,108904,108905,108906,1,2,0
31132,5,2,108909,108909,108911,0,2,3
31133,4,3,108913,108913,108916,0,3,2
31134,5,3,108918,108918,108921,0,3,2
31135,1,2,108919,108921,108923,2,4,0
31136,5,3,108924,108924,108927,0,3,1
31137,6,2,108930,108930,108932,0,2,3
31138,2,2,108932,108932,108934,0,2,0
31139,3,3,108935,108935,108938,0,3,1
31140,4,3,108939,108939,108942,0,3,1
31141,2,3,108941,108942,108945,1,4,0
31142,5,2,108946,108946,108948,0,2,1
31143,3,3,108949,108949,108952,0,3,1
31144,1,2,108950,108952,108954,2,4,0
31145,4,1,108954,108954,108955,0,1,0
31146,4,3,108958,108958,108961,0,3,3
31147,1,3,108959,108961,108964,2,5,0
31148,1,3,108960,108964,108967,4,7,0
31149,1,1,108961,108967,108968,6,7,0
31150,5,2,108966,108968,108970,2,4,0
31151,1,1,108967,108970,108971,3,4,0
31152,6,3,108973,108973,108976,0,3,2
31153,6,2,108979,108979,108981,0,2,3
31154,6,2,108985,108985,108987,0,2,4
31155,3,1,108988,108988,108989,0,1,1
31156,3,1,108991,108991,108992,0,1,2
31157,5,1,108996,108996,108997,0,1,4
31158,6,2,109002,109002,109004,0,2,5
31159,2,3,109004,109004,109007,0,3,0
31160,4,1,109008,109008,109009,0,1,1
31161,2,1,109010,109010,109011,0,1,1
31162,6,1,109016,109016,109017,0,1,5
31163,2,1,109018,109018,109019,0,1,1
31164,3,2,109021,109021,109023,0,2,2
31165,6,3,109027,109027,109030,0,3,4
31166,3,1,109030,109030,109031,0,1,0
31167,6,3,109036,109036,109039,0,3,5
31168,2,2,109038,109039,109041,1,3,0
31169,5,1,109043,109043,109044,0,1,2
31170,3,2,109046,109046,109048,0,2,2
31171,5,2,109051,109051,109053,0,2,3
31172,2,2,109053,109053,109055,0,2,0
31173,2,1,109055,109055,109056,0,1,0
31174,1,3,109056,109056,109059,0,3,0
31175,6,2,109062,109062,109064,0,2,3
31176,5,2,109067,109067,109069,0,2,3
31177,3,2,109070,109070,109072,0,2,1
31178,5,1,109075,109075,109076,0,1,3
31179,2,2,109077,109077,109079,0,2,1
31180,2,3,109079,109079,109082,0,3,0
31181,3,2,109082,109082,109084,0,2,0
31182,4,2,109086,109086,109088,0,2,2
31183,1,2,109087,109088,109090,1,3,0
31184,2,3,109089,109090,109093,1,4,0
31185,3,3,109092,109093,109096,1,4,0
31186,5,1,109097,109097,109098,0,1,1
31187,5,2,109102,109102,109104,0,2,4
31188,1,2,109103,109104,109106,1,3,0
31189,2,1,109105,109106,109107,1,2,0
31190,5,1,109110,109110,109111,0,1,3
31191,6,2,109116,109116,109118,0,2,5
31192,1,3,109117,109118,109121,1,4,0
31193,1,2,109118,109121,109123,3,5,0
31194,2,3,109120,109123,109126,3,6,0
31195,2,3,109122,109126,109129,4,7,0
31196,6,1,109128,109129,109130,1,2,0
31197,3,2,109131,109131,109133,0,2,1
31198,1,3,109132,109133,109136,1,4,0
31199,5,1,109137,109137,109138,0,1,1
31200,5,3,109142,109142,109145,0,3,4
31201,2,1,109144,109145,109146,1,2,0
31202,5,1,109149,109149,109150,0,1,3
31203,3,3,109152,109152,109155,0,3,2
31204,1,3,109153,109155,109158,2,5,0
31205,2,2,109155,109158,109160,3,5,0
31206,3,1,109158,109160,109161,2,3,0
31207,3,1,109161,109161,109162,0,1,0
31208,4,2,109165,109165,109167,0,2,3
31209,3,3,109168,109168,109171,0,3,1
31210,3,3,109171,109171,109174,0,3,0
31211,5,1,109176,109176,109177,0,1,2
31212,1,3,109177,109177,109180,0,3,0
31213,2,2,109179,109180,109182,1,3,0
31214,6,2,109185,109185,109187,0,2,3
31215,2,2,109187,109187,109189,0,2,0
31216,3,3,109190,109190,109193,0,3,1
31217,6,1,109196,109196,109197,0,1,3
31218,6,3,109202,109202,109205,0,3,5
31219,3,3,109205,109205,109208,0,3,0
31220,3,2,109208,109208,109210,0,2,0
31221,2,3,109210,109210,109213,0,3,0
31222,1,3,109211,109213,109216,2,5,0
31223,6,1,109217,109217,109218,0,1,1
31224,4,3,109221,109221,109224,0,3,3
31225,2,2,109223,109224,109226,1,3,0
31226,4,1,109227,109227,109228,0,1,1
31227,5,3,109232,109232,109235,0,3,4
31228,1,1,109233,109235,109236,2,3,0
31229,6,1,109239,109239,109240,0,1,3
31230,3,1,109242,109242,109243,0,1,2
31231,1,3,109243,109243,109246,0,3,0
31232,6,3,109249,109249,109252,0,3,3
31233,4,1,109253,109253,109254,0,1,1
31234,5,3,109258,109258,109261,0,3,4
31235,1,1,109259,109261,109262,2,3,0
31236,3,3,109262,109262,109265,0,3,0
31237,3,2,109265,109265,109267,0,2,0
31238,1,1,109266,109267,109268,1,2,0
31239,3,3,109269,109269,109272,0,3,1
31240,2,2,109271,109272,109274,1,3,0
31241,4,1,109275,109275,109276,0,1,1
31242,3,1,109278,109278,109279,0,1,2
31243,6,2,109284,109284,109286,0,2,5
31244,6,3,109290,109290,109293,0,3,4
31245,2,2,109292,109293,109295,1,3,0
31246,4,1,109296,109296,109297,0,1,1
31247,5,1,109301,109301,109302,0,1,4
31248,1,1,109302,109302,109303,0,1,0
31249,5,3,109307,109307,109310,0,3,4
31250,6,2,109313,109313,109315,0,2,3
31251,2,3,109315,109315,109318,0,3,0
31252,3,2,109318,109318,109320,0,2,0
31253,5,3,109323,109323,109326,0,3,3
31254,5,1,109328,109328,109329,0,1,2
31255,6,3,109334,109334,109337,0,3,5
31256,6,2,109340,109340,109342,0,2,3
31257,5,3,109345,109345,109348,0,3,3
31258,3,2,109348,109348,109350,0,2,0
31259,6,1,109354,109354,109355,0,1,4
31260,6,2,109360,109360,109362,0,2,5
31261,1,3,109361,109362,109365,1,4,0
31262,2,3,109363,109365,109368,2,5,0
31263,4,1,109367,109368,109369,1,2,0
31264,6,1,109373,109373,109374,0,1,4
31265,5,1,109378,109378,109379,0,1,4
31266,3,2,109381,109381,109383,0,2,2
31267,6,2,109387,109387,109389,0,2,4
31268,6,1,109393,109393,109394,0,1,4
31269,3,2,109396,109396,109398,0,2,2
31270,4,3,109400,109400,109403,0,3,2
31271,3,2,109403,109403,109405,0,2,0
31272,3,1,109406,109406,109407,0,1,1
31273,5,2,109411,109411,109413,0,2,4
31274,1,3,109412,109413,109416,1,4,0
31275,1,1,109413,109416,109417,3,4,0
31276,5,3,109418,109418,109421,0,3,1
31277,5,2,109423,109423,109425,0,2,2
31278,4,1,109427,109427,109428,0,1,2
31279,3,1,109430,109430,109431,0,1,2
31280,6,3,109436,109436,109439,0,3,5
31281,5,1,109441,109441,109442,0,1,2
31282,6,1,109447,109447,109448,0,1,5
31283,6,2,109453,109453,109455,0,2,5
31284,1,2,109454,109455,109457,1,3,0
31285,1,3,109455,109457,109460,2,5,0
31286,5,1,109460,109460,109461,0,1,0
31287,4,1,109464,109464,109465,0,1,3
31288,5,2,109469,109469,109471,0,2,4
31289,2,2,109471,109471,109473,0,2,0
31290,5,2,109476,109476,109478,0,2,3
31291,1,2,109477,109478,109480,1,3,0
31292,3,2,109480,109480,109482,0,2,0
31293,4,1,109484,109484,109485,0,1,2
31294,4,2,109488,109488,109490,0,2,3
31295,1,2,109489,109490,109492,1,3,0
31296,6,2,109495,109495,109497,0,2,3
31297,6,3,109501,109501,109504,0,3,4
31298,6,2,109507,109507,109509,0,2,3
31299,2,2,109509,109509,109511,0,2,0
31300,3,3,109512,109512,109515,0,3,1
31301,1,3,109513,109515,109518,2,5,0
31302,4,2,109517,109518,109520,1,3,0
31303,3,2,109520,109520,109522,0,2,0
31304,2,3,109522,109522,109525,0,3,0
31305,5,1,109527,109527,109528,0,1,2
31306,6,2,109533,109533,109535,0,2,5
31307,2,2,109535,109535,109537,0,2,0
31308,2,2,109537,109537,109539,0,2,0
31309,2,3,109539,109539,109542,0,3,0
31310,1,1,109540,109542,109543,2,3,0
31311,6,3,109546,109546,109549,0,3,3
31312,6,1,109552,109552,109553,0,1,3
31313,2,3,109554,109554,109557,0,3,1
31314,3,2,109557,109557,109559,0,2,0
31315,4,3,109561,109561,109564,0,3,2
31316,2,2,109563,109564,109566,1,3,0
31317,3,2,109566,109566,109568,0,2,0
31318,1,3,109567,109568,109571,1,4,0
31319,6,1,109573,109573,109574,0,1,2
31320,4,3,109577,109577,109580,0,3,3
31321,3,1,109580,109580,109581,0,1,0
31322,6,1,109586,109586,109587,0,1,5
31323,1,3,109587,109587,109590,0,3,0
31324,5,3,109592,109592,109595,0,3,2
31325,3,1,109595,109595,109596,0,1,0
31326,4,1,109599,109599,109600,0,1,3
31327,3,2,109602,109602,109604,0,2,2
31328,4,1,109606,109606,109607,0,1,2
31329,4,3,109610,109610,109613,0,3,3
31330,6,3,109616,109616,109619,0,3,3
31331,3,3,109619,109619,109622,0,3,0
31332,1,3,109620,109622,109625,2,5,0
31333,4,2,109624,109625,109627,1,3,0
31334,2,3,109626,109627,109630,1,4,0
31335,5,1,109631,109631,109632,0,1,1
31336,4,3,109635,109635,109638,0,3,3
31337,1,3,109636,109638,109641,2,5,0
31338,5,3,109641,109641,109644,0,3,0
31339,3,3,109644,109644,109647,0,3,0
31340,3,3,109647,109647,109650,0,3,0
31341,4,2,109651,109651,109653,0,2,1
31342,2,1,109653,109653,109654,0,1,0
31343,3,1,109656,109656,109657,0,1,2
31344,5,1,109661,109661,109662,0,1,4
31345,4,1,109665,109665,109666,0,1,3
31346,1,3,109666,109666,109669,0,3,0
31347,1,1,109667,109669,109670,2,3,0
31348,6,2,109673,109673,109675,0,2,3
31349,4,3,109677,109677,109680,0,3,2
31350,2,1,109679,109680,109681,1,2,0
31351,6,1,109685,109685,109686,0,1,4
31352,4,1,109689,109689,109690,0,1,3
31353,4,3,109693,109693,109696,0,3,3
31354,6,1,109699,109699,109700,0,1,3
31355,6,3,109705,109705,109708,0,3,5
31356,4,2,109709,109709,109711,0,2,1
31357,5,2,109714,109714,109716,0,2,3
31358,2,1,109716,109716,109717,0,1,0
31359,4,3,109720,109720,109723,0,3,3
31360,3,1,109723,109723,109724,0,1,0
31361,1,3,109724,109724,109727,0,3,0
31362,4,3,109728,109728,109731,0,3,1
31363,3,1,109731,109731,109732,0,1,0
31364,6,1,109737,109737,109738,0,1,5
31365,6,3,109743,109743,109746,0,3,5
31366,1,1,109744,109746,109747,2,3,0
31367,3,1,109747,109747,109748,0,1,0
31368,2,1,109749,109749,109750,0,1,1
31369,5,2,109754,109754,109756,0,2,4
31370,3,1,109757,109757,109758,0,1,1
31371,4,3,109761,109761,109764,0,3,3
31372,5,2,109766,109766,109768,0,2,2
31373,2,3,109768,109768,109771,0,3,0
31374,4,3,109772,109772,109775,0,3,1
31375,5,2,109777,109777,109779,0,2,2
31376,3,2,109780,109780,109782,0,2,1
31377,4,3,109784,109784,109787,0,3,2
31378,2,3,109786,109787,109790,1,4,0
31379,5,1,109791,109791,109792,0,1,1
31380,2,3,109793,109793,109796,0,3,1
31381,2,3,109795,109796,109799,1,4,0
31382,3,1,109798,109799,109800,1,2,0
31383,3,2,109801,109801,109803,0,2,1
31384,5,3,109806,109806,109809,0,3,3
31385,6,1,109812,109812,109813,0,1,3
31386,5,1,109817,109817,109818,0,1,4
31387,5,3,109822,109822,109825,0,3,4
31388,2,2,109824,109825,109827,1,3,0
31389,2,3,109826,109827,109830,1,4,0
31390,1,3,109827,109830,109833,3,6,0
31391,5,3,109832,109833,109836,1,4,0
31392,5,1,109837,109837,109838,0,1,1
31393,4,3,109841,109841,109844,0,3,3
31394,3,3,109844,109844,109847,0,3,0
31395,4,3,109848,109848,109851,0,3,1
31396,4,3,109852,109852,109855,0,3,1
31397,1,1,109853,109855,109856,2,3,0
31398,2,3,109855,109856,109859,1,4,0
31399,5,3,109860,109860,109863,0,3,1
31400,4,1,109864,109864,109865,0,1,1
31401,3,1,109867,109867,109868,0,1,2
31402,3,1,109870,109870,109871,0,1,2
31403,3,2,109873,109873,109875,0,2,2
31404,5,1,109878,109878,109879,0,1,3
31405,2,2,109880,109880,109882,0,2,1
31406,6,3,109886,109886,109889,0,3,4
31407,3,1,109889,109889,109890,0,1,0
31408,3,1,109892,109892,109893,0,1,2
31409,5,1,109897,109897,109898,0,1,4
31410,1,3,109898,109898,109901,0,3,0
31411,2,1,109900,109901,109902,1,2,0
31412,4,2,109904,109904,109906,0,2,2
31413,2,2,109906,109906,109908,0,2,0
31414,6,2,109912,109912,109914,0,2,4
31415,1,1,109913,109914,109915,1,2,0
31416,4,3,109917,109917,109920,0,3,2
31417,2,1,109919,109920,109921,1,2,0
31418,3,3,109922,109922,109925,0,3,1
31419,3,3,109925,109925,109928,0,3,0
31420,6,3,109931,109931,109934,0,3,3
31421,5,3,109936,109936,109939,0,3,2
31422,2,1,109938,109939,109940,1,2,0
31423,1,2,109939,109940,109942,1,3,0
31424,1,1,109940,109942,109943,2,3,0
31425,2,1,109942,109943,109944,1,2,0
31426,2,1,109944,109944,109945,0,1,0
31427,5,2,109949,109949,109951,0,2,4
31428,5,3,109954,109954,109957,0,3,3
31429,1,2,109955,109957,109959,2,4,0
31430,2,2,109957,109959,109961,2,4,0
31431,2,2,109959,109961,109963,2,4,0
31432,6,2,109965,109965,109967,0,2,2
31433,5,1,109970,109970,109971,0,1,3
31434,2,3,109972,109972,109975,0,3,1
31435,6,3,109978,109978,109981,0,3,3
31436,2,1,109980,109981,109982,1,2,0
31437,6,1,109986,109986,109987,0,1,4
31438,5,2,109991,109991,109993,0,2,4
31439,1,1,109992,109993,109994,1,2,0
31440,2,3,109994,109994,109997,0,3,0
31441,4,2,109998,109998,110000,0,2,1
31442,2,3,110000,110000,110003,0,3,0
31443,5,3,110005,110005,110008,0,3,2
31444,4,3,110009,110009,110012,0,3,1
31445,6,2,110015,110015,110017,0,2,3
31446,1,3,110016,110017,110020,1,4,0
31447,3,3,110019,110020,110023,1,4,0
31448,3,2,110022,110023,110025,1,3,0
31449,4,3,110026,110026,110029,0,3,1
31450,1,3,110027,110029,110032,2,5,0
31451,4,2,110031,110032,110034,1,3,0
31452,3,1,110034,110034,110035,0,1,0
31453,1,2,110035,110035,110037,0,2,0
31454,4,3,110039,110039,110042,0,3,2
31455,3,1,110042,110042,110043,0,1,0
31456,5,1,110047,110047,110048,0,1,4
31457,6,1,110053,110053,110054,0,1,5
31458,5,2,110058,110058,110060,0,2,4
31459,1,1,110059,110060,110061,1,2,0
31460,1,1,110060,110061,110062,1,2,0
31461,2,2,110062,110062,110064,0,2,0
31462,4,1,110066,110066,110067,0,1,2
31463,6,1,110072,110072,110073,0,1,5
31464,4,3,110076,110076,110079,0,3,3
31465,5,1,110081,110081,110082,0,1,2
31466,4,1,110085,110085,110086,0,1,3
31467,5,2,110090,110090,110092,0,2,4
31468,4,3,110094,110094,110097,0,3,2
31469,6,3,110100,110100,110103,0,3,3
31470,5,3,110105,110105,110108,0,3,2
31471,2,2,110107,110108,110110,1,3,0
31472,4,2,110111,110111,110113,0,2,1
31473,3,3,110114,110114,110117,0,3,1
31474,6,1,110120,110120,110121,0,1,3
31475,2,3,110122,110122,110125,0,3,1
31476,4,3,110126,110126,110129,0,3,1
31477,1,3,110127,110129,110132,2,5,0
31478,5,3,110132,110132,110135,0,3,0
31479,6,2,110138,110138,110140,0,2,3
31480,1,3,110139,110140,110143,1,4,0
31481,6,3,110145,110145,110148,0,3,2
31482,1,3,110146,110148,110151,2,5,0
31483,4,2,110150,110151,110153,1,3,0
31484,1,2,110151,110153,110155,2,4,0
31485,2,3,110153,110155,110158,2,5,0
31486,6,1,110159,110159,110160,0,1,1
31487,5,2,110164,110164,110166,0,2,4
31488,3,3,110167,110167,110170,0,3,1
31489,6,1,110173,110173,110174,0,1,3
31490,1,1,110174,110174,110175,0,1,0
31491,6,2,110180,110180,110182,0,2,5
31492,5,3,110185,110185,110188,0,3,3
31493,5,1,110190,110190,110191,0,1,2
31494,5,3,110195,110195,110198,0,3,4
31495,3,1,110198,110198,110199,0,1,0
31496,3,3,110201,110201,110204,0,3,2
31497,3,1,110204,110204,110205,0,1,0
31498,4,3,110208,110208,110211,0,3,3
31499,1,1,110209,110211,110212,2,3,0
31500,3,2,110212,110212,110214,0,2,0
31501,5,1,110217,110217,110218,0,1,3
31502,5,3,110222,110222,110225,0,3,4
31503,6,2,110228,110228,110230,0,2,3
31504,5,2,110233,110233,110235,0,2,3
31505,1,1,110234,110235,110236,1,2,0
31506,1,3,110235,110236,110239,1,4,0
31507,2,1,110237,110239,110240,2,3,0
31508,1,1,110238,110240,110241,2,3,0
31509,2,3,110240,110241,110244,1,4,0
31510,3,1,110243,110244,110245,1,2,0
31511,5,2,110248,110248,110250,0,2,3
31512,2,1,110250,110250,110251,0,1,0
31513,2,3,110252,110252,110255,0,3,1
31514,1,2,110253,110255,110257,2,4,0
31515,5,1,110258,110258,110259,0,1,1
31516,1,2,110259,110259,110261,0,2,0
31517,3,2,110262,110262,110264,0,2,1
31518,3,2,110265,110265,110267,0,2,1
31519,6,2,110271,110271,110273,0,2,4
31520,5,3,110276,110276,110279,0,3,3
31521,3,1,110279,110279,110280,0,1,0
31522,2,3,110281,110281,110284,0,3,1
31523,2,3,110283,110284,110287,1,4,0
31524,2,1,110285,110287,110288,2,3,0
31525,6,3,110291,110291,110294,0,3,3
31526,4,2,110295,110295,110297,0,2,1
31527,6,3,110301,110301,110304,0,3,4
31528,5,2,110306,110306,110308,0,2,2
31529,6,3,110312,110312,110315,0,3,4
31530,2,2,110314,110315,110317,1,3,0
31531,5,1,110319,110319,110320,0,1,2
31532,6,2,110325,110325,110327,0,2,5
31533,4,3,110329,110329,110332,0,3,2
31534,5,2,110334,110334,110336,0,2,2
31535,1,1,110335,110336,110337,1,2,0
31536,1,1,110336,110337,110338,1,2,0
31537,4,3,110340,110340,110343,0,3,2
31538,2,3,110342,110343,110346,1,4,0
31539,1,2,110343,110346,110348,3,5,0
31540,4,1,110347,110348,110349,1,2,0
31541,6,1,110353,110353,110354,0,1,4
31542,5,1,110358,110358,110359,0,1,4
31543,2,2,110360,110360,110362,0,2,1
31544,6,1,110366,110366,110367,0,1,4
31545,5,3,110371,110371,110374,0,3,4
31546,5,2,110376,110376,110378,0,2,2
31547,4,1,110380,110380,110381,0,1,2
31548,2,2,110382,110382,110384,0,2,1
31549,1,2,110383,110384,110386,1,3,0
31550,3,3,110386,110386,110389,0,3,0
31551,6,1,110392,110392,110393,0,1,3
31552,5,3,110397,110397,110400,0,3,4
31553,3,3,110400,110400,110403,0,3,0
31554,2,2,110402,110403,110405,1,3,0
31555,2,3,110404,110405,110408,1,4,0
31556,1,2,110405,110408,110410,3,5,0
31557,5,2,110410,110410,110412,0,2,0
31558,2,1,110412,110412,110413,0,1,0
31559,1,1,110413,110413,110414,0,1,0
31560,1,1,110414,110414,110415,0,1,0
31561,5,2,110419,110419,110421,0,2,4
31562,1,2,110420,110421,110423,1,3,0
31563,3,1,110423,110423,110424,0,1,0
31564,6,1,110429,110429,110430,0,1,5
31565,6,1,110435,110435,110436,0,1,5
31566,1,3,110436,110436,110439,0,3,0
31567,5,3,110441,110441,110444,0,3,2
31568,2,1,110443,110444,110445,1,2,0
31569,4,1,110447,110447,110448,0,1,2
31570,1,2,110448,110448,110450,0,2,0
31571,2,3,110450,110450,110453,0,3,0
31572,4,1,110454,110454,110455,0,1,1
31573,2,2,110456,110456,110458,0,2,1
31574,1,3,110457,110458,110461,1,4,0
31575,6,1,110463,110463,110464,0,1,2
31576,3,3,110466,110466,110469,0,3,2
31577,4,3,110470,110470,110473,0,3,1
31578,1,3,110471,110473,110476,2,5,0
31579,5,2,110476,110476,110478,0,2,0
31580,5,1,110481,110481,110482,0,1,3
31581,3,1,110484,110484,110485,0,1,2
31582,4,2,110488,110488,110490,0,2,3
31583,3,3,110491,110491,110494,0,3,1
31584,1,1,110492,110494,110495,2,3,0
31585,6,2,110498,110498,110500,0,2,3
31586,4,3,110502,110502,110505,0,3,2
31587,5,3,110507,110507,110510,0,3,2
31588,4,3,110511,110511,110514,0,3,1
31589,2,1,110513,110514,110515,1,2,0
31590,5,2,110518,110518,110520,0,2,3
31591,5,1,110523,110523,110524,0,1,3
31592,1,1,110524,110524,110525,0,1,0
31593,4,1,110528,110528,110529,0,1,3
31594,2,2,110530,110530,110532,0,2,1
31595,6,2,110536,110536,110538,0,2,4
31596,6,1,110542,110542,110543,0,1,4
31597,6,2,110548,110548,110550,0,2,5
31598,1,1,110549,110550,110551,1,2,0
31599,4,2,110553,110553,110555,0,2,2
31600,5,2,110558,110558,110560,0,2,3
31601,3,3,110561,110561,110564,0,3,1
31602,5,1,110566,110566,110567,0,1,2
31603,2,1,110568,110568,110569,0,1,1
31604,1,3,110569,110569,110572,0,3,0
31605,6,1,110575,110575,110576,0,1,3
31606,3,3,110578,110578,110581,0,3,2
31607,1,1,110579,110581,110582,2,3,0
31608,3,1,110582,110582,110583,0,1,0
31609,6,2,110588,110588,110590,0,2,5
31610,2,3,110590,110590,110593,0,3,0
31611,5,2,110595,110595,110597,0,2,2
31612,2,1,110597,110597,110598,0,1,0
31613,1,3,110598,110598,110601,0,3,0
31614,6,2,110604,110604,110606,0,2,3
31615,1,2,110605,110606,110608,1,3,0
31616,6,2,110611,110611,110613,0,2,3
31617,6,3,110617,110617,110620,0,3,4
31618,2,1,110619,110620,110621,1,2,0
31619,6,2,110625,110625,110627,0,2,4
31620,4,3,110629,110629,110632,0,3,2
31621,1,2,110630,110632,110634,2,4,0
31622,2,1,110632,110634,110635,2,3,0
31623,5,2,110637,110637,110639,0,2,2
31624,4,2,110641,110641,110643,0,2,2
31625,5,2,110646,110646,110648,0,2,3
31626,2,3,110648,110648,110651,0,3,0
31627,5,3,110653,110653,110656,0,3,2
31628,6,3,110659,110659,110662,0,3,3
31629,3,2,110662,110662,110664,0,2,0
31630,3,1,110665,110665,110666,0,1,1
31631,5,1,110670,110670,110671,0,1,4
31632,2,1,110672,110672,110673,0,1,1
31633,5,1,110677,110677,110678,0,1,4
31634,2,3,110679,110679,110682,0,3,1
31635,3,1,110682,110682,110683,0,1,0
31636,5,3,110687,110687,110690,0,3,4
31637,4,1,110691,110691,110692,0,1,1
31638,6,2,110697,110697,110699,0,2,5
31639,4,1,110701,110701,110702,0,1,2
31640,2,1,110703,110703,110704,0,1,1
31641,6,1,110709,110709,110710,0,1,5
31642,2,2,110711,110711,110713,0,2,1
31643,4,1,110715,110715,110716,0,1,2
31644,3,1,110718,110718,110719,0,1,2
31645,3,1,110721,110721,110722,0,1,2
31646,2,1,110723,110723,110724,0,1,1
31647,6,3,110729,110729,110732,0,3,5
31648,6,3,110735,110735,110738,0,3,3
31649,3,1,110738,110738,110739,0,1,0
31650,3,2,110741,110741,110743,0,2,2
31651,4,2,110745,110745,110747,0,2,2
31652,3,2,110748,110748,110750,0,2,1
31653,6,3,110754,110754,110757,0,3,4
31654,5,1,110759,110759,110760,0,1,2
31655,1,1,110760,110760,110761,0,1,0
31656,3,1,110763,110763,110764,0,1,2
31657,3,2,110766,110766,110768,0,2,2
31658,1,3,110767,110768,110771,1,4,0
31659,5,3,110772,110772,110775,0,3,1
31660,3,3,110775,110775,110778,0,3,0
31661,5,2,110780,110780,110782,0,2,2
31662,3,2,110783,110783,110785,0,2,1
31663,2,1,110785,110785,110786,0,1,0
31664,2,2,110787,110787,110789,0,2,1
31665,1,2,110788,110789,110791,1,3,0
31666,1,1,110789,110791,110792,2,3,0
31667,4,3,110793,110793,110796,0,3,1
31668,6,2,110799,110799,110801,0,2,3
31669,2,2,110801,110801,110803,0,2,0
31670,1,2,110802,110803,110805,1,3,0
31671,1,1,110803,110805,110806,2,3,0
31672,6,2,110809,110809,110811,0,2,3
31673,5,2,110814,110814,110816,0,2,3
31674,1,2,110815,110816,110818,1,3,0
31675,6,3,110821,110821,110824,0,3,3
31676,2,1,110823,110824,110825,1,2,0
31677,5,2,110828,110828,110830,0,2,3
31678,3,2,110831,110831,110833,0,2,1
31679,1,2,110832,110833,110835,1,3,0
31680,2,3,110834,110835,110838,1,4,0
31681,3,2,110837,110838,110840,1,3,0
31682,2,2,110839,110840,110842,1,3,0
31683,5,3,110844,110844,110847,0,3,2
31684,3,2,110847,110847,110849,0,2,0
31685,6,2,110853,110853,110855,0,2,4
31686,4,3,110857,110857,110860,0,3,2
31687,1,2,110858,110860,110862,2,4,0
31688,3,2,110861,110862,110864,1,3,0
31689,1,2,110862,110864,110866,2,4,0
31690,5,3,110867,110867,110870,0,3,1
31691,6,1,110873,110873,110874,0,1,3
31692,4,2,110877,110877,110879,0,2,3
31693,4,1,110881,110881,110882,0,1,2
31694,6,2,110887,110887,110889,0,2,5
31695,2,2,110889,110889,110891,0,2,0
31696,5,1,110894,110894,110895,0,1,3
31697,5,1,110899,110899,110900,0,1,4
31698,4,1,110903,110903,110904,0,1,3
31699,3,1,110906,110906,110907,0,1,2
31700,6,1,110912,110912,110913,0,1,5
31701,2,1,110914,110914,110915,0,1,1
31702,4,2,110918,110918,110920,0,2,3
31703,5,3,110923,110923,110926,0,3,3
31704,4,2,110927,110927,110929,0,2,1
31705,6,2,110933,110933,110935,0,2,4
31706,3,3,110936,110936,110939,0,3,1
31707,1,2,110937,110939,110941,2,4,0
31708,6,3,110943,110943,110946,0,3,2
31709,1,1,110944,110946,110947,2,3,0
31710,6,3,110950,110950,110953,0,3,3
31711,1,2,110951,110953,110955,2,4,0
31712,2,1,110953,110955,110956,2,3,0
31713,2,2,110955,110956,110958,1,3,0
31714,3,1,110958,110958,110959,0,1,0
31715,4,3,110962,110962,110965,0,3,3
31716,2,1,110964,110965,110966,1,2,0
31717,6,2,110970,110970,110972,0,2,4
31718,1,1,110971,110972,110973,1,2,0
31719,2,2,110973,110973,110975,0,2,0
31720,5,3,110978,110978,110981,0,3,3
31721,2,1,110980,110981,110982,1,2,0
31722,3,2,110983,110983,110985,0,2,1
31723,6,3,110989,110989,110992,0,3,4
31724,5,1,110994,110994,110995,0,1,2
31725,6,2,111000,111000,111002,0,2,5
31726,2,3,111002,111002,111005,0,3,0
31727,6,1,111008,111008,111009,0,1,3
31728,4,2,111012,111012,111014,0,2,3
31729,1,1,111013,111014,111015,1,2,0
31730,6,3,111019,111019,111022,0,3,4
31731,1,2,111020,111022,111024,2,4,0
31732,3,2,111023,111024,111026,1,3,0
31733,4,1,111027,111027,111028,0,1,1
31734,1,3,111028,111028,111031,0,3,0
31735,4,2,111032,111032,111034,0,2,1
31736,3,2,111035,111035,111037,0,2,1
31737,3,2,111038,111038,111040,0,2,1
31738,3,1,111041,111041,111042,0,1,1
31739,3,1,111044,111044,111045,0,1,2
31740,3,2,111047,111047,111049,0,2,2
31741,5,3,111052,111052,111055,0,3,3
31742,3,2,111055,111055,111057,0,2,0
31743,3,2,111058,111058,111060,0,2,1
31744,4,3,111062,111062,111065,0,3,2
31745,3,2,111065,111065,111067,0,2,0
31746,3,1,111068,111068,111069,0,1,1
31747,5,2,111073,111073,111075,0,2,4
31748,1,3,111074,111075,111078,1,4,0
31749,4,3,111078,111078,111081,0,3,0
31750,1,2,111079,111081,111083,2,4,0
31751,3,2,111082,111083,111085,1,3,0
31752,6,3,111088,111088,111091,0,3,3
31753,2,2,111090,111091,111093,1,3,0
31754,1,2,111091,111093,111095,2,4,0
31755,4,1,111095,111095,111096,0,1,0
31756,1,2,111096,111096,111098,0,2,0
31757,6,2,111102,111102,111104,0,2,4
31758,1,3,111103,111104,111107,1,4,0
31759,1,1,111104,111107,111108,3,4,0
31760,1,1,111105,111108,111109,3,4,0
31761,3,2,111108,111109,111111,1,3,0
31762,2,3,111110,111111,111114,1,4,0
31763,5,1,111115,111115,111116,0,1,1
31764,4,3,111119,111119,111122,0,3,3
31765,2,3,111121,111122,111125,1,4,0
31766,5,1,111126,111126,111127,0,1,1
31767,2,2,111128,111128,111130,0,2,1
31768,4,3,111132,111132,111135,0,3,2
31769,4,1,111136,111136,111137,0,1,1
31770,4,3,111140,111140,111143,0,3,3
31771,3,3,111143,111143,111146,0,3,0
31772,2,1,111145,111146,111147,1,2,0
31773,6,1,111151,111151,111152,0,1,4
31774,4,2,111155,111155,111157,0,2,3
31775,3,3,111158,111158,111161,0,3,1
31776,6,1,111164,111164,111165,0,1,3
31777,4,3,111168,111168,111171,0,3,3
31778,4,3,111172,111172,111175,0,3,1
31779,4,3,111176,111176,111179,0,3,1
31780,1,2,111177,111179,111181,2,4,0
31781,2,2,111179,111181,111183,2,4,0
31782,4,2,111183,111183,111185,0,2,0
31783,2,1,111185,111185,111186,0,1,0
31784,4,2,111189,111189,111191,0,2,3
31785,4,2,111193,111193,111195,0,2,2
31786,4,3,111197,111197,111200,0,3,2
31787,1,2,111198,111200,111202,2,4,0
31788,4,2,111202,111202,111204,0,2,0
31789,4,1,111206,111206,111207,0,1,2
31790,6,2,111212,111212,111214,0,2,5
31791,6,3,111218,111218,111221,0,3,4
31792,1,2,111219,111221,111223,2,4,0
31793,6,3,111225,111225,111228,0,3,2
31794,6,2,111231,111231,111233,0,2,3
31795,2,3,111233,111233,111236,0,3,0
31796,4,1,111237,111237,111238,0,1,1
31797,4,3,111241,111241,111244,0,3,3
31798,5,2,111246,111246,111248,0,2,2
31799,2,2,111248,111248,111250,0,2,0
31800,1,1,111249,111250,111251,1,2,0
31801,1,2,111250,111251,111253,1,3,0
31802,3,1,111253,111253,111254,0,1,0
31803,6,3,111259,111259,111262,0,3,5
31804,5,3,111264,111264,111267,0,3,2
31805,6,1,111270,111270,111271,0,1,3
31806,3,1,111273,111273,111274,0,1,2
31807,5,1,111278,111278,111279,0,1,4
31808,6,1,111284,111284,111285,0,1,5
31809,3,2,111287,111287,111289,0,2,2
31810,3,3,111290,111290,111293,0,3,1
31811,5,3,111295,111295,111298,0,3,2
31812,5,2,111300,111300,111302,0,2,2
31813,5,1,111305,111305,111306,0,1,3
31814,5,1,111310,111310,111311,0,1,4
31815,2,3,111312,111312,111315,0,3,1
31816,6,1,111318,111318,111319,0,1,3
31817,2,2,111320,111320,111322,0,2,1
31818,6,3,111326,111326,111329,0,3,4
31819,4,2,111330,111330,111332,0,2,1
31820,2,1,111332,111332,111333,0,1,0
31821,3,1,111335,111335,111336,0,1,2
31822,4,2,111339,111339,111341,0,2,3
31823,3,2,111342,111342,111344,0,2,1
31824,3,1,111345,111345,111346,0,1,1
31825,5,1,111350,111350,111351,0,1,4
31826,3,2,111353,111353,111355,0,2,2
31827,4,2,111357,111357,111359,0,2,2
31828,5,1,111362,111362,111363,0,1,3
31829,2,2,111364,111364,111366,0,2,1
31830,3,1,111367,111367,111368,0,1,1
31831,1,3,111368,111368,111371,0,3,0
31832,1,2,111369,111371,111373,2,4,0
31833,2,1,111371,111373,111374,2,3,0
31834,2,3,111373,111374,111377,1,4,0
31835,3,1,111376,111377,111378,1,2,0
31836,6,2,111382,111382,111384,0,2,4
31837,1,2,111383,111384,111386,1,3,0
31838,4,3,111387,111387,111390,0,3,1
31839,3,3,111390,111390,111393,0,3,0
31840,6,1,111396,111396,111397,0,1,3
31841,4,3,111400,111400,111403,0,3,3
31842,4,3,111404,111404,111407,0,3,1
31843,1,2,111405,111407,111409,2,4,0
31844,2,2,111407,111409,111411,2,4,0
31845,6,2,111413,111413,111415,0,2,2
31846,3,3,111416,111416,111419,0,3,1
31847,6,2,111422,111422,111424,0,2,3
31848,2,3,111424,111424,111427,0,3,0
31849,2,2,111426,111427,111429,1,3,0
31850,3,2,111429,111429,111431,0,2,0
31851,3,2,111432,111432,111434,0,2,1
31852,1,3,111433,111434,111437,1,4,0
31853,2,3,111435,111437,111440,2,5,0
31854,2,3,111437,111440,111443,3,6,0
31855,5,3,111442,111443,111446,1,4,0
31856,5,2,111447,111447,111449,0,2,1
31857,2,3,111449,111449,111452,0,3,0
31858,6,3,111455,111455,111458,0,3,3
31859,4,2,111459,111459,111461,0,2,1
31860,2,3,111461,111461,111464,0,3,0
31861,4,1,111465,111465,111466,0,1,1
31862,4,3,111469,111469,111472,0,3,3
31863,3,1,111472,111472,111473,0,1,0
31864,4,2,111476,111476,111478,0,2,3
31865,4,3,111480,111480,111483,0,3,2
31866,3,3,111483,111483,111486,0,3,0
31867,2,3,111485,111486,111489,1,4,0
31868,4,1,111489,111489,111490,0,1,0
31869,2,2,111491,111491,111493,0,2,1
31870,3,3,111494,111494,111497,0,3,1
31871,5,1,111499,111499,111500,0,1,2
31872,1,3,111500,111500,111503,0,3,0
31873,6,2,111506,111506,111508,0,2,3
31874,1,2,111507,111508,111510,1,3,0
31875,5,3,111512,111512,111515,0,3,2
31876,6,1,111518,111518,111519,0,1,3
31877,6,3,111524,111524,111527,0,3,5
31878,3,1,111527,111527,111528,0,1,0
31879,1,3,111528,111528,111531,0,3,0
31880,1,1,111529,111531,111532,2,3,0
31881,3,1,111532,111532,111533,0,1,0
31882,3,3,111535,111535,111538,0,3,2
31883,5,2,111540,111540,111542,0,2,2
31884,4,1,111544,111544,111545,0,1,2
31885,5,3,111549,111549,111552,0,3,4
31886,3,3,111552,111552,111555,0,3,0
31887,2,3,111554,111555,111558,1,4,0
31888,5,2,111559,111559,111561,0,2,1
31889,6,1,111565,111565,111566,0,1,4
31890,1,1,111566,111566,111567,0,1,0
31891,3,2,111569,111569,111571,0,2,2
31892,6,3,111575,111575,111578,0,3,4
31893,1,3,111576,111578,111581,2,5,0
31894,2,1,111578,111581,111582,3,4,0
31895,5,2,111583,111583,111585,0,2,1
31896,5,1,111588,111588,111589,0,1,3
31897,2,3,111590,111590,111593,0,3,1
31898,4,1,111594,111594,111595,0,1,1
31899,6,1,111600,111600,111601,0,1,5
31900,3,3,111603,111603,111606,0,3,2
31901,6,3,111609,111609,111612,0,3,3
31902,5,2,111614,111614,111616,0,2,2
31903,1,2,111615,111616,111618,1,3,0
31904,3,2,111618,111618,111620,0,2,0
31905,5,3,111623,111623,111626,0,3,3
31906,3,3,111626,111626,111629,0,3,0
31907,5,3,111631,111631,111634,0,3,2
31908,2,3,111633,111634,111637,1,4,0
31909,3,2,111636,111637,111639,1,3,0
31910,6,2,111642,111642,111644,0,2,3
31911,2,1,111644,111644,111645,0,1,0
31912,4,2,111648,111648,111650,0,2,3
31913,4,2,111652,111652,111654,0,2,2
31914,3,3,111655,111655,111658,0,3,1
31915,6,3,111661,111661,111664,0,3,3
31916,2,3,111663,111664,111667,1,4,0
31917,5,1,111668,111668,111669,0,1,1
31918,3,1,111671,111671,111672,0,1,2
31919,1,1,111672,111672,111673,0,1,0
31920,6,2,111678,111678,111680,0,2,5
31921,5,3,111683,111683,111686,0,3,3
31922,4,3,111687,111687,111690,0,3,1
31923,5,3,111692,111692,111695,0,3,2
31924,2,3,111694,111695,111698,1,4,0
31925,6,2,111700,111700,111702,0,2,2
31926,3,1,111703,111703,111704,0,1,1
31927,4,3,111707,111707,111710,0,3,3
31928,1,1,111708,111710,111711,2,3,0
31929,6,3,111714,111714,111717,0,3,3
31930,6,3,111720,111720,111723,0,3,3
31931,5,2,111725,111725,111727,0,2,2
31932,2,3,111727,111727,111730,0,3,0
31933,1,3,111728,111730,111733,2,5,0
31934,2,1,111730,111733,111734,3,4,0
31935,4,3,111734,111734,111737,0,3,0
31936,6,2,111740,111740,111742,0,2,3
31937,2,1,111742,111742,111743,0,1,0
31938,2,1,111744,111744,111745,0,1,1
31939,2,2,111746,111746,111748,0,2,1
31940,5,2,111751,111751,111753,0,2,3
31941,6,1,111757,111757,111758,0,1,4
31942,4,1,111761,111761,111762,0,1,3
31943,3,1,111764,111764,111765,0,1,2
31944,3,2,111767,111767,111769,0,2,2
31945,6,1,111773,111773,111774,0,1,4
31946,6,2,111779,111779,111781,0,2,5
31947,2,1,111781,111781,111782,0,1,0
31948,3,2,111784,111784,111786,0,2,2
31949,3,3,111787,111787,111790,0,3,1
31950,3,1,111790,111790,111791,0,1,0
31951,1,2,111791,111791,111793,0,2,0
31952,2,2,111793,111793,111795,0,2,0
31953,1,3,111794,111795,111798,1,4,0
31954,5,2,111799,111799,111801,0,2,1
31955,6,2,111805,111805,111807,0,2,4
31956,3,2,111808,111808,111810,0,2,1
31957,6,3,111814,111814,111817,0,3,4
31958,4,2,111818,111818,111820,0,2,1
31959,5,2,111823,111823,111825,0,2,3
31960,5,3,111828,111828,111831,0,3,3
31961,3,2,111831,111831,111833,0,2,0
31962,5,1,111836,111836,111837,0,1,3
31963,3,3,111839,111839,111842,0,3,2
31964,6,1,111845,111845,111846,0,1,3
31965,6,1,111851,111851,111852,0,1,5
31966,2,1,111853,111853,111854,0,1,1
31967,1,1,111854,111854,111855,0,1,0
31968,2,1,111856,111856,111857,0,1,1
31969,5,3,111861,111861,111864,0,3,4
31970,3,1,111864,111864,111865,0,1,0
31971,6,1,111870,111870,111871,0,1,5
31972,1,2,111871,111871,111873,0,2,0
31973,5,1,111876,111876,111877,0,1,3
31974,3,2,111879,111879,111881,0,2,2
31975,3,3,111882,111882,111885,0,3,1
31976,5,2,111887,111887,111889,0,2,2
31977,2,3,111889,111889,111892,0,3,0
31978,2,1,111891,111892,111893,1,2,0
31979,3,2,111894,111894,111896,0,2,1
31980,1,1,111895,111896,111897,1,2,0
31981,6,2,111901,111901,111903,0,2,4
31982,2,1,111903,111903,111904,0,1,0
31983,5,3,111908,111908,111911,0,3,4
31984,3,3,111911,111911,111914,0,3,0
31985,6,3,111917,111917,111920,0,3,3
31986,4,1,111921,111921,111922,0,1,1
31987,1,2,111922,111922,111924,0,2,0
31988,4,3,111926,111926,111929,0,3,2
31989,1,3,111927,111929,111932,2,5,0
31990,2,2,111929,111932,111934,3,5,0
31991,6,1,111935,111935,111936,0,1,1
31992,1,2,111936,111936,111938,0,2,0
31993,2,2,111938,111938,111940,0,2,0
31994,6,2,111944,111944,111946,0,2,4
31995,1,3,111945,111946,111949,1,4,0
31996,4,2,111949,111949,111951,0,2,0
31997,4,2,111953,111953,111955,0,2,2
31998,2,3,111955,111955,111958,0,3,0
31999,3,3,111958,111958,111961,0,3,0
32000,2,3,111960,111961,111964,1,4,0
32001,4,1,111964,111964,111965,0,1,0
32002,5,3,111969,111969,111972,0,3,4
32003,1,2,111970,111972,111974,2,4,0
32004,4,1,111974,111974,111975,0,1,0
32005,4,2,111978,111978,111980,0,2,3
32006,2,3,111980,111980,111983,0,3,0
32007,3,3,111983,111983,111986,0,3,0
32008,3,1,111986,111986,111987,0,1,0
32009,3,2,111989,111989,111991,0,2,2
32010,6,1,111995,111995,111996,0,1,4
32011,5,3,112000,112000,112003,0,3,4
32012,5,2,112005,112005,112007,0,2,2
32013,3,3,112008,112008,112011,0,3,1
32014,6,1,112014,112014,112015,0,1,3
32015,2,3,112016,112016,112019,0,3,1
32016,1,3,112017,112019,112022,2,5,0
32017,1,2,112018,112022,112024,4,6,0
32018,6,1,112024,112024,112025,0,1,0
32019,3,3,112027,112027,112030,0,3,2
32020,1,3,112028,112030,112033,2,5,0
32021,4,1,112032,112033,112034,1,2,0
32022,3,1,112035,112035,112036,0,1,1
32023,6,3,112041,112041,112044,0,3,5
32024,5,1,112046,112046,112047,0,1,2
32025,6,3,112052,112052,112055,0,3,5
32026,5,2,112057,112057,112059,0,2,2
32027,5,2,112062,112062,112064,0,2,3
32028,3,3,112065,112065,112068,0,3,1
32029,6,2,112071,112071,112073,0,2,3
32030,4,3,112075,112075,112078,0,3,2
32031,5,3,112080,112080,112083,0,3,2
32032,6,2,112086,112086,112088,0,2,3
32033,4,2,112090,112090,112092,0,2,2
32034,2,3,112092,112092,112095,0,3,0
32035,2,2,112094,112095,112097,1,3,0
32036,4,3,112098,112098,112101,0,3,1
32037,2,3,112100,112101,112104,1,4,0
32038,1,2,112101,112104,112106,3,5,0
32039,4,1,112105,112106,112107,1,2,0
32040,3,1,112108,112108,112109,0,1,1
32041,5,3,112113,112113,112116,0,3,4
32042,5,3,112118,112118,112121,0,3,2
32043,6,2,112124,112124,112126,0,2,3
32044,5,1,112129,112129,112130,0,1,3
32045,5,1,112134,112134,112135,0,1,4
32046,6,3,112140,112140,112143,0,3,5
32047,3,3,112143,112143,112146,0,3,0
32048,2,2,112145,112146,112148,1,3,0
32049,4,3,112149,112149,112152,0,3,1
32050,1,1,112150,112152,112153,2,3,0
32051,2,3,112152,112153,112156,1,4,0
32052,6,2,112158,112158,112160,0,2,2
32053,5,1,112163,112163,112164,0,1,3
32054,4,1,112167,112167,112168,0,1,3
32055,6,2,112173,112173,112175,0,2,5
32056,4,3,112177,112177,112180,0,3,2
32057,2,3,112179,112180,112183,1,4,0
32058,2,1,112181,112183,112184,2,3,0
32059,3,2,112184,112184,112186,0,2,0
32060,2,2,112186,112186,112188,0,2,0
32061,1,3,112187,112188,112191,1,4,0
32062,5,2,112192,112192,112194,0,2,1
32063,6,2,112198,112198,112200,0,2,4
32064,1,3,112199,112200,112203,1,4,0
32065,2,2,112201,112203,112205,2,4,0
32066,3,2,112204,112205,112207,1,3,0
32067,5,2,112209,112209,112211,0,2,2
32068,5,3,112214,112214,112217,0,3,3
32069,4,2,112218,112218,112220,0,2,1
32070,2,2,112220,112220,112222,0,2,0
32071,1,1,112221,112222,112223,1,2,0
32072,5,1,112226,112226,112227,0,1,3
32073,1,2,112227,112227,112229,0,2,0
32074,2,2,112229,112229,112231,0,2,0
32075,5,1,112234,112234,112235,0,1,3
32076,4,1,112238,112238,112239,0,1,3
32077,4,1,112242,112242,112243,0,1,3
32078,5,1,112247,112247,112248,0,1,4
32079,2,2,112249,112249,112251,0,2,1
32080,6,2,112255,112255,112257,0,2,4
32081,1,2,112256,112257,112259,1,3,0
32082,6,3,112262,112262,112265,0,3,3
32083,3,1,112265,112265,112266,0,1,0
32084,2,3,112267,112267,112270,0,3,1
32085,6,2,112273,112273,112275,0,2,3
32086,3,2,112276,112276,112278,0,2,1
32087,4,3,112280,112280,112283,0,3,2
32088,1,1,112281,112283,112284,2,3,0
32089,3,1,112284,112284,112285,0,1,0
32090,4,3,112288,112288,112291,0,3,3
32091,5,2,112293,112293,112295,0,2,2
32092,6,1,112299,112299,112300,0,1,4
32093,1,1,112300,112300,112301,0,1,0
32094,3,1,112303,112303,112304,0,1,2
32095,6,3,112309,112309,112312,0,3,5
32096,2,2,112311,112312,112314,1,3,0
32097,6,1,112317,112317,112318,0,1,3
32098,3,1,112320,112320,112321,0,1,2
32099,1,2,112321,112321,112323,0,2,0
32100,3,2,112324,112324,112326,0,2,1
32101,4,3,112328,112328,112331,0,3,2
32102,5,3,112333,112333,112336,0,3,2
32103,4,2,112337,112337,112339,0,2,1
32104,4,3,112341,112341,112344,0,3,2
32105,2,1,112343,112344,112345,1,2,0
32106,3,1,112346,112346,112347,0,1,1
32107,2,2,112348,112348,112350,0,2,1
32108,3,3,112351,112351,112354,0,3,1
32109,3,3,112354,112354,112357,0,3,0
32110,3,2,112357,112357,112359,0,2,0
32111,6,3,112363,112363,112366,0,3,4
32112,6,2,112369,112369,112371,0,2,3
32113,1,1,112370,112371,112372,1,2,0
32114,1,2,112371,112372,112374,1,3,0
32115,6,1,112377,112377,112378,0,1,3
32116,3,2,112380,112380,112382,0,2,2
32117,2,3,112382,112382,112385,0,3,0
32118,5,2,112387,112387,112389,0,2,2
32119,6,2,112393,112393,112395,0,2,4
32120,1,2,112394,112395,112397,1,3,0
32121,1,3,112395,112397,112400,2,5,0
32122,6,1,112401,112401,112402,0,1,1
32123,2,3,112403,112403,112406,0,3,1
32124,6,3,112409,112409,112412,0,3,3
32125,6,1,112415,112415,112416,0,1,3
32126,3,1,112418,112418,112419,0,1,2
32127,4,2,112422,112422,112424,0,2,3
32128,5,2,112427,112427,112429,0,2,3
32129,1,3,112428,112429,112432,1,4,0
32130,2,2,112430,112432,112434,2,4,0
32131,6,3,112436,112436,112439,0,3,2
32132,6,3,112442,112442,112445,0,3,3
32133,6,2,112448,112448,112450,0,2,3
32134,1,3,112449,112450,112453,1,4,0
32135,6,2,112455,112455,112457,0,2,2
32136,5,1,112460,112460,112461,0,1,3
32137,2,1,112462,112462,112463,0,1,1
32138,1,2,112463,112463,112465,0,2,0
32139,3,1,112466,112466,112467,0,1,1
32140,6,2,112472,112472,112474,0,2,5
32141,3,1,112475,112475,112476,0,1,1
32142,3,3,112478,112478,112481,0,3,2
32143,3,2,112481,112481,112483,0,2,0
32144,6,3,112487,112487,112490,0,3,4
32145,6,1,112493,112493,112494,0,1,3
32146,3,1,112496,112496,112497,0,1,2
32147,5,3,112501,112501,112504,0,3,4
32148,3,1,112504,112504,112505,0,1,0
32149,6,2,112510,112510,112512,0,2,5
32150,5,2,112515,112515,112517,0,2,3
32151,1,3,112516,112517,112520,1,4,0
32152,6,3,112522,112522,112525,0,3,2
32153,5,1,112527,112527,112528,0,1,2
32154,4,1,112531,112531,112532,0,1,3
32155,2,2,112533,112533,112535,0,2,1
32156,1,2,112534,112535,112537,1,3,0
32157,3,3,112537,112537,112540,0,3,0
32158,4,1,112541,112541,112542,0,1,1
32159,4,1,112545,112545,112546,0,1,3
32160,3,3,112548,112548,112551,0,3,2
32161,4,2,112552,112552,112554,0,2,1
32162,3,1,112555,112555,112556,0,1,1
32163,3,2,112558,112558,112560,0,2,2
32164,4,3,112562,112562,112565,0,3,2
32165,6,2,112568,112568,112570,0,2,3
32166,6,2,112574,112574,112576,0,2,4
32167,4,2,112578,112578,112580,0,2,2
32168,1,3,112579,112580,112583,1,4,0
32169,5,1,112584,112584,112585,0,1,1
32170,1,1,112585,112585,112586,0,1,0
32171,3,1,112588,112588,112589,0,1,2
32172,3,3,112591,112591,112594,0,3,2
32173,3,3,112594,112594,112597,0,3,0
32174,5,1,112599,112599,112600,0,1,2
32175,5,1,112604,112604,112605,0,1,4
32176,4,1,112608,112608,112609,0,1,3
32177,1,3,112609,112609,112612,0,3,0
32178,6,1,112615,112615,112616,0,1,3
32179,4,1,112619,112619,112620,0,1,3
32180,4,1,112623,112623,112624,0,1,3
32181,6,3,112629,112629,112632,0,3,5
32182,5,3,112634,112634,112637,0,3,2
32183,2,3,112636,112637,112640,1,4,0
32184,1,3,112637,112640,112643,3,6,0
32185,1,1,112638,112643,112644,5,6,0
32186,4,1,112642,112644,112645,2,3,0
32187,5,2,112647,112647,112649,0,2,2
32188,5,1,112652,112652,112653,0,1,3
32189,2,3,112654,112654,112657,0,3,1
32190,4,3,112658,112658,112661,0,3,1
32191,1,2,112659,112661,112663,2,4,0
32192,5,1,112664,112664,112665,0,1,1
32193,4,3,112668,112668,112671,0,3,3
32194,6,3,112674,112674,112677,0,3,3
32195,3,2,112677,112677,112679,0,2,0
32196,5,2,112682,112682,112684,0,2,3
32197,3,2,112685,112685,112687,0,2,1
32198,6,2,112691,112691,112693,0,2,4
32199,1,3,112692,112693,112696,1,4,0
32200,4,2,112696,112696,112698,0,2,0
32201,6,1,112702,112702,112703,0,1,4
32202,6,1,112708,112708,112709,0,1,5
32203,5,2,112713,112713,112715,0,2,4
32204,4,2,112717,112717,112719,0,2,2
32205,5,1,112722,112722,112723,0,1,3
32206,5,2,112727,112727,112729,0,2,4
32207,4,2,112731,112731,112733,0,2,2
32208,2,1,112733,112733,112734,0,1,0
32209,6,3,112739,112739,112742,0,3,5
32210,2,1,112741,112742,112743,1,2,0
32211,1,3,112742,112743,112746,1,4,0
32212,1,1,112743,112746,112747,3,4,0
32213,6,3,112749,112749,112752,0,3,2
32214,4,3,112753,112753,112756,0,3,1
32215,2,2,112755,112756,112758,1,3,0
32216,5,2,112760,112760,112762,0,2,2
32217,2,3,112762,112762,112765,0,3,0
32218,3,3,112765,112765,112768,0,3,0
32219,2,1,112767,112768,112769,1,2,0
32220,2,3,112769,112769,112772,0,3,0
32221,4,2,112773,112773,112775,0,2,1
32222,1,3,112774,112775,112778,1,4,0
32223,6,2,112780,112780,112782,0,2,2
32224,2,3,112782,112782,112785,0,3,0
32225,5,2,112787,112787,112789,0,2,2
32226,3,2,112790,112790,112792,0,2,1
32227,4,2,112794,112794,112796,0,2,2
32228,2,2,112796,112796,112798,0,2,0
32229,3,1,112799,112799,112800,0,1,1
32230,2,3,112801,112801,112804,0,3,1
32231,1,1,112802,112804,112805,2,3,0
32232,5,2,112807,112807,112809,0,2,2
32233,2,3,112809,112809,112812,0,3,0
32234,1,3,112810,112812,112815,2,5,0
32235,5,1,112815,112815,112816,0,1,0
32236,3,3,112818,112818,112821,0,3,2
32237,2,2,112820,112821,112823,1,3,0
32238,5,2,112825,112825,112827,0,2,2
32239,5,3,112830,112830,112833,0,3,3
32240,4,1,112834,112834,112835,0,1,1
32241,1,3,112835,112835,112838,0,3,0
32242,5,2,112840,112840,112842,0,2,2
32243,3,3,112843,112843,112846,0,3,1
32244,5,3,112848,112848,112851,0,3,2
32245,3,1,112851,112851,112852,0,1,0
32246,2,3,112853,112853,112856,0,3,1
32247,2,2,112855,112856,112858,1,3,0
32248,6,1,112861,112861,112862,0,1,3
32249,5,1,112866,112866,112867,0,1,4
32250,6,2,112872,112872,112874,0,2,5
32251,1,3,112873,112874,112877,1,4,0
32252,6,3,112879,112879,112882,0,3,2
32253,4,3,112883,112883,112886,0,3,1
32254,3,3,112886,112886,112889,0,3,0
32255,3,3,112889,112889,112892,0,3,0
32256,6,1,112895,112895,112896,0,1,3
32257,2,1,112897,112897,112898,0,1,1
32258,2,2,112899,112899,112901,0,2,1
32259,2,1,112901,112901,112902,0,1,0
32260,3,1,112904,112904,112905,0,1,2
32261,4,3,112908,112908,112911,0,3,3
32262,5,2,112913,112913,112915,0,2,2
32263,3,2,112916,112916,112918,0,2,1
32264,1,1,112917,112918,112919,1,2,0
32265,3,1,112920,112920,112921,0,1,1
32266,1,1,112921,112921,112922,0,1,0
32267,6,2,112927,112927,112929,0,2,5
32268,3,2,112930,112930,112932,0,2,1
32269,1,1,112931,112932,112933,1,2,0
32270,5,2,112936,112936,112938,0,2,3
32271,6,2,112942,112942,112944,0,2,4
32272,5,1,112947,112947,112948,0,1,3
32273,1,1,112948,112948,112949,0,1,0
32274,4,1,112952,112952,112953,0,1,3
32275,2,2,112954,112954,112956,0,2,1
32276,2,2,112956,112956,112958,0,2,0
32277,3,1,112959,112959,112960,0,1,1
32278,5,2,112964,112964,112966,0,2,4
32279,4,1,112968,112968,112969,0,1,2
32280,6,2,112974,112974,112976,0,2,5
32281,2,1,112976,112976,112977,0,1,0
32282,1,2,112977,112977,112979,0,2,0
32283,1,1,112978,112979,112980,1,2,0
32284,6,1,112984,112984,112985,0,1,4
32285,2,1,112986,112986,112987,0,1,1
32286,1,3,112987,112987,112990,0,3,0
32287,4,2,112991,112991,112993,0,2,1
32288,4,1,112995,112995,112996,0,1,2
32289,4,1,112999,112999,113000,0,1,3
32290,4,1,113003,113003,113004,0,1,3
32291,6,3,113009,113009,113012,0,3,5
32292,5,2,113014,113014,113016,0,2,2
32293,6,1,113020,113020,113021,0,1,4
32294,1,1,113021,113021,113022,0,1,0
32295,5,1,113026,113026,113027,0,1,4
32296,1,2,113027,113027,113029,0,2,0
32297,3,2,113030,113030,113032,0,2,1
32298,4,3,113034,113034,113037,0,3,2
32299,1,3,113035,113037,113040,2,5,0
32300,2,1,113037,113040,113041,3,4,0
32301,2,1,113039,113041,113042,2,3,0
32302,6,2,113045,113045,113047,0,2,3
32303,1,2,113046,113047,113049,1,3,0
32304,1,2,113047,113049,113051,2,4,0
32305,4,1,113051,113051,113052,0,1,0
32306,5,3,113056,113056,113059,0,3,4
32307,1,1,113057,113059,113060,2,3,0
32308,5,3,113062,113062,113065,0,3,2
32309,4,1,113066,113066,113067,0,1,1
32310,3,3,113069,113069,113072,0,3,2
32311,5,2,113074,113074,113076,0,2,2
32312,1,3,113075,113076,113079,1,4,0
32313,3,3,113078,113079,113082,1,4,0
32314,5,2,113083,113083,113085,0,2,1
32315,4,1,113087,113087,113088,0,1,2
32316,1,3,113088,113088,113091,0,3,0
32317,1,3,113089,113091,113094,2,5,0
32318,2,2,113091,113094,113096,3,5,0
32319,1,2,113092,113096,113098,4,6,0
32320,2,3,113094,113098,113101,4,7,0
32321,5,1,113099,113101,113102,2,3,0
32322,2,2,113101,113102,113104,1,3,0
32323,4,2,113105,113105,113107,0,2,1
32324,5,1,113110,113110,113111,0,1,3
32325,4,2,113114,113114,113116,0,2,3
32326,1,1,113115,113116,113117,1,2,0
32327,1,3,113116,113117,113120,1,4,0
32328,1,2,113117,113120,113122,3,5,0
32329,2,1,113119,113122,113123,3,4,0
32330,3,1,113122,113123,113124,1,2,0
32331,5,2,113127,113127,113129,0,2,3
32332,2,3,113129,113129,113132,0,3,0
32333,2,1,113131,113132,113133,1,2,0
32334,1,2,113132,113133,113135,1,3,0
32335,5,3,113137,113137,113140,0,3,2
32336,4,3,113141,113141,113144,0,3,1
32337,4,1,113145,113145,113146,0,1,1
32338,4,1,113149,113149,113150,0,1,3
32339,3,1,113152,113152,113153,0,1,2
32340,6,1,113158,113158,113159,0,1,5
32341,2,3,113160,113160,113163,0,3,1
32342,2,1,113162,113163,113164,1,2,0
32343,2,1,113164,113164,113165,0,1,0
32344,4,1,113168,113168,113169,0,1,3
32345,3,2,113171,113171,113173,0,2,2
32346,3,2,113174,113174,113176,0,2,1
32347,3,3,113177,113177,113180,0,3,1
32348,6,2,113183,113183,113185,0,2,3
32349,6,2,113189,113189,113191,0,2,4
32350,2,2,113191,113191,113193,0,2,0
32351,5,1,113196,113196,113197,0,1,3
32352,4,2,113200,113200,113202,0,2,3
32353,2,2,113202,113202,113204,0,2,0
32354,3,1,113205,113205,113206,0,1,1
32355,2,3,113207,113207,113210,0,3,1
32356,1,2,113208,113210,113212,2,4,0
32357,2,3,113210,113212,113215,2,5,0
32358,4,3,113214,113215,113218,1,4,0
32359,2,2,113216,113218,113220,2,4,0
32360,6,2,113222,113222,113224,0,2,2
32361,1,2,113223,113224,113226,1,3,0
32362,2,1,113225,113226,113227,1,2,0
32363,5,3,113230,113230,113233,0,3,3
32364,2,2,113232,113233,113235,1,3,0
32365,5,3,113237,113237,113240,0,3,2
32366,5,2,113242,113242,113244,0,2,2
32367,2,3,113244,113244,113247,0,3,0
32368,3,2,113247,113247,113249,0,2,0
32369,5,3,113252,113252,113255,0,3,3
32370,6,1,113258,113258,113259,0,1,3
32371,5,2,113263,113263,113265,0,2,4
32372,2,3,113265,113265,113268,0,3,0
32373,5,3,113270,113270,113273,0,3,2
32374,4,1,113274,113274,113275,0,1,1
32375,4,3,113278,113278,113281,0,3,3
32376,2,3,113280,113281,113284,1,4,0
32377,6,3,113286,113286,113289,0,3,2
32378,4,2,113290,113290,113292,0,2,1
32379,3,1,113293,113293,113294,0,1,1
32380,6,2,113299,113299,113301,0,2,5
32381,3,2,113302,113302,113304,0,2,1
32382,5,3,113307,113307,113310,0,3,3
32383,6,3,113313,113313,113316,0,3,3
32384,2,2,113315,113316,113318,1,3,0
32385,5,1,113320,113320,113321,0,1,2
32386,2,1,113322,113322,113323,0,1,1
32387,1,3,113323,113323,113326,0,3,0
32388,3,3,113326,113326,113329,0,3,0
32389,1,2,113327,113329,113331,2,4,0
32390,3,2,113330,113331,113333,1,3,0
32391,6,3,113336,113336,113339,0,3,3
32392,4,2,113340,113340,113342,0,2,1
32393,3,2,113343,113343,113345,0,2,1
32394,3,3,113346,113346,113349,0,3,1
32395,6,2,113352,113352,113354,0,2,3
32396,4,3,113356,113356,113359,0,3,2
32397,2,1,113358,113359,113360,1,2,0
32398,2,2,113360,113360,113362,0,2,0
32399,2,2,113362,113362,113364,0,2,0
32400,3,1,113365,113365,113366,0,1,1
32401,1,2,113366,113366,113368,0,2,0
32402,4,3,113370,113370,113373,0,3,2
32403,5,2,113375,113375,113377,0,2,2
32404,4,1,113379,113379,113380,0,1,2
32405,5,3,113384,113384,113387,0,3,4
32406,6,2,113390,113390,113392,0,2,3
32407,6,1,113396,113396,113397,0,1,4
32408,4,3,113400,113400,113403,0,3,3
32409,1,2,113401,113403,113405,2,4,0
32410,3,2,113404,113405,113407,1,3,0
32411,5,2,113409,113409,113411,0,2,2
32412,3,1,113412,113412,113413,0,1,1
32413,5,2,113417,113417,113419,0,2,4
32414,5,1,113422,113422,113423,0,1,3
32415,2,3,113424,113424,113427,0,3,1
32416,5,3,113429,113429,113432,0,3,2
32417,5,3,113434,113434,113437,0,3,2
32418,6,2,113440,113440,113442,0,2,3
32419,6,3,113446,113446,113449,0,3,4
32420,3,1,113449,113449,113450,0,1,0
32421,5,2,113454,113454,113456,0,2,4
32422,6,1,113460,113460,113461,0,1,4
32423,3,2,113463,113463,113465,0,2,2
32424,1,1,113464,113465,113466,1,2,0
32425,5,3,113469,113469,113472,0,3,3
32426,4,1,113473,113473,113474,0,1,1
32427,2,1,113475,113475,113476,0,1,1
32428,5,2,113480,113480,113482,0,2,4
32429,4,2,113484,113484,113486,0,2,2
32430,2,3,113486,113486,113489,0,3,0
32431,1,1,113487,113489,113490,2,3,0
32432,3,3,113490,113490,113493,0,3,0
32433,2,3,113492,113493,113496,1,4,0
32434,5,3,113497,113497,113500,0,3,1
32435,2,2,113499,113500,113502,1,3,0
32436,5,3,113504,113504,113507,0,3,2
32437,3,1,113507,113507,113508,0,1,0
32438,6,1,113513,113513,113514,0,1,5
32439,2,2,113515,113515,113517,0,2,1
32440,6,2,113521,113521,113523,0,2,4
32441,3,2,113524,113524,113526,0,2,1
32442,4,2,113528,113528,113530,0,2,2
32443,6,3,113534,113534,113537,0,3,4
32444,4,1,113538,113538,113539,0,1,1
32445,3,1,113541,113541,113542,0,1,2
32446,4,2,113545,113545,113547,0,2,3
32447,4,1,113549,113549,113550,0,1,2
32448,4,1,113553,113553,113554,0,1,3
32449,3,2,113556,113556,113558,0,2,2
32450,5,1,113561,113561,113562,0,1,3
32451,2,3,113563,113563,113566,0,3,1
32452,4,3,113567,113567,113570,0,3,1
32453,6,1,113573,113573,113574,0,1,3
32454,5,1,113578,113578,113579,0,1,4
32455,6,2,113584,113584,113586,0,2,5
32456,2,1,113586,113586,113587,0,1,0
32457,3,1,113589,113589,113590,0,1,2
32458,4,1,113593,113593,113594,0,1,3
32459,6,3,113599,113599,113602,0,3,5
32460,4,3,113603,113603,113606,0,3,1
32461,3,3,113606,113606,113609,0,3,0
32462,4,1,113610,113610,113611,0,1,1
32463,3,1,113613,113613,113614,0,1,2
32464,2,1,113615,113615,113616,0,1,1
32465,2,1,113617,113617,113618,0,1,1
32466,4,3,113621,113621,113624,0,3,3
32467,3,1,113624,113624,113625,0,1,0
32468,2,2,113626,113626,113628,0,2,1
32469,6,3,113632,113632,113635,0,3,4
32470,3,1,113635,113635,113636,0,1,0
32471,6,3,113641,113641,113644,0,3,5
32472,5,1,113646,113646,113647,0,1,2
32473,5,1,113651,113651,113652,0,1,4
32474,3,2,113654,113654,113656,0,2,2
32475,2,1,113656,113656,113657,0,1,0
32476,6,1,113662,113662,113663,0,1,5
32477,3,1,113665,113665,113666,0,1,2
32478,1,3,113666,113666,113669,0,3,0
32479,4,1,113670,113670,113671,0,1,1
32480,5,1,113675,113675,113676,0,1,4
32481,4,2,113679,113679,113681,0,2,3
32482,3,2,113682,113682,113684,0,2,1
32483,1,1,113683,113684,113685,1,2,0
32484,6,3,113689,113689,113692,0,3,4
32485,3,3,113692,113692,113695,0,3,0
32486,6,1,113698,113698,113699,0,1,3
32487,3,3,113701,113701,113704,0,3,2
32488,2,3,113703,113704,113707,1,4,0
32489,5,1,113708,113708,113709,0,1,1
32490,3,2,113711,113711,113713,0,2,2
32491,6,1,113717,113717,113718,0,1,4
32492,1,2,113718,113718,113720,0,2,0
32493,2,1,113720,113720,113721,0,1,0
32494,3,1,113723,113723,113724,0,1,2
32495,3,1,113726,113726,113727,0,1,2
32496,6,3,113732,113732,113735,0,3,5
32497,1,3,113733,113735,113738,2,5,0
32498,1,3,113734,113738,113741,4,7,0
32499,5,2,113739,113741,113743,2,4,0
32500,5,1,113744,113744,113745,0,1,1
32501,2,1,113746,113746,113747,0,1,1
32502,2,3,113748,113748,113751,0,3,1
32503,2,1,113750,113751,113752,1,2,0
32504,5,1,113755,113755,113756,0,1,3
32505,2,2,113757,113757,113759,0,2,1
32506,2,2,113759,113759,113761,0,2,0
32507,2,1,113761,113761,113762,0,1,0
32508,4,2,113765,113765,113767,0,2,3
32509,6,3,113771,113771,113774,0,3,4
32510,1,2,113772,113774,113776,2,4,0
32511,2,3,113774,113776,113779,2,5,0
32512,6,1,113780,113780,113781,0,1,1
32513,5,3,113785,113785,113788,0,3,4
32514,3,3,113788,113788,113791,0,3,0
32515,3,2,113791,113791,113793,0,2,0
32516,3,3,113794,113794,113797,0,3,1
32517,6,1,113800,113800,113801,0,1,3
32518,3,2,113803,113803,113805,0,2,2
32519,4,3,113807,113807,113810,0,3,2
32520,4,2,113811,113811,113813,0,2,1
32521,2,1,113813,113813,113814,0,1,0
32522,5,1,113818,113818,113819,0,1,4
32523,6,3,113824,113824,113827,0,3,5
32524,2,1,113826,113827,113828,1,2,0
32525,5,1,113831,113831,113832,0,1,3
32526,5,1,113836,113836,113837,0,1,4
32527,5,1,113841,113841,113842,0,1,4
32528,2,1,113843,113843,113844,0,1,1
32529,2,3,113845,113845,113848,0,3,1
32530,4,2,113849,113849,113851,0,2,1
32531,6,1,113855,113855,113856,0,1,4
32532,4,3,113859,113859,113862,0,3,3
32533,3,1,113862,113862,113863,0,1,0
32534,1,2,113863,113863,113865,0,2,0
32535,2,1,113865,113865,113866,0,1,0
32536,5,3,113870,113870,113873,0,3,4
32537,5,3,113875,113875,113878,0,3,2
32538,5,2,113880,113880,113882,0,2,2
32539,2,1,113882,113882,113883,0,1,0
32540,4,3,113886,113886,113889,0,3,3
32541,3,2,113889,113889,113891,0,2,0
32542,1,2,113890,113891,113893,1,3,0
32543,3,3,113893,113893,113896,0,3,0
32544,5,3,113898,113898,113901,0,3,2
32545,2,2,113900,113901,113903,1,3,0
32546,5,1,113905,113905,113906,0,1,2
32547,4,3,113909,113909,113912,0,3,3
32548,3,2,113912,113912,113914,0,2,0
32549,1,3,113913,113914,113917,1,4,0
32550,3,1,113916,113917,113918,1,2,0
32551,3,1,113919,113919,113920,0,1,1
32552,4,3,113923,113923,113926,0,3,3
32553,4,3,113927,113927,113930,0,3,1
32554,6,1,113933,113933,113934,0,1,3
32555,5,3,113938,113938,113941,0,3,4
32556,5,3,113943,113943,113946,0,3,2
32557,2,2,113945,113946,113948,1,3,0
32558,1,3,113946,113948,113951,2,5,0
32559,6,3,113952,113952,113955,0,3,1
32560,2,2,113954,113955,113957,1,3,0
32561,4,3,113958,113958,113961,0,3,1
32562,1,1,113959,113961,113962,2,3,0
32563,3,1,113962,113962,113963,0,1,0
32564,2,2,113964,113964,113966,0,2,1
32565,3,1,113967,113967,113968,0,1,1
32566,1,2,113968,113968,113970,0,2,0
32567,6,2,113974,113974,113976,0,2,4
32568,5,2,113979,113979,113981,0,2,3
32569,3,1,113982,113982,113983,0,1,1
32570,5,3,113987,113987,113990,0,3,4
32571,6,1,113993,113993,113994,0,1,3
32572,2,1,113995,113995,113996,0,1,1
32573,1,2,113996,113996,113998,0,2,0
32574,1,3,113997,113998,114001,1,4,0
32575,5,1,114002,114002,114003,0,1,1
32576,5,3,114007,114007,114010,0,3,4
32577,6,1,114013,114013,114014,0,1,3
32578,2,2,114015,114015,114017,0,2,1
32579,3,3,114018,114018,114021,0,3,1
32580,2,2,114020,114021,114023,1,3,0
32581,6,2,114026,114026,114028,0,2,3
32582,2,3,114028,114028,114031,0,3,0
32583,2,1,114030,114031,114032,1,2,0
32584,2,3,114032,114032,114035,0,3,0
32585,6,2,114038,114038,114040,0,2,3
32586,3,1,114041,114041,114042,0,1,1
32587,1,1,114042,114042,114043,0,1,0
32588,2,3,114044,114044,114047,0,3,1
32589,6,2,114050,114050,114052,0,2,3
32590,1,3,114051,114052,114055,1,4,0
32591,1,1,114052,114055,114056,3,4,0
32592,3,2,114055,114056,114058,1,3,0
32593,1,3,114056,114058,114061,2,5,0
32594,3,2,114059,114061,114063,2,4,0
32595,3,1,114062,114063,114064,1,2,0
32596,3,1,114065,114065,114066,0,1,1
32597,6,2,114071,114071,114073,0,2,5
32598,2,1,114073,114073,114074,0,1,0
32599,1,3,114074,114074,114077,0,3,0
32600,4,2,114078,114078,114080,0,2,1
32601,3,3,114081,114081,114084,0,3,1
32602,3,1,114084,114084,114085,0,1,0
32603,1,2,114085,114085,114087,0,2,0
32604,5,3,114090,114090,114093,0,3,3
32605,4,1,114094,114094,114095,0,1,1
32606,5,2,114099,114099,114101,0,2,4
32607,3,2,114102,114102,114104,0,2,1
32608,5,2,114107,114107,114109,0,2,3
32609,3,2,114110,114110,114112,0,2,1
32610,6,2,114116,114116,114118,0,2,4
32611,3,3,114119,114119,114122,0,3,1
32612,3,1,114122,114122,114123,0,1,0
32613,1,3,114123,114123,114126,0,3,0
32614,4,3,114127,114127,114130,0,3,1
32615,1,2,114128,114130,114132,2,4,0
32616,1,1,114129,114132,114133,3,4,0
32617,1,3,114130,114133,114136,3,6,0
32618,1,3,114131,114136,114139,5,8,0
32619,3,3,114134,114139,114142,5,8,0
32620,6,3,114140,114142,114145,2,5,0
32621,3,3,114143,114145,114148,2,5,0
32622,1,2,114144,114148,114150,4,6,0
32623,3,2,114147,114150,114152,3,5,0
32624,4,3,114151,114152,114155,1,4,0
32625,1,3,114152,114155,114158,3,6,0
32626,1,2,114153,114158,114160,5,7,0
32627,5,2,114158,114160,114162,2,4,0
32628,5,1,114163,114163,114164,0,1,1
32629,1,3,114164,114164,114167,0,3,0
32630,2,2,114166,114167,114169,1,3,0
32631,1,3,114167,114169,114172,2,5,0
32632,1,2,114168,114172,114174,4,6,0
32633,1,3,114169,114174,114177,5,8,0
32634,5,2,114174,114177,114179,3,5,0
32635,6,2,114180,114180,114182,0,2,1
32636,5,1,114185,114185,114186,0,1,3
32637,5,1,114190,114190,114191,0,1,4
32638,6,2,114196,114196,114198,0,2,5
32639,5,2,114201,114201,114203,0,2,3
32640,2,2,114203,114203,114205,0,2,0
32641,5,2,114208,114208,114210,0,2,3
32642,3,3,114211,114211,114214,0,3,1
32643,1,3,114212,114214,114217,2,5,0
32644,6,3,114218,114218,114221,0,3,1
32645,2,3,114220,114221,114224,1,4,0
32646,4,2,114224,114224,114226,0,2,0
32647,4,2,114228,114228,114230,0,2,2
32648,2,1,114230,114230,114231,0,1,0
32649,4,1,114234,114234,114235,0,1,3
32650,4,3,114238,114238,114241,0,3,3
32651,3,1,114241,114241,114242,0,1,0
32652,3,1,114244,114244,114245,0,1,2
32653,3,3,114247,114247,114250,0,3,2
32654,4,1,114251,114251,114252,0,1,1
32655,1,3,114252,114252,114255,0,3,0
32656,2,3,114254,114255,114258,1,4,0
32657,3,3,114257,114258,114261,1,4,0
32658,6,3,114263,114263,114266,0,3,2
32659,6,3,114269,114269,114272,0,3,3
32660,2,2,114271,114272,114274,1,3,0
32661,2,1,114273,114274,114275,1,2,0
32662,4,3,114277,114277,114280,0,3,2
32663,5,3,114282,114282,114285,0,3,2
32664,5,2,114287,114287,114289,0,2,2
32665,2,1,114289,114289,114290,0,1,0
32666,3,3,114292,114292,114295,0,3,2
32667,6,3,114298,114298,114301,0,3,3
32668,6,2,114304,114304,114306,0,2,3
32669,2,2,114306,114306,114308,0,2,0
32670,6,2,114312,114312,114314,0,2,4
32671,3,1,114315,114315,114316,0,1,1
32672,2,1,114317,114317,114318,0,1,1
32673,2,3,114319,114319,114322,0,3,1
32674,2,2,114321,114322,114324,1,3,0
32675,5,3,114326,114326,114329,0,3,2
32676,5,1,114331,114331,114332,0,1,2
32677,5,3,114336,114336,114339,0,3,4
32678,5,1,114341,114341,114342,0,1,2
32679,1,3,114342,114342,114345,0,3,0
32680,6,3,114348,114348,114351,0,3,3
32681,2,3,114350,114351,114354,1,4,0
32682,4,3,114354,114354,114357,0,3,0
32683,3,2,114357,114357,114359,0,2,0
32684,6,1,114363,114363,114364,0,1,4
32685,5,2,114368,114368,114370,0,2,4
32686,5,3,114373,114373,114376,0,3,3
32687,5,3,114378,114378,114381,0,3,2
32688,5,1,114383,114383,114384,0,1,2
32689,2,1,114385,114385,114386,0,1,1
32690,2,3,114387,114387,114390,0,3,1
32691,2,2,114389,114390,114392,1,3,0
32692,5,3,114394,114394,114397,0,3,2
32693,6,3,114400,114400,114403,0,3,3
32694,3,3,114403,114403,114406,0,3,0
32695,2,2,114405,114406,114408,1,3,0
32696,5,3,114410,114410,114413,0,3,2
32697,5,3,114415,114415,114418,0,3,2
32698,2,1,114417,114418,114419,1,2,0
32699,4,2,114421,114421,114423,0,2,2
32700,1,3,114422,114423,114426,1,4,0
32701,1,1,114423,114426,114427,3,4,0
32702,2,2,114425,114427,114429,2,4,0
32703,2,3,114427,114429,114432,2,5,0
32704,4,2,114431,114432,114434,1,3,0
32705,3,1,114434,114434,114435,0,1,0
32706,4,2,114438,114438,114440,0,2,3
32707,4,2,114442,114442,114444,0,2,2
32708,2,3,114444,114444,114447,0,3,0
32709,1,1,114445,114447,114448,2,3,0
32710,1,1,114446,114448,114449,2,3,0
32711,2,3,114448,114449,114452,1,4,0
32712,3,1,114451,114452,114453,1,2,0
32713,2,1,114453,114453,114454,0,1,0
32714,6,1,114459,114459,114460,0,1,5
32715,6,1,114465,114465,114466,0,1,5
32716,4,2,114469,114469,114471,0,2,3
32717,2,1,114471,114471,114472,0,1,0
32718,4,3,114475,114475,114478,0,3,3
32719,3,1,114478,114478,114479,0,1,0
32720,1,1,114479,114479,114480,0,1,0
32721,6,2,114485,114485,114487,0,2,5
32722,1,1,114486,114487,114488,1,2,0
32723,4,1,114490,114490,114491,0,1,2
32724,5,2,114495,114495,114497,0,2,4
32725,2,2,114497,114497,114499,0,2,0
32726,2,2,114499,114499,114501,0,2,0
32727,1,2,114500,114501,114503,1,3,0
32728,3,2,114503,114503,114505,0,2,0
32729,2,2,114505,114505,114507,0,2,0
32730,3,2,114508,114508,114510,0,2,1
32731,6,3,114514,114514,114517,0,3,4
32732,5,3,114519,114519,114522,0,3,2
32733,4,2,114523,114523,114525,0,2,1
32734,4,2,114527,114527,114529,0,2,2
32735,1,2,114528,114529,114531,1,3,0
32736,1,3,114529,114531,114534,2,5,0
32737,1,2,114530,114534,114536,4,6,0
32738,3,2,114533,114536,114538,3,5,0
32739,6,2,114539,114539,114541,0,2,1
32740,6,2,114545,114545,114547,0,2,4
32741,3,2,114548,114548,114550,0,2,1
32742,3,3,114551,114551,114554,0,3,1
32743,3,1,114554,114554,114555,0,1,0
32744,5,1,114559,114559,114560,0,1,4
32745,1,2,114560,114560,114562,0,2,0
32746,1,3,114561,114562,114565,1,4,0
32747,6,1,114567,114567,114568,0,1,2
32748,2,3,114569,114569,114572,0,3,1
32749,2,2,114571,114572,114574,1,3,0
32750,2,3,114573,114574,114577,1,4,0
32751,5,2,114578,114578,114580,0,2,1
32752,4,3,114582,114582,114585,0,3,2
32753,6,3,114588,114588,114591,0,3,3
32754,1,1,114589,114591,114592,2,3,0
32755,6,3,114595,114595,114598,0,3,3
32756,4,3,114599,114599,114602,0,3,1
32757,6,1,114605,114605,114606,0,1,3
32758,5,3,114610,114610,114613,0,3,4
32759,5,3,114615,114615,114618,0,3,2
32760,2,3,114617,114618,114621,1,4,0
32761,2,3,114619,114621,114624,2,5,0
32762,4,3,114623,114624,114627,1,4,0
32763,5,2,114628,114628,114630,0,2,1
32764,4,3,114632,114632,114635,0,3,2
32765,2,3,114634,114635,114638,1,4,0
32766,1,1,114635,114638,114639,3,4,0
32767,2,2,114637,114639,114641,2,4,0
32768,1,1,114638,114641,114642,3,4,0
32769,3,2,114641,114642,114644,1,3,0
32770,3,3,114644,114644,114647,0,3,0
32771,6,3,114650,114650,114653,0,3,3
32772,1,3,114651,114653,114656,2,5,0
32773,6,1,114657,114657,114658,0,1,1
32774,3,2,114660,114660,114662,0,2,2
32775,2,2,114662,114662,114664,0,2,0
32776,5,1,114667,114667,114668,0,1,3
32777,2,1,114669,114669,114670,0,1,1
32778,1,2,114670,114670,114672,0,2,0
32779,1,1,114671,114672,114673,1,2,0
32780,3,1,114674,114674,114675,0,1,1
32781,1,2,114675,114675,114677,0,2,0
32782,1,1,114676,114677,114678,1,2,0
32783,2,2,114678,114678,114680,0,2,0
32784,1,2,114679,114680,114682,1,3,0
32785,1,3,114680,114682,114685,2,5,0
32786,2,2,114682,114685,114687,3,5,0
32787,6,3,114688,114688,114691,0,3,1
32788,6,1,114694,114694,114695,0,1,3
32789,5,2,114699,114699,114701,0,2,4
32790,5,1,114704,114704,114705,0,1,3
32791,1,3,114705,114705,114708,0,3,0
32792,4,3,114709,114709,114712,0,3,1
32793,4,3,114713,114713,114716,0,3,1
32794,3,2,114716,114716,114718,0,2,0
32795,1,3,114717,114718,114721,1,4,0
32796,5,1,114722,114722,114723,0,1,1
32797,1,1,114723,114723,114724,0,1,0
32798,6,3,114729,114729,114732,0,3,5
32799,3,2,114732,114732,114734,0,2,0
32800,5,2,114737,114737,114739,0,2,3
32801,1,3,114738,114739,114742,1,4,0
32802,3,2,114741,114742,114744,1,3,0
32803,6,3,114747,114747,114750,0,3,3
32804,3,3,114750,114750,114753,0,3,0
32805,5,1,114755,114755,114756,0,1,2
32806,5,2,114760,114760,114762,0,2,4
32807,6,1,114766,114766,114767,0,1,4
32808,2,2,114768,114768,114770,0,2,1
32809,4,2,114772,114772,114774,0,2,2
32810,6,1,114778,114778,114779,0,1,4
32811,3,1,114781,114781,114782,0,1,2
32812,1,2,114782,114782,114784,0,2,0
32813,1,3,114783,114784,114787,1,4,0
32814,4,2,114787,114787,114789,0,2,0
32815,2,3,114789,114789,114792,0,3,0
32816,5,3,114794,114794,114797,0,3,2
32817,2,1,114796,114797,114798,1,2,0
32818,4,3,114800,114800,114803,0,3,2
32819,3,3,114803,114803,114806,0,3,0
32820,5,2,114808,114808,114810,0,2,2
32821,3,3,114811,114811,114814,0,3,1
32822,2,2,114813,114814,114816,1,3,0
32823,1,3,114814,114816,114819,2,5,0
32824,2,2,114816,114819,114821,3,5,0
32825,1,3,114817,114821,114824,4,7,0
32826,5,2,114822,114824,114826,2,4,0
32827,2,1,114824,114826,114827,2,3,0
32828,2,3,114826,114827,114830,1,4,0
32829,3,3,114829,114830,114833,1,4,0
32830,1,1,114830,114833,114834,3,4,0
32831,3,3,114833,114834,114837,1,4,0
32832,4,2,114837,114837,114839,0,2,0
32833,1,3,114838,114839,114842,1,4,0
32834,5,3,114843,114843,114846,0,3,1
32835,4,3,114847,114847,114850,0,3,1
32836,6,3,114853,114853,114856,0,3,3
32837,6,2,114859,114859,114861,0,2,3
32838,5,3,114864,114864,114867,0,3,3
32839,3,2,114867,114867,114869,0,2,0
32840,2,2,114869,114869,114871,0,2,0
32841,3,3,114872,114872,114875,0,3,1
32842,1,3,114873,114875,114878,2,5,0
32843,2,3,114875,114878,114881,3,6,0
32844,1,2,114876,114881,114883,5,7,0
32845,2,1,114878,114883,114884,5,6,0
32846,6,1,114884,114884,114885,0,1,0
32847,4,1,114888,114888,114889,0,1,3
32848,5,1,114893,114893,114894,0,1,4
32849,2,1,114895,114895,114896,0,1,1
32850,1,3,114896,114896,114899,0,3,0
32851,4,2,114900,114900,114902,0,2,1
32852,1,1,114901,114902,114903,1,2,0
32853,4,3,114905,114905,114908,0,3,2
32854,1,3,114906,114908,114911,2,5,0
32855,6,2,114912,114912,114914,0,2,1
32856,4,2,114916,114916,114918,0,2,2
32857,5,1,114921,114921,114922,0,1,3
32858,5,2,114926,114926,114928,0,2,4
32859,5,2,114931,114931,114933,0,2,3
32860,4,3,114935,114935,114938,0,3,2
32861,4,3,114939,114939,114942,0,3,1
32862,6,1,114945,114945,114946,0,1,3
32863,3,2,114948,114948,114950,0,2,2
32864,3,2,114951,114951,114953,0,2,1
32865,4,1,114955,114955,114956,0,1,2
32866,6,1,114961,114961,114962,0,1,5
32867,6,2,114967,114967,114969,0,2,5
32868,6,3,114973,114973,114976,0,3,4
32869,2,3,114975,114976,114979,1,4,0
32870,6,1,114981,114981,114982,0,1,2
32871,5,3,114986,114986,114989,0,3,4
32872,1,3,114987,114989,114992,2,5,0
32873,2,2,114989,114992,114994,3,5,0
32874,1,3,114990,114994,114997,4,7,0
32875,4,2,114994,114997,114999,3,5,0
32876,6,1,115000,115000,115001,0,1,1
32877,5,2,115005,115005,115007,0,2,4
32878,4,1,115009,115009,115010,0,1,2
32879,6,1,115015,115015,115016,0,1,5
32880,4,1,115019,115019,115020,0,1,3
32881,3,1,115022,115022,115023,0,1,2
32882,3,2,115025,115025,115027,0,2,2
32883,3,3,115028,115028,115031,0,3,1
32884,6,2,115034,115034,115036,0,2,3
32885,6,1,115040,115040,115041,0,1,4
32886,4,3,115044,115044,115047,0,3,3
32887,2,1,115046,115047,115048,1,2,0
32888,2,1,115048,115048,115049,0,1,0
32889,1,3,115049,115049,115052,0,3,0
32890,1,2,115050,115052,115054,2,4,0
32891,3,3,115053,115054,115057,1,4,0
32892,3,1,115056,115057,115058,1,2,0
32893,5,3,115061,115061,115064,0,3,3
32894,2,1,115063,115064,115065,1,2,0
32895,5,3,115068,115068,115071,0,3,3
32896,6,2,115074,115074,115076,0,2,3
32897,6,3,115080,115080,115083,0,3,4
32898,5,1,115085,115085,115086,0,1,2
32899,1,1,115086,115086,115087,0,1,0
32900,4,1,115090,115090,115091,0,1,3
32901,3,2,115093,115093,115095,0,2,2
32902,1,3,115094,115095,115098,1,4,0
32903,4,3,115098,115098,115101,0,3,0
32904,6,1,115104,115104,115105,0,1,3
32905,2,1,115106,115106,115107,0,1,1
32906,6,3,115112,115112,115115,0,3,5
32907,3,3,115115,115115,115118,0,3,0
32908,6,3,115121,115121,115124,0,3,3
32909,6,1,115127,115127,115128,0,1,3
32910,5,1,115132,115132,115133,0,1,4
32911,5,3,115137,115137,115140,0,3,4
32912,3,2,115140,115140,115142,0,2,0
32913,6,2,115146,115146,115148,0,2,4
32914,6,3,115152,115152,115155,0,3,4
32915,1,2,115153,115155,115157,2,4,0
32916,5,1,115158,115158,115159,0,1,1
32917,2,1,115160,115160,115161,0,1,1
32918,3,1,115163,115163,115164,0,1,2
32919,2,2,115165,115165,115167,0,2,1
32920,1,3,115166,115167,115170,1,4,0
32921,5,2,115171,115171,115173,0,2,1
32922,4,2,115175,115175,115177,0,2,2
32923,6,3,115181,115181,115184,0,3,4
32924,5,1,115186,115186,115187,0,1,2
32925,1,3,115187,115187,115190,0,3,0
32926,2,3,115189,115190,115193,1,4,0
32927,4,2,115193,115193,115195,0,2,0
32928,1,1,115194,115195,115196,1,2,0
32929,3,3,115197,115197,115200,0,3,1
32930,3,2,115200,115200,115202,0,2,0
32931,4,2,115204,115204,115206,0,2,2
32932,4,3,115208,115208,115211,0,3,2
32933,4,2,115212,115212,115214,0,2,1
32934,5,2,115217,115217,115219,0,2,3
32935,1,3,115218,115219,115222,1,4,0
32936,2,2,115220,115222,115224,2,4,0
32937,2,3,115222,115224,115227,2,5,0
32938,6,3,115228,115228,115231,0,3,1
32939,5,1,115233,115233,115234,0,1,2
32940,2,1,115235,115235,115236,0,1,1
32941,6,3,115241,115241,115244,0,3,5
32942,6,3,115247,115247,115250,0,3,3
32943,3,1,115250,115250,115251,0,1,0
32944,1,3,115251,115251,115254,0,3,0
32945,2,3,115253,115254,115257,1,4,0
32946,6,1,115259,115259,115260,0,1,2
32947,3,2,115262,115262,115264,0,2,2
32948,4,3,115266,115266,115269,0,3,2
32949,4,2,115270,115270,115272,0,2,1
32950,3,2,115273,115273,115275,0,2,1
32951,1,2,115274,115275,115277,1,3,0
32952,6,3,115280,115280,115283,0,3,3
32953,2,1,115282,115283,115284,1,2,0
32954,5,2,115287,115287,115289,0,2,3
32955,2,2,115289,115289,115291,0,2,0
32956,2,1,115291,115291,115292,0,1,0
32957,3,1,115294,115294,115295,0,1,2
32958,5,2,115299,115299,115301,0,2,4
32959,5,3,115304,115304,115307,0,3,3
32960,6,1,115310,115310,115311,0,1,3
32961,6,1,115316,115316,115317,0,1,5
32962,3,3,115319,115319,115322,0,3,2
32963,6,2,115325,115325,115327,0,2,3
32964,3,2,115328,115328,115330,0,2,1
32965,3,1,115331,115331,115332,0,1,1
32966,1,2,115332,115332,115334,0,2,0
32967,4,1,115336,115336,115337,0,1,2
32968,4,3,115340,115340,115343,0,3,3
32969,6,2,115346,115346,115348,0,2,3
32970,2,1,115348,115348,115349,0,1,0
32971,1,3,115349,115349,115352,0,3,0
32972,4,1,115353,115353,115354,0,1,1
32973,3,1,115356,115356,115357,0,1,2
32974,2,3,115358,115358,115361,0,3,1
32975,4,3,115362,115362,115365,0,3,1
32976,3,1,115365,115365,115366,0,1,0
32977,2,1,115367,115367,115368,0,1,1
32978,4,3,115371,115371,115374,0,3,3
32979,5,3,115376,115376,115379,0,3,2
32980,4,1,115380,115380,115381,0,1,1
32981,5,2,115385,115385,115387,0,2,4
32982,2,2,115387,115387,115389,0,2,0
32983,4,3,115391,115391,115394,0,3,2
32984,1,3,115392,115394,115397,2,5,0
32985,3,2,115395,115397,115399,2,4,0
32986,2,1,115397,115399,115400,2,3,0
32987,4,1,115401,115401,115402,0,1,1
32988,1,3,115402,115402,115405,0,3,0
32989,2,3,115404,115405,115408,1,4,0
32990,6,2,115410,115410,115412,0,2,2
32991,4,2,115414,115414,115416,0,2,2
32992,6,2,115420,115420,115422,0,2,4
32993,6,3,115426,115426,115429,0,3,4
32994,5,3,115431,115431,115434,0,3,2
32995,1,3,115432,115434,115437,2,5,0
32996,1,1,115433,115437,115438,4,5,0
32997,1,3,115434,115438,115441,4,7,0
32998,5,1,115439,115441,115442,2,3,0
32999,2,1,115441,115442,115443,1,2,0
33000,3,1,115444,115444,115445,0,1,1
33001,2,1,115446,115446,115447,0,1,1
33002,6,1,115452,115452,115453,0,1,5
33003,5,2,115457,115457,115459,0,2,4
33004,4,1,115461,115461,115462,0,1,2
33005,4,1,115465,115465,115466,0,1,3
33006,2,2,115467,115467,115469,0,2,1
33007,3,1,115470,115470,115471,0,1,1
33008,2,1,115472,115472,115473,0,1,1
33009,2,3,115474,115474,115477,0,3,1
33010,6,3,115480,115480,115483,0,3,3
33011,6,2,115486,115486,115488,0,2,3
33012,6,2,115492,115492,115494,0,2,4
33013,1,3,115493,115494,115497,1,4,0
33014,4,2,115497,115497,115499,0,2,0
33015,5,1,115502,115502,115503,0,1,3
33016,2,1,115504,115504,115505,0,1,1
33017,1,2,115505,115505,115507,0,2,0
33018,3,1,115508,115508,115509,0,1,1
33019,5,1,115513,115513,115514,0,1,4
33020,2,1,115515,115515,115516,0,1,1
33021,2,1,115517,115517,115518,0,1,1
33022,2,3,115519,115519,115522,0,3,1
33023,5,2,115524,115524,115526,0,2,2
33024,3,2,115527,115527,115529,0,2,1
33025,2,2,115529,115529,115531,0,2,0
33026,3,2,115532,115532,115534,0,2,1
33027,5,1,115537,115537,115538,0,1,3
33028,6,1,115543,115543,115544,0,1,5
33029,4,3,115547,115547,115550,0,3,3
33030,1,1,115548,115550,115551,2,3,0
33031,3,2,115551,115551,115553,0,2,0
33032,1,3,115552,115553,115556,1,4,0
33033,2,1,115554,115556,115557,2,3,0
33034,1,1,115555,115557,115558,2,3,0
33035,3,1,115558,115558,115559,0,1,0
33036,5,1,115563,115563,115564,0,1,4
33037,5,1,115568,115568,115569,0,1,4
33038,3,1,115571,115571,115572,0,1,2
33039,6,2,115577,115577,115579,0,2,5
33040,4,1,115581,115581,115582,0,1,2
33041,5,2,115586,115586,115588,0,2,4
33042,1,2,115587,115588,115590,1,3,0
33043,4,1,115591,115591,115592,0,1,1
33044,6,2,115597,115597,115599,0,2,5
33045,1,2,115598,115599,115601,1,3,0
33046,1,2,115599,115601,115603,2,4,0
33047,4,3,115603,115603,115606,0,3,0
33048,1,1,115604,115606,115607,2,3,0
33049,6,3,115610,115610,115613,0,3,3
33050,4,3,115614,115614,115617,0,3,1
33051,3,1,115617,115617,115618,0,1,0
33052,3,3,115620,115620,115623,0,3,2
33053,2,2,115622,115623,115625,1,3,0
33054,5,2,115627,115627,115629,0,2,2
33055,5,2,115632,115632,115634,0,2,3
33056,2,2,115634,115634,115636,0,2,0
33057,3,2,115637,115637,115639,0,2,1
33058,2,1,115639,115639,115640,0,1,0
33059,5,3,115644,115644,115647,0,3,4
33060,1,3,115645,115647,115650,2,5,0
33061,5,1,115650,115650,115651,0,1,0
33062,2,3,115652,115652,115655,0,3,1
33063,5,3,115657,115657,115660,0,3,2
33064,1,1,115658,115660,115661,2,3,0
33065,4,1,115662,115662,115663,0,1,1
33066,1,3,115663,115663,115666,0,3,0
33067,4,3,115667,115667,115670,0,3,1
33068,3,3,115670,115670,115673,0,3,0
33069,3,3,115673,115673,115676,0,3,0
33070,2,3,115675,115676,115679,1,4,0
33071,5,2,115680,115680,115682,0,2,1
33072,1,1,115681,115682,115683,1,2,0
33073,2,1,115683,115683,115684,0,1,0
33074,6,2,115689,115689,115691,0,2,5
33075,1,3,115690,115691,115694,1,4,0
33076,6,2,115696,115696,115698,0,2,2
33077,5,1,115701,115701,115702,0,1,3
33078,3,1,115704,115704,115705,0,1,2
33079,1,2,115705,115705,115707,0,2,0
33080,5,3,115710,115710,115713,0,3,3
33081,6,2,115716,115716,115718,0,2,3
33082,5,1,115721,115721,115722,0,1,3
33083,6,2,115727,115727,115729,0,2,5
33084,2,3,115729,115729,115732,0,3,0
33085,1,3,115730,115732,115735,2,5,0
33086,4,2,115734,115735,115737,1,3,0
33087,5,2,115739,115739,115741,0,2,2
33088,1,2,115740,115741,115743,1,3,0
33089,1,3,115741,115743,115746,2,5,0
33090,3,3,115744,115746,115749,2,5,0
33091,2,2,115746,115749,115751,3,5,0
33092,3,2,115749,115751,115753,2,4,0
33093,3,3,115752,115753,115756,1,4,0
33094,5,2,115757,115757,115759,0,2,1
33095,5,2,115762,115762,115764,0,2,3
33096,6,3,115768,115768,115771,0,3,4
33097,6,1,115774,115774,115775,0,1,3
33098,4,2,115778,115778,115780,0,2,3
33099,5,3,115783,115783,115786,0,3,3
33100,4,1,115787,115787,115788,0,1,1
33101,4,2,115791,115791,115793,0,2,3
33102,4,1,115795,115795,115796,0,1,2
33103,1,1,115796,115796,115797,0,1,0
33104,6,1,115802,115802,115803,0,1,5
33105,4,3,115806,115806,115809,0,3,3
33106,2,1,115808,115809,115810,1,2,0
33107,6,2,115814,115814,115816,0,2,4
33108,2,2,115816,115816,115818,0,2,0
33109,3,2,115819,115819,115821,0,2,1
33110,3,2,115822,115822,115824,0,2,1
33111,3,2,115825,115825,115827,0,2,1
33112,4,2,115829,115829,115831,0,2,2
33113,6,2,115835,115835,115837,0,2,4
33114,5,1,115840,115840,115841,0,1,3
33115,4,3,115844,115844,115847,0,3,3
33116,4,1,115848,115848,115849,0,1,1
33117,3,2,115851,115851,115853,0,2,2
33118,2,1,115853,115853,115854,0,1,0
33119,1,1,115854,115854,115855,0,1,0
33120,1,1,115855,115855,115856,0,1,0
33121,5,1,115860,115860,115861,0,1,4
33122,5,3,115865,115865,115868,0,3,4
33123,3,3,115868,115868,115871,0,3,0
33124,4,2,115872,115872,115874,0,2,1
33125,4,3,115876,115876,115879,0,3,2
33126,2,3,115878,115879,115882,1,4,0
33127,5,3,115883,115883,115886,0,3,1
33128,3,3,115886,115886,115889,0,3,0
33129,2,2,115888,115889,115891,1,3,0
33130,5,2,115893,115893,115895,0,2,2
33131,3,2,115896,115896,115898,0,2,1
33132,5,2,115901,115901,115903,0,2,3
33133,2,1,115903,115903,115904,0,1,0
33134,4,2,115907,115907,115909,0,2,3
33135,5,1,115912,115912,115913,0,1,3
33136,1,3,115913,115913,115916,0,3,0
33137,5,3,115918,115918,115921,0,3,2
33138,6,2,115924,115924,115926,0,2,3
33139,5,3,115929,115929,115932,0,3,3
33140,6,1,115935,115935,115936,0,1,3
33141,2,3,115937,115937,115940,0,3,1
33142,2,1,115939,115940,115941,1,2,0
33143,2,1,115941,115941,115942,0,1,0
33144,3,3,115944,115944,115947,0,3,2
33145,5,3,115949,115949,115952,0,3,2
33146,3,2,115952,115952,115954,0,2,0
33147,4,1,115956,115956,115957,0,1,2
33148,6,3,115962,115962,115965,0,3,5
33149,1,2,115963,115965,115967,2,4,0
33150,3,3,115966,115967,115970,1,4,0
33151,4,1,115970,115970,115971,0,1,0
33152,2,2,115972,115972,115974,0,2,1
33153,2,2,115974,115974,115976,0,2,0
33154,2,3,115976,115976,115979,0,3,0
33155,1,1,115977,115979,115980,2,3,0
33156,1,3,115978,115980,115983,2,5,0
33157,3,2,115981,115983,115985,2,4,0
33158,1,3,115982,115985,115988,3,6,0
33159,3,1,115985,115988,115989,3,4,0
33160,2,3,115987,115989,115992,2,5,0
33161,6,2,115993,115993,115995,0,2,1
33162,6,1,115999,115999,116000,0,1,4
33163,5,3,116004,116004,116007,0,3,4
33164,5,2,116009,116009,116011,0,2,2
33165,3,2,116012,116012,116014,0,2,1
33166,6,2,116018,116018,116020,0,2,4
33167,1,3,116019,116020,116023,1,4,0
33168,2,3,116021,116023,116026,2,5,0
33169,4,3,116025,116026,116029,1,4,0
33170,2,3,116027,116029,116032,2,5,0
33171,2,1,116029,116032,116033,3,4,0
33172,3,3,116032,116033,116036,1,4,0
33173,4,2,116036,116036,116038,0,2,0
33174,3,2,116039,116039,116041,0,2,1
33175,3,1,116042,116042,116043,0,1,1
33176,5,1,116047,116047,116048,0,1,4
33177,6,2,116053,116053,116055,0,2,5
33178,5,1,116058,116058,116059,0,1,3
33179,4,3,116062,116062,116065,0,3,3
33180,2,2,116064,116065,116067,1,3,0
33181,6,3,116070,116070,116073,0,3,3
33182,3,1,116073,116073,116074,0,1,0
33183,6,1,116079,116079,116080,0,1,5
33184,3,2,116082,116082,116084,0,2,2
33185,6,1,116088,116088,116089,0,1,4
33186,1,1,116089,116089,116090,0,1,0
33187,1,3,116090,116090,116093,0,3,0
33188,4,3,116094,116094,116097,0,3,1
33189,1,2,116095,116097,116099,2,4,0
33190,6,2,116101,116101,116103,0,2,2
33191,3,1,116104,116104,116105,0,1,1
33192,2,3,116106,116106,116109,0,3,1
33193,2,1,116108,116109,116110,1,2,0
33194,1,2,116109,116110,116112,1,3,0
33195,2,1,116111,116112,116113,1,2,0
33196,5,2,116116,116116,116118,0,2,3
33197,3,3,116119,116119,116122,0,3,1
33198,4,2,116123,116123,116125,0,2,1
33199,6,3,116129,116129,116132,0,3,4
33200,6,2,116135,116135,116137,0,2,3
33201,4,1,116139,116139,116140,0,1,2
33202,6,3,116145,116145,116148,0,3,5
33203,1,1,116146,116148,116149,2,3,0
33204,1,2,116147,116149,116151,2,4,0
33205,5,3,116152,116152,116155,0,3,1
33206,6,3,116158,116158,116161,0,3,3
33207,2,1,116160,116161,116162,1,2,0
33208,4,2,116164,116164,116166,0,2,2
33209,2,1,116166,116166,116167,0,1,0
33210,3,3,116169,116169,116172,0,3,2
33211,2,2,116171,116172,116174,1,3,0
33212,4,1,116175,116175,116176,0,1,1
33213,3,3,116178,116178,116181,0,3,2
33214,6,2,116184,116184,116186,0,2,3
33215,4,2,116188,116188,116190,0,2,2
33216,5,3,116193,116193,116196,0,3,3
33217,5,1,116198,116198,116199,0,1,2
33218,6,2,116204,116204,116206,0,2,5
33219,1,3,116205,116206,116209,1,4,0
33220,2,3,116207,116209,116212,2,5,0
33221,6,1,116213,116213,116214,0,1,1
33222,3,2,116216,116216,116218,0,2,2
33223,4,1,116220,116220,116221,0,1,2
33224,4,3,116224,116224,116227,0,3,3
33225,1,1,116225,116227,116228,2,3,0
33226,1,2,116226,116228,116230,2,4,0
33227,6,3,116232,116232,116235,0,3,2
33228,3,2,116235,116235,116237,0,2,0
33229,5,3,116240,116240,116243,0,3,3
33230,2,1,116242,116243,116244,1,2,0
33231,2,2,116244,116244,116246,0,2,0
33232,6,1,116250,116250,116251,0,1,4
33233,4,2,116254,116254,116256,0,2,3
33234,2,1,116256,116256,116257,0,1,0
33235,2,3,116258,116258,116261,0,3,1
33236,5,1,116263,116263,116264,0,1,2
33237,1,3,116264,116264,116267,0,3,0
33238,3,1,116267,116267,116268,0,1,0
33239,6,1,116273,116273,116274,0,1,5
33240,2,2,116275,116275,116277,0,2,1
33241,6,3,116281,116281,116284,0,3,4
33242,6,3,116287,116287,116290,0,3,3
33243,5,2,116292,116292,116294,0,2,2
33244,5,1,116297,116297,116298,0,1,3
33245,3,1,116300,116300,116301,0,1,2
33246,6,3,116306,116306,116309,0,3,5
33247,2,1,116308,116309,116310,1,2,0
33248,5,3,116313,116313,116316,0,3,3
33249,1,1,116314,116316,116317,2,3,0
33250,5,1,116319,116319,116320,0,1,2
33251,2,3,116321,116321,116324,0,3,1
33252,5,1,116326,116326,116327,0,1,2
33253,6,1,116332,116332,116333,0,1,5
33254,3,2,116335,116335,116337,0,2,2
33255,1,3,116336,116337,116340,1,4,0
33256,3,3,116339,116340,116343,1,4,0
33257,2,1,116341,116343,116344,2,3,0
33258,3,2,116344,116344,116346,0,2,0
33259,3,3,116347,116347,116350,0,3,1
33260,3,1,116350,116350,116351,0,1,0
33261,2,2,116352,116352,116354,0,2,1
33262,4,3,116356,116356,116359,0,3,2
33263,4,1,116360,116360,116361,0,1,1
33264,5,2,116365,116365,116367,0,2,4
33265,6,3,116371,116371,116374,0,3,4
33266,2,2,116373,116374,116376,1,3,0
33267,4,2,116377,116377,116379,0,2,1
33268,4,1,116381,116381,116382,0,1,2
33269,1,1,116382,116382,116383,0,1,0
33270,3,1,116385,116385,116386,0,1,2
33271,5,2,116390,116390,116392,0,2,4
33272,5,2,116395,116395,116397,0,2,3
33273,6,3,116401,116401,116404,0,3,4
33274,4,1,116405,116405,116406,0,1,1
33275,4,2,116409,116409,116411,0,2,3
33276,1,1,116410,116411,116412,1,2,0
33277,3,3,116413,116413,116416,0,3,1
33278,4,3,116417,116417,116420,0,3,1
33279,4,2,116421,116421,116423,0,2,1
33280,2,3,116423,116423,116426,0,3,0
33281,3,2,116426,116426,116428,0,2,0
33282,2,3,116428,116428,116431,0,3,0
33283,1,2,116429,116431,116433,2,4,0
33284,3,3,116432,116433,116436,1,4,0
33285,4,3,116436,116436,116439,0,3,0
33286,6,3,116442,116442,116445,0,3,3
33287,1,3,116443,116445,116448,2,5,0
33288,2,3,116445,116448,116451,3,6,0
33289,4,2,116449,116451,116453,2,4,0
33290,4,2,116453,116453,116455,0,2,0
33291,4,3,116457,116457,116460,0,3,2
33292,5,3,116462,116462,116465,0,3,2
33293,1,3,116463,116465,116468,2,5,0
33294,6,1,116469,116469,116470,0,1,1
33295,6,1,116475,116475,116476,0,1,5
33296,3,2,116478,116478,116480,0,2,2
33297,5,3,116483,116483,116486,0,3,3
33298,5,3,116488,116488,116491,0,3,2
33299,6,3,116494,116494,116497,0,3,3
33300,2,2,116496,116497,116499,1,3,0
33301,4,1,116500,116500,116501,0,1,1
33302,4,2,116504,116504,116506,0,2,3
33303,2,1,116506,116506,116507,0,1,0
33304,4,1,116510,116510,116511,0,1,3
33305,6,1,116516,116516,116517,0,1,5
33306,4,1,116520,116520,116521,0,1,3
33307,6,1,116526,116526,116527,0,1,5
33308,2,2,116528,116528,116530,0,2,1
33309,2,1,116530,116530,116531,0,1,0
33310,1,3,116531,116531,116534,0,3,0
33311,5,3,116536,116536,116539,0,3,2
33312,1,1,116537,116539,116540,2,3,0
33313,4,2,116541,116541,116543,0,2,1
33314,3,2,116544,116544,116546,0,2,1
33315,6,1,116550,116550,116551,0,1,4
33316,3,3,116553,116553,116556,0,3,2
33317,2,3,116555,116556,116559,1,4,0
33318,5,3,116560,116560,116563,0,3,1
33319,3,1,116563,116563,116564,0,1,0
33320,4,1,116567,116567,116568,0,1,3
33321,2,3,116569,116569,116572,0,3,1
33322,1,2,116570,116572,116574,2,4,0
33323,5,3,116575,116575,116578,0,3,1
33324,1,2,116576,116578,116580,2,4,0
33325,3,1,116579,116580,116581,1,2,0
33326,1,3,116580,116581,116584,1,4,0
33327,3,3,116583,116584,116587,1,4,0
33328,4,2,116587,116587,116589,0,2,0
33329,2,1,116589,116589,116590,0,1,0
33330,3,1,116592,116592,116593,0,1,2
33331,1,1,116593,116593,116594,0,1,0
33332,4,3,116597,116597,116600,0,3,3
33333,6,2,116603,116603,116605,0,2,3
33334,1,3,116604,116605,116608,1,4,0
33335,2,1,116606,116608,116609,2,3,0
33336,4,1,116610,116610,116611,0,1,1
33337,6,1,116616,116616,116617,0,1,5
33338,2,1,116618,116618,116619,0,1,1
33339,5,2,116623,116623,116625,0,2,4
33340,4,2,116627,116627,116629,0,2,2
33341,3,2,116630,116630,116632,0,2,1
33342,4,1,116634,116634,116635,0,1,2
33343,5,3,116639,116639,116642,0,3,4
33344,3,1,116642,116642,116643,0,1,0
33345,5,3,116647,116647,116650,0,3,4
33346,4,1,116651,116651,116652,0,1,1
33347,3,3,116654,116654,116657,0,3,2
33348,4,3,116658,116658,116661,0,3,1
33349,5,2,116663,116663,116665,0,2,2
33350,3,3,116666,116666,116669,0,3,1
33351,3,3,116669,116669,116672,0,3,0
33352,4,3,116673,116673,116676,0,3,1
33353,6,1,116679,116679,116680,0,1,3
33354,2,1,116681,116681,116682,0,1,1
33355,3,2,116684,116684,116686,0,2,2
33356,5,2,116689,116689,116691,0,2,3
33357,2,2,116691,116691,116693,0,2,0
33358,6,1,116697,116697,116698,0,1,4
33359,5,3,116702,116702,116705,0,3,4
33360,6,1,116708,116708,116709,0,1,3
33361,2,2,116710,116710,116712,0,2,1
33362,5,1,116715,116715,116716,0,1,3
33363,1,1,116716,116716,116717,0,1,0
33364,6,3,116722,116722,116725,0,3,5
33365,4,2,116726,116726,116728,0,2,1
33366,3,3,116729,116729,116732,0,3,1
33367,1,2,116730,116732,116734,2,4,0
33368,5,3,116735,116735,116738,0,3,1
33369,2,3,116737,116738,116741,1,4,0
33370,3,2,116740,116741,116743,1,3,0
33371,5,1,116745,116745,116746,0,1,2
33372,2,2,116747,116747,116749,0,2,1
33373,4,2,116751,116751,116753,0,2,2
33374,5,3,116756,116756,116759,0,3,3
33375,5,1,116761,116761,116762,0,1,2
33376,5,3,116766,116766,116769,0,3,4
33377,3,3,116769,116769,116772,0,3,0
33378,6,3,116775,116775,116778,0,3,3
33379,1,2,116776,116778,116780,2,4,0
33380,3,2,116779,116780,116782,1,3,0
33381,3,3,116782,116782,116785,0,3,0
33382,6,3,116788,116788,116791,0,3,3
33383,1,2,116789,116791,116793,2,4,0
33384,3,1,116792,116793,116794,1,2,0
33385,6,2,116798,116798,116800,0,2,4
33386,3,2,116801,116801,116803,0,2,1
33387,4,2,116805,116805,116807,0,2,2
33388,5,2,116810,116810,116812,0,2,3
33389,2,3,116812,116812,116815,0,3,0
33390,1,3,116813,116815,116818,2,5,0
33391,6,3,116819,116819,116822,0,3,1
33392,6,2,116825,116825,116827,0,2,3
33393,4,1,116829,116829,116830,0,1,2
33394,1,2,116830,116830,116832,0,2,0
33395,5,2,116835,116835,116837,0,2,3
33396,6,1,116841,116841,116842,0,1,4
33397,6,2,116847,116847,116849,0,2,5
33398,4,1,116851,116851,116852,0,1,2
33399,3,3,116854,116854,116857,0,3,2
33400,4,3,116858,116858,116861,0,3,1
33401,5,1,116863,116863,116864,0,1,2
33402,6,2,116869,116869,116871,0,2,5
33403,4,1,116873,116873,116874,0,1,2
33404,4,2,116877,116877,116879,0,2,3
33405,6,2,116883,116883,116885,0,2,4
33406,6,2,116889,116889,116891,0,2,4
33407,6,3,116895,116895,116898,0,3,4
33408,2,1,116897,116898,116899,1,2,0
33409,5,1,116902,116902,116903,0,1,3
33410,1,2,116903,116903,116905,0,2,0
33411,2,1,116905,116905,116906,0,1,0
33412,2,2,116907,116907,116909,0,2,1
33413,6,2,116913,116913,116915,0,2,4
33414,1,2,116914,116915,116917,1,3,0
33415,6,1,116920,116920,116921,0,1,3
33416,6,3,116926,116926,116929,0,3,5
33417,5,2,116931,116931,116933,0,2,2
33418,4,1,116935,116935,116936,0,1,2
33419,1,2,116936,116936,116938,0,2,0
33420,4,1,116940,116940,116941,0,1,2
33421,4,1,116944,116944,116945,0,1,3
33422,5,1,116949,116949,116950,0,1,4
33423,2,1,116951,116951,116952,0,1,1
33424,3,2,116954,116954,116956,0,2,2
33425,6,2,116960,116960,116962,0,2,4
33426,2,1,116962,116962,116963,0,1,0
33427,3,1,116965,116965,116966,0,1,2
33428,2,3,116967,116967,116970,0,3,1
33429,4,2,116971,116971,116973,0,2,1
33430,5,1,116976,116976,116977,0,1,3
33431,2,2,116978,116978,116980,0,2,1
33432,2,3,116980,116980,116983,0,3,0
33433,3,1,116983,116983,116984,0,1,0
33434,1,2,116984,116984,116986,0,2,0
33435,3,3,116987,116987,116990,0,3,1
33436,1,2,116988,116990,116992,2,4,0
33437,2,3,116990,116992,116995,2,5,0
33438,6,1,116996,116996,116997,0,1,1
33439,4,2,117000,117000,117002,0,2,3
33440,4,3,117004,117004,117007,0,3,2
33441,4,2,117008,117008,117010,0,2,1
33442,6,1,117014,117014,117015,0,1,4
33443,3,1,117017,117017,117018,0,1,2
33444,5,2,117022,117022,117024,0,2,4
33445,6,1,117028,117028,117029,0,1,4
33446,4,3,117032,117032,117035,0,3,3
33447,6,1,117038,117038,117039,0,1,3
33448,1,3,117039,117039,117042,0,3,0
33449,2,1,117041,117042,117043,1,2,0
33450,3,3,117044,117044,117047,0,3,1
33451,2,3,117046,117047,117050,1,4,0
33452,3,3,117049,117050,117053,1,4,0
33453,3,2,117052,117053,117055,1,3,0
33454,5,1,117057,117057,117058,0,1,2
33455,1,1,117058,117058,117059,0,1,0
33456,6,2,117064,117064,117066,0,2,5
33457,4,2,117068,117068,117070,0,2,2
33458,6,2,117074,117074,117076,0,2,4
33459,1,1,117075,117076,117077,1,2,0
33460,5,3,117080,117080,117083,0,3,3
33461,2,1,117082,117083,117084,1,2,0
33462,2,1,117084,117084,117085,0,1,0
33463,4,2,117088,117088,117090,0,2,3
33464,6,3,117094,117094,117097,0,3,4
33465,6,3,117100,117100,117103,0,3,3
33466,4,2,117104,117104,117106,0,2,1
33467,4,1,117108,117108,117109,0,1,2
33468,1,2,117109,117109,117111,0,2,0
33469,5,3,117114,117114,117117,0,3,3
33470,4,2,117118,117118,117120,0,2,1
33471,3,1,117121,117121,117122,0,1,1
33472,5,3,117126,117126,117129,0,3,4
33473,1,1,117127,117129,117130,2,3,0
33474,5,1,117132,117132,117133,0,1,2
33475,6,1,117138,117138,117139,0,1,5
33476,5,1,117143,117143,117144,0,1,4
33477,5,3,117148,117148,117151,0,3,4
33478,6,2,117154,117154,117156,0,2,3
33479,2,3,117156,117156,117159,0,3,0
33480,3,2,117159,117159,117161,0,2,0
33481,5,1,117164,117164,117165,0,1,3
33482,6,3,117170,117170,117173,0,3,5
33483,1,1,117171,117173,117174,2,3,0
33484,4,1,117175,117175,117176,0,1,1
33485,2,2,117177,117177,117179,0,2,1
33486,3,3,117180,117180,117183,0,3,1
33487,1,1,117181,117183,117184,2,3,0
33488,5,3,117186,117186,117189,0,3,2
33489,1,2,117187,117189,117191,2,4,0
33490,1,2,117188,117191,117193,3,5,0
33491,3,3,117191,117193,117196,2,5,0
33492,1,3,117192,117196,117199,4,7,0
33493,2,2,117194,117199,117201,5,7,0
33494,2,2,117196,117201,117203,5,7,0
33495,5,1,117201,117203,117204,2,3,0
33496,2,1,117203,117204,117205,1,2,0
33497,5,2,117208,117208,117210,0,2,3
33498,6,3,117214,117214,117217,0,3,4
33499,6,1,117220,117220,117221,0,1,3
33500,4,3,117224,117224,117227,0,3,3
33501,3,2,117227,117227,117229,0,2,0
33502,3,2,117230,117230,117232,0,2,1
33503,5,3,117235,117235,117238,0,3,3
33504,3,1,117238,117238,117239,0,1,0
33505,6,3,117244,117244,117247,0,3,5
33506,5,1,117249,117249,117250,0,1,2
33507,5,3,117254,117254,117257,0,3,4
33508,4,1,117258,117258,117259,0,1,1
33509,3,3,117261,117261,117264,0,3,2
33510,6,2,117267,117267,117269,0,2,3
33511,1,3,117268,117269,117272,1,4,0
33512,2,2,117270,117272,117274,2,4,0
33513,4,2,117274,117274,117276,0,2,0
33514,4,2,117278,117278,117280,0,2,2
33515,5,3,117283,117283,117286,0,3,3
33516,4,2,117287,117287,117289,0,2,1
33517,5,2,117292,117292,117294,0,2,3
33518,2,3,117294,117294,117297,0,3,0
33519,1,2,117295,117297,117299,2,4,0
33520,2,3,117297,117299,117302,2,5,0
33521,5,3,117302,117302,117305,0,3,0
33522,5,3,117307,117307,117310,0,3,2
33523,1,1,117308,117310,117311,2,3,0
33524,3,3,117311,117311,117314,0,3,0
33525,4,3,117315,117315,117318,0,3,1
33526,2,3,117317,117318,117321,1,4,0
33527,5,2,117322,117322,117324,0,2,1
33528,3,1,117325,117325,117326,0,1,1
33529,5,1,117330,117330,117331,0,1,4
33530,3,2,117333,117333,117335,0,2,2
33531,1,2,117334,117335,117337,1,3,0
33532,1,3,117335,117337,117340,2,5,0
33533,4,2,117339,117340,117342,1,3,0
33534,2,3,117341,117342,117345,1,4,0
33535,6,2,117347,117347,117349,0,2,2
33536,6,2,117353,117353,117355,0,2,4
33537,3,3,117356,117356,117359,0,3,1
33538,5,1,117361,117361,117362,0,1,2
33539,6,2,117367,117367,117369,0,2,5
33540,2,1,117369,117369,117370,0,1,0
33541,2,1,117371,117371,117372,0,1,1
33542,4,2,117375,117375,117377,0,2,3
33543,1,1,117376,117377,117378,1,2,0
33544,4,1,117380,117380,117381,0,1,2
33545,5,1,117385,117385,117386,0,1,4
33546,3,2,117388,117388,117390,0,2,2
33547,2,3,117390,117390,117393,0,3,0
33548,2,2,117392,117393,117395,1,3,0
33549,6,3,117398,117398,117401,0,3,3
33550,6,3,117404,117404,117407,0,3,3
33551,1,1,117405,117407,117408,2,3,0
33552,6,1,117411,117411,117412,0,1,3
33553,5,3,117416,117416,117419,0,3,4
33554,3,1,117419,117419,117420,0,1,0
33555,5,3,117424,117424,117427,0,3,4
33556,5,2,117429,117429,117431,0,2,2
33557,2,3,117431,117431,117434,0,3,0
33558,4,1,117435,117435,117436,0,1,1
33559,5,1,117440,117440,117441,0,1,4
33560,5,2,117445,117445,117447,0,2,4
33561,5,3,117450,117450,117453,0,3,3
33562,1,3,117451,117453,117456,2,5,0
33563,1,2,117452,117456,117458,4,6,0
33564,6,1,117458,117458,117459,0,1,0
33565,2,2,117460,117460,117462,0,2,1
33566,2,3,117462,117462,117465,0,3,0
33567,5,3,117467,117467,117470,0,3,2
33568,2,2,117469,117470,117472,1,3,0
33569,6,1,117475,117475,117476,0,1,3
33570,2,3,117477,117477,117480,0,3,1
33571,4,3,117481,117481,117484,0,3,1
33572,3,1,117484,117484,117485,0,1,0
33573,2,3,117486,117486,117489,0,3,1
33574,2,2,117488,117489,117491,1,3,0
33575,6,2,117494,117494,117496,0,2,3
33576,3,1,117497,117497,117498,0,1,1
33577,5,1,117502,117502,117503,0,1,4
33578,5,3,117507,117507,117510,0,3,4
33579,4,2,117511,117511,117513,0,2,1
33580,4,2,117515,117515,117517,0,2,2
33581,1,1,117516,117517,117518,1,2,0
33582,3,3,117519,117519,117522,0,3,1
33583,6,3,117525,117525,117528,0,3,3
33584,4,2,117529,117529,117531,0,2,1
33585,5,1,117534,117534,117535,0,1,3
33586,1,3,117535,117535,117538,0,3,0
33587,5,1,117540,117540,117541,0,1,2
33588,1,3,117541,117541,117544,0,3,0
33589,2,3,117543,117544,117547,1,4,0
33590,3,3,117546,117547,117550,1,4,0
33591,5,2,117551,117551,117553,0,2,1
33592,6,2,117557,117557,117559,0,2,4
33593,5,2,117562,117562,117564,0,2,3
33594,5,1,117567,117567,117568,0,1,3
33595,5,2,117572,117572,117574,0,2,4
33596,4,2,117576,117576,117578,0,2,2
33597,1,1,117577,117578,117579,1,2,0
33598,6,2,117583,117583,117585,0,2,4
33599,3,1,117586,117586,117587,0,1,1
33600,2,3,117588,117588,117591,0,3,1
33601,3,1,117591,117591,117592,0,1,0
33602,6,1,117597,117597,117598,0,1,5
33603,2,2,117599,117599,117601,0,2,1
33604,6,2,117605,117605,117607,0,2,4
33605,3,2,117608,117608,117610,0,2,1
33606,6,3,117614,117614,117617,0,3,4
33607,3,2,117617,117617,117619,0,2,0
33608,6,3,117623,117623,117626,0,3,4
33609,5,3,117628,117628,117631,0,3,2
33610,1,2,117629,117631,117633,2,4,0
33611,6,2,117635,117635,117637,0,2,2
33612,6,1,117641,117641,117642,0,1,4
33613,2,3,117643,117643,117646,0,3,1
33614,5,2,117648,117648,117650,0,2,2
33615,3,2,117651,117651,117653,0,2,1
33616,1,1,117652,117653,117654,1,2,0
33617,4,3,117656,117656,117659,0,3,2
33618,5,1,117661,117661,117662,0,1,2
33619,2,2,117663,117663,117665,0,2,1
33620,6,2,117669,117669,117671,0,2,4
33621,6,2,117675,117675,117677,0,2,4
33622,5,3,117680,117680,117683,0,3,3
33623,2,3,117682,117683,117686,1,4,0
33624,6,3,117688,117688,117691,0,3,2
33625,2,2,117690,117691,117693,1,3,0
33626,2,2,117692,117693,117695,1,3,0
33627,1,1,117693,117695,117696,2,3,0
33628,5,3,117698,117698,117701,0,3,2
33629,6,3,117704,117704,117707,0,3,3
33630,1,1,117705,117707,117708,2,3,0
33631,4,3,117709,117709,117712,0,3,1
33632,3,3,117712,117712,117715,0,3,0
33633,5,2,117717,117717,117719,0,2,2
33634,4,2,117721,117721,117723,0,2,2
33635,2,3,117723,117723,117726,0,3,0
33636,1,1,117724,117726,117727,2,3,0
33637,3,2,117727,117727,117729,0,2,0
33638,1,2,117728,117729,117731,1,3,0
33639,2,2,117730,117731,117733,1,3,0
33640,6,2,117736,117736,117738,0,2,3
33641,4,3,117740,117740,117743,0,3,2
33642,6,1,117746,117746,117747,0,1,3
33643,6,2,117752,117752,117754,0,2,5
33644,1,2,117753,117754,117756,1,3,0
33645,3,1,117756,117756,117757,0,1,0
33646,4,2,117760,117760,117762,0,2,3
33647,5,3,117765,117765,117768,0,3,3
33648,1,3,117766,117768,117771,2,5,0
33649,1,1,117767,117771,117772,4,5,0
33650,4,2,117771,117772,117774,1,3,0
33651,6,1,117777,117777,117778,0,1,3
33652,4,2,117781,117781,117783,0,2,3
33653,5,1,117786,117786,117787,0,1,3
33654,3,3,117789,117789,117792,0,3,2
33655,2,3,117791,117792,117795,1,4,0
33656,2,3,117793,117795,117798,2,5,0
33657,2,2,117795,117798,117800,3,5,0
33658,6,1,117801,117801,117802,0,1,1
33659,2,3,117803,117803,117806,0,3,1
33660,2,1,117805,117806,117807,1,2,0
33661,1,3,117806,117807,117810,1,4,0
33662,5,1,117811,117811,117812,0,1,1
33663,1,3,117812,117812,117815,0,3,0
33664,3,2,117815,117815,117817,0,2,0
33665,3,1,117818,117818,117819,0,1,1
33666,2,1,117820,117820,117821,0,1,1
33667,5,2,117825,117825,117827,0,2,4
33668,3,2,117828,117828,117830,0,2,1
33669,6,2,117834,117834,117836,0,2,4
33670,1,2,117835,117836,117838,1,3,0
33671,6,3,117841,117841,117844,0,3,3
33672,3,2,117844,117844,117846,0,2,0
33673,2,2,117846,117846,117848,0,2,0
33674,4,2,117850,117850,117852,0,2,2
33675,4,2,117854,117854,117856,0,2,2
33676,5,2,117859,117859,117861,0,2,3
33677,4,1,117863,117863,117864,0,1,2
33678,4,3,117867,117867,117870,0,3,3
33679,1,3,117868,117870,117873,2,5,0
33680,1,2,117869,117873,117875,4,6,0
33681,3,1,117872,117875,117876,3,4,0
33682,1,2,117873,117876,117878,3,5,0
33683,1,1,117874,117878,117879,4,5,0
33684,1,3,117875,117879,117882,4,7,0
33685,2,2,117877,117882,117884,5,7,0
33686,2,1,117879,117884,117885,5,6,0
33687,2,3,117881,117885,117888,4,7,0
33688,4,3,117885,117888,117891,3,6,0
33689,2,1,117887,117891,117892,4,5,0
33690,1,2,117888,117892,117894,4,6,0
33691,2,3,117890,117894,117897,4,7,0
33692,6,1,117896,117897,117898,1,2,0
33693,6,2,117902,117902,117904,0,2,4
33694,6,1,117908,117908,117909,0,1,4
33695,3,3,117911,117911,117914,0,3,2
33696,3,2,117914,117914,117916,0,2,0
33697,2,2,117916,117916,117918,0,2,0
33698,1,1,117917,117918,117919,1,2,0
33699,3,3,117920,117920,117923,0,3,1
33700,6,1,117926,117926,117927,0,1,3
33701,4,2,117930,117930,117932,0,2,3
33702,3,2,117933,117933,117935,0,2,1
33703,3,2,117936,117936,117938,0,2,1
33704,1,2,117937,117938,117940,1,3,0
33705,5,1,117942,117942,117943,0,1,2
33706,2,1,117944,117944,117945,0,1,1
33707,2,2,117946,117946,117948,0,2,1
33708,2,3,117948,117948,117951,0,3,0
33709,1,2,117949,117951,117953,2,4,0
33710,6,2,117955,117955,117957,0,2,2
33711,3,2,117958,117958,117960,0,2,1
33712,3,1,117961,117961,117962,0,1,1
33713,2,1,117963,117963,117964,0,1,1
33714,1,2,117964,117964,117966,0,2,0
33715,2,2,117966,117966,117968,0,2,0
33716,1,2,117967,117968,117970,1,3,0
33717,6,2,117973,117973,117975,0,2,3
33718,3,1,117976,117976,117977,0,1,1
33719,1,2,117977,117977,117979,0,2,0
33720,2,3,117979,117979,117982,0,3,0
33721,1,3,117980,117982,117985,2,5,0
33722,3,1,117983,117985,117986,2,3,0
33723,5,2,117988,117988,117990,0,2,2
33724,6,2,117994,117994,117996,0,2,4
33725,3,2,117997,117997,117999,0,2,1
33726,6,1,118003,118003,118004,0,1,4
33727,6,3,118009,118009,118012,0,3,5
33728,2,1,118011,118012,118013,1,2,0
33729,2,2,118013,118013,118015,0,2,0
33730,2,2,118015,118015,118017,0,2,0
33731,2,2,118017,118017,118019,0,2,0
33732,3,3,118020,118020,118023,0,3,1
33733,6,2,118026,118026,118028,0,2,3
33734,3,2,118029,118029,118031,0,2,1
33735,5,1,118034,118034,118035,0,1,3
33736,3,2,118037,118037,118039,0,2,2
33737,5,2,118042,118042,118044,0,2,3
33738,1,3,118043,118044,118047,1,4,0
33739,6,3,118049,118049,118052,0,3,2
33740,2,3,118051,118052,118055,1,4,0
33741,6,2,118057,118057,118059,0,2,2
33742,4,2,118061,118061,118063,0,2,2
33743,1,3,118062,118063,118066,1,4,0
33744,2,3,118064,118066,118069,2,5,0
33745,6,3,118070,118070,118073,0,3,1
33746,6,2,118076,118076,118078,0,2,3
33747,6,3,118082,118082,118085,0,3,4
33748,6,2,118088,118088,118090,0,2,3
33749,4,1,118092,118092,118093,0,1,2
33750,4,2,118096,118096,118098,0,2,3
33751,3,3,118099,118099,118102,0,3,1
33752,2,1,118101,118102,118103,1,2,0
33753,6,3,118107,118107,118110,0,3,4
33754,2,3,118109,118110,118113,1,4,0
33755,2,1,118111,118113,118114,2,3,0
33756,1,1,118112,118114,118115,2,3,0
33757,2,3,118114,118115,118118,1,4,0
33758,2,2,118116,118118,118120,2,4,0
33759,2,2,118118,118120,118122,2,4,0
33760,5,3,118123,118123,118126,0,3,1
33761,6,3,118129,118129,118132,0,3,3
33762,2,1,118131,118132,118133,1,2,0
33763,4,2,118135,118135,118137,0,2,2
33764,4,1,118139,118139,118140,0,1,2
33765,2,2,118141,118141,118143,0,2,1
33766,1,1,118142,118143,118144,1,2,0
33767,3,1,118145,118145,118146,0,1,1
33768,5,3,118150,118150,118153,0,3,4
33769,6,2,118156,118156,118158,0,2,3
33770,5,2,118161,118161,118163,0,2,3
33771,1,3,118162,118163,118166,1,4,0
33772,1,2,118163,118166,118168,3,5,0
33773,2,1,118165,118168,118169,3,4,0
33774,6,1,118171,118171,118172,0,1,2
33775,3,3,118174,118174,118177,0,3,2
33776,5,3,118179,118179,118182,0,3,2
33777,2,2,118181,118182,118184,1,3,0
33778,2,1,118183,118184,118185,1,2,0
33779,3,1,118186,118186,118187,0,1,1
33780,3,2,118189,118189,118191,0,2,2
33781,2,3,118191,118191,118194,0,3,0
33782,3,3,118194,118194,118197,0,3,0
33783,6,2,118200,118200,118202,0,2,3
33784,2,3,118202,118202,118205,0,3,0
33785,6,3,118208,118208,118211,0,3,3
33786,1,1,118209,118211,118212,2,3,0
33787,3,1,118212,118212,118213,0,1,0
33788,5,3,118217,118217,118220,0,3,4
33789,6,2,118223,118223,118225,0,2,3
33790,5,3,118228,118228,118231,0,3,3
33791,4,2,118232,118232,118234,0,2,1
33792,2,2,118234,118234,118236,0,2,0
33793,1,2,118235,118236,118238,1,3,0
33794,5,3,118240,118240,118243,0,3,2
33795,4,1,118244,118244,118245,0,1,1
33796,2,1,118246,118246,118247,0,1,1
33797,1,3,118247,118247,118250,0,3,0
33798,3,3,118250,118250,118253,0,3,0
33799,3,1,118253,118253,118254,0,1,0
33800,2,2,118255,118255,118257,0,2,1
33801,1,1,118256,118257,118258,1,2,0
33802,6,1,118262,118262,118263,0,1,4
33803,1,3,118263,118263,118266,0,3,0
33804,4,3,118267,118267,118270,0,3,1
33805,4,1,118271,118271,118272,0,1,1
33806,5,1,118276,118276,118277,0,1,4
33807,4,2,118280,118280,118282,0,2,3
33808,5,1,118285,118285,118286,0,1,3
33809,3,3,118288,118288,118291,0,3,2
33810,3,2,118291,118291,118293,0,2,0
33811,3,3,118294,118294,118297,0,3,1
33812,5,2,118299,118299,118301,0,2,2
33813,2,1,118301,118301,118302,0,1,0
33814,6,2,118307,118307,118309,0,2,5
33815,2,2,118309,118309,118311,0,2,0
33816,3,1,118312,118312,118313,0,1,1
33817,6,3,118318,118318,118321,0,3,5
33818,5,2,118323,118323,118325,0,2,2
33819,2,1,118325,118325,118326,0,1,0
33820,4,1,118329,118329,118330,0,1,3
33821,5,2,118334,118334,118336,0,2,4
33822,2,2,118336,118336,118338,0,2,0
33823,3,2,118339,118339,118341,0,2,1
33824,1,1,118340,118341,118342,1,2,0
33825,4,2,118344,118344,118346,0,2,2
33826,6,1,118350,118350,118351,0,1,4
33827,4,2,118354,118354,118356,0,2,3
33828,3,2,118357,118357,118359,0,2,1
33829,5,2,118362,118362,118364,0,2,3
33830,4,2,118366,118366,118368,0,2,2
33831,3,3,118369,118369,118372,0,3,1
33832,5,2,118374,118374,118376,0,2,2
33833,4,1,118378,118378,118379,0,1,2
33834,5,1,118383,118383,118384,0,1,4
33835,5,1,118388,118388,118389,0,1,4
33836,3,3,118391,118391,118394,0,3,2
33837,2,3,118393,118394,118397,1,4,0
33838,2,2,118395,118397,118399,2,4,0
33839,5,2,118400,118400,118402,0,2,1
33840,5,1,118405,118405,118406,0,1,3
33841,3,3,118408,118408,118411,0,3,2
33842,6,1,118414,118414,118415,0,1,3
33843,1,2,118415,118415,118417,0,2,0
33844,6,1,118421,118421,118422,0,1,4
33845,6,1,118427,118427,118428,0,1,5
33846,4,3,118431,118431,118434,0,3,3
33847,1,1,118432,118434,118435,2,3,0
33848,5,3,118437,118437,118440,0,3,2
33849,1,2,118438,118440,118442,2,4,0
33850,2,3,118440,118442,118445,2,5,0
33851,1,3,118441,118445,118448,4,7,0
33852,6,2,118447,118448,118450,1,3,0
33853,2,1,118449,118450,118451,1,2,0
33854,5,2,118454,118454,118456,0,2,3
33855,1,2,118455,118456,118458,1,3,0
33856,1,3,118456,118458,118461,2,5,0
33857,2,2,118458,118461,118463,3,5,0
33858,6,2,118464,118464,118466,0,2,1
33859,2,2,118466,118466,118468,0,2,0
33860,2,2,118468,118468,118470,0,2,0
33861,2,2,118470,118470,118472,0,2,0
33862,3,2,118473,118473,118475,0,2,1
33863,3,1,118476,118476,118477,0,1,1
33864,3,1,118479,118479,118480,0,1,2
33865,2,2,118481,118481,118483,0,2,1
33866,6,2,118487,118487,118489,0,2,4
33867,3,1,118490,118490,118491,0,1,1
33868,5,3,118495,118495,118498,0,3,4
33869,2,2,118497,118498,118500,1,3,0
33870,3,1,118500,118500,118501,0,1,0
33871,4,1,118504,118504,118505,0,1,3
33872,4,3,118508,118508,118511,0,3,3
33873,1,1,118509,118511,118512,2,3,0
33874,3,3,118512,118512,118515,0,3,0
33875,4,2,118516,118516,118518,0,2,1
33876,1,2,118517,118518,118520,1,3,0
33877,3,2,118520,118520,118522,0,2,0
33878,1,3,118521,118522,118525,1,4,0
33879,1,3,118522,118525,118528,3,6,0
33880,2,3,118524,118528,118531,4,7,0
33881,5,3,118529,118531,118534,2,5,0
33882,4,2,118533,118534,118536,1,3,0
33883,4,1,118537,118537,118538,0,1,1
33884,4,1,118541,118541,118542,0,1,3
33885,5,1,118546,118546,118547,0,1,4
33886,6,2,118552,118552,118554,0,2,5
33887,1,3,118553,118554,118557,1,4,0
33888,5,2,118558,118558,118560,0,2,1
33889,5,1,118563,118563,118564,0,1,3
33890,2,2,118565,118565,118567,0,2,1
33891,6,2,118571,118571,118573,0,2,4
33892,2,2,118573,118573,118575,0,2,0
33893,3,1,118576,118576,118577,0,1,1
33894,3,2,118579,118579,118581,0,2,2
33895,5,3,118584,118584,118587,0,3,3
33896,6,3,118590,118590,118593,0,3,3
33897,5,1,118595,118595,118596,0,1,2
33898,1,2,118596,118596,118598,0,2,0
33899,6,2,118602,118602,118604,0,2,4
33900,3,3,118605,118605,118608,0,3,1
33901,5,3,118610,118610,118613,0,3,2
33902,5,2,118615,118615,118617,0,2,2
33903,1,3,118616,118617,118620,1,4,0
33904,5,2,118621,118621,118623,0,2,1
33905,4,3,118625,118625,118628,0,3,2
33906,2,1,118627,118628,118629,1,2,0
33907,3,2,118630,118630,118632,0,2,1
33908,3,2,118633,118633,118635,0,2,1
33909,6,2,118639,118639,118641,0,2,4
33910,1,1,118640,118641,118642,1,2,0
33911,3,1,118643,118643,118644,0,1,1
33912,4,2,118647,118647,118649,0,2,3
33913,4,1,118651,118651,118652,0,1,2
33914,3,2,118654,118654,118656,0,2,2
33915,1,2,118655,118656,118658,1,3,0
33916,2,3,118657,118658,118661,1,4,0
33917,2,3,118659,118661,118664,2,5,0
33918,4,1,118663,118664,118665,1,2,0
33919,2,3,118665,118665,118668,0,3,0
33920,1,1,118666,118668,118669,2,3,0
33921,6,2,118672,118672,118674,0,2,3
33922,4,2,118676,118676,118678,0,2,2
33923,2,1,118678,118678,118679,0,1,0
33924,6,1,118684,118684,118685,0,1,5
33925,3,3,118687,118687,118690,0,3,2
33926,1,2,118688,118690,118692,2,4,0
33927,3,2,118691,118692,118694,1,3,0
33928,5,2,118696,118696,118698,0,2,2
33929,1,1,118697,118698,118699,1,2,0
33930,6,1,118703,118703,118704,0,1,4
33931,5,3,118708,118708,118711,0,3,4
33932,6,3,118714,118714,118717,0,3,3
33933,6,2,118720,118720,118722,0,2,3
33934,3,1,118723,118723,118724,0,1,1
33935,2,3,118725,118725,118728,0,3,1
33936,2,3,118727,118728,118731,1,4,0
33937,2,2,118729,118731,118733,2,4,0
33938,6,3,118735,118735,118738,0,3,2
33939,1,3,118736,118738,118741,2,5,0
33940,4,1,118740,118741,118742,1,2,0
33941,3,1,118743,118743,118744,0,1,1
33942,1,2,118744,118744,118746,0,2,0
33943,6,2,118750,118750,118752,0,2,4
33944,3,1,118753,118753,118754,0,1,1
33945,5,3,118758,118758,118761,0,3,4
33946,6,3,118764,118764,118767,0,3,3
33947,3,1,118767,118767,118768,0,1,0
33948,4,1,118771,118771,118772,0,1,3
33949,1,1,118772,118772,118773,0,1,0
33950,3,2,118775,118775,118777,0,2,2
33951,1,3,118776,118777,118780,1,4,0
33952,3,1,118779,118780,118781,1,2,0
33953,3,3,118782,118782,118785,0,3,1
33954,3,3,118785,118785,118788,0,3,0
33955,6,1,118791,118791,118792,0,1,3
33956,4,1,118795,118795,118796,0,1,3
33957,6,1,118801,118801,118802,0,1,5
33958,6,1,118807,118807,118808,0,1,5
33959,5,2,118812,118812,118814,0,2,4
33960,3,3,118815,118815,118818,0,3,1
33961,5,3,118820,118820,118823,0,3,2
33962,1,3,118821,118823,118826,2,5,0
33963,2,2,118823,118826,118828,3,5,0
33964,5,3,118828,118828,118831,0,3,0
33965,4,3,118832,118832,118835,0,3,1
33966,5,3,118837,118837,118840,0,3,2
33967,3,1,118840,118840,118841,0,1,0
33968,5,1,118845,118845,118846,0,1,4
33969,5,3,118850,118850,118853,0,3,4
33970,4,1,118854,118854,118855,0,1,1
33971,5,1,118859,118859,118860,0,1,4
33972,6,2,118865,118865,118867,0,2,5
33973,6,3,118871,118871,118874,0,3,4
33974,5,1,118876,118876,118877,0,1,2
33975,6,2,118882,118882,118884,0,2,5
33976,4,3,118886,118886,118889,0,3,2
33977,2,1,118888,118889,118890,1,2,0
33978,4,2,118892,118892,118894,0,2,2
33979,1,3,118893,118894,118897,1,4,0
33980,2,2,118895,118897,118899,2,4,0
33981,4,2,118899,118899,118901,0,2,0
33982,5,2,118904,118904,118906,0,2,3
33983,6,3,118910,118910,118913,0,3,4
33984,2,2,118912,118913,118915,1,3,0
33985,5,3,118917,118917,118920,0,3,2
33986,1,1,118918,118920,118921,2,3,0
33987,5,2,118923,118923,118925,0,2,2
33988,5,2,118928,118928,118930,0,2,3
33989,6,2,118934,118934,118936,0,2,4
33990,5,3,118939,118939,118942,0,3,3
33991,2,1,118941,118942,118943,1,2,0
33992,1,2,118942,118943,118945,1,3,0
33993,6,3,118948,118948,118951,0,3,3
33994,3,2,118951,118951,118953,0,2,0
33995,1,3,118952,118953,118956,1,4,0
33996,6,2,118958,118958,118960,0,2,2
33997,4,3,118962,118962,118965,0,3,2
33998,6,1,118968,118968,118969,0,1,3
33999,1,1,118969,118969,118970,0,1,0
34000,5,2,118974,118974,118976,0,2,4
34001,6,1,118980,118980,118981,0,1,4
34002,3,2,118983,118983,118985,0,2,2
34003,2,1,118985,118985,118986,0,1,0
34004,3,3,118988,118988,118991,0,3,2
34005,2,1,118990,118991,118992,1,2,0
34006,3,1,118993,118993,118994,0,1,1
34007,5,3,118998,118998,119001,0,3,4
34008,3,3,119001,119001,119004,0,3,0
34009,2,1,119003,119004,119005,1,2,0
34010,2,1,119005,119005,119006,0,1,0
34011,1,3,119006,119006,119009,0,3,0
34012,5,2,119011,119011,119013,0,2,2
34013,2,3,119013,119013,119016,0,3,0
34014,4,1,119017,119017,119018,0,1,1
34015,2,3,119019,119019,119022,0,3,1
34016,1,1,119020,119022,119023,2,3,0
34017,6,1,119026,119026,119027,0,1,3
34018,1,3,119027,119027,119030,0,3,0
34019,3,2,119030,119030,119032,0,2,0
34020,1,1,119031,119032,119033,1,2,0
34021,5,3,119036,119036,119039,0,3,3
34022,4,3,119040,119040,119043,0,3,1
34023,3,2,119043,119043,119045,0,2,0
34024,3,2,119046,119046,119048,0,2,1
34025,6,3,119052,119052,119055,0,3,4
34026,3,2,119055,119055,119057,0,2,0
34027,6,3,119061,119061,119064,0,3,4
34028,1,2,119062,119064,119066,2,4,0
34029,2,3,119064,119066,119069,2,5,0
34030,1,2,119065,119069,119071,4,6,0
34031,2,2,119067,119071,119073,4,6,0
34032,3,3,119070,119073,119076,3,6,0
34033,1,3,119071,119076,119079,5,8,0
34034,1,2,119072,119079,119081,7,9,0
34035,3,1,119075,119081,119082,6,7,0
34036,4,3,119079,119082,119085,3,6,0
34037,3,1,119082,119085,119086,3,4,0
34038,1,3,119083,119086,119089,3,6,0
34039,3,2,119086,119089,119091,3,5,0
34040,3,3,119089,119091,119094,2,5,0
34041,2,3,119091,119094,119097,3,6,0
34042,4,2,119095,119097,119099,2,4,0
34043,2,1,119097,119099,119100,2,3,0
34044,5,3,119102,119102,119105,0,3,2
34045,6,1,119108,119108,119109,0,1,3
34046,5,2,119113,119113,119115,0,2,4
34047,5,2,119118,119118,119120,0,2,3
34048,3,3,119121,119121,119124,0,3,1
34049,6,3,119127,119127,119130,0,3,3
34050,3,1,119130,119130,119131,0,1,0
34051,5,2,119135,119135,119137,0,2,4
34052,2,1,119137,119137,119138,0,1,0
34053,4,3,119141,119141,119144,0,3,3
34054,5,3,119146,119146,119149,0,3,2
34055,2,2,119148,119149,119151,1,3,0
34056,4,2,119152,119152,119154,0,2,1
34057,1,1,119153,119154,119155,1,2,0
34058,1,3,119154,119155,119158,1,4,0
34059,1,3,119155,119158,119161,3,6,0
34060,1,2,119156,119161,119163,5,7,0
34061,6,1,119162,119163,119164,1,2,0
34062,2,1,119164,119164,119165,0,1,0
34063,6,1,119170,119170,119171,0,1,5
34064,4,3,119174,119174,119177,0,3,3
34065,6,1,119180,119180,119181,0,1,3
34066,4,2,119184,119184,119186,0,2,3
34067,2,3,119186,119186,119189,0,3,0
34068,3,1,119189,119189,119190,0,1,0
34069,4,1,119193,119193,119194,0,1,3
34070,4,1,119197,119197,119198,0,1,3
34071,4,1,119201,119201,119202,0,1,3
34072,1,2,119202,119202,119204,0,2,0
34073,3,3,119205,119205,119208,0,3,1
34074,5,2,119210,119210,119212,0,2,2
34075,6,1,119216,119216,119217,0,1,4
34076,4,3,119220,119220,119223,0,3,3
34077,3,3,119223,119223,119226,0,3,0
34078,1,1,119224,119226,119227,2,3,0
34079,5,1,119229,119229,119230,0,1,2
34080,4,3,119233,119233,119236,0,3,3
34081,3,1,119236,119236,119237,0,1,0
34082,4,1,119240,119240,119241,0,1,3
34083,5,1,119245,119245,119246,0,1,4
34084,2,2,119247,119247,119249,0,2,1
34085,4,1,119251,119251,119252,0,1,2
34086,2,2,119253,119253,119255,0,2,1
34087,5,3,119258,119258,119261,0,3,3
34088,5,2,119263,119263,119265,0,2,2
34089,2,2,119265,119265,119267,0,2,0
34090,6,1,119271,119271,119272,0,1,4
34091,3,3,119274,119274,119277,0,3,2
34092,4,2,119278,119278,119280,0,2,1
34093,3,3,119281,119281,119284,0,3,1
34094,4,3,119285,119285,119288,0,3,1
34095,5,1,119290,119290,119291,0,1,2
34096,3,3,119293,119293,119296,0,3,2
34097,2,1,119295,119296,119297,1,2,0
34098,6,3,119301,119301,119304,0,3,4
34099,5,3,119306,119306,119309,0,3,2
34100,3,3,119309,119309,119312,0,3,0
34101,6,2,119315,119315,119317,0,2,3
34102,5,2,119320,119320,119322,0,2,3
34103,1,3,119321,119322,119325,1,4,0
34104,5,1,119326,119326,119327,0,1,1
34105,5,1,119331,119331,119332,0,1,4
34106,2,2,119333,119333,119335,0,2,1
34107,5,1,119338,119338,119339,0,1,3
34108,1,1,119339,119339,119340,0,1,0
34109,3,3,119342,119342,119345,0,3,2
34110,5,1,119347,119347,119348,0,1,2
34111,3,3,119350,119350,119353,0,3,2
34112,6,1,119356,119356,119357,0,1,3
34113,5,3,119361,119361,119364,0,3,4
34114,2,1,119363,119364,119365,1,2,0
34115,6,2,119369,119369,119371,0,2,4
34116,5,2,119374,119374,119376,0,2,3
34117,6,1,119380,119380,119381,0,1,4
34118,6,1,119386,119386,119387,0,1,5
34119,2,2,119388,119388,119390,0,2,1
34120,4,1,119392,119392,119393,0,1,2
34121,3,1,119395,119395,119396,0,1,2
34122,4,1,119399,119399,119400,0,1,3
34123,1,1,119400,119400,119401,0,1,0
34124,6,2,119406,119406,119408,0,2,5
34125,6,1,119412,119412,119413,0,1,4
34126,2,3,119414,119414,119417,0,3,1
34127,2,1,119416,119417,119418,1,2,0
34128,2,1,119418,119418,119419,0,1,0
34129,5,3,119423,119423,119426,0,3,4
34130,1,3,119424,119426,119429,2,5,0
34131,2,1,119426,119429,119430,3,4,0
34132,4,3,119430,119430,119433,0,3,0
34133,4,2,119434,119434,119436,0,2,1
34134,1,3,119435,119436,119439,1,4,0
34135,1,2,119436,119439,119441,3,5,0
34136,6,3,119442,119442,119445,0,3,1
34137,3,2,119445,119445,119447,0,2,0
34138,5,2,119450,119450,119452,0,2,3
34139,5,3,119455,119455,119458,0,3,3
34140,6,2,119461,119461,119463,0,2,3
34141,5,3,119466,119466,119469,0,3,3
34142,6,1,119472,119472,119473,0,1,3
34143,2,2,119474,119474,119476,0,2,1
34144,6,3,119480,119480,119483,0,3,4
34145,2,1,119482,119483,119484,1,2,0
34146,2,2,119484,119484,119486,0,2,0
34147,1,2,119485,119486,119488,1,3,0
34148,3,3,119488,119488,119491,0,3,0
34149,4,1,119492,119492,119493,0,1,1
34150,4,2,119496,119496,119498,0,2,3
34151,1,2,119497,119498,119500,1,3,0
34152,6,1,119503,119503,119504,0,1,3
34153,4,3,119507,119507,119510,0,3,3
34154,5,1,119512,119512,119513,0,1,2
34155,2,1,119514,119514,119515,0,1,1
34156,1,1,119515,119515,119516,0,1,0
34157,2,3,119517,119517,119520,0,3,1
34158,5,1,119522,119522,119523,0,1,2
34159,3,2,119525,119525,119527,0,2,2
34160,1,1,119526,119527,119528,1,2,0
34161,1,3,119527,119528,119531,1,4,0
34162,3,3,119530,119531,119534,1,4,0
34163,2,3,119532,119534,119537,2,5,0
34164,4,2,119536,119537,119539,1,3,0
34165,4,1,119540,119540,119541,0,1,1
34166,1,3,119541,119541,119544,0,3,0
34167,5,2,119546,119546,119548,0,2,2
34168,3,1,119549,119549,119550,0,1,1
34169,3,3,119552,119552,119555,0,3,2
34170,1,2,119553,119555,119557,2,4,0
34171,6,3,119559,119559,119562,0,3,2
34172,6,3,119565,119565,119568,0,3,3
34173,3,3,119568,119568,119571,0,3,0
34174,4,1,119572,119572,119573,0,1,1
34175,6,1,119578,119578,119579,0,1,5
34176,5,2,119583,119583,119585,0,2,4
34177,6,3,119589,119589,119592,0,3,4
34178,2,2,119591,119592,119594,1,3,0
34179,4,1,119595,119595,119596,0,1,1
34180,4,3,119599,119599,119602,0,3,3
34181,4,3,119603,119603,119606,0,3,1
34182,4,2,119607,119607,119609,0,2,1
34183,5,3,119612,119612,119615,0,3,3
34184,6,3,119618,119618,119621,0,3,3
34185,4,2,119622,119622,119624,0,2,1
34186,3,2,119625,119625,119627,0,2,1
34187,1,3,119626,119627,119630,1,4,0
34188,1,1,119627,119630,119631,3,4,0
34189,6,1,119633,119633,119634,0,1,2
34190,3,2,119636,119636,119638,0,2,2
34191,4,1,119640,119640,119641,0,1,2
34192,4,3,119644,119644,119647,0,3,3
34193,5,3,119649,119649,119652,0,3,2
34194,5,3,119654,119654,119657,0,3,2
34195,4,2,119658,119658,119660,0,2,1
34196,5,2,119663,119663,119665,0,2,3
34197,6,3,119669,119669,119672,0,3,4
34198,5,1,119674,119674,119675,0,1,2
34199,6,1,119680,119680,119681,0,1,5
34200,2,1,119682,119682,119683,0,1,1
34201,1,1,119683,119683,119684,0,1,0
34202,3,3,119686,119686,119689,0,3,2
34203,2,1,119688,119689,119690,1,2,0
34204,3,1,119691,119691,119692,0,1,1
34205,6,2,119697,119697,119699,0,2,5
34206,3,2,119700,119700,119702,0,2,1
34207,3,2,119703,119703,119705,0,2,1
34208,2,1,119705,119705,119706,0,1,0
34209,2,3,119707,119707,119710,0,3,1
34210,1,2,119708,119710,119712,2,4,0
34211,2,2,119710,119712,119714,2,4,0
34212,6,3,119716,119716,119719,0,3,2
34213,4,2,119720,119720,119722,0,2,1
34214,3,1,119723,119723,119724,0,1,1
34215,5,1,119728,119728,119729,0,1,4
34216,3,2,119731,119731,119733,0,2,2
34217,6,1,119737,119737,119738,0,1,4
34218,6,1,119743,119743,119744,0,1,5
34219,3,2,119746,119746,119748,0,2,2
34220,1,1,119747,119748,119749,1,2,0
34221,2,1,119749,119749,119750,0,1,0
34222,2,1,119751,119751,119752,0,1,1
34223,5,1,119756,119756,119757,0,1,4
34224,6,2,119762,119762,119764,0,2,5
34225,5,2,119767,119767,119769,0,2,3
34226,2,2,119769,119769,119771,0,2,0
34227,1,1,119770,119771,119772,1,2,0
34228,2,1,119772,119772,119773,0,1,0
34229,4,2,119776,119776,119778,0,2,3
34230,4,3,119780,119780,119783,0,3,2
34231,3,2,119783,119783,119785,0,2,0
34232,6,2,119789,119789,119791,0,2,4
34233,6,2,119795,119795,119797,0,2,4
34234,4,1,119799,119799,119800,0,1,2
34235,6,1,119805,119805,119806,0,1,5
34236,3,2,119808,119808,119810,0,2,2
34237,4,3,119812,119812,119815,0,3,2
34238,3,2,119815,119815,119817,0,2,0
34239,2,3,119817,119817,119820,0,3,0
34240,5,3,119822,119822,119825,0,3,2
34241,2,1,119824,119825,119826,1,2,0
34242,6,3,119830,119830,119833,0,3,4
34243,1,1,119831,119833,119834,2,3,0
34244,3,3,119834,119834,119837,0,3,0
34245,6,1,119840,119840,119841,0,1,3
34246,5,3,119845,119845,119848,0,3,4
34247,1,3,119846,119848,119851,2,5,0
34248,6,1,119852,119852,119853,0,1,1
34249,6,3,119858,119858,119861,0,3,5
34250,6,3,119864,119864,119867,0,3,3
34251,1,2,119865,119867,119869,2,4,0
34252,2,3,119867,119869,119872,2,5,0
34253,3,3,119870,119872,119875,2,5,0
34254,6,2,119876,119876,119878,0,2,1
34255,2,1,119878,119878,119879,0,1,0
34256,3,1,119881,119881,119882,0,1,2
34257,3,1,119884,119884,119885,0,1,2
34258,2,2,119886,119886,119888,0,2,1
34259,3,2,119889,119889,119891,0,2,1
34260,3,2,119892,119892,119894,0,2,1
34261,2,2,119894,119894,119896,0,2,0
34262,6,3,119900,119900,119903,0,3,4
34263,5,1,119905,119905,119906,0,1,2
34264,1,1,119906,119906,119907,0,1,0
34265,5,1,119911,119911,119912,0,1,4
34266,2,1,119913,119913,119914,0,1,1
34267,2,1,119915,119915,119916,0,1,1
34268,3,2,119918,119918,119920,0,2,2
34269,2,1,119920,119920,119921,0,1,0
34270,5,2,119925,119925,119927,0,2,4
34271,1,3,119926,119927,119930,1,4,0
34272,2,3,119928,119930,119933,2,5,0
34273,4,2,119932,119933,119935,1,3,0
34274,4,2,119936,119936,119938,0,2,1
34275,5,3,119941,119941,119944,0,3,3
34276,4,2,119945,119945,119947,0,2,1
34277,5,3,119950,119950,119953,0,3,3
34278,2,2,119952,119953,119955,1,3,0
34279,4,2,119956,119956,119958,0,2,1
34280,4,2,119960,119960,119962,0,2,2
34281,5,3,119965,119965,119968,0,3,3
34282,5,1,119970,119970,119971,0,1,2
34283,5,3,119975,119975,119978,0,3,4
34284,6,3,119981,119981,119984,0,3,3
34285,3,3,119984,119984,119987,0,3,0
34286,5,1,119989,119989,119990,0,1,2
34287,4,3,119993,119993,119996,0,3,3
34288,5,2,119998,119998,120000,0,2,2
34289,4,3,120002,120002,120005,0,3,2
34290,2,3,120004,120005,120008,1,4,0
34291,3,2,120007,120008,120010,1,3,0
34292,2,3,120009,120010,120013,1,4,0
34293,3,3,120012,120013,120016,1,4,0
34294,2,3,120014,120016,120019,2,5,0
34295,1,2,120015,120019,120021,4,6,0
34296,6,1,120021,120021,120022,0,1,0
34297,1,2,120022,120022,120024,0,2,0
34298,4,3,120026,120026,120029,0,3,2
34299,3,1,120029,120029,120030,0,1,0
34300,3,1,120032,120032,120033,0,1,2
34301,5,2,120037,120037,120039,0,2,4
34302,4,1,120041,120041,120042,0,1,2
34303,1,3,120042,120042,120045,0,3,0
34304,2,3,120044,120045,120048,1,4,0
34305,5,1,120049,120049,120050,0,1,1
34306,5,3,120054,120054,120057,0,3,4
34307,6,3,120060,120060,120063,0,3,3
34308,6,2,120066,120066,120068,0,2,3
34309,5,2,120071,120071,120073,0,2,3
34310,1,1,120072,120073,120074,1,2,0
34311,2,2,120074,120074,120076,0,2,0
34312,5,1,120079,120079,120080,0,1,3
34313,2,2,120081,120081,120083,0,2,1
34314,4,2,120085,120085,120087,0,2,2
34315,1,3,120086,120087,120090,1,4,0
34316,1,1,120087,120090,120091,3,4,0
34317,5,2,120092,120092,120094,0,2,1
34318,4,3,120096,120096,120099,0,3,2
34319,2,1,120098,120099,120100,1,2,0
34320,5,3,120103,120103,120106,0,3,3
34321,5,3,120108,120108,120111,0,3,2
34322,1,2,120109,120111,120113,2,4,0
34323,3,3,120112,120113,120116,1,4,0
34324,4,1,120116,120116,120117,0,1,0
34325,1,3,120117,120117,120120,0,3,0
34326,5,2,120122,120122,120124,0,2,2
34327,3,2,120125,120125,120127,0,2,1
34328,2,1,120127,120127,120128,0,1,0
34329,2,3,120129,120129,120132,0,3,1
34330,4,2,120133,120133,120135,0,2,1
34331,2,1,120135,120135,120136,0,1,0
34332,4,2,120139,120139,120141,0,2,3
34333,2,1,120141,120141,120142,0,1,0
34334,4,1,120145,120145,120146,0,1,3
34335,4,2,120149,120149,120151,0,2,3
34336,3,2,120152,120152,120154,0,2,1
34337,4,2,120156,120156,120158,0,2,2
34338,5,1,120161,120161,120162,0,1,3
34339,4,3,120165,120165,120168,0,3,3
34340,5,3,120170,120170,120173,0,3,2
34341,5,3,120175,120175,120178,0,3,2
34342,4,2,120179,120179,120181,0,2,1
34343,4,2,120183,120183,120185,0,2,2
34344,2,3,120185,120185,120188,0,3,0
34345,2,1,120187,120188,120189,1,2,0
34346,5,3,120192,120192,120195,0,3,3
34347,6,3,120198,120198,120201,0,3,3
34348,2,2,120200,120201,120203,1,3,0
34349,3,1,120203,120203,120204,0,1,0
34350,1,3,120204,120204,120207,0,3,0
34351,6,1,120210,120210,120211,0,1,3
34352,5,2,120215,120215,120217,0,2,4
34353,2,3,120217,120217,120220,0,3,0
34354,5,2,120222,120222,120224,0,2,2
34355,3,3,120225,120225,120228,0,3,1
34356,2,2,120227,120228,120230,1,3,0
34357,3,2,120230,120230,120232,0,2,0
34358,1,2,120231,120232,120234,1,3,0
34359,2,2,120233,120234,120236,1,3,0
34360,1,3,120234,120236,120239,2,5,0
34361,3,1,120237,120239,120240,2,3,0
34362,3,2,120240,120240,120242,0,2,0
34363,6,2,120246,120246,120248,0,2,4
34364,1,3,120247,120248,120251,1,4,0
34365,2,2,120249,120251,120253,2,4,0
34366,4,3,120253,120253,120256,0,3,0
34367,6,3,120259,120259,120262,0,3,3
34368,1,1,120260,120262,120263,2,3,0
34369,6,2,120266,120266,120268,0,2,3
34370,1,2,120267,120268,120270,1,3,0
34371,6,2,120273,120273,120275,0,2,3
34372,3,3,120276,120276,120279,0,3,1
34373,5,1,120281,120281,120282,0,1,2
34374,6,3,120287,120287,120290,0,3,5
34375,6,1,120293,120293,120294,0,1,3
34376,1,2,120294,120294,120296,0,2,0
34377,3,2,120297,120297,120299,0,2,1
34378,5,3,120302,120302,120305,0,3,3
34379,3,2,120305,120305,120307,0,2,0
34380,6,1,120311,120311,120312,0,1,4
34381,1,2,120312,120312,120314,0,2,0
34382,3,1,120315,120315,120316,0,1,1
34383,2,1,120317,120317,120318,0,1,1
34384,5,2,120322,120322,120324,0,2,4
34385,2,2,120324,120324,120326,0,2,0
34386,4,1,120328,120328,120329,0,1,2
34387,2,2,120330,120330,120332,0,2,1
34388,2,2,120332,120332,120334,0,2,0
34389,1,3,120333,120334,120337,1,4,0
34390,1,2,120334,120337,120339,3,5,0
34391,5,2,120339,120339,120341,0,2,0
34392,5,1,120344,120344,120345,0,1,3
34393,3,2,120347,120347,120349,0,2,2
34394,4,1,120351,120351,120352,0,1,2
34395,1,2,120352,120352,120354,0,2,0
34396,6,1,120358,120358,120359,0,1,4
34397,5,1,120363,120363,120364,0,1,4
34398,1,3,120364,120364,120367,0,3,0
34399,4,2,120368,120368,120370,0,2,1
34400,6,2,120374,120374,120376,0,2,4
34401,5,2,120379,120379,120381,0,2,3
34402,6,1,120385,120385,120386,0,1,4
34403,4,2,120389,120389,120391,0,2,3
34404,4,2,120393,120393,120395,0,2,2
34405,2,2,120395,120395,120397,0,2,0
34406,2,1,120397,120397,120398,0,1,0
34407,2,1,120399,120399,120400,0,1,1
34408,3,2,120402,120402,120404,0,2,2
34409,6,1,120408,120408,120409,0,1,4
34410,3,1,120411,120411,120412,0,1,2
34411,6,2,120417,120417,120419,0,2,5
34412,2,3,120419,120419,120422,0,3,0
34413,2,1,120421,120422,120423,1,2,0
34414,2,3,120423,120423,120426,0,3,0
34415,5,1,120428,120428,120429,0,1,2
34416,3,1,120431,120431,120432,0,1,2
34417,6,3,120437,120437,120440,0,3,5
34418,1,3,120438,120440,120443,2,5,0
34419,6,2,120444,120444,120446,0,2,1
34420,4,1,120448,120448,120449,0,1,2
34421,1,1,120449,120449,120450,0,1,0
34422,1,1,120450,120450,120451,0,1,0
34423,5,2,120455,120455,120457,0,2,4
34424,3,1,120458,120458,120459,0,1,1
34425,2,3,120460,120460,120463,0,3,1
34426,2,3,120462,120463,120466,1,4,0
34427,5,2,120467,120467,120469,0,2,1
34428,1,1,120468,120469,120470,1,2,0
34429,6,2,120474,120474,120476,0,2,4
34430,2,3,120476,120476,120479,0,3,0
34431,6,2,120482,120482,120484,0,2,3
34432,3,2,120485,120485,120487,0,2,1
34433,2,1,120487,120487,120488,0,1,0
34434,1,1,120488,120488,120489,0,1,0
34435,3,3,120491,120491,120494,0,3,2
34436,6,3,120497,120497,120500,0,3,3
34437,4,1,120501,120501,120502,0,1,1
34438,5,1,120506,120506,120507,0,1,4
34439,4,2,120510,120510,120512,0,2,3
34440,5,2,120515,120515,120517,0,2,3
34441,4,3,120519,120519,120522,0,3,2
34442,1,3,120520,120522,120525,2,5,0
34443,2,2,120522,120525,120527,3,5,0
34444,4,2,120526,120527,120529,1,3,0
34445,6,3,120532,120532,120535,0,3,3
34446,3,2,120535,120535,120537,0,2,0
34447,5,3,120540,120540,120543,0,3,3
34448,3,1,120543,120543,120544,0,1,0
34449,4,1,120547,120547,120548,0,1,3
34450,6,3,120553,120553,120556,0,3,5
34451,1,3,120554,120556,120559,2,5,0
34452,5,2,120559,120559,120561,0,2,0
34453,4,1,120563,120563,120564,0,1,2
34454,6,3,120569,120569,120572,0,3,5
34455,4,1,120573,120573,120574,0,1,1
34456,2,2,120575,120575,120577,0,2,1
34457,5,1,120580,120580,120581,0,1,3
34458,2,1,120582,120582,120583,0,1,1
34459,6,1,120588,120588,120589,0,1,5
34460,1,3,120589,120589,120592,0,3,0
34461,5,3,120594,120594,120597,0,3,2
34462,5,1,120599,120599,120600,0,1,2
34463,6,2,120605,120605,120607,0,2,5
34464,4,1,120609,120609,120610,0,1,2
34465,1,2,120610,120610,120612,0,2,0
34466,6,3,120616,120616,120619,0,3,4
34467,2,3,120618,120619,120622,1,4,0
34468,1,3,120619,120622,120625,3,6,0
34469,4,2,120623,120625,120627,2,4,0
34470,6,1,120629,120629,120630,0,1,2
34471,5,3,120634,120634,120637,0,3,4
34472,4,2,120638,120638,120640,0,2,1
34473,1,2,120639,120640,120642,1,3,0
34474,3,2,120642,120642,120644,0,2,0
34475,5,1,120647,120647,120648,0,1,3
34476,3,2,120650,120650,120652,0,2,2
34477,5,2,120655,120655,120657,0,2,3
34478,5,1,120660,120660,120661,0,1,3
34479,1,2,120661,120661,120663,0,2,0
34480,6,3,120667,120667,120670,0,3,4
34481,3,2,120670,120670,120672,0,2,0
34482,4,2,120674,120674,120676,0,2,2
34483,6,3,120680,120680,120683,0,3,4
34484,1,1,120681,120683,120684,2,3,0
34485,5,3,120686,120686,120689,0,3,2
34486,6,1,120692,120692,120693,0,1,3
34487,6,2,120698,120698,120700,0,2,5
34488,1,2,120699,120700,120702,1,3,0
34489,2,3,120701,120702,120705,1,4,0
34490,3,1,120704,120705,120706,1,2,0
34491,3,2,120707,120707,120709,0,2,1
34492,3,3,120710,120710,120713,0,3,1
34493,4,1,120714,120714,120715,0,1,1
34494,2,1,120716,120716,120717,0,1,1
34495,5,1,120721,120721,120722,0,1,4
34496,6,3,120727,120727,120730,0,3,5
34497,2,3,120729,120730,120733,1,4,0
34498,4,3,120733,120733,120736,0,3,0
34499,2,1,120735,120736,120737,1,2,0
34500,4,2,120739,120739,120741,0,2,2
34501,1,2,120740,120741,120743,1,3,0
34502,3,3,120743,120743,120746,0,3,0
34503,6,2,120749,120749,120751,0,2,3
34504,2,2,120751,120751,120753,0,2,0
34505,2,1,120753,120753,120754,0,1,0
34506,2,1,120755,120755,120756,0,1,1
34507,6,1,120761,120761,120762,0,1,5
34508,2,3,120763,120763,120766,0,3,1
34509,3,1,120766,120766,120767,0,1,0
34510,2,3,120768,120768,120771,0,3,1
34511,6,2,120774,120774,120776,0,2,3
34512,2,1,120776,120776,120777,0,1,0
34513,4,3,120780,120780,120783,0,3,3
34514,6,2,120786,120786,120788,0,2,3
34515,2,1,120788,120788,120789,0,1,0
34516,2,3,120790,120790,120793,0,3,1
34517,5,1,120795,120795,120796,0,1,2
34518,3,3,120798,120798,120801,0,3,2
34519,6,2,120804,120804,120806,0,2,3
34520,4,1,120808,120808,120809,0,1,2
34521,6,2,120814,120814,120816,0,2,5
34522,5,2,120819,120819,120821,0,2,3
34523,3,2,120822,120822,120824,0,2,1
34524,1,1,120823,120824,120825,1,2,0
34525,3,1,120826,120826,120827,0,1,1
34526,6,1,120832,120832,120833,0,1,5
34527,2,2,120834,120834,120836,0,2,1
34528,6,3,120840,120840,120843,0,3,4
34529,4,1,120844,120844,120845,0,1,1
34530,5,1,120849,120849,120850,0,1,4
34531,3,2,120852,120852,120854,0,2,2
34532,5,1,120857,120857,120858,0,1,3
34533,5,3,120862,120862,120865,0,3,4
34534,6,2,120868,120868,120870,0,2,3
34535,5,1,120873,120873,120874,0,1,3
34536,5,2,120878,120878,120880,0,2,4
34537,4,1,120882,120882,120883,0,1,2
34538,1,2,120883,120883,120885,0,2,0
34539,2,2,120885,120885,120887,0,2,0
34540,5,2,120890,120890,120892,0,2,3
34541,6,2,120896,120896,120898,0,2,4
34542,5,2,120901,120901,120903,0,2,3
34543,5,3,120906,120906,120909,0,3,3
34544,4,3,120910,120910,120913,0,3,1
34545,2,3,120912,120913,120916,1,4,0
34546,3,3,120915,120916,120919,1,4,0
34547,5,3,120920,120920,120923,0,3,1
34548,5,2,120925,120925,120927,0,2,2
34549,5,1,120930,120930,120931,0,1,3
34550,6,1,120936,120936,120937,0,1,5
34551,6,3,120942,120942,120945,0,3,5
34552,6,3,120948,120948,120951,0,3,3
34553,3,2,120951,120951,120953,0,2,0
34554,3,3,120954,120954,120957,0,3,1
34555,1,3,120955,120957,120960,2,5,0
34556,2,2,120957,120960,120962,3,5,0
34557,5,1,120962,120962,120963,0,1,0
34558,5,3,120967,120967,120970,0,3,4
34559,5,2,120972,120972,120974,0,2,2
34560,3,1,120975,120975,120976,0,1,1
34561,5,1,120980,120980,120981,0,1,4
34562,5,3,120985,120985,120988,0,3,4
34563,3,3,120988,120988,120991,0,3,0
34564,4,1,120992,120992,120993,0,1,1
34565,2,1,120994,120994,120995,0,1,1
34566,3,2,120997,120997,120999,0,2,2
34567,3,1,121000,121000,121001,0,1,1
34568,2,3,121002,121002,121005,0,3,1
34569,5,1,121007,121007,121008,0,1,2
34570,2,3,121009,121009,121012,0,3,1
34571,2,2,121011,121012,121014,1,3,0
34572,2,1,121013,121014,121015,1,2,0
34573,1,3,121014,121015,121018,1,4,0
34574,2,1,121016,121018,121019,2,3,0
34575,4,1,121020,121020,121021,0,1,1
34576,6,2,121026,121026,121028,0,2,5
34577,6,2,121032,121032,121034,0,2,4
34578,5,2,121037,121037,121039,0,2,3
34579,4,1,121041,121041,121042,0,1,2
34580,4,1,121045,121045,121046,0,1,3
34581,4,3,121049,121049,121052,0,3,3
34582,4,2,121053,121053,121055,0,2,1
34583,2,3,121055,121055,121058,0,3,0
34584,3,2,121058,121058,121060,0,2,0
34585,3,3,121061,121061,121064,0,3,1
34586,3,2,121064,121064,121066,0,2,0
34587,1,3,121065,121066,121069,1,4,0
34588,6,2,121071,121071,121073,0,2,2
34589,4,2,121075,121075,121077,0,2,2
34590,3,1,121078,121078,121079,0,1,1
34591,1,1,121079,121079,121080,0,1,0
34592,5,2,121084,121084,121086,0,2,4
34593,6,1,121090,121090,121091,0,1,4
34594,3,1,121093,121093,121094,0,1,2
34595,4,3,121097,121097,121100,0,3,3
34596,6,3,121103,121103,121106,0,3,3
34597,6,1,121109,121109,121110,0,1,3
34598,5,1,121114,121114,121115,0,1,4
34599,3,1,121117,121117,121118,0,1,2
34600,5,3,121122,121122,121125,0,3,4
34601,5,3,121127,121127,121130,0,3,2
34602,3,1,121130,121130,121131,0,1,0
34603,2,1,121132,121132,121133,0,1,1
34604,2,3,121134,121134,121137,0,3,1
34605,1,1,121135,121137,121138,2,3,0
34606,6,1,121141,121141,121142,0,1,3
34607,2,3,121143,121143,121146,0,3,1
34608,5,1,121148,121148,121149,0,1,2
34609,1,3,121149,121149,121152,0,3,0
34610,2,2,121151,121152,121154,1,3,0
34611,5,2,121156,121156,121158,0,2,2
34612,4,3,121160,121160,121163,0,3,2
34613,6,3,121166,121166,121169,0,3,3
34614,6,1,121172,121172,121173,0,1,3
34615,4,1,121176,121176,121177,0,1,3
34616,5,2,121181,121181,121183,0,2,4
34617,2,2,121183,121183,121185,0,2,0
34618,3,1,121186,121186,121187,0,1,1
34619,3,1,121189,121189,121190,0,1,2
34620,6,1,121195,121195,121196,0,1,5
34621,3,3,121198,121198,121201,0,3,2
34622,1,1,121199,121201,121202,2,3,0
34623,1,1,121200,121202,121203,2,3,0
34624,4,3,121204,121204,121207,0,3,1
34625,4,1,121208,121208,121209,0,1,1
34626,2,2,121210,121210,121212,0,2,1
34627,2,2,121212,121212,121214,0,2,0
34628,5,1,121217,121217,121218,0,1,3
34629,1,1,121218,121218,121219,0,1,0
34630,3,2,121221,121221,121223,0,2,2
34631,2,3,121223,121223,121226,0,3,0
34632,6,2,121229,121229,121231,0,2,3
34633,6,2,121235,121235,121237,0,2,4
34634,4,2,121239,121239,121241,0,2,2
34635,2,1,121241,121241,121242,0,1,0
34636,1,1,121242,121242,121243,0,1,0
34637,5,1,121247,121247,121248,0,1,4
34638,3,1,121250,121250,121251,0,1,2
34639,3,2,121253,121253,121255,0,2,2
34640,3,2,121256,121256,121258,0,2,1
34641,4,1,121260,121260,121261,0,1,2
34642,3,2,121263,121263,121265,0,2,2
34643,4,3,121267,121267,121270,0,3,2
34644,3,2,121270,121270,121272,0,2,0
34645,1,3,121271,121272,121275,1,4,0
34646,6,3,121277,121277,121280,0,3,2
34647,4,1,121281,121281,121282,0,1,1
34648,2,3,121283,121283,121286,0,3,1
34649,4,1,121287,121287,121288,0,1,1
34650,4,3,121291,121291,121294,0,3,3
34651,6,1,121297,121297,121298,0,1,3
34652,2,1,121299,121299,121300,0,1,1
34653,6,1,121305,121305,121306,0,1,5
34654,5,3,121310,121310,121313,0,3,4
34655,1,3,121311,121313,121316,2,5,0
34656,6,3,121317,121317,121320,0,3,1
34657,4,2,121321,121321,121323,0,2,1
34658,6,1,121327,121327,121328,0,1,4
34659,1,2,121328,121328,121330,0,2,0
34660,6,3,121334,121334,121337,0,3,4
34661,3,2,121337,121337,121339,0,2,0
34662,2,2,121339,121339,121341,0,2,0
34663,2,3,121341,121341,121344,0,3,0
34664,4,3,121345,121345,121348,0,3,1
34665,6,1,121351,121351,121352,0,1,3
34666,2,1,121353,121353,121354,0,1,1
34667,6,2,121359,121359,121361,0,2,5
34668,5,2,121364,121364,121366,0,2,3
34669,3,3,121367,121367,121370,0,3,1
34670,3,3,121370,121370,121373,0,3,0
34671,2,1,121372,121373,121374,1,2,0
34672,2,3,121374,121374,121377,0,3,0
34673,5,2,121379,121379,121381,0,2,2
34674,2,2,121381,121381,121383,0,2,0
34675,4,3,121385,121385,121388,0,3,2
34676,5,2,121390,121390,121392,0,2,2
34677,5,3,121395,121395,121398,0,3,3
34678,1,3,121396,121398,121401,2,5,0
34679,5,1,121401,121401,121402,0,1,0
34680,2,1,121403,121403,121404,0,1,1
34681,3,2,121406,121406,121408,0,2,2
34682,1,2,121407,121408,121410,1,3,0
34683,1,2,121408,121410,121412,2,4,0
34684,1,2,121409,121412,121414,3,5,0
34685,1,1,121410,121414,121415,4,5,0
34686,5,1,121415,121415,121416,0,1,0
34687,3,2,121418,121418,121420,0,2,2
34688,4,1,121422,121422,121423,0,1,2
34689,3,3,121425,121425,121428,0,3,2
34690,2,2,121427,121428,121430,1,3,0
34691,4,1,121431,121431,121432,0,1,1
34692,3,2,121434,121434,121436,0,2,2
34693,2,2,121436,121436,121438,0,2,0
34694,6,1,121442,121442,121443,0,1,4
34695,5,2,121447,121447,121449,0,2,4
34696,6,1,121453,121453,121454,0,1,4
34697,5,1,121458,121458,121459,0,1,4
34698,6,1,121464,121464,121465,0,1,5
34699,6,2,121470,121470,121472,0,2,5
34700,4,1,121474,121474,121475,0,1,2
34701,5,3,121479,121479,121482,0,3,4
34702,1,1,121480,121482,121483,2,3,0
34703,5,2,121485,121485,121487,0,2,2
34704,3,3,121488,121488,121491,0,3,1
34705,6,2,121494,121494,121496,0,2,3
34706,5,2,121499,121499,121501,0,2,3
34707,4,2,121503,121503,121505,0,2,2
34708,5,2,121508,121508,121510,0,2,3
34709,4,3,121512,121512,121515,0,3,2
34710,4,1,121516,121516,121517,0,1,1
34711,4,1,121520,121520,121521,0,1,3
34712,2,2,121522,121522,121524,0,2,1
34713,5,1,121527,121527,121528,0,1,3
34714,1,3,121528,121528,121531,0,3,0
34715,6,1,121534,121534,121535,0,1,3
34716,5,2,121539,121539,121541,0,2,4
34717,1,1,121540,121541,121542,1,2,0
34718,3,1,121543,121543,121544,0,1,1
34719,3,3,121546,121546,121549,0,3,2
34720,1,2,121547,121549,121551,2,4,0
34721,5,1,121552,121552,121553,0,1,1
34722,5,1,121557,121557,121558,0,1,4
34723,1,2,121558,121558,121560,0,2,0
34724,5,3,121563,121563,121566,0,3,3
34725,3,3,121566,121566,121569,0,3,0
34726,1,1,121567,121569,121570,2,3,0
34727,1,1,121568,121570,121571,2,3,0
34728,6,3,121574,121574,121577,0,3,3
34729,6,1,121580,121580,121581,0,1,3
34730,1,3,121581,121581,121584,0,3,0
34731,5,3,121586,121586,121589,0,3,2
34732,6,1,121592,121592,121593,0,1,3
34733,2,1,121594,121594,121595,0,1,1
34734,4,3,121598,121598,121601,0,3,3
34735,4,1,121602,121602,121603,0,1,1
34736,3,1,121605,121605,121606,0,1,2
34737,2,1,121607,121607,121608,0,1,1
34738,1,2,121608,121608,121610,0,2,0
34739,3,1,121611,121611,121612,0,1,1
34740,6,3,121617,121617,121620,0,3,5
34741,6,2,121623,121623,121625,0,2,3
34742,6,3,121629,121629,121632,0,3,4
34743,6,3,121635,121635,121638,0,3,3
34744,4,3,121639,121639,121642,0,3,1
34745,1,2,121640,121642,121644,2,4,0
34746,5,1,121645,121645,121646,0,1,1
34747,2,2,121647,121647,121649,0,2,1
34748,3,1,121650,121650,121651,0,1,1
34749,4,2,121654,121654,121656,0,2,3
34750,5,2,121659,121659,121661,0,2,3
34751,4,2,121663,121663,121665,0,2,2
34752,6,3,121669,121669,121672,0,3,4
34753,3,2,121672,121672,121674,0,2,0
34754,4,1,121676,121676,121677,0,1,2
34755,5,2,121681,121681,121683,0,2,4
34756,4,2,121685,121685,121687,0,2,2
34757,2,3,121687,121687,121690,0,3,0
34758,4,1,121691,121691,121692,0,1,1
34759,6,1,121697,121697,121698,0,1,5
34760,5,1,121702,121702,121703,0,1,4
34761,5,1,121707,121707,121708,0,1,4
34762,1,1,121708,121708,121709,0,1,0
34763,2,2,121710,121710,121712,0,2,1
34764,3,1,121713,121713,121714,0,1,1
34765,6,2,121719,121719,121721,0,2,5
34766,6,3,121725,121725,121728,0,3,4
34767,3,3,121728,121728,121731,0,3,0
34768,3,2,121731,121731,121733,0,2,0
34769,6,1,121737,121737,121738,0,1,4
34770,6,2,121743,121743,121745,0,2,5
34771,5,3,121748,121748,121751,0,3,3
34772,4,3,121752,121752,121755,0,3,1
34773,3,3,121755,121755,121758,0,3,0
34774,4,2,121759,121759,121761,0,2,1
34775,5,3,121764,121764,121767,0,3,3
34776,3,3,121767,121767,121770,0,3,0
34777,6,3,121773,121773,121776,0,3,3
34778,5,1,121778,121778,121779,0,1,2
34779,1,2,121779,121779,121781,0,2,0
34780,4,3,121783,121783,121786,0,3,2
34781,2,1,121785,121786,121787,1,2,0
34782,6,3,121791,121791,121794,0,3,4
34783,2,1,121793,121794,121795,1,2,0
34784,1,1,121794,121795,121796,1,2,0
34785,5,3,121799,121799,121802,0,3,3
34786,5,2,121804,121804,121806,0,2,2
34787,6,1,121810,121810,121811,0,1,4
34788,1,1,121811,121811,121812,0,1,0
34789,1,1,121812,121812,121813,0,1,0
34790,4,1,121816,121816,121817,0,1,3
34791,6,3,121822,121822,121825,0,3,5
34792,2,1,121824,121825,121826,1,2,0
34793,2,2,121826,121826,121828,0,2,0
34794,5,1,121831,121831,121832,0,1,3
34795,5,1,121836,121836,121837,0,1,4
34796,2,1,121838,121838,121839,0,1,1
34797,6,2,121844,121844,121846,0,2,5
34798,4,1,121848,121848,121849,0,1,2
34799,4,3,121852,121852,121855,0,3,3
34800,3,2,121855,121855,121857,0,2,0
34801,1,2,121856,121857,121859,1,3,0
34802,1,3,121857,121859,121862,2,5,0
34803,4,3,121861,121862,121865,1,4,0
34804,1,1,121862,121865,121866,3,4,0
34805,3,1,121865,121866,121867,1,2,0
34806,5,2,121870,121870,121872,0,2,3
34807,2,2,121872,121872,121874,0,2,0
34808,6,2,121878,121878,121880,0,2,4
34809,4,2,121882,121882,121884,0,2,2
34810,6,3,121888,121888,121891,0,3,4
34811,5,1,121893,121893,121894,0,1,2
34812,6,3,121899,121899,121902,0,3,5
34813,2,3,121901,121902,121905,1,4,0
34814,2,1,121903,121905,121906,2,3,0
34815,3,2,121906,121906,121908,0,2,0
34816,5,2,121911,121911,121913,0,2,3
34817,4,1,121915,121915,121916,0,1,2
34818,2,2,121917,121917,121919,0,2,1
34819,4,1,121921,121921,121922,0,1,2
34820,5,3,121926,121926,121929,0,3,4
34821,5,1,121931,121931,121932,0,1,2
34822,5,3,121936,121936,121939,0,3,4
34823,6,2,121942,121942,121944,0,2,3
34824,4,3,121946,121946,121949,0,3,2
34825,1,1,121947,121949,121950,2,3,0
34826,5,1,121952,121952,121953,0,1,2
34827,5,3,121957,121957,121960,0,3,4
34828,4,1,121961,121961,121962,0,1,1
34829,2,3,121963,121963,121966,0,3,1
34830,4,1,121967,121967,121968,0,1,1
34831,5,2,121972,121972,121974,0,2,4
34832,2,1,121974,121974,121975,0,1,0
34833,4,3,121978,121978,121981,0,3,3
34834,3,1,121981,121981,121982,0,1,0
34835,3,2,121984,121984,121986,0,2,2
34836,3,1,121987,121987,121988,0,1,1
34837,5,3,121992,121992,121995,0,3,4
34838,3,3,121995,121995,121998,0,3,0
34839,6,3,122001,122001,122004,0,3,3
34840,1,3,122002,122004,122007,2,5,0
34841,4,2,122006,122007,122009,1,3,0
34842,3,1,122009,122009,122010,0,1,0
34843,4,3,122013,122013,122016,0,3,3
34844,1,1,122014,122016,122017,2,3,0
34845,4,2,122018,122018,122020,0,2,1
34846,5,2,122023,122023,122025,0,2,3
34847,3,2,122026,122026,122028,0,2,1
34848,6,2,122032,122032,122034,0,2,4
34849,4,1,122036,122036,122037,0,1,2
34850,5,2,122041,122041,122043,0,2,4
34851,3,2,122044,122044,122046,0,2,1
34852,3,1,122047,122047,122048,0,1,1
34853,3,2,122050,122050,122052,0,2,2
34854,2,3,122052,122052,122055,0,3,0
34855,1,2,122053,122055,122057,2,4,0
34856,2,3,122055,122057,122060,2,5,0
34857,5,2,122060,122060,122062,0,2,0
34858,5,1,122065,122065,122066,0,1,3
34859,4,3,122069,122069,122072,0,3,3
34860,2,2,122071,122072,122074,1,3,0
34861,2,1,122073,122074,122075,1,2,0
34862,4,1,122077,122077,122078,0,1,2
34863,4,2,122081,122081,122083,0,2,3
34864,1,1,122082,122083,122084,1,2,0
34865,2,3,122084,122084,122087,0,3,0
34866,4,2,122088,122088,122090,0,2,1
34867,2,1,122090,122090,122091,0,1,0
34868,3,3,122093,122093,122096,0,3,2
34869,5,1,122098,122098,122099,0,1,2
34870,4,1,122102,122102,122103,0,1,3
34871,5,3,122107,122107,122110,0,3,4
34872,4,1,122111,122111,122112,0,1,1
34873,1,3,122112,122112,122115,0,3,0
34874,1,3,122113,122115,122118,2,5,0
34875,1,1,122114,122118,122119,4,5,0
34876,4,2,122118,122119,122121,1,3,0
34877,4,2,122122,122122,122124,0,2,1
34878,1,1,122123,122124,122125,1,2,0
34879,6,3,122129,122129,122132,0,3,4
34880,2,3,122131,122132,122135,1,4,0
34881,3,1,122134,122135,122136,1,2,0
34882,5,1,122139,122139,122140,0,1,3
34883,2,1,122141,122141,122142,0,1,1
34884,1,2,122142,122142,122144,0,2,0
34885,3,3,122145,122145,122148,0,3,1
34886,2,3,122147,122148,122151,1,4,0
34887,3,1,122150,122151,122152,1,2,0
34888,3,1,122153,122153,122154,0,1,1
34889,1,1,122154,122154,122155,0,1,0
34890,3,3,122157,122157,122160,0,3,2
34891,1,1,122158,122160,122161,2,3,0
34892,1,2,122159,122161,122163,2,4,0
34893,2,1,122161,122163,122164,2,3,0
34894,6,1,122167,122167,122168,0,1,3
34895,4,1,122171,122171,122172,0,1,3
34896,1,2,122172,122172,122174,0,2,0
34897,5,1,122177,122177,122178,0,1,3
34898,3,3,122180,122180,122183,0,3,2
34899,5,3,122185,122185,122188,0,3,2
34900,2,1,122187,122188,122189,1,2,0
34901,2,1,122189,122189,122190,0,1,0
34902,4,1,122193,122193,122194,0,1,3
34903,1,2,122194,122194,122196,0,2,0
34904,3,2,122197,122197,122199,0,2,1
34905,1,2,122198,122199,122201,1,3,0
34906,1,3,122199,122201,122204,2,5,0
34907,2,3,122201,122204,122207,3,6,0
34908,1,2,122202,122207,122209,5,7,0
34909,1,1,122203,122209,122210,6,7,0
34910,1,2,122204,122210,122212,6,8,0
34911,1,1,122205,122212,122213,7,8,0
34912,5,2,122210,122213,122215,3,5,0
34913,4,3,122214,122215,122218,1,4,0
34914,4,3,122218,122218,122221,0,3,0
34915,1,1,122219,122221,122222,2,3,0
34916,5,3,122224,122224,122227,0,3,2
34917,3,1,122227,122227,122228,0,1,0
34918,5,3,122232,122232,122235,0,3,4
34919,4,2,122236,122236,122238,0,2,1
34920,3,1,122239,122239,122240,0,1,1
34921,3,1,122242,122242,122243,0,1,2
34922,4,3,122246,122246,122249,0,3,3
34923,6,3,122252,122252,122255,0,3,3
34924,1,1,122253,122255,122256,2,3,0
34925,1,3,122254,122256,122259,2,5,0
34926,5,2,122259,122259,122261,0,2,0
34927,5,1,122264,122264,122265,0,1,3
34928,3,1,122267,122267,122268,0,1,2
34929,1,2,122268,122268,122270,0,2,0
34930,4,1,122272,122272,122273,0,1,2
34931,1,1,122273,122273,122274,0,1,0
34932,3,2,122276,122276,122278,0,2,2
34933,5,1,122281,122281,122282,0,1,3
34934,1,2,122282,122282,122284,0,2,0
34935,1,1,122283,122284,122285,1,2,0
34936,4,1,122287,122287,122288,0,1,2
34937,3,2,122290,122290,122292,0,2,2
34938,5,2,122295,122295,122297,0,2,3
34939,6,1,122301,122301,122302,0,1,4
34940,3,1,122304,122304,122305,0,1,2
34941,4,3,122308,122308,122311,0,3,3
34942,6,1,122314,122314,122315,0,1,3
34943,1,3,122315,122315,122318,0,3,0
34944,1,3,122316,122318,122321,2,5,0
34945,1,2,122317,122321,122323,4,6,0
34946,3,1,122320,122323,122324,3,4,0
34947,1,2,122321,122324,122326,3,5,0
34948,5,2,122326,122326,122328,0,2,0
34949,6,3,122332,122332,122335,0,3,4
34950,1,1,122333,122335,122336,2,3,0
34951,2,2,122335,122336,122338,1,3,0
34952,2,1,122337,122338,122339,1,2,0
34953,4,3,122341,122341,122344,0,3,2
34954,2,2,122343,122344,122346,1,3,0
34955,5,2,122348,122348,122350,0,2,2
34956,2,2,122350,122350,122352,0,2,0
34957,3,2,122353,122353,122355,0,2,1
34958,3,3,122356,122356,122359,0,3,1
34959,2,3,122358,122359,122362,1,4,0
34960,3,1,122361,122362,122363,1,2,0
34961,4,1,122365,122365,122366,0,1,2
34962,2,2,122367,122367,122369,0,2,1
34963,5,1,122372,122372,122373,0,1,3
34964,4,1,122376,122376,122377,0,1,3
34965,3,3,122379,122379,122382,0,3,2
34966,2,3,122381,122382,122385,1,4,0
34967,6,3,122387,122387,122390,0,3,2
34968,6,3,122393,122393,122396,0,3,3
34969,6,1,122399,122399,122400,0,1,3
34970,2,2,122401,122401,122403,0,2,1
34971,5,1,122406,122406,122407,0,1,3
34972,4,2,122410,122410,122412,0,2,3
34973,2,1,122412,122412,122413,0,1,0
34974,4,2,122416,122416,122418,0,2,3
34975,5,1,122421,122421,122422,0,1,3
34976,4,2,122425,122425,122427,0,2,3
34977,2,3,122427,122427,122430,0,3,0
34978,2,1,122429,122430,122431,1,2,0
34979,3,3,122432,122432,122435,0,3,1
34980,4,3,122436,122436,122439,0,3,1
34981,3,2,122439,122439,122441,0,2,0
34982,2,3,122441,122441,122444,0,3,0
34983,6,1,122447,122447,122448,0,1,3
34984,4,1,122451,122451,122452,0,1,3
34985,5,2,122456,122456,122458,0,2,4
34986,2,1,122458,122458,122459,0,1,0
34987,6,1,122464,122464,122465,0,1,5
34988,6,3,122470,122470,122473,0,3,5
34989,6,2,122476,122476,122478,0,2,3
34990,3,3,122479,122479,122482,0,3,1
34991,4,3,122483,122483,122486,0,3,1
34992,4,2,122487,122487,122489,0,2,1
34993,4,2,122491,122491,122493,0,2,2
34994,6,2,122497,122497,122499,0,2,4
34995,6,2,122503,122503,122505,0,2,4
34996,4,1,122507,122507,122508,0,1,2
34997,6,2,122513,122513,122515,0,2,5
34998,4,3,122517,122517,122520,0,3,2
34999,4,1,122521,122521,122522,0,1,1
35000,1,2,122522,122522,122524,0,2,0
35001,6,1,122528,122528,122529,0,1,4
35002,1,2,122529,122529,122531,0,2,0
35003,6,3,122535,122535,122538,0,3,4
35004,3,3,122538,122538,122541,0,3,0
35005,6,3,122544,122544,122547,0,3,3
35006,6,2,122550,122550,122552,0,2,3
35007,6,1,122556,122556,122557,0,1,4
35008,6,1,122562,122562,122563,0,1,5
35009,5,1,122567,122567,122568,0,1,4
35010,4,1,122571,122571,122572,0,1,3
35011,2,3,122573,122573,122576,0,3,1
35012,1,3,122574,122576,122579,2,5,0
35013,5,1,122579,122579,122580,0,1,0
35014,1,1,122580,122580,122581,0,1,0
35015,4,1,122584,122584,122585,0,1,3
35016,6,1,122590,122590,122591,0,1,5
35017,3,2,122593,122593,122595,0,2,2
35018,3,1,122596,122596,122597,0,1,1
35019,3,1,122599,122599,122600,0,1,2
35020,2,2,122601,122601,122603,0,2,1
35021,3,1,122604,122604,122605,0,1,1
35022,5,3,122609,122609,122612,0,3,4
35023,3,2,122612,122612,122614,0,2,0
35024,6,2,122618,122618,122620,0,2,4
35025,3,2,122621,122621,122623,0,2,1
35026,2,2,122623,122623,122625,0,2,0
35027,3,2,122626,122626,122628,0,2,1
35028,2,2,122628,122628,122630,0,2,0
35029,2,1,122630,122630,122631,0,1,0
35030,2,1,122632,122632,122633,0,1,1
35031,1,1,122633,122633,122634,0,1,0
35032,6,2,122639,122639,122641,0,2,5
35033,1,1,122640,122641,122642,1,2,0
35034,1,1,122641,122642,122643,1,2,0
35035,3,2,122644,122644,122646,0,2,1
35036,6,2,122650,122650,122652,0,2,4
35037,5,2,122655,122655,122657,0,2,3
35038,4,2,122659,122659,122661,0,2,2
35039,4,2,122663,122663,122665,0,2,2
35040,3,1,122666,122666,122667,0,1,1
35041,5,3,122671,122671,122674,0,3,4
35042,3,1,122674,122674,122675,0,1,0
35043,4,1,122678,122678,122679,0,1,3
35044,3,2,122681,122681,122683,0,2,2
35045,6,2,122687,122687,122689,0,2,4
35046,4,3,122691,122691,122694,0,3,2
35047,5,3,122696,122696,122699,0,3,2
35048,2,1,122698,122699,122700,1,2,0
35049,6,1,122704,122704,122705,0,1,4
35050,2,3,122706,122706,122709,0,3,1
35051,2,1,122708,122709,122710,1,2,0
35052,4,1,122712,122712,122713,0,1,2
35053,6,1,122718,122718,122719,0,1,5
35054,3,3,122721,122721,122724,0,3,2
35055,2,3,122723,122724,122727,1,4,0
35056,2,1,122725,122727,122728,2,3,0
35057,5,3,122730,122730,122733,0,3,2
35058,2,3,122732,122733,122736,1,4,0
35059,6,1,122738,122738,122739,0,1,2
35060,5,1,122743,122743,122744,0,1,4
35061,5,2,122748,122748,122750,0,2,4
35062,1,1,122749,122750,122751,1,2,0
35063,4,3,122753,122753,122756,0,3,2
35064,6,2,122759,122759,122761,0,2,3
35065,2,2,122761,122761,122763,0,2,0
35066,4,3,122765,122765,122768,0,3,2
35067,6,2,122771,122771,122773,0,2,3
35068,2,1,122773,122773,122774,0,1,0
35069,6,2,122779,122779,122781,0,2,5
35070,3,2,122782,122782,122784,0,2,1
35071,2,2,122784,122784,122786,0,2,0
35072,1,3,122785,122786,122789,1,4,0
35073,5,3,122790,122790,122793,0,3,1
35074,4,1,122794,122794,122795,0,1,1
35075,1,3,122795,122795,122798,0,3,0
35076,3,3,122798,122798,122801,0,3,0
35077,6,2,122804,122804,122806,0,2,3
35078,5,1,122809,122809,122810,0,1,3
35079,3,3,122812,122812,122815,0,3,2
35080,6,1,122818,122818,122819,0,1,3
35081,6,3,122824,122824,122827,0,3,5
35082,2,2,122826,122827,122829,1,3,0
35083,5,3,122831,122831,122834,0,3,2
35084,4,3,122835,122835,122838,0,3,1
35085,3,2,122838,122838,122840,0,2,0
35086,6,3,122844,122844,122847,0,3,4
35087,3,3,122847,122847,122850,0,3,0
35088,2,1,122849,122850,122851,1,2,0
35089,5,1,122854,122854,122855,0,1,3
35090,4,2,122858,122858,122860,0,2,3
35091,5,2,122863,122863,122865,0,2,3
35092,3,1,122866,122866,122867,0,1,1
35093,4,3,122870,122870,122873,0,3,3
35094,6,3,122876,122876,122879,0,3,3
35095,6,2,122882,122882,122884,0,2,3
35096,1,1,122883,122884,122885,1,2,0
35097,2,1,122885,122885,122886,0,1,0
35098,2,2,122887,122887,122889,0,2,1
35099,6,2,122893,122893,122895,0,2,4
35100,4,3,122897,122897,122900,0,3,2
35101,6,2,122903,122903,122905,0,2,3
35102,5,1,122908,122908,122909,0,1,3
35103,2,1,122910,122910,122911,0,1,1
35104,4,1,122914,122914,122915,0,1,3
35105,5,1,122919,122919,122920,0,1,4
35106,1,3,122920,122920,122923,0,3,0
35107,3,3,122923,122923,122926,0,3,0
35108,4,2,122927,122927,122929,0,2,1
35109,1,3,122928,122929,122932,1,4,0
35110,4,2,122932,122932,122934,0,2,0
35111,6,1,122938,122938,122939,0,1,4
35112,4,1,122942,122942,122943,0,1,3
35113,1,3,122943,122943,122946,0,3,0
35114,3,3,122946,122946,122949,0,3,0
35115,1,2,122947,122949,122951,2,4,0
35116,2,3,122949,122951,122954,2,5,0
35117,3,1,122952,122954,122955,2,3,0
35118,5,1,122957,122957,122958,0,1,2
35119,2,3,122959,122959,122962,0,3,1
35120,6,1,122965,122965,122966,0,1,3
35121,6,3,122971,122971,122974,0,3,5
35122,5,3,122976,122976,122979,0,3,2
35123,2,1,122978,122979,122980,1,2,0
35124,2,1,122980,122980,122981,0,1,0
35125,5,3,122985,122985,122988,0,3,4
35126,5,3,122990,122990,122993,0,3,2
35127,4,2,122994,122994,122996,0,2,1
35128,2,3,122996,122996,122999,0,3,0
35129,4,3,123000,123000,123003,0,3,1
35130,3,1,123003,123003,123004,0,1,0
35131,5,1,123008,123008,123009,0,1,4
35132,6,3,123014,123014,123017,0,3,5
35133,2,1,123016,123017,123018,1,2,0
35134,6,1,123022,123022,123023,0,1,4
35135,4,1,123026,123026,123027,0,1,3
35136,3,2,123029,123029,123031,0,2,2
35137,1,2,123030,123031,123033,1,3,0
35138,5,2,123035,123035,123037,0,2,2
35139,5,3,123040,123040,123043,0,3,3
35140,1,3,123041,123043,123046,2,5,0
35141,4,2,123045,123046,123048,1,3,0
35142,6,3,123051,123051,123054,0,3,3
35143,5,1,123056,123056,123057,0,1,2
35144,1,3,123057,123057,123060,0,3,0
35145,2,2,123059,123060,123062,1,3,0
35146,4,2,123063,123063,123065,0,2,1
35147,5,3,123068,123068,123071,0,3,3
35148,3,3,123071,123071,123074,0,3,0
35149,6,1,123077,123077,123078,0,1,3
35150,3,3,123080,123080,123083,0,3,2
35151,2,2,123082,123083,123085,1,3,0
35152,6,1,123088,123088,123089,0,1,3
35153,2,1,123090,123090,123091,0,1,1
35154,6,1,123096,123096,123097,0,1,5
35155,1,3,123097,123097,123100,0,3,0
35156,4,3,123101,123101,123104,0,3,1
35157,4,3,123105,123105,123108,0,3,1
35158,1,2,123106,123108,123110,2,4,0
35159,2,2,123108,123110,123112,2,4,0
35160,4,3,123112,123112,123115,0,3,0
35161,1,1,123113,123115,123116,2,3,0
35162,2,3,123115,123116,123119,1,4,0
35163,1,2,123116,123119,123121,3,5,0
35164,5,1,123121,123121,123122,0,1,0
35165,2,2,123123,123123,123125,0,2,1
35166,1,3,123124,123125,123128,1,4,0
35167,4,1,123128,123128,123129,0,1,0
35168,3,1,123131,123131,123132,0,1,2
35169,4,3,123135,123135,123138,0,3,3
35170,1,1,123136,123138,123139,2,3,0
35171,3,2,123139,123139,123141,0,2,0
35172,1,1,123140,123141,123142,1,2,0
35173,5,1,123145,123145,123146,0,1,3
35174,4,2,123149,123149,123151,0,2,3
35175,2,1,123151,123151,123152,0,1,0
35176,2,2,123153,123153,123155,0,2,1
35177,4,3,123157,123157,123160,0,3,2
35178,3,3,123160,123160,123163,0,3,0
35179,3,1,123163,123163,123164,0,1,0
35180,1,1,123164,123164,123165,0,1,0
35181,4,2,123168,123168,123170,0,2,3
35182,6,1,123174,123174,123175,0,1,4
35183,6,1,123180,123180,123181,0,1,5
35184,2,3,123182,123182,123185,0,3,1
35185,1,3,123183,123185,123188,2,5,0
35186,5,1,123188,123188,123189,0,1,0
35187,1,3,123189,123189,123192,0,3,0
35188,6,1,123195,123195,123196,0,1,3
35189,6,3,123201,123201,123204,0,3,5
35190,6,2,123207,123207,123209,0,2,3
35191,1,2,123208,123209,123211,1,3,0
35192,5,3,123213,123213,123216,0,3,2
35193,5,2,123218,123218,123220,0,2,2
35194,3,2,123221,123221,123223,0,2,1
35195,3,2,123224,123224,123226,0,2,1
35196,3,1,123227,123227,123228,0,1,1
35197,4,2,123231,123231,123233,0,2,3
35198,4,1,123235,123235,123236,0,1,2
35199,5,1,123240,123240,123241,0,1,4
35200,2,1,123242,123242,123243,0,1,1
35201,2,3,123244,123244,123247,0,3,1
35202,4,3,123248,123248,123251,0,3,1
35203,3,1,123251,123251,123252,0,1,0
35204,5,3,123256,123256,123259,0,3,4
35205,5,3,123261,123261,123264,0,3,2
35206,4,2,123265,123265,123267,0,2,1
35207,1,2,123266,123267,123269,1,3,0
35208,2,1,123268,123269,123270,1,2,0
35209,1,2,123269,123270,123272,1,3,0
35210,6,1,123275,123275,123276,0,1,3
35211,1,3,123276,123276,123279,0,3,0
35212,6,2,123282,123282,123284,0,2,3
35213,6,3,123288,123288,123291,0,3,4
35214,3,3,123291,123291,123294,0,3,0
35215,2,2,123293,123294,123296,1,3,0
35216,5,3,123298,123298,123301,0,3,2
35217,5,2,123303,123303,123305,0,2,2
35218,2,1,123305,123305,123306,0,1,0
35219,2,2,123307,123307,123309,0,2,1
35220,6,1,123313,123313,123314,0,1,4
35221,5,3,123318,123318,123321,0,3,4
35222,5,2,123323,123323,123325,0,2,2
35223,4,2,123327,123327,123329,0,2,2
35224,4,2,123331,123331,123333,0,2,2
35225,1,2,123332,123333,123335,1,3,0
35226,3,2,123335,123335,123337,0,2,0
35227,4,3,123339,123339,123342,0,3,2
35228,2,3,123341,123342,123345,1,4,0
35229,4,1,123345,123345,123346,0,1,0
35230,4,1,123349,123349,123350,0,1,3
35231,4,2,123353,123353,123355,0,2,3
35232,5,3,123358,123358,123361,0,3,3
35233,4,1,123362,123362,123363,0,1,1
35234,1,1,123363,123363,123364,0,1,0
35235,2,2,123365,123365,123367,0,2,1
35236,3,3,123368,123368,123371,0,3,1
35237,3,2,123371,123371,123373,0,2,0
35238,2,1,123373,123373,123374,0,1,0
35239,5,3,123378,123378,123381,0,3,4
35240,4,3,123382,123382,123385,0,3,1
35241,4,3,123386,123386,123389,0,3,1
35242,6,3,123392,123392,123395,0,3,3
35243,1,2,123393,123395,123397,2,4,0
35244,3,3,123396,123397,123400,1,4,0
35245,3,1,123399,123400,123401,1,2,0
35246,4,2,123403,123403,123405,0,2,2
35247,5,1,123408,123408,123409,0,1,3
35248,1,2,123409,123409,123411,0,2,0
35249,3,3,123412,123412,123415,0,3,1
35250,3,3,123415,123415,123418,0,3,0
35251,3,3,123418,123418,123421,0,3,0
35252,5,1,123423,123423,123424,0,1,2
35253,5,2,123428,123428,123430,0,2,4
35254,3,3,123431,123431,123434,0,3,1
35255,6,1,123437,123437,123438,0,1,3
35256,6,1,123443,123443,123444,0,1,5
35257,1,2,123444,123444,123446,0,2,0
35258,4,2,123448,123448,123450,0,2,2
35259,2,1,123450,123450,123451,0,1,0
35260,6,1,123456,123456,123457,0,1,5
35261,3,3,123459,123459,123462,0,3,2
35262,2,3,123461,123462,123465,1,4,0
35263,5,1,123466,123466,123467,0,1,1
35264,5,3,123471,123471,123474,0,3,4
35265,2,3,123473,123474,123477,1,4,0
35266,2,1,123475,123477,123478,2,3,0
35267,3,1,123478,123478,123479,0,1,0
35268,1,1,123479,123479,123480,0,1,0
35269,5,2,123484,123484,123486,0,2,4
35270,2,1,123486,123486,123487,0,1,0
35271,2,3,123488,123488,123491,0,3,1
35272,5,1,123493,123493,123494,0,1,2
35273,3,1,123496,123496,123497,0,1,2
35274,6,3,123502,123502,123505,0,3,5
35275,5,1,123507,123507,123508,0,1,2
35276,1,3,123508,123508,123511,0,3,0
35277,1,2,123509,123511,123513,2,4,0
35278,6,1,123515,123515,123516,0,1,2
35279,5,2,123520,123520,123522,0,2,4
35280,1,3,123521,123522,123525,1,4,0
35281,3,1,123524,123525,123526,1,2,0
35282,1,2,123525,123526,123528,1,3,0
35283,3,2,123528,123528,123530,0,2,0
35284,6,3,123534,123534,123537,0,3,4
35285,5,3,123539,123539,123542,0,3,2
35286,1,1,123540,123542,123543,2,3,0
35287,4,1,123544,123544,123545,0,1,1
35288,6,2,123550,123550,123552,0,2,5
35289,3,3,123553,123553,123556,0,3,1
35290,3,3,123556,123556,123559,0,3,0
35291,5,2,123561,123561,123563,0,2,2
35292,5,3,123566,123566,123569,0,3,3
35293,5,2,123571,123571,123573,0,2,2
35294,2,1,123573,123573,123574,0,1,0
35295,2,3,123575,123575,123578,0,3,1
35296,4,1,123579,123579,123580,0,1,1
35297,6,3,123585,123585,123588,0,3,5
35298,4,2,123589,123589,123591,0,2,1
35299,5,1,123594,123594,123595,0,1,3
35300,4,1,123598,123598,123599,0,1,3
35301,6,2,123604,123604,123606,0,2,5
35302,4,2,123608,123608,123610,0,2,2
35303,2,2,123610,123610,123612,0,2,0
35304,2,2,123612,123612,123614,0,2,0
35305,2,1,123614,123614,123615,0,1,0
35306,5,1,123619,123619,123620,0,1,4
35307,2,1,123621,123621,123622,0,1,1
35308,3,2,123624,123624,123626,0,2,2
35309,2,2,123626,123626,123628,0,2,0
35310,4,3,123630,123630,123633,0,3,2
35311,5,2,123635,123635,123637,0,2,2
35312,2,2,123637,123637,123639,0,2,0
35313,4,1,123641,123641,123642,0,1,2
35314,6,2,123647,123647,123649,0,2,5
35315,2,2,123649,123649,123651,0,2,0
35316,3,2,123652,123652,123654,0,2,1
35317,5,1,123657,123657,123658,0,1,3
35318,6,2,123663,123663,123665,0,2,5
35319,6,3,123669,123669,123672,0,3,4
35320,4,2,123673,123673,123675,0,2,1
35321,4,2,123677,123677,123679,0,2,2
35322,5,1,123682,123682,123683,0,1,3
35323,1,2,123683,123683,123685,0,2,0
35324,1,2,123684,123685,123687,1,3,0
35325,1,2,123685,123687,123689,2,4,0
35326,1,2,123686,123689,123691,3,5,0
35327,6,1,123692,123692,123693,0,1,1
35328,5,3,123697,123697,123700,0,3,4
35329,1,1,123698,123700,123701,2,3,0
35330,5,2,123703,123703,123705,0,2,2
35331,1,1,123704,123705,123706,1,2,0
35332,3,3,123707,123707,123710,0,3,1
35333,5,3,123712,123712,123715,0,3,2
35334,3,2,123715,123715,123717,0,2,0
35335,1,2,123716,123717,123719,1,3,0
35336,1,1,123717,123719,123720,2,3,0
35337,1,1,123718,123720,123721,2,3,0
35338,6,1,123724,123724,123725,0,1,3
35339,3,2,123727,123727,123729,0,2,2
35340,5,1,123732,123732,123733,0,1,3
35341,5,3,123737,123737,123740,0,3,4
35342,1,2,123738,123740,123742,2,4,0
35343,6,1,123744,123744,123745,0,1,2
35344,4,3,123748,123748,123751,0,3,3
35345,2,2,123750,123751,123753,1,3,0
35346,2,1,123752,123753,123754,1,2,0
35347,4,2,123756,123756,123758,0,2,2
35348,4,2,123760,123760,123762,0,2,2
35349,5,3,123765,123765,123768,0,3,3
35350,6,1,123771,123771,123772,0,1,3
35351,1,2,123772,123772,123774,0,2,0
35352,2,2,123774,123774,123776,0,2,0
35353,5,1,123779,123779,123780,0,1,3
35354,5,1,123784,123784,123785,0,1,4
35355,4,1,123788,123788,123789,0,1,3
35356,2,2,123790,123790,123792,0,2,1
35357,6,1,123796,123796,123797,0,1,4
35358,1,2,123797,123797,123799,0,2,0
35359,4,1,123801,123801,123802,0,1,2
35360,1,2,123802,123802,123804,0,2,0
35361,1,3,123803,123804,123807,1,4,0
35362,2,1,123805,123807,123808,2,3,0
35363,5,1,123810,123810,123811,0,1,2
35364,3,2,123813,123813,123815,0,2,2
35365,4,1,123817,123817,123818,0,1,2
35366,3,1,123820,123820,123821,0,1,2
35367,6,1,123826,123826,123827,0,1,5
35368,6,2,123832,123832,123834,0,2,5
35369,1,2,123833,123834,123836,1,3,0
35370,1,2,123834,123836,123838,2,4,0
35371,4,1,123838,123838,123839,0,1,0
35372,2,1,123840,123840,123841,0,1,1
35373,6,2,123846,123846,123848,0,2,5
35374,6,1,123852,123852,123853,0,1,4
35375,1,2,123853,123853,123855,0,2,0
35376,3,1,123856,123856,123857,0,1,1
35377,4,3,123860,123860,123863,0,3,3
35378,2,2,123862,123863,123865,1,3,0
35379,1,2,123863,123865,123867,2,4,0
35380,3,1,123866,123867,123868,1,2,0
35381,4,2,123870,123870,123872,0,2,2
35382,4,3,123874,123874,123877,0,3,2
35383,5,1,123879,123879,123880,0,1,2
35384,2,3,123881,123881,123884,0,3,1
35385,4,2,123885,123885,123887,0,2,1
35386,1,2,123886,123887,123889,1,3,0
35387,1,2,123887,123889,123891,2,4,0
35388,1,1,123888,123891,123892,3,4,0
35389,5,3,123893,123893,123896,0,3,1
35390,1,1,123894,123896,123897,2,3,0
35391,2,1,123896,123897,123898,1,2,0
35392,3,1,123899,123899,123900,0,1,1
35393,5,3,123904,123904,123907,0,3,4
35394,5,2,123909,123909,123911,0,2,2
35395,5,2,123914,123914,123916,0,2,3
35396,6,1,123920,123920,123921,0,1,4
35397,5,2,123925,123925,123927,0,2,4
35398,1,3,123926,123927,123930,1,4,0
35399,5,2,123931,123931,123933,0,2,1
35400,1,2,123932,123933,123935,1,3,0
35401,2,2,123934,123935,123937,1,3,0
35402,3,2,123937,123937,123939,0,2,0
35403,4,1,123941,123941,123942,0,1,2
35404,1,1,123942,123942,123943,0,1,0
35405,1,1,123943,123943,123944,0,1,0
35406,5,1,123948,123948,123949,0,1,4
35407,4,2,123952,123952,123954,0,2,3
35408,2,1,123954,123954,123955,0,1,0
35409,5,2,123959,123959,123961,0,2,4
35410,1,1,123960,123961,123962,1,2,0
35411,3,1,123963,123963,123964,0,1,1
35412,5,1,123968,123968,123969,0,1,4
35413,1,3,123969,123969,123972,0,3,0
35414,6,1,123975,123975,123976,0,1,3
35415,6,2,123981,123981,123983,0,2,5
35416,2,1,123983,123983,123984,0,1,0
35417,1,3,123984,123984,123987,0,3,0
35418,6,1,123990,123990,123991,0,1,3
35419,4,3,123994,123994,123997,0,3,3
35420,3,1,123997,123997,123998,0,1,0
35421,3,2,124000,124000,124002,0,2,2
35422,5,2,124005,124005,124007,0,2,3
35423,3,2,124008,124008,124010,0,2,1
35424,6,1,124014,124014,124015,0,1,4
35425,3,2,124017,124017,124019,0,2,2
35426,6,3,124023,124023,124026,0,3,4
35427,3,1,124026,124026,124027,0,1,0
35428,1,3,124027,124027,124030,0,3,0
35429,3,3,124030,124030,124033,0,3,0
35430,5,1,124035,124035,124036,0,1,2
35431,6,1,124041,124041,124042,0,1,5
35432,6,3,124047,124047,124050,0,3,5
35433,1,2,124048,124050,124052,2,4,0
35434,5,3,124053,124053,124056,0,3,1
35435,1,3,124054,124056,124059,2,5,0
35436,4,1,124058,124059,124060,1,2,0
35437,6,2,124064,124064,124066,0,2,4
35438,2,1,124066,124066,124067,0,1,0
35439,3,3,124069,124069,124072,0,3,2
35440,2,3,124071,124072,124075,1,4,0
35441,5,2,124076,124076,124078,0,2,1
35442,4,1,124080,124080,124081,0,1,2
35443,2,3,124082,124082,124085,0,3,1
35444,1,2,124083,124085,124087,2,4,0
35445,6,1,124089,124089,124090,0,1,2
35446,2,3,124091,124091,124094,0,3,1
35447,2,2,124093,124094,124096,1,3,0
35448,4,2,124097,124097,124099,0,2,1
35449,2,1,124099,124099,124100,0,1,0
35450,5,3,124104,124104,124107,0,3,4
35451,6,2,124110,124110,124112,0,2,3
35452,3,3,124113,124113,124116,0,3,1
35453,3,1,124116,124116,124117,0,1,0
35454,1,2,124117,124117,124119,0,2,0
35455,3,3,124120,124120,124123,0,3,1
35456,2,3,124122,124123,124126,1,4,0
35457,3,2,124125,124126,124128,1,3,0
35458,2,3,124127,124128,124131,1,4,0
35459,5,3,124132,124132,124135,0,3,1
35460,2,3,124134,124135,124138,1,4,0
35461,1,2,124135,124138,124140,3,5,0
35462,2,1,124137,124140,124141,3,4,0
35463,3,3,124140,124141,124144,1,4,0
35464,6,1,124146,124146,124147,0,1,2
35465,1,2,124147,124147,124149,0,2,0
35466,5,2,124152,124152,124154,0,2,3
35467,5,2,124157,124157,124159,0,2,3
35468,4,3,124161,124161,124164,0,3,2
35469,1,3,124162,124164,124167,2,5,0
35470,3,1,124165,124167,124168,2,3,0
35471,2,3,124167,124168,124171,1,4,0
35472,1,2,124168,124171,124173,3,5,0
35473,5,3,124173,124173,124176,0,3,0
35474,1,3,124174,124176,124179,2,5,0
35475,3,2,124177,124179,124181,2,4,0
35476,4,1,124181,124181,124182,0,1,0
35477,5,3,124186,124186,124189,0,3,4
35478,4,1,124190,124190,124191,0,1,1
35479,2,3,124192,124192,124195,0,3,1
35480,6,3,124198,124198,124201,0,3,3
35481,6,3,124204,124204,124207,0,3,3
35482,3,2,124207,124207,124209,0,2,0
35483,1,2,124208,124209,124211,1,3,0
35484,2,1,124210,124211,124212,1,2,0
35485,2,3,124212,124212,124215,0,3,0
35486,6,1,124218,124218,124219,0,1,3
35487,4,1,124222,124222,124223,0,1,3
35488,2,3,124224,124224,124227,0,3,1
35489,6,3,124230,124230,124233,0,3,3
35490,5,1,124235,124235,124236,0,1,2
35491,6,1,124241,124241,124242,0,1,5
35492,4,2,124245,124245,124247,0,2,3
35493,3,3,124248,124248,124251,0,3,1
35494,6,1,124254,124254,124255,0,1,3
35495,2,2,124256,124256,124258,0,2,1
35496,3,1,124259,124259,124260,0,1,1
35497,6,3,124265,124265,124268,0,3,5
35498,6,3,124271,124271,124274,0,3,3
35499,6,2,124277,124277,124279,0,2,3
35500,2,2,124279,124279,124281,0,2,0
35501,6,2,124285,124285,124287,0,2,4
35502,3,2,124288,124288,124290,0,2,1
35503,3,1,124291,124291,124292,0,1,1
35504,3,3,124294,124294,124297,0,3,2
35505,1,2,124295,124297,124299,2,4,0
35506,1,2,124296,124299,124301,3,5,0
35507,6,2,124302,124302,124304,0,2,1
35508,2,1,124304,124304,124305,0,1,0
35509,5,1,124309,124309,124310,0,1,4
35510,5,2,124314,124314,124316,0,2,4
35511,3,1,124317,124317,124318,0,1,1
35512,4,3,124321,124321,124324,0,3,3
35513,6,1,124327,124327,124328,0,1,3
35514,2,3,124329,124329,124332,0,3,1
35515,6,3,124335,124335,124338,0,3,3
35516,4,2,124339,124339,124341,0,2,1
35517,6,1,124345,124345,124346,0,1,4
35518,3,2,124348,124348,124350,0,2,2
35519,4,3,124352,124352,124355,0,3,2
35520,2,2,124354,124355,124357,1,3,0
35521,5,3,124359,124359,124362,0,3,2
35522,5,3,124364,124364,124367,0,3,2
35523,2,3,124366,124367,124370,1,4,0
35524,6,1,124372,124372,124373,0,1,2
35525,5,1,124377,124377,124378,0,1,4
35526,4,3,124381,124381,124384,0,3,3
35527,2,2,124383,124384,124386,1,3,0
35528,5,1,124388,124388,124389,0,1,2
35529,4,1,124392,124392,124393,0,1,3
35530,5,3,124397,124397,124400,0,3,4
35531,3,1,124400,124400,124401,0,1,0
35532,3,1,124403,124403,124404,0,1,2
35533,3,1,124406,124406,124407,0,1,2
35534,3,2,124409,124409,124411,0,2,2
35535,6,3,124415,124415,124418,0,3,4
35536,6,2,124421,124421,124423,0,2,3
35537,4,3,124425,124425,124428,0,3,2
35538,1,1,124426,124428,124429,2,3,0
35539,2,1,124428,124429,124430,1,2,0
35540,5,3,124433,124433,124436,0,3,3
35541,1,1,124434,124436,124437,2,3,0
35542,1,1,124435,124437,124438,2,3,0
35543,2,1,124437,124438,124439,1,2,0
35544,2,2,124439,124439,124441,0,2,0
35545,5,3,124444,124444,124447,0,3,3
35546,2,1,124446,124447,124448,1,2,0
35547,3,3,124449,124449,124452,0,3,1
35548,6,1,124455,124455,124456,0,1,3
35549,6,1,124461,124461,124462,0,1,5
35550,3,3,124464,124464,124467,0,3,2
35551,2,1,124466,124467,124468,1,2,0
35552,3,3,124469,124469,124472,0,3,1
35553,5,2,124474,124474,124476,0,2,2
35554,1,1,124475,124476,124477,1,2,0
35555,3,2,124478,124478,124480,0,2,1
35556,1,2,124479,124480,124482,1,3,0
35557,1,2,124480,124482,124484,2,4,0
35558,2,3,124482,124484,124487,2,5,0
35559,1,3,124483,124487,124490,4,7,0
35560,3,1,124486,124490,124491,4,5,0
35561,5,3,124491,124491,124494,0,3,0
35562,6,2,124497,124497,124499,0,2,3
35563,3,2,124500,124500,124502,0,2,1
35564,3,2,124503,124503,124505,0,2,1
35565,5,2,124508,124508,124510,0,2,3
35566,4,2,124512,124512,124514,0,2,2
35567,6,1,124518,124518,124519,0,1,4
35568,6,1,124524,124524,124525,0,1,5
35569,2,2,124526,124526,124528,0,2,1
35570,4,3,124530,124530,124533,0,3,2
35571,5,2,124535,124535,124537,0,2,2
35572,4,3,124539,124539,124542,0,3,2
35573,6,2,124545,124545,124547,0,2,3
35574,2,2,124547,124547,124549,0,2,0
35575,5,2,124552,124552,124554,0,2,3
35576,6,2,124558,124558,124560,0,2,4
35577,4,3,124562,124562,124565,0,3,2
35578,1,2,124563,124565,124567,2,4,0
35579,6,1,124569,124569,124570,0,1,2
35580,3,1,124572,124572,124573,0,1,2
35581,4,2,124576,124576,124578,0,2,3
35582,3,1,124579,124579,124580,0,1,1
35583,6,3,124585,124585,124588,0,3,5
35584,1,1,124586,124588,124589,2,3,0
35585,4,3,124590,124590,124593,0,3,1
35586,1,2,124591,124593,124595,2,4,0
35587,3,1,124594,124595,124596,1,2,0
35588,4,1,124598,124598,124599,0,1,2
35589,2,1,124600,124600,124601,0,1,1
35590,5,2,124605,124605,124607,0,2,4
35591,3,1,124608,124608,124609,0,1,1
35592,6,1,124614,124614,124615,0,1,5
35593,5,1,124619,124619,124620,0,1,4
35594,3,2,124622,124622,124624,0,2,2
35595,6,2,124628,124628,124630,0,2,4
35596,6,1,124634,124634,124635,0,1,4
35597,1,3,124635,124635,124638,0,3,0
35598,4,3,124639,124639,124642,0,3,1
35599,3,2,124642,124642,124644,0,2,0
35600,1,2,124643,124644,124646,1,3,0
35601,3,1,124646,124646,124647,0,1,0
35602,5,1,124651,124651,124652,0,1,4
35603,5,1,124656,124656,124657,0,1,4
35604,5,1,124661,124661,124662,0,1,4
35605,5,3,124666,124666,124669,0,3,4
35606,2,3,124668,124669,124672,1,4,0
35607,2,3,124670,124672,124675,2,5,0
35608,4,2,124674,124675,124677,1,3,0
35609,6,3,124680,124680,124683,0,3,3
35610,3,2,124683,124683,124685,0,2,0
35611,3,1,124686,124686,124687,0,1,1
35612,6,1,124692,124692,124693,0,1,5
35613,3,3,124695,124695,124698,0,3,2
35614,4,2,124699,124699,124701,0,2,1
35615,3,3,124702,124702,124705,0,3,1
35616,3,3,124705,124705,124708,0,3,0
35617,1,2,124706,124708,124710,2,4,0
35618,1,3,124707,124710,124713,3,6,0
35619,5,2,124712,124713,124715,1,3,0
35620,4,3,124716,124716,124719,0,3,1
35621,1,3,124717,124719,124722,2,5,0
35622,3,2,124720,124722,124724,2,4,0
35623,3,3,124723,124724,124727,1,4,0
35624,2,3,124725,124727,124730,2,5,0
35625,4,2,124729,124730,124732,1,3,0
35626,4,1,124733,124733,124734,0,1,1
35627,3,1,124736,124736,124737,0,1,2
35628,5,3,124741,124741,124744,0,3,4
35629,4,3,124745,124745,124748,0,3,1
35630,2,2,124747,124748,124750,1,3,0
35631,5,2,124752,124752,124754,0,2,2
35632,4,1,124756,124756,124757,0,1,2
35633,4,1,124760,124760,124761,0,1,3
35634,3,2,124763,124763,124765,0,2,2
35635,3,1,124766,124766,124767,0,1,1
35636,3,3,124769,124769,124772,0,3,2
35637,5,2,124774,124774,124776,0,2,2
35638,6,1,124780,124780,124781,0,1,4
35639,6,1,124786,124786,124787,0,1,5
35640,1,3,124787,124787,124790,0,3,0
35641,1,1,124788,124790,124791,2,3,0
35642,1,1,124789,124791,124792,2,3,0
35643,4,1,124793,124793,124794,0,1,1
35644,2,1,124795,124795,124796,0,1,1
35645,3,3,124798,124798,124801,0,3,2
35646,2,1,124800,124801,124802,1,2,0
35647,1,3,124801,124802,124805,1,4,0
35648,4,2,124805,124805,124807,0,2,0
35649,5,3,124810,124810,124813,0,3,3
35650,5,2,124815,124815,124817,0,2,2
35651,2,2,124817,124817,124819,0,2,0
35652,4,2,124821,124821,124823,0,2,2
35653,2,1,124823,124823,124824,0,1,0
35654,4,1,124827,124827,124828,0,1,3
35655,1,3,124828,124828,124831,0,3,0
35656,5,3,124833,124833,124836,0,3,2
35657,1,2,124834,124836,124838,2,4,0
35658,1,1,124835,124838,124839,3,4,0
35659,4,2,124839,124839,124841,0,2,0
35660,2,2,124841,124841,124843,0,2,0
35661,4,1,124845,124845,124846,0,1,2
35662,5,2,124850,124850,124852,0,2,4
35663,6,2,124856,124856,124858,0,2,4
35664,3,3,124859,124859,124862,0,3,1
35665,3,1,124862,124862,124863,0,1,0
35666,6,1,124868,124868,124869,0,1,5
35667,3,3,124871,124871,124874,0,3,2
35668,3,1,124874,124874,124875,0,1,0
35669,2,2,124876,124876,124878,0,2,1
35670,4,1,124880,124880,124881,0,1,2
35671,2,1,124882,124882,124883,0,1,1
35672,4,3,124886,124886,124889,0,3,3
35673,5,3,124891,124891,124894,0,3,2
35674,1,2,124892,124894,124896,2,4,0
35675,1,1,124893,124896,124897,3,4,0
35676,6,3,124899,124899,124902,0,3,2
35677,5,3,124904,124904,124907,0,3,2
35678,2,1,124906,124907,124908,1,2,0
35679,2,2,124908,124908,124910,0,2,0
35680,1,1,124909,124910,124911,1,2,0
35681,1,2,124910,124911,124913,1,3,0
35682,4,3,124914,124914,124917,0,3,1
35683,6,1,124920,124920,124921,0,1,3
35684,6,1,124926,124926,124927,0,1,5
35685,2,1,124928,124928,124929,0,1,1
35686,5,2,124933,124933,124935,0,2,4
35687,6,3,124939,124939,124942,0,3,4
35688,5,2,124944,124944,124946,0,2,2
35689,5,1,124949,124949,124950,0,1,3
35690,1,2,124950,124950,124952,0,2,0
35691,2,2,124952,124952,124954,0,2,0
35692,5,3,124957,124957,124960,0,3,3
35693,1,2,124958,124960,124962,2,4,0
35694,3,2,124961,124962,124964,1,3,0
35695,6,1,124967,124967,124968,0,1,3
35696,4,1,124971,124971,124972,0,1,3
35697,4,2,124975,124975,124977,0,2,3
35698,4,1,124979,124979,124980,0,1,2
35699,5,2,124984,124984,124986,0,2,4
35700,1,2,124985,124986,124988,1,3,0
35701,1,1,124986,124988,124989,2,3,0
35702,6,3,124992,124992,124995,0,3,3
35703,6,3,124998,124998,125001,0,3,3
35704,5,2,125003,125003,125005,0,2,2
35705,3,2,125006,125006,125008,0,2,1
35706,3,3,125009,125009,125012,0,3,1
35707,1,3,125010,125012,125015,2,5,0
35708,1,3,125011,125015,125018,4,7,0
35709,6,2,125017,125018,125020,1,3,0
35710,6,3,125023,125023,125026,0,3,3
35711,2,2,125025,125026,125028,1,3,0
35712,3,3,125028,125028,125031,0,3,0
35713,1,1,125029,125031,125032,2,3,0
35714,1,3,125030,125032,125035,2,5,0
35715,2,2,125032,125035,125037,3,5,0
35716,1,3,125033,125037,125040,4,7,0
35717,4,3,125037,125040,125043,3,6,0
35718,6,2,125043,125043,125045,0,2,0
35719,3,2,125046,125046,125048,0,2,1
35720,4,2,125050,125050,125052,0,2,2
35721,1,3,125051,125052,125055,1,4,0
35722,2,3,125053,125055,125058,2,5,0
35723,6,3,125059,125059,125062,0,3,1
35724,3,1,125062,125062,125063,0,1,0
35725,4,1,125066,125066,125067,0,1,3
35726,1,3,125067,125067,125070,0,3,0
35727,4,1,125071,125071,125072,0,1,1
35728,2,1,125073,125073,125074,0,1,1
35729,5,1,125078,125078,125079,0,1,4
35730,4,3,125082,125082,125085,0,3,3
35731,6,2,125088,125088,125090,0,2,3
35732,6,1,125094,125094,125095,0,1,4
35733,4,3,125098,125098,125101,0,3,3
35734,6,2,125104,125104,125106,0,2,3
35735,6,3,125110,125110,125113,0,3,4
35736,5,1,125115,125115,125116,0,1,2
35737,2,2,125117,125117,125119,0,2,1
35738,5,2,125122,125122,125124,0,2,3
35739,3,3,125125,125125,125128,0,3,1
35740,3,1,125128,125128,125129,0,1,0
35741,6,3,125134,125134,125137,0,3,5
35742,3,1,125137,125137,125138,0,1,0
35743,1,1,125138,125138,125139,0,1,0
35744,2,2,125140,125140,125142,0,2,1
35745,5,1,125145,125145,125146,0,1,3
35746,5,1,125150,125150,125151,0,1,4
35747,1,3,125151,125151,125154,0,3,0
35748,3,3,125154,125154,125157,0,3,0
35749,6,1,125160,125160,125161,0,1,3
35750,4,2,125164,125164,125166,0,2,3
35751,4,3,125168,125168,125171,0,3,2
35752,1,2,125169,125171,125173,2,4,0
35753,5,1,125174,125174,125175,0,1,1
35754,3,1,125177,125177,125178,0,1,2
35755,1,3,125178,125178,125181,0,3,0
35756,3,1,125181,125181,125182,0,1,0
35757,4,2,125185,125185,125187,0,2,3
35758,4,1,125189,125189,125190,0,1,2
35759,5,3,125194,125194,125197,0,3,4
35760,6,2,125200,125200,125202,0,2,3
35761,6,1,125206,125206,125207,0,1,4
35762,5,3,125211,125211,125214,0,3,4
35763,5,2,125216,125216,125218,0,2,2
35764,1,1,125217,125218,125219,1,2,0
35765,2,2,125219,125219,125221,0,2,0
35766,4,3,125223,125223,125226,0,3,2
35767,6,1,125229,125229,125230,0,1,3
35768,1,2,125230,125230,125232,0,2,0
35769,2,2,125232,125232,125234,0,2,0
35770,3,3,125235,125235,125238,0,3,1
35771,6,1,125241,125241,125242,0,1,3
35772,2,2,125243,125243,125245,0,2,1
35773,4,3,125247,125247,125250,0,3,2
35774,2,2,125249,125250,125252,1,3,0
35775,2,2,125251,125252,125254,1,3,0
35776,3,1,125254,125254,125255,0,1,0
35777,3,1,125257,125257,125258,0,1,2
35778,5,1,125262,125262,125263,0,1,4
35779,2,1,125264,125264,125265,0,1,1
35780,3,2,125267,125267,125269,0,2,2
35781,3,2,125270,125270,125272,0,2,1
35782,6,2,125276,125276,125278,0,2,4
35783,2,1,125278,125278,125279,0,1,0
35784,2,1,125280,125280,125281,0,1,1
35785,4,1,125284,125284,125285,0,1,3
35786,1,2,125285,125285,125287,0,2,0
35787,4,2,125289,125289,125291,0,2,2
35788,4,1,125293,125293,125294,0,1,2
35789,3,1,125296,125296,125297,0,1,2
35790,4,2,125300,125300,125302,0,2,3
35791,3,2,125303,125303,125305,0,2,1
35792,2,3,125305,125305,125308,0,3,0
35793,2,3,125307,125308,125311,1,4,0
35794,4,2,125311,125311,125313,0,2,0
35795,3,3,125314,125314,125317,0,3,1
35796,3,2,125317,125317,125319,0,2,0
35797,1,2,125318,125319,125321,1,3,0
35798,4,1,125322,125322,125323,0,1,1
35799,5,2,125327,125327,125329,0,2,4
35800,5,1,125332,125332,125333,0,1,3
35801,3,3,125335,125335,125338,0,3,2
35802,6,2,125341,125341,125343,0,2,3
35803,6,1,125347,125347,125348,0,1,4
35804,5,3,125352,125352,125355,0,3,4
35805,1,1,125353,125355,125356,2,3,0
35806,1,3,125354,125356,125359,2,5,0
35807,4,1,125358,125359,125360,1,2,0
35808,1,2,125359,125360,125362,1,3,0
35809,1,1,125360,125362,125363,2,3,0
35810,4,3,125364,125364,125367,0,3,1
35811,4,1,125368,125368,125369,0,1,1
35812,1,2,125369,125369,125371,0,2,0
35813,2,2,125371,125371,125373,0,2,0
35814,6,1,125377,125377,125378,0,1,4
35815,3,1,125380,125380,125381,0,1,2
35816,4,1,125384,125384,125385,0,1,3
35817,1,3,125385,125385,125388,0,3,0
35818,3,1,125388,125388,125389,0,1,0
35819,2,2,125390,125390,125392,0,2,1
35820,6,3,125396,125396,125399,0,3,4
35821,6,2,125402,125402,125404,0,2,3
35822,6,2,125408,125408,125410,0,2,4
35823,2,3,125410,125410,125413,0,3,0
35824,2,2,125412,125413,125415,1,3,0
35825,6,1,125418,125418,125419,0,1,3
35826,3,2,125421,125421,125423,0,2,2
35827,5,3,125426,125426,125429,0,3,3
35828,4,2,125430,125430,125432,0,2,1
35829,1,3,125431,125432,125435,1,4,0
35830,3,3,125434,125435,125438,1,4,0
35831,3,2,125437,125438,125440,1,3,0
35832,1,3,125438,125440,125443,2,5,0
35833,2,1,125440,125443,125444,3,4,0
35834,2,1,125442,125444,125445,2,3,0
35835,5,2,125447,125447,125449,0,2,2
35836,3,2,125450,125450,125452,0,2,1
35837,6,3,125456,125456,125459,0,3,4
35838,6,1,125462,125462,125463,0,1,3
35839,1,3,125463,125463,125466,0,3,0
35840,3,3,125466,125466,125469,0,3,0
35841,1,1,125467,125469,125470,2,3,0
35842,3,2,125470,125470,125472,0,2,0
35843,1,3,125471,125472,125475,1,4,0
35844,4,1,125475,125475,125476,0,1,0
35845,5,1,125480,125480,125481,0,1,4
35846,5,1,125485,125485,125486,0,1,4
35847,2,1,125487,125487,125488,0,1,1
35848,6,3,125493,125493,125496,0,3,5
35849,3,2,125496,125496,125498,0,2,0
35850,2,3,125498,125498,125501,0,3,0
35851,5,2,125503,125503,125505,0,2,2
35852,2,3,125505,125505,125508,0,3,0
35853,6,3,125511,125511,125514,0,3,3
35854,6,2,125517,125517,125519,0,2,3
35855,4,1,125521,125521,125522,0,1,2
35856,6,1,125527,125527,125528,0,1,5
35857,3,3,125530,125530,125533,0,3,2
35858,5,1,125535,125535,125536,0,1,2
35859,6,3,125541,125541,125544,0,3,5
35860,6,3,125547,125547,125550,0,3,3
35861,3,3,125550,125550,125553,0,3,0
35862,1,3,125551,125553,125556,2,5,0
35863,4,1,125555,125556,125557,1,2,0
35864,5,1,125560,125560,125561,0,1,3
35865,5,1,125565,125565,125566,0,1,4
35866,2,1,125567,125567,125568,0,1,1
35867,1,1,125568,125568,125569,0,1,0
35868,3,3,125571,125571,125574,0,3,2
35869,5,3,125576,125576,125579,0,3,2
35870,2,1,125578,125579,125580,1,2,0
35871,1,3,125579,125580,125583,1,4,0
35872,6,3,125585,125585,125588,0,3,2
35873,6,2,125591,125591,125593,0,2,3
35874,3,1,125594,125594,125595,0,1,1
35875,1,3,125595,125595,125598,0,3,0
35876,6,3,125601,125601,125604,0,3,3
35877,2,2,125603,125604,125606,1,3,0
35878,1,2,125604,125606,125608,2,4,0
35879,2,3,125606,125608,125611,2,5,0
35880,2,2,125608,125611,125613,3,5,0
35881,1,1,125609,125613,125614,4,5,0
35882,4,2,125613,125614,125616,1,3,0
35883,5,3,125618,125618,125621,0,3,2
35884,3,3,125621,125621,125624,0,3,0
35885,5,1,125626,125626,125627,0,1,2
35886,3,3,125629,125629,125632,0,3,2
35887,2,1,125631,125632,125633,1,2,0
35888,6,3,125637,125637,125640,0,3,4
35889,4,1,125641,125641,125642,0,1,1
35890,3,2,125644,125644,125646,0,2,2
35891,1,2,125645,125646,125648,1,3,0
35892,3,2,125648,125648,125650,0,2,0
35893,5,1,125653,125653,125654,0,1,3
35894,3,3,125656,125656,125659,0,3,2
35895,2,2,125658,125659,125661,1,3,0
35896,5,2,125663,125663,125665,0,2,2
35897,1,3,125664,125665,125668,1,4,0
35898,1,1,125665,125668,125669,3,4,0
35899,1,2,125666,125669,125671,3,5,0
35900,1,3,125667,125671,125674,4,7,0
35901,2,1,125669,125674,125675,5,6,0
35902,5,3,125674,125675,125678,1,4,0
35903,6,2,125680,125680,125682,0,2,2
35904,2,3,125682,125682,125685,0,3,0
35905,6,1,125688,125688,125689,0,1,3
35906,5,1,125693,125693,125694,0,1,4
35907,4,1,125697,125697,125698,0,1,3
35908,2,1,125699,125699,125700,0,1,1
35909,2,1,125701,125701,125702,0,1,1
35910,4,2,125705,125705,125707,0,2,3
35911,5,3,125710,125710,125713,0,3,3
35912,4,2,125714,125714,125716,0,2,1
35913,6,2,125720,125720,125722,0,2,4
35914,6,2,125726,125726,125728,0,2,4
35915,4,1,125730,125730,125731,0,1,2
35916,6,1,125736,125736,125737,0,1,5
35917,3,3,125739,125739,125742,0,3,2
35918,2,1,125741,125742,125743,1,2,0
35919,1,3,125742,125743,125746,1,4,0
35920,3,3,125745,125746,125749,1,4,0
35921,5,2,125750,125750,125752,0,2,1
35922,5,1,125755,125755,125756,0,1,3
35923,6,1,125761,125761,125762,0,1,5
35924,2,1,125763,125763,125764,0,1,1
35925,2,1,125765,125765,125766,0,1,1
35926,2,1,125767,125767,125768,0,1,1
35927,6,1,125773,125773,125774,0,1,5
35928,3,2,125776,125776,125778,0,2,2
35929,2,3,125778,125778,125781,0,3,0
35930,6,1,125784,125784,125785,0,1,3
35931,5,1,125789,125789,125790,0,1,4
35932,4,1,125793,125793,125794,0,1,3
35933,4,1,125797,125797,125798,0,1,3
35934,5,2,125802,125802,125804,0,2,4
35935,3,1,125805,125805,125806,0,1,1
35936,1,3,125806,125806,125809,0,3,0
35937,2,3,125808,125809,125812,1,4,0
35938,1,3,125809,125812,125815,3,6,0
35939,2,3,125811,125815,125818,4,7,0
35940,1,3,125812,125818,125821,6,9,0
35941,6,1,125818,125821,125822,3,4,0
35942,1,1,125819,125822,125823,3,4,0
35943,4,3,125823,125823,125826,0,3,0
35944,5,3,125828,125828,125831,0,3,2
35945,1,3,125829,125831,125834,2,5,0
35946,1,2,125830,125834,125836,4,6,0
35947,3,3,125833,125836,125839,3,6,0
35948,5,1,125838,125839,125840,1,2,0
35949,5,1,125843,125843,125844,0,1,3
35950,5,1,125848,125848,125849,0,1,4
35951,3,3,125851,125851,125854,0,3,2
35952,1,2,125852,125854,125856,2,4,0
35953,1,1,125853,125856,125857,3,4,0
35954,5,1,125858,125858,125859,0,1,1
35955,1,2,125859,125859,125861,0,2,0
35956,6,2,125865,125865,125867,0,2,4
35957,6,3,125871,125871,125874,0,3,4
35958,1,2,125872,125874,125876,2,4,0
35959,1,2,125873,125876,125878,3,5,0
35960,2,3,125875,125878,125881,3,6,0
35961,6,2,125881,125881,125883,0,2,0
35962,5,1,125886,125886,125887,0,1,3
35963,2,3,125888,125888,125891,0,3,1
35964,4,2,125892,125892,125894,0,2,1
35965,1,1,125893,125894,125895,1,2,0
35966,6,2,125899,125899,125901,0,2,4
35967,3,2,125902,125902,125904,0,2,1
35968,3,2,125905,125905,125907,0,2,1
35969,6,3,125911,125911,125914,0,3,4
35970,1,2,125912,125914,125916,2,4,0
35971,3,3,125915,125916,125919,1,4,0
35972,6,1,125921,125921,125922,0,1,2
35973,6,3,125927,125927,125930,0,3,5
35974,6,1,125933,125933,125934,0,1,3
35975,5,2,125938,125938,125940,0,2,4
35976,1,3,125939,125940,125943,1,4,0
35977,4,2,125943,125943,125945,0,2,0
35978,2,3,125945,125945,125948,0,3,0
35979,2,3,125947,125948,125951,1,4,0
35980,4,1,125951,125951,125952,0,1,0
35981,2,3,125953,125953,125956,0,3,1
35982,5,1,125958,125958,125959,0,1,2
35983,4,2,125962,125962,125964,0,2,3
35984,5,3,125967,125967,125970,0,3,3
35985,5,3,125972,125972,125975,0,3,2
35986,6,1,125978,125978,125979,0,1,3
35987,5,3,125983,125983,125986,0,3,4
35988,2,2,125985,125986,125988,1,3,0
35989,2,1,125987,125988,125989,1,2,0
35990,6,2,125993,125993,125995,0,2,4
35991,1,2,125994,125995,125997,1,3,0
35992,1,3,125995,125997,126000,2,5,0
35993,6,1,126001,126001,126002,0,1,1
35994,2,3,126003,126003,126006,0,3,1
35995,4,1,126007,126007,126008,0,1,1
35996,4,2,126011,126011,126013,0,2,3
35997,1,2,126012,126013,126015,1,3,0
35998,1,1,126013,126015,126016,2,3,0
35999,6,2,126019,126019,126021,0,2,3
36000,2,1,126021,126021,126022,0,1,0
36001,6,2,126027,126027,126029,0,2,5
36002,4,2,126031,126031,126033,0,2,2
36003,2,2,126033,126033,126035,0,2,0
36004,6,2,126039,126039,126041,0,2,4
36005,6,2,126045,126045,126047,0,2,4
36006,5,2,126050,126050,126052,0,2,3
36007,4,2,126054,126054,126056,0,2,2
36008,2,2,126056,126056,126058,0,2,0
36009,1,1,126057,126058,126059,1,2,0
36010,2,1,126059,126059,126060,0,1,0
36011,1,1,126060,126060,126061,0,1,0
36012,2,3,126062,126062,126065,0,3,1
36013,4,3,126066,126066,126069,0,3,1
36014,6,1,126072,126072,126073,0,1,3
36015,3,2,126075,126075,126077,0,2,2
36016,5,1,126080,126080,126081,0,1,3
36017,1,3,126081,126081,126084,0,3,0
36018,3,2,126084,126084,126086,0,2,0
36019,5,3,126089,126089,126092,0,3,3
36020,6,2,126095,126095,126097,0,2,3
36021,4,3,126099,126099,126102,0,3,2
36022,1,3,126100,126102,126105,2,5,0
36023,3,1,126103,126105,126106,2,3,0
36024,3,1,126106,126106,126107,0,1,0
36025,2,2,126108,126108,126110,0,2,1
36026,3,3,126111,126111,126114,0,3,1
36027,4,3,126115,126115,126118,0,3,1
36028,6,1,126121,126121,126122,0,1,3
36029,6,3,126127,126127,126130,0,3,5
36030,6,1,126133,126133,126134,0,1,3
36031,5,3,126138,126138,126141,0,3,4
36032,1,1,126139,126141,126142,2,3,0
36033,4,3,126143,126143,126146,0,3,1
36034,3,2,126146,126146,126148,0,2,0
36035,6,2,126152,126152,126154,0,2,4
36036,5,1,126157,126157,126158,0,1,3
36037,1,3,126158,126158,126161,0,3,0
36038,3,1,126161,126161,126162,0,1,0
36039,4,3,126165,126165,126168,0,3,3
36040,4,2,126169,126169,126171,0,2,1
36041,4,3,126173,126173,126176,0,3,2
36042,6,1,126179,126179,126180,0,1,3
36043,1,3,126180,126180,126183,0,3,0
36044,6,2,126186,126186,126188,0,2,3
36045,2,2,126188,126188,126190,0,2,0
36046,1,2,126189,126190,126192,1,3,0
36047,3,1,126192,126192,126193,0,1,0
36048,3,3,126195,126195,126198,0,3,2
36049,2,3,126197,126198,126201,1,4,0
36050,3,3,126200,126201,126204,1,4,0
36051,1,2,126201,126204,126206,3,5,0
36052,2,3,126203,126206,126209,3,6,0
36053,2,1,126205,126209,126210,4,5,0
36054,5,1,126210,126210,126211,0,1,0
36055,3,3,126213,126213,126216,0,3,2
36056,2,1,126215,126216,126217,1,2,0
36057,3,3,126218,126218,126221,0,3,1
36058,1,2,126219,126221,126223,2,4,0
36059,3,1,126222,126223,126224,1,2,0
36060,1,1,126223,126224,126225,1,2,0
36061,1,3,126224,126225,126228,1,4,0
36062,4,1,126228,126228,126229,0,1,0
36063,1,2,126229,126229,126231,0,2,0
36064,4,1,126233,126233,126234,0,1,2
36065,2,2,126235,126235,126237,0,2,1
36066,6,3,126241,126241,126244,0,3,4
36067,3,2,126244,126244,126246,0,2,0
36068,5,2,126249,126249,126251,0,2,3
36069,2,1,126251,126251,126252,0,1,0
36070,5,1,126256,126256,126257,0,1,4
36071,4,3,126260,126260,126263,0,3,3
36072,2,1,126262,126263,126264,1,2,0
36073,4,2,126266,126266,126268,0,2,2
36074,1,1,126267,126268,126269,1,2,0
36075,4,3,126271,126271,126274,0,3,2
36076,5,2,126276,126276,126278,0,2,2
36077,2,3,126278,126278,126281,0,3,0
36078,2,2,126280,126281,126283,1,3,0
36079,5,2,126285,126285,126287,0,2,2
36080,2,1,126287,126287,126288,0,1,0
36081,3,1,126290,126290,126291,0,1,2
36082,4,2,126294,126294,126296,0,2,3
36083,1,1,126295,126296,126297,1,2,0
36084,3,3,126298,126298,126301,0,3,1
36085,1,1,126299,126301,126302,2,3,0
36086,2,1,126301,126302,126303,1,2,0
36087,6,3,126307,126307,126310,0,3,4
36088,3,1,126310,126310,126311,0,1,0
36089,4,2,126314,126314,126316,0,2,3
36090,3,1,126317,126317,126318,0,1,1
36091,6,3,126323,126323,126326,0,3,5
36092,1,1,126324,126326,126327,2,3,0
36093,3,2,126327,126327,126329,0,2,0
36094,1,3,126328,126329,126332,1,4,0
36095,1,2,126329,126332,126334,3,5,0
36096,3,1,126332,126334,126335,2,3,0
36097,4,2,126336,126336,126338,0,2,1
36098,1,2,126337,126338,126340,1,3,0
36099,3,2,126340,126340,126342,0,2,0
36100,3,2,126343,126343,126345,0,2,1
36101,1,1,126344,126345,126346,1,2,0
36102,2,2,126346,126346,126348,0,2,0
36103,3,3,126349,126349,126352,0,3,1
36104,5,3,126354,126354,126357,0,3,2
36105,1,2,126355,126357,126359,2,4,0
36106,2,1,126357,126359,126360,2,3,0
36107,5,1,126362,126362,126363,0,1,2
36108,6,1,126368,126368,126369,0,1,5
36109,2,2,126370,126370,126372,0,2,1
36110,4,3,126374,126374,126377,0,3,2
36111,3,2,126377,126377,126379,0,2,0
36112,1,3,126378,126379,126382,1,4,0
36113,5,1,126383,126383,126384,0,1,1
36114,4,3,126387,126387,126390,0,3,3
36115,3,2,126390,126390,126392,0,2,0
36116,3,2,126393,126393,126395,0,2,1
36117,1,2,126394,126395,126397,1,3,0
36118,3,1,126397,126397,126398,0,1,0
36119,4,2,126401,126401,126403,0,2,3
36120,4,2,126405,126405,126407,0,2,2
36121,6,1,126411,126411,126412,0,1,4
36122,5,2,126416,126416,126418,0,2,4
36123,1,3,126417,126418,126421,1,4,0
36124,4,3,126421,126421,126424,0,3,0
36125,6,2,126427,126427,126429,0,2,3
36126,2,3,126429,126429,126432,0,3,0
36127,2,2,126431,126432,126434,1,3,0
36128,5,2,126436,126436,126438,0,2,2
36129,1,2,126437,126438,126440,1,3,0
36130,5,3,126442,126442,126445,0,3,2
36131,1,1,126443,126445,126446,2,3,0
36132,1,3,126444,126446,126449,2,5,0
36133,4,1,126448,126449,126450,1,2,0
36134,5,1,126453,126453,126454,0,1,3
36135,3,2,126456,126456,126458,0,2,2
36136,3,3,126459,126459,126462,0,3,1
36137,5,1,126464,126464,126465,0,1,2
36138,3,2,126467,126467,126469,0,2,2
36139,5,2,126472,126472,126474,0,2,3
36140,6,1,126478,126478,126479,0,1,4
36141,1,3,126479,126479,126482,0,3,0
36142,6,2,126485,126485,126487,0,2,3
36143,5,2,126490,126490,126492,0,2,3
36144,3,3,126493,126493,126496,0,3,1
36145,6,2,126499,126499,126501,0,2,3
36146,1,2,126500,126501,126503,1,3,0
36147,2,3,126502,126503,126506,1,4,0
36148,1,3,126503,126506,126509,3,6,0
36149,4,2,126507,126509,126511,2,4,0
36150,5,3,126512,126512,126515,0,3,1
36151,6,1,126518,126518,126519,0,1,3
36152,3,2,126521,126521,126523,0,2,2
36153,5,2,126526,126526,126528,0,2,3
36154,6,3,126532,126532,126535,0,3,4
36155,2,2,126534,126535,126537,1,3,0
36156,4,3,126538,126538,126541,0,3,1
36157,2,3,126540,126541,126544,1,4,0
36158,4,2,126544,126544,126546,0,2,0
36159,4,3,126548,126548,126551,0,3,2
36160,1,2,126549,126551,126553,2,4,0
36161,5,1,126554,126554,126555,0,1,1
36162,5,2,126559,126559,126561,0,2,4
36163,2,1,126561,126561,126562,0,1,0
36164,6,1,126567,126567,126568,0,1,5
36165,5,1,126572,126572,126573,0,1,4
36166,5,1,126577,126577,126578,0,1,4
36167,2,2,126579,126579,126581,0,2,1
36168,4,3,126583,126583,126586,0,3,2
36169,2,2,126585,126586,126588,1,3,0
36170,2,2,126587,126588,126590,1,3,0
36171,5,3,126592,126592,126595,0,3,2
36172,3,1,126595,126595,126596,0,1,0
36173,6,1,126601,126601,126602,0,1,5
36174,6,2,126607,126607,126609,0,2,5
36175,6,3,126613,126613,126616,0,3,4
36176,6,1,126619,126619,126620,0,1,3
36177,1,3,126620,126620,126623,0,3,0
36178,1,1,126621,126623,126624,2,3,0
36179,3,3,126624,126624,126627,0,3,0
36180,2,1,126626,126627,126628,1,2,0
36181,6,1,126632,126632,126633,0,1,4
36182,6,3,126638,126638,126641,0,3,5
36183,6,3,126644,126644,126647,0,3,3
36184,3,3,126647,126647,126650,0,3,0
36185,6,2,126653,126653,126655,0,2,3
36186,2,2,126655,126655,126657,0,2,0
36187,2,2,126657,126657,126659,0,2,0
36188,1,3,126658,126659,126662,1,4,0
36189,3,2,126661,126662,126664,1,3,0
36190,6,3,126667,126667,126670,0,3,3
36191,5,2,126672,126672,126674,0,2,2
36192,2,1,126674,126674,126675,0,1,0
36193,6,1,126680,126680,126681,0,1,5
36194,4,2,126684,126684,126686,0,2,3
36195,4,3,126688,126688,126691,0,3,2
36196,4,1,126692,126692,126693,0,1,1
36197,3,2,126695,126695,126697,0,2,2
36198,4,3,126699,126699,126702,0,3,2
36199,2,1,126701,126702,126703,1,2,0
36200,2,3,126703,126703,126706,0,3,0
36201,1,3,126704,126706,126709,2,5,0
36202,2,2,126706,126709,126711,3,5,0
36203,6,2,126712,126712,126714,0,2,1
36204,1,1,126713,126714,126715,1,2,0
36205,1,3,126714,126715,126718,1,4,0
36206,3,3,126717,126718,126721,1,4,0
36207,5,1,126722,126722,126723,0,1,1
36208,6,2,126728,126728,126730,0,2,5
36209,3,3,126731,126731,126734,0,3,1
36210,6,3,126737,126737,126740,0,3,3
36211,4,1,126741,126741,126742,0,1,1
36212,6,1,126747,126747,126748,0,1,5
36213,3,2,126750,126750,126752,0,2,2
36214,5,1,126755,126755,126756,0,1,3
36215,6,3,126761,126761,126764,0,3,5
36216,6,1,126767,126767,126768,0,1,3
36217,3,3,126770,126770,126773,0,3,2
36218,2,1,126772,126773,126774,1,2,0
36219,5,2,126777,126777,126779,0,2,3
36220,1,2,126778,126779,126781,1,3,0
36221,3,2,126781,126781,126783,0,2,0
36222,2,1,126783,126783,126784,0,1,0
36223,1,3,126784,126784,126787,0,3,0
36224,2,1,126786,126787,126788,1,2,0
36225,3,1,126789,126789,126790,0,1,1
36226,4,1,126793,126793,126794,0,1,3
36227,4,2,126797,126797,126799,0,2,3
36228,2,3,126799,126799,126802,0,3,0
36229,2,1,126801,126802,126803,1,2,0
36230,2,2,126803,126803,126805,0,2,0
36231,1,2,126804,126805,126807,1,3,0
36232,1,1,126805,126807,126808,2,3,0
36233,5,2,126810,126810,126812,0,2,2
36234,5,2,126815,126815,126817,0,2,3
36235,1,1,126816,126817,126818,1,2,0
36236,1,2,126817,126818,126820,1,3,0
36237,3,3,126820,126820,126823,0,3,0
36238,5,1,126825,126825,126826,0,1,2
36239,6,1,126831,126831,126832,0,1,5
36240,1,1,126832,126832,126833,0,1,0
36241,2,2,126834,126834,126836,0,2,1
36242,1,2,126835,126836,126838,1,3,0
36243,6,1,126841,126841,126842,0,1,3
36244,1,1,126842,126842,126843,0,1,0
36245,3,1,126845,126845,126846,0,1,2
36246,1,2,126846,126846,126848,0,2,0
36247,3,3,126849,126849,126852,0,3,1
36248,3,3,126852,126852,126855,0,3,0
36249,4,1,126856,126856,126857,0,1,1
36250,4,1,126860,126860,126861,0,1,3
36251,6,3,126866,126866,126869,0,3,5
36252,4,2,126870,126870,126872,0,2,1
36253,3,3,126873,126873,126876,0,3,1
36254,4,2,126877,126877,126879,0,2,1
36255,4,3,126881,126881,126884,0,3,2
36256,3,3,126884,126884,126887,0,3,0
36257,2,1,126886,126887,126888,1,2,0
36258,5,2,126891,126891,126893,0,2,3
36259,5,3,126896,126896,126899,0,3,3
36260,1,1,126897,126899,126900,2,3,0
36261,3,2,126900,126900,126902,0,2,0
36262,1,3,126901,126902,126905,1,4,0
36263,5,3,126906,126906,126909,0,3,1
36264,6,2,126912,126912,126914,0,2,3
36265,2,1,126914,126914,126915,0,1,0
36266,6,3,126920,126920,126923,0,3,5
36267,2,2,126922,126923,126925,1,3,0
36268,5,2,126927,126927,126929,0,2,2
36269,6,2,126933,126933,126935,0,2,4
36270,4,2,126937,126937,126939,0,2,2
36271,3,1,126940,126940,126941,0,1,1
36272,6,1,126946,126946,126947,0,1,5
36273,1,3,126947,126947,126950,0,3,0
36274,4,3,126951,126951,126954,0,3,1
36275,5,3,126956,126956,126959,0,3,2
36276,2,1,126958,126959,126960,1,2,0
36277,1,2,126959,126960,126962,1,3,0
36278,1,2,126960,126962,126964,2,4,0
36279,1,1,126961,126964,126965,3,4,0
36280,4,1,126965,126965,126966,0,1,0
36281,5,1,126970,126970,126971,0,1,4
36282,4,1,126974,126974,126975,0,1,3
36283,6,2,126980,126980,126982,0,2,5
36284,4,1,126984,126984,126985,0,1,2
36285,5,2,126989,126989,126991,0,2,4
36286,6,2,126995,126995,126997,0,2,4
36287,6,2,127001,127001,127003,0,2,4
36288,1,3,127002,127003,127006,1,4,0
36289,5,2,127007,127007,127009,0,2,1
36290,2,2,127009,127009,127011,0,2,0
36291,6,1,127015,127015,127016,0,1,4
36292,4,2,127019,127019,127021,0,2,3
36293,6,1,127025,127025,127026,0,1,4
36294,3,2,127028,127028,127030,0,2,2
36295,3,2,127031,127031,127033,0,2,1
36296,2,3,127033,127033,127036,0,3,0
36297,5,2,127038,127038,127040,0,2,2
36298,5,3,127043,127043,127046,0,3,3
36299,6,1,127049,127049,127050,0,1,3
36300,2,2,127051,127051,127053,0,2,1
36301,4,3,127055,127055,127058,0,3,2
36302,5,1,127060,127060,127061,0,1,2
36303,6,3,127066,127066,127069,0,3,5
36304,4,3,127070,127070,127073,0,3,1
36305,6,2,127076,127076,127078,0,2,3
36306,2,2,127078,127078,127080,0,2,0
36307,5,2,127083,127083,127085,0,2,3
36308,4,3,127087,127087,127090,0,3,2
36309,4,3,127091,127091,127094,0,3,1
36310,3,1,127094,127094,127095,0,1,0
36311,3,1,127097,127097,127098,0,1,2
36312,6,3,127103,127103,127106,0,3,5
36313,2,2,127105,127106,127108,1,3,0
36314,4,2,127109,127109,127111,0,2,1
36315,2,2,127111,127111,127113,0,2,0
36316,4,3,127115,127115,127118,0,3,2
36317,4,2,127119,127119,127121,0,2,1
36318,6,1,127125,127125,127126,0,1,4
36319,1,2,127126,127126,127128,0,2,0
36320,6,1,127132,127132,127133,0,1,4
36321,4,2,127136,127136,127138,0,2,3
36322,3,3,127139,127139,127142,0,3,1
36323,5,3,127144,127144,127147,0,3,2
36324,6,3,127150,127150,127153,0,3,3
36325,1,1,127151,127153,127154,2,3,0
36326,6,1,127157,127157,127158,0,1,3
36327,1,2,127158,127158,127160,0,2,0
36328,2,2,127160,127160,127162,0,2,0
36329,1,3,127161,127162,127165,1,4,0
36330,6,2,127167,127167,127169,0,2,2
36331,4,1,127171,127171,127172,0,1,2
36332,2,3,127173,127173,127176,0,3,1
36333,1,1,127174,127176,127177,2,3,0
36334,5,3,127179,127179,127182,0,3,2
36335,6,1,127185,127185,127186,0,1,3
36336,6,1,127191,127191,127192,0,1,5
36337,6,3,127197,127197,127200,0,3,5
36338,4,2,127201,127201,127203,0,2,1
36339,2,3,127203,127203,127206,0,3,0
36340,4,2,127207,127207,127209,0,2,1
36341,1,1,127208,127209,127210,1,2,0
36342,4,2,127212,127212,127214,0,2,2
36343,4,3,127216,127216,127219,0,3,2
36344,3,3,127219,127219,127222,0,3,0
36345,3,2,127222,127222,127224,0,2,0
36346,6,1,127228,127228,127229,0,1,4
36347,2,3,127230,127230,127233,0,3,1
36348,4,3,127234,127234,127237,0,3,1
36349,5,3,127239,127239,127242,0,3,2
36350,5,2,127244,127244,127246,0,2,2
36351,5,1,127249,127249,127250,0,1,3
36352,4,3,127253,127253,127256,0,3,3
36353,4,2,127257,127257,127259,0,2,1
36354,5,1,127262,127262,127263,0,1,3
36355,1,3,127263,127263,127266,0,3,0
36356,6,1,127269,127269,127270,0,1,3
36357,2,1,127271,127271,127272,0,1,1
36358,3,3,127274,127274,127277,0,3,2
36359,3,2,127277,127277,127279,0,2,0
36360,4,1,127281,127281,127282,0,1,2
36361,1,2,127282,127282,127284,0,2,0
36362,6,2,127288,127288,127290,0,2,4
36363,4,3,127292,127292,127295,0,3,2
36364,1,1,127293,127295,127296,2,3,0
36365,3,1,127296,127296,127297,0,1,0
36366,4,2,127300,127300,127302,0,2,3
36367,3,1,127303,127303,127304,0,1,1
36368,6,3,127309,127309,127312,0,3,5
36369,4,2,127313,127313,127315,0,2,1
36370,4,2,127317,127317,127319,0,2,2
36371,4,2,127321,127321,127323,0,2,2
36372,3,1,127324,127324,127325,0,1,1
36373,4,1,127328,127328,127329,0,1,3
36374,4,2,127332,127332,127334,0,2,3
36375,3,2,127335,127335,127337,0,2,1
36376,1,2,127336,127337,127339,1,3,0
36377,3,3,127339,127339,127342,0,3,0
36378,2,3,127341,127342,127345,1,4,0
36379,3,2,127344,127345,127347,1,3,0
36380,2,2,127346,127347,127349,1,3,0
36381,3,1,127349,127349,127350,0,1,0
36382,5,2,127354,127354,127356,0,2,4
36383,6,1,127360,127360,127361,0,1,4
36384,6,3,127366,127366,127369,0,3,5
36385,2,2,127368,127369,127371,1,3,0
36386,6,2,127374,127374,127376,0,2,3
36387,4,2,127378,127378,127380,0,2,2
36388,3,1,127381,127381,127382,0,1,1
36389,4,2,127385,127385,127387,0,2,3
36390,3,2,127388,127388,127390,0,2,1
36391,2,3,127390,127390,127393,0,3,0
36392,5,2,127395,127395,127397,0,2,2
36393,5,3,127400,127400,127403,0,3,3
36394,1,2,127401,127403,127405,2,4,0
36395,6,1,127407,127407,127408,0,1,2
36396,3,1,127410,127410,127411,0,1,2
36397,1,2,127411,127411,127413,0,2,0
36398,5,1,127416,127416,127417,0,1,3
36399,5,1,127421,127421,127422,0,1,4
36400,1,2,127422,127422,127424,0,2,0
36401,6,1,127428,127428,127429,0,1,4
36402,6,3,127434,127434,127437,0,3,5
36403,1,2,127435,127437,127439,2,4,0
36404,4,3,127439,127439,127442,0,3,0
36405,6,2,127445,127445,127447,0,2,3
36406,6,2,127451,127451,127453,0,2,4
36407,2,2,127453,127453,127455,0,2,0
36408,6,3,127459,127459,127462,0,3,4
36409,6,3,127465,127465,127468,0,3,3
36410,3,2,127468,127468,127470,0,2,0
36411,4,3,127472,127472,127475,0,3,2
36412,3,2,127475,127475,127477,0,2,0
36413,6,3,127481,127481,127484,0,3,4
36414,1,1,127482,127484,127485,2,3,0
36415,2,3,127484,127485,127488,1,4,0
36416,5,1,127489,127489,127490,0,1,1
36417,5,3,127494,127494,127497,0,3,4
36418,3,2,127497,127497,127499,0,2,0
36419,3,3,127500,127500,127503,0,3,1
36420,1,1,127501,127503,127504,2,3,0
36421,6,1,127507,127507,127508,0,1,3
36422,1,3,127508,127508,127511,0,3,0
36423,2,2,127510,127511,127513,1,3,0
36424,1,1,127511,127513,127514,2,3,0
36425,2,1,127513,127514,127515,1,2,0
36426,5,1,127518,127518,127519,0,1,3
36427,2,1,127520,127520,127521,0,1,1
36428,4,2,127524,127524,127526,0,2,3
36429,3,3,127527,127527,127530,0,3,1
36430,5,2,127532,127532,127534,0,2,2
36431,1,3,127533,127534,127537,1,4,0
36432,5,1,127538,127538,127539,0,1,1
36433,4,2,127542,127542,127544,0,2,3
36434,6,1,127548,127548,127549,0,1,4
36435,5,1,127553,127553,127554,0,1,4
36436,6,1,127559,127559,127560,0,1,5
36437,4,3,127563,127563,127566,0,3,3
36438,1,3,127564,127566,127569,2,5,0
36439,2,3,127566,127569,127572,3,6,0
36440,4,2,127570,127572,127574,2,4,0
36441,6,2,127576,127576,127578,0,2,2
36442,1,1,127577,127578,127579,1,2,0
36443,6,1,127583,127583,127584,0,1,4
36444,6,2,127589,127589,127591,0,2,5
36445,4,1,127593,127593,127594,0,1,2
36446,6,3,127599,127599,127602,0,3,5
36447,2,2,127601,127602,127604,1,3,0
36448,5,3,127606,127606,127609,0,3,2
36449,2,2,127608,127609,127611,1,3,0
36450,6,1,127614,127614,127615,0,1,3
36451,2,1,127616,127616,127617,0,1,1
36452,2,2,127618,127618,127620,0,2,1
36453,5,1,127623,127623,127624,0,1,3
36454,1,1,127624,127624,127625,0,1,0
36455,3,1,127627,127627,127628,0,1,2
36456,2,1,127629,127629,127630,0,1,1
36457,1,2,127630,127630,127632,0,2,0
36458,2,3,127632,127632,127635,0,3,0
36459,6,1,127638,127638,127639,0,1,3
36460,4,3,127642,127642,127645,0,3,3
36461,1,3,127643,127645,127648,2,5,0
36462,4,1,127647,127648,127649,1,2,0
36463,5,1,127652,127652,127653,0,1,3
36464,1,2,127653,127653,127655,0,2,0
36465,3,3,127656,127656,127659,0,3,1
36466,2,2,127658,127659,127661,1,3,0
36467,3,2,127661,127661,127663,0,2,0
36468,5,1,127666,127666,127667,0,1,3
36469,3,3,127669,127669,127672,0,3,2
36470,1,1,127670,127672,127673,2,3,0
36471,4,2,127674,127674,127676,0,2,1
36472,2,3,127676,127676,127679,0,3,0
36473,1,3,127677,127679,127682,2,5,0
36474,5,3,127682,127682,127685,0,3,0
36475,6,3,127688,127688,127691,0,3,3
36476,1,1,127689,127691,127692,2,3,0
36477,4,3,127693,127693,127696,0,3,1
36478,1,2,127694,127696,127698,2,4,0
36479,5,3,127699,127699,127702,0,3,1
36480,6,3,127705,127705,127708,0,3,3
36481,3,1,127708,127708,127709,0,1,0
36482,4,3,127712,127712,127715,0,3,3
36483,1,2,127713,127715,127717,2,4,0
36484,1,1,127714,127717,127718,3,4,0
36485,4,3,127718,127718,127721,0,3,0
36486,4,1,127722,127722,127723,0,1,1
36487,5,3,127727,127727,127730,0,3,4
36488,6,3,127733,127733,127736,0,3,3
36489,6,3,127739,127739,127742,0,3,3
36490,3,3,127742,127742,127745,0,3,0
36491,5,1,127747,127747,127748,0,1,2
36492,2,1,127749,127749,127750,0,1,1
36493,6,1,127755,127755,127756,0,1,5
36494,2,2,127757,127757,127759,0,2,1
36495,2,1,127759,127759,127760,0,1,0
36496,4,3,127763,127763,127766,0,3,3
36497,5,2,127768,127768,127770,0,2,2
36498,6,2,127774,127774,127776,0,2,4
36499,2,3,127776,127776,127779,0,3,0
36500,4,1,127780,127780,127781,0,1,1
36501,4,3,127784,127784,127787,0,3,3
36502,6,1,127790,127790,127791,0,1,3
36503,5,1,127795,127795,127796,0,1,4
36504,6,3,127801,127801,127804,0,3,5
36505,2,3,127803,127804,127807,1,4,0
36506,6,3,127809,127809,127812,0,3,2
36507,4,3,127813,127813,127816,0,3,1
36508,3,2,127816,127816,127818,0,2,0
36509,4,3,127820,127820,127823,0,3,2
36510,3,3,127823,127823,127826,0,3,0
36511,4,1,127827,127827,127828,0,1,1
36512,5,3,127832,127832,127835,0,3,4
36513,6,3,127838,127838,127841,0,3,3
36514,1,1,127839,127841,127842,2,3,0
36515,1,2,127840,127842,127844,2,4,0
36516,4,2,127844,127844,127846,0,2,0
36517,6,1,127850,127850,127851,0,1,4
36518,2,1,127852,127852,127853,0,1,1
36519,5,2,127857,127857,127859,0,2,4
36520,4,1,127861,127861,127862,0,1,2
36521,3,1,127864,127864,127865,0,1,2
36522,2,1,127866,127866,127867,0,1,1
36523,5,2,127871,127871,127873,0,2,4
36524,4,2,127875,127875,127877,0,2,2
36525,2,3,127877,127877,127880,0,3,0
36526,5,1,127882,127882,127883,0,1,2
36527,6,1,127888,127888,127889,0,1,5
36528,5,2,127893,127893,127895,0,2,4
36529,1,2,127894,127895,127897,1,3,0
36530,6,2,127900,127900,127902,0,2,3
36531,6,3,127906,127906,127909,0,3,4
36532,6,3,127912,127912,127915,0,3,3
36533,4,1,127916,127916,127917,0,1,1
36534,2,3,127918,127918,127921,0,3,1
36535,3,2,127921,127921,127923,0,2,0
36536,5,2,127926,127926,127928,0,2,3
36537,4,2,127930,127930,127932,0,2,2
36538,6,1,127936,127936,127937,0,1,4
36539,4,1,127940,127940,127941,0,1,3
36540,4,3,127944,127944,127947,0,3,3
36541,1,1,127945,127947,127948,2,3,0
36542,1,3,127946,127948,127951,2,5,0
36543,2,1,127948,127951,127952,3,4,0
36544,4,2,127952,127952,127954,0,2,0
36545,1,2,127953,127954,127956,1,3,0
36546,4,1,127957,127957,127958,0,1,1
36547,3,1,127960,127960,127961,0,1,2
36548,4,1,127964,127964,127965,0,1,3
36549,1,2,127965,127965,127967,0,2,0
36550,2,3,127967,127967,127970,0,3,0
36551,5,3,127972,127972,127975,0,3,2
36552,6,3,127978,127978,127981,0,3,3
36553,4,1,127982,127982,127983,0,1,1
36554,4,2,127986,127986,127988,0,2,3
36555,1,3,127987,127988,127991,1,4,0
36556,3,1,127990,127991,127992,1,2,0
36557,4,2,127994,127994,127996,0,2,2
36558,6,3,128000,128000,128003,0,3,4
36559,1,3,128001,128003,128006,2,5,0
36560,5,2,128006,128006,128008,0,2,0
36561,4,1,128010,128010,128011,0,1,2
36562,6,1,128016,128016,128017,0,1,5
36563,3,3,128019,128019,128022,0,3,2
36564,6,3,128025,128025,128028,0,3,3
36565,6,3,128031,128031,128034,0,3,3
36566,1,2,128032,128034,128036,2,4,0
36567,6,1,128038,128038,128039,0,1,2
36568,2,3,128040,128040,128043,0,3,1
36569,1,2,128041,128043,128045,2,4,0
36570,2,2,128043,128045,128047,2,4,0
36571,1,3,128044,128047,128050,3,6,0
36572,1,1,128045,128050,128051,5,6,0
36573,1,3,128046,128051,128054,5,8,0
36574,1,3,128047,128054,128057,7,10,0
36575,3,1,128050,128057,128058,7,8,0
36576,5,3,128055,128058,128061,3,6,0
36577,5,3,128060,128061,128064,1,4,0
36578,5,3,128065,128065,128068,0,3,1
36579,2,2,128067,128068,128070,1,3,0
36580,6,1,128073,128073,128074,0,1,3
36581,4,2,128077,128077,128079,0,2,3
36582,1,3,128078,128079,128082,1,4,0
36583,2,3,128080,128082,128085,2,5,0
36584,4,3,128084,128085,128088,1,4,0
36585,5,3,128089,128089,128092,0,3,1
36586,2,1,128091,128092,128093,1,2,0
36587,2,2,128093,128093,128095,0,2,0
36588,1,2,128094,128095,128097,1,3,0
36589,6,1,128100,128100,128101,0,1,3
36590,6,3,128106,128106,128109,0,3,5
36591,3,3,128109,128109,128112,0,3,0
36592,4,1,128113,128113,128114,0,1,1
36593,6,3,128119,128119,128122,0,3,5
36594,5,2,128124,128124,128126,0,2,2
36595,5,2,128129,128129,128131,0,2,3
36596,5,1,128134,128134,128135,0,1,3
36597,4,1,128138,128138,128139,0,1,3
36598,5,1,128143,128143,128144,0,1,4
36599,3,3,128146,128146,128149,0,3,2
36600,2,1,128148,128149,128150,1,2,0
36601,5,3,128153,128153,128156,0,3,3
36602,1,2,128154,128156,128158,2,4,0
36603,1,3,128155,128158,128161,3,6,0
36604,5,2,128160,128161,128163,1,3,0
36605,2,2,128162,128163,128165,1,3,0
36606,4,3,128166,128166,128169,0,3,1
36607,1,3,128167,128169,128172,2,5,0
36608,1,1,128168,128172,128173,4,5,0
36609,5,3,128173,128173,128176,0,3,0
36610,6,2,128179,128179,128181,0,2,3
36611,6,3,128185,128185,128188,0,3,4
36612,2,1,128187,128188,128189,1,2,0
36613,3,2,128190,128190,128192,0,2,1
36614,3,1,128193,128193,128194,0,1,1
36615,2,1,128195,128195,128196,0,1,1
36616,5,2,128200,128200,128202,0,2,4
36617,3,2,128203,128203,128205,0,2,1
36618,1,2,128204,128205,128207,1,3,0
36619,1,2,128205,128207,128209,2,4,0
36620,4,2,128209,128209,128211,0,2,0
36621,6,2,128215,128215,128217,0,2,4
36622,5,3,128220,128220,128223,0,3,3
36623,3,3,128223,128223,128226,0,3,0
36624,2,1,128225,128226,128227,1,2,0
36625,4,2,128229,128229,128231,0,2,2
36626,1,2,128230,128231,128233,1,3,0
36627,1,1,128231,128233,128234,2,3,0
36628,5,2,128236,128236,128238,0,2,2
36629,6,2,128242,128242,128244,0,2,4
36630,5,2,128247,128247,128249,0,2,3
36631,5,3,128252,128252,128255,0,3,3
36632,1,1,128253,128255,128256,2,3,0
36633,1,2,128254,128256,128258,2,4,0
36634,4,2,128258,128258,128260,0,2,0
36635,3,3,128261,128261,128264,0,3,1
36636,2,3,128263,128264,128267,1,4,0
36637,2,3,128265,128267,128270,2,5,0
36638,6,3,128271,128271,128274,0,3,1
36639,3,2,128274,128274,128276,0,2,0
36640,2,2,128276,128276,128278,0,2,0
36641,1,2,128277,128278,128280,1,3,0
36642,4,1,128281,128281,128282,0,1,1
36643,6,3,128287,128287,128290,0,3,5
36644,4,1,128291,128291,128292,0,1,1
36645,6,2,128297,128297,128299,0,2,5
36646,6,3,128303,128303,128306,0,3,4
36647,2,2,128305,128306,128308,1,3,0
36648,5,3,128310,128310,128313,0,3,2
36649,3,1,128313,128313,128314,0,1,0
36650,5,1,128318,128318,128319,0,1,4
36651,4,2,128322,128322,128324,0,2,3
36652,6,3,128328,128328,128331,0,3,4
36653,4,2,128332,128332,128334,0,2,1
36654,4,2,128336,128336,128338,0,2,2
36655,2,2,128338,128338,128340,0,2,0
36656,3,1,128341,128341,128342,0,1,1
36657,2,3,128343,128343,128346,0,3,1
36658,5,1,128348,128348,128349,0,1,2
36659,5,2,128353,128353,128355,0,2,4
36660,6,3,128359,128359,128362,0,3,4
36661,6,3,128365,128365,128368,0,3,3
36662,6,3,128371,128371,128374,0,3,3
36663,5,3,128376,128376,128379,0,3,2
36664,3,3,128379,128379,128382,0,3,0
36665,2,3,128381,128382,128385,1,4,0
36666,1,2,128382,128385,128387,3,5,0
36667,4,2,128386,128387,128389,1,3,0
36668,3,3,128389,128389,128392,0,3,0
36669,3,2,128392,128392,128394,0,2,0
36670,3,2,128395,128395,128397,0,2,1
36671,4,2,128399,128399,128401,0,2,2
36672,3,1,128402,128402,128403,0,1,1
36673,1,2,128403,128403,128405,0,2,0
36674,6,1,128409,128409,128410,0,1,4
36675,4,2,128413,128413,128415,0,2,3
36676,1,1,128414,128415,128416,1,2,0
36677,2,1,128416,128416,128417,0,1,0
36678,3,2,128419,128419,128421,0,2,2
36679,6,2,128425,128425,128427,0,2,4
36680,4,2,128429,128429,128431,0,2,2
36681,5,2,128434,128434,128436,0,2,3
36682,6,1,128440,128440,128441,0,1,4
36683,2,2,128442,128442,128444,0,2,1
36684,5,1,128447,128447,128448,0,1,3
36685,6,3,128453,128453,128456,0,3,5
36686,1,1,128454,128456,128457,2,3,0
36687,6,3,128460,128460,128463,0,3,3
36688,4,1,128464,128464,128465,0,1,1
36689,4,2,128468,128468,128470,0,2,3
36690,4,2,128472,128472,128474,0,2,2
36691,3,1,128475,128475,128476,0,1,1
36692,2,1,128477,128477,128478,0,1,1
36693,4,2,128481,128481,128483,0,2,3
36694,4,2,128485,128485,128487,0,2,2
36695,1,1,128486,128487,128488,1,2,0
36696,1,3,128487,128488,128491,1,4,0
36697,5,2,128492,128492,128494,0,2,1
36698,3,3,128495,128495,128498,0,3,1
36699,1,3,128496,128498,128501,2,5,0
36700,5,1,128501,128501,128502,0,1,0
36701,6,1,128507,128507,128508,0,1,5
36702,5,3,128512,128512,128515,0,3,4
36703,1,3,128513,128515,128518,2,5,0
36704,4,1,128517,128518,128519,1,2,0
36705,4,3,128521,128521,128524,0,3,2
36706,3,3,128524,128524,128527,0,3,0
36707,5,2,128529,128529,128531,0,2,2
36708,4,2,128533,128533,128535,0,2,2
36709,3,3,128536,128536,128539,0,3,1
36710,4,3,128540,128540,128543,0,3,1
36711,5,1,128545,128545,128546,0,1,2
36712,6,3,128551,128551,128554,0,3,5
36713,1,3,128552,128554,128557,2,5,0
36714,5,3,128557,128557,128560,0,3,0
36715,6,1,128563,128563,128564,0,1,3
36716,4,1,128567,128567,128568,0,1,3
36717,6,2,128573,128573,128575,0,2,5
36718,2,1,128575,128575,128576,0,1,0
36719,4,2,128579,128579,128581,0,2,3
36720,5,3,128584,128584,128587,0,3,3
36721,1,2,128585,128587,128589,2,4,0
36722,4,1,128589,128589,128590,0,1,0
36723,3,1,128592,128592,128593,0,1,2
36724,2,2,128594,128594,128596,0,2,1
36725,6,3,128600,128600,128603,0,3,4
36726,2,3,128602,128603,128606,1,4,0
36727,6,2,128608,128608,128610,0,2,2
36728,5,2,128613,128613,128615,0,2,3
36729,3,1,128616,128616,128617,0,1,1
36730,1,2,128617,128617,128619,0,2,0
36731,6,3,128623,128623,128626,0,3,4
36732,6,3,128629,128629,128632,0,3,3
36733,1,1,128630,128632,128633,2,3,0
36734,1,1,128631,128633,128634,2,3,0
36735,3,3,128634,128634,128637,0,3,0
36736,4,3,128638,128638,128641,0,3,1
36737,1,2,128639,128641,128643,2,4,0
36738,6,1,128645,128645,128646,0,1,2
36739,3,1,128648,128648,128649,0,1,2
36740,5,1,128653,128653,128654,0,1,4
36741,6,1,128659,128659,128660,0,1,5
36742,1,3,128660,128660,128663,0,3,0
36743,3,1,128663,128663,128664,0,1,0
36744,2,2,128665,128665,128667,0,2,1
36745,3,2,128668,128668,128670,0,2,1
36746,2,3,128670,128670,128673,0,3,0
36747,5,3,128675,128675,128678,0,3,2
36748,4,2,128679,128679,128681,0,2,1
36749,3,1,128682,128682,128683,0,1,1
36750,3,1,128685,128685,128686,0,1,2
36751,1,3,128686,128686,128689,0,3,0
36752,1,2,128687,128689,128691,2,4,0
36753,1,1,128688,128691,128692,3,4,0
36754,2,3,128690,128692,128695,2,5,0
36755,3,3,128693,128695,128698,2,5,0
36756,1,3,128694,128698,128701,4,7,0
36757,6,1,128700,128701,128702,1,2,0
36758,6,1,128706,128706,128707,0,1,4
36759,1,2,128707,128707,128709,0,2,0
36760,5,1,128712,128712,128713,0,1,3
36761,1,3,128713,128713,128716,0,3,0
36762,2,3,128715,128716,128719,1,4,0
36763,3,1,128718,128719,128720,1,2,0
36764,3,3,128721,128721,128724,0,3,1
36765,3,3,128724,128724,128727,0,3,0
36766,3,2,128727,128727,128729,0,2,0
36767,4,1,128731,128731,128732,0,1,2
36768,4,3,128735,128735,128738,0,3,3
36769,3,3,128738,128738,128741,0,3,0
36770,5,1,128743,128743,128744,0,1,2
36771,4,1,128747,128747,128748,0,1,3
36772,6,1,128753,128753,128754,0,1,5
36773,3,3,128756,128756,128759,0,3,2
36774,3,3,128759,128759,128762,0,3,0
36775,6,1,128765,128765,128766,0,1,3
36776,2,2,128767,128767,128769,0,2,1
36777,6,1,128773,128773,128774,0,1,4
36778,4,3,128777,128777,128780,0,3,3
36779,2,1,128779,128780,128781,1,2,0
36780,1,3,128780,128781,128784,1,4,0
36781,4,1,128784,128784,128785,0,1,0
36782,1,3,128785,128785,128788,0,3,0
36783,2,3,128787,128788,128791,1,4,0
36784,6,2,128793,128793,128795,0,2,2
36785,4,2,128797,128797,128799,0,2,2
36786,5,2,128802,128802,128804,0,2,3
36787,6,3,128808,128808,128811,0,3,4
36788,5,2,128813,128813,128815,0,2,2
36789,3,3,128816,128816,128819,0,3,1
36790,3,2,128819,128819,128821,0,2,0
36791,2,2,128821,128821,128823,0,2,0
36792,6,2,128827,128827,128829,0,2,4
36793,4,2,128831,128831,128833,0,2,2
36794,1,3,128832,128833,128836,1,4,0
36795,4,1,128836,128836,128837,0,1,0
36796,6,3,128842,128842,128845,0,3,5
36797,6,1,128848,128848,128849,0,1,3
36798,1,1,128849,128849,128850,0,1,0
36799,1,3,128850,128850,128853,0,3,0
36800,3,1,128853,128853,128854,0,1,0
36801,1,3,128854,128854,128857,0,3,0
36802,5,2,128859,128859,128861,0,2,2
36803,1,3,128860,128861,128864,1,4,0
36804,2,3,128862,128864,128867,2,5,0
36805,5,2,128867,128867,128869,0,2,0
36806,6,2,128873,128873,128875,0,2,4
36807,2,2,128875,128875,128877,0,2,0
36808,3,1,128878,128878,128879,0,1,1
36809,3,3,128881,128881,128884,0,3,2
36810,1,1,128882,128884,128885,2,3,0
36811,6,2,128888,128888,128890,0,2,3
36812,4,3,128892,128892,128895,0,3,2
36813,5,3,128897,128897,128900,0,3,2
36814,1,2,128898,128900,128902,2,4,0
36815,6,2,128904,128904,128906,0,2,2
36816,5,3,128909,128909,128912,0,3,3
36817,4,2,128913,128913,128915,0,2,1
36818,3,1,128916,128916,128917,0,1,1
36819,6,3,128922,128922,128925,0,3,5
36820,3,3,128925,128925,128928,0,3,0
36821,5,3,128930,128930,128933,0,3,2
36822,5,1,128935,128935,128936,0,1,2
36823,6,1,128941,128941,128942,0,1,5
36824,4,3,128945,128945,128948,0,3,3
36825,4,3,128949,128949,128952,0,3,1
36826,2,1,128951,128952,128953,1,2,0
36827,5,3,128956,128956,128959,0,3,3
36828,3,3,128959,128959,128962,0,3,0
36829,6,2,128965,128965,128967,0,2,3
36830,5,1,128970,128970,128971,0,1,3
36831,2,3,128972,128972,128975,0,3,1
36832,3,2,128975,128975,128977,0,2,0
36833,1,1,128976,128977,128978,1,2,0
36834,4,2,128980,128980,128982,0,2,2
36835,3,3,128983,128983,128986,0,3,1
36836,4,2,128987,128987,128989,0,2,1
36837,5,1,128992,128992,128993,0,1,3
36838,1,2,128993,128993,128995,0,2,0
36839,5,3,128998,128998,129001,0,3,3
36840,3,3,129001,129001,129004,0,3,0
36841,4,3,129005,129005,129008,0,3,1
36842,3,3,129008,129008,129011,0,3,0
36843,1,2,129009,129011,129013,2,4,0
36844,4,2,129013,129013,129015,0,2,0
36845,1,1,129014,129015,129016,1,2,0
36846,6,2,129020,129020,129022,0,2,4
36847,1,3,129021,129022,129025,1,4,0
36848,1,1,129022,129025,129026,3,4,0
36849,4,2,129026,129026,129028,0,2,0
36850,1,1,129027,129028,129029,1,2,0
36851,3,1,129030,129030,129031,0,1,1
36852,2,2,129032,129032,129034,0,2,1
36853,1,1,129033,129034,129035,1,2,0
36854,6,3,129039,129039,129042,0,3,4
36855,2,2,129041,129042,129044,1,3,0
36856,1,1,129042,129044,129045,2,3,0
36857,3,2,129045,129045,129047,0,2,0
36858,3,2,129048,129048,129050,0,2,1
36859,6,3,129054,129054,129057,0,3,4
36860,1,2,129055,129057,129059,2,4,0
36861,2,2,129057,129059,129061,2,4,0
36862,2,1,129059,129061,129062,2,3,0
36863,3,3,129062,129062,129065,0,3,0
36864,3,1,129065,129065,129066,0,1,0
36865,6,1,129071,129071,129072,0,1,5
36866,6,3,129077,129077,129080,0,3,5
36867,6,2,129083,129083,129085,0,2,3
36868,3,3,129086,129086,129089,0,3,1
36869,3,2,129089,129089,129091,0,2,0
36870,2,2,129091,129091,129093,0,2,0
36871,3,1,129094,129094,129095,0,1,1
36872,2,3,129096,129096,129099,0,3,1
36873,4,2,129100,129100,129102,0,2,1
36874,4,1,129104,129104,129105,0,1,2
36875,5,1,129109,129109,129110,0,1,4
36876,2,3,129111,129111,129114,0,3,1
36877,3,2,129114,129114,129116,0,2,0
36878,2,2,129116,129116,129118,0,2,0
36879,6,1,129122,129122,129123,0,1,4
36880,4,2,129126,129126,129128,0,2,3
36881,6,2,129132,129132,129134,0,2,4
36882,5,2,129137,129137,129139,0,2,3
36883,1,1,129138,129139,129140,1,2,0
36884,1,2,129139,129140,129142,1,3,0
36885,6,2,129145,129145,129147,0,2,3
36886,1,3,129146,129147,129150,1,4,0
36887,6,1,129152,129152,129153,0,1,2
36888,3,1,129155,129155,129156,0,1,2
36889,6,3,129161,129161,129164,0,3,5
36890,2,2,129163,129164,129166,1,3,0
36891,4,1,129167,129167,129168,0,1,1
36892,4,1,129171,129171,129172,0,1,3
36893,6,3,129177,129177,129180,0,3,5
36894,1,3,129178,129180,129183,2,5,0
36895,1,1,129179,129183,129184,4,5,0
36896,6,3,129185,129185,129188,0,3,1
36897,3,1,129188,129188,129189,0,1,0
36898,2,1,129190,129190,129191,0,1,1
36899,5,1,129195,129195,129196,0,1,4
36900,3,1,129198,129198,129199,0,1,2
36901,2,3,129200,129200,129203,0,3,1
36902,3,2,129203,129203,129205,0,2,0
36903,5,1,129208,129208,129209,0,1,3
36904,6,2,129214,129214,129216,0,2,5
36905,1,1,129215,129216,129217,1,2,0
36906,2,1,129217,129217,129218,0,1,0
36907,4,2,129221,129221,129223,0,2,3
36908,2,3,129223,129223,129226,0,3,0
36909,1,1,129224,129226,129227,2,3,0
36910,1,2,129225,129227,129229,2,4,0
36911,2,1,129227,129229,129230,2,3,0
36912,2,3,129229,129230,129233,1,4,0
36913,5,1,129234,129234,129235,0,1,1
36914,6,1,129240,129240,129241,0,1,5
36915,5,3,129245,129245,129248,0,3,4
36916,4,2,129249,129249,129251,0,2,1
36917,2,3,129251,129251,129254,0,3,0
36918,4,1,129255,129255,129256,0,1,1
36919,4,3,129259,129259,129262,0,3,3
36920,5,1,129264,129264,129265,0,1,2
36921,3,1,129267,129267,129268,0,1,2
36922,1,2,129268,129268,129270,0,2,0
36923,2,2,129270,129270,129272,0,2,0
36924,3,2,129273,129273,129275,0,2,1
36925,1,3,129274,129275,129278,1,4,0
36926,6,3,129280,129280,129283,0,3,2
36927,6,3,129286,129286,129289,0,3,3
36928,5,1,129291,129291,129292,0,1,2
36929,6,3,129297,129297,129300,0,3,5
36930,4,2,129301,129301,129303,0,2,1
36931,2,2,129303,129303,129305,0,2,0
36932,5,3,129308,129308,129311,0,3,3
36933,5,2,129313,129313,129315,0,2,2
36934,2,2,129315,129315,129317,0,2,0
36935,4,2,129319,129319,129321,0,2,2
36936,2,2,129321,129321,129323,0,2,0
36937,5,1,129326,129326,129327,0,1,3
36938,5,2,129331,129331,129333,0,2,4
36939,3,1,129334,129334,129335,0,1,1
36940,3,1,129337,129337,129338,0,1,2
36941,4,2,129341,129341,129343,0,2,3
36942,6,1,129347,129347,129348,0,1,4
36943,4,1,129351,129351,129352,0,1,3
36944,3,2,129354,129354,129356,0,2,2
36945,2,2,129356,129356,129358,0,2,0
36946,4,2,129360,129360,129362,0,2,2
36947,3,2,129363,129363,129365,0,2,1
36948,1,1,129364,129365,129366,1,2,0
36949,6,1,129370,129370,129371,0,1,4
36950,3,2,129373,129373,129375,0,2,2
36951,6,1,129379,129379,129380,0,1,4
36952,5,2,129384,129384,129386,0,2,4
36953,3,1,129387,129387,129388,0,1,1
36954,4,3,129391,129391,129394,0,3,3
36955,1,3,129392,129394,129397,2,5,0
36956,6,2,129398,129398,129400,0,2,1
36957,2,3,129400,129400,129403,0,3,0
36958,5,1,129405,129405,129406,0,1,2
36959,6,2,129411,129411,129413,0,2,5
36960,1,2,129412,129413,129415,1,3,0
36961,1,2,129413,129415,129417,2,4,0
36962,5,2,129418,129418,129420,0,2,1
36963,1,1,129419,129420,129421,1,2,0
36964,5,2,129424,129424,129426,0,2,3
36965,6,1,129430,129430,129431,0,1,4
36966,6,2,129436,129436,129438,0,2,5
36967,3,3,129439,129439,129442,0,3,1
36968,1,3,129440,129442,129445,2,5,0
36969,1,1,129441,129445,129446,4,5,0
36970,1,3,129442,129446,129449,4,7,0
36971,4,2,129446,129449,129451,3,5,0
36972,5,3,129451,129451,129454,0,3,0
36973,4,2,129455,129455,129457,0,2,1
36974,5,2,129460,129460,129462,0,2,3
36975,5,2,129465,129465,129467,0,2,3
36976,5,3,129470,129470,129473,0,3,3
36977,2,1,129472,129473,129474,1,2,0
36978,6,3,129478,129478,129481,0,3,4
36979,1,1,129479,129481,129482,2,3,0
36980,2,1,129481,129482,129483,1,2,0
36981,4,1,129485,129485,129486,0,1,2
36982,5,2,129490,129490,129492,0,2,4
36983,3,3,129493,129493,129496,0,3,1
36984,6,2,129499,129499,129501,0,2,3
36985,5,2,129504,129504,129506,0,2,3
36986,4,1,129508,129508,129509,0,1,2
36987,6,2,129514,129514,129516,0,2,5
36988,5,2,129519,129519,129521,0,2,3
36989,6,2,129525,129525,129527,0,2,4
36990,2,2,129527,129527,129529,0,2,0
36991,3,3,129530,129530,129533,0,3,1
36992,2,2,129532,129533,129535,1,3,0
36993,2,3,129534,129535,129538,1,4,0
36994,6,2,129540,129540,129542,0,2,2
36995,3,2,129543,129543,129545,0,2,1
36996,4,3,129547,129547,129550,0,3,2
36997,5,1,129552,129552,129553,0,1,2
36998,5,1,129557,129557,129558,0,1,4
36999,3,3,129560,129560,129563,0,3,2
37000,5,3,129565,129565,129568,0,3,2
37001,5,1,129570,129570,129571,0,1,2
37002,4,3,129574,129574,129577,0,3,3
37003,2,1,129576,129577,129578,1,2,0
37004,5,1,129581,129581,129582,0,1,3
37005,5,1,129586,129586,129587,0,1,4
37006,6,1,129592,129592,129593,0,1,5
37007,2,2,129594,129594,129596,0,2,1
37008,2,1,129596,129596,129597,0,1,0
37009,1,1,129597,129597,129598,0,1,0
37010,5,3,129602,129602,129605,0,3,4
37011,6,3,129608,129608,129611,0,3,3
37012,4,1,129612,129612,129613,0,1,1
37013,4,3,129616,129616,129619,0,3,3
37014,2,2,129618,129619,129621,1,3,0
37015,1,1,129619,129621,129622,2,3,0
37016,4,2,129623,129623,129625,0,2,1
37017,2,1,129625,129625,129626,0,1,0
37018,4,1,129629,129629,129630,0,1,3
37019,6,3,129635,129635,129638,0,3,5
37020,2,1,129637,129638,129639,1,2,0
37021,2,1,129639,129639,129640,0,1,0
37022,6,2,129645,129645,129647,0,2,5
37023,2,2,129647,129647,129649,0,2,0
37024,5,3,129652,129652,129655,0,3,3
37025,5,1,129657,129657,129658,0,1,2
37026,1,2,129658,129658,129660,0,2,0
37027,2,3,129660,129660,129663,0,3,0
37028,5,1,129665,129665,129666,0,1,2
37029,6,2,129671,129671,129673,0,2,5
37030,5,1,129676,129676,129677,0,1,3
37031,2,2,129678,129678,129680,0,2,1
37032,4,3,129682,129682,129685,0,3,2
37033,2,1,129684,129685,129686,1,2,0
37034,6,2,129690,129690,129692,0,2,4
37035,3,1,129693,129693,129694,0,1,1
37036,4,1,129697,129697,129698,0,1,3
37037,5,2,129702,129702,129704,0,2,4
37038,4,3,129706,129706,129709,0,3,2
37039,4,1,129710,129710,129711,0,1,1
37040,4,1,129714,129714,129715,0,1,3
37041,2,3,129716,129716,129719,0,3,1
37042,1,2,129717,129719,129721,2,4,0
37043,4,1,129721,129721,129722,0,1,0
37044,5,3,129726,129726,129729,0,3,4
37045,5,2,129731,129731,129733,0,2,2
37046,6,2,129737,129737,129739,0,2,4
37047,2,3,129739,129739,129742,0,3,0
37048,1,1,129740,129742,129743,2,3,0
37049,6,1,129746,129746,129747,0,1,3
37050,6,3,129752,129752,129755,0,3,5
37051,5,3,129757,129757,129760,0,3,2
37052,4,3,129761,129761,129764,0,3,1
37053,4,1,129765,129765,129766,0,1,1
37054,4,3,129769,129769,129772,0,3,3
37055,3,1,129772,129772,129773,0,1,0
37056,6,2,129778,129778,129780,0,2,5
37057,4,1,129782,129782,129783,0,1,2
37058,4,2,129786,129786,129788,0,2,3
37059,2,1,129788,129788,129789,0,1,0
37060,4,2,129792,129792,129794,0,2,3
37061,3,3,129795,129795,129798,0,3,1
37062,2,1,129797,129798,129799,1,2,0
37063,5,1,129802,129802,129803,0,1,3
37064,4,1,129806,129806,129807,0,1,3
37065,2,2,129808,129808,129810,0,2,1
37066,5,1,129813,129813,129814,0,1,3
37067,4,3,129817,129817,129820,0,3,3
37068,4,2,129821,129821,129823,0,2,1
37069,3,2,129824,129824,129826,0,2,1
37070,4,1,129828,129828,129829,0,1,2
37071,1,1,129829,129829,129830,0,1,0
37072,4,1,129833,129833,129834,0,1,3
37073,5,3,129838,129838,129841,0,3,4
37074,1,2,129839,129841,129843,2,4,0
37075,4,1,129843,129843,129844,0,1,0
37076,2,1,129845,129845,129846,0,1,1
37077,2,3,129847,129847,129850,0,3,1
37078,2,1,129849,129850,129851,1,2,0
37079,3,3,129852,129852,129855,0,3,1
37080,5,2,129857,129857,129859,0,2,2
37081,1,3,129858,129859,129862,1,4,0
37082,6,2,129864,129864,129866,0,2,2
37083,2,2,129866,129866,129868,0,2,0
37084,3,1,129869,129869,129870,0,1,1
37085,5,3,129874,129874,129877,0,3,4
37086,4,3,129878,129878,129881,0,3,1
37087,3,3,129881,129881,129884,0,3,0
37088,2,1,129883,129884,129885,1,2,0
37089,2,3,129885,129885,129888,0,3,0
37090,3,2,129888,129888,129890,0,2,0
37091,3,3,129891,129891,129894,0,3,1
37092,5,2,129896,129896,129898,0,2,2
37093,3,3,129899,129899,129902,0,3,1
37094,6,3,129905,129905,129908,0,3,3
37095,5,1,129910,129910,129911,0,1,2
37096,5,2,129915,129915,129917,0,2,4
37097,2,2,129917,129917,129919,0,2,0
37098,2,3,129919,129919,129922,0,3,0
37099,4,1,129923,129923,129924,0,1,1
37100,2,2,129925,129925,129927,0,2,1
37101,6,2,129931,129931,129933,0,2,4
37102,3,1,129934,129934,129935,0,1,1
37103,1,3,129935,129935,129938,0,3,0
37104,3,1,129938,129938,129939,0,1,0
37105,3,2,129941,129941,129943,0,2,2
37106,6,2,129947,129947,129949,0,2,4
37107,5,1,129952,129952,129953,0,1,3
37108,6,3,129958,129958,129961,0,3,5
37109,3,2,129961,129961,129963,0,2,0
37110,6,2,129967,129967,129969,0,2,4
37111,6,3,129973,129973,129976,0,3,4
37112,3,3,129976,129976,129979,0,3,0
37113,3,2,129979,129979,129981,0,2,0
37114,5,2,129984,129984,129986,0,2,3
37115,5,2,129989,129989,129991,0,2,3
37116,2,3,129991,129991,129994,0,3,0
37117,2,3,129993,129994,129997,1,4,0
37118,1,2,129994,129997,129999,3,5,0
37119,5,1,129999,129999,130000,0,1,0
37120,3,1,130002,130002,130003,0,1,2
37121,5,3,130007,130007,130010,0,3,4
37122,4,1,130011,130011,130012,0,1,1
37123,6,3,130017,130017,130020,0,3,5
37124,6,2,130023,130023,130025,0,2,3
37125,4,2,130027,130027,130029,0,2,2
37126,1,2,130028,130029,130031,1,3,0
37127,2,3,130030,130031,130034,1,4,0
37128,4,2,130034,130034,130036,0,2,0
37129,6,1,130040,130040,130041,0,1,4
37130,5,1,130045,130045,130046,0,1,4
37131,6,1,130051,130051,130052,0,1,5
37132,5,1,130056,130056,130057,0,1,4
37133,2,3,130058,130058,130061,0,3,1
37134,4,1,130062,130062,130063,0,1,1
37135,5,3,130067,130067,130070,0,3,4
37136,1,2,130068,130070,130072,2,4,0
37137,5,1,130073,130073,130074,0,1,1
37138,5,1,130078,130078,130079,0,1,4
37139,5,3,130083,130083,130086,0,3,4
37140,6,2,130089,130089,130091,0,2,3
37141,3,2,130092,130092,130094,0,2,1
37142,6,3,130098,130098,130101,0,3,4
37143,1,2,130099,130101,130103,2,4,0
37144,3,3,130102,130103,130106,1,4,0
37145,1,2,130103,130106,130108,3,5,0
37146,2,1,130105,130108,130109,3,4,0
37147,2,3,130107,130109,130112,2,5,0
37148,1,2,130108,130112,130114,4,6,0
37149,3,1,130111,130114,130115,3,4,0
37150,3,2,130114,130115,130117,1,3,0
37151,2,2,130116,130117,130119,1,3,0
37152,2,3,130118,130119,130122,1,4,0
37153,1,3,130119,130122,130125,3,6,0
37154,3,2,130122,130125,130127,3,5,0
37155,2,3,130124,130127,130130,3,6,0
37156,5,1,130129,130130,130131,1,2,0
37157,3,3,130132,130132,130135,0,3,1
37158,5,2,130137,130137,130139,0,2,2
37159,1,1,130138,130139,130140,1,2,0
37160,5,1,130143,130143,130144,0,1,3
37161,1,1,130144,130144,130145,0,1,0
37162,3,2,130147,130147,130149,0,2,2
37163,5,3,130152,130152,130155,0,3,3
37164,4,3,130156,130156,130159,0,3,1
37165,1,2,130157,130159,130161,2,4,0
37166,3,2,130160,130161,130163,1,3,0
37167,3,1,130163,130163,130164,0,1,0
37168,1,2,130164,130164,130166,0,2,0
37169,5,3,130169,130169,130172,0,3,3
37170,3,2,130172,130172,130174,0,2,0
37171,5,2,130177,130177,130179,0,2,3
37172,5,3,130182,130182,130185,0,3,3
37173,5,3,130187,130187,130190,0,3,2
37174,2,3,130189,130190,130193,1,4,0
37175,1,2,130190,130193,130195,3,5,0
37176,5,1,130195,130195,130196,0,1,0
37177,6,3,130201,130201,130204,0,3,5
37178,2,1,130203,130204,130205,1,2,0
37179,4,3,130207,130207,130210,0,3,2
37180,4,3,130211,130211,130214,0,3,1
37181,6,1,130217,130217,130218,0,1,3
37182,1,2,130218,130218,130220,0,2,0
37183,3,3,130221,130221,130224,0,3,1
37184,6,1,130227,130227,130228,0,1,3
37185,3,1,130230,130230,130231,0,1,2
37186,3,3,130233,130233,130236,0,3,2
37187,2,1,130235,130236,130237,1,2,0
37188,1,1,130236,130237,130238,1,2,0
37189,6,3,130242,130242,130245,0,3,4
37190,4,2,130246,130246,130248,0,2,1
37191,1,3,130247,130248,130251,1,4,0
37192,3,3,130250,130251,130254,1,4,0
37193,5,2,130255,130255,130257,0,2,1
37194,3,2,130258,130258,130260,0,2,1
37195,4,2,130262,130262,130264,0,2,2
37196,1,1,130263,130264,130265,1,2,0
37197,4,1,130267,130267,130268,0,1,2
37198,2,1,130269,130269,130270,0,1,1
37199,1,2,130270,130270,130272,0,2,0
37200,6,3,130276,130276,130279,0,3,4
37201,3,3,130279,130279,130282,0,3,0
37202,2,3,130281,130282,130285,1,4,0
37203,1,3,130282,130285,130288,3,6,0
37204,4,1,130286,130288,130289,2,3,0
37205,4,3,130290,130290,130293,0,3,1
37206,2,1,130292,130293,130294,1,2,0
37207,5,2,130297,130297,130299,0,2,3
37208,3,3,130300,130300,130303,0,3,1
37209,6,3,130306,130306,130309,0,3,3
37210,3,2,130309,130309,130311,0,2,0
37211,3,2,130312,130312,130314,0,2,1
37212,5,2,130317,130317,130319,0,2,3
37213,1,1,130318,130319,130320,1,2,0
37214,6,1,130324,130324,130325,0,1,4
37215,3,2,130327,130327,130329,0,2,2
37216,6,3,130333,130333,130336,0,3,4
37217,1,2,130334,130336,130338,2,4,0
37218,4,2,130338,130338,130340,0,2,0
37219,2,3,130340,130340,130343,0,3,0
37220,3,2,130343,130343,130345,0,2,0
37221,3,3,130346,130346,130349,0,3,1
37222,4,1,130350,130350,130351,0,1,1
37223,1,3,130351,130351,130354,0,3,0
37224,4,3,130355,130355,130358,0,3,1
37225,5,1,130360,130360,130361,0,1,2
37226,2,1,130362,130362,130363,0,1,1
37227,3,2,130365,130365,130367,0,2,2
37228,1,1,130366,130367,130368,1,2,0
37229,1,1,130367,130368,130369,1,2,0
37230,1,2,130368,130369,130371,1,3,0
37231,4,1,130372,130372,130373,0,1,1
37232,4,3,130376,130376,130379,0,3,3
37233,2,2,130378,130379,130381,1,3,0
37234,1,3,130379,130381,130384,2,5,0
37235,5,3,130384,130384,130387,0,3,0
37236,6,1,130390,130390,130391,0,1,3
37237,6,2,130396,130396,130398,0,2,5
37238,1,1,130397,130398,130399,1,2,0
37239,6,3,130403,130403,130406,0,3,4
37240,6,3,130409,130409,130412,0,3,3
37241,5,1,130414,130414,130415,0,1,2
37242,3,2,130417,130417,130419,0,2,2
37243,2,2,130419,130419,130421,0,2,0
37244,5,2,130424,130424,130426,0,2,3
37245,6,3,130430,130430,130433,0,3,4
37246,1,2,130431,130433,130435,2,4,0
37247,5,1,130436,130436,130437,0,1,1
37248,3,1,130439,130439,130440,0,1,2
37249,5,1,130444,130444,130445,0,1,4
37250,4,1,130448,130448,130449,0,1,3
37251,3,1,130451,130451,130452,0,1,2
37252,3,2,130454,130454,130456,0,2,2
37253,2,3,130456,130456,130459,0,3,0
37254,1,2,130457,130459,130461,2,4,0
37255,4,3,130461,130461,130464,0,3,0
37256,3,3,130464,130464,130467,0,3,0
37257,3,1,130467,130467,130468,0,1,0
37258,2,3,130469,130469,130472,0,3,1
37259,3,2,130472,130472,130474,0,2,0
37260,1,3,130473,130474,130477,1,4,0
37261,3,1,130476,130477,130478,1,2,0
37262,5,2,130481,130481,130483,0,2,3
37263,4,2,130485,130485,130487,0,2,2
37264,2,2,130487,130487,130489,0,2,0
37265,1,2,130488,130489,130491,1,3,0
37266,3,3,130491,130491,130494,0,3,0
37267,4,3,130495,130495,130498,0,3,1
37268,3,2,130498,130498,130500,0,2,0
37269,2,2,130500,130500,130502,0,2,0
37270,6,1,130506,130506,130507,0,1,4
37271,1,3,130507,130507,130510,0,3,0
37272,3,3,130510,130510,130513,0,3,0
37273,6,3,130516,130516,130519,0,3,3
37274,4,1,130520,130520,130521,0,1,1
37275,2,3,130522,130522,130525,0,3,1
37276,2,3,130524,130525,130528,1,4,0
37277,5,1,130529,130529,130530,0,1,1
37278,2,2,130531,130531,130533,0,2,1
37279,6,1,130537,130537,130538,0,1,4
37280,6,3,130543,130543,130546,0,3,5
37281,1,3,130544,130546,130549,2,5,0
37282,2,1,130546,130549,130550,3,4,0
37283,1,2,130547,130550,130552,3,5,0
37284,1,3,130548,130552,130555,4,7,0
37285,1,3,130549,130555,130558,6,9,0
37286,4,2,130553,130558,130560,5,7,0
37287,2,1,130555,130560,130561,5,6,0
37288,1,3,130556,130561,130564,5,8,0
37289,5,1,130561,130564,130565,3,4,0
37290,1,1,130562,130565,130566,3,4,0
37291,4,2,130566,130566,130568,0,2,0
37292,3,2,130569,130569,130571,0,2,1
37293,4,3,130573,130573,130576,0,3,2
37294,6,1,130579,130579,130580,0,1,3
37295,6,2,130585,130585,130587,0,2,5
37296,3,1,130588,130588,130589,0,1,1
37297,5,1,130593,130593,130594,0,1,4
37298,5,1,130598,130598,130599,0,1,4
37299,5,1,130603,130603,130604,0,1,4
37300,3,2,130606,130606,130608,0,2,2
37301,1,2,130607,130608,130610,1,3,0
37302,5,1,130612,130612,130613,0,1,2
37303,2,1,130614,130614,130615,0,1,1
37304,2,3,130616,130616,130619,0,3,1
37305,3,1,130619,130619,130620,0,1,0
37306,1,3,130620,130620,130623,0,3,0
37307,5,1,130625,130625,130626,0,1,2
37308,3,2,130628,130628,130630,0,2,2
37309,4,3,130632,130632,130635,0,3,2
37310,5,3,130637,130637,130640,0,3,2
37311,4,2,130641,130641,130643,0,2,1
37312,4,2,130645,130645,130647,0,2,2
37313,6,2,130651,130651,130653,0,2,4
37314,5,3,130656,130656,130659,0,3,3
37315,3,1,130659,130659,130660,0,1,0
37316,3,3,130662,130662,130665,0,3,2
37317,1,1,130663,130665,130666,2,3,0
37318,1,2,130664,130666,130668,2,4,0
37319,5,2,130669,130669,130671,0,2,1
37320,2,2,130671,130671,130673,0,2,0
37321,1,1,130672,130673,130674,1,2,0
37322,1,1,130673,130674,130675,1,2,0
37323,5,2,130678,130678,130680,0,2,3
37324,1,2,130679,130680,130682,1,3,0
37325,1,3,130680,130682,130685,2,5,0
37326,5,1,130685,130685,130686,0,1,0
37327,5,3,130690,130690,130693,0,3,4
37328,3,3,130693,130693,130696,0,3,0
37329,3,1,130696,130696,130697,0,1,0
37330,4,3,130700,130700,130703,0,3,3
37331,6,1,130706,130706,130707,0,1,3
37332,6,1,130712,130712,130713,0,1,5
37333,3,2,130715,130715,130717,0,2,2
37334,3,3,130718,130718,130721,0,3,1
37335,1,1,130719,130721,130722,2,3,0
37336,2,3,130721,130722,130725,1,4,0
37337,3,2,130724,130725,130727,1,3,0
37338,5,2,130729,130729,130731,0,2,2
37339,6,2,130735,130735,130737,0,2,4
37340,3,3,130738,130738,130741,0,3,1
37341,6,1,130744,130744,130745,0,1,3
37342,6,2,130750,130750,130752,0,2,5
37343,6,2,130756,130756,130758,0,2,4
37344,4,2,130760,130760,130762,0,2,2
37345,4,2,130764,130764,130766,0,2,2
37346,6,2,130770,130770,130772,0,2,4
37347,3,3,130773,130773,130776,0,3,1
37348,4,2,130777,130777,130779,0,2,1
37349,4,2,130781,130781,130783,0,2,2
37350,4,1,130785,130785,130786,0,1,2
37351,5,1,130790,130790,130791,0,1,4
37352,4,3,130794,130794,130797,0,3,3
37353,1,3,130795,130797,130800,2,5,0
37354,6,1,130801,130801,130802,0,1,1
37355,6,1,130807,130807,130808,0,1,5
37356,6,1,130813,130813,130814,0,1,5
37357,2,2,130815,130815,130817,0,2,1
37358,4,1,130819,130819,130820,0,1,2
37359,3,1,130822,130822,130823,0,1,2
37360,6,1,130828,130828,130829,0,1,5
37361,1,2,130829,130829,130831,0,2,0
37362,1,1,130830,130831,130832,1,2,0
37363,5,3,130835,130835,130838,0,3,3
37364,2,3,130837,130838,130841,1,4,0
37365,5,2,130842,130842,130844,0,2,1
37366,3,3,130845,130845,130848,0,3,1
37367,4,2,130849,130849,130851,0,2,1
37368,4,1,130853,130853,130854,0,1,2
37369,2,2,130855,130855,130857,0,2,1
37370,6,3,130861,130861,130864,0,3,4
37371,3,1,130864,130864,130865,0,1,0
37372,3,3,130867,130867,130870,0,3,2
37373,1,2,130868,130870,130872,2,4,0
37374,2,3,130870,130872,130875,2,5,0
37375,6,3,130876,130876,130879,0,3,1
37376,5,2,130881,130881,130883,0,2,2
37377,3,1,130884,130884,130885,0,1,1
37378,4,3,130888,130888,130891,0,3,3
37379,4,2,130892,130892,130894,0,2,1
37380,4,2,130896,130896,130898,0,2,2
37381,5,1,130901,130901,130902,0,1,3
37382,3,2,130904,130904,130906,0,2,2
37383,5,2,130909,130909,130911,0,2,3
37384,5,2,130914,130914,130916,0,2,3
37385,3,3,130917,130917,130920,0,3,1
37386,3,3,130920,130920,130923,0,3,0
37387,2,3,130922,130923,130926,1,4,0
37388,2,2,130924,130926,130928,2,4,0
37389,4,3,130928,130928,130931,0,3,0
37390,4,2,130932,130932,130934,0,2,1
37391,4,1,130936,130936,130937,0,1,2
37392,1,2,130937,130937,130939,0,2,0
37393,2,2,130939,130939,130941,0,2,0
37394,5,3,130944,130944,130947,0,3,3
37395,4,1,130948,130948,130949,0,1,1
37396,5,3,130953,130953,130956,0,3,4
37397,3,1,130956,130956,130957,0,1,0
37398,6,1,130962,130962,130963,0,1,5
37399,1,1,130963,130963,130964,0,1,0
37400,4,2,130967,130967,130969,0,2,3
37401,1,2,130968,130969,130971,1,3,0
37402,6,3,130974,130974,130977,0,3,3
37403,4,2,130978,130978,130980,0,2,1
37404,5,1,130983,130983,130984,0,1,3
37405,3,3,130986,130986,130989,0,3,2
37406,6,1,130992,130992,130993,0,1,3
37407,4,1,130996,130996,130997,0,1,3
37408,6,3,131002,131002,131005,0,3,5
37409,1,1,131003,131005,131006,2,3,0
37410,3,3,131006,131006,131009,0,3,0
37411,3,3,131009,131009,131012,0,3,0
37412,6,2,131015,131015,131017,0,2,3
37413,3,2,131018,131018,131020,0,2,1
37414,3,2,131021,131021,131023,0,2,1
37415,6,3,131027,131027,131030,0,3,4
37416,3,3,131030,131030,131033,0,3,0
37417,2,2,131032,131033,131035,1,3,0
37418,2,1,131034,131035,131036,1,2,0
37419,2,3,131036,131036,131039,0,3,0
37420,3,3,131039,131039,131042,0,3,0
37421,5,1,131044,131044,131045,0,1,2
37422,2,3,131046,131046,131049,0,3,1
37423,1,2,131047,131049,131051,2,4,0
37424,6,1,131053,131053,131054,0,1,2
37425,3,3,131056,131056,131059,0,3,2
37426,2,1,131058,131059,131060,1,2,0
37427,2,2,131060,131060,131062,0,2,0
37428,4,2,131064,131064,131066,0,2,2
37429,6,2,131070,131070,131072,0,2,4
37430,1,2,131071,131072,131074,1,3,0
37431,6,2,131077,131077,131079,0,2,3
37432,6,3,131083,131083,131086,0,3,4
37433,4,2,131087,131087,131089,0,2,1
37434,4,2,131091,131091,131093,0,2,2
37435,2,2,131093,131093,131095,0,2,0
37436,2,2,131095,131095,131097,0,2,0
37437,1,2,131096,131097,131099,1,3,0
37438,2,2,131098,131099,131101,1,3,0
37439,6,2,131104,131104,131106,0,2,3
37440,2,1,131106,131106,131107,0,1,0
37441,4,2,131110,131110,131112,0,2,3
37442,6,3,131116,131116,131119,0,3,4
37443,1,1,131117,131119,131120,2,3,0
37444,3,3,131120,131120,131123,0,3,0
37445,5,3,131125,131125,131128,0,3,2
37446,2,1,131127,131128,131129,1,2,0
37447,1,2,131128,131129,131131,1,3,0
37448,5,1,131133,131133,131134,0,1,2
37449,2,1,131135,131135,131136,0,1,1
37450,2,1,131137,131137,131138,0,1,1
37451,1,3,131138,131138,131141,0,3,0
37452,5,2,131143,131143,131145,0,2,2
37453,5,2,131148,131148,131150,0,2,3
37454,2,3,131150,131150,131153,0,3,0
37455,4,1,131154,131154,131155,0,1,1
37456,4,1,131158,131158,131159,0,1,3
37457,4,1,131162,131162,131163,0,1,3
37458,6,1,131168,131168,131169,0,1,5
37459,1,1,131169,131169,131170,0,1,0
37460,5,2,131174,131174,131176,0,2,4
37461,6,3,131180,131180,131183,0,3,4
37462,4,1,131184,131184,131185,0,1,1
37463,1,1,131185,131185,131186,0,1,0
37464,1,2,131186,131186,131188,0,2,0
37465,6,1,131192,131192,131193,0,1,4
37466,3,1,131195,131195,131196,0,1,2
37467,4,3,131199,131199,131202,0,3,3
37468,1,2,131200,131202,131204,2,4,0
37469,1,2,131201,131204,131206,3,5,0
37470,5,2,131206,131206,131208,0,2,0
37471,4,2,131210,131210,131212,0,2,2
37472,5,2,131215,131215,131217,0,2,3
37473,6,3,131221,131221,131224,0,3,4
37474,1,2,131222,131224,131226,2,4,0
37475,6,2,131228,131228,131230,0,2,2
37476,6,3,131234,131234,131237,0,3,4
37477,1,3,131235,131237,131240,2,5,0
37478,1,2,131236,131240,131242,4,6,0
37479,2,1,131238,131242,131243,4,5,0
37480,2,1,131240,131243,131244,3,4,0
37481,1,1,131241,131244,131245,3,4,0
37482,5,2,131246,131246,131248,0,2,1
37483,4,2,131250,131250,131252,0,2,2
37484,2,1,131252,131252,131253,0,1,0
37485,5,2,131257,131257,131259,0,2,4
37486,4,3,131261,131261,131264,0,3,2
37487,3,3,131264,131264,131267,0,3,0
37488,6,2,131270,131270,131272,0,2,3
37489,4,1,131274,131274,131275,0,1,2
37490,3,3,131277,131277,131280,0,3,2
37491,2,2,131279,131280,131282,1,3,0
37492,4,1,131283,131283,131284,0,1,1
37493,3,3,131286,131286,131289,0,3,2
37494,1,2,131287,131289,131291,2,4,0
37495,2,3,131289,131291,131294,2,5,0
37496,5,3,131294,131294,131297,0,3,0
37497,1,3,131295,131297,131300,2,5,0
37498,6,3,131301,131301,131304,0,3,1
37499,5,1,131306,131306,131307,0,1,2
37500,5,3,131311,131311,131314,0,3,4
37501,2,1,131313,131314,131315,1,2,0
37502,3,2,131316,131316,131318,0,2,1
37503,4,3,131320,131320,131323,0,3,2
37504,6,1,131326,131326,131327,0,1,3
37505,5,3,131331,131331,131334,0,3,4
37506,2,1,131333,131334,131335,1,2,0
37507,3,2,131336,131336,131338,0,2,1
37508,5,1,131341,131341,131342,0,1,3
37509,2,3,131343,131343,131346,0,3,1
37510,2,3,131345,131346,131349,1,4,0
37511,2,3,131347,131349,131352,2,5,0
37512,1,3,131348,131352,131355,4,7,0
37513,3,1,131351,131355,131356,4,5,0
37514,4,1,131355,131356,131357,1,2,0
37515,6,3,131361,131361,131364,0,3,4
37516,2,2,131363,131364,131366,1,3,0
37517,4,1,131367,131367,131368,0,1,1
37518,2,3,131369,131369,131372,0,3,1
37519,1,3,131370,131372,131375,2,5,0
37520,3,2,131373,131375,131377,2,4,0
37521,6,2,131379,131379,131381,0,2,2
37522,4,3,131383,131383,131386,0,3,2
37523,4,3,131387,131387,131390,0,3,1
37524,6,3,131393,131393,131396,0,3,3
37525,1,2,131394,131396,131398,2,4,0
37526,6,2,131400,131400,131402,0,2,2
37527,3,2,131403,131403,131405,0,2,1
37528,2,3,131405,131405,131408,0,3,0
37529,1,2,131406,131408,131410,2,4,0
37530,5,1,131411,131411,131412,0,1,1
37531,2,2,131413,131413,131415,0,2,1
37532,1,3,131414,131415,131418,1,4,0
37533,2,3,131416,131418,131421,2,5,0
37534,1,2,131417,131421,131423,4,6,0
37535,3,1,131420,131423,131424,3,4,0
37536,1,2,131421,131424,131426,3,5,0
37537,4,3,131425,131426,131429,1,4,0
37538,2,1,131427,131429,131430,2,3,0
37539,5,3,131432,131432,131435,0,3,2
37540,4,1,131436,131436,131437,0,1,1
37541,4,3,131440,131440,131443,0,3,3
37542,6,1,131446,131446,131447,0,1,3
37543,2,2,131448,131448,131450,0,2,1
37544,1,2,131449,131450,131452,1,3,0
37545,4,1,131453,131453,131454,0,1,1
37546,3,3,131456,131456,131459,0,3,2
37547,2,3,131458,131459,131462,1,4,0
37548,3,1,131461,131462,131463,1,2,0
37549,4,3,131465,131465,131468,0,3,2
37550,5,2,131470,131470,131472,0,2,2
37551,3,1,131473,131473,131474,0,1,1
37552,3,2,131476,131476,131478,0,2,2
37553,3,2,131479,131479,131481,0,2,1
37554,4,2,131483,131483,131485,0,2,2
37555,1,1,131484,131485,131486,1,2,0
37556,3,2,131487,131487,131489,0,2,1
37557,2,2,131489,131489,131491,0,2,0
37558,5,1,131494,131494,131495,0,1,3
37559,6,1,131500,131500,131501,0,1,5
37560,5,1,131505,131505,131506,0,1,4
37561,1,2,131506,131506,131508,0,2,0
37562,2,2,131508,131508,131510,0,2,0
37563,2,1,131510,131510,131511,0,1,0
37564,5,2,131515,131515,131517,0,2,4
37565,1,1,131516,131517,131518,1,2,0
37566,1,3,131517,131518,131521,1,4,0
37567,4,2,131521,131521,131523,0,2,0
37568,6,2,131527,131527,131529,0,2,4
37569,2,1,131529,131529,131530,0,1,0
37570,2,1,131531,131531,131532,0,1,1
37571,2,3,131533,131533,131536,0,3,1
37572,3,1,131536,131536,131537,0,1,0
37573,2,3,131538,131538,131541,0,3,1
37574,3,1,131541,131541,131542,0,1,0
37575,2,1,131543,131543,131544,0,1,1
37576,5,2,131548,131548,131550,0,2,4
37577,3,3,131551,131551,131554,0,3,1
37578,4,3,131555,131555,131558,0,3,1
37579,5,3,131560,131560,131563,0,3,2
37580,5,2,131565,131565,131567,0,2,2
37581,3,3,131568,131568,131571,0,3,1
37582,1,2,131569,131571,131573,2,4,0
37583,4,2,131573,131573,131575,0,2,0
37584,3,3,131576,131576,131579,0,3,1
37585,2,2,131578,131579,131581,1,3,0
37586,4,1,131582,131582,131583,0,1,1
37587,6,3,131588,131588,131591,0,3,5
37588,3,2,131591,131591,131593,0,2,0
37589,2,3,131593,131593,131596,0,3,0
37590,4,1,131597,131597,131598,0,1,1
37591,2,1,131599,131599,131600,0,1,1
37592,6,3,131605,131605,131608,0,3,5
37593,3,3,131608,131608,131611,0,3,0
37594,2,2,131610,131611,131613,1,3,0
37595,2,1,131612,131613,131614,1,2,0
37596,4,1,131616,131616,131617,0,1,2
37597,4,3,131620,131620,131623,0,3,3
37598,6,1,131626,131626,131627,0,1,3
37599,3,3,131629,131629,131632,0,3,2
37600,6,2,131635,131635,131637,0,2,3
37601,1,3,131636,131637,131640,1,4,0
37602,4,3,131640,131640,131643,0,3,0
37603,2,1,131642,131643,131644,1,2,0
37604,6,3,131648,131648,131651,0,3,4
37605,3,3,131651,131651,131654,0,3,0
37606,4,3,131655,131655,131658,0,3,1
37607,4,1,131659,131659,131660,0,1,1
37608,2,3,131661,131661,131664,0,3,1
37609,2,3,131663,131664,131667,1,4,0
37610,5,2,131668,131668,131670,0,2,1
37611,1,3,131669,131670,131673,1,4,0
37612,4,2,131673,131673,131675,0,2,0
37613,4,3,131677,131677,131680,0,3,2
37614,4,3,131681,131681,131684,0,3,1
37615,2,3,131683,131684,131687,1,4,0
37616,3,3,131686,131687,131690,1,4,0
37617,3,3,131689,131690,131693,1,4,0
37618,5,1,131694,131694,131695,0,1,1
37619,1,1,131695,131695,131696,0,1,0
37620,3,3,131698,131698,131701,0,3,2
37621,6,1,131704,131704,131705,0,1,3
37622,1,2,131705,131705,131707,0,2,0
37623,4,3,131709,131709,131712,0,3,2
37624,3,3,131712,131712,131715,0,3,0
37625,5,3,131717,131717,131720,0,3,2
37626,2,2,131719,131720,131722,1,3,0
37627,6,3,131725,131725,131728,0,3,3
37628,4,1,131729,131729,131730,0,1,1
37629,3,2,131732,131732,131734,0,2,2
37630,1,2,131733,131734,131736,1,3,0
37631,1,1,131734,131736,131737,2,3,0
37632,6,3,131740,131740,131743,0,3,3
37633,4,3,131744,131744,131747,0,3,1
37634,1,2,131745,131747,131749,2,4,0
37635,3,2,131748,131749,131751,1,3,0
37636,1,1,131749,131751,131752,2,3,0
37637,4,3,131753,131753,131756,0,3,1
37638,3,2,131756,131756,131758,0,2,0
37639,3,2,131759,131759,131761,0,2,1
37640,2,2,131761,131761,131763,0,2,0
37641,3,1,131764,131764,131765,0,1,1
37642,4,2,131768,131768,131770,0,2,3
37643,3,3,131771,131771,131774,0,3,1
37644,3,2,131774,131774,131776,0,2,0
37645,6,2,131780,131780,131782,0,2,4
37646,6,3,131786,131786,131789,0,3,4
37647,5,1,131791,131791,131792,0,1,2
37648,5,2,131796,131796,131798,0,2,4
37649,2,3,131798,131798,131801,0,3,0
37650,2,3,131800,131801,131804,1,4,0
37651,6,1,131806,131806,131807,0,1,2
37652,4,1,131810,131810,131811,0,1,3
37653,2,3,131812,131812,131815,0,3,1
37654,4,2,131816,131816,131818,0,2,1
37655,4,1,131820,131820,131821,0,1,2
37656,6,2,131826,131826,131828,0,2,5
37657,3,1,131829,131829,131830,0,1,1
37658,1,3,131830,131830,131833,0,3,0
37659,1,2,131831,131833,131835,2,4,0
37660,3,3,131834,131835,131838,1,4,0
37661,6,3,131840,131840,131843,0,3,2
37662,3,2,131843,131843,131845,0,2,0
37663,6,2,131849,131849,131851,0,2,4
37664,4,1,131853,131853,131854,0,1,2
37665,6,1,131859,131859,131860,0,1,5
37666,6,1,131865,131865,131866,0,1,5
37667,3,1,131868,131868,131869,0,1,2
37668,4,3,131872,131872,131875,0,3,3
37669,2,3,131874,131875,131878,1,4,0
37670,2,3,131876,131878,131881,2,5,0
37671,2,3,131878,131881,131884,3,6,0
37672,4,3,131882,131884,131887,2,5,0
37673,4,3,131886,131887,131890,1,4,0
37674,2,2,131888,131890,131892,2,4,0
37675,4,3,131892,131892,131895,0,3,0
37676,5,1,131897,131897,131898,0,1,2
37677,1,1,131898,131898,131899,0,1,0
37678,5,2,131903,131903,131905,0,2,4
37679,2,3,131905,131905,131908,0,3,0
37680,2,1,131907,131908,131909,1,2,0
37681,4,3,131911,131911,131914,0,3,2
37682,3,1,131914,131914,131915,0,1,0
37683,6,3,131920,131920,131923,0,3,5
37684,2,1,131922,131923,131924,1,2,0
37685,5,1,131927,131927,131928,0,1,3
37686,2,3,131929,131929,131932,0,3,1
37687,1,2,131930,131932,131934,2,4,0
37688,4,1,131934,131934,131935,0,1,0
37689,6,1,131940,131940,131941,0,1,5
37690,1,1,131941,131941,131942,0,1,0
37691,3,3,131944,131944,131947,0,3,2
37692,2,3,131946,131947,131950,1,4,0
37693,1,1,131947,131950,131951,3,4,0
37694,6,2,131953,131953,131955,0,2,2
37695,2,3,131955,131955,131958,0,3,0
37696,6,1,131961,131961,131962,0,1,3
37697,4,3,131965,131965,131968,0,3,3
37698,2,2,131967,131968,131970,1,3,0
37699,6,2,131973,131973,131975,0,2,3
37700,6,2,131979,131979,131981,0,2,4
37701,6,2,131985,131985,131987,0,2,4
37702,6,1,131991,131991,131992,0,1,4
37703,3,3,131994,131994,131997,0,3,2
37704,4,2,131998,131998,132000,0,2,1
37705,2,2,132000,132000,132002,0,2,0
37706,2,1,132002,132002,132003,0,1,0
37707,1,2,132003,132003,132005,0,2,0
37708,6,3,132009,132009,132012,0,3,4
37709,2,1,132011,132012,132013,1,2,0
37710,4,1,132015,132015,132016,0,1,2
37711,4,2,132019,132019,132021,0,2,3
37712,3,2,132022,132022,132024,0,2,1
37713,6,3,132028,132028,132031,0,3,4
37714,1,3,132029,132031,132034,2,5,0
37715,4,1,132033,132034,132035,1,2,0
37716,5,2,132038,132038,132040,0,2,3
37717,5,2,132043,132043,132045,0,2,3
37718,6,2,132049,132049,132051,0,2,4
37719,3,3,132052,132052,132055,0,3,1
37720,2,3,132054,132055,132058,1,4,0
37721,5,1,132059,132059,132060,0,1,1
37722,1,1,132060,132060,132061,0,1,0
37723,3,2,132063,132063,132065,0,2,2
37724,4,3,132067,132067,132070,0,3,2
37725,1,1,132068,132070,132071,2,3,0
37726,3,2,132071,132071,132073,0,2,0
37727,5,1,132076,132076,132077,0,1,3
37728,1,1,132077,132077,132078,0,1,0
37729,4,1,132081,132081,132082,0,1,3
37730,2,3,132083,132083,132086,0,3,1
37731,3,3,132086,132086,132089,0,3,0
37732,4,3,132090,132090,132093,0,3,1
37733,4,2,132094,132094,132096,0,2,1
37734,4,3,132098,132098,132101,0,3,2
37735,1,2,132099,132101,132103,2,4,0
37736,5,3,132104,132104,132107,0,3,1
37737,5,2,132109,132109,132111,0,2,2
37738,4,2,132113,132113,132115,0,2,2
37739,4,2,132117,132117,132119,0,2,2
37740,6,1,132123,132123,132124,0,1,4
37741,4,3,132127,132127,132130,0,3,3
37742,1,3,132128,132130,132133,2,5,0
37743,6,3,132134,132134,132137,0,3,1
37744,6,2,132140,132140,132142,0,2,3
37745,4,3,132144,132144,132147,0,3,2
37746,1,2,132145,132147,132149,2,4,0
37747,1,3,132146,132149,132152,3,6,0
37748,2,2,132148,132152,132154,4,6,0
37749,1,1,132149,132154,132155,5,6,0
37750,2,1,132151,132155,132156,4,5,0
37751,4,1,132155,132156,132157,1,2,0
37752,4,3,132159,132159,132162,0,3,2
37753,5,3,132164,132164,132167,0,3,2
37754,4,2,132168,132168,132170,0,2,1
37755,4,3,132172,132172,132175,0,3,2
37756,2,1,132174,132175,132176,1,2,0
37757,5,1,132179,132179,132180,0,1,3
37758,6,3,132185,132185,132188,0,3,5
37759,5,3,132190,132190,132193,0,3,2
37760,1,2,132191,132193,132195,2,4,0
37761,6,1,132197,132197,132198,0,1,2
37762,6,3,132203,132203,132206,0,3,5
37763,6,3,132209,132209,132212,0,3,3
37764,6,3,132215,132215,132218,0,3,3
37765,1,1,132216,132218,132219,2,3,0
37766,4,2,132220,132220,132222,0,2,1
37767,6,1,132226,132226,132227,0,1,4
37768,5,1,132231,132231,132232,0,1,4
37769,3,1,132234,132234,132235,0,1,2
37770,3,3,132237,132237,132240,0,3,2
37771,5,2,132242,132242,132244,0,2,2
37772,2,1,132244,132244,132245,0,1,0
37773,1,2,132245,132245,132247,0,2,0
37774,2,2,132247,132247,132249,0,2,0
37775,3,1,132250,132250,132251,0,1,1
37776,6,3,132256,132256,132259,0,3,5
37777,3,3,132259,132259,132262,0,3,0
37778,5,3,132264,132264,132267,0,3,2
37779,5,2,132269,132269,132271,0,2,2
37780,1,1,132270,132271,132272,1,2,0
37781,6,1,132276,132276,132277,0,1,4
37782,4,1,132280,132280,132281,0,1,3
37783,3,1,132283,132283,132284,0,1,2
37784,5,1,132288,132288,132289,0,1,4
37785,5,3,132293,132293,132296,0,3,4
37786,1,3,132294,132296,132299,2,5,0
37787,3,2,132297,132299,132301,2,4,0
37788,5,3,132302,132302,132305,0,3,1
37789,1,3,132303,132305,132308,2,5,0
37790,2,3,132305,132308,132311,3,6,0
37791,1,1,132306,132311,132312,5,6,0
37792,5,2,132311,132312,132314,1,3,0
37793,2,1,132313,132314,132315,1,2,0
37794,3,3,132316,132316,132319,0,3,1
37795,2,2,132318,132319,132321,1,3,0
37796,2,1,132320,132321,132322,1,2,0
37797,5,3,132325,132325,132328,0,3,3
37798,3,3,132328,132328,132331,0,3,0
37799,4,2,132332,132332,132334,0,2,1
37800,2,2,132334,132334,132336,0,2,0
37801,6,1,132340,132340,132341,0,1,4
37802,3,1,132343,132343,132344,0,1,2
37803,4,3,132347,132347,132350,0,3,3
37804,3,2,132350,132350,132352,0,2,0
37805,5,1,132355,132355,132356,0,1,3
37806,1,3,132356,132356,132359,0,3,0
37807,3,1,132359,132359,132360,0,1,0
37808,4,2,132363,132363,132365,0,2,3
37809,4,3,132367,132367,132370,0,3,2
37810,6,3,132373,132373,132376,0,3,3
37811,6,1,132379,132379,132380,0,1,3
37812,3,3,132382,132382,132385,0,3,2
37813,2,3,132384,132385,132388,1,4,0
37814,2,3,132386,132388,132391,2,5,0
37815,1,3,132387,132391,132394,4,7,0
37816,5,3,132392,132394,132397,2,5,0
37817,4,3,132396,132397,132400,1,4,0
37818,3,2,132399,132400,132402,1,3,0
37819,6,2,132405,132405,132407,0,2,3
37820,2,2,132407,132407,132409,0,2,0
37821,5,3,132412,132412,132415,0,3,3
37822,1,1,132413,132415,132416,2,3,0
37823,5,1,132418,132418,132419,0,1,2
37824,1,3,132419,132419,132422,0,3,0
37825,4,1,132423,132423,132424,0,1,1
37826,3,1,132426,132426,132427,0,1,2
37827,6,1,132432,132432,132433,0,1,5
37828,1,1,132433,132433,132434,0,1,0
37829,6,1,132439,132439,132440,0,1,5
37830,6,2,132445,132445,132447,0,2,5
37831,6,3,132451,132451,132454,0,3,4
37832,6,3,132457,132457,132460,0,3,3
37833,6,1,132463,132463,132464,0,1,3
37834,6,1,132469,132469,132470,0,1,5
37835,5,3,132474,132474,132477,0,3,4
37836,3,2,132477,132477,132479,0,2,0
37837,1,1,132478,132479,132480,1,2,0
37838,1,2,132479,132480,132482,1,3,0
37839,4,2,132483,132483,132485,0,2,1
37840,3,3,132486,132486,132489,0,3,1
37841,1,3,132487,132489,132492,2,5,0
37842,2,1,132489,132492,132493,3,4,0
37843,4,3,132493,132493,132496,0,3,0
37844,1,3,132494,132496,132499,2,5,0
37845,1,1,132495,132499,132500,4,5,0
37846,1,3,132496,132500,132503,4,7,0
37847,5,1,132501,132503,132504,2,3,0
37848,1,2,132502,132504,132506,2,4,0
37849,5,1,132507,132507,132508,0,1,1
37850,3,3,132510,132510,132513,0,3,2
37851,5,2,132515,132515,132517,0,2,2
37852,6,3,132521,132521,132524,0,3,4
37853,2,2,132523,132524,132526,1,3,0
37854,6,2,132529,132529,132531,0,2,3
37855,2,3,132531,132531,132534,0,3,0
37856,4,2,132535,132535,132537,0,2,1
37857,2,2,132537,132537,132539,0,2,0
37858,3,1,132540,132540,132541,0,1,1
37859,3,2,132543,132543,132545,0,2,2
37860,4,3,132547,132547,132550,0,3,2
37861,2,1,132549,132550,132551,1,2,0
37862,6,3,132555,132555,132558,0,3,4
37863,4,3,132559,132559,132562,0,3,1
37864,1,3,132560,132562,132565,2,5,0
37865,4,3,132564,132565,132568,1,4,0
37866,6,2,132570,132570,132572,0,2,2
37867,1,2,132571,132572,132574,1,3,0
37868,3,2,132574,132574,132576,0,2,0
37869,4,1,132578,132578,132579,0,1,2
37870,3,2,132581,132581,132583,0,2,2
37871,3,2,132584,132584,132586,0,2,1
37872,1,3,132585,132586,132589,1,4,0
37873,2,3,132587,132589,132592,2,5,0
37874,2,1,132589,132592,132593,3,4,0
37875,5,3,132594,132594,132597,0,3,1
37876,4,2,132598,132598,132600,0,2,1
37877,2,2,132600,132600,132602,0,2,0
37878,5,3,132605,132605,132608,0,3,3
37879,6,3,132611,132611,132614,0,3,3
37880,3,3,132614,132614,132617,0,3,0
37881,3,3,132617,132617,132620,0,3,0
37882,5,3,132622,132622,132625,0,3,2
37883,5,1,132627,132627,132628,0,1,2
37884,4,1,132631,132631,132632,0,1,3
37885,4,1,132635,132635,132636,0,1,3
37886,2,3,132637,132637,132640,0,3,1
37887,1,1,132638,132640,132641,2,3,0
37888,1,2,132639,132641,132643,2,4,0
37889,6,1,132645,132645,132646,0,1,2
37890,2,1,132647,132647,132648,0,1,1
37891,2,1,132649,132649,132650,0,1,1
37892,4,2,132653,132653,132655,0,2,3
37893,4,1,132657,132657,132658,0,1,2
37894,5,1,132662,132662,132663,0,1,4
37895,6,3,132668,132668,132671,0,3,5
37896,6,1,132674,132674,132675,0,1,3
37897,3,1,132677,132677,132678,0,1,2
37898,2,2,132679,132679,132681,0,2,1
37899,4,3,132683,132683,132686,0,3,2
37900,4,2,132687,132687,132689,0,2,1
37901,2,1,132689,132689,132690,0,1,0
37902,4,3,132693,132693,132696,0,3,3
37903,4,1,132697,132697,132698,0,1,1
37904,5,2,132702,132702,132704,0,2,4
37905,1,1,132703,132704,132705,1,2,0
37906,1,2,132704,132705,132707,1,3,0
37907,2,1,132706,132707,132708,1,2,0
37908,3,2,132709,132709,132711,0,2,1
37909,6,2,132715,132715,132717,0,2,4
37910,6,3,132721,132721,132724,0,3,4
37911,3,1,132724,132724,132725,0,1,0
37912,3,2,132727,132727,132729,0,2,2
37913,3,1,132730,132730,132731,0,1,1
37914,2,3,132732,132732,132735,0,3,1
37915,3,3,132735,132735,132738,0,3,0
37916,6,3,132741,132741,132744,0,3,3
37917,4,2,132745,132745,132747,0,2,1
37918,2,3,132747,132747,132750,0,3,0
37919,5,3,132752,132752,132755,0,3,2
37920,1,1,132753,132755,132756,2,3,0
37921,4,3,132757,132757,132760,0,3,1
37922,2,1,132759,132760,132761,1,2,0
37923,2,3,132761,132761,132764,0,3,0
37924,4,3,132765,132765,132768,0,3,1
37925,5,3,132770,132770,132773,0,3,2
37926,1,3,132771,132773,132776,2,5,0
37927,6,3,132777,132777,132780,0,3,1
37928,5,2,132782,132782,132784,0,2,2
37929,6,1,132788,132788,132789,0,1,4
37930,3,1,132791,132791,132792,0,1,2
37931,4,1,132795,132795,132796,0,1,3
37932,3,1,132798,132798,132799,0,1,2
37933,4,2,132802,132802,132804,0,2,3
37934,3,3,132805,132805,132808,0,3,1
37935,4,3,132809,132809,132812,0,3,1
37936,1,1,132810,132812,132813,2,3,0
37937,4,1,132814,132814,132815,0,1,1
37938,6,3,132820,132820,132823,0,3,5
37939,3,3,132823,132823,132826,0,3,0
37940,2,3,132825,132826,132829,1,4,0
37941,2,2,132827,132829,132831,2,4,0
37942,4,2,132831,132831,132833,0,2,0
37943,4,2,132835,132835,132837,0,2,2
37944,3,1,132838,132838,132839,0,1,1
37945,1,3,132839,132839,132842,0,3,0
37946,2,3,132841,132842,132845,1,4,0
37947,5,1,132846,132846,132847,0,1,1
37948,5,3,132851,132851,132854,0,3,4
37949,1,2,132852,132854,132856,2,4,0
37950,3,1,132855,132856,132857,1,2,0
37951,2,3,132857,132857,132860,0,3,0
37952,6,1,132863,132863,132864,0,1,3
37953,5,3,132868,132868,132871,0,3,4
37954,4,2,132872,132872,132874,0,2,1
37955,4,1,132876,132876,132877,0,1,2
37956,6,2,132882,132882,132884,0,2,5
37957,4,2,132886,132886,132888,0,2,2
37958,6,3,132892,132892,132895,0,3,4
37959,6,3,132898,132898,132901,0,3,3
37960,1,2,132899,132901,132903,2,4,0
37961,4,1,132903,132903,132904,0,1,0
37962,2,2,132905,132905,132907,0,2,1
37963,6,2,132911,132911,132913,0,2,4
37964,1,2,132912,132913,132915,1,3,0
37965,6,3,132918,132918,132921,0,3,3
37966,6,3,132924,132924,132927,0,3,3
37967,3,3,132927,132927,132930,0,3,0
37968,3,2,132930,132930,132932,0,2,0
37969,5,3,132935,132935,132938,0,3,3
37970,6,3,132941,132941,132944,0,3,3
37971,2,3,132943,132944,132947,1,4,0
37972,1,2,132944,132947,132949,3,5,0
37973,6,1,132950,132950,132951,0,1,1
37974,4,1,132954,132954,132955,0,1,3
37975,6,3,132960,132960,132963,0,3,5
37976,4,1,132964,132964,132965,0,1,1
37977,5,3,132969,132969,132972,0,3,4
37978,3,3,132972,132972,132975,0,3,0
37979,1,1,132973,132975,132976,2,3,0
37980,6,1,132979,132979,132980,0,1,3
37981,3,3,132982,132982,132985,0,3,2
37982,1,2,132983,132985,132987,2,4,0
37983,1,2,132984,132987,132989,3,5,0
37984,2,3,132986,132989,132992,3,6,0
37985,4,1,132990,132992,132993,2,3,0
37986,6,1,132996,132996,132997,0,1,3
37987,2,1,132998,132998,132999,0,1,1
37988,4,1,133002,133002,133003,0,1,3
37989,5,1,133007,133007,133008,0,1,4
37990,5,3,133012,133012,133015,0,3,4
37991,2,2,133014,133015,133017,1,3,0
37992,6,3,133020,133020,133023,0,3,3
37993,1,2,133021,133023,133025,2,4,0
37994,1,3,133022,133025,133028,3,6,0
37995,4,1,133026,133028,133029,2,3,0
37996,5,2,133031,133031,133033,0,2,2
37997,6,1,133037,133037,133038,0,1,4
37998,3,3,133040,133040,133043,0,3,2
37999,4,2,133044,133044,133046,0,2,1
38000,2,2,133046,133046,133048,0,2,0
38001,4,3,133050,133050,133053,0,3,2
38002,1,2,133051,133053,133055,2,4,0
38003,5,1,133056,133056,133057,0,1,1
38004,1,1,133057,133057,133058,0,1,0
38005,2,2,133059,133059,133061,0,2,1
38006,2,3,133061,133061,133064,0,3,0
38007,4,3,133065,133065,133068,0,3,1
38008,4,3,133069,133069,133072,0,3,1
38009,3,1,133072,133072,133073,0,1,0
38010,4,1,133076,133076,133077,0,1,3
38011,6,1,133082,133082,133083,0,1,5
38012,1,1,133083,133083,133084,0,1,0
38013,4,2,133087,133087,133089,0,2,3
38014,3,1,133090,133090,133091,0,1,1
38015,2,2,133092,133092,133094,0,2,1
38016,5,2,133097,133097,133099,0,2,3
38017,5,3,133102,133102,133105,0,3,3
38018,6,2,133108,133108,133110,0,2,3
38019,1,2,133109,133110,133112,1,3,0
38020,1,3,133110,133112,133115,2,5,0
38021,2,1,133112,133115,133116,3,4,0
38022,6,2,133118,133118,133120,0,2,2
38023,2,3,133120,133120,133123,0,3,0
38024,2,3,133122,133123,133126,1,4,0
38025,6,3,133128,133128,133131,0,3,2
38026,1,2,133129,133131,133133,2,4,0
38027,1,2,133130,133133,133135,3,5,0
38028,3,3,133133,133135,133138,2,5,0
38029,1,1,133134,133138,133139,4,5,0
38030,3,2,133137,133139,133141,2,4,0
38031,3,3,133140,133141,133144,1,4,0
38032,3,2,133143,133144,133146,1,3,0
38033,6,1,133149,133149,133150,0,1,3
38034,6,3,133155,133155,133158,0,3,5
38035,3,3,133158,133158,133161,0,3,0
38036,5,2,133163,133163,133165,0,2,2
38037,5,3,133168,133168,133171,0,3,3
38038,3,3,133171,133171,133174,0,3,0
38039,2,2,133173,133174,133176,1,3,0
38040,1,1,133174,133176,133177,2,3,0
38041,1,3,133175,133177,133180,2,5,0
38042,2,2,133177,133180,133182,3,5,0
38043,5,1,133182,133182,133183,0,1,0
38044,5,3,133187,133187,133190,0,3,4
38045,2,1,133189,133190,133191,1,2,0
38046,6,1,133195,133195,133196,0,1,4
38047,1,3,133196,133196,133199,0,3,0
38048,5,3,133201,133201,133204,0,3,2
38049,4,1,133205,133205,133206,0,1,1
38050,2,1,133207,133207,133208,0,1,1
38051,3,3,133210,133210,133213,0,3,2
38052,1,3,133211,133213,133216,2,5,0
38053,5,3,133216,133216,133219,0,3,0
38054,2,3,133218,133219,133222,1,4,0
38055,6,2,133224,133224,133226,0,2,2
38056,5,1,133229,133229,133230,0,1,3
38057,3,2,133232,133232,133234,0,2,2
38058,6,1,133238,133238,133239,0,1,4
38059,3,3,133241,133241,133244,0,3,2
38060,2,1,133243,133244,133245,1,2,0
38061,1,1,133244,133245,133246,1,2,0
38062,2,1,133246,133246,133247,0,1,0
38063,1,1,133247,133247,133248,0,1,0
38064,3,2,133250,133250,133252,0,2,2
38065,1,3,133251,133252,133255,1,4,0
38066,5,3,133256,133256,133259,0,3,1
38067,3,3,133259,133259,133262,0,3,0
38068,5,2,133264,133264,133266,0,2,2
38069,5,2,133269,133269,133271,0,2,3
38070,1,2,133270,133271,133273,1,3,0
38071,5,2,133275,133275,133277,0,2,2
38072,5,2,133280,133280,133282,0,2,3
38073,3,1,133283,133283,133284,0,1,1
38074,1,3,133284,133284,133287,0,3,0
38075,6,2,133290,133290,133292,0,2,3
38076,4,1,133294,133294,133295,0,1,2
38077,4,2,133298,133298,133300,0,2,3
38078,2,1,133300,133300,133301,0,1,0
38079,5,3,133305,133305,133308,0,3,4
38080,3,1,133308,133308,133309,0,1,0
38081,5,3,133313,133313,133316,0,3,4
38082,4,1,133317,133317,133318,0,1,1
38083,3,1,133320,133320,133321,0,1,2
38084,3,3,133323,133323,133326,0,3,2
38085,6,3,133329,133329,133332,0,3,3
38086,6,1,133335,133335,133336,0,1,3
38087,6,1,133341,133341,133342,0,1,5
38088,4,3,133345,133345,133348,0,3,3
38089,3,1,133348,133348,133349,0,1,0
38090,4,1,133352,133352,133353,0,1,3
38091,1,3,133353,133353,133356,0,3,0
38092,5,2,133358,133358,133360,0,2,2
38093,1,3,133359,133360,133363,1,4,0
38094,2,1,133361,133363,133364,2,3,0
38095,4,1,133365,133365,133366,0,1,1
38096,5,1,133370,133370,133371,0,1,4
38097,6,2,133376,133376,133378,0,2,5
38098,5,2,133381,133381,133383,0,2,3
38099,4,1,133385,133385,133386,0,1,2
38100,4,3,133389,133389,133392,0,3,3
38101,4,1,133393,133393,133394,0,1,1
38102,6,1,133399,133399,133400,0,1,5
38103,3,3,133402,133402,133405,0,3,2
38104,4,3,133406,133406,133409,0,3,1
38105,4,3,133410,133410,133413,0,3,1
38106,6,2,133416,133416,133418,0,2,3
38107,2,3,133418,133418,133421,0,3,0
38108,2,1,133420,133421,133422,1,2,0
38109,6,1,133426,133426,133427,0,1,4
38110,2,1,133428,133428,133429,0,1,1
38111,5,1,133433,133433,133434,0,1,4
38112,5,2,133438,133438,133440,0,2,4
38113,1,3,133439,133440,133443,1,4,0
38114,4,1,133443,133443,133444,0,1,0
38115,2,2,133445,133445,133447,0,2,1
38116,5,1,133450,133450,133451,0,1,3
38117,2,2,133452,133452,133454,0,2,1
38118,5,1,133457,133457,133458,0,1,3
38119,3,2,133460,133460,133462,0,2,2
38120,3,3,133463,133463,133466,0,3,1
38121,2,1,133465,133466,133467,1,2,0
38122,5,1,133470,133470,133471,0,1,3
38123,1,1,133471,133471,133472,0,1,0
38124,1,2,133472,133472,133474,0,2,0
38125,6,3,133478,133478,133481,0,3,4
38126,6,3,133484,133484,133487,0,3,3
38127,6,3,133490,133490,133493,0,3,3
38128,1,1,133491,133493,133494,2,3,0
38129,6,1,133497,133497,133498,0,1,3
38130,1,1,133498,133498,133499,0,1,0
38131,1,3,133499,133499,133502,0,3,0
38132,1,1,133500,133502,133503,2,3,0
38133,1,1,133501,133503,133504,2,3,0
38134,3,3,133504,133504,133507,0,3,0
38135,1,3,133505,133507,133510,2,5,0
38136,1,3,133506,133510,133513,4,7,0
38137,5,3,133511,133513,133516,2,5,0
38138,3,1,133514,133516,133517,2,3,0
38139,4,2,133518,133518,133520,0,2,1
38140,6,2,133524,133524,133526,0,2,4
38141,3,2,133527,133527,133529,0,2,1
38142,1,3,133528,133529,133532,1,4,0
38143,1,3,133529,133532,133535,3,6,0
38144,2,1,133531,133535,133536,4,5,0
38145,4,2,133535,133536,133538,1,3,0
38146,1,2,133536,133538,133540,2,4,0
38147,2,2,133538,133540,133542,2,4,0
38148,3,1,133541,133542,133543,1,2,0
38149,6,2,133547,133547,133549,0,2,4
38150,2,1,133549,133549,133550,0,1,0
38151,4,2,133553,133553,133555,0,2,3
38152,4,1,133557,133557,133558,0,1,2
38153,2,1,133559,133559,133560,0,1,1
38154,6,3,133565,133565,133568,0,3,5
38155,3,1,133568,133568,133569,0,1,0
38156,1,1,133569,133569,133570,0,1,0
38157,3,1,133572,133572,133573,0,1,2
38158,1,3,133573,133573,133576,0,3,0
38159,2,1,133575,133576,133577,1,2,0
38160,6,1,133581,133581,133582,0,1,4
38161,3,1,133584,133584,133585,0,1,2
38162,5,1,133589,133589,133590,0,1,4
38163,1,2,133590,133590,133592,0,2,0
38164,5,1,133595,133595,133596,0,1,3
38165,2,2,133597,133597,133599,0,2,1
38166,3,2,133600,133600,133602,0,2,1
38167,3,1,133603,133603,133604,0,1,1
38168,5,2,133608,133608,133610,0,2,4
38169,2,3,133610,133610,133613,0,3,0
38170,5,1,133615,133615,133616,0,1,2
38171,4,2,133619,133619,133621,0,2,3
38172,4,2,133623,133623,133625,0,2,2
38173,1,1,133624,133625,133626,1,2,0
38174,3,2,133627,133627,133629,0,2,1
38175,3,2,133630,133630,133632,0,2,1
38176,6,1,133636,133636,133637,0,1,4
38177,3,1,133639,133639,133640,0,1,2
38178,2,2,133641,133641,133643,0,2,1
38179,6,1,133647,133647,133648,0,1,4
38180,4,2,133651,133651,133653,0,2,3
38181,4,2,133655,133655,133657,0,2,2
38182,2,1,133657,133657,133658,0,1,0
38183,6,1,133663,133663,133664,0,1,5
38184,2,3,133665,133665,133668,0,3,1
38185,3,3,133668,133668,133671,0,3,0
38186,2,1,133670,133671,133672,1,2,0
38187,2,2,133672,133672,133674,0,2,0
38188,6,1,133678,133678,133679,0,1,4
38189,2,3,133680,133680,133683,0,3,1
38190,6,2,133686,133686,133688,0,2,3
38191,1,3,133687,133688,133691,1,4,0
38192,5,2,133692,133692,133694,0,2,1
38193,5,2,133697,133697,133699,0,2,3
38194,5,1,133702,133702,133703,0,1,3
38195,1,3,133703,133703,133706,0,3,0
38196,5,2,133708,133708,133710,0,2,2
38197,6,3,133714,133714,133717,0,3,4
38198,3,3,133717,133717,133720,0,3,0
38199,4,1,133721,133721,133722,0,1,1
38200,6,1,133727,133727,133728,0,1,5
38201,4,2,133731,133731,133733,0,2,3
38202,4,2,133735,133735,133737,0,2,2
38203,1,3,133736,133737,133740,1,4,0
38204,1,1,133737,133740,133741,3,4,0
38205,2,2,133739,133741,133743,2,4,0
38206,3,3,133742,133743,133746,1,4,0
38207,2,3,133744,133746,133749,2,5,0
38208,6,3,133750,133750,133753,0,3,1
38209,2,2,133752,133753,133755,1,3,0
38210,4,2,133756,133756,133758,0,2,1
38211,5,3,133761,133761,133764,0,3,3
38212,3,3,133764,133764,133767,0,3,0
38213,4,2,133768,133768,133770,0,2,1
38214,6,2,133774,133774,133776,0,2,4
38215,4,2,133778,133778,133780,0,2,2
38216,6,1,133784,133784,133785,0,1,4
38217,2,2,133786,133786,133788,0,2,1
38218,6,1,133792,133792,133793,0,1,4
38219,5,2,133797,133797,133799,0,2,4
38220,2,3,133799,133799,133802,0,3,0
38221,1,3,133800,133802,133805,2,5,0
38222,1,1,133801,133805,133806,4,5,0
38223,1,1,133802,133806,133807,4,5,0
38224,2,3,133804,133807,133810,3,6,0
38225,1,2,133805,133810,133812,5,7,0
38226,4,3,133809,133812,133815,3,6,0
38227,3,1,133812,133815,133816,3,4,0
38228,2,1,133814,133816,133817,2,3,0
38229,3,3,133817,133817,133820,0,3,0
38230,1,3,133818,133820,133823,2,5,0
38231,2,1,133820,133823,133824,3,4,0
38232,5,1,133825,133825,133826,0,1,1
38233,2,1,133827,133827,133828,0,1,1
38234,4,2,133831,133831,133833,0,2,3
38235,2,1,133833,133833,133834,0,1,0
38236,5,2,133838,133838,133840,0,2,4
38237,2,1,133840,133840,133841,0,1,0
38238,5,1,133845,133845,133846,0,1,4
38239,1,3,133846,133846,133849,0,3,0
38240,1,1,133847,133849,133850,2,3,0
38241,1,2,133848,133850,133852,2,4,0
38242,6,2,133854,133854,133856,0,2,2
38243,5,3,133859,133859,133862,0,3,3
38244,5,1,133864,133864,133865,0,1,2
38245,2,2,133866,133866,133868,0,2,1
38246,3,2,133869,133869,133871,0,2,1
38247,3,2,133872,133872,133874,0,2,1
38248,4,1,133876,133876,133877,0,1,2
38249,2,3,133878,133878,133881,0,3,1
38250,2,1,133880,133881,133882,1,2,0
38251,6,2,133886,133886,133888,0,2,4
38252,2,3,133888,133888,133891,0,3,0
38253,1,3,133889,133891,133894,2,5,0
38254,6,3,133895,133895,133898,0,3,1
38255,6,2,133901,133901,133903,0,2,3
38256,1,2,133902,133903,133905,1,3,0
38257,5,3,133907,133907,133910,0,3,2
38258,1,3,133908,133910,133913,2,5,0
38259,5,3,133913,133913,133916,0,3,0
38260,5,3,133918,133918,133921,0,3,2
38261,4,3,133922,133922,133925,0,3,1
38262,2,1,133924,133925,133926,1,2,0
38263,5,1,133929,133929,133930,0,1,3
38264,1,3,133930,133930,133933,0,3,0
38265,5,2,133935,133935,133937,0,2,2
38266,5,1,133940,133940,133941,0,1,3
38267,5,3,133945,133945,133948,0,3,4
38268,5,2,133950,133950,133952,0,2,2
38269,5,2,133955,133955,133957,0,2,3
38270,5,2,133960,133960,133962,0,2,3
38271,5,1,133965,133965,133966,0,1,3
38272,4,3,133969,133969,133972,0,3,3
38273,4,3,133973,133973,133976,0,3,1
38274,3,2,133976,133976,133978,0,2,0
38275,6,2,133982,133982,133984,0,2,4
38276,4,3,133986,133986,133989,0,3,2
38277,4,3,133990,133990,133993,0,3,1
38278,3,1,133993,133993,133994,0,1,0
38279,1,2,133994,133994,133996,0,2,0
38280,2,1,133996,133996,133997,0,1,0
38281,1,2,133997,133997,133999,0,2,0
38282,5,3,134002,134002,134005,0,3,3
38283,3,2,134005,134005,134007,0,2,0
38284,4,2,134009,134009,134011,0,2,2
38285,3,3,134012,134012,134015,0,3,1
38286,1,2,134013,134015,134017,2,4,0
38287,3,1,134016,134017,134018,1,2,0
38288,4,2,134020,134020,134022,0,2,2
38289,5,1,134025,134025,134026,0,1,3
38290,6,2,134031,134031,134033,0,2,5
38291,1,3,134032,134033,134036,1,4,0
38292,6,3,134038,134038,134041,0,3,2
38293,5,3,134043,134043,134046,0,3,2
38294,3,2,134046,134046,134048,0,2,0
38295,2,1,134048,134048,134049,0,1,0
38296,5,3,134053,134053,134056,0,3,4
38297,4,3,134057,134057,134060,0,3,1
38298,2,2,134059,134060,134062,1,3,0
38299,5,3,134064,134064,134067,0,3,2
38300,4,2,134068,134068,134070,0,2,1
38301,1,3,134069,134070,134073,1,4,0
38302,3,3,134072,134073,134076,1,4,0
38303,6,3,134078,134078,134081,0,3,2
38304,4,1,134082,134082,134083,0,1,1
38305,4,1,134086,134086,134087,0,1,3
38306,2,2,134088,134088,134090,0,2,1
38307,6,3,134094,134094,134097,0,3,4
38308,4,2,134098,134098,134100,0,2,1
38309,4,1,134102,134102,134103,0,1,2
38310,4,2,134106,134106,134108,0,2,3
38311,2,1,134108,134108,134109,0,1,0
38312,4,2,134112,134112,134114,0,2,3
38313,4,2,134116,134116,134118,0,2,2
38314,4,1,134120,134120,134121,0,1,2
38315,5,1,134125,134125,134126,0,1,4
38316,1,1,134126,134126,134127,0,1,0
38317,2,1,134128,134128,134129,0,1,1
38318,3,3,134131,134131,134134,0,3,2
38319,2,1,134133,134134,134135,1,2,0
38320,1,1,134134,134135,134136,1,2,0
38321,1,1,134135,134136,134137,1,2,0
38322,5,3,134140,134140,134143,0,3,3
38323,2,3,134142,134143,134146,1,4,0
38324,6,2,134148,134148,134150,0,2,2
38325,3,2,134151,134151,134153,0,2,1
38326,3,2,134154,134154,134156,0,2,1
38327,4,2,134158,134158,134160,0,2,2
38328,1,3,134159,134160,134163,1,4,0
38329,3,2,134162,134163,134165,1,3,0
38330,2,1,134164,134165,134166,1,2,0
38331,2,2,134166,134166,134168,0,2,0
38332,3,3,134169,134169,134172,0,3,1
38333,3,2,134172,134172,134174,0,2,0
38334,4,1,134176,134176,134177,0,1,2
38335,6,2,134182,134182,134184,0,2,5
38336,2,3,134184,134184,134187,0,3,0
38337,6,3,134190,134190,134193,0,3,3
38338,2,2,134192,134193,134195,1,3,0
38339,2,2,134194,134195,134197,1,3,0
38340,2,1,134196,134197,134198,1,2,0
38341,6,2,134202,134202,134204,0,2,4
38342,2,1,134204,134204,134205,0,1,0
38343,5,2,134209,134209,134211,0,2,4
38344,4,2,134213,134213,134215,0,2,2
38345,2,3,134215,134215,134218,0,3,0
38346,5,2,134220,134220,134222,0,2,2
38347,6,2,134226,134226,134228,0,2,4
38348,3,2,134229,134229,134231,0,2,1
38349,2,3,134231,134231,134234,0,3,0
38350,3,2,134234,134234,134236,0,2,0
38351,3,1,134237,134237,134238,0,1,1
38352,1,1,134238,134238,134239,0,1,0
38353,1,3,134239,134239,134242,0,3,0
38354,3,3,134242,134242,134245,0,3,0
38355,4,3,134246,134246,134249,0,3,1
38356,1,1,134247,134249,134250,2,3,0
38357,3,3,134250,134250,134253,0,3,0
38358,5,2,134255,134255,134257,0,2,2
38359,1,3,134256,134257,134260,1,4,0
38360,4,1,134260,134260,134261,0,1,0
38361,2,3,134262,134262,134265,0,3,1
38362,6,3,134268,134268,134271,0,3,3
38363,6,1,134274,134274,134275,0,1,3
38364,1,1,134275,134275,134276,0,1,0
38365,5,3,134280,134280,134283,0,3,4
38366,5,3,134285,134285,134288,0,3,2
38367,1,1,134286,134288,134289,2,3,0
38368,2,1,134288,134289,134290,1,2,0
38369,3,2,134291,134291,134293,0,2,1
38370,5,2,134296,134296,134298,0,2,3
38371,3,3,134299,134299,134302,0,3,1
38372,1,2,134300,134302,134304,2,4,0
38373,4,2,134304,134304,134306,0,2,0
38374,2,1,134306,134306,134307,0,1,0
38375,3,2,134309,134309,134311,0,2,2
38376,3,1,134312,134312,134313,0,1,1
38377,4,2,134316,134316,134318,0,2,3
38378,2,3,134318,134318,134321,0,3,0
38379,1,2,134319,134321,134323,2,4,0
38380,4,2,134323,134323,134325,0,2,0
38381,1,3,134324,134325,134328,1,4,0
38382,5,1,134329,134329,134330,0,1,1
38383,1,1,134330,134330,134331,0,1,0
38384,5,1,134335,134335,134336,0,1,4
38385,6,3,134341,134341,134344,0,3,5
38386,6,1,134347,134347,134348,0,1,3
38387,4,1,134351,134351,134352,0,1,3
38388,1,3,134352,134352,134355,0,3,0
38389,6,3,134358,134358,134361,0,3,3
38390,1,3,134359,134361,134364,2,5,0
38391,3,1,134362,134364,134365,2,3,0
38392,2,1,134364,134365,134366,1,2,0
38393,3,1,134367,134367,134368,0,1,1
38394,6,1,134373,134373,134374,0,1,5
38395,5,1,134378,134378,134379,0,1,4
38396,2,3,134380,134380,134383,0,3,1
38397,5,2,134385,134385,134387,0,2,2
38398,6,1,134391,134391,134392,0,1,4
38399,1,3,134392,134392,134395,0,3,0
38400,6,1,134398,134398,134399,0,1,3
38401,3,3,134401,134401,134404,0,3,2
38402,2,1,134403,134404,134405,1,2,0
38403,3,2,134406,134406,134408,0,2,1
38404,3,1,134409,134409,134410,0,1,1
38405,1,3,134410,134410,134413,0,3,0
38406,5,1,134415,134415,134416,0,1,2
38407,2,3,134417,134417,134420,0,3,1
38408,6,3,134423,134423,134426,0,3,3
38409,3,3,134426,134426,134429,0,3,0
38410,4,2,134430,134430,134432,0,2,1
38411,1,2,134431,134432,134434,1,3,0
38412,6,2,134437,134437,134439,0,2,3
38413,3,3,134440,134440,134443,0,3,1
38414,6,3,134446,134446,134449,0,3,3
38415,6,2,134452,134452,134454,0,2,3
38416,2,2,134454,134454,134456,0,2,0
38417,3,2,134457,134457,134459,0,2,1
38418,2,1,134459,134459,134460,0,1,0
38419,1,3,134460,134460,134463,0,3,0
38420,3,2,134463,134463,134465,0,2,0
38421,6,2,134469,134469,134471,0,2,4
38422,2,3,134471,134471,134474,0,3,0
38423,2,2,134473,134474,134476,1,3,0
38424,3,2,134476,134476,134478,0,2,0
38425,4,3,134480,134480,134483,0,3,2
38426,2,3,134482,134483,134486,1,4,0
38427,4,2,134486,134486,134488,0,2,0
38428,1,3,134487,134488,134491,1,4,0
38429,2,3,134489,134491,134494,2,5,0
38430,4,1,134493,134494,134495,1,2,0
38431,1,3,134494,134495,134498,1,4,0
38432,5,2,134499,134499,134501,0,2,1
38433,4,3,134503,134503,134506,0,3,2
38434,4,2,134507,134507,134509,0,2,1
38435,1,1,134508,134509,134510,1,2,0
38436,5,2,134513,134513,134515,0,2,3
38437,3,1,134516,134516,134517,0,1,1
38438,6,2,134522,134522,134524,0,2,5
38439,6,3,134528,134528,134531,0,3,4
38440,1,2,134529,134531,134533,2,4,0
38441,5,3,134534,134534,134537,0,3,1
38442,1,1,134535,134537,134538,2,3,0
38443,5,3,134540,134540,134543,0,3,2
38444,5,2,134545,134545,134547,0,2,2
38445,4,1,134549,134549,134550,0,1,2
38446,6,3,134555,134555,134558,0,3,5
38447,1,3,134556,134558,134561,2,5,0
38448,6,3,134562,134562,134565,0,3,1
38449,5,3,134567,134567,134570,0,3,2
38450,1,2,134568,134570,134572,2,4,0
38451,4,1,134572,134572,134573,0,1,0
38452,2,1,134574,134574,134575,0,1,1
38453,3,3,134577,134577,134580,0,3,2
38454,6,3,134583,134583,134586,0,3,3
38455,1,1,134584,134586,134587,2,3,0
38456,2,2,134586,134587,134589,1,3,0
38457,2,3,134588,134589,134592,1,4,0
38458,5,3,134593,134593,134596,0,3,1
38459,5,1,134598,134598,134599,0,1,2
38460,3,2,134601,134601,134603,0,2,2
38461,1,1,134602,134603,134604,1,2,0
38462,6,2,134608,134608,134610,0,2,4
38463,4,2,134612,134612,134614,0,2,2
38464,1,2,134613,134614,134616,1,3,0
38465,4,2,134617,134617,134619,0,2,1
38466,5,2,134622,134622,134624,0,2,3
38467,5,1,134627,134627,134628,0,1,3
38468,2,1,134629,134629,134630,0,1,1
38469,2,2,134631,134631,134633,0,2,1
38470,5,3,134636,134636,134639,0,3,3
38471,1,3,134637,134639,134642,2,5,0
38472,3,1,134640,134642,134643,2,3,0
38473,3,3,134643,134643,134646,0,3,0
38474,4,2,134647,134647,134649,0,2,1
38475,3,3,134650,134650,134653,0,3,1
38476,4,1,134654,134654,134655,0,1,1
38477,3,3,134657,134657,134660,0,3,2
38478,1,2,134658,134660,134662,2,4,0
38479,4,3,134662,134662,134665,0,3,0
38480,1,3,134663,134665,134668,2,5,0
38481,2,1,134665,134668,134669,3,4,0
38482,3,3,134668,134669,134672,1,4,0
38483,1,1,134669,134672,134673,3,4,0
38484,3,1,134672,134673,134674,1,2,0
38485,5,2,134677,134677,134679,0,2,3
38486,1,2,134678,134679,134681,1,3,0
38487,4,3,134682,134682,134685,0,3,1
38488,4,1,134686,134686,134687,0,1,1
38489,6,3,134692,134692,134695,0,3,5
38490,3,2,134695,134695,134697,0,2,0
38491,5,3,134700,134700,134703,0,3,3
38492,2,1,134702,134703,134704,1,2,0
38493,5,2,134707,134707,134709,0,2,3
38494,3,2,134710,134710,134712,0,2,1
38495,1,2,134711,134712,134714,1,3,0
38496,6,2,134717,134717,134719,0,2,3
38497,6,3,134723,134723,134726,0,3,4
38498,6,1,134729,134729,134730,0,1,3
38499,3,2,134732,134732,134734,0,2,2
38500,3,1,134735,134735,134736,0,1,1
38501,5,3,134740,134740,134743,0,3,4
38502,4,3,134744,134744,134747,0,3,1
38503,5,3,134749,134749,134752,0,3,2
38504,1,1,134750,134752,134753,2,3,0
38505,5,2,134755,134755,134757,0,2,2
38506,6,1,134761,134761,134762,0,1,4
38507,4,2,134765,134765,134767,0,2,3
38508,5,2,134770,134770,134772,0,2,3
38509,3,1,134773,134773,134774,0,1,1
38510,4,1,134777,134777,134778,0,1,3
38511,4,2,134781,134781,134783,0,2,3
38512,2,2,134783,134783,134785,0,2,0
38513,4,1,134787,134787,134788,0,1,2
38514,3,2,134790,134790,134792,0,2,2
38515,3,3,134793,134793,134796,0,3,1
38516,6,1,134799,134799,134800,0,1,3
38517,5,2,134804,134804,134806,0,2,4
38518,3,3,134807,134807,134810,0,3,1
38519,2,2,134809,134810,134812,1,3,0
38520,5,1,134814,134814,134815,0,1,2
38521,6,2,134820,134820,134822,0,2,5
38522,2,1,134822,134822,134823,0,1,0
38523,1,2,134823,134823,134825,0,2,0
38524,2,3,134825,134825,134828,0,3,0
38525,1,3,134826,134828,134831,2,5,0
38526,1,1,134827,134831,134832,4,5,0
38527,3,2,134830,134832,134834,2,4,0
38528,3,2,134833,134834,134836,1,3,0
38529,2,3,134835,134836,134839,1,4,0
38530,1,3,134836,134839,134842,3,6,0
38531,2,3,134838,134842,134845,4,7,0
38532,4,3,134842,134845,134848,3,6,0
38533,1,1,134843,134848,134849,5,6,0
38534,2,3,134845,134849,134852,4,7,0
38535,1,3,134846,134852,134855,6,9,0
38536,1,3,134847,134855,134858,8,11,0
38537,4,1,134851,134858,134859,7,8,0
38538,5,1,134856,134859,134860,3,4,0
38539,5,3,134861,134861,134864,0,3,1
38540,1,1,134862,134864,134865,2,3,0
38541,1,2,134863,134865,134867,2,4,0
38542,4,2,134867,134867,134869,0,2,0
38543,2,3,134869,134869,134872,0,3,0
38544,5,3,134874,134874,134877,0,3,2
38545,2,2,134876,134877,134879,1,3,0
38546,1,2,134877,134879,134881,2,4,0
38547,4,2,134881,134881,134883,0,2,0
38548,5,3,134886,134886,134889,0,3,3
38549,2,1,134888,134889,134890,1,2,0
38550,5,1,134893,134893,134894,0,1,3
38551,2,3,134895,134895,134898,0,3,1
38552,4,2,134899,134899,134901,0,2,1
38553,1,3,134900,134901,134904,1,4,0
38554,6,2,134906,134906,134908,0,2,2
38555,6,3,134912,134912,134915,0,3,4
38556,1,3,134913,134915,134918,2,5,0
38557,5,1,134918,134918,134919,0,1,0
38558,5,1,134923,134923,134924,0,1,4
38559,5,3,134928,134928,134931,0,3,4
38560,5,1,134933,134933,134934,0,1,2
38561,1,2,134934,134934,134936,0,2,0
38562,6,2,134940,134940,134942,0,2,4
38563,4,3,134944,134944,134947,0,3,2
38564,3,3,134947,134947,134950,0,3,0
38565,6,3,134953,134953,134956,0,3,3
38566,6,2,134959,134959,134961,0,2,3
38567,1,3,134960,134961,134964,1,4,0
38568,3,2,134963,134964,134966,1,3,0
38569,3,3,134966,134966,134969,0,3,0
38570,2,2,134968,134969,134971,1,3,0
38571,2,2,134970,134971,134973,1,3,0
38572,1,3,134971,134973,134976,2,5,0
38573,1,1,134972,134976,134977,4,5,0
38574,2,2,134974,134977,134979,3,5,0
38575,1,1,134975,134979,134980,4,5,0
38576,4,2,134979,134980,134982,1,3,0
38577,5,2,134984,134984,134986,0,2,2
38578,6,1,134990,134990,134991,0,1,4
38579,2,1,134992,134992,134993,0,1,1
38580,1,1,134993,134993,134994,0,1,0
38581,1,3,134994,134994,134997,0,3,0
38582,4,3,134998,134998,135001,0,3,1
38583,6,2,135004,135004,135006,0,2,3
38584,2,2,135006,135006,135008,0,2,0
38585,3,3,135009,135009,135012,0,3,1
38586,3,3,135012,135012,135015,0,3,0
38587,4,2,135016,135016,135018,0,2,1
38588,5,1,135021,135021,135022,0,1,3
38589,6,2,135027,135027,135029,0,2,5
38590,1,1,135028,135029,135030,1,2,0
38591,2,1,135030,135030,135031,0,1,0
38592,5,2,135035,135035,135037,0,2,4
38593,5,1,135040,135040,135041,0,1,3
38594,6,1,135046,135046,135047,0,1,5
38595,5,3,135051,135051,135054,0,3,4
38596,6,1,135057,135057,135058,0,1,3
38597,2,1,135059,135059,135060,0,1,1
38598,2,2,135061,135061,135063,0,2,1
38599,3,3,135064,135064,135067,0,3,1
38600,6,3,135070,135070,135073,0,3,3
38601,6,1,135076,135076,135077,0,1,3
38602,5,3,135081,135081,135084,0,3,4
38603,5,1,135086,135086,135087,0,1,2
38604,4,2,135090,135090,135092,0,2,3
38605,4,2,135094,135094,135096,0,2,2
38606,2,2,135096,135096,135098,0,2,0
38607,5,1,135101,135101,135102,0,1,3
38608,6,2,135107,135107,135109,0,2,5
38609,2,2,135109,135109,135111,0,2,0
38610,1,1,135110,135111,135112,1,2,0
38611,5,1,135115,135115,135116,0,1,3
38612,3,3,135118,135118,135121,0,3,2
38613,2,2,135120,135121,135123,1,3,0
38614,5,1,135125,135125,135126,0,1,2
38615,6,2,135131,135131,135133,0,2,5
38616,3,3,135134,135134,135137,0,3,1
38617,3,2,135137,135137,135139,0,2,0
38618,2,1,135139,135139,135140,0,1,0
38619,2,3,135141,135141,135144,0,3,1
38620,2,3,135143,135144,135147,1,4,0
38621,2,1,135145,135147,135148,2,3,0
38622,3,1,135148,135148,135149,0,1,0
38623,2,2,135150,135150,135152,0,2,1
38624,1,3,135151,135152,135155,1,4,0
38625,1,2,135152,135155,135157,3,5,0
38626,5,2,135157,135157,135159,0,2,0
38627,2,1,135159,135159,135160,0,1,0
38628,2,3,135161,135161,135164,0,3,1
38629,1,2,135162,135164,135166,2,4,0
38630,5,3,135167,135167,135170,0,3,1
38631,5,3,135172,135172,135175,0,3,2
38632,5,1,135177,135177,135178,0,1,2
38633,5,2,135182,135182,135184,0,2,4
38634,3,3,135185,135185,135188,0,3,1
38635,5,2,135190,135190,135192,0,2,2
38636,2,1,135192,135192,135193,0,1,0
38637,4,3,135196,135196,135199,0,3,3
38638,4,1,135200,135200,135201,0,1,1
38639,3,3,135203,135203,135206,0,3,2
38640,4,1,135207,135207,135208,0,1,1
38641,6,2,135213,135213,135215,0,2,5
38642,6,1,135219,135219,135220,0,1,4
38643,6,3,135225,135225,135228,0,3,5
38644,5,3,135230,135230,135233,0,3,2
38645,5,2,135235,135235,135237,0,2,2
38646,4,1,135239,135239,135240,0,1,2
38647,5,3,135244,135244,135247,0,3,4
38648,3,3,135247,135247,135250,0,3,0
38649,3,3,135250,135250,135253,0,3,0
38650,1,1,135251,135253,135254,2,3,0
38651,5,2,135256,135256,135258,0,2,2
38652,3,1,135259,135259,135260,0,1,1
38653,3,1,135262,135262,135263,0,1,2
38654,5,1,135267,135267,135268,0,1,4
38655,5,1,135272,135272,135273,0,1,4
38656,2,2,135274,135274,135276,0,2,1
38657,6,2,135280,135280,135282,0,2,4
38658,6,1,135286,135286,135287,0,1,4
38659,5,3,135291,135291,135294,0,3,4
38660,1,2,135292,135294,135296,2,4,0
38661,5,2,135297,135297,135299,0,2,1
38662,2,2,135299,135299,135301,0,2,0
38663,2,2,135301,135301,135303,0,2,0
38664,2,1,135303,135303,135304,0,1,0
38665,4,1,135307,135307,135308,0,1,3
38666,5,3,135312,135312,135315,0,3,4
38667,1,2,135313,135315,135317,2,4,0
38668,1,2,135314,135317,135319,3,5,0
38669,3,2,135317,135319,135321,2,4,0
38670,1,1,135318,135321,135322,3,4,0
38671,2,1,135320,135322,135323,2,3,0
38672,5,2,135325,135325,135327,0,2,2
38673,4,2,135329,135329,135331,0,2,2
38674,4,2,135333,135333,135335,0,2,2
38675,5,1,135338,135338,135339,0,1,3
38676,3,2,135341,135341,135343,0,2,2
38677,2,1,135343,135343,135344,0,1,0
38678,3,1,135346,135346,135347,0,1,2
38679,6,1,135352,135352,135353,0,1,5
38680,6,2,135358,135358,135360,0,2,5
38681,2,3,135360,135360,135363,0,3,0
38682,5,2,135365,135365,135367,0,2,2
38683,2,1,135367,135367,135368,0,1,0
38684,4,2,135371,135371,135373,0,2,3
38685,6,1,135377,135377,135378,0,1,4
38686,4,1,135381,135381,135382,0,1,3
38687,5,2,135386,135386,135388,0,2,4
38688,6,1,135392,135392,135393,0,1,4
38689,3,2,135395,135395,135397,0,2,2
38690,2,2,135397,135397,135399,0,2,0
38691,6,3,135403,135403,135406,0,3,4
38692,4,2,135407,135407,135409,0,2,1
38693,1,2,135408,135409,135411,1,3,0
38694,2,1,135410,135411,135412,1,2,0
38695,4,1,135414,135414,135415,0,1,2
38696,6,2,135420,135420,135422,0,2,5
38697,5,3,135425,135425,135428,0,3,3
38698,6,3,135431,135431,135434,0,3,3
38699,2,2,135433,135434,135436,1,3,0
38700,1,1,135434,135436,135437,2,3,0
38701,2,2,135436,135437,135439,1,3,0
38702,4,2,135440,135440,135442,0,2,1
38703,5,2,135445,135445,135447,0,2,3
38704,2,3,135447,135447,135450,0,3,0
38705,2,2,135449,135450,135452,1,3,0
38706,5,1,135454,135454,135455,0,1,2
38707,5,1,135459,135459,135460,0,1,4
38708,2,3,135461,135461,135464,0,3,1
38709,2,1,135463,135464,135465,1,2,0
38710,2,1,135465,135465,135466,0,1,0
38711,3,1,135468,135468,135469,0,1,2
38712,5,3,135473,135473,135476,0,3,4
38713,1,2,135474,135476,135478,2,4,0
38714,1,2,135475,135478,135480,3,5,0
38715,3,1,135478,135480,135481,2,3,0
38716,5,1,135483,135483,135484,0,1,2
38717,3,2,135486,135486,135488,0,2,2
38718,5,1,135491,135491,135492,0,1,3
38719,3,1,135494,135494,135495,0,1,2
38720,5,2,135499,135499,135501,0,2,4
38721,4,3,135503,135503,135506,0,3,2
38722,1,1,135504,135506,135507,2,3,0
38723,3,2,135507,135507,135509,0,2,0
38724,5,1,135512,135512,135513,0,1,3
38725,5,1,135517,135517,135518,0,1,4
38726,3,3,135520,135520,135523,0,3,2
38727,3,3,135523,135523,135526,0,3,0
38728,3,2,135526,135526,135528,0,2,0
38729,3,3,135529,135529,135532,0,3,1
38730,2,3,135531,135532,135535,1,4,0
38731,1,1,135532,135535,135536,3,4,0
38732,5,3,135537,135537,135540,0,3,1
38733,2,3,135539,135540,135543,1,4,0
38734,1,2,135540,135543,135545,3,5,0
38735,6,3,135546,135546,135549,0,3,1
38736,2,1,135548,135549,135550,1,2,0
38737,6,2,135554,135554,135556,0,2,4
38738,6,2,135560,135560,135562,0,2,4
38739,2,2,135562,135562,135564,0,2,0
38740,4,3,135566,135566,135569,0,3,2
38741,5,2,135571,135571,135573,0,2,2
38742,1,1,135572,135573,135574,1,2,0
38743,2,3,135574,135574,135577,0,3,0
38744,2,2,135576,135577,135579,1,3,0
38745,3,2,135579,135579,135581,0,2,0
38746,5,2,135584,135584,135586,0,2,3
38747,5,3,135589,135589,135592,0,3,3
38748,5,1,135594,135594,135595,0,1,2
38749,5,1,135599,135599,135600,0,1,4
38750,5,2,135604,135604,135606,0,2,4
38751,5,3,135609,135609,135612,0,3,3
38752,2,3,135611,135612,135615,1,4,0
38753,3,2,135614,135615,135617,1,3,0
38754,2,1,135616,135617,135618,1,2,0
38755,1,1,135617,135618,135619,1,2,0
38756,6,1,135623,135623,135624,0,1,4
38757,1,3,135624,135624,135627,0,3,0
38758,2,1,135626,135627,135628,1,2,0
38759,1,1,135627,135628,135629,1,2,0
38760,5,1,135632,135632,135633,0,1,3
38761,2,2,135634,135634,135636,0,2,1
38762,6,3,135640,135640,135643,0,3,4
38763,1,1,135641,135643,135644,2,3,0
38764,1,1,135642,135644,135645,2,3,0
38765,1,2,135643,135645,135647,2,4,0
38766,1,1,135644,135647,135648,3,4,0
38767,4,1,135648,135648,135649,0,1,0
38768,6,2,135654,135654,135656,0,2,5
38769,1,2,135655,135656,135658,1,3,0
38770,2,1,135657,135658,135659,1,2,0
38771,6,2,135663,135663,135665,0,2,4
38772,3,2,135666,135666,135668,0,2,1
38773,3,3,135669,135669,135672,0,3,1
38774,3,3,135672,135672,135675,0,3,0
38775,4,2,135676,135676,135678,0,2,1
38776,6,2,135682,135682,135684,0,2,4
38777,5,2,135687,135687,135689,0,2,3
38778,4,2,135691,135691,135693,0,2,2
38779,2,1,135693,135693,135694,0,1,0
38780,3,3,135696,135696,135699,0,3,2
38781,2,2,135698,135699,135701,1,3,0
38782,2,1,135700,135701,135702,1,2,0
38783,2,3,135702,135702,135705,0,3,0
38784,4,3,135706,135706,135709,0,3,1
38785,6,2,135712,135712,135714,0,2,3
38786,2,1,135714,135714,135715,0,1,0
38787,5,3,135719,135719,135722,0,3,4
38788,2,2,135721,135722,135724,1,3,0
38789,5,2,135726,135726,135728,0,2,2
38790,6,3,135732,135732,135735,0,3,4
38791,1,1,135733,135735,135736,2,3,0
38792,3,1,135736,135736,135737,0,1,0
38793,6,2,135742,135742,135744,0,2,5
38794,5,3,135747,135747,135750,0,3,3
38795,4,1,135751,135751,135752,0,1,1
38796,4,3,135755,135755,135758,0,3,3
38797,2,3,135757,135758,135761,1,4,0
38798,2,2,135759,135761,135763,2,4,0
38799,6,1,135765,135765,135766,0,1,2
38800,1,3,135766,135766,135769,0,3,0
38801,1,2,135767,135769,135771,2,4,0
38802,6,2,135773,135773,135775,0,2,2
38803,2,3,135775,135775,135778,0,3,0
38804,6,3,135781,135781,135784,0,3,3
38805,5,2,135786,135786,135788,0,2,2
38806,1,2,135787,135788,135790,1,3,0
38807,1,2,135788,135790,135792,2,4,0
38808,2,1,135790,135792,135793,2,3,0
38809,6,1,135796,135796,135797,0,1,3
38810,3,3,135799,135799,135802,0,3,2
38811,4,3,135803,135803,135806,0,3,1
38812,3,1,135806,135806,135807,0,1,0
38813,1,1,135807,135807,135808,0,1,0
38814,3,3,135810,135810,135813,0,3,2
38815,6,2,135816,135816,135818,0,2,3
38816,5,2,135821,135821,135823,0,2,3
38817,1,1,135822,135823,135824,1,2,0
38818,6,2,135828,135828,135830,0,2,4
38819,1,3,135829,135830,135833,1,4,0
38820,6,1,135835,135835,135836,0,1,2
38821,3,3,135838,135838,135841,0,3,2
38822,5,3,135843,135843,135846,0,3,2
38823,3,2,135846,135846,135848,0,2,0
38824,5,2,135851,135851,135853,0,2,3
38825,1,2,135852,135853,135855,1,3,0
38826,6,1,135858,135858,135859,0,1,3
38827,5,3,135863,135863,135866,0,3,4
38828,3,2,135866,135866,135868,0,2,0
38829,5,3,135871,135871,135874,0,3,3
38830,3,1,135874,135874,135875,0,1,0
38831,3,1,135877,135877,135878,0,1,2
38832,2,3,135879,135879,135882,0,3,1
38833,5,3,135884,135884,135887,0,3,2
38834,6,3,135890,135890,135893,0,3,3
38835,1,2,135891,135893,135895,2,4,0
38836,1,1,135892,135895,135896,3,4,0
38837,1,2,135893,135896,135898,3,5,0
38838,2,3,135895,135898,135901,3,6,0
38839,2,3,135897,135901,135904,4,7,0
38840,4,3,135901,135904,135907,3,6,0
38841,6,1,135907,135907,135908,0,1,0
38842,4,1,135911,135911,135912,0,1,3
38843,5,2,135916,135916,135918,0,2,4
38844,6,3,135922,135922,135925,0,3,4
38845,2,2,135924,135925,135927,1,3,0
38846,2,2,135926,135927,135929,1,3,0
38847,4,1,135930,135930,135931,0,1,1
38848,5,3,135935,135935,135938,0,3,4
38849,2,2,135937,135938,135940,1,3,0
38850,5,1,135942,135942,135943,0,1,2
38851,6,3,135948,135948,135951,0,3,5
38852,5,1,135953,135953,135954,0,1,2
38853,4,3,135957,135957,135960,0,3,3
38854,1,3,135958,135960,135963,2,5,0
38855,3,1,135961,135963,135964,2,3,0
38856,4,3,135965,135965,135968,0,3,1
38857,6,2,135971,135971,135973,0,2,3
38858,2,3,135973,135973,135976,0,3,0
38859,2,3,135975,135976,135979,1,4,0
38860,1,2,135976,135979,135981,3,5,0
38861,3,3,135979,135981,135984,2,5,0
38862,3,1,135982,135984,135985,2,3,0
38863,4,1,135986,135986,135987,0,1,1
38864,5,3,135991,135991,135994,0,3,4
38865,4,1,135995,135995,135996,0,1,1
38866,1,1,135996,135996,135997,0,1,0
38867,3,2,135999,135999,136001,0,2,2
38868,5,3,136004,136004,136007,0,3,3
38869,5,2,136009,136009,136011,0,2,2
38870,2,2,136011,136011,136013,0,2,0
38871,5,3,136016,136016,136019,0,3,3
38872,5,2,136021,136021,136023,0,2,2
38873,3,1,136024,136024,136025,0,1,1
38874,1,2,136025,136025,136027,0,2,0
38875,1,2,136026,136027,136029,1,3,0
38876,2,3,136028,136029,136032,1,4,0
38877,2,2,136030,136032,136034,2,4,0
38878,5,1,136035,136035,136036,0,1,1
38879,6,3,136041,136041,136044,0,3,5
38880,2,1,136043,136044,136045,1,2,0
38881,4,2,136047,136047,136049,0,2,2
38882,5,3,136052,136052,136055,0,3,3
38883,5,1,136057,136057,136058,0,1,2
38884,6,1,136063,136063,136064,0,1,5
38885,2,2,136065,136065,136067,0,2,1
38886,4,1,136069,136069,136070,0,1,2
38887,1,2,136070,136070,136072,0,2,0
38888,5,2,136075,136075,136077,0,2,3
38889,2,3,136077,136077,136080,0,3,0
38890,3,1,136080,136080,136081,0,1,0
38891,6,1,136086,136086,136087,0,1,5
38892,1,1,136087,136087,136088,0,1,0
38893,5,1,136092,136092,136093,0,1,4
38894,6,3,136098,136098,136101,0,3,5
38895,4,1,136102,136102,136103,0,1,1
38896,5,3,136107,136107,136110,0,3,4
38897,3,1,136110,136110,136111,0,1,0
38898,6,3,136116,136116,136119,0,3,5
38899,3,1,136119,136119,136120,0,1,0
38900,2,1,136121,136121,136122,0,1,1
38901,4,3,136125,136125,136128,0,3,3
38902,4,3,136129,136129,136132,0,3,1
38903,3,3,136132,136132,136135,0,3,0
38904,5,1,136137,136137,136138,0,1,2
38905,4,1,136141,136141,136142,0,1,3
38906,5,2,136146,136146,136148,0,2,4
38907,2,3,136148,136148,136151,0,3,0
38908,1,3,136149,136151,136154,2,5,0
38909,3,1,136152,136154,136155,2,3,0
38910,1,2,136153,136155,136157,2,4,0
38911,6,3,136159,136159,136162,0,3,2
38912,2,3,136161,136162,136165,1,4,0
38913,5,1,136166,136166,136167,0,1,1
38914,2,1,136168,136168,136169,0,1,1
38915,5,3,136173,136173,136176,0,3,4
38916,6,1,136179,136179,136180,0,1,3
38917,3,1,136182,136182,136183,0,1,2
38918,3,3,136185,136185,136188,0,3,2
38919,1,2,136186,136188,136190,2,4,0
38920,6,1,136192,136192,136193,0,1,2
38921,4,3,136196,136196,136199,0,3,3
38922,2,2,136198,136199,136201,1,3,0
38923,4,1,136202,136202,136203,0,1,1
38924,5,2,136207,136207,136209,0,2,4
38925,6,1,136213,136213,136214,0,1,4
38926,4,2,136217,136217,136219,0,2,3
38927,1,3,136218,136219,136222,1,4,0
38928,2,1,136220,136222,136223,2,3,0
38929,2,2,136222,136223,136225,1,3,0
38930,6,3,136228,136228,136231,0,3,3
38931,5,2,136233,136233,136235,0,2,2
38932,5,3,136238,136238,136241,0,3,3
38933,4,2,136242,136242,136244,0,2,1
38934,3,3,136245,136245,136248,0,3,1
38935,3,2,136248,136248,136250,0,2,0
38936,2,1,136250,136250,136251,0,1,0
38937,6,2,136256,136256,136258,0,2,5
38938,5,2,136261,136261,136263,0,2,3
38939,3,3,136264,136264,136267,0,3,1
38940,2,3,136266,136267,136270,1,4,0
38941,1,2,136267,136270,136272,3,5,0
38942,6,3,136273,136273,136276,0,3,1
38943,1,2,136274,136276,136278,2,4,0
38944,1,1,136275,136278,136279,3,4,0
38945,3,2,136278,136279,136281,1,3,0
38946,3,1,136281,136281,136282,0,1,0
38947,5,1,136286,136286,136287,0,1,4
38948,1,3,136287,136287,136290,0,3,0
38949,4,1,136291,136291,136292,0,1,1
38950,2,2,136293,136293,136295,0,2,1
38951,2,3,136295,136295,136298,0,3,0
38952,3,2,136298,136298,136300,0,2,0
38953,5,1,136303,136303,136304,0,1,3
38954,3,3,136306,136306,136309,0,3,2
38955,3,3,136309,136309,136312,0,3,0
38956,3,1,136312,136312,136313,0,1,0
38957,6,3,136318,136318,136321,0,3,5
38958,6,3,136324,136324,136327,0,3,3
38959,6,2,136330,136330,136332,0,2,3
38960,1,3,136331,136332,136335,1,4,0
38961,4,2,136335,136335,136337,0,2,0
38962,4,2,136339,136339,136341,0,2,2
38963,1,3,136340,136341,136344,1,4,0
38964,2,1,136342,136344,136345,2,3,0
38965,5,3,136347,136347,136350,0,3,2
38966,3,1,136350,136350,136351,0,1,0
38967,3,2,136353,136353,136355,0,2,2
38968,6,3,136359,136359,136362,0,3,4
38969,6,1,136365,136365,136366,0,1,3
38970,4,2,136369,136369,136371,0,2,3
38971,5,2,136374,136374,136376,0,2,3
38972,1,3,136375,136376,136379,1,4,0
38973,6,3,136381,136381,136384,0,3,2
38974,4,3,136385,136385,136388,0,3,1
38975,6,3,136391,136391,136394,0,3,3
38976,3,1,136394,136394,136395,0,1,0
38977,6,1,136400,136400,136401,0,1,5
38978,2,3,136402,136402,136405,0,3,1
38979,1,2,136403,136405,136407,2,4,0
38980,2,1,136405,136407,136408,2,3,0
38981,4,3,136409,136409,136412,0,3,1
38982,1,2,136410,136412,136414,2,4,0
38983,3,2,136413,136414,136416,1,3,0
38984,6,2,136419,136419,136421,0,2,3
38985,6,2,136425,136425,136427,0,2,4
38986,3,1,136428,136428,136429,0,1,1
38987,3,1,136431,136431,136432,0,1,2
38988,6,1,136437,136437,136438,0,1,5
38989,3,1,136440,136440,136441,0,1,2
38990,3,3,136443,136443,136446,0,3,2
38991,3,2,136446,136446,136448,0,2,0
38992,4,1,136450,136450,136451,0,1,2
38993,2,1,136452,136452,136453,0,1,1
38994,5,1,136457,136457,136458,0,1,4
38995,5,3,136462,136462,136465,0,3,4
38996,3,3,136465,136465,136468,0,3,0
38997,4,2,136469,136469,136471,0,2,1
38998,1,1,136470,136471,136472,1,2,0
38999,4,3,136474,136474,136477,0,3,2
39000,5,2,136479,136479,136481,0,2,2
39001,6,2,136485,136485,136487,0,2,4
39002,6,2,136491,136491,136493,0,2,4
39003,2,3,136493,136493,136496,0,3,0
39004,1,2,136494,136496,136498,2,4,0
39005,4,3,136498,136498,136501,0,3,0
39006,3,3,136501,136501,136504,0,3,0
39007,3,3,136504,136504,136507,0,3,0
39008,2,2,136506,136507,136509,1,3,0
39009,4,1,136510,136510,136511,0,1,1
39010,6,3,136516,136516,136519,0,3,5
39011,1,1,136517,136519,136520,2,3,0
39012,5,3,136522,136522,136525,0,3,2
39013,5,1,136527,136527,136528,0,1,2
39014,2,3,136529,136529,136532,0,3,1
39015,5,2,136534,136534,136536,0,2,2
39016,6,2,136540,136540,136542,0,2,4
39017,5,1,136545,136545,136546,0,1,3
39018,5,2,136550,136550,136552,0,2,4
39019,5,2,136555,136555,136557,0,2,3
39020,5,1,136560,136560,136561,0,1,3
39021,4,2,136564,136564,136566,0,2,3
39022,3,1,136567,136567,136568,0,1,1
39023,5,2,136572,136572,136574,0,2,4
39024,6,1,136578,136578,136579,0,1,4
39025,6,2,136584,136584,136586,0,2,5
39026,5,1,136589,136589,136590,0,1,3
39027,1,2,136590,136590,136592,0,2,0
39028,5,3,136595,136595,136598,0,3,3
39029,1,1,136596,136598,136599,2,3,0
39030,1,1,136597,136599,136600,2,3,0
39031,6,3,136603,136603,136606,0,3,3
39032,1,2,136604,136606,136608,2,4,0
39033,4,1,136608,136608,136609,0,1,0
39034,3,3,136611,136611,136614,0,3,2
39035,2,2,136613,136614,136616,1,3,0
39036,5,2,136618,136618,136620,0,2,2
39037,1,3,136619,136620,136623,1,4,0
39038,2,2,136621,136623,136625,2,4,0
39039,5,1,136626,136626,136627,0,1,1
39040,6,1,136632,136632,136633,0,1,5
39041,1,2,136633,136633,136635,0,2,0
39042,5,1,136638,136638,136639,0,1,3
39043,4,2,136642,136642,136644,0,2,3
39044,4,2,136646,136646,136648,0,2,2
39045,4,1,136650,136650,136651,0,1,2
39046,3,2,136653,136653,136655,0,2,2
39047,1,1,136654,136655,136656,1,2,0
39048,3,2,136657,136657,136659,0,2,1
39049,3,1,136660,136660,136661,0,1,1
39050,4,1,136664,136664,136665,0,1,3
39051,4,1,136668,136668,136669,0,1,3
39052,1,3,136669,136669,136672,0,3,0
39053,1,3,136670,136672,136675,2,5,0
39054,3,3,136673,136675,136678,2,5,0
39055,5,2,136678,136678,136680,0,2,0
39056,6,3,136684,136684,136687,0,3,4
39057,2,3,136686,136687,136690,1,4,0
39058,1,1,136687,136690,136691,3,4,0
39059,5,3,136692,136692,136695,0,3,1
39060,4,1,136696,136696,136697,0,1,1
39061,1,3,136697,136697,136700,0,3,0
39062,3,1,136700,136700,136701,0,1,0
39063,2,2,136702,136702,136704,0,2,1
39064,3,1,136705,136705,136706,0,1,1
39065,1,3,136706,136706,136709,0,3,0
39066,5,3,136711,136711,136714,0,3,2
39067,1,1,136712,136714,136715,2,3,0
39068,4,3,136716,136716,136719,0,3,1
39069,5,1,136721,136721,136722,0,1,2
39070,6,1,136727,136727,136728,0,1,5
39071,3,2,136730,136730,136732,0,2,2
39072,5,1,136735,136735,136736,0,1,3
39073,3,3,136738,136738,136741,0,3,2
39074,2,3,136740,136741,136744,1,4,0
39075,1,2,136741,136744,136746,3,5,0
39076,6,2,136747,136747,136749,0,2,1
39077,1,3,136748,136749,136752,1,4,0
39078,3,3,136751,136752,136755,1,4,0
39079,6,1,136757,136757,136758,0,1,2
39080,4,3,136761,136761,136764,0,3,3
39081,4,2,136765,136765,136767,0,2,1
39082,6,3,136771,136771,136774,0,3,4
39083,5,1,136776,136776,136777,0,1,2
39084,4,3,136780,136780,136783,0,3,3
39085,3,2,136783,136783,136785,0,2,0
39086,1,1,136784,136785,136786,1,2,0
39087,3,3,136787,136787,136790,0,3,1
39088,4,3,136791,136791,136794,0,3,1
39089,1,2,136792,136794,136796,2,4,0
39090,4,1,136796,136796,136797,0,1,0
39091,3,2,136799,136799,136801,0,2,2
39092,5,1,136804,136804,136805,0,1,3
39093,5,1,136809,136809,136810,0,1,4
39094,2,2,136811,136811,136813,0,2,1
39095,5,2,136816,136816,136818,0,2,3
39096,5,2,136821,136821,136823,0,2,3
39097,3,1,136824,136824,136825,0,1,1
39098,6,1,136830,136830,136831,0,1,5
39099,2,2,136832,136832,136834,0,2,1
39100,4,1,136836,136836,136837,0,1,2
39101,4,1,136840,136840,136841,0,1,3
39102,1,1,136841,136841,136842,0,1,0
39103,2,1,136843,136843,136844,0,1,1
39104,4,1,136847,136847,136848,0,1,3
39105,5,3,136852,136852,136855,0,3,4
39106,6,1,136858,136858,136859,0,1,3
39107,3,3,136861,136861,136864,0,3,2
39108,3,1,136864,136864,136865,0,1,0
39109,3,3,136867,136867,136870,0,3,2
39110,2,2,136869,136870,136872,1,3,0
39111,5,3,136874,136874,136877,0,3,2
39112,2,3,136876,136877,136880,1,4,0
39113,6,3,136882,136882,136885,0,3,2
39114,6,3,136888,136888,136891,0,3,3
39115,5,3,136893,136893,136896,0,3,2
39116,6,3,136899,136899,136902,0,3,3
39117,1,2,136900,136902,136904,2,4,0
39118,4,3,136904,136904,136907,0,3,0
39119,3,2,136907,136907,136909,0,2,0
39120,1,3,136908,136909,136912,1,4,0
39121,3,1,136911,136912,136913,1,2,0
39122,3,3,136914,136914,136917,0,3,1
39123,6,2,136920,136920,136922,0,2,3
39124,1,1,136921,136922,136923,1,2,0
39125,4,3,136925,136925,136928,0,3,2
39126,4,2,136929,136929,136931,0,2,1
39127,5,1,136934,136934,136935,0,1,3
39128,3,2,136937,136937,136939,0,2,2
39129,3,3,136940,136940,136943,0,3,1
39130,4,1,136944,136944,136945,0,1,1
39131,2,3,136946,136946,136949,0,3,1
39132,4,3,136950,136950,136953,0,3,1
39133,3,2,136953,136953,136955,0,2,0
39134,1,1,136954,136955,136956,1,2,0
39135,4,1,136958,136958,136959,0,1,2
39136,2,1,136960,136960,136961,0,1,1
39137,2,3,136962,136962,136965,0,3,1
39138,1,3,136963,136965,136968,2,5,0
39139,2,2,136965,136968,136970,3,5,0
39140,1,1,136966,136970,136971,4,5,0
39141,4,2,136970,136971,136973,1,3,0
39142,2,2,136972,136973,136975,1,3,0
39143,2,1,136974,136975,136976,1,2,0
39144,5,2,136979,136979,136981,0,2,3
39145,4,1,136983,136983,136984,0,1,2
39146,2,1,136985,136985,136986,0,1,1
39147,1,3,136986,136986,136989,0,3,0
39148,2,3,136988,136989,136992,1,4,0
39149,6,3,136994,136994,136997,0,3,2
39150,6,3,137000,137000,137003,0,3,3
39151,5,2,137005,137005,137007,0,2,2
39152,5,1,137010,137010,137011,0,1,3
39153,2,3,137012,137012,137015,0,3,1
39154,5,2,137017,137017,137019,0,2,2
39155,3,2,137020,137020,137022,0,2,1
39156,2,2,137022,137022,137024,0,2,0
39157,6,1,137028,137028,137029,0,1,4
39158,2,1,137030,137030,137031,0,1,1
39159,4,3,137034,137034,137037,0,3,3
39160,6,3,137040,137040,137043,0,3,3
39161,4,3,137044,137044,137047,0,3,1
39162,3,3,137047,137047,137050,0,3,0
39163,5,3,137052,137052,137055,0,3,2
39164,3,1,137055,137055,137056,0,1,0
39165,3,3,137058,137058,137061,0,3,2
39166,2,3,137060,137061,137064,1,4,0
39167,1,3,137061,137064,137067,3,6,0
39168,3,1,137064,137067,137068,3,4,0
39169,5,2,137069,137069,137071,0,2,1
39170,6,3,137075,137075,137078,0,3,4
39171,4,3,137079,137079,137082,0,3,1
39172,2,1,137081,137082,137083,1,2,0
39173,6,2,137087,137087,137089,0,2,4
39174,5,1,137092,137092,137093,0,1,3
39175,4,1,137096,137096,137097,0,1,3
39176,2,1,137098,137098,137099,0,1,1
39177,1,2,137099,137099,137101,0,2,0
39178,3,1,137102,137102,137103,0,1,1
39179,4,3,137106,137106,137109,0,3,3
39180,6,3,137112,137112,137115,0,3,3
39181,6,2,137118,137118,137120,0,2,3
39182,2,3,137120,137120,137123,0,3,0
39183,6,2,137126,137126,137128,0,2,3
39184,4,2,137130,137130,137132,0,2,2
39185,3,3,137133,137133,137136,0,3,1
39186,6,1,137139,137139,137140,0,1,3
39187,5,2,137144,137144,137146,0,2,4
39188,4,1,137148,137148,137149,0,1,2
39189,3,3,137151,137151,137154,0,3,2
39190,1,3,137152,137154,137157,2,5,0
39191,6,1,137158,137158,137159,0,1,1
39192,6,3,137164,137164,137167,0,3,5
39193,4,1,137168,137168,137169,0,1,1
39194,6,1,137174,137174,137175,0,1,5
39195,1,2,137175,137175,137177,0,2,0
39196,6,3,137181,137181,137184,0,3,4
39197,6,1,137187,137187,137188,0,1,3
39198,1,1,137188,137188,137189,0,1,0
39199,2,3,137190,137190,137193,0,3,1
39200,3,1,137193,137193,137194,0,1,0
39201,3,3,137196,137196,137199,0,3,2
39202,6,2,137202,137202,137204,0,2,3
39203,1,1,137203,137204,137205,1,2,0
39204,5,3,137208,137208,137211,0,3,3
39205,2,3,137210,137211,137214,1,4,0
39206,6,1,137216,137216,137217,0,1,2
39207,6,1,137222,137222,137223,0,1,5
39208,3,1,137225,137225,137226,0,1,2
39209,5,1,137230,137230,137231,0,1,4
39210,3,3,137233,137233,137236,0,3,2
39211,3,1,137236,137236,137237,0,1,0
39212,3,2,137239,137239,137241,0,2,2
39213,2,3,137241,137241,137244,0,3,0
39214,4,2,137245,137245,137247,0,2,1
39215,1,2,137246,137247,137249,1,3,0
39216,3,2,137249,137249,137251,0,2,0
39217,5,1,137254,137254,137255,0,1,3
39218,4,3,137258,137258,137261,0,3,3
39219,5,2,137263,137263,137265,0,2,2
39220,5,3,137268,137268,137271,0,3,3
39221,1,2,137269,137271,137273,2,4,0
39222,4,2,137273,137273,137275,0,2,0
39223,2,2,137275,137275,137277,0,2,0
39224,4,2,137279,137279,137281,0,2,2
39225,4,1,137283,137283,137284,0,1,2
39226,3,3,137286,137286,137289,0,3,2
39227,2,2,137288,137289,137291,1,3,0
39228,2,3,137290,137291,137294,1,4,0
39229,6,2,137296,137296,137298,0,2,2
39230,4,1,137300,137300,137301,0,1,2
39231,5,1,137305,137305,137306,0,1,4
39232,6,2,137311,137311,137313,0,2,5
39233,4,3,137315,137315,137318,0,3,2
39234,4,2,137319,137319,137321,0,2,1
39235,4,3,137323,137323,137326,0,3,2
39236,2,2,137325,137326,137328,1,3,0
39237,2,1,137327,137328,137329,1,2,0
39238,5,3,137332,137332,137335,0,3,3
39239,1,3,137333,137335,137338,2,5,0
39240,2,1,137335,137338,137339,3,4,0
39241,1,1,137336,137339,137340,3,4,0
39242,1,3,137337,137340,137343,3,6,0
39243,3,2,137340,137343,137345,3,5,0
39244,6,2,137346,137346,137348,0,2,1
39245,3,1,137349,137349,137350,0,1,1
39246,3,1,137352,137352,137353,0,1,2
39247,6,1,137358,137358,137359,0,1,5
39248,4,2,137362,137362,137364,0,2,3
39249,1,3,137363,137364,137367,1,4,0
39250,5,2,137368,137368,137370,0,2,1
39251,5,2,137373,137373,137375,0,2,3
39252,1,2,137374,137375,137377,1,3,0
39253,5,1,137379,137379,137380,0,1,2
39254,5,2,137384,137384,137386,0,2,4
39255,1,1,137385,137386,137387,1,2,0
39256,4,2,137389,137389,137391,0,2,2
39257,3,3,137392,137392,137395,0,3,1
39258,6,3,137398,137398,137401,0,3,3
39259,5,1,137403,137403,137404,0,1,2
39260,3,2,137406,137406,137408,0,2,2
39261,5,3,137411,137411,137414,0,3,3
39262,3,3,137414,137414,137417,0,3,0
39263,1,2,137415,137417,137419,2,4,0
39264,3,2,137418,137419,137421,1,3,0
39265,1,2,137419,137421,137423,2,4,0
39266,1,1,137420,137423,137424,3,4,0
39267,2,2,137422,137424,137426,2,4,0
39268,3,3,137425,137426,137429,1,4,0
39269,1,2,137426,137429,137431,3,5,0
39270,1,3,137427,137431,137434,4,7,0
39271,3,1,137430,137434,137435,4,5,0
39272,1,1,137431,137435,137436,4,5,0
39273,4,1,137435,137436,137437,1,2,0
39274,2,2,137437,137437,137439,0,2,0
39275,2,2,137439,137439,137441,0,2,0
39276,4,1,137443,137443,137444,0,1,2
39277,1,2,137444,137444,137446,0,2,0
39278,5,2,137449,137449,137451,0,2,3
39279,3,3,137452,137452,137455,0,3,1
39280,4,1,137456,137456,137457,0,1,1
39281,3,1,137459,137459,137460,0,1,2
39282,6,1,137465,137465,137466,0,1,5
39283,3,2,137468,137468,137470,0,2,2
39284,5,2,137473,137473,137475,0,2,3
39285,1,3,137474,137475,137478,1,4,0
39286,5,2,137479,137479,137481,0,2,1
39287,5,1,137484,137484,137485,0,1,3
39288,3,2,137487,137487,137489,0,2,2
39289,3,2,137490,137490,137492,0,2,1
39290,5,2,137495,137495,137497,0,2,3
39291,4,3,137499,137499,137502,0,3,2
39292,6,3,137505,137505,137508,0,3,3
39293,2,2,137507,137508,137510,1,3,0
39294,6,1,137513,137513,137514,0,1,3
39295,1,1,137514,137514,137515,0,1,0
39296,3,1,137517,137517,137518,0,1,2
39297,3,1,137520,137520,137521,0,1,2
39298,1,2,137521,137521,137523,0,2,0
39299,3,3,137524,137524,137527,0,3,1
39300,3,2,137527,137527,137529,0,2,0
39301,4,3,137531,137531,137534,0,3,2
39302,2,3,137533,137534,137537,1,4,0
39303,6,2,137539,137539,137541,0,2,2
39304,1,1,137540,137541,137542,1,2,0
39305,1,2,137541,137542,137544,1,3,0
39306,1,3,137542,137544,137547,2,5,0
39307,1,2,137543,137547,137549,4,6,0
39308,4,2,137547,137549,137551,2,4,0
39309,3,2,137550,137551,137553,1,3,0
39310,4,3,137554,137554,137557,0,3,1
39311,4,2,137558,137558,137560,0,2,1
39312,2,3,137560,137560,137563,0,3,0
39313,3,3,137563,137563,137566,0,3,0
39314,1,3,137564,137566,137569,2,5,0
39315,1,2,137565,137569,137571,4,6,0
39316,2,2,137567,137571,137573,4,6,0
39317,4,2,137571,137573,137575,2,4,0
39318,4,3,137575,137575,137578,0,3,0
39319,5,1,137580,137580,137581,0,1,2
39320,2,2,137582,137582,137584,0,2,1
39321,5,3,137587,137587,137590,0,3,3
39322,1,2,137588,137590,137592,2,4,0
39323,6,2,137594,137594,137596,0,2,2
39324,2,2,137596,137596,137598,0,2,0
39325,1,3,137597,137598,137601,1,4,0
39326,1,1,137598,137601,137602,3,4,0
39327,3,2,137601,137602,137604,1,3,0
39328,2,1,137603,137604,137605,1,2,0
39329,1,2,137604,137605,137607,1,3,0
39330,3,3,137607,137607,137610,0,3,0
39331,3,1,137610,137610,137611,0,1,0
39332,1,2,137611,137611,137613,0,2,0
39333,3,1,137614,137614,137615,0,1,1
39334,5,1,137619,137619,137620,0,1,4
39335,4,2,137623,137623,137625,0,2,3
39336,5,2,137628,137628,137630,0,2,3
39337,3,1,137631,137631,137632,0,1,1
39338,5,3,137636,137636,137639,0,3,4
39339,2,3,137638,137639,137642,1,4,0
39340,3,3,137641,137642,137645,1,4,0
39341,6,1,137647,137647,137648,0,1,2
39342,5,2,137652,137652,137654,0,2,4
39343,5,3,137657,137657,137660,0,3,3
39344,4,2,137661,137661,137663,0,2,1
39345,1,2,137662,137663,137665,1,3,0
39346,2,2,137664,137665,137667,1,3,0
39347,3,2,137667,137667,137669,0,2,0
39348,2,1,137669,137669,137670,0,1,0
39349,3,3,137672,137672,137675,0,3,2
39350,3,2,137675,137675,137677,0,2,0
39351,5,2,137680,137680,137682,0,2,3
39352,1,3,137681,137682,137685,1,4,0
39353,1,1,137682,137685,137686,3,4,0
39354,4,1,137686,137686,137687,0,1,0
39355,4,2,137690,137690,137692,0,2,3
39356,1,1,137691,137692,137693,1,2,0
39357,1,3,137692,137693,137696,1,4,0
39358,1,1,137693,137696,137697,3,4,0
39359,2,1,137695,137697,137698,2,3,0
39360,2,2,137697,137698,137700,1,3,0
39361,1,1,137698,137700,137701,2,3,0
39362,2,2,137700,137701,137703,1,3,0
39363,2,1,137702,137703,137704,1,2,0
39364,6,3,137708,137708,137711,0,3,4
39365,6,2,137714,137714,137716,0,2,3
39366,4,2,137718,137718,137720,0,2,2
39367,2,3,137720,137720,137723,0,3,0
39368,6,2,137726,137726,137728,0,2,3
39369,6,2,137732,137732,137734,0,2,4
39370,6,1,137738,137738,137739,0,1,4
39371,2,1,137740,137740,137741,0,1,1
39372,2,2,137742,137742,137744,0,2,1
39373,2,3,137744,137744,137747,0,3,0
39374,3,2,137747,137747,137749,0,2,0
39375,3,2,137750,137750,137752,0,2,1
39376,2,1,137752,137752,137753,0,1,0
39377,4,2,137756,137756,137758,0,2,3
39378,3,3,137759,137759,137762,0,3,1
39379,2,3,137761,137762,137765,1,4,0
39380,6,1,137767,137767,137768,0,1,2
39381,6,3,137773,137773,137776,0,3,5
39382,3,2,137776,137776,137778,0,2,0
39383,4,2,137780,137780,137782,0,2,2
39384,5,2,137785,137785,137787,0,2,3
39385,1,3,137786,137787,137790,1,4,0
39386,3,3,137789,137790,137793,1,4,0
39387,1,3,137790,137793,137796,3,6,0
39388,2,1,137792,137796,137797,4,5,0
39389,6,2,137798,137798,137800,0,2,1
39390,5,1,137803,137803,137804,0,1,3
39391,4,3,137807,137807,137810,0,3,3
39392,4,3,137811,137811,137814,0,3,1
39393,6,2,137817,137817,137819,0,2,3
39394,2,3,137819,137819,137822,0,3,0
39395,6,2,137825,137825,137827,0,2,3
39396,1,2,137826,137827,137829,1,3,0
39397,3,2,137829,137829,137831,0,2,0
39398,3,3,137832,137832,137835,0,3,1
39399,6,1,137838,137838,137839,0,1,3
39400,5,2,137843,137843,137845,0,2,4
39401,4,2,137847,137847,137849,0,2,2
39402,3,2,137850,137850,137852,0,2,1
39403,6,1,137856,137856,137857,0,1,4
39404,1,1,137857,137857,137858,0,1,0
39405,3,3,137860,137860,137863,0,3,2
39406,4,3,137864,137864,137867,0,3,1
39407,5,3,137869,137869,137872,0,3,2
39408,3,3,137872,137872,137875,0,3,0
39409,6,2,137878,137878,137880,0,2,3
39410,2,3,137880,137880,137883,0,3,0
39411,3,1,137883,137883,137884,0,1,0
39412,5,3,137888,137888,137891,0,3,4
39413,3,2,137891,137891,137893,0,2,0
39414,3,2,137894,137894,137896,0,2,1
39415,6,3,137900,137900,137903,0,3,4
39416,5,2,137905,137905,137907,0,2,2
39417,2,1,137907,137907,137908,0,1,0
39418,2,3,137909,137909,137912,0,3,1
39419,3,3,137912,137912,137915,0,3,0
39420,2,3,137914,137915,137918,1,4,0
39421,6,2,137920,137920,137922,0,2,2
39422,1,3,137921,137922,137925,1,4,0
39423,3,2,137924,137925,137927,1,3,0
39424,5,2,137929,137929,137931,0,2,2
39425,2,1,137931,137931,137932,0,1,0
39426,5,1,137936,137936,137937,0,1,4
39427,3,3,137939,137939,137942,0,3,2
39428,2,2,137941,137942,137944,1,3,0
39429,6,3,137947,137947,137950,0,3,3
39430,3,3,137950,137950,137953,0,3,0
39431,2,3,137952,137953,137956,1,4,0
39432,5,1,137957,137957,137958,0,1,1
39433,6,2,137963,137963,137965,0,2,5
39434,2,2,137965,137965,137967,0,2,0
39435,3,2,137968,137968,137970,0,2,1
39436,2,1,137970,137970,137971,0,1,0
39437,1,2,137971,137971,137973,0,2,0
39438,1,1,137972,137973,137974,1,2,0
39439,1,2,137973,137974,137976,1,3,0
39440,1,3,137974,137976,137979,2,5,0
39441,1,2,137975,137979,137981,4,6,0
39442,4,1,137979,137981,137982,2,3,0
39443,5,2,137984,137984,137986,0,2,2
39444,4,2,137988,137988,137990,0,2,2
39445,6,1,137994,137994,137995,0,1,4
39446,4,2,137998,137998,138000,0,2,3
39447,2,2,138000,138000,138002,0,2,0
39448,1,1,138001,138002,138003,1,2,0
39449,5,1,138006,138006,138007,0,1,3
39450,3,2,138009,138009,138011,0,2,2
39451,3,2,138012,138012,138014,0,2,1
39452,4,3,138016,138016,138019,0,3,2
39453,5,3,138021,138021,138024,0,3,2
39454,6,1,138027,138027,138028,0,1,3
39455,6,3,138033,138033,138036,0,3,5
39456,4,1,138037,138037,138038,0,1,1
39457,1,2,138038,138038,138040,0,2,0
39458,5,3,138043,138043,138046,0,3,3
39459,2,1,138045,138046,138047,1,2,0
39460,2,2,138047,138047,138049,0,2,0
39461,2,1,138049,138049,138050,0,1,0
39462,5,2,138054,138054,138056,0,2,4
39463,4,1,138058,138058,138059,0,1,2
39464,6,1,138064,138064,138065,0,1,5
39465,5,2,138069,138069,138071,0,2,4
39466,1,2,138070,138071,138073,1,3,0
39467,4,3,138074,138074,138077,0,3,1
39468,4,3,138078,138078,138081,0,3,1
39469,2,1,138080,138081,138082,1,2,0
39470,1,1,138081,138082,138083,1,2,0
39471,2,3,138083,138083,138086,0,3,0
39472,3,3,138086,138086,138089,0,3,0
39473,4,1,138090,138090,138091,0,1,1
39474,6,3,138096,138096,138099,0,3,5
39475,3,3,138099,138099,138102,0,3,0
39476,5,3,138104,138104,138107,0,3,2
39477,3,1,138107,138107,138108,0,1,0
39478,2,1,138109,138109,138110,0,1,1
39479,4,1,138113,138113,138114,0,1,3
39480,4,2,138117,138117,138119,0,2,3
39481,6,3,138123,138123,138126,0,3,4
39482,6,3,138129,138129,138132,0,3,3
39483,5,2,138134,138134,138136,0,2,2
39484,2,3,138136,138136,138139,0,3,0
39485,6,2,138142,138142,138144,0,2,3
39486,2,3,138144,138144,138147,0,3,0
39487,2,2,138146,138147,138149,1,3,0
39488,5,1,138151,138151,138152,0,1,2
39489,6,2,138157,138157,138159,0,2,5
39490,3,2,138160,138160,138162,0,2,1
39491,3,1,138163,138163,138164,0,1,1
39492,6,3,138169,138169,138172,0,3,5
39493,3,3,138172,138172,138175,0,3,0
39494,3,3,138175,138175,138178,0,3,0
39495,6,2,138181,138181,138183,0,2,3
39496,1,3,138182,138183,138186,1,4,0
39497,6,1,138188,138188,138189,0,1,2
39498,6,3,138194,138194,138197,0,3,5
39499,2,2,138196,138197,138199,1,3,0
39500,3,3,138199,138199,138202,0,3,0
39501,2,2,138201,138202,138204,1,3,0
39502,1,3,138202,138204,138207,2,5,0
39503,1,3,138203,138207,138210,4,7,0
39504,4,3,138207,138210,138213,3,6,0
39505,5,3,138212,138213,138216,1,4,0
39506,3,1,138215,138216,138217,1,2,0
39507,5,3,138220,138220,138223,0,3,3
39508,4,2,138224,138224,138226,0,2,1
39509,3,3,138227,138227,138230,0,3,1
39510,6,2,138233,138233,138235,0,2,3
39511,2,1,138235,138235,138236,0,1,0
39512,1,3,138236,138236,138239,0,3,0
39513,1,2,138237,138239,138241,2,4,0
39514,5,3,138242,138242,138245,0,3,1
39515,2,3,138244,138245,138248,1,4,0
39516,2,2,138246,138248,138250,2,4,0
39517,2,2,138248,138250,138252,2,4,0
39518,1,3,138249,138252,138255,3,6,0
39519,2,1,138251,138255,138256,4,5,0
39520,2,2,138253,138256,138258,3,5,0
39521,3,1,138256,138258,138259,2,3,0
39522,2,1,138258,138259,138260,1,2,0
39523,4,3,138262,138262,138265,0,3,2
39524,2,1,138264,138265,138266,1,2,0
39525,4,2,138268,138268,138270,0,2,2
39526,1,1,138269,138270,138271,1,2,0
39527,3,1,138272,138272,138273,0,1,1
39528,2,1,138274,138274,138275,0,1,1
39529,6,3,138280,138280,138283,0,3,5
39530,6,2,138286,138286,138288,0,2,3
39531,2,2,138288,138288,138290,0,2,0
39532,2,2,138290,138290,138292,0,2,0
39533,6,3,138296,138296,138299,0,3,4
39534,2,1,138298,138299,138300,1,2,0
39535,3,1,138301,138301,138302,0,1,1
39536,1,2,138302,138302,138304,0,2,0
39537,6,3,138308,138308,138311,0,3,4
39538,6,3,138314,138314,138317,0,3,3
39539,5,1,138319,138319,138320,0,1,2
39540,3,3,138322,138322,138325,0,3,2
39541,2,3,138324,138325,138328,1,4,0
39542,4,3,138328,138328,138331,0,3,0
39543,3,3,138331,138331,138334,0,3,0
39544,6,2,138337,138337,138339,0,2,3
39545,5,2,138342,138342,138344,0,2,3
39546,3,3,138345,138345,138348,0,3,1
39547,1,1,138346,138348,138349,2,3,0
39548,3,1,138349,138349,138350,0,1,0
39549,6,3,138355,138355,138358,0,3,5
39550,6,3,138361,138361,138364,0,3,3
39551,4,2,138365,138365,138367,0,2,1
39552,5,3,138370,138370,138373,0,3,3
39553,3,2,138373,138373,138375,0,2,0
39554,1,2,138374,138375,138377,1,3,0
39555,4,1,138378,138378,138379,0,1,1
39556,4,1,138382,138382,138383,0,1,3
39557,5,1,138387,138387,138388,0,1,4
39558,5,2,138392,138392,138394,0,2,4
39559,4,3,138396,138396,138399,0,3,2
39560,1,3,138397,138399,138402,2,5,0
39561,1,3,138398,138402,138405,4,7,0
39562,6,2,138404,138405,138407,1,3,0
39563,1,2,138405,138407,138409,2,4,0
39564,6,2,138411,138411,138413,0,2,2
39565,4,1,138415,138415,138416,0,1,2
39566,6,1,138421,138421,138422,0,1,5
39567,5,3,138426,138426,138429,0,3,4
39568,4,3,138430,138430,138433,0,3,1
39569,5,2,138435,138435,138437,0,2,2
39570,6,1,138441,138441,138442,0,1,4
39571,4,1,138445,138445,138446,0,1,3
39572,2,2,138447,138447,138449,0,2,1
39573,6,3,138453,138453,138456,0,3,4
39574,2,2,138455,138456,138458,1,3,0
39575,3,3,138458,138458,138461,0,3,0
39576,5,2,138463,138463,138465,0,2,2
39577,1,3,138464,138465,138468,1,4,0
39578,6,2,138470,138470,138472,0,2,2
39579,6,1,138476,138476,138477,0,1,4
39580,4,2,138480,138480,138482,0,2,3
39581,4,1,138484,138484,138485,0,1,2
39582,1,1,138485,138485,138486,0,1,0
39583,3,1,138488,138488,138489,0,1,2
39584,4,3,138492,138492,138495,0,3,3
39585,3,3,138495,138495,138498,0,3,0
39586,2,2,138497,138498,138500,1,3,0
39587,3,2,138500,138500,138502,0,2,0
39588,5,2,138505,138505,138507,0,2,3
39589,4,3,138509,138509,138512,0,3,2
39590,3,3,138512,138512,138515,0,3,0
39591,1,1,138513,138515,138516,2,3,0
39592,1,1,138514,138516,138517,2,3,0
39593,5,1,138519,138519,138520,0,1,2
39594,2,2,138521,138521,138523,0,2,1
39595,5,1,138526,138526,138527,0,1,3
39596,6,1,138532,138532,138533,0,1,5
39597,4,3,138536,138536,138539,0,3,3
39598,4,3,138540,138540,138543,0,3,1
39599,2,1,138542,138543,138544,1,2,0
39600,2,1,138544,138544,138545,0,1,0
39601,5,2,138549,138549,138551,0,2,4
39602,1,3,138550,138551,138554,1,4,0
39603,5,1,138555,138555,138556,0,1,1
39604,1,1,138556,138556,138557,0,1,0
39605,3,3,138559,138559,138562,0,3,2
39606,5,2,138564,138564,138566,0,2,2
39607,1,1,138565,138566,138567,1,2,0
39608,2,2,138567,138567,138569,0,2,0
39609,2,3,138569,138569,138572,0,3,0
39610,4,2,138573,138573,138575,0,2,1
39611,2,2,138575,138575,138577,0,2,0
39612,2,1,138577,138577,138578,0,1,0
39613,3,2,138580,138580,138582,0,2,2
39614,3,3,138583,138583,138586,0,3,1
39615,6,2,138589,138589,138591,0,2,3
39616,5,1,138594,138594,138595,0,1,3
39617,5,1,138599,138599,138600,0,1,4
39618,3,3,138602,138602,138605,0,3,2
39619,2,2,138604,138605,138607,1,3,0
39620,4,1,138608,138608,138609,0,1,1
39621,2,2,138610,138610,138612,0,2,1
39622,4,1,138614,138614,138615,0,1,2
39623,1,2,138615,138615,138617,0,2,0
39624,4,3,138619,138619,138622,0,3,2
39625,5,2,138624,138624,138626,0,2,2
39626,2,2,138626,138626,138628,0,2,0
39627,1,2,138627,138628,138630,1,3,0
39628,1,1,138628,138630,138631,2,3,0
39629,5,3,138633,138633,138636,0,3,2
39630,2,2,138635,138636,138638,1,3,0
39631,6,1,138641,138641,138642,0,1,3
39632,3,1,138644,138644,138645,0,1,2
39633,1,1,138645,138645,138646,0,1,0
39634,5,3,138650,138650,138653,0,3,4
39635,6,1,138656,138656,138657,0,1,3
39636,4,3,138660,138660,138663,0,3,3
39637,3,1,138663,138663,138664,0,1,0
39638,2,1,138665,138665,138666,0,1,1
39639,5,1,138670,138670,138671,0,1,4
39640,4,1,138674,138674,138675,0,1,3
39641,5,2,138679,138679,138681,0,2,4
39642,1,3,138680,138681,138684,1,4,0
39643,6,3,138686,138686,138689,0,3,2
39644,3,3,138689,138689,138692,0,3,0
39645,3,2,138692,138692,138694,0,2,0
39646,2,2,138694,138694,138696,0,2,0
39647,6,2,138700,138700,138702,0,2,4
39648,1,1,138701,138702,138703,1,2,0
39649,6,2,138707,138707,138709,0,2,4
39650,3,2,138710,138710,138712,0,2,1
39651,6,1,138716,138716,138717,0,1,4
39652,6,1,138722,138722,138723,0,1,5
39653,5,2,138727,138727,138729,0,2,4
39654,1,2,138728,138729,138731,1,3,0
39655,6,2,138734,138734,138736,0,2,3
39656,1,3,138735,138736,138739,1,4,0
39657,3,1,138738,138739,138740,1,2,0
39658,6,3,138744,138744,138747,0,3,4
39659,2,3,138746,138747,138750,1,4,0
39660,4,2,138750,138750,138752,0,2,0
39661,6,2,138756,138756,138758,0,2,4
39662,3,1,138759,138759,138760,0,1,1
39663,4,2,138763,138763,138765,0,2,3
39664,3,2,138766,138766,138768,0,2,1
39665,3,3,138769,138769,138772,0,3,1
39666,4,3,138773,138773,138776,0,3,1
39667,1,2,138774,138776,138778,2,4,0
39668,5,3,138779,138779,138782,0,3,1
39669,4,2,138783,138783,138785,0,2,1
39670,4,2,138787,138787,138789,0,2,2
39671,5,1,138792,138792,138793,0,1,3
39672,3,1,138795,138795,138796,0,1,2
39673,2,3,138797,138797,138800,0,3,1
39674,6,2,138803,138803,138805,0,2,3
39675,1,1,138804,138805,138806,1,2,0
39676,4,2,138808,138808,138810,0,2,2
39677,2,2,138810,138810,138812,0,2,0
39678,5,1,138815,138815,138816,0,1,3
39679,5,1,138820,138820,138821,0,1,4
39680,2,1,138822,138822,138823,0,1,1
39681,2,2,138824,138824,138826,0,2,1
39682,1,3,138825,138826,138829,1,4,0
39683,3,1,138828,138829,138830,1,2,0
39684,2,1,138830,138830,138831,0,1,0
39685,6,3,138836,138836,138839,0,3,5
39686,1,1,138837,138839,138840,2,3,0
39687,2,1,138839,138840,138841,1,2,0
39688,1,3,138840,138841,138844,1,4,0
39689,2,2,138842,138844,138846,2,4,0
39690,5,2,138847,138847,138849,0,2,1
39691,4,2,138851,138851,138853,0,2,2
39692,1,1,138852,138853,138854,1,2,0
39693,2,2,138854,138854,138856,0,2,0
39694,4,3,138858,138858,138861,0,3,2
39695,5,1,138863,138863,138864,0,1,2
39696,5,1,138868,138868,138869,0,1,4
39697,6,3,138874,138874,138877,0,3,5
39698,1,3,138875,138877,138880,2,5,0
39699,1,2,138876,138880,138882,4,6,0
39700,1,1,138877,138882,138883,5,6,0
39701,6,2,138883,138883,138885,0,2,0
39702,3,3,138886,138886,138889,0,3,1
39703,4,2,138890,138890,138892,0,2,1
39704,1,2,138891,138892,138894,1,3,0
39705,5,1,138896,138896,138897,0,1,2
39706,4,2,138900,138900,138902,0,2,3
39707,2,1,138902,138902,138903,0,1,0
39708,4,1,138906,138906,138907,0,1,3
39709,5,2,138911,138911,138913,0,2,4
39710,2,1,138913,138913,138914,0,1,0
39711,2,2,138915,138915,138917,0,2,1
39712,3,3,138918,138918,138921,0,3,1
39713,4,3,138922,138922,138925,0,3,1
39714,6,1,138928,138928,138929,0,1,3
39715,3,2,138931,138931,138933,0,2,2
39716,4,3,138935,138935,138938,0,3,2
39717,1,3,138936,138938,138941,2,5,0
39718,6,3,138942,138942,138945,0,3,1
39719,1,2,138943,138945,138947,2,4,0
39720,6,1,138949,138949,138950,0,1,2
39721,2,2,138951,138951,138953,0,2,1
39722,1,1,138952,138953,138954,1,2,0
39723,3,2,138955,138955,138957,0,2,1
39724,5,3,138960,138960,138963,0,3,3
39725,4,2,138964,138964,138966,0,2,1
39726,2,2,138966,138966,138968,0,2,0
39727,1,2,138967,138968,138970,1,3,0
39728,3,2,138970,138970,138972,0,2,0
39729,6,3,138976,138976,138979,0,3,4
39730,6,2,138982,138982,138984,0,2,3
39731,1,2,138983,138984,138986,1,3,0
39732,2,2,138985,138986,138988,1,3,0
39733,6,3,138991,138991,138994,0,3,3
39734,1,3,138992,138994,138997,2,5,0
39735,4,1,138996,138997,138998,1,2,0
39736,3,1,138999,138999,139000,0,1,1
39737,3,2,139002,139002,139004,0,2,2
39738,5,3,139007,139007,139010,0,3,3
39739,4,3,139011,139011,139014,0,3,1
39740,3,2,139014,139014,139016,0,2,0
39741,1,1,139015,139016,139017,1,2,0
39742,2,1,139017,139017,139018,0,1,0
39743,5,1,139022,139022,139023,0,1,4
39744,4,2,139026,139026,139028,0,2,3
39745,6,3,139032,139032,139035,0,3,4
39746,5,2,139037,139037,139039,0,2,2
39747,2,3,139039,139039,139042,0,3,0
39748,4,2,139043,139043,139045,0,2,1
39749,6,2,139049,139049,139051,0,2,4
39750,5,2,139054,139054,139056,0,2,3
39751,3,2,139057,139057,139059,0,2,1
39752,3,1,139060,139060,139061,0,1,1
39753,6,2,139066,139066,139068,0,2,5
39754,4,2,139070,139070,139072,0,2,2
39755,2,1,139072,139072,139073,0,1,0
39756,1,3,139073,139073,139076,0,3,0
39757,3,3,139076,139076,139079,0,3,0
39758,5,3,139081,139081,139084,0,3,2
39759,3,1,139084,139084,139085,0,1,0
39760,1,3,139085,139085,139088,0,3,0
39761,5,2,139090,139090,139092,0,2,2
39762,1,3,139091,139092,139095,1,4,0
39763,3,2,139094,139095,139097,1,3,0
39764,5,1,139099,139099,139100,0,1,2
39765,5,2,139104,139104,139106,0,2,4
39766,3,3,139107,139107,139110,0,3,1
39767,3,1,139110,139110,139111,0,1,0
39768,1,2,139111,139111,139113,0,2,0
39769,4,2,139115,139115,139117,0,2,2
39770,1,1,139116,139117,139118,1,2,0
39771,3,2,139119,139119,139121,0,2,1
39772,1,3,139120,139121,139124,1,4,0
39773,6,2,139126,139126,139128,0,2,2
39774,2,2,139128,139128,139130,0,2,0
39775,5,1,139133,139133,139134,0,1,3
39776,1,3,139134,139134,139137,0,3,0
39777,5,2,139139,139139,139141,0,2,2
39778,5,3,139144,139144,139147,0,3,3
39779,2,3,139146,139147,139150,1,4,0
39780,3,1,139149,139150,139151,1,2,0
39781,4,2,139153,139153,139155,0,2,2
39782,3,2,139156,139156,139158,0,2,1
39783,5,1,139161,139161,139162,0,1,3
39784,6,3,139167,139167,139170,0,3,5
39785,3,1,139170,139170,139171,0,1,0
39786,4,2,139174,139174,139176,0,2,3
39787,4,1,139178,139178,139179,0,1,2
39788,1,1,139179,139179,139180,0,1,0
39789,1,3,139180,139180,139183,0,3,0
39790,1,2,139181,139183,139185,2,4,0
39791,3,3,139184,139185,139188,1,4,0
39792,2,2,139186,139188,139190,2,4,0
39793,3,2,139189,139190,139192,1,3,0
39794,4,2,139193,139193,139195,0,2,1
39795,4,3,139197,139197,139200,0,3,2
39796,4,2,139201,139201,139203,0,2,1
39797,6,2,139207,139207,139209,0,2,4
39798,2,2,139209,139209,139211,0,2,0
39799,5,1,139214,139214,139215,0,1,3
39800,2,3,139216,139216,139219,0,3,1
39801,4,1,139220,139220,139221,0,1,1
39802,1,2,139221,139221,139223,0,2,0
39803,4,2,139225,139225,139227,0,2,2
39804,4,2,139229,139229,139231,0,2,2
39805,5,1,139234,139234,139235,0,1,3
39806,5,2,139239,139239,139241,0,2,4
39807,4,1,139243,139243,139244,0,1,2
39808,6,2,139249,139249,139251,0,2,5
39809,1,1,139250,139251,139252,1,2,0
39810,5,1,139255,139255,139256,0,1,3
39811,4,3,139259,139259,139262,0,3,3
39812,5,3,139264,139264,139267,0,3,2
39813,2,2,139266,139267,139269,1,3,0
39814,4,3,139270,139270,139273,0,3,1
39815,1,1,139271,139273,139274,2,3,0
39816,5,1,139276,139276,139277,0,1,2
39817,2,1,139278,139278,139279,0,1,1
39818,5,2,139283,139283,139285,0,2,4
39819,6,3,139289,139289,139292,0,3,4
39820,1,3,139290,139292,139295,2,5,0
39821,2,1,139292,139295,139296,3,4,0
39822,4,1,139296,139296,139297,0,1,0
39823,1,3,139297,139297,139300,0,3,0
39824,3,3,139300,139300,139303,0,3,0
39825,3,3,139303,139303,139306,0,3,0
39826,2,1,139305,139306,139307,1,2,0
39827,3,1,139308,139308,139309,0,1,1
39828,4,1,139312,139312,139313,0,1,3
39829,1,3,139313,139313,139316,0,3,0
39830,6,1,139319,139319,139320,0,1,3
39831,4,3,139323,139323,139326,0,3,3
39832,2,1,139325,139326,139327,1,2,0
39833,3,3,139328,139328,139331,0,3,1
39834,5,3,139333,139333,139336,0,3,2
39835,2,2,139335,139336,139338,1,3,0
39836,5,3,139340,139340,139343,0,3,2
39837,2,2,139342,139343,139345,1,3,0
39838,1,2,139343,139345,139347,2,4,0
39839,5,3,139348,139348,139351,0,3,1
39840,2,3,139350,139351,139354,1,4,0
39841,4,2,139354,139354,139356,0,2,0
39842,5,1,139359,139359,139360,0,1,3
39843,3,2,139362,139362,139364,0,2,2
39844,2,2,139364,139364,139366,0,2,0
39845,6,2,139370,139370,139372,0,2,4
39846,4,1,139374,139374,139375,0,1,2
39847,6,3,139380,139380,139383,0,3,5
39848,6,1,139386,139386,139387,0,1,3
39849,2,3,139388,139388,139391,0,3,1
39850,1,1,139389,139391,139392,2,3,0
39851,5,1,139394,139394,139395,0,1,2
39852,3,3,139397,139397,139400,0,3,2
39853,2,3,139399,139400,139403,1,4,0
39854,2,1,139401,139403,139404,2,3,0
39855,5,3,139406,139406,139409,0,3,2
39856,3,3,139409,139409,139412,0,3,0
39857,6,3,139415,139415,139418,0,3,3
39858,6,1,139421,139421,139422,0,1,3
39859,1,2,139422,139422,139424,0,2,0
39860,3,1,139425,139425,139426,0,1,1
39861,3,3,139428,139428,139431,0,3,2
39862,2,2,139430,139431,139433,1,3,0
39863,1,3,139431,139433,139436,2,5,0
39864,5,2,139436,139436,139438,0,2,0
39865,1,3,139437,139438,139441,1,4,0
39866,1,3,139438,139441,139444,3,6,0
39867,2,2,139440,139444,139446,4,6,0
39868,6,1,139446,139446,139447,0,1,0
39869,6,1,139452,139452,139453,0,1,5
39870,3,1,139455,139455,139456,0,1,2
39871,5,1,139460,139460,139461,0,1,4
39872,2,3,139462,139462,139465,0,3,1
39873,1,3,139463,139465,139468,2,5,0
39874,3,2,139466,139468,139470,2,4,0
39875,2,3,139468,139470,139473,2,5,0
39876,4,3,139472,139473,139476,1,4,0
39877,3,3,139475,139476,139479,1,4,0
39878,4,1,139479,139479,139480,0,1,0
39879,4,2,139483,139483,139485,0,2,3
39880,3,3,139486,139486,139489,0,3,1
39881,2,2,139488,139489,139491,1,3,0
39882,3,3,139491,139491,139494,0,3,0
39883,6,2,139497,139497,139499,0,2,3
39884,6,3,139503,139503,139506,0,3,4
39885,6,1,139509,139509,139510,0,1,3
39886,2,3,139511,139511,139514,0,3,1
39887,1,2,139512,139514,139516,2,4,0
39888,3,1,139515,139516,139517,1,2,0
39889,2,1,139517,139517,139518,0,1,0
39890,1,3,139518,139518,139521,0,3,0
39891,3,3,139521,139521,139524,0,3,0
39892,2,3,139523,139524,139527,1,4,0
39893,6,2,139529,139529,139531,0,2,2
39894,5,2,139534,139534,139536,0,2,3
39895,5,2,139539,139539,139541,0,2,3
39896,1,1,139540,139541,139542,1,2,0
39897,6,1,139546,139546,139547,0,1,4
39898,2,2,139548,139548,139550,0,2,1
39899,4,1,139552,139552,139553,0,1,2
39900,6,2,139558,139558,139560,0,2,5
39901,2,3,139560,139560,139563,0,3,0
39902,1,3,139561,139563,139566,2,5,0
39903,3,3,139564,139566,139569,2,5,0
39904,3,1,139567,139569,139570,2,3,0
39905,4,2,139571,139571,139573,0,2,1
39906,1,3,139572,139573,139576,1,4,0
39907,6,1,139578,139578,139579,0,1,2
39908,4,2,139582,139582,139584,0,2,3
39909,4,1,139586,139586,139587,0,1,2
39910,1,3,139587,139587,139590,0,3,0
39911,5,3,139592,139592,139595,0,3,2
39912,1,3,139593,139595,139598,2,5,0
39913,5,2,139598,139598,139600,0,2,0
39914,4,2,139602,139602,139604,0,2,2
39915,1,3,139603,139604,139607,1,4,0
39916,5,1,139608,139608,139609,0,1,1
39917,5,1,139613,139613,139614,0,1,4
39918,3,1,139616,139616,139617,0,1,2
39919,4,1,139620,139620,139621,0,1,3
39920,1,3,139621,139621,139624,0,3,0
39921,1,1,139622,139624,139625,2,3,0
39922,6,2,139628,139628,139630,0,2,3
39923,5,2,139633,139633,139635,0,2,3
39924,3,3,139636,139636,139639,0,3,1
39925,1,3,139637,139639,139642,2,5,0
39926,5,1,139642,139642,139643,0,1,0
39927,4,3,139646,139646,139649,0,3,3
39928,5,3,139651,139651,139654,0,3,2
39929,6,2,139657,139657,139659,0,2,3
39930,5,3,139662,139662,139665,0,3,3
39931,6,2,139668,139668,139670,0,2,3
39932,2,2,139670,139670,139672,0,2,0
39933,2,3,139672,139672,139675,0,3,0
39934,1,1,139673,139675,139676,2,3,0
39935,1,3,139674,139676,139679,2,5,0
39936,3,2,139677,139679,139681,2,4,0
39937,3,3,139680,139681,139684,1,4,0
39938,2,1,139682,139684,139685,2,3,0
39939,6,2,139688,139688,139690,0,2,3
39940,5,1,139693,139693,139694,0,1,3
39941,1,3,139694,139694,139697,0,3,0
39942,1,3,139695,139697,139700,2,5,0
39943,1,3,139696,139700,139703,4,7,0
39944,3,1,139699,139703,139704,4,5,0
39945,1,2,139700,139704,139706,4,6,0
39946,3,2,139703,139706,139708,3,5,0
39947,5,2,139708,139708,139710,0,2,0
39948,5,2,139713,139713,139715,0,2,3
39949,4,1,139717,139717,139718,0,1,2
39950,3,1,139720,139720,139721,0,1,2
39951,2,2,139722,139722,139724,0,2,1
39952,5,2,139727,139727,139729,0,2,3
39953,1,2,139728,139729,139731,1,3,0
39954,1,1,139729,139731,139732,2,3,0
39955,3,3,139732,139732,139735,0,3,0
39956,3,1,139735,139735,139736,0,1,0
39957,2,2,139737,139737,139739,0,2,1
39958,6,3,139743,139743,139746,0,3,4
39959,4,2,139747,139747,139749,0,2,1
39960,2,2,139749,139749,139751,0,2,0
39961,1,2,139750,139751,139753,1,3,0
39962,5,1,139755,139755,139756,0,1,2
39963,1,2,139756,139756,139758,0,2,0
39964,5,2,139761,139761,139763,0,2,3
39965,6,1,139767,139767,139768,0,1,4
39966,1,2,139768,139768,139770,0,2,0
39967,6,1,139774,139774,139775,0,1,4
39968,4,2,139778,139778,139780,0,2,3
39969,4,1,139782,139782,139783,0,1,2
39970,2,1,139784,139784,139785,0,1,1
39971,1,3,139785,139785,139788,0,3,0
39972,1,2,139786,139788,139790,2,4,0
39973,2,2,139788,139790,139792,2,4,0
39974,6,3,139794,139794,139797,0,3,2
39975,2,3,139796,139797,139800,1,4,0
39976,6,1,139802,139802,139803,0,1,2
39977,5,1,139807,139807,139808,0,1,4
39978,6,3,139813,139813,139816,0,3,5
39979,5,1,139818,139818,139819,0,1,2
39980,3,1,139821,139821,139822,0,1,2
39981,3,3,139824,139824,139827,0,3,2
39982,3,3,139827,139827,139830,0,3,0
39983,3,1,139830,139830,139831,0,1,0
39984,2,1,139832,139832,139833,0,1,1
39985,1,1,139833,139833,139834,0,1,0
39986,3,2,139836,139836,139838,0,2,2
39987,5,2,139841,139841,139843,0,2,3
39988,5,3,139846,139846,139849,0,3,3
39989,4,2,139850,139850,139852,0,2,1
39990,6,2,139856,139856,139858,0,2,4
39991,6,3,139862,139862,139865,0,3,4
39992,2,3,139864,139865,139868,1,4,0
39993,6,2,139870,139870,139872,0,2,2
39994,6,3,139876,139876,139879,0,3,4
39995,2,3,139878,139879,139882,1,4,0
39996,6,2,139884,139884,139886,0,2,2
39997,6,1,139890,139890,139891,0,1,4
39998,1,2,139891,139891,139893,0,2,0
39999,4,3,139895,139895,139898,0,3,2
40000,6,3,139901,139901,139904,0,3,3
40001,5,2,139906,139906,139908,0,2,2
40002,5,2,139911,139911,139913,0,2,3
40003,1,1,139912,139913,139914,1,2,0
40004,6,2,139918,139918,139920,0,2,4
40005,2,3,139920,139920,139923,0,3,0
40006,6,1,139926,139926,139927,0,1,3
40007,1,2,139927,139927,139929,0,2,0
40008,2,3,139929,139929,139932,0,3,0
40009,4,3,139933,139933,139936,0,3,1
40010,2,1,139935,139936,139937,1,2,0
40011,6,2,139941,139941,139943,0,2,4
40012,2,2,139943,139943,139945,0,2,0
40013,2,3,139945,139945,139948,0,3,0
40014,3,3,139948,139948,139951,0,3,0
40015,2,3,139950,139951,139954,1,4,0
40016,3,1,139953,139954,139955,1,2,0
40017,3,2,139956,139956,139958,0,2,1
40018,4,1,139960,139960,139961,0,1,2
40019,6,2,139966,139966,139968,0,2,5
40020,5,3,139971,139971,139974,0,3,3
40021,1,3,139972,139974,139977,2,5,0
40022,2,1,139974,139977,139978,3,4,0
40023,1,1,139975,139978,139979,3,4,0
40024,5,2,139980,139980,139982,0,2,1
40025,3,1,139983,139983,139984,0,1,1
40026,4,1,139987,139987,139988,0,1,3
40027,5,1,139992,139992,139993,0,1,4
40028,2,3,139994,139994,139997,0,3,1
40029,5,1,139999,139999,140000,0,1,2
40030,6,1,140005,140005,140006,0,1,5
40031,5,2,140010,140010,140012,0,2,4
40032,3,2,140013,140013,140015,0,2,1
40033,1,1,140014,140015,140016,1,2,0
40034,2,1,140016,140016,140017,0,1,0
40035,1,1,140017,140017,140018,0,1,0
40036,3,3,140020,140020,140023,0,3,2
40037,1,1,140021,140023,140024,2,3,0
40038,2,1,140023,140024,140025,1,2,0
40039,4,2,140027,140027,140029,0,2,2
40040,5,2,140032,140032,140034,0,2,3
40041,1,2,140033,140034,140036,1,3,0
40042,2,1,140035,140036,140037,1,2,0
40043,3,1,140038,140038,140039,0,1,1
40044,4,2,140042,140042,140044,0,2,3
40045,5,3,140047,140047,140050,0,3,3
40046,4,1,140051,140051,140052,0,1,1
40047,5,3,140056,140056,140059,0,3,4
40048,2,2,140058,140059,140061,1,3,0
40049,1,2,140059,140061,140063,2,4,0
40050,5,2,140064,140064,140066,0,2,1
40051,5,1,140069,140069,140070,0,1,3
40052,5,3,140074,140074,140077,0,3,4
40053,3,3,140077,140077,140080,0,3,0
40054,3,3,140080,140080,140083,0,3,0
40055,4,2,140084,140084,140086,0,2,1
40056,6,1,140090,140090,140091,0,1,4
40057,3,3,140093,140093,140096,0,3,2
40058,6,1,140099,140099,140100,0,1,3
40059,2,3,140101,140101,140104,0,3,1
40060,3,2,140104,140104,140106,0,2,0
40061,5,3,140109,140109,140112,0,3,3
40062,4,3,140113,140113,140116,0,3,1
40063,3,1,140116,140116,140117,0,1,0
40064,4,1,140120,140120,140121,0,1,3
40065,6,2,140126,140126,140128,0,2,5
40066,2,2,140128,140128,140130,0,2,0
40067,6,3,140134,140134,140137,0,3,4
40068,5,2,140139,140139,140141,0,2,2
40069,6,1,140145,140145,140146,0,1,4
40070,6,1,140151,140151,140152,0,1,5
40071,6,2,140157,140157,140159,0,2,5
40072,3,3,140160,140160,140163,0,3,1
40073,4,1,140164,140164,140165,0,1,1
40074,4,1,140168,140168,140169,0,1,3
40075,2,2,140170,140170,140172,0,2,1
40076,4,3,140174,140174,140177,0,3,2
40077,6,1,140180,140180,140181,0,1,3
40078,5,2,140185,140185,140187,0,2,4
40079,6,3,140191,140191,140194,0,3,4
40080,4,2,140195,140195,140197,0,2,1
40081,2,2,140197,140197,140199,0,2,0
40082,1,1,140198,140199,140200,1,2,0
40083,2,2,140200,140200,140202,0,2,0
40084,4,2,140204,140204,140206,0,2,2
40085,4,3,140208,140208,140211,0,3,2
40086,2,3,140210,140211,140214,1,4,0
40087,6,3,140216,140216,140219,0,3,2
40088,3,1,140219,140219,140220,0,1,0
40089,4,3,140223,140223,140226,0,3,3
40090,6,1,140229,140229,140230,0,1,3
40091,5,1,140234,140234,140235,0,1,4
40092,4,3,140238,140238,140241,0,3,3
40093,1,1,140239,140241,140242,2,3,0
40094,1,1,140240,140242,140243,2,3,0
40095,4,2,140244,140244,140246,0,2,1
40096,6,2,140250,140250,140252,0,2,4
40097,6,2,140256,140256,140258,0,2,4
40098,3,1,140259,140259,140260,0,1,1
40099,2,1,140261,140261,140262,0,1,1
40100,5,2,140266,140266,140268,0,2,4
40101,4,1,140270,140270,140271,0,1,2
40102,4,2,140274,140274,140276,0,2,3
40103,1,1,140275,140276,140277,1,2,0
40104,2,1,140277,140277,140278,0,1,0
40105,2,1,140279,140279,140280,0,1,1
40106,4,3,140283,140283,140286,0,3,3
40107,5,3,140288,140288,140291,0,3,2
40108,3,1,140291,140291,140292,0,1,0
40109,2,1,140293,140293,140294,0,1,1
40110,6,1,140299,140299,140300,0,1,5
40111,6,3,140305,140305,140308,0,3,5
40112,2,2,140307,140308,140310,1,3,0
40113,4,1,140311,140311,140312,0,1,1
40114,6,2,140317,140317,140319,0,2,5
40115,3,2,140320,140320,140322,0,2,1
40116,3,3,140323,140323,140326,0,3,1
40117,3,3,140326,140326,140329,0,3,0
40118,1,2,140327,140329,140331,2,4,0
40119,4,3,140331,140331,140334,0,3,0
40120,4,1,140335,140335,140336,0,1,1
40121,6,3,140341,140341,140344,0,3,5
40122,1,3,140342,140344,140347,2,5,0
40123,6,1,140348,140348,140349,0,1,1
40124,2,3,140350,140350,140353,0,3,1
40125,2,1,140352,140353,140354,1,2,0
40126,3,1,140355,140355,140356,0,1,1
40127,3,3,140358,140358,140361,0,3,2
40128,1,3,140359,140361,140364,2,5,0
40129,5,3,140364,140364,140367,0,3,0
40130,5,1,140369,140369,140370,0,1,2
40131,6,1,140375,140375,140376,0,1,5
40132,6,1,140381,140381,140382,0,1,5
40133,3,3,140384,140384,140387,0,3,2
40134,2,2,140386,140387,140389,1,3,0
40135,4,3,140390,140390,140393,0,3,1
40136,2,1,140392,140393,140394,1,2,0
40137,5,1,140397,140397,140398,0,1,3
40138,4,1,140401,140401,140402,0,1,3
40139,5,3,140406,140406,140409,0,3,4
40140,1,3,140407,140409,140412,2,5,0
40141,1,2,140408,140412,140414,4,6,0
40142,2,2,140410,140414,140416,4,6,0
40143,3,1,140413,140416,140417,3,4,0
40144,4,1,140417,140417,140418,0,1,0
40145,6,1,140423,140423,140424,0,1,5
40146,6,1,140429,140429,140430,0,1,5
40147,2,2,140431,140431,140433,0,2,1
40148,3,2,140434,140434,140436,0,2,1
40149,4,2,140438,140438,140440,0,2,2
40150,1,3,140439,140440,140443,1,4,0
40151,2,1,140441,140443,140444,2,3,0
40152,1,3,140442,140444,140447,2,5,0
40153,1,1,140443,140447,140448,4,5,0
40154,2,1,140445,140448,140449,3,4,0
40155,5,1,140450,140450,140451,0,1,1
40156,1,2,140451,140451,140453,0,2,0
40157,4,2,140455,140455,140457,0,2,2
40158,4,1,140459,140459,140460,0,1,2
40159,2,1,140461,140461,140462,0,1,1
40160,3,3,140464,140464,140467,0,3,2
40161,1,2,140465,140467,140469,2,4,0
40162,3,1,140468,140469,140470,1,2,0
40163,2,3,140470,140470,140473,0,3,0
40164,1,3,140471,140473,140476,2,5,0
40165,1,1,140472,140476,140477,4,5,0
40166,5,1,140477,140477,140478,0,1,0
40167,6,3,140483,140483,140486,0,3,5
40168,3,2,140486,140486,140488,0,2,0
40169,1,1,140487,140488,140489,1,2,0
40170,3,2,140490,140490,140492,0,2,1
40171,2,1,140492,140492,140493,0,1,0
40172,3,2,140495,140495,140497,0,2,2
40173,2,3,140497,140497,140500,0,3,0
40174,2,1,140499,140500,140501,1,2,0
40175,2,1,140501,140501,140502,0,1,0
40176,2,2,140503,140503,140505,0,2,1
40177,1,1,140504,140505,140506,1,2,0
40178,5,2,140509,140509,140511,0,2,3
40179,3,1,140512,140512,140513,0,1,1
40180,4,2,140516,140516,140518,0,2,3
40181,4,2,140520,140520,140522,0,2,2
40182,1,3,140521,140522,140525,1,4,0
40183,3,1,140524,140525,140526,1,2,0
40184,1,1,140525,140526,140527,1,2,0
40185,3,3,140528,140528,140531,0,3,1
40186,3,1,140531,140531,140532,0,1,0
40187,2,1,140533,140533,140534,0,1,1
40188,2,1,140535,140535,140536,0,1,1
40189,3,3,140538,140538,140541,0,3,2
40190,4,1,140542,140542,140543,0,1,1
40191,4,2,140546,140546,140548,0,2,3
40192,4,3,140550,140550,140553,0,3,2
40193,3,1,140553,140553,140554,0,1,0
40194,2,3,140555,140555,140558,0,3,1
40195,3,1,140558,140558,140559,0,1,0
40196,6,2,140564,140564,140566,0,2,5
40197,1,3,140565,140566,140569,1,4,0
40198,6,3,140571,140571,140574,0,3,2
40199,1,2,140572,140574,140576,2,4,0
40200,5,1,140577,140577,140578,0,1,1
40201,4,3,140581,140581,140584,0,3,3
40202,4,1,140585,140585,140586,0,1,1
40203,6,1,140591,140591,140592,0,1,5
40204,2,1,140593,140593,140594,0,1,1
40205,5,3,140598,140598,140601,0,3,4
40206,2,2,140600,140601,140603,1,3,0
40207,6,3,140606,140606,140609,0,3,3
40208,4,1,140610,140610,140611,0,1,1
40209,4,3,140614,140614,140617,0,3,3
40210,5,3,140619,140619,140622,0,3,2
40211,2,3,140621,140622,140625,1,4,0
40212,2,2,140623,140625,140627,2,4,0
40213,5,3,140628,140628,140631,0,3,1
40214,5,2,140633,140633,140635,0,2,2
40215,5,2,140638,140638,140640,0,2,3
40216,1,3,140639,140640,140643,1,4,0
40217,1,2,140640,140643,140645,3,5,0
40218,1,3,140641,140645,140648,4,7,0
40219,4,3,140645,140648,140651,3,6,0
40220,3,1,140648,140651,140652,3,4,0
40221,6,3,140654,140654,140657,0,3,2
40222,1,1,140655,140657,140658,2,3,0
40223,6,2,140661,140661,140663,0,2,3
40224,3,1,140664,140664,140665,0,1,1
40225,4,3,140668,140668,140671,0,3,3
40226,1,3,140669,140671,140674,2,5,0
40227,4,2,140673,140674,140676,1,3,0
40228,6,3,140679,140679,140682,0,3,3
40229,6,3,140685,140685,140688,0,3,3
40230,4,1,140689,140689,140690,0,1,1
40231,3,2,140692,140692,140694,0,2,2
40232,5,1,140697,140697,140698,0,1,3
40233,6,3,140703,140703,140706,0,3,5
40234,2,1,140705,140706,140707,1,2,0
40235,3,2,140708,140708,140710,0,2,1
40236,4,1,140712,140712,140713,0,1,2
40237,5,2,140717,140717,140719,0,2,4
40238,6,2,140723,140723,140725,0,2,4
40239,2,3,140725,140725,140728,0,3,0
40240,4,1,140729,140729,140730,0,1,1
40241,6,2,140735,140735,140737,0,2,5
40242,2,3,140737,140737,140740,0,3,0
40243,1,1,140738,140740,140741,2,3,0
40244,3,1,140741,140741,140742,0,1,0
40245,4,3,140745,140745,140748,0,3,3
40246,2,2,140747,140748,140750,1,3,0
40247,2,3,140749,140750,140753,1,4,0
40248,4,3,140753,140753,140756,0,3,0
40249,2,2,140755,140756,140758,1,3,0
40250,1,2,140756,140758,140760,2,4,0
40251,3,1,140759,140760,140761,1,2,0
40252,5,1,140764,140764,140765,0,1,3
40253,6,2,140770,140770,140772,0,2,5
40254,1,2,140771,140772,140774,1,3,0
40255,3,2,140774,140774,140776,0,2,0
40256,4,1,140778,140778,140779,0,1,2
40257,3,3,140781,140781,140784,0,3,2
40258,3,2,140784,140784,140786,0,2,0
40259,4,1,140788,140788,140789,0,1,2
40260,5,3,140793,140793,140796,0,3,4
40261,6,2,140799,140799,140801,0,2,3
40262,4,1,140803,140803,140804,0,1,2
40263,3,1,140806,140806,140807,0,1,2
40264,5,3,140811,140811,140814,0,3,4
40265,1,1,140812,140814,140815,2,3,0
40266,4,1,140816,140816,140817,0,1,1
40267,4,1,140820,140820,140821,0,1,3
40268,2,1,140822,140822,140823,0,1,1
40269,1,2,140823,140823,140825,0,2,0
40270,1,3,140824,140825,140828,1,4,0
40271,6,2,140830,140830,140832,0,2,2
40272,6,1,140836,140836,140837,0,1,4
40273,4,3,140840,140840,140843,0,3,3
40274,6,3,140846,140846,140849,0,3,3
40275,5,2,140851,140851,140853,0,2,2
40276,6,1,140857,140857,140858,0,1,4
40277,6,2,140863,140863,140865,0,2,5
40278,1,1,140864,140865,140866,1,2,0
40279,3,3,140867,140867,140870,0,3,1
40280,2,2,140869,140870,140872,1,3,0
40281,1,1,140870,140872,140873,2,3,0
40282,6,2,140876,140876,140878,0,2,3
40283,2,2,140878,140878,140880,0,2,0
40284,5,1,140883,140883,140884,0,1,3
40285,1,3,140884,140884,140887,0,3,0
40286,6,1,140890,140890,140891,0,1,3
40287,2,2,140892,140892,140894,0,2,1
40288,1,1,140893,140894,140895,1,2,0
40289,5,1,140898,140898,140899,0,1,3
40290,4,2,140902,140902,140904,0,2,3
40291,2,3,140904,140904,140907,0,3,0
40292,5,3,140909,140909,140912,0,3,2
40293,1,1,140910,140912,140913,2,3,0
40294,3,2,140913,140913,140915,0,2,0
40295,1,2,140914,140915,140917,1,3,0
40296,6,2,140920,140920,140922,0,2,3
40297,1,2,140921,140922,140924,1,3,0
40298,2,3,140923,140924,140927,1,4,0
40299,3,3,140926,140927,140930,1,4,0
40300,2,1,140928,140930,140931,2,3,0
40301,2,3,140930,140931,140934,1,4,0
40302,4,1,140934,140934,140935,0,1,0
40303,4,1,140938,140938,140939,0,1,3
40304,4,2,140942,140942,140944,0,2,3
40305,1,1,140943,140944,140945,1,2,0
40306,4,1,140947,140947,140948,0,1,2
40307,4,3,140951,140951,140954,0,3,3
40308,5,3,140956,140956,140959,0,3,2
40309,6,3,140962,140962,140965,0,3,3
40310,1,1,140963,140965,140966,2,3,0
40311,6,3,140969,140969,140972,0,3,3
40312,5,1,140974,140974,140975,0,1,2
40313,1,1,140975,140975,140976,0,1,0
40314,2,1,140977,140977,140978,0,1,1
40315,5,3,140982,140982,140985,0,3,4
40316,4,1,140986,140986,140987,0,1,1
40317,2,3,140988,140988,140991,0,3,1
40318,4,1,140992,140992,140993,0,1,1
40319,5,3,140997,140997,141000,0,3,4
40320,2,2,140999,141000,141002,1,3,0
40321,3,2,141002,141002,141004,0,2,0
40322,4,3,141006,141006,141009,0,3,2
40323,5,1,141011,141011,141012,0,1,2
40324,6,2,141017,141017,141019,0,2,5
40325,5,2,141022,141022,141024,0,2,3
40326,1,3,141023,141024,141027,1,4,0
40327,6,1,141029,141029,141030,0,1,2
40328,4,3,141033,141033,141036,0,3,3
40329,2,3,141035,141036,141039,1,4,0
40330,2,1,141037,141039,141040,2,3,0
40331,4,1,141041,141041,141042,0,1,1
40332,2,2,141043,141043,141045,0,2,1
40333,6,3,141049,141049,141052,0,3,4
40334,5,3,141054,141054,141057,0,3,2
40335,6,1,141060,141060,141061,0,1,3
40336,1,1,141061,141061,141062,0,1,0
40337,4,1,141065,141065,141066,0,1,3
40338,6,3,141071,141071,141074,0,3,5
40339,6,3,141077,141077,141080,0,3,3
40340,2,2,141079,141080,141082,1,3,0
40341,5,3,141084,141084,141087,0,3,2
40342,5,1,141089,141089,141090,0,1,2
40343,1,1,141090,141090,141091,0,1,0
40344,4,2,141094,141094,141096,0,2,3
40345,3,1,141097,141097,141098,0,1,1
40346,2,2,141099,141099,141101,0,2,1
40347,5,3,141104,141104,141107,0,3,3
40348,3,2,141107,141107,141109,0,2,0
40349,2,2,141109,141109,141111,0,2,0
40350,6,3,141115,141115,141118,0,3,4
40351,1,3,141116,141118,141121,2,5,0
40352,3,1,141119,141121,141122,2,3,0
40353,1,1,141120,141122,141123,2,3,0
40354,3,1,141123,141123,141124,0,1,0
40355,5,1,141128,141128,141129,0,1,4
40356,6,3,141134,141134,141137,0,3,5
40357,1,3,141135,141137,141140,2,5,0
40358,3,3,141138,141140,141143,2,5,0
40359,2,1,141140,141143,141144,3,4,0
40360,1,2,141141,141144,141146,3,5,0
40361,5,2,141146,141146,141148,0,2,0
40362,5,3,141151,141151,141154,0,3,3
40363,6,1,141157,141157,141158,0,1,3
40364,2,1,141159,141159,141160,0,1,1
40365,1,2,141160,141160,141162,0,2,0
40366,5,3,141165,141165,141168,0,3,3
40367,6,2,141171,141171,141173,0,2,3
40368,3,2,141174,141174,141176,0,2,1
40369,1,1,141175,141176,141177,1,2,0
40370,2,1,141177,141177,141178,0,1,0
40371,6,3,141183,141183,141186,0,3,5
40372,2,1,141185,141186,141187,1,2,0
40373,5,3,141190,141190,141193,0,3,3
40374,6,1,141196,141196,141197,0,1,3
40375,3,2,141199,141199,141201,0,2,2
40376,1,3,141200,141201,141204,1,4,0
40377,2,1,141202,141204,141205,2,3,0
40378,4,1,141206,141206,141207,0,1,1
40379,4,2,141210,141210,141212,0,2,3
40380,1,3,141211,141212,141215,1,4,0
40381,6,2,141217,141217,141219,0,2,2
40382,6,1,141223,141223,141224,0,1,4
40383,5,3,141228,141228,141231,0,3,4
40384,2,2,141230,141231,141233,1,3,0
40385,1,1,141231,141233,141234,2,3,0
40386,1,2,141232,141234,141236,2,4,0
40387,2,3,141234,141236,141239,2,5,0
40388,3,3,141237,141239,141242,2,5,0
40389,5,3,141242,141242,141245,0,3,0
40390,2,3,141244,141245,141248,1,4,0
40391,6,3,141250,141250,141253,0,3,2
40392,3,1,141253,141253,141254,0,1,0
40393,5,1,141258,141258,141259,0,1,4
40394,3,2,141261,141261,141263,0,2,2
40395,1,1,141262,141263,141264,1,2,0
40396,3,3,141265,141265,141268,0,3,1
40397,5,2,141270,141270,141272,0,2,2
40398,6,2,141276,141276,141278,0,2,4
40399,4,1,141280,141280,141281,0,1,2
40400,4,1,141284,141284,141285,0,1,3
40401,2,3,141286,141286,141289,0,3,1
40402,4,3,141290,141290,141293,0,3,1
40403,6,2,141296,141296,141298,0,2,3
40404,1,2,141297,141298,141300,1,3,0
40405,1,2,141298,141300,141302,2,4,0
40406,1,3,141299,141302,141305,3,6,0
40407,2,2,141301,141305,141307,4,6,0
40408,1,1,141302,141307,141308,5,6,0
40409,3,2,141305,141308,141310,3,5,0
40410,3,1,141308,141310,141311,2,3,0
40411,6,1,141314,141314,141315,0,1,3
40412,1,3,141315,141315,141318,0,3,0
40413,5,2,141320,141320,141322,0,2,2
40414,6,2,141326,141326,141328,0,2,4
40415,6,2,141332,141332,141334,0,2,4
40416,3,2,141335,141335,141337,0,2,1
40417,1,2,141336,141337,141339,1,3,0
40418,4,1,141340,141340,141341,0,1,1
40419,3,1,141343,141343,141344,0,1,2
40420,4,1,141347,141347,141348,0,1,3
40421,6,2,141353,141353,141355,0,2,5
40422,1,2,141354,141355,141357,1,3,0
40423,3,1,141357,141357,141358,0,1,0
40424,3,3,141360,141360,141363,0,3,2
40425,4,1,141364,141364,141365,0,1,1
40426,4,1,141368,141368,141369,0,1,3
40427,5,2,141373,141373,141375,0,2,4
40428,4,2,141377,141377,141379,0,2,2
40429,5,2,141382,141382,141384,0,2,3
40430,3,3,141385,141385,141388,0,3,1
40431,1,3,141386,141388,141391,2,5,0
40432,4,1,141390,141391,141392,1,2,0
40433,4,1,141394,141394,141395,0,1,2
40434,5,3,141399,141399,141402,0,3,4
40435,3,2,141402,141402,141404,0,2,0
40436,5,1,141407,141407,141408,0,1,3
40437,6,1,141413,141413,141414,0,1,5
40438,5,3,141418,141418,141421,0,3,4
40439,6,2,141424,141424,141426,0,2,3
40440,5,1,141429,141429,141430,0,1,3
40441,2,2,141431,141431,141433,0,2,1
40442,5,2,141436,141436,141438,0,2,3
40443,3,3,141439,141439,141442,0,3,1
40444,1,3,141440,141442,141445,2,5,0
40445,1,2,141441,141445,141447,4,6,0
40446,5,1,141446,141447,141448,1,2,0
40447,4,1,141450,141450,141451,0,1,2
40448,2,2,141452,141452,141454,0,2,1
40449,2,1,141454,141454,141455,0,1,0
40450,4,1,141458,141458,141459,0,1,3
40451,3,2,141461,141461,141463,0,2,2
40452,4,3,141465,141465,141468,0,3,2
40453,2,1,141467,141468,141469,1,2,0
40454,6,3,141473,141473,141476,0,3,4
40455,3,3,141476,141476,141479,0,3,0
40456,5,3,141481,141481,141484,0,3,2
40457,2,1,141483,141484,141485,1,2,0
40458,6,3,141489,141489,141492,0,3,4
40459,6,2,141495,141495,141497,0,2,3
40460,5,3,141500,141500,141503,0,3,3
40461,4,2,141504,141504,141506,0,2,1
40462,3,3,141507,141507,141510,0,3,1
40463,6,2,141513,141513,141515,0,2,3
40464,3,1,141516,141516,141517,0,1,1
40465,1,3,141517,141517,141520,0,3,0
40466,6,1,141523,141523,141524,0,1,3
40467,2,3,141525,141525,141528,0,3,1
40468,4,3,141529,141529,141532,0,3,1
40469,2,1,141531,141532,141533,1,2,0
40470,5,3,141536,141536,141539,0,3,3
40471,5,3,141541,141541,141544,0,3,2
40472,2,1,141543,141544,141545,1,2,0
40473,5,2,141548,141548,141550,0,2,3
40474,6,1,141554,141554,141555,0,1,4
40475,2,3,141556,141556,141559,0,3,1
40476,3,1,141559,141559,141560,0,1,0
40477,6,2,141565,141565,141567,0,2,5
40478,6,2,141571,141571,141573,0,2,4
40479,2,1,141573,141573,141574,0,1,0
40480,1,3,141574,141574,141577,0,3,0
40481,3,3,141577,141577,141580,0,3,0
40482,4,3,141581,141581,141584,0,3,1
40483,3,1,141584,141584,141585,0,1,0
40484,4,1,141588,141588,141589,0,1,3
40485,5,2,141593,141593,141595,0,2,4
40486,1,3,141594,141595,141598,1,4,0
40487,5,3,141599,141599,141602,0,3,1
40488,4,1,141603,141603,141604,0,1,1
40489,6,1,141609,141609,141610,0,1,5
40490,6,2,141615,141615,141617,0,2,5
40491,6,1,141621,141621,141622,0,1,4
40492,3,1,141624,141624,141625,0,1,2
40493,5,1,141629,141629,141630,0,1,4
40494,2,3,141631,141631,141634,0,3,1
40495,3,1,141634,141634,141635,0,1,0
40496,3,2,141637,141637,141639,0,2,2
40497,2,2,141639,141639,141641,0,2,0
40498,4,1,141643,141643,141644,0,1,2
40499,3,3,141646,141646,141649,0,3,2
40500,4,2,141650,141650,141652,0,2,1
40501,3,3,141653,141653,141656,0,3,1
40502,6,2,141659,141659,141661,0,2,3
40503,5,2,141664,141664,141666,0,2,3
40504,4,1,141668,141668,141669,0,1,2
40505,6,2,141674,141674,141676,0,2,5
40506,2,2,141676,141676,141678,0,2,0
40507,1,1,141677,141678,141679,1,2,0
40508,4,1,141681,141681,141682,0,1,2
40509,4,3,141685,141685,141688,0,3,3
40510,2,1,141687,141688,141689,1,2,0
40511,2,1,141689,141689,141690,0,1,0
40512,4,1,141693,141693,141694,0,1,3
40513,5,3,141698,141698,141701,0,3,4
40514,5,1,141703,141703,141704,0,1,2
40515,3,3,141706,141706,141709,0,3,2
40516,3,1,141709,141709,141710,0,1,0
40517,4,2,141713,141713,141715,0,2,3
40518,6,3,141719,141719,141722,0,3,4
40519,4,3,141723,141723,141726,0,3,1
40520,6,1,141729,141729,141730,0,1,3
40521,1,3,141730,141730,141733,0,3,0
40522,3,1,141733,141733,141734,0,1,0
40523,2,3,141735,141735,141738,0,3,1
40524,5,3,141740,141740,141743,0,3,2
40525,3,3,141743,141743,141746,0,3,0
40526,6,1,141749,141749,141750,0,1,3
40527,2,3,141751,141751,141754,0,3,1
40528,3,2,141754,141754,141756,0,2,0
40529,6,1,141760,141760,141761,0,1,4
40530,6,3,141766,141766,141769,0,3,5
40531,6,2,141772,141772,141774,0,2,3
40532,3,1,141775,141775,141776,0,1,1
40533,2,2,141777,141777,141779,0,2,1
40534,1,1,141778,141779,141780,1,2,0
40535,2,3,141780,141780,141783,0,3,0
40536,6,1,141786,141786,141787,0,1,3
40537,4,3,141790,141790,141793,0,3,3
40538,5,2,141795,141795,141797,0,2,2
40539,2,3,141797,141797,141800,0,3,0
40540,1,2,141798,141800,141802,2,4,0
40541,5,2,141803,141803,141805,0,2,1
40542,5,2,141808,141808,141810,0,2,3
40543,5,3,141813,141813,141816,0,3,3
40544,3,3,141816,141816,141819,0,3,0
40545,6,2,141822,141822,141824,0,2,3
40546,5,2,141827,141827,141829,0,2,3
40547,4,2,141831,141831,141833,0,2,2
40548,4,2,141835,141835,141837,0,2,2
40549,5,3,141840,141840,141843,0,3,3
40550,6,3,141846,141846,141849,0,3,3
40551,3,2,141849,141849,141851,0,2,0
40552,5,3,141854,141854,141857,0,3,3
40553,2,3,141856,141857,141860,1,4,0
40554,3,2,141859,141860,141862,1,3,0
40555,4,2,141863,141863,141865,0,2,1
40556,1,3,141864,141865,141868,1,4,0
40557,6,3,141870,141870,141873,0,3,2
40558,4,2,141874,141874,141876,0,2,1
40559,3,1,141877,141877,141878,0,1,1
40560,3,2,141880,141880,141882,0,2,2
40561,6,1,141886,141886,141887,0,1,4
40562,6,1,141892,141892,141893,0,1,5
40563,3,2,141895,141895,141897,0,2,2
40564,1,2,141896,141897,141899,1,3,0
40565,2,2,141898,141899,141901,1,3,0
40566,5,2,141903,141903,141905,0,2,2
40567,3,1,141906,141906,141907,0,1,1
40568,2,2,141908,141908,141910,0,2,1
40569,2,1,141910,141910,141911,0,1,0
40570,5,2,141915,141915,141917,0,2,4
40571,6,3,141921,141921,141924,0,3,4
40572,6,1,141927,141927,141928,0,1,3
40573,3,3,141930,141930,141933,0,3,2
40574,3,1,141933,141933,141934,0,1,0
40575,6,3,141939,141939,141942,0,3,5
40576,3,1,141942,141942,141943,0,1,0
40577,3,2,141945,141945,141947,0,2,2
40578,2,1,141947,141947,141948,0,1,0
40579,3,2,141950,141950,141952,0,2,2
40580,4,3,141954,141954,141957,0,3,2
40581,3,2,141957,141957,141959,0,2,0
40582,1,1,141958,141959,141960,1,2,0
40583,1,2,141959,141960,141962,1,3,0
40584,2,2,141961,141962,141964,1,3,0
40585,4,1,141965,141965,141966,0,1,1
40586,1,1,141966,141966,141967,0,1,0
40587,3,3,141969,141969,141972,0,3,2
40588,2,1,141971,141972,141973,1,2,0
40589,6,3,141977,141977,141980,0,3,4
40590,5,2,141982,141982,141984,0,2,2
40591,6,2,141988,141988,141990,0,2,4
40592,2,1,141990,141990,141991,0,1,0
40593,1,1,141991,141991,141992,0,1,0
40594,2,3,141993,141993,141996,0,3,1
40595,6,2,141999,141999,142001,0,2,3
40596,1,1,142000,142001,142002,1,2,0
40597,2,3,142002,142002,142005,0,3,0
40598,2,2,142004,142005,142007,1,3,0
40599,2,2,142006,142007,142009,1,3,0
40600,4,2,142010,142010,142012,0,2,1
40601,6,3,142016,142016,142019,0,3,4
40602,1,3,142017,142019,142022,2,5,0
40603,5,3,142022,142022,142025,0,3,0
40604,5,3,142027,142027,142030,0,3,2
40605,3,1,142030,142030,142031,0,1,0
40606,2,2,142032,142032,142034,0,2,1
40607,2,1,142034,142034,142035,0,1,0
40608,1,2,142035,142035,142037,0,2,0
40609,4,3,142039,142039,142042,0,3,2
40610,6,3,142045,142045,142048,0,3,3
40611,4,1,142049,142049,142050,0,1,1
40612,6,1,142055,142055,142056,0,1,5
40613,4,3,142059,142059,142062,0,3,3
40614,6,3,142065,142065,142068,0,3,3
40615,5,3,142070,142070,142073,0,3,2
40616,2,3,142072,142073,142076,1,4,0
40617,1,3,142073,142076,142079,3,6,0
40618,4,2,142077,142079,142081,2,4,0
40619,5,3,142082,142082,142085,0,3,1
40620,1,3,142083,142085,142088,2,5,0
40621,4,2,142087,142088,142090,1,3,0
40622,5,3,142092,142092,142095,0,3,2
40623,2,3,142094,142095,142098,1,4,0
40624,2,2,142096,142098,142100,2,4,0
40625,5,2,142101,142101,142103,0,2,1
40626,4,2,142105,142105,142107,0,2,2
40627,6,3,142111,142111,142114,0,3,4
40628,5,1,142116,142116,142117,0,1,2
40629,2,3,142118,142118,142121,0,3,1
40630,5,2,142123,142123,142125,0,2,2
40631,3,1,142126,142126,142127,0,1,1
40632,5,3,142131,142131,142134,0,3,4
40633,3,1,142134,142134,142135,0,1,0
40634,3,1,142137,142137,142138,0,1,2
40635,2,2,142139,142139,142141,0,2,1
40636,6,2,142145,142145,142147,0,2,4
40637,1,2,142146,142147,142149,1,3,0
40638,5,2,142151,142151,142153,0,2,2
40639,2,1,142153,142153,142154,0,1,0
40640,6,1,142159,142159,142160,0,1,5
40641,6,1,142165,142165,142166,0,1,5
40642,3,2,142168,142168,142170,0,2,2
40643,4,2,142172,142172,142174,0,2,2
40644,4,3,142176,142176,142179,0,3,2
40645,6,3,142182,142182,142185,0,3,3
40646,1,2,142183,142185,142187,2,4,0
40647,3,3,142186,142187,142190,1,4,0
40648,3,3,142189,142190,142193,1,4,0
40649,1,2,142190,142193,142195,3,5,0
40650,6,3,142196,142196,142199,0,3,1
40651,2,1,142198,142199,142200,1,2,0
40652,6,3,142204,142204,142207,0,3,4
40653,4,1,142208,142208,142209,0,1,1
40654,6,3,142214,142214,142217,0,3,5
40655,1,3,142215,142217,142220,2,5,0
40656,4,2,142219,142220,142222,1,3,0
40657,4,3,142223,142223,142226,0,3,1
40658,4,3,142227,142227,142230,0,3,1
40659,4,2,142231,142231,142233,0,2,1
40660,4,1,142235,142235,142236,0,1,2
40661,6,2,142241,142241,142243,0,2,5
40662,6,3,142247,142247,142250,0,3,4
40663,2,3,142249,142250,142253,1,4,0
40664,4,2,142253,142253,142255,0,2,0
40665,1,2,142254,142255,142257,1,3,0
40666,5,1,142259,142259,142260,0,1,2
40667,5,2,142264,142264,142266,0,2,4
40668,6,1,142270,142270,142271,0,1,4
40669,1,2,142271,142271,142273,0,2,0
40670,1,2,142272,142273,142275,1,3,0
40671,1,2,142273,142275,142277,2,4,0
40672,5,1,142278,142278,142279,0,1,1
40673,2,1,142280,142280,142281,0,1,1
40674,5,2,142285,142285,142287,0,2,4
40675,4,3,142289,142289,142292,0,3,2
40676,1,2,142290,142292,142294,2,4,0
40677,4,2,142294,142294,142296,0,2,0
40678,2,3,142296,142296,142299,0,3,0
40679,1,3,142297,142299,142302,2,5,0
40680,4,1,142301,142302,142303,1,2,0
40681,2,3,142303,142303,142306,0,3,0
40682,1,3,142304,142306,142309,2,5,0
40683,4,3,142308,142309,142312,1,4,0
40684,4,1,142312,142312,142313,0,1,0
40685,1,3,142313,142313,142316,0,3,0
40686,5,2,142318,142318,142320,0,2,2
40687,2,2,142320,142320,142322,0,2,0
40688,6,3,142326,142326,142329,0,3,4
40689,4,2,142330,142330,142332,0,2,1
40690,6,2,142336,142336,142338,0,2,4
40691,1,3,142337,142338,142341,1,4,0
40692,5,1,142342,142342,142343,0,1,1
40693,5,3,142347,142347,142350,0,3,4
40694,2,2,142349,142350,142352,1,3,0
40695,2,1,142351,142352,142353,1,2,0
40696,4,2,142355,142355,142357,0,2,2
40697,2,3,142357,142357,142360,0,3,0
40698,6,1,142363,142363,142364,0,1,3
40699,4,2,142367,142367,142369,0,2,3
40700,3,1,142370,142370,142371,0,1,1
40701,1,1,142371,142371,142372,0,1,0
40702,2,3,142373,142373,142376,0,3,1
40703,5,1,142378,142378,142379,0,1,2
40704,3,1,142381,142381,142382,0,1,2
40705,1,3,142382,142382,142385,0,3,0
40706,5,3,142387,142387,142390,0,3,2
40707,2,2,142389,142390,142392,1,3,0
40708,4,1,142393,142393,142394,0,1,1
40709,4,2,142397,142397,142399,0,2,3
40710,6,3,142403,142403,142406,0,3,4
40711,3,1,142406,142406,142407,0,1,0
40712,4,1,142410,142410,142411,0,1,3
40713,2,1,142412,142412,142413,0,1,1
40714,6,2,142418,142418,142420,0,2,5
40715,4,3,142422,142422,142425,0,3,2
40716,4,3,142426,142426,142429,0,3,1
40717,4,2,142430,142430,142432,0,2,1
40718,6,3,142436,142436,142439,0,3,4
40719,4,1,142440,142440,142441,0,1,1
40720,6,3,142446,142446,142449,0,3,5
40721,1,3,142447,142449,142452,2,5,0
40722,3,3,142450,142452,142455,2,5,0
40723,5,1,142455,142455,142456,0,1,0
40724,2,3,142457,142457,142460,0,3,1
40725,2,2,142459,142460,142462,1,3,0
40726,2,2,142461,142462,142464,1,3,0
40727,3,2,142464,142464,142466,0,2,0
40728,2,1,142466,142466,142467,0,1,0
40729,1,1,142467,142467,142468,0,1,0
40730,6,1,142473,142473,142474,0,1,5
40731,5,2,142478,142478,142480,0,2,4
40732,2,3,142480,142480,142483,0,3,0
40733,6,2,142486,142486,142488,0,2,3
40734,1,2,142487,142488,142490,1,3,0
40735,2,1,142489,142490,142491,1,2,0
40736,4,3,142493,142493,142496,0,3,2
40737,1,1,142494,142496,142497,2,3,0
40738,2,2,142496,142497,142499,1,3,0
40739,6,2,142502,142502,142504,0,2,3
40740,2,3,142504,142504,142507,0,3,0
40741,3,1,142507,142507,142508,0,1,0
40742,2,3,142509,142509,142512,0,3,1
40743,1,3,142510,142512,142515,2,5,0
40744,2,3,142512,142515,142518,3,6,0
40745,1,1,142513,142518,142519,5,6,0
40746,2,3,142515,142519,142522,4,7,0
40747,2,1,142517,142522,142523,5,6,0
40748,2,1,142519,142523,142524,4,5,0
40749,3,1,142522,142524,142525,2,3,0
40750,5,3,142527,142527,142530,0,3,2
40751,5,1,142532,142532,142533,0,1,2
40752,5,2,142537,142537,142539,0,2,4
40753,2,2,142539,142539,142541,0,2,0
40754,4,3,142543,142543,142546,0,3,2
40755,3,2,142546,142546,142548,0,2,0
40756,6,2,142552,142552,142554,0,2,4
40757,2,3,142554,142554,142557,0,3,0
40758,4,3,142558,142558,142561,0,3,1
40759,2,2,142560,142561,142563,1,3,0
40760,2,2,142562,142563,142565,1,3,0
40761,5,2,142567,142567,142569,0,2,2
40762,4,3,142571,142571,142574,0,3,2
40763,4,1,142575,142575,142576,0,1,1
40764,2,1,142577,142577,142578,0,1,1
40765,5,2,142582,142582,142584,0,2,4
40766,4,1,142586,142586,142587,0,1,2
40767,3,2,142589,142589,142591,0,2,2
40768,5,3,142594,142594,142597,0,3,3
40769,3,3,142597,142597,142600,0,3,0
40770,1,1,142598,142600,142601,2,3,0
40771,5,2,142603,142603,142605,0,2,2
40772,1,3,142604,142605,142608,1,4,0
40773,3,3,142607,142608,142611,1,4,0
40774,4,2,142611,142611,142613,0,2,0
40775,6,3,142617,142617,142620,0,3,4
40776,5,1,142622,142622,142623,0,1,2
40777,5,3,142627,142627,142630,0,3,4
40778,3,2,142630,142630,142632,0,2,0
40779,2,2,142632,142632,142634,0,2,0
40780,5,3,142637,142637,142640,0,3,3
40781,3,1,142640,142640,142641,0,1,0
40782,2,3,142642,142642,142645,0,3,1
40783,6,1,142648,142648,142649,0,1,3
40784,5,1,142653,142653,142654,0,1,4
40785,5,3,142658,142658,142661,0,3,4
40786,3,2,142661,142661,142663,0,2,0
40787,6,3,142667,142667,142670,0,3,4
40788,2,3,142669,142670,142673,1,4,0
40789,5,3,142674,142674,142677,0,3,1
40790,3,2,142677,142677,142679,0,2,0
40791,3,1,142680,142680,142681,0,1,1
40792,1,2,142681,142681,142683,0,2,0
40793,1,1,142682,142683,142684,1,2,0
40794,1,1,142683,142684,142685,1,2,0
40795,5,1,142688,142688,142689,0,1,3
40796,1,2,142689,142689,142691,0,2,0
40797,6,2,142695,142695,142697,0,2,4
40798,4,3,142699,142699,142702,0,3,2
40799,6,1,142705,142705,142706,0,1,3
40800,4,2,142709,142709,142711,0,2,3
40801,2,2,142711,142711,142713,0,2,0
40802,2,3,142713,142713,142716,0,3,0
40803,3,1,142716,142716,142717,0,1,0
40804,4,1,142720,142720,142721,0,1,3
40805,2,3,142722,142722,142725,0,3,1
40806,1,3,142723,142725,142728,2,5,0
40807,5,2,142728,142728,142730,0,2,0
40808,4,2,142732,142732,142734,0,2,2
40809,4,2,142736,142736,142738,0,2,2
40810,1,3,142737,142738,142741,1,4,0
40811,2,3,142739,142741,142744,2,5,0
40812,3,3,142742,142744,142747,2,5,0
40813,1,1,142743,142747,142748,4,5,0
40814,5,2,142748,142748,142750,0,2,0
40815,1,3,142749,142750,142753,1,4,0
40816,2,3,142751,142753,142756,2,5,0
40817,4,3,142755,142756,142759,1,4,0
40818,4,2,142759,142759,142761,0,2,0
40819,4,3,142763,142763,142766,0,3,2
40820,1,2,142764,142766,142768,2,4,0
40821,3,1,142767,142768,142769,1,2,0
40822,1,2,142768,142769,142771,1,3,0
40823,6,1,142774,142774,142775,0,1,3
40824,1,2,142775,142775,142777,0,2,0
40825,6,3,142781,142781,142784,0,3,4
40826,2,1,142783,142784,142785,1,2,0
40827,5,2,142788,142788,142790,0,2,3
40828,5,2,142793,142793,142795,0,2,3
40829,1,3,142794,142795,142798,1,4,0
40830,1,2,142795,142798,142800,3,5,0
40831,6,1,142801,142801,142802,0,1,1
40832,4,3,142805,142805,142808,0,3,3
40833,6,1,142811,142811,142812,0,1,3
40834,1,1,142812,142812,142813,0,1,0
40835,3,2,142815,142815,142817,0,2,2
40836,4,2,142819,142819,142821,0,2,2
40837,2,3,142821,142821,142824,0,3,0
40838,2,1,142823,142824,142825,1,2,0
40839,4,3,142827,142827,142830,0,3,2
40840,1,1,142828,142830,142831,2,3,0
40841,3,2,142831,142831,142833,0,2,0
40842,6,1,142837,142837,142838,0,1,4
40843,4,3,142841,142841,142844,0,3,3
40844,3,2,142844,142844,142846,0,2,0
40845,1,1,142845,142846,142847,1,2,0
40846,5,2,142850,142850,142852,0,2,3
40847,2,1,142852,142852,142853,0,1,0
40848,4,2,142856,142856,142858,0,2,3
40849,2,1,142858,142858,142859,0,1,0
40850,4,1,142862,142862,142863,0,1,3
40851,4,3,142866,142866,142869,0,3,3
40852,4,1,142870,142870,142871,0,1,1
40853,4,1,142874,142874,142875,0,1,3
40854,1,1,142875,142875,142876,0,1,0
40855,5,1,142880,142880,142881,0,1,4
40856,5,2,142885,142885,142887,0,2,4
40857,2,3,142887,142887,142890,0,3,0
40858,5,1,142892,142892,142893,0,1,2
40859,1,2,142893,142893,142895,0,2,0
40860,1,2,142894,142895,142897,1,3,0
40861,1,1,142895,142897,142898,2,3,0
40862,6,2,142901,142901,142903,0,2,3
40863,3,2,142904,142904,142906,0,2,1
40864,1,3,142905,142906,142909,1,4,0
40865,5,1,142910,142910,142911,0,1,1
40866,2,3,142912,142912,142915,0,3,1
40867,3,2,142915,142915,142917,0,2,0
40868,6,3,142921,142921,142924,0,3,4
40869,6,3,142927,142927,142930,0,3,3
40870,6,1,142933,142933,142934,0,1,3
40871,1,1,142934,142934,142935,0,1,0
40872,5,2,142939,142939,142941,0,2,4
40873,4,3,142943,142943,142946,0,3,2
40874,6,3,142949,142949,142952,0,3,3
40875,3,2,142952,142952,142954,0,2,0
40876,1,2,142953,142954,142956,1,3,0
40877,4,2,142957,142957,142959,0,2,1
40878,6,3,142963,142963,142966,0,3,4
40879,1,1,142964,142966,142967,2,3,0
40880,3,3,142967,142967,142970,0,3,0
40881,5,3,142972,142972,142975,0,3,2
40882,4,2,142976,142976,142978,0,2,1
40883,1,2,142977,142978,142980,1,3,0
40884,3,1,142980,142980,142981,0,1,0
40885,1,2,142981,142981,142983,0,2,0
40886,2,2,142983,142983,142985,0,2,0
40887,2,1,142985,142985,142986,0,1,0
40888,1,2,142986,142986,142988,0,2,0
40889,5,3,142991,142991,142994,0,3,3
40890,6,1,142997,142997,142998,0,1,3
40891,3,2,143000,143000,143002,0,2,2
40892,6,1,143006,143006,143007,0,1,4
40893,6,1,143012,143012,143013,0,1,5
40894,6,1,143018,143018,143019,0,1,5
40895,4,3,143022,143022,143025,0,3,3
40896,2,2,143024,143025,143027,1,3,0
40897,6,2,143030,143030,143032,0,2,3
40898,2,1,143032,143032,143033,0,1,0
40899,5,3,143037,143037,143040,0,3,4
40900,4,2,143041,143041,143043,0,2,1
40901,3,1,143044,143044,143045,0,1,1
40902,4,1,143048,143048,143049,0,1,3
40903,1,2,143049,143049,143051,0,2,0
40904,2,1,143051,143051,143052,0,1,0
40905,1,2,143052,143052,143054,0,2,0
40906,4,3,143056,143056,143059,0,3,2
40907,6,3,143062,143062,143065,0,3,3
40908,6,2,143068,143068,143070,0,2,3
40909,3,1,143071,143071,143072,0,1,1
40910,5,3,143076,143076,143079,0,3,4
40911,3,1,143079,143079,143080,0,1,0
40912,5,3,143084,143084,143087,0,3,4
40913,3,2,143087,143087,143089,0,2,0
40914,6,2,143093,143093,143095,0,2,4
40915,3,3,143096,143096,143099,0,3,1
40916,6,1,143102,143102,143103,0,1,3
40917,4,2,143106,143106,143108,0,2,3
40918,2,3,143108,143108,143111,0,3,0
40919,3,2,143111,143111,143113,0,2,0
40920,6,2,143117,143117,143119,0,2,4
40921,3,1,143120,143120,143121,0,1,1
40922,1,3,143121,143121,143124,0,3,0
40923,2,2,143123,143124,143126,1,3,0
40924,1,2,143124,143126,143128,2,4,0
40925,4,2,143128,143128,143130,0,2,0
40926,6,1,143134,143134,143135,0,1,4
40927,1,2,143135,143135,143137,0,2,0
40928,3,3,143138,143138,143141,0,3,1
40929,4,2,143142,143142,143144,0,2,1
40930,3,2,143145,143145,143147,0,2,1
40931,1,1,143146,143147,143148,1,2,0
40932,3,2,143149,143149,143151,0,2,1
40933,2,3,143151,143151,143154,0,3,0
40934,3,3,143154,143154,143157,0,3,0
40935,6,2,143160,143160,143162,0,2,3
40936,6,1,143166,143166,143167,0,1,4
40937,5,2,143171,143171,143173,0,2,4
40938,5,3,143176,143176,143179,0,3,3
40939,5,1,143181,143181,143182,0,1,2
40940,3,2,143184,143184,143186,0,2,2
40941,5,1,143189,143189,143190,0,1,3
40942,6,3,143195,143195,143198,0,3,5
40943,5,3,143200,143200,143203,0,3,2
40944,2,3,143202,143203,143206,1,4,0
40945,4,3,143206,143206,143209,0,3,0
40946,4,1,143210,143210,143211,0,1,1
40947,2,1,143212,143212,143213,0,1,1
40948,1,3,143213,143213,143216,0,3,0
40949,6,1,143219,143219,143220,0,1,3
40950,3,2,143222,143222,143224,0,2,2
40951,1,3,143223,143224,143227,1,4,0
40952,1,3,143224,143227,143230,3,6,0
40953,3,2,143227,143230,143232,3,5,0
40954,6,1,143233,143233,143234,0,1,1
40955,4,2,143237,143237,143239,0,2,3
40956,5,2,143242,143242,143244,0,2,3
40957,6,1,143248,143248,143249,0,1,4
40958,4,1,143252,143252,143253,0,1,3
40959,1,1,143253,143253,143254,0,1,0
40960,5,2,143258,143258,143260,0,2,4
40961,3,1,143261,143261,143262,0,1,1
40962,2,2,143263,143263,143265,0,2,1
40963,6,2,143269,143269,143271,0,2,4
40964,4,2,143273,143273,143275,0,2,2
40965,5,3,143278,143278,143281,0,3,3
40966,3,3,143281,143281,143284,0,3,0
40967,2,1,143283,143284,143285,1,2,0
40968,3,3,143286,143286,143289,0,3,1
40969,5,1,143291,143291,143292,0,1,2
40970,3,1,143294,143294,143295,0,1,2
40971,5,1,143299,143299,143300,0,1,4
40972,3,2,143302,143302,143304,0,2,2
40973,2,2,143304,143304,143306,0,2,0
40974,4,1,143308,143308,143309,0,1,2
40975,5,2,143313,143313,143315,0,2,4
40976,2,1,143315,143315,143316,0,1,0
40977,4,2,143319,143319,143321,0,2,3
40978,6,3,143325,143325,143328,0,3,4
40979,6,1,143331,143331,143332,0,1,3
40980,5,2,143336,143336,143338,0,2,4
40981,5,1,143341,143341,143342,0,1,3
40982,2,2,143343,143343,143345,0,2,1
40983,3,2,143346,143346,143348,0,2,1
40984,3,2,143349,143349,143351,0,2,1
40985,5,1,143354,143354,143355,0,1,3
40986,5,1,143359,143359,143360,0,1,4
40987,1,2,143360,143360,143362,0,2,0
40988,6,3,143366,143366,143369,0,3,4
40989,4,3,143370,143370,143373,0,3,1
40990,6,1,143376,143376,143377,0,1,3
40991,6,1,143382,143382,143383,0,1,5
40992,2,1,143384,143384,143385,0,1,1
40993,2,2,143386,143386,143388,0,2,1
40994,3,3,143389,143389,143392,0,3,1
40995,4,3,143393,143393,143396,0,3,1
40996,4,1,143397,143397,143398,0,1,1
40997,4,2,143401,143401,143403,0,2,3
40998,6,2,143407,143407,143409,0,2,4
40999,3,2,143410,143410,143412,0,2,1
41000,1,2,143411,143412,143414,1,3,0
41001,3,3,143414,143414,143417,0,3,0
41002,6,2,143420,143420,143422,0,2,3
41003,4,3,143424,143424,143427,0,3,2
41004,6,2,143430,143430,143432,0,2,3
41005,6,2,143436,143436,143438,0,2,4
41006,2,1,143438,143438,143439,0,1,0
41007,5,3,143443,143443,143446,0,3,4
41008,2,1,143445,143446,143447,1,2,0
41009,6,2,143451,143451,143453,0,2,4
41010,4,2,143455,143455,143457,0,2,2
41011,5,2,143460,143460,143462,0,2,3
41012,4,1,143464,143464,143465,0,1,2
41013,3,1,143467,143467,143468,0,1,2
41014,6,2,143473,143473,143475,0,2,5
41015,5,3,143478,143478,143481,0,3,3
41016,1,1,143479,143481,143482,2,3,0
41017,5,3,143484,143484,143487,0,3,2
41018,5,2,143489,143489,143491,0,2,2
41019,3,1,143492,143492,143493,0,1,1
41020,5,1,143497,143497,143498,0,1,4
41021,4,2,143501,143501,143503,0,2,3
41022,1,3,143502,143503,143506,1,4,0
41023,1,3,143503,143506,143509,3,6,0
41024,4,3,143507,143509,143512,2,5,0
41025,4,1,143511,143512,143513,1,2,0
41026,2,2,143513,143513,143515,0,2,0
41027,5,1,143518,143518,143519,0,1,3
41028,4,2,143522,143522,143524,0,2,3
41029,3,3,143525,143525,143528,0,3,1
41030,2,3,143527,143528,143531,1,4,0
41031,3,2,143530,143531,143533,1,3,0
41032,4,1,143534,143534,143535,0,1,1
41033,1,3,143535,143535,143538,0,3,0
41034,3,2,143538,143538,143540,0,2,0
41035,2,2,143540,143540,143542,0,2,0
41036,1,3,143541,143542,143545,1,4,0
41037,3,3,143544,143545,143548,1,4,0
41038,2,3,143546,143548,143551,2,5,0
41039,2,2,143548,143551,143553,3,5,0
41040,4,3,143552,143553,143556,1,4,0
41041,1,2,143553,143556,143558,3,5,0
41042,1,1,143554,143558,143559,4,5,0
41043,5,3,143559,143559,143562,0,3,0
41044,2,2,143561,143562,143564,1,3,0
41045,3,1,143564,143564,143565,0,1,0
41046,3,1,143567,143567,143568,0,1,2
41047,3,2,143570,143570,143572,0,2,2
41048,1,3,143571,143572,143575,1,4,0
41049,6,3,143577,143577,143580,0,3,2
41050,6,3,143583,143583,143586,0,3,3
41051,6,2,143589,143589,143591,0,2,3
41052,3,2,143592,143592,143594,0,2,1
41053,1,3,143593,143594,143597,1,4,0
41054,5,1,143598,143598,143599,0,1,1
41055,1,3,143599,143599,143602,0,3,0
41056,5,1,143604,143604,143605,0,1,2
41057,3,3,143607,143607,143610,0,3,2
41058,1,3,143608,143610,143613,2,5,0
41059,4,1,143612,143613,143614,1,2,0
41060,2,1,143614,143614,143615,0,1,0
41061,3,2,143617,143617,143619,0,2,2
41062,1,2,143618,143619,143621,1,3,0
41063,4,1,143622,143622,143623,0,1,1
41064,2,1,143624,143624,143625,0,1,1
41065,2,1,143626,143626,143627,0,1,1
41066,3,3,143629,143629,143632,0,3,2
41067,1,3,143630,143632,143635,2,5,0
41068,4,2,143634,143635,143637,1,3,0
41069,2,1,143636,143637,143638,1,2,0
41070,6,3,143642,143642,143645,0,3,4
41071,1,1,143643,143645,143646,2,3,0
41072,2,2,143645,143646,143648,1,3,0
41073,5,1,143650,143650,143651,0,1,2
41074,4,2,143654,143654,143656,0,2,3
41075,6,1,143660,143660,143661,0,1,4
41076,2,1,143662,143662,143663,0,1,1
41077,6,3,143668,143668,143671,0,3,5
41078,3,3,143671,143671,143674,0,3,0
41079,6,3,143677,143677,143680,0,3,3
41080,5,1,143682,143682,143683,0,1,2
41081,2,1,143684,143684,143685,0,1,1
41082,4,1,143688,143688,143689,0,1,3
41083,3,1,143691,143691,143692,0,1,2
41084,3,3,143694,143694,143697,0,3,2
41085,4,3,143698,143698,143701,0,3,1
41086,4,1,143702,143702,143703,0,1,1
41087,5,1,143707,143707,143708,0,1,4
41088,6,1,143713,143713,143714,0,1,5
41089,2,2,143715,143715,143717,0,2,1
41090,3,1,143718,143718,143719,0,1,1
41091,2,2,143720,143720,143722,0,2,1
41092,2,3,143722,143722,143725,0,3,0
41093,6,3,143728,143728,143731,0,3,3
41094,4,2,143732,143732,143734,0,2,1
41095,2,1,143734,143734,143735,0,1,0
41096,6,1,143740,143740,143741,0,1,5
41097,3,2,143743,143743,143745,0,2,2
41098,1,1,143744,143745,143746,1,2,0
41099,5,1,143749,143749,143750,0,1,3
41100,5,1,143754,143754,143755,0,1,4
41101,5,2,143759,143759,143761,0,2,4
41102,4,2,143763,143763,143765,0,2,2
41103,5,2,143768,143768,143770,0,2,3
41104,3,2,143771,143771,143773,0,2,1
41105,1,2,143772,143773,143775,1,3,0
41106,5,3,143777,143777,143780,0,3,2
41107,4,2,143781,143781,143783,0,2,1
41108,2,3,143783,143783,143786,0,3,0
41109,2,2,143785,143786,143788,1,3,0
41110,4,3,143789,143789,143792,0,3,1
41111,6,3,143795,143795,143798,0,3,3
41112,1,2,143796,143798,143800,2,4,0
41113,4,1,143800,143800,143801,0,1,0
41114,2,2,143802,143802,143804,0,2,1
41115,5,1,143807,143807,143808,0,1,3
41116,4,2,143811,143811,143813,0,2,3
41117,5,3,143816,143816,143819,0,3,3
41118,6,2,143822,143822,143824,0,2,3
41119,4,2,143826,143826,143828,0,2,2
41120,3,3,143829,143829,143832,0,3,1
41121,1,1,143830,143832,143833,2,3,0
41122,5,2,143835,143835,143837,0,2,2
41123,2,3,143837,143837,143840,0,3,0
41124,2,2,143839,143840,143842,1,3,0
41125,4,1,143843,143843,143844,0,1,1
41126,5,3,143848,143848,143851,0,3,4
41127,5,2,143853,143853,143855,0,2,2
41128,5,2,143858,143858,143860,0,2,3
41129,1,1,143859,143860,143861,1,2,0
41130,4,2,143863,143863,143865,0,2,2
41131,6,1,143869,143869,143870,0,1,4
41132,6,2,143875,143875,143877,0,2,5
41133,5,1,143880,143880,143881,0,1,3
41134,3,3,143883,143883,143886,0,3,2
41135,3,1,143886,143886,143887,0,1,0
41136,2,3,143888,143888,143891,0,3,1
41137,4,3,143892,143892,143895,0,3,1
41138,5,1,143897,143897,143898,0,1,2
41139,4,1,143901,143901,143902,0,1,3
41140,3,2,143904,143904,143906,0,2,2
41141,4,3,143908,143908,143911,0,3,2
41142,3,1,143911,143911,143912,0,1,0
41143,3,3,143914,143914,143917,0,3,2
41144,1,2,143915,143917,143919,2,4,0
41145,2,1,143917,143919,143920,2,3,0
41146,2,2,143919,143920,143922,1,3,0
41147,2,1,143921,143922,143923,1,2,0
41148,1,3,143922,143923,143926,1,4,0
41149,1,1,143923,143926,143927,3,4,0
41150,6,3,143929,143929,143932,0,3,2
41151,2,2,143931,143932,143934,1,3,0
41152,4,1,143935,143935,143936,0,1,1
41153,1,1,143936,143936,143937,0,1,0
41154,5,3,143941,143941,143944,0,3,4
41155,5,1,143946,143946,143947,0,1,2
41156,2,2,143948,143948,143950,0,2,1
41157,1,3,143949,143950,143953,1,4,0
41158,3,1,143952,143953,143954,1,2,0
41159,4,2,143956,143956,143958,0,2,2
41160,3,1,143959,143959,143960,0,1,1
41161,5,2,143964,143964,143966,0,2,4
41162,3,2,143967,143967,143969,0,2,1
41163,4,2,143971,143971,143973,0,2,2
41164,2,3,143973,143973,143976,0,3,0
41165,2,2,143975,143976,143978,1,3,0
41166,5,3,143980,143980,143983,0,3,2
41167,5,2,143985,143985,143987,0,2,2
41168,5,3,143990,143990,143993,0,3,3
41169,1,3,143991,143993,143996,2,5,0
41170,2,3,143993,143996,143999,3,6,0
41171,5,1,143998,143999,144000,1,2,0
41172,3,3,144001,144001,144004,0,3,1
41173,5,2,144006,144006,144008,0,2,2
41174,4,3,144010,144010,144013,0,3,2
41175,1,3,144011,144013,144016,2,5,0
41176,1,2,144012,144016,144018,4,6,0
41177,4,1,144016,144018,144019,2,3,0
41178,6,1,144022,144022,144023,0,1,3
41179,3,1,144025,144025,144026,0,1,2
41180,5,2,144030,144030,144032,0,2,4
41181,4,2,144034,144034,144036,0,2,2
41182,4,2,144038,144038,144040,0,2,2
41183,5,3,144043,144043,144046,0,3,3
41184,3,1,144046,144046,144047,0,1,0
41185,6,3,144052,144052,144055,0,3,5
41186,1,1,144053,144055,144056,2,3,0
41187,2,1,144055,144056,144057,1,2,0
41188,5,3,144060,144060,144063,0,3,3
41189,3,2,144063,144063,144065,0,2,0
41190,4,1,144067,144067,144068,0,1,2
41191,5,3,144072,144072,144075,0,3,4
41192,4,2,144076,144076,144078,0,2,1
41193,1,1,144077,144078,144079,1,2,0
41194,4,2,144081,144081,144083,0,2,2
41195,3,3,144084,144084,144087,0,3,1
41196,3,1,144087,144087,144088,0,1,0
41197,3,1,144090,144090,144091,0,1,2
41198,6,3,144096,144096,144099,0,3,5
41199,2,2,144098,144099,144101,1,3,0
41200,3,1,144101,144101,144102,0,1,0
41201,2,2,144103,144103,144105,0,2,1
41202,5,2,144108,144108,144110,0,2,3
41203,3,3,144111,144111,144114,0,3,1
41204,4,2,144115,144115,144117,0,2,1
41205,4,3,144119,144119,144122,0,3,2
41206,1,2,144120,144122,144124,2,4,0
41207,6,3,144126,144126,144129,0,3,2
41208,1,1,144127,144129,144130,2,3,0
41209,2,2,144129,144130,144132,1,3,0
41210,4,2,144133,144133,144135,0,2,1
41211,5,2,144138,144138,144140,0,2,3
41212,6,3,144144,144144,144147,0,3,4
41213,3,1,144147,144147,144148,0,1,0
41214,3,2,144150,144150,144152,0,2,2
41215,3,3,144153,144153,144156,0,3,1
41216,1,2,144154,144156,144158,2,4,0
41217,1,3,144155,144158,144161,3,6,0
41218,6,2,144161,144161,144163,0,2,0
41219,2,1,144163,144163,144164,0,1,0
41220,1,2,144164,144164,144166,0,2,0
41221,5,3,144169,144169,144172,0,3,3
41222,2,2,144171,144172,144174,1,3,0
41223,2,3,144173,144174,144177,1,4,0
41224,6,3,144179,144179,144182,0,3,2
41225,4,1,144183,144183,144184,0,1,1
41226,1,1,144184,144184,144185,0,1,0
41227,2,3,144186,144186,144189,0,3,1
41228,6,2,144192,144192,144194,0,2,3
41229,2,2,144194,144194,144196,0,2,0
41230,3,3,144197,144197,144200,0,3,1
41231,1,3,144198,144200,144203,2,5,0
41232,4,1,144202,144203,144204,1,2,0
41233,4,2,144206,144206,144208,0,2,2
41234,6,3,144212,144212,144215,0,3,4
41235,6,1,144218,144218,144219,0,1,3
41236,5,1,144223,144223,144224,0,1,4
41237,3,1,144226,144226,144227,0,1,2
41238,3,1,144229,144229,144230,0,1,2
41239,4,3,144233,144233,144236,0,3,3
41240,6,3,144239,144239,144242,0,3,3
41241,1,1,144240,144242,144243,2,3,0
41242,2,1,144242,144243,144244,1,2,0
41243,1,3,144243,144244,144247,1,4,0
41244,3,2,144246,144247,144249,1,3,0
41245,2,2,144248,144249,144251,1,3,0
41246,5,1,144253,144253,144254,0,1,2
41247,5,2,144258,144258,144260,0,2,4
41248,4,2,144262,144262,144264,0,2,2
41249,3,2,144265,144265,144267,0,2,1
41250,2,2,144267,144267,144269,0,2,0
41251,2,3,144269,144269,144272,0,3,0
41252,2,1,144271,144272,144273,1,2,0
41253,6,2,144277,144277,144279,0,2,4
41254,1,2,144278,144279,144281,1,3,0
41255,6,2,144284,144284,144286,0,2,3
41256,4,3,144288,144288,144291,0,3,2
41257,3,2,144291,144291,144293,0,2,0
41258,5,2,144296,144296,144298,0,2,3
41259,1,3,144297,144298,144301,1,4,0
41260,6,3,144303,144303,144306,0,3,2
41261,6,1,144309,144309,144310,0,1,3
41262,1,1,144310,144310,144311,0,1,0
41263,4,3,144314,144314,144317,0,3,3
41264,4,3,144318,144318,144321,0,3,1
41265,4,3,144322,144322,144325,0,3,1
41266,3,1,144325,144325,144326,0,1,0
41267,1,1,144326,144326,144327,0,1,0
41268,6,3,144332,144332,144335,0,3,5
41269,5,1,144337,144337,144338,0,1,2
41270,1,2,144338,144338,144340,0,2,0
41271,4,1,144342,144342,144343,0,1,2
41272,3,2,144345,144345,144347,0,2,2
41273,1,2,144346,144347,144349,1,3,0
41274,3,2,144349,144349,144351,0,2,0
41275,2,1,144351,144351,144352,0,1,0
41276,2,2,144353,144353,144355,0,2,1
41277,4,2,144357,144357,144359,0,2,2
41278,1,2,144358,144359,144361,1,3,0
41279,5,1,144363,144363,144364,0,1,2
41280,2,2,144365,144365,144367,0,2,1
41281,5,2,144370,144370,144372,0,2,3
41282,4,2,144374,144374,144376,0,2,2
41283,3,1,144377,144377,144378,0,1,1
41284,4,2,144381,144381,144383,0,2,3
41285,1,1,144382,144383,144384,1,2,0
41286,1,3,144383,144384,144387,1,4,0
41287,6,1,144389,144389,144390,0,1,2
41288,5,3,144394,144394,144397,0,3,4
41289,5,2,144399,144399,144401,0,2,2
41290,4,2,144403,144403,144405,0,2,2
41291,4,1,144407,144407,144408,0,1,2
41292,5,2,144412,144412,144414,0,2,4
41293,6,1,144418,144418,144419,0,1,4
41294,2,2,144420,144420,144422,0,2,1
41295,6,2,144426,144426,144428,0,2,4
41296,6,3,144432,144432,144435,0,3,4
41297,1,2,144433,144435,144437,2,4,0
41298,4,1,144437,144437,144438,0,1,0
41299,2,1,144439,144439,144440,0,1,1
41300,5,2,144444,144444,144446,0,2,4
41301,1,1,144445,144446,144447,1,2,0
41302,5,1,144450,144450,144451,0,1,3
41303,4,2,144454,144454,144456,0,2,3
41304,1,3,144455,144456,144459,1,4,0
41305,4,3,144459,144459,144462,0,3,0
41306,4,1,144463,144463,144464,0,1,1
41307,3,1,144466,144466,144467,0,1,2
41308,1,2,144467,144467,144469,0,2,0
41309,2,2,144469,144469,144471,0,2,0
41310,5,3,144474,144474,144477,0,3,3
41311,4,1,144478,144478,144479,0,1,1
41312,1,2,144479,144479,144481,0,2,0
41313,5,1,144484,144484,144485,0,1,3
41314,2,3,144486,144486,144489,0,3,1
41315,5,3,144491,144491,144494,0,3,2
41316,6,3,144497,144497,144500,0,3,3
41317,4,3,144501,144501,144504,0,3,1
41318,6,2,144507,144507,144509,0,2,3
41319,6,1,144513,144513,144514,0,1,4
41320,3,1,144516,144516,144517,0,1,2
41321,1,2,144517,144517,144519,0,2,0
41322,2,2,144519,144519,144521,0,2,0
41323,1,2,144520,144521,144523,1,3,0
41324,3,1,144523,144523,144524,0,1,0
41325,6,1,144529,144529,144530,0,1,5
41326,4,3,144533,144533,144536,0,3,3
41327,3,2,144536,144536,144538,0,2,0
41328,4,1,144540,144540,144541,0,1,2
41329,6,1,144546,144546,144547,0,1,5
41330,1,3,144547,144547,144550,0,3,0
41331,1,2,144548,144550,144552,2,4,0
41332,6,2,144554,144554,144556,0,2,2
41333,2,3,144556,144556,144559,0,3,0
41334,1,1,144557,144559,144560,2,3,0
41335,6,3,144563,144563,144566,0,3,3
41336,6,2,144569,144569,144571,0,2,3
41337,3,1,144572,144572,144573,0,1,1
41338,3,1,144575,144575,144576,0,1,2
41339,6,1,144581,144581,144582,0,1,5
41340,1,1,144582,144582,144583,0,1,0
41341,1,1,144583,144583,144584,0,1,0
41342,1,2,144584,144584,144586,0,2,0
41343,2,2,144586,144586,144588,0,2,0
41344,2,3,144588,144588,144591,0,3,0
41345,5,1,144593,144593,144594,0,1,2
41346,3,1,144596,144596,144597,0,1,2
41347,6,2,144602,144602,144604,0,2,5
41348,3,3,144605,144605,144608,0,3,1
41349,3,3,144608,144608,144611,0,3,0
41350,4,1,144612,144612,144613,0,1,1
41351,5,2,144617,144617,144619,0,2,4
41352,2,2,144619,144619,144621,0,2,0
41353,4,1,144623,144623,144624,0,1,2
41354,3,3,144626,144626,144629,0,3,2
41355,1,1,144627,144629,144630,2,3,0
41356,3,2,144630,144630,144632,0,2,0
41357,2,3,144632,144632,144635,0,3,0
41358,4,3,144636,144636,144639,0,3,1
41359,1,3,144637,144639,144642,2,5,0
41360,6,2,144643,144643,144645,0,2,1
41361,2,3,144645,144645,144648,0,3,0
41362,1,3,144646,144648,144651,2,5,0
41363,4,3,144650,144651,144654,1,4,0
41364,5,1,144655,144655,144656,0,1,1
41365,5,1,144660,144660,144661,0,1,4
41366,4,1,144664,144664,144665,0,1,3
41367,1,2,144665,144665,144667,0,2,0
41368,2,1,144667,144667,144668,0,1,0
41369,4,2,144671,144671,144673,0,2,3
41370,1,3,144672,144673,144676,1,4,0
41371,3,1,144675,144676,144677,1,2,0
41372,2,2,144677,144677,144679,0,2,0
41373,5,2,144682,144682,144684,0,2,3
41374,1,2,144683,144684,144686,1,3,0
41375,4,2,144687,144687,144689,0,2,1
41376,1,1,144688,144689,144690,1,2,0
41377,4,3,144692,144692,144695,0,3,2
41378,1,3,144693,144695,144698,2,5,0
41379,6,1,144699,144699,144700,0,1,1
41380,1,1,144700,144700,144701,0,1,0
41381,4,2,144704,144704,144706,0,2,3
41382,1,2,144705,144706,144708,1,3,0
41383,1,1,144706,144708,144709,2,3,0
41384,4,1,144710,144710,144711,0,1,1
41385,4,3,144714,144714,144717,0,3,3
41386,2,3,144716,144717,144720,1,4,0
41387,5,1,144721,144721,144722,0,1,1
41388,1,3,144722,144722,144725,0,3,0
41389,1,2,144723,144725,144727,2,4,0
41390,4,1,144727,144727,144728,0,1,0
41391,4,1,144731,144731,144732,0,1,3
41392,1,3,144732,144732,144735,0,3,0
41393,3,2,144735,144735,144737,0,2,0
41394,1,3,144736,144737,144740,1,4,0
41395,4,1,144740,144740,144741,0,1,0
41396,1,2,144741,144741,144743,0,2,0
41397,4,3,144745,144745,144748,0,3,2
41398,1,3,144746,144748,144751,2,5,0
41399,6,3,144752,144752,144755,0,3,1
41400,3,2,144755,144755,144757,0,2,0
41401,2,1,144757,144757,144758,0,1,0
41402,4,3,144761,144761,144764,0,3,3
41403,4,1,144765,144765,144766,0,1,1
41404,1,2,144766,144766,144768,0,2,0
41405,2,1,144768,144768,144769,0,1,0
41406,6,1,144774,144774,144775,0,1,5
41407,4,1,144778,144778,144779,0,1,3
41408,5,3,144783,144783,144786,0,3,4
41409,6,2,144789,144789,144791,0,2,3
41410,6,2,144795,144795,144797,0,2,4
41411,6,2,144801,144801,144803,0,2,4
41412,6,1,144807,144807,144808,0,1,4
41413,2,1,144809,144809,144810,0,1,1
41414,5,2,144814,144814,144816,0,2,4
41415,5,1,144819,144819,144820,0,1,3
41416,4,2,144823,144823,144825,0,2,3
41417,2,3,144825,144825,144828,0,3,0
41418,5,3,144830,144830,144833,0,3,2
41419,4,3,144834,144834,144837,0,3,1
41420,2,3,144836,144837,144840,1,4,0
41421,3,2,144839,144840,144842,1,3,0
41422,5,1,144844,144844,144845,0,1,2
41423,6,1,144850,144850,144851,0,1,5
41424,4,3,144854,144854,144857,0,3,3
41425,4,3,144858,144858,144861,0,3,1
41426,4,2,144862,144862,144864,0,2,1
41427,6,2,144868,144868,144870,0,2,4
41428,2,2,144870,144870,144872,0,2,0
41429,2,2,144872,144872,144874,0,2,0
41430,1,3,144873,144874,144877,1,4,0
41431,2,2,144875,144877,144879,2,4,0
41432,5,3,144880,144880,144883,0,3,1
41433,6,1,144886,144886,144887,0,1,3
41434,1,1,144887,144887,144888,0,1,0
41435,1,2,144888,144888,144890,0,2,0
41436,1,2,144889,144890,144892,1,3,0
41437,2,2,144891,144892,144894,1,3,0
41438,2,3,144893,144894,144897,1,4,0
41439,4,3,144897,144897,144900,0,3,0
41440,5,1,144902,144902,144903,0,1,2
41441,5,2,144907,144907,144909,0,2,4
41442,1,3,144908,144909,144912,1,4,0
41443,4,1,144912,144912,144913,0,1,0
41444,3,2,144915,144915,144917,0,2,2
41445,1,2,144916,144917,144919,1,3,0
41446,2,3,144918,144919,144922,1,4,0
41447,5,3,144923,144923,144926,0,3,1
41448,5,2,144928,144928,144930,0,2,2
41449,3,1,144931,144931,144932,0,1,1
41450,5,1,144936,144936,144937,0,1,4
41451,1,2,144937,144937,144939,0,2,0
41452,6,2,144943,144943,144945,0,2,4
41453,1,3,144944,144945,144948,1,4,0
41454,6,1,144950,144950,144951,0,1,2
41455,1,1,144951,144951,144952,0,1,0
41456,4,1,144955,144955,144956,0,1,3
41457,2,2,144957,144957,144959,0,2,1
41458,4,2,144961,144961,144963,0,2,2
41459,2,1,144963,144963,144964,0,1,0
41460,2,3,144965,144965,144968,0,3,1
41461,6,2,144971,144971,144973,0,2,3
41462,2,1,144973,144973,144974,0,1,0
41463,5,1,144978,144978,144979,0,1,4
41464,5,1,144983,144983,144984,0,1,4
41465,3,2,144986,144986,144988,0,2,2
41466,3,2,144989,144989,144991,0,2,1
41467,1,2,144990,144991,144993,1,3,0
41468,5,3,144995,144995,144998,0,3,2
41469,6,1,145001,145001,145002,0,1,3
41470,2,2,145003,145003,145005,0,2,1
41471,5,3,145008,145008,145011,0,3,3
41472,5,3,145013,145013,145016,0,3,2
41473,1,2,145014,145016,145018,2,4,0
41474,1,3,145015,145018,145021,3,6,0
41475,6,3,145021,145021,145024,0,3,0
41476,1,3,145022,145024,145027,2,5,0
41477,3,3,145025,145027,145030,2,5,0
41478,5,2,145030,145030,145032,0,2,0
41479,1,2,145031,145032,145034,1,3,0
41480,5,1,145036,145036,145037,0,1,2
41481,2,2,145038,145038,145040,0,2,1
41482,2,2,145040,145040,145042,0,2,0
41483,4,3,145044,145044,145047,0,3,2
41484,5,2,145049,145049,145051,0,2,2
41485,4,3,145053,145053,145056,0,3,2
41486,1,3,145054,145056,145059,2,5,0
41487,4,1,145058,145059,145060,1,2,0
41488,6,3,145064,145064,145067,0,3,4
41489,6,2,145070,145070,145072,0,2,3
41490,3,1,145073,145073,145074,0,1,1
41491,5,3,145078,145078,145081,0,3,4
41492,3,3,145081,145081,145084,0,3,0
41493,1,3,145082,145084,145087,2,5,0
41494,4,1,145086,145087,145088,1,2,0
41495,3,3,145089,145089,145092,0,3,1
41496,3,1,145092,145092,145093,0,1,0
41497,2,2,145094,145094,145096,0,2,1
41498,5,2,145099,145099,145101,0,2,3
41499,6,1,145105,145105,145106,0,1,4
41500,5,2,145110,145110,145112,0,2,4
41501,1,3,145111,145112,145115,1,4,0
41502,4,2,145115,145115,145117,0,2,0
41503,6,1,145121,145121,145122,0,1,4
41504,3,1,145124,145124,145125,0,1,2
41505,3,2,145127,145127,145129,0,2,2
41506,3,2,145130,145130,145132,0,2,1
41507,2,1,145132,145132,145133,0,1,0
41508,3,3,145135,145135,145138,0,3,2
41509,4,3,145139,145139,145142,0,3,1
41510,6,2,145145,145145,145147,0,2,3
41511,6,1,145151,145151,145152,0,1,4
41512,6,3,145157,145157,145160,0,3,5
41513,1,1,145158,145160,145161,2,3,0
41514,3,1,145161,145161,145162,0,1,0
41515,2,1,145163,145163,145164,0,1,1
41516,2,3,145165,145165,145168,0,3,1
41517,5,2,145170,145170,145172,0,2,2
41518,6,1,145176,145176,145177,0,1,4
41519,2,3,145178,145178,145181,0,3,1
41520,5,3,145183,145183,145186,0,3,2
41521,4,3,145187,145187,145190,0,3,1
41522,6,1,145193,145193,145194,0,1,3
41523,6,2,145199,145199,145201,0,2,5
41524,3,3,145202,145202,145205,0,3,1
41525,1,3,145203,145205,145208,2,5,0
41526,1,1,145204,145208,145209,4,5,0
41527,2,3,145206,145209,145212,3,6,0
41528,1,2,145207,145212,145214,5,7,0
41529,6,3,145213,145214,145217,1,4,0
41530,3,1,145216,145217,145218,1,2,0
41531,5,3,145221,145221,145224,0,3,3
41532,6,3,145227,145227,145230,0,3,3
41533,6,1,145233,145233,145234,0,1,3
41534,1,1,145234,145234,145235,0,1,0
41535,6,2,145240,145240,145242,0,2,5
41536,6,3,145246,145246,145249,0,3,4
41537,1,1,145247,145249,145250,2,3,0
41538,5,2,145252,145252,145254,0,2,2
41539,1,1,145253,145254,145255,1,2,0
41540,2,3,145255,145255,145258,0,3,0
41541,2,2,145257,145258,145260,1,3,0
41542,2,3,145259,145260,145263,1,4,0
41543,2,1,145261,145263,145264,2,3,0
41544,4,3,145265,145265,145268,0,3,1
41545,5,1,145270,145270,145271,0,1,2
41546,6,2,145276,145276,145278,0,2,5
41547,1,3,145277,145278,145281,1,4,0
41548,3,3,145280,145281,145284,1,4,0
41549,2,1,145282,145284,145285,2,3,0
41550,2,3,145284,145285,145288,1,4,0
41551,5,2,145289,145289,145291,0,2,1
41552,3,3,145292,145292,145295,0,3,1
41553,6,3,145298,145298,145301,0,3,3
41554,4,3,145302,145302,145305,0,3,1
41555,4,2,145306,145306,145308,0,2,1
41556,5,3,145311,145311,145314,0,3,3
41557,4,1,145315,145315,145316,0,1,1
41558,6,3,145321,145321,145324,0,3,5
41559,1,3,145322,145324,145327,2,5,0
41560,2,3,145324,145327,145330,3,6,0
41561,3,3,145327,145330,145333,3,6,0
41562,5,1,145332,145333,145334,1,2,0
41563,4,3,145336,145336,145339,0,3,2
41564,5,1,145341,145341,145342,0,1,2
41565,4,1,145345,145345,145346,0,1,3
41566,3,2,145348,145348,145350,0,2,2
41567,6,3,145354,145354,145357,0,3,4
41568,5,3,145359,145359,145362,0,3,2
41569,1,1,145360,145362,145363,2,3,0
41570,2,2,145362,145363,145365,1,3,0
41571,3,3,145365,145365,145368,0,3,0
41572,6,3,145371,145371,145374,0,3,3
41573,1,1,145372,145374,145375,2,3,0
41574,6,2,145378,145378,145380,0,2,3
41575,2,2,145380,145380,145382,0,2,0
41576,2,2,145382,145382,145384,0,2,0
41577,2,1,145384,145384,145385,0,1,0
41578,1,2,145385,145385,145387,0,2,0
41579,1,2,145386,145387,145389,1,3,0
41580,6,1,145392,145392,145393,0,1,3
41581,3,3,145395,145395,145398,0,3,2
41582,6,1,145401,145401,145402,0,1,3
41583,6,1,145407,145407,145408,0,1,5
41584,2,1,145409,145409,145410,0,1,1
41585,5,3,145414,145414,145417,0,3,4
41586,2,2,145416,145417,145419,1,3,0
41587,1,3,145417,145419,145422,2,5,0
41588,6,1,145423,145423,145424,0,1,1
41589,5,3,145428,145428,145431,0,3,4
41590,4,2,145432,145432,145434,0,2,1
41591,2,3,145434,145434,145437,0,3,0
41592,6,1,145440,145440,145441,0,1,3
41593,6,3,145446,145446,145449,0,3,5
41594,6,2,145452,145452,145454,0,2,3
41595,3,1,145455,145455,145456,0,1,1
41596,2,2,145457,145457,145459,0,2,1
41597,5,3,145462,145462,145465,0,3,3
41598,3,3,145465,145465,145468,0,3,0
41599,2,1,145467,145468,145469,1,2,0
41600,1,1,145468,145469,145470,1,2,0
41601,3,2,145471,145471,145473,0,2,1
41602,2,2,145473,145473,145475,0,2,0
41603,2,1,145475,145475,145476,0,1,0
41604,6,2,145481,145481,145483,0,2,5
41605,5,1,145486,145486,145487,0,1,3
41606,4,2,145490,145490,145492,0,2,3
41607,2,3,145492,145492,145495,0,3,0
41608,2,3,145494,145495,145498,1,4,0
41609,4,3,145498,145498,145501,0,3,0
41610,3,3,145501,145501,145504,0,3,0
41611,2,3,145503,145504,145507,1,4,0
41612,1,2,145504,145507,145509,3,5,0
41613,2,1,145506,145509,145510,3,4,0
41614,4,3,145510,145510,145513,0,3,0
41615,3,1,145513,145513,145514,0,1,0
41616,3,2,145516,145516,145518,0,2,2
41617,3,1,145519,145519,145520,0,1,1
41618,1,1,145520,145520,145521,0,1,0
41619,1,1,145521,145521,145522,0,1,0
41620,3,3,145524,145524,145527,0,3,2
41621,2,3,145526,145527,145530,1,4,0
41622,6,1,145532,145532,145533,0,1,2
41623,5,1,145537,145537,145538,0,1,4
41624,4,3,145541,145541,145544,0,3,3
41625,6,3,145547,145547,145550,0,3,3
41626,5,3,145552,145552,145555,0,3,2
41627,6,2,145558,145558,145560,0,2,3
41628,6,3,145564,145564,145567,0,3,4
41629,6,3,145570,145570,145573,0,3,3
41630,4,2,145574,145574,145576,0,2,1
41631,6,1,145580,145580,145581,0,1,4
41632,4,2,145584,145584,145586,0,2,3
41633,2,2,145586,145586,145588,0,2,0
41634,6,2,145592,145592,145594,0,2,4
41635,1,3,145593,145594,145597,1,4,0
41636,2,2,145595,145597,145599,2,4,0
41637,5,1,145600,145600,145601,0,1,1
41638,1,2,145601,145601,145603,0,2,0
41639,1,1,145602,145603,145604,1,2,0
41640,1,1,145603,145604,145605,1,2,0
41641,6,1,145609,145609,145610,0,1,4
41642,5,3,145614,145614,145617,0,3,4
41643,4,2,145618,145618,145620,0,2,1
41644,5,3,145623,145623,145626,0,3,3
41645,4,3,145627,145627,145630,0,3,1
41646,6,1,145633,145633,145634,0,1,3
41647,3,2,145636,145636,145638,0,2,2
41648,2,2,145638,145638,145640,0,2,0
41649,5,2,145643,145643,145645,0,2,3
41650,3,3,145646,145646,145649,0,3,1
41651,4,2,145650,145650,145652,0,2,1
41652,5,1,145655,145655,145656,0,1,3
41653,1,3,145656,145656,145659,0,3,0
41654,5,3,145661,145661,145664,0,3,2
41655,5,1,145666,145666,145667,0,1,2
41656,5,3,145671,145671,145674,0,3,4
41657,5,1,145676,145676,145677,0,1,2
41658,4,2,145680,145680,145682,0,2,3
41659,3,3,145683,145683,145686,0,3,1
41660,5,1,145688,145688,145689,0,1,2
41661,4,1,145692,145692,145693,0,1,3
41662,6,2,145698,145698,145700,0,2,5
41663,5,1,145703,145703,145704,0,1,3
41664,3,1,145706,145706,145707,0,1,2
41665,2,2,145708,145708,145710,0,2,1
41666,1,3,145709,145710,145713,1,4,0
41667,3,2,145712,145713,145715,1,3,0
41668,3,3,145715,145715,145718,0,3,0
41669,6,3,145721,145721,145724,0,3,3
41670,2,2,145723,145724,145726,1,3,0
41671,4,1,145727,145727,145728,0,1,1
41672,6,1,145733,145733,145734,0,1,5
41673,3,2,145736,145736,145738,0,2,2
41674,3,1,145739,145739,145740,0,1,1
41675,6,2,145745,145745,145747,0,2,5
41676,1,2,145746,145747,145749,1,3,0
41677,1,2,145747,145749,145751,2,4,0
41678,2,1,145749,145751,145752,2,3,0
41679,4,3,145753,145753,145756,0,3,1
41680,1,1,145754,145756,145757,2,3,0
41681,5,2,145759,145759,145761,0,2,2
41682,5,1,145764,145764,145765,0,1,3
41683,2,1,145766,145766,145767,0,1,1
41684,3,3,145769,145769,145772,0,3,2
41685,5,1,145774,145774,145775,0,1,2
41686,1,3,145775,145775,145778,0,3,0
41687,1,3,145776,145778,145781,2,5,0
41688,4,1,145780,145781,145782,1,2,0
41689,3,2,145783,145783,145785,0,2,1
41690,4,2,145787,145787,145789,0,2,2
41691,4,2,145791,145791,145793,0,2,2
41692,2,2,145793,145793,145795,0,2,0
41693,6,1,145799,145799,145800,0,1,4
41694,6,1,145805,145805,145806,0,1,5
41695,3,3,145808,145808,145811,0,3,2
41696,4,3,145812,145812,145815,0,3,1
41697,6,2,145818,145818,145820,0,2,3
41698,3,1,145821,145821,145822,0,1,1
41699,2,2,145823,145823,145825,0,2,1
41700,6,1,145829,145829,145830,0,1,4
41701,4,2,145833,145833,145835,0,2,3
41702,3,1,145836,145836,145837,0,1,1
41703,2,3,145838,145838,145841,0,3,1
41704,1,3,145839,145841,145844,2,5,0
41705,6,2,145845,145845,145847,0,2,1
41706,1,1,145846,145847,145848,1,2,0
41707,5,3,145851,145851,145854,0,3,3
41708,6,2,145857,145857,145859,0,2,3
41709,4,1,145861,145861,145862,0,1,2
41710,1,3,145862,145862,145865,0,3,0
41711,6,3,145868,145868,145871,0,3,3
41712,5,3,145873,145873,145876,0,3,2
41713,6,3,145879,145879,145882,0,3,3
41714,2,3,145881,145882,145885,1,4,0
41715,6,3,145887,145887,145890,0,3,2
41716,2,2,145889,145890,145892,1,3,0
41717,2,3,145891,145892,145895,1,4,0
41718,2,2,145893,145895,145897,2,4,0
41719,3,3,145896,145897,145900,1,4,0
41720,3,3,145899,145900,145903,1,4,0
41721,1,1,145900,145903,145904,3,4,0
41722,3,2,145903,145904,145906,1,3,0
41723,3,2,145906,145906,145908,0,2,0
41724,4,1,145910,145910,145911,0,1,2
41725,4,3,145914,145914,145917,0,3,3
41726,1,2,145915,145917,145919,2,4,0
41727,5,2,145920,145920,145922,0,2,1
41728,1,1,145921,145922,145923,1,2,0
41729,5,3,145926,145926,145929,0,3,3
41730,6,1,145932,145932,145933,0,1,3
41731,1,3,145933,145933,145936,0,3,0
41732,1,1,145934,145936,145937,2,3,0
41733,1,2,145935,145937,145939,2,4,0
41734,2,2,145937,145939,145941,2,4,0
41735,2,3,145939,145941,145944,2,5,0
41736,3,2,145942,145944,145946,2,4,0
41737,3,3,145945,145946,145949,1,4,0
41738,2,1,145947,145949,145950,2,3,0
41739,6,1,145953,145953,145954,0,1,3
41740,4,1,145957,145957,145958,0,1,3
41741,1,2,145958,145958,145960,0,2,0
41742,4,2,145962,145962,145964,0,2,2
41743,4,2,145966,145966,145968,0,2,2
41744,5,2,145971,145971,145973,0,2,3
41745,4,3,145975,145975,145978,0,3,2
41746,4,1,145979,145979,145980,0,1,1
41747,1,2,145980,145980,145982,0,2,0
41748,6,3,145986,145986,145989,0,3,4
41749,1,3,145987,145989,145992,2,5,0
41750,2,1,145989,145992,145993,3,4,0
41751,6,3,145995,145995,145998,0,3,2
41752,1,1,145996,145998,145999,2,3,0
41753,2,1,145998,145999,146000,1,2,0
41754,3,1,146001,146001,146002,0,1,1
41755,6,3,146007,146007,146010,0,3,5
41756,5,3,146012,146012,146015,0,3,2
41757,5,3,146017,146017,146020,0,3,2
41758,2,2,146019,146020,146022,1,3,0
41759,5,3,146024,146024,146027,0,3,2
41760,1,3,146025,146027,146030,2,5,0
41761,4,3,146029,146030,146033,1,4,0
41762,4,1,146033,146033,146034,0,1,0
41763,5,3,146038,146038,146041,0,3,4
41764,6,2,146044,146044,146046,0,2,3
41765,4,3,146048,146048,146051,0,3,2
41766,1,1,146049,146051,146052,2,3,0
41767,6,1,146055,146055,146056,0,1,3
41768,2,1,146057,146057,146058,0,1,1
41769,1,2,146058,146058,146060,0,2,0
41770,4,2,146062,146062,146064,0,2,2
41771,1,2,146063,146064,146066,1,3,0
41772,4,2,146067,146067,146069,0,2,1
41773,3,2,146070,146070,146072,0,2,1
41774,1,2,146071,146072,146074,1,3,0
41775,6,2,146077,146077,146079,0,2,3
41776,3,2,146080,146080,146082,0,2,1
41777,3,2,146083,146083,146085,0,2,1
41778,6,2,146089,146089,146091,0,2,4
41779,2,2,146091,146091,146093,0,2,0
41780,2,1,146093,146093,146094,0,1,0
41781,1,2,146094,146094,146096,0,2,0
41782,5,2,146099,146099,146101,0,2,3
41783,2,3,146101,146101,146104,0,3,0
41784,1,1,146102,146104,146105,2,3,0
41785,3,1,146105,146105,146106,0,1,0
41786,4,2,146109,146109,146111,0,2,3
41787,6,1,146115,146115,146116,0,1,4
41788,2,1,146117,146117,146118,0,1,1
41789,6,3,146123,146123,146126,0,3,5
41790,2,1,146125,146126,146127,1,2,0
41791,6,2,146131,146131,146133,0,2,4
41792,5,3,146136,146136,146139,0,3,3
41793,5,2,146141,146141,146143,0,2,2
41794,1,1,146142,146143,146144,1,2,0
41795,6,3,146148,146148,146151,0,3,4
41796,6,2,146154,146154,146156,0,2,3
41797,6,2,146160,146160,146162,0,2,4
41798,5,3,146165,146165,146168,0,3,3
41799,1,3,146166,146168,146171,2,5,0
41800,5,2,146171,146171,146173,0,2,0
41801,4,1,146175,146175,146176,0,1,2
41802,2,2,146177,146177,146179,0,2,1
41803,1,3,146178,146179,146182,1,4,0
41804,5,3,146183,146183,146186,0,3,1
41805,1,2,146184,146186,146188,2,4,0
41806,4,1,146188,146188,146189,0,1,0
41807,3,2,146191,146191,146193,0,2,2
41808,4,3,146195,146195,146198,0,3,2
41809,3,3,146198,146198,146201,0,3,0
41810,2,2,146200,146201,146203,1,3,0
41811,6,2,146206,146206,146208,0,2,3
41812,2,1,146208,146208,146209,0,1,0
41813,6,1,146214,146214,146215,0,1,5
41814,2,1,146216,146216,146217,0,1,1
41815,6,1,146222,146222,146223,0,1,5
41816,1,1,146223,146223,146224,0,1,0
41817,2,2,146225,146225,146227,0,2,1
41818,1,1,146226,146227,146228,1,2,0
41819,3,3,146229,146229,146232,0,3,1
41820,6,1,146235,146235,146236,0,1,3
41821,4,1,146239,146239,146240,0,1,3
41822,4,2,146243,146243,146245,0,2,3
41823,3,3,146246,146246,146249,0,3,1
41824,6,1,146252,146252,146253,0,1,3
41825,3,1,146255,146255,146256,0,1,2
41826,4,1,146259,146259,146260,0,1,3
41827,2,1,146261,146261,146262,0,1,1
41828,6,2,146267,146267,146269,0,2,5
41829,6,1,146273,146273,146274,0,1,4
41830,6,2,146279,146279,146281,0,2,5
41831,1,1,146280,146281,146282,1,2,0
41832,4,3,146284,146284,146287,0,3,2
41833,3,3,146287,146287,146290,0,3,0
41834,2,2,146289,146290,146292,1,3,0
41835,2,3,146291,146292,146295,1,4,0
41836,2,2,146293,146295,146297,2,4,0
41837,3,3,146296,146297,146300,1,4,0
41838,2,1,146298,146300,146301,2,3,0
41839,5,3,146303,146303,146306,0,3,2
41840,4,1,146307,146307,146308,0,1,1
41841,6,3,146313,146313,146316,0,3,5
41842,6,1,146319,146319,146320,0,1,3
41843,3,1,146322,146322,146323,0,1,2
41844,2,1,146324,146324,146325,0,1,1
41845,5,3,146329,146329,146332,0,3,4
41846,5,2,146334,146334,146336,0,2,2
41847,2,3,146336,146336,146339,0,3,0
41848,3,2,146339,146339,146341,0,2,0
41849,4,2,146343,146343,146345,0,2,2
41850,2,1,146345,146345,146346,0,1,0
41851,2,1,146347,146347,146348,0,1,1
41852,2,2,146349,146349,146351,0,2,1
41853,6,2,146355,146355,146357,0,2,4
41854,5,1,146360,146360,146361,0,1,3
41855,3,3,146363,146363,146366,0,3,2
41856,6,3,146369,146369,146372,0,3,3
41857,5,1,146374,146374,146375,0,1,2
41858,1,3,146375,146375,146378,0,3,0
41859,4,2,146379,146379,146381,0,2,1
41860,2,1,146381,146381,146382,0,1,0
41861,6,1,146387,146387,146388,0,1,5
41862,6,2,146393,146393,146395,0,2,5
41863,3,1,146396,146396,146397,0,1,1
41864,4,2,146400,146400,146402,0,2,3
41865,6,1,146406,146406,146407,0,1,4
41866,1,3,146407,146407,146410,0,3,0
41867,5,1,146412,146412,146413,0,1,2
41868,6,3,146418,146418,146421,0,3,5
41869,4,2,146422,146422,146424,0,2,1
41870,1,3,146423,146424,146427,1,4,0
41871,1,1,146424,146427,146428,3,4,0
41872,6,1,146430,146430,146431,0,1,2
41873,3,2,146433,146433,146435,0,2,2
41874,1,1,146434,146435,146436,1,2,0
41875,4,2,146438,146438,146440,0,2,2
41876,3,3,146441,146441,146444,0,3,1
41877,5,1,146446,146446,146447,0,1,2
41878,4,1,146450,146450,146451,0,1,3
41879,6,1,146456,146456,146457,0,1,5
41880,1,1,146457,146457,146458,0,1,0
41881,6,2,146463,146463,146465,0,2,5
41882,2,2,146465,146465,146467,0,2,0
41883,1,1,146466,146467,146468,1,2,0
41884,5,1,146471,146471,146472,0,1,3
41885,3,1,146474,146474,146475,0,1,2
41886,2,2,146476,146476,146478,0,2,1
41887,3,3,146479,146479,146482,0,3,1
41888,4,3,146483,146483,146486,0,3,1
41889,3,1,146486,146486,146487,0,1,0
41890,3,1,146489,146489,146490,0,1,2
41891,2,3,146491,146491,146494,0,3,1
41892,3,3,146494,146494,146497,0,3,0
41893,1,1,146495,146497,146498,2,3,0
41894,6,1,146501,146501,146502,0,1,3
41895,2,1,146503,146503,146504,0,1,1
41896,6,3,146509,146509,146512,0,3,5
41897,4,3,146513,146513,146516,0,3,1
41898,4,1,146517,146517,146518,0,1,1
41899,6,2,146523,146523,146525,0,2,5
41900,6,3,146529,146529,146532,0,3,4
41901,2,1,146531,146532,146533,1,2,0
41902,3,3,146534,146534,146537,0,3,1
41903,4,3,146538,146538,146541,0,3,1
41904,5,1,146543,146543,146544,0,1,2
41905,4,1,146547,146547,146548,0,1,3
41906,2,3,146549,146549,146552,0,3,1
41907,1,2,146550,146552,146554,2,4,0
41908,1,3,146551,146554,146557,3,6,0
41909,3,1,146554,146557,146558,3,4,0
41910,5,1,146559,146559,146560,0,1,1
41911,3,1,146562,146562,146563,0,1,2
41912,1,3,146563,146563,146566,0,3,0
41913,6,2,146569,146569,146571,0,2,3
41914,5,1,146574,146574,146575,0,1,3
41915,1,3,146575,146575,146578,0,3,0
41916,1,1,146576,146578,146579,2,3,0
41917,1,1,146577,146579,146580,2,3,0
41918,1,3,146578,146580,146583,2,5,0
41919,2,2,146580,146583,146585,3,5,0
41920,3,2,146583,146585,146587,2,4,0
41921,6,3,146589,146589,146592,0,3,2
41922,2,2,146591,146592,146594,1,3,0
41923,1,3,146592,146594,146597,2,5,0
41924,4,1,146596,146597,146598,1,2,0
41925,4,1,146600,146600,146601,0,1,2
41926,1,1,146601,146601,146602,0,1,0
41927,6,3,146607,146607,146610,0,3,5
41928,3,1,146610,146610,146611,0,1,0
41929,5,1,146615,146615,146616,0,1,4
41930,4,3,146619,146619,146622,0,3,3
41931,3,3,146622,146622,146625,0,3,0
41932,2,3,146624,146625,146628,1,4,0
41933,2,2,146626,146628,146630,2,4,0
41934,5,3,146631,146631,146634,0,3,1
41935,2,1,146633,146634,146635,1,2,0
41936,1,3,146634,146635,146638,1,4,0
41937,2,2,146636,146638,146640,2,4,0
41938,2,2,146638,146640,146642,2,4,0
41939,5,3,146643,146643,146646,0,3,1
41940,5,3,146648,146648,146651,0,3,2
41941,3,2,146651,146651,146653,0,2,0
41942,4,2,146655,146655,146657,0,2,2
41943,2,2,146657,146657,146659,0,2,0
41944,6,3,146663,146663,146666,0,3,4
41945,3,1,146666,146666,146667,0,1,0
41946,5,1,146671,146671,146672,0,1,4
41947,5,1,146676,146676,146677,0,1,4
41948,2,1,146678,146678,146679,0,1,1
41949,2,2,146680,146680,146682,0,2,1
41950,2,3,146682,146682,146685,0,3,0
41951,3,2,146685,146685,146687,0,2,0
41952,6,3,146691,146691,146694,0,3,4
41953,4,1,146695,146695,146696,0,1,1
41954,3,2,146698,146698,146700,0,2,2
41955,5,2,146703,146703,146705,0,2,3
41956,4,3,146707,146707,146710,0,3,2
41957,3,2,146710,146710,146712,0,2,0
41958,3,3,146713,146713,146716,0,3,1
41959,5,2,146718,146718,146720,0,2,2
41960,2,3,146720,146720,146723,0,3,0
41961,6,3,146726,146726,146729,0,3,3
41962,2,3,146728,146729,146732,1,4,0
41963,4,1,146732,146732,146733,0,1,0
41964,5,3,146737,146737,146740,0,3,4
41965,4,3,146741,146741,146744,0,3,1
41966,6,1,146747,146747,146748,0,1,3
41967,1,2,146748,146748,146750,0,2,0
41968,6,3,146754,146754,146757,0,3,4
41969,6,3,146760,146760,146763,0,3,3
41970,2,2,146762,146763,146765,1,3,0
41971,6,3,146768,146768,146771,0,3,3
41972,2,3,146770,146771,146774,1,4,0
41973,5,3,146775,146775,146778,0,3,1
41974,6,1,146781,146781,146782,0,1,3
41975,5,1,146786,146786,146787,0,1,4
41976,1,1,146787,146787,146788,0,1,0
41977,2,3,146789,146789,146792,0,3,1
41978,5,1,146794,146794,146795,0,1,2
41979,5,2,146799,146799,146801,0,2,4
41980,2,2,146801,146801,146803,0,2,0
41981,5,1,146806,146806,146807,0,1,3
41982,1,3,146807,146807,146810,0,3,0
41983,1,1,146808,146810,146811,2,3,0
41984,4,3,146812,146812,146815,0,3,1
41985,2,3,146814,146815,146818,1,4,0
41986,3,2,146817,146818,146820,1,3,0
41987,1,1,146818,146820,146821,2,3,0
41988,5,3,146823,146823,146826,0,3,2
41989,3,3,146826,146826,146829,0,3,0
41990,5,3,146831,146831,146834,0,3,2
41991,2,1,146833,146834,146835,1,2,0
41992,5,3,146838,146838,146841,0,3,3
41993,1,3,146839,146841,146844,2,5,0
41994,3,2,146842,146844,146846,2,4,0
41995,3,1,146845,146846,146847,1,2,0
41996,4,1,146849,146849,146850,0,1,2
41997,4,2,146853,146853,146855,0,2,3
41998,2,1,146855,146855,146856,0,1,0
41999,2,2,146857,146857,146859,0,2,1
42000,2,2,146859,146859,146861,0,2,0
42001,2,2,146861,146861,146863,0,2,0
42002,2,2,146863,146863,146865,0,2,0
42003,4,1,146867,146867,146868,0,1,2
42004,6,2,146873,146873,146875,0,2,5
42005,1,1,146874,146875,146876,1,2,0
42006,3,1,146877,146877,146878,0,1,1
42007,2,1,146879,146879,146880,0,1,1
42008,6,1,146885,146885,146886,0,1,5
42009,5,2,146890,146890,146892,0,2,4
42010,1,2,146891,146892,146894,1,3,0
42011,5,2,146896,146896,146898,0,2,2
42012,3,2,146899,146899,146901,0,2,1
42013,4,1,146903,146903,146904,0,1,2
42014,5,1,146908,146908,146909,0,1,4
42015,6,1,146914,146914,146915,0,1,5
42016,3,2,146917,146917,146919,0,2,2
42017,3,1,146920,146920,146921,0,1,1
42018,3,1,146923,146923,146924,0,1,2
42019,4,2,146927,146927,146929,0,2,3
42020,5,1,146932,146932,146933,0,1,3
42021,4,3,146936,146936,146939,0,3,3
42022,5,3,146941,146941,146944,0,3,2
42023,6,1,146947,146947,146948,0,1,3
42024,6,3,146953,146953,146956,0,3,5
42025,4,3,146957,146957,146960,0,3,1
42026,4,1,146961,146961,146962,0,1,1
42027,4,1,146965,146965,146966,0,1,3
42028,6,3,146971,146971,146974,0,3,5
42029,3,1,146974,146974,146975,0,1,0
42030,1,2,146975,146975,146977,0,2,0
42031,4,2,146979,146979,146981,0,2,2
42032,4,3,146983,146983,146986,0,3,2
42033,2,1,146985,146986,146987,1,2,0
42034,1,3,146986,146987,146990,1,4,0
42035,2,3,146988,146990,146993,2,5,0
42036,5,2,146993,146993,146995,0,2,0
42037,5,2,146998,146998,147000,0,2,3
42038,4,1,147002,147002,147003,0,1,2
42039,5,2,147007,147007,147009,0,2,4
42040,1,1,147008,147009,147010,1,2,0
42041,6,1,147014,147014,147015,0,1,4
42042,3,2,147017,147017,147019,0,2,2
42043,6,2,147023,147023,147025,0,2,4
42044,3,2,147026,147026,147028,0,2,1
42045,5,2,147031,147031,147033,0,2,3
42046,4,2,147035,147035,147037,0,2,2
42047,6,1,147041,147041,147042,0,1,4
42048,5,1,147046,147046,147047,0,1,4
42049,3,3,147049,147049,147052,0,3,2
42050,4,2,147053,147053,147055,0,2,1
42051,3,3,147056,147056,147059,0,3,1
42052,2,1,147058,147059,147060,1,2,0
42053,1,2,147059,147060,147062,1,3,0
42054,5,2,147064,147064,147066,0,2,2
42055,1,1,147065,147066,147067,1,2,0
42056,1,3,147066,147067,147070,1,4,0
42057,3,3,147069,147070,147073,1,4,0
42058,4,1,147073,147073,147074,0,1,0
42059,5,3,147078,147078,147081,0,3,4
42060,6,3,147084,147084,147087,0,3,3
42061,6,1,147090,147090,147091,0,1,3
42062,6,2,147096,147096,147098,0,2,5
42063,2,1,147098,147098,147099,0,1,0
42064,1,3,147099,147099,147102,0,3,0
42065,4,2,147103,147103,147105,0,2,1
42066,4,3,147107,147107,147110,0,3,2
42067,2,2,147109,147110,147112,1,3,0
42068,3,3,147112,147112,147115,0,3,0
42069,4,1,147116,147116,147117,0,1,1
42070,2,2,147118,147118,147120,0,2,1
42071,3,3,147121,147121,147124,0,3,1
42072,3,1,147124,147124,147125,0,1,0
42073,5,2,147129,147129,147131,0,2,4
42074,1,1,147130,147131,147132,1,2,0
42075,3,2,147133,147133,147135,0,2,1
42076,5,1,147138,147138,147139,0,1,3
42077,1,2,147139,147139,147141,0,2,0
42078,3,2,147142,147142,147144,0,2,1
42079,2,2,147144,147144,147146,0,2,0
42080,1,3,147145,147146,147149,1,4,0
42081,1,3,147146,147149,147152,3,6,0
42082,4,2,147150,147152,147154,2,4,0
42083,1,2,147151,147154,147156,3,5,0
42084,2,1,147153,147156,147157,3,4,0
42085,1,2,147154,147157,147159,3,5,0
42086,1,3,147155,147159,147162,4,7,0
42087,3,3,147158,147162,147165,4,7,0
42088,3,1,147161,147165,147166,4,5,0
42089,4,2,147165,147166,147168,1,3,0
42090,3,2,147168,147168,147170,0,2,0
42091,4,1,147172,147172,147173,0,1,2
42092,2,1,147174,147174,147175,0,1,1
42093,3,2,147177,147177,147179,0,2,2
42094,4,2,147181,147181,147183,0,2,2
42095,2,3,147183,147183,147186,0,3,0
42096,3,3,147186,147186,147189,0,3,0
42097,1,2,147187,147189,147191,2,4,0
42098,5,2,147192,147192,147194,0,2,1
42099,4,1,147196,147196,147197,0,1,2
42100,4,2,147200,147200,147202,0,2,3
42101,3,3,147203,147203,147206,0,3,1
42102,1,3,147204,147206,147209,2,5,0
42103,4,2,147208,147209,147211,1,3,0
42104,4,1,147212,147212,147213,0,1,1
42105,3,3,147215,147215,147218,0,3,2
42106,4,3,147219,147219,147222,0,3,1
42107,4,1,147223,147223,147224,0,1,1
42108,3,1,147226,147226,147227,0,1,2
42109,4,1,147230,147230,147231,0,1,3
42110,2,1,147232,147232,147233,0,1,1
42111,6,3,147238,147238,147241,0,3,5
42112,6,3,147244,147244,147247,0,3,3
42113,5,3,147249,147249,147252,0,3,2
42114,3,3,147252,147252,147255,0,3,0
42115,1,2,147253,147255,147257,2,4,0
42116,2,3,147255,147257,147260,2,5,0
42117,6,1,147261,147261,147262,0,1,1
42118,6,3,147267,147267,147270,0,3,5
42119,3,3,147270,147270,147273,0,3,0
42120,5,3,147275,147275,147278,0,3,2
42121,6,3,147281,147281,147284,0,3,3
42122,2,3,147283,147284,147287,1,4,0
42123,6,2,147289,147289,147291,0,2,2
42124,3,2,147292,147292,147294,0,2,1
42125,6,2,147298,147298,147300,0,2,4
42126,6,2,147304,147304,147306,0,2,4
42127,6,3,147310,147310,147313,0,3,4
42128,1,3,147311,147313,147316,2,5,0
42129,5,3,147316,147316,147319,0,3,0
42130,3,1,147319,147319,147320,0,1,0
42131,4,3,147323,147323,147326,0,3,3
42132,3,3,147326,147326,147329,0,3,0
42133,2,3,147328,147329,147332,1,4,0
42134,6,2,147334,147334,147336,0,2,2
42135,5,3,147339,147339,147342,0,3,3
42136,1,2,147340,147342,147344,2,4,0
42137,3,2,147343,147344,147346,1,3,0
42138,2,2,147345,147346,147348,1,3,0
42139,5,2,147350,147350,147352,0,2,2
42140,6,1,147356,147356,147357,0,1,4
42141,4,2,147360,147360,147362,0,2,3
42142,5,3,147365,147365,147368,0,3,3
42143,4,2,147369,147369,147371,0,2,1
42144,2,1,147371,147371,147372,0,1,0
42145,1,3,147372,147372,147375,0,3,0
42146,6,1,147378,147378,147379,0,1,3
42147,3,1,147381,147381,147382,0,1,2
42148,4,2,147385,147385,147387,0,2,3
42149,1,1,147386,147387,147388,1,2,0
42150,6,3,147392,147392,147395,0,3,4
42151,1,1,147393,147395,147396,2,3,0
42152,6,3,147399,147399,147402,0,3,3
42153,4,2,147403,147403,147405,0,2,1
42154,3,3,147406,147406,147409,0,3,1
42155,1,1,147407,147409,147410,2,3,0
42156,1,3,147408,147410,147413,2,5,0
42157,2,2,147410,147413,147415,3,5,0
42158,3,2,147413,147415,147417,2,4,0
42159,3,3,147416,147417,147420,1,4,0
42160,6,3,147422,147422,147425,0,3,2
42161,5,3,147427,147427,147430,0,3,2
42162,5,1,147432,147432,147433,0,1,2
42163,3,1,147435,147435,147436,0,1,2
42164,5,2,147440,147440,147442,0,2,4
42165,3,3,147443,147443,147446,0,3,1
42166,6,1,147449,147449,147450,0,1,3
42167,1,1,147450,147450,147451,0,1,0
42168,3,3,147453,147453,147456,0,3,2
42169,2,1,147455,147456,147457,1,2,0
42170,6,2,147461,147461,147463,0,2,4
42171,6,3,147467,147467,147470,0,3,4
42172,4,1,147471,147471,147472,0,1,1
42173,3,1,147474,147474,147475,0,1,2
42174,5,2,147479,147479,147481,0,2,4
42175,4,3,147483,147483,147486,0,3,2
42176,5,2,147488,147488,147490,0,2,2
42177,3,2,147491,147491,147493,0,2,1
42178,4,3,147495,147495,147498,0,3,2
42179,4,2,147499,147499,147501,0,2,1
42180,3,1,147502,147502,147503,0,1,1
42181,6,1,147508,147508,147509,0,1,5
42182,5,3,147513,147513,147516,0,3,4
42183,2,2,147515,147516,147518,1,3,0
42184,5,1,147520,147520,147521,0,1,2
42185,1,3,147521,147521,147524,0,3,0
42186,3,2,147524,147524,147526,0,2,0
42187,2,3,147526,147526,147529,0,3,0
42188,6,2,147532,147532,147534,0,2,3
42189,5,2,147537,147537,147539,0,2,3
42190,3,2,147540,147540,147542,0,2,1
42191,4,2,147544,147544,147546,0,2,2
42192,3,3,147547,147547,147550,0,3,1
42193,3,2,147550,147550,147552,0,2,0
42194,3,3,147553,147553,147556,0,3,1
42195,6,3,147559,147559,147562,0,3,3
42196,2,1,147561,147562,147563,1,2,0
42197,5,3,147566,147566,147569,0,3,3
42198,6,1,147572,147572,147573,0,1,3
42199,6,2,147578,147578,147580,0,2,5
42200,5,1,147583,147583,147584,0,1,3
42201,5,1,147588,147588,147589,0,1,4
42202,3,1,147591,147591,147592,0,1,2
42203,6,2,147597,147597,147599,0,2,5
42204,3,1,147600,147600,147601,0,1,1
42205,3,2,147603,147603,147605,0,2,2
42206,5,3,147608,147608,147611,0,3,3
42207,5,3,147613,147613,147616,0,3,2
42208,5,3,147618,147618,147621,0,3,2
42209,4,2,147622,147622,147624,0,2,1
42210,2,2,147624,147624,147626,0,2,0
42211,6,3,147630,147630,147633,0,3,4
42212,5,2,147635,147635,147637,0,2,2
42213,5,3,147640,147640,147643,0,3,3
42214,4,2,147644,147644,147646,0,2,1
42215,3,1,147647,147647,147648,0,1,1
42216,5,2,147652,147652,147654,0,2,4
42217,4,2,147656,147656,147658,0,2,2
42218,6,3,147662,147662,147665,0,3,4
42219,3,2,147665,147665,147667,0,2,0
42220,2,1,147667,147667,147668,0,1,0
42221,5,3,147672,147672,147675,0,3,4
42222,1,1,147673,147675,147676,2,3,0
42223,3,1,147676,147676,147677,0,1,0
42224,1,2,147677,147677,147679,0,2,0
42225,1,2,147678,147679,147681,1,3,0
42226,4,1,147682,147682,147683,0,1,1
42227,6,1,147688,147688,147689,0,1,5
42228,3,1,147691,147691,147692,0,1,2
42229,5,2,147696,147696,147698,0,2,4
42230,3,2,147699,147699,147701,0,2,1
42231,6,1,147705,147705,147706,0,1,4
42232,1,3,147706,147706,147709,0,3,0
42233,5,1,147711,147711,147712,0,1,2
42234,1,1,147712,147712,147713,0,1,0
42235,1,3,147713,147713,147716,0,3,0
42236,4,1,147717,147717,147718,0,1,1
42237,1,1,147718,147718,147719,0,1,0
42238,5,3,147723,147723,147726,0,3,4
42239,1,1,147724,147726,147727,2,3,0
42240,5,3,147729,147729,147732,0,3,2
42241,5,3,147734,147734,147737,0,3,2
42242,6,1,147740,147740,147741,0,1,3
42243,6,1,147746,147746,147747,0,1,5
42244,2,2,147748,147748,147750,0,2,1
42245,2,2,147750,147750,147752,0,2,0
42246,4,1,147754,147754,147755,0,1,2
42247,1,2,147755,147755,147757,0,2,0
42248,6,1,147761,147761,147762,0,1,4
42249,6,3,147767,147767,147770,0,3,5
42250,5,1,147772,147772,147773,0,1,2
42251,5,1,147777,147777,147778,0,1,4
42252,4,1,147781,147781,147782,0,1,3
42253,2,2,147783,147783,147785,0,2,1
42254,3,3,147786,147786,147789,0,3,1
42255,3,1,147789,147789,147790,0,1,0
42256,2,1,147791,147791,147792,0,1,1
42257,4,2,147795,147795,147797,0,2,3
42258,6,3,147801,147801,147804,0,3,4
42259,6,2,147807,147807,147809,0,2,3
42260,5,1,147812,147812,147813,0,1,3
42261,3,2,147815,147815,147817,0,2,2
42262,3,2,147818,147818,147820,0,2,1
42263,1,1,147819,147820,147821,1,2,0
42264,5,3,147824,147824,147827,0,3,3
42265,3,2,147827,147827,147829,0,2,0
42266,2,2,147829,147829,147831,0,2,0
42267,5,1,147834,147834,147835,0,1,3
42268,2,2,147836,147836,147838,0,2,1
42269,1,2,147837,147838,147840,1,3,0
42270,2,2,147839,147840,147842,1,3,0
42271,2,2,147841,147842,147844,1,3,0
42272,6,3,147847,147847,147850,0,3,3
42273,3,3,147850,147850,147853,0,3,0
42274,6,1,147856,147856,147857,0,1,3
42275,2,3,147858,147858,147861,0,3,1
42276,4,3,147862,147862,147865,0,3,1
42277,6,1,147868,147868,147869,0,1,3
42278,6,3,147874,147874,147877,0,3,5
42279,2,1,147876,147877,147878,1,2,0
42280,2,3,147878,147878,147881,0,3,0
42281,4,2,147882,147882,147884,0,2,1
42282,4,1,147886,147886,147887,0,1,2
42283,5,3,147891,147891,147894,0,3,4
42284,1,3,147892,147894,147897,2,5,0
42285,3,3,147895,147897,147900,2,5,0
42286,6,2,147901,147901,147903,0,2,1
42287,5,3,147906,147906,147909,0,3,3
42288,1,1,147907,147909,147910,2,3,0
42289,3,2,147910,147910,147912,0,2,0
42290,3,2,147913,147913,147915,0,2,1
42291,5,3,147918,147918,147921,0,3,3
42292,2,1,147920,147921,147922,1,2,0
42293,6,2,147926,147926,147928,0,2,4
42294,6,1,147932,147932,147933,0,1,4
42295,3,1,147935,147935,147936,0,1,2
42296,4,1,147939,147939,147940,0,1,3
42297,4,3,147943,147943,147946,0,3,3
42298,6,2,147949,147949,147951,0,2,3
42299,5,2,147954,147954,147956,0,2,3
42300,4,2,147958,147958,147960,0,2,2
42301,4,3,147962,147962,147965,0,3,2
42302,6,2,147968,147968,147970,0,2,3
42303,5,2,147973,147973,147975,0,2,3
42304,5,3,147978,147978,147981,0,3,3
42305,2,3,147980,147981,147984,1,4,0
42306,5,2,147985,147985,147987,0,2,1
42307,1,1,147986,147987,147988,1,2,0
42308,4,1,147990,147990,147991,0,1,2
42309,3,1,147993,147993,147994,0,1,2
42310,4,2,147997,147997,147999,0,2,3
42311,4,1,148001,148001,148002,0,1,2
42312,6,1,148007,148007,148008,0,1,5
42313,3,3,148010,148010,148013,0,3,2
42314,1,3,148011,148013,148016,2,5,0
42315,1,2,148012,148016,148018,4,6,0
42316,4,2,148016,148018,148020,2,4,0
42317,2,3,148018,148020,148023,2,5,0
42318,1,3,148019,148023,148026,4,7,0
42319,4,3,148023,148026,148029,3,6,0
42320,6,3,148029,148029,148032,0,3,0
42321,3,3,148032,148032,148035,0,3,0
42322,2,3,148034,148035,148038,1,4,0
42323,4,3,148038,148038,148041,0,3,0
42324,4,1,148042,148042,148043,0,1,1
42325,5,1,148047,148047,148048,0,1,4
42326,2,2,148049,148049,148051,0,2,1
42327,2,1,148051,148051,148052,0,1,0
42328,6,3,148057,148057,148060,0,3,5
42329,4,1,148061,148061,148062,0,1,1
42330,6,3,148067,148067,148070,0,3,5
42331,5,2,148072,148072,148074,0,2,2
42332,4,2,148076,148076,148078,0,2,2
42333,4,1,148080,148080,148081,0,1,2
42334,6,2,148086,148086,148088,0,2,5
42335,5,3,148091,148091,148094,0,3,3
42336,1,3,148092,148094,148097,2,5,0
42337,1,3,148093,148097,148100,4,7,0
42338,2,1,148095,148100,148101,5,6,0
42339,3,1,148098,148101,148102,3,4,0
42340,6,3,148104,148104,148107,0,3,2
42341,5,1,148109,148109,148110,0,1,2
42342,3,2,148112,148112,148114,0,2,2
42343,6,3,148118,148118,148121,0,3,4
42344,5,2,148123,148123,148125,0,2,2
42345,6,3,148129,148129,148132,0,3,4
42346,4,1,148133,148133,148134,0,1,1
42347,3,2,148136,148136,148138,0,2,2
42348,1,2,148137,148138,148140,1,3,0
42349,6,1,148143,148143,148144,0,1,3
42350,5,2,148148,148148,148150,0,2,4
42351,1,3,148149,148150,148153,1,4,0
42352,6,3,148155,148155,148158,0,3,2
42353,2,3,148157,148158,148161,1,4,0
42354,6,3,148163,148163,148166,0,3,2
42355,2,3,148165,148166,148169,1,4,0
42356,2,3,148167,148169,148172,2,5,0
42357,3,3,148170,148172,148175,2,5,0
42358,2,3,148172,148175,148178,3,6,0
42359,6,1,148178,148178,148179,0,1,0
42360,1,1,148179,148179,148180,0,1,0
42361,4,2,148183,148183,148185,0,2,3
42362,6,2,148189,148189,148191,0,2,4
42363,6,1,148195,148195,148196,0,1,4
42364,1,3,148196,148196,148199,0,3,0
42365,5,3,148201,148201,148204,0,3,2
42366,3,1,148204,148204,148205,0,1,0
42367,3,1,148207,148207,148208,0,1,2
42368,5,3,148212,148212,148215,0,3,4
42369,4,3,148216,148216,148219,0,3,1
42370,3,2,148219,148219,148221,0,2,0
42371,2,3,148221,148221,148224,0,3,0
42372,4,2,148225,148225,148227,0,2,1
42373,5,3,148230,148230,148233,0,3,3
42374,6,3,148236,148236,148239,0,3,3
42375,6,2,148242,148242,148244,0,2,3
42376,6,1,148248,148248,148249,0,1,4
42377,6,2,148254,148254,148256,0,2,5
42378,2,1,148256,148256,148257,0,1,0
42379,2,1,148258,148258,148259,0,1,1
42380,5,1,148263,148263,148264,0,1,4
42381,4,2,148267,148267,148269,0,2,3
42382,4,3,148271,148271,148274,0,3,2
42383,6,2,148277,148277,148279,0,2,3
42384,6,3,148283,148283,148286,0,3,4
42385,4,3,148287,148287,148290,0,3,1
42386,6,2,148293,148293,148295,0,2,3
42387,6,1,148299,148299,148300,0,1,4
42388,2,1,148301,148301,148302,0,1,1
42389,1,3,148302,148302,148305,0,3,0
42390,5,2,148307,148307,148309,0,2,2
42391,3,1,148310,148310,148311,0,1,1
42392,2,2,148312,148312,148314,0,2,1
42393,4,3,148316,148316,148319,0,3,2
42394,5,1,148321,148321,148322,0,1,2
42395,5,2,148326,148326,148328,0,2,4
42396,2,1,148328,148328,148329,0,1,0
42397,5,1,148333,148333,148334,0,1,4
42398,5,2,148338,148338,148340,0,2,4
42399,1,3,148339,148340,148343,1,4,0
42400,3,2,148342,148343,148345,1,3,0
42401,6,1,148348,148348,148349,0,1,3
42402,5,2,148353,148353,148355,0,2,4
42403,2,3,148355,148355,148358,0,3,0
42404,6,3,148361,148361,148364,0,3,3
42405,4,3,148365,148365,148368,0,3,1
42406,6,2,148371,148371,148373,0,2,3
42407,1,2,148372,148373,148375,1,3,0
42408,1,2,148373,148375,148377,2,4,0
42409,5,2,148378,148378,148380,0,2,1
42410,2,2,148380,148380,148382,0,2,0
42411,3,2,148383,148383,148385,0,2,1
42412,1,3,148384,148385,148388,1,4,0
42413,5,1,148389,148389,148390,0,1,1
42414,5,2,148394,148394,148396,0,2,4
42415,3,3,148397,148397,148400,0,3,1
42416,4,1,148401,148401,148402,0,1,1
42417,5,1,148406,148406,148407,0,1,4
42418,6,3,148412,148412,148415,0,3,5
42419,3,3,148415,148415,148418,0,3,0
42420,2,3,148417,148418,148421,1,4,0
42421,3,3,148420,148421,148424,1,4,0
42422,3,3,148423,148424,148427,1,4,0
42423,3,2,148426,148427,148429,1,3,0
42424,1,1,148427,148429,148430,2,3,0
42425,1,3,148428,148430,148433,2,5,0
42426,2,3,148430,148433,148436,3,6,0
42427,4,3,148434,148436,148439,2,5,0
42428,5,3,148439,148439,148442,0,3,0
42429,4,2,148443,148443,148445,0,2,1
42430,1,1,148444,148445,148446,1,2,0
42431,1,1,148445,148446,148447,1,2,0
42432,6,1,148451,148451,148452,0,1,4
42433,2,1,148453,148453,148454,0,1,1
42434,6,1,148459,148459,148460,0,1,5
42435,4,2,148463,148463,148465,0,2,3
42436,2,2,148465,148465,148467,0,2,0
42437,6,2,148471,148471,148473,0,2,4
42438,2,1,148473,148473,148474,0,1,0
42439,6,3,148479,148479,148482,0,3,5
42440,4,2,148483,148483,148485,0,2,1
42441,2,2,148485,148485,148487,0,2,0
42442,6,1,148491,148491,148492,0,1,4
42443,2,1,148493,148493,148494,0,1,1
42444,6,1,148499,148499,148500,0,1,5
42445,4,2,148503,148503,148505,0,2,3
42446,1,1,148504,148505,148506,1,2,0
42447,5,2,148509,148509,148511,0,2,3
42448,2,3,148511,148511,148514,0,3,0
42449,1,3,148512,148514,148517,2,5,0
42450,3,3,148515,148517,148520,2,5,0
42451,1,2,148516,148520,148522,4,6,0
42452,5,3,148521,148522,148525,1,4,0
42453,6,3,148527,148527,148530,0,3,2
42454,2,1,148529,148530,148531,1,2,0
42455,6,2,148535,148535,148537,0,2,4
42456,4,3,148539,148539,148542,0,3,2
42457,4,2,148543,148543,148545,0,2,1
42458,3,2,148546,148546,148548,0,2,1
42459,1,3,148547,148548,148551,1,4,0
42460,3,1,148550,148551,148552,1,2,0
42461,6,1,148556,148556,148557,0,1,4
42462,2,1,148558,148558,148559,0,1,1
42463,3,1,148561,148561,148562,0,1,2
42464,1,3,148562,148562,148565,0,3,0
42465,4,1,148566,148566,148567,0,1,1
42466,1,3,148567,148567,148570,0,3,0
42467,6,1,148573,148573,148574,0,1,3
42468,6,3,148579,148579,148582,0,3,5
42469,5,1,148584,148584,148585,0,1,2
42470,2,3,148586,148586,148589,0,3,1
42471,4,2,148590,148590,148592,0,2,1
42472,5,3,148595,148595,148598,0,3,3
42473,1,1,148596,148598,148599,2,3,0
42474,4,2,148600,148600,148602,0,2,1
42475,3,1,148603,148603,148604,0,1,1
42476,1,3,148604,148604,148607,0,3,0
42477,4,3,148608,148608,148611,0,3,1
42478,4,3,148612,148612,148615,0,3,1
42479,2,2,148614,148615,148617,1,3,0
42480,6,2,148620,148620,148622,0,2,3
42481,2,2,148622,148622,148624,0,2,0
42482,2,1,148624,148624,148625,0,1,0
42483,4,2,148628,148628,148630,0,2,3
42484,4,3,148632,148632,148635,0,3,2
42485,2,3,148634,148635,148638,1,4,0
42486,5,2,148639,148639,148641,0,2,1
42487,1,1,148640,148641,148642,1,2,0
42488,6,1,148646,148646,148647,0,1,4
42489,6,2,148652,148652,148654,0,2,5
42490,5,3,148657,148657,148660,0,3,3
42491,2,2,148659,148660,148662,1,3,0
42492,4,3,148663,148663,148666,0,3,1
42493,6,1,148669,148669,148670,0,1,3
42494,1,2,148670,148670,148672,0,2,0
42495,1,3,148671,148672,148675,1,4,0
42496,5,3,148676,148676,148679,0,3,1
42497,6,2,148682,148682,148684,0,2,3
42498,4,3,148686,148686,148689,0,3,2
42499,1,1,148687,148689,148690,2,3,0
42500,4,2,148691,148691,148693,0,2,1
42501,4,1,148695,148695,148696,0,1,2
42502,4,3,148699,148699,148702,0,3,3
42503,5,3,148704,148704,148707,0,3,2
42504,1,2,148705,148707,148709,2,4,0
42505,1,2,148706,148709,148711,3,5,0
42506,5,2,148711,148711,148713,0,2,0
42507,2,3,148713,148713,148716,0,3,0
42508,6,2,148719,148719,148721,0,2,3
42509,1,1,148720,148721,148722,1,2,0
42510,6,2,148726,148726,148728,0,2,4
42511,3,2,148729,148729,148731,0,2,1
42512,5,3,148734,148734,148737,0,3,3
42513,1,3,148735,148737,148740,2,5,0
42514,5,3,148740,148740,148743,0,3,0
42515,6,1,148746,148746,148747,0,1,3
42516,2,2,148748,148748,148750,0,2,1
42517,6,3,148754,148754,148757,0,3,4
42518,3,1,148757,148757,148758,0,1,0
42519,2,1,148759,148759,148760,0,1,1
42520,5,2,148764,148764,148766,0,2,4
42521,1,3,148765,148766,148769,1,4,0
42522,5,2,148770,148770,148772,0,2,1
42523,4,1,148774,148774,148775,0,1,2
42524,5,1,148779,148779,148780,0,1,4
42525,3,1,148782,148782,148783,0,1,2
42526,3,1,148785,148785,148786,0,1,2
42527,1,1,148786,148786,148787,0,1,0
42528,1,2,148787,148787,148789,0,2,0
42529,6,1,148793,148793,148794,0,1,4
42530,6,2,148799,148799,148801,0,2,5
42531,6,1,148805,148805,148806,0,1,4
42532,2,1,148807,148807,148808,0,1,1
42533,2,2,148809,148809,148811,0,2,1
42534,5,1,148814,148814,148815,0,1,3
42535,2,1,148816,148816,148817,0,1,1
42536,1,1,148817,148817,148818,0,1,0
42537,4,2,148821,148821,148823,0,2,3
42538,1,3,148822,148823,148826,1,4,0
42539,5,3,148827,148827,148830,0,3,1
42540,5,1,148832,148832,148833,0,1,2
42541,4,1,148836,148836,148837,0,1,3
42542,1,2,148837,148837,148839,0,2,0
42543,6,1,148843,148843,148844,0,1,4
42544,3,2,148846,148846,148848,0,2,2
42545,6,1,148852,148852,148853,0,1,4
42546,3,3,148855,148855,148858,0,3,2
42547,2,3,148857,148858,148861,1,4,0
42548,6,3,148863,148863,148866,0,3,2
42549,5,2,148868,148868,148870,0,2,2
42550,3,2,148871,148871,148873,0,2,1
42551,4,2,148875,148875,148877,0,2,2
42552,3,1,148878,148878,148879,0,1,1
42553,1,1,148879,148879,148880,0,1,0
42554,4,2,148883,148883,148885,0,2,3
42555,1,1,148884,148885,148886,1,2,0
42556,5,1,148889,148889,148890,0,1,3
42557,4,3,148893,148893,148896,0,3,3
42558,4,1,148897,148897,148898,0,1,1
42559,6,3,148903,148903,148906,0,3,5
42560,3,3,148906,148906,148909,0,3,0
42561,5,2,148911,148911,148913,0,2,2
42562,6,3,148917,148917,148920,0,3,4
42563,6,1,148923,148923,148924,0,1,3
42564,4,3,148927,148927,148930,0,3,3
42565,2,3,148929,148930,148933,1,4,0
42566,1,2,148930,148933,148935,3,5,0
42567,2,3,148932,148935,148938,3,6,0
42568,3,2,148935,148938,148940,3,5,0
42569,5,1,148940,148940,148941,0,1,0
42570,4,1,148944,148944,148945,0,1,3
42571,2,3,148946,148946,148949,0,3,1
42572,5,2,148951,148951,148953,0,2,2
42573,6,1,148957,148957,148958,0,1,4
42574,1,3,148958,148958,148961,0,3,0
42575,2,2,148960,148961,148963,1,3,0
42576,5,1,148965,148965,148966,0,1,2
42577,5,1,148970,148970,148971,0,1,4
42578,1,3,148971,148971,148974,0,3,0
42579,5,3,148976,148976,148979,0,3,2
42580,2,2,148978,148979,148981,1,3,0
42581,3,2,148981,148981,148983,0,2,0
42582,5,3,148986,148986,148989,0,3,3
42583,4,3,148990,148990,148993,0,3,1
42584,4,3,148994,148994,148997,0,3,1
42585,3,3,148997,148997,149000,0,3,0
42586,3,2,149000,149000,149002,0,2,0
42587,6,3,149006,149006,149009,0,3,4
42588,4,1,149010,149010,149011,0,1,1
42589,2,2,149012,149012,149014,0,2,1
42590,1,3,149013,149014,149017,1,4,0
42591,2,3,149015,149017,149020,2,5,0
42592,3,3,149018,149020,149023,2,5,0
42593,1,1,149019,149023,149024,4,5,0
42594,5,1,149024,149024,149025,0,1,0
42595,4,2,149028,149028,149030,0,2,3
42596,5,2,149033,149033,149035,0,2,3
42597,2,3,149035,149035,149038,0,3,0
42598,4,1,149039,149039,149040,0,1,1
42599,4,1,149043,149043,149044,0,1,3
42600,4,2,149047,149047,149049,0,2,3
42601,2,3,149049,149049,149052,0,3,0
42602,6,3,149055,149055,149058,0,3,3
42603,5,3,149060,149060,149063,0,3,2
42604,3,1,149063,149063,149064,0,1,0
42605,2,1,149065,149065,149066,0,1,1
42606,4,2,149069,149069,149071,0,2,3
42607,2,1,149071,149071,149072,0,1,0
42608,3,3,149074,149074,149077,0,3,2
42609,1,3,149075,149077,149080,2,5,0
42610,6,2,149081,149081,149083,0,2,1
42611,2,3,149083,149083,149086,0,3,0
42612,2,2,149085,149086,149088,1,3,0
42613,4,3,149089,149089,149092,0,3,1
42614,1,1,149090,149092,149093,2,3,0
42615,3,1,149093,149093,149094,0,1,0
42616,5,3,149098,149098,149101,0,3,4
42617,3,1,149101,149101,149102,0,1,0
42618,6,1,149107,149107,149108,0,1,5
42619,1,2,149108,149108,149110,0,2,0
42620,1,3,149109,149110,149113,1,4,0
42621,6,2,149115,149115,149117,0,2,2
42622,1,2,149116,149117,149119,1,3,0
42623,4,3,149120,149120,149123,0,3,1
42624,6,3,149126,149126,149129,0,3,3
42625,5,3,149131,149131,149134,0,3,2
42626,6,3,149137,149137,149140,0,3,3
42627,4,2,149141,149141,149143,0,2,1
42628,4,2,149145,149145,149147,0,2,2
42629,4,1,149149,149149,149150,0,1,2
42630,6,1,149155,149155,149156,0,1,5
42631,3,2,149158,149158,149160,0,2,2
42632,3,2,149161,149161,149163,0,2,1
42633,3,2,149164,149164,149166,0,2,1
42634,1,1,149165,149166,149167,1,2,0
42635,5,1,149170,149170,149171,0,1,3
42636,6,2,149176,149176,149178,0,2,5
42637,3,3,149179,149179,149182,0,3,1
42638,4,1,149183,149183,149184,0,1,1
42639,5,3,149188,149188,149191,0,3,4
42640,1,3,149189,149191,149194,2,5,0
42641,4,3,149193,149194,149197,1,4,0
42642,3,3,149196,149197,149200,1,4,0
42643,1,3,149197,149200,149203,3,6,0
42644,4,1,149201,149203,149204,2,3,0
42645,5,2,149206,149206,149208,0,2,2
42646,4,3,149210,149210,149213,0,3,2
42647,3,1,149213,149213,149214,0,1,0
42648,6,3,149219,149219,149222,0,3,5
42649,4,3,149223,149223,149226,0,3,1
42650,3,3,149226,149226,149229,0,3,0
42651,6,1,149232,149232,149233,0,1,3
42652,5,1,149237,149237,149238,0,1,4
42653,4,1,149241,149241,149242,0,1,3
42654,4,1,149245,149245,149246,0,1,3
42655,3,3,149248,149248,149251,0,3,2
42656,5,1,149253,149253,149254,0,1,2
42657,2,1,149255,149255,149256,0,1,1
42658,4,1,149259,149259,149260,0,1,3
42659,3,3,149262,149262,149265,0,3,2
42660,4,3,149266,149266,149269,0,3,1
42661,3,1,149269,149269,149270,0,1,0
42662,5,2,149274,149274,149276,0,2,4
42663,1,3,149275,149276,149279,1,4,0
42664,5,3,149280,149280,149283,0,3,1
42665,3,2,149283,149283,149285,0,2,0
42666,5,2,149288,149288,149290,0,2,3
42667,3,1,149291,149291,149292,0,1,1
42668,3,3,149294,149294,149297,0,3,2
42669,3,2,149297,149297,149299,0,2,0
42670,5,1,149302,149302,149303,0,1,3
42671,1,2,149303,149303,149305,0,2,0
42672,3,2,149306,149306,149308,0,2,1
42673,4,3,149310,149310,149313,0,3,2
42674,1,1,149311,149313,149314,2,3,0
42675,3,1,149314,149314,149315,0,1,0
42676,2,1,149316,149316,149317,0,1,1
42677,2,3,149318,149318,149321,0,3,1
42678,1,3,149319,149321,149324,2,5,0
42679,6,2,149325,149325,149327,0,2,1
42680,6,1,149331,149331,149332,0,1,4
42681,3,3,149334,149334,149337,0,3,2
42682,6,2,149340,149340,149342,0,2,3
42683,4,1,149344,149344,149345,0,1,2
42684,3,1,149347,149347,149348,0,1,2
42685,6,3,149353,149353,149356,0,3,5
42686,1,3,149354,149356,149359,2,5,0
42687,5,3,149359,149359,149362,0,3,0
42688,3,1,149362,149362,149363,0,1,0
42689,2,3,149364,149364,149367,0,3,1
42690,5,2,149369,149369,149371,0,2,2
42691,1,3,149370,149371,149374,1,4,0
42692,4,3,149374,149374,149377,0,3,0
42693,6,1,149380,149380,149381,0,1,3
42694,2,3,149382,149382,149385,0,3,1
42695,6,3,149388,149388,149391,0,3,3
42696,3,2,149391,149391,149393,0,2,0
42697,2,1,149393,149393,149394,0,1,0
42698,6,2,149399,149399,149401,0,2,5
42699,2,2,149401,149401,149403,0,2,0
42700,2,3,149403,149403,149406,0,3,0
42701,4,2,149407,149407,149409,0,2,1
42702,3,1,149410,149410,149411,0,1,1
42703,5,1,149415,149415,149416,0,1,4
42704,6,1,149421,149421,149422,0,1,5
42705,3,2,149424,149424,149426,0,2,2
42706,3,1,149427,149427,149428,0,1,1
42707,4,2,149431,149431,149433,0,2,3
42708,1,1,149432,149433,149434,1,2,0
42709,2,2,149434,149434,149436,0,2,0
42710,2,1,149436,149436,149437,0,1,0
42711,6,1,149442,149442,149443,0,1,5
42712,5,1,149447,149447,149448,0,1,4
42713,2,2,149449,149449,149451,0,2,1
42714,5,1,149454,149454,149455,0,1,3
42715,5,1,149459,149459,149460,0,1,4
42716,6,2,149465,149465,149467,0,2,5
42717,6,3,149471,149471,149474,0,3,4
42718,1,3,149472,149474,149477,2,5,0
42719,5,1,149477,149477,149478,0,1,0
42720,3,2,149480,149480,149482,0,2,2
42721,1,2,149481,149482,149484,1,3,0
42722,4,2,149485,149485,149487,0,2,1
42723,5,1,149490,149490,149491,0,1,3
42724,5,2,149495,149495,149497,0,2,4
42725,4,3,149499,149499,149502,0,3,2
42726,4,1,149503,149503,149504,0,1,1
42727,4,3,149507,149507,149510,0,3,3
42728,3,1,149510,149510,149511,0,1,0
42729,5,2,149515,149515,149517,0,2,4
42730,5,3,149520,149520,149523,0,3,3
42731,6,2,149526,149526,149528,0,2,3
42732,3,2,149529,149529,149531,0,2,1
42733,6,2,149535,149535,149537,0,2,4
42734,4,2,149539,149539,149541,0,2,2
42735,3,1,149542,149542,149543,0,1,1
42736,3,2,149545,149545,149547,0,2,2
42737,5,2,149550,149550,149552,0,2,3
42738,4,2,149554,149554,149556,0,2,2
42739,6,3,149560,149560,149563,0,3,4
42740,6,1,149566,149566,149567,0,1,3
42741,4,2,149570,149570,149572,0,2,3
42742,2,1,149572,149572,149573,0,1,0
42743,5,3,149577,149577,149580,0,3,4
42744,5,1,149582,149582,149583,0,1,2
42745,2,2,149584,149584,149586,0,2,1
42746,1,3,149585,149586,149589,1,4,0
42747,1,3,149586,149589,149592,3,6,0
42748,6,2,149592,149592,149594,0,2,0
42749,2,1,149594,149594,149595,0,1,0
42750,2,1,149596,149596,149597,0,1,1
42751,2,3,149598,149598,149601,0,3,1
42752,6,2,149604,149604,149606,0,2,3
42753,1,3,149605,149606,149609,1,4,0
42754,3,2,149608,149609,149611,1,3,0
42755,3,3,149611,149611,149614,0,3,0
42756,3,1,149614,149614,149615,0,1,0
42757,3,1,149617,149617,149618,0,1,2
42758,1,2,149618,149618,149620,0,2,0
42759,1,2,149619,149620,149622,1,3,0
42760,5,3,149624,149624,149627,0,3,2
42761,4,1,149628,149628,149629,0,1,1
42762,1,1,149629,149629,149630,0,1,0
42763,2,3,149631,149631,149634,0,3,1
42764,5,3,149636,149636,149639,0,3,2
42765,3,2,149639,149639,149641,0,2,0
42766,3,1,149642,149642,149643,0,1,1
42767,2,2,149644,149644,149646,0,2,1
42768,2,3,149646,149646,149649,0,3,0
42769,6,2,149652,149652,149654,0,2,3
42770,6,2,149658,149658,149660,0,2,4
42771,5,3,149663,149663,149666,0,3,3
42772,5,1,149668,149668,149669,0,1,2
42773,5,2,149673,149673,149675,0,2,4
42774,5,3,149678,149678,149681,0,3,3
42775,1,3,149679,149681,149684,2,5,0
42776,1,2,149680,149684,149686,4,6,0
42777,6,2,149686,149686,149688,0,2,0
42778,3,1,149689,149689,149690,0,1,1
42779,2,2,149691,149691,149693,0,2,1
42780,2,1,149693,149693,149694,0,1,0
42781,1,2,149694,149694,149696,0,2,0
42782,2,2,149696,149696,149698,0,2,0
42783,5,1,149701,149701,149702,0,1,3
42784,4,2,149705,149705,149707,0,2,3
42785,3,2,149708,149708,149710,0,2,1
42786,2,1,149710,149710,149711,0,1,0
42787,5,2,149715,149715,149717,0,2,4
42788,3,3,149718,149718,149721,0,3,1
42789,5,3,149723,149723,149726,0,3,2
42790,3,2,149726,149726,149728,0,2,0
42791,1,1,149727,149728,149729,1,2,0
42792,2,1,149729,149729,149730,0,1,0
42793,1,2,149730,149730,149732,0,2,0
42794,2,3,149732,149732,149735,0,3,0
42795,2,1,149734,149735,149736,1,2,0
42796,3,1,149737,149737,149738,0,1,1
42797,5,2,149742,149742,149744,0,2,4
42798,1,3,149743,149744,149747,1,4,0
42799,5,2,149748,149748,149750,0,2,1
42800,2,3,149750,149750,149753,0,3,0
42801,6,3,149756,149756,149759,0,3,3
42802,2,3,149758,149759,149762,1,4,0
42803,1,3,149759,149762,149765,3,6,0
42804,3,2,149762,149765,149767,3,5,0
42805,3,1,149765,149767,149768,2,3,0
42806,1,3,149766,149768,149771,2,5,0
42807,1,2,149767,149771,149773,4,6,0
42808,2,3,149769,149773,149776,4,7,0
42809,6,3,149775,149776,149779,1,4,0
42810,3,1,149778,149779,149780,1,2,0
42811,3,1,149781,149781,149782,0,1,1
42812,6,3,149787,149787,149790,0,3,5
42813,5,3,149792,149792,149795,0,3,2
42814,3,2,149795,149795,149797,0,2,0
42815,6,2,149801,149801,149803,0,2,4
42816,2,2,149803,149803,149805,0,2,0
42817,6,1,149809,149809,149810,0,1,4
42818,6,3,149815,149815,149818,0,3,5
42819,5,3,149820,149820,149823,0,3,2
42820,2,1,149822,149823,149824,1,2,0
42821,6,1,149828,149828,149829,0,1,4
42822,6,1,149834,149834,149835,0,1,5
42823,4,3,149838,149838,149841,0,3,3
42824,1,1,149839,149841,149842,2,3,0
42825,1,2,149840,149842,149844,2,4,0
42826,1,3,149841,149844,149847,3,6,0
42827,6,2,149847,149847,149849,0,2,0
42828,5,3,149852,149852,149855,0,3,3
42829,1,1,149853,149855,149856,2,3,0
42830,2,2,149855,149856,149858,1,3,0
42831,1,1,149856,149858,149859,2,3,0
42832,5,3,149861,149861,149864,0,3,2
42833,6,3,149867,149867,149870,0,3,3
42834,4,2,149871,149871,149873,0,2,1
42835,4,1,149875,149875,149876,0,1,2
42836,1,1,149876,149876,149877,0,1,0
42837,5,3,149881,149881,149884,0,3,4
42838,3,1,149884,149884,149885,0,1,0
42839,5,1,149889,149889,149890,0,1,4
42840,2,3,149891,149891,149894,0,3,1
42841,1,3,149892,149894,149897,2,5,0
42842,2,1,149894,149897,149898,3,4,0
42843,5,3,149899,149899,149902,0,3,1
42844,3,3,149902,149902,149905,0,3,0
42845,5,1,149907,149907,149908,0,1,2
42846,2,1,149909,149909,149910,0,1,1
42847,6,1,149915,149915,149916,0,1,5
42848,5,2,149920,149920,149922,0,2,4
42849,3,3,149923,149923,149926,0,3,1
42850,5,2,149928,149928,149930,0,2,2
42851,6,1,149934,149934,149935,0,1,4
42852,4,3,149938,149938,149941,0,3,3
42853,2,1,149940,149941,149942,1,2,0
42854,1,3,149941,149942,149945,1,4,0
42855,5,2,149946,149946,149948,0,2,1
42856,1,3,149947,149948,149951,1,4,0
42857,6,2,149953,149953,149955,0,2,2
42858,2,3,149955,149955,149958,0,3,0
42859,1,2,149956,149958,149960,2,4,0
42860,3,1,149959,149960,149961,1,2,0
42861,4,3,149963,149963,149966,0,3,2
42862,2,3,149965,149966,149969,1,4,0
42863,2,1,149967,149969,149970,2,3,0
42864,6,3,149973,149973,149976,0,3,3
42865,4,3,149977,149977,149980,0,3,1
42866,5,2,149982,149982,149984,0,2,2
42867,5,3,149987,149987,149990,0,3,3
42868,5,1,149992,149992,149993,0,1,2
42869,4,3,149996,149996,149999,0,3,3
42870,5,1,150001,150001,150002,0,1,2
42871,3,2,150004,150004,150006,0,2,2
42872,1,3,150005,150006,150009,1,4,0
42873,2,2,150007,150009,150011,2,4,0
42874,3,3,150010,150011,150014,1,4,0
42875,4,1,150014,150014,150015,0,1,0
42876,1,3,150015,150015,150018,0,3,0
42877,2,1,150017,150018,150019,1,2,0
42878,6,3,150023,150023,150026,0,3,4
42879,1,1,150024,150026,150027,2,3,0
42880,6,3,150030,150030,150033,0,3,3
42881,2,2,150032,150033,150035,1,3,0
42882,3,1,150035,150035,150036,0,1,0
42883,3,3,150038,150038,150041,0,3,2
42884,3,2,150041,150041,150043,0,2,0
42885,6,1,150047,150047,150048,0,1,4
42886,4,1,150051,150051,150052,0,1,3
42887,4,2,150055,150055,150057,0,2,3
42888,1,3,150056,150057,150060,1,4,0
42889,3,2,150059,150060,150062,1,3,0
42890,3,1,150062,150062,150063,0,1,0
42891,1,3,150063,150063,150066,0,3,0
42892,2,3,150065,150066,150069,1,4,0
42893,1,1,150066,150069,150070,3,4,0
42894,5,1,150071,150071,150072,0,1,1
42895,6,2,150077,150077,150079,0,2,5
42896,4,1,150081,150081,150082,0,1,2
42897,3,3,150084,150084,150087,0,3,2
42898,2,2,150086,150087,150089,1,3,0
42899,4,1,150090,150090,150091,0,1,1
42900,1,2,150091,150091,150093,0,2,0
42901,5,2,150096,150096,150098,0,2,3
42902,3,1,150099,150099,150100,0,1,1
42903,4,3,150103,150103,150106,0,3,3
42904,5,3,150108,150108,150111,0,3,2
42905,6,3,150114,150114,150117,0,3,3
42906,5,1,150119,150119,150120,0,1,2
42907,2,1,150121,150121,150122,0,1,1
42908,6,2,150127,150127,150129,0,2,5
42909,5,3,150132,150132,150135,0,3,3
42910,5,1,150137,150137,150138,0,1,2
42911,6,3,150143,150143,150146,0,3,5
42912,1,3,150144,150146,150149,2,5,0
42913,6,3,150150,150150,150153,0,3,1
42914,6,1,150156,150156,150157,0,1,3
42915,1,1,150157,150157,150158,0,1,0
42916,5,3,150162,150162,150165,0,3,4
42917,6,2,150168,150168,150170,0,2,3
42918,5,2,150173,150173,150175,0,2,3
42919,6,3,150179,150179,150182,0,3,4
42920,2,2,150181,150182,150184,1,3,0
42921,1,2,150182,150184,150186,2,4,0
42922,6,1,150188,150188,150189,0,1,2
42923,3,3,150191,150191,150194,0,3,2
42924,3,2,150194,150194,150196,0,2,0
42925,1,1,150195,150196,150197,1,2,0
42926,1,2,150196,150197,150199,1,3,0
42927,1,2,150197,150199,150201,2,4,0
42928,4,1,150201,150201,150202,0,1,0
42929,1,2,150202,150202,150204,0,2,0
42930,1,3,150203,150204,150207,1,4,0
42931,6,2,150209,150209,150211,0,2,2
42932,6,3,150215,150215,150218,0,3,4
42933,4,3,150219,150219,150222,0,3,1
42934,5,3,150224,150224,150227,0,3,2
42935,4,1,150228,150228,150229,0,1,1
42936,4,1,150232,150232,150233,0,1,3
42937,4,3,150236,150236,150239,0,3,3
42938,1,2,150237,150239,150241,2,4,0
42939,1,3,150238,150241,150244,3,6,0
42940,6,1,150244,150244,150245,0,1,0
42941,6,3,150250,150250,150253,0,3,5
42942,1,3,150251,150253,150256,2,5,0
42943,2,3,150253,150256,150259,3,6,0
42944,6,1,150259,150259,150260,0,1,0
42945,5,1,150264,150264,150265,0,1,4
42946,1,1,150265,150265,150266,0,1,0
42947,2,3,150267,150267,150270,0,3,1
42948,6,3,150273,150273,150276,0,3,3
42949,2,3,150275,150276,150279,1,4,0
42950,6,3,150281,150281,150284,0,3,2
42951,1,2,150282,150284,150286,2,4,0
42952,4,3,150286,150286,150289,0,3,0
42953,1,3,150287,150289,150292,2,5,0
42954,2,2,150289,150292,150294,3,5,0
42955,5,1,150294,150294,150295,0,1,0
42956,3,3,150297,150297,150300,0,3,2
42957,4,3,150301,150301,150304,0,3,1
42958,1,1,150302,150304,150305,2,3,0
42959,2,3,150304,150305,150308,1,4,0
42960,1,3,150305,150308,150311,3,6,0
42961,5,2,150310,150311,150313,1,3,0
42962,6,3,150316,150316,150319,0,3,3
42963,5,2,150321,150321,150323,0,2,2
42964,6,3,150327,150327,150330,0,3,4
42965,5,2,150332,150332,150334,0,2,2
42966,2,1,150334,150334,150335,0,1,0
42967,5,1,150339,150339,150340,0,1,4
42968,5,3,150344,150344,150347,0,3,4
42969,3,2,150347,150347,150349,0,2,0
42970,1,2,150348,150349,150351,1,3,0
42971,3,2,150351,150351,150353,0,2,0
42972,3,3,150354,150354,150357,0,3,1
42973,6,1,150360,150360,150361,0,1,3
42974,3,2,150363,150363,150365,0,2,2
42975,2,3,150365,150365,150368,0,3,0
42976,1,1,150366,150368,150369,2,3,0
42977,3,2,150369,150369,150371,0,2,0
42978,3,2,150372,150372,150374,0,2,1
42979,4,3,150376,150376,150379,0,3,2
42980,1,3,150377,150379,150382,2,5,0
42981,2,3,150379,150382,150385,3,6,0
42982,6,1,150385,150385,150386,0,1,0
42983,4,2,150389,150389,150391,0,2,3
42984,1,2,150390,150391,150393,1,3,0
42985,1,2,150391,150393,150395,2,4,0
42986,2,2,150393,150395,150397,2,4,0
42987,6,2,150399,150399,150401,0,2,2
42988,2,3,150401,150401,150404,0,3,0
42989,6,2,150407,150407,150409,0,2,3
42990,3,1,150410,150410,150411,0,1,1
42991,2,1,150412,150412,150413,0,1,1
42992,1,2,150413,150413,150415,0,2,0
42993,5,3,150418,150418,150421,0,3,3
42994,6,3,150424,150424,150427,0,3,3
42995,4,3,150428,150428,150431,0,3,1
42996,3,3,150431,150431,150434,0,3,0
42997,6,3,150437,150437,150440,0,3,3
42998,4,2,150441,150441,150443,0,2,1
42999,4,2,150445,150445,150447,0,2,2
43000,5,1,150450,150450,150451,0,1,3
43001,6,2,150456,150456,150458,0,2,5
43002,1,1,150457,150458,150459,1,2,0
43003,4,1,150461,150461,150462,0,1,2
43004,2,2,150463,150463,150465,0,2,1
43005,2,1,150465,150465,150466,0,1,0
43006,4,2,150469,150469,150471,0,2,3
43007,4,2,150473,150473,150475,0,2,2
43008,5,3,150478,150478,150481,0,3,3
43009,4,1,150482,150482,150483,0,1,1
43010,1,3,150483,150483,150486,0,3,0
43011,5,1,150488,150488,150489,0,1,2
43012,1,3,150489,150489,150492,0,3,0
43013,3,3,150492,150492,150495,0,3,0
43014,3,3,150495,150495,150498,0,3,0
43015,2,3,150497,150498,150501,1,4,0
43016,2,2,150499,150501,150503,2,4,0
43017,4,2,150503,150503,150505,0,2,0
43018,1,2,150504,150505,150507,1,3,0
43019,6,1,150510,150510,150511,0,1,3
43020,2,1,150512,150512,150513,0,1,1
43021,1,1,150513,150513,150514,0,1,0
43022,2,2,150515,150515,150517,0,2,1
43023,5,3,150520,150520,150523,0,3,3
43024,5,3,150525,150525,150528,0,3,2
43025,4,3,150529,150529,150532,0,3,1
43026,5,1,150534,150534,150535,0,1,2
43027,4,3,150538,150538,150541,0,3,3
43028,3,3,150541,150541,150544,0,3,0
43029,1,3,150542,150544,150547,2,5,0
43030,1,3,150543,150547,150550,4,7,0
43031,1,3,150544,150550,150553,6,9,0
43032,4,1,150548,150553,150554,5,6,0
43033,1,1,150549,150554,150555,5,6,0
43034,1,2,150550,150555,150557,5,7,0
43035,4,2,150554,150557,150559,3,5,0
43036,6,1,150560,150560,150561,0,1,1
43037,1,3,150561,150561,150564,0,3,0
43038,1,2,150562,150564,150566,2,4,0
43039,2,2,150564,150566,150568,2,4,0
43040,2,2,150566,150568,150570,2,4,0
43041,5,1,150571,150571,150572,0,1,1
43042,4,1,150575,150575,150576,0,1,3
43043,3,2,150578,150578,150580,0,2,2
43044,6,3,150584,150584,150587,0,3,4
43045,1,3,150585,150587,150590,2,5,0
43046,1,3,150586,150590,150593,4,7,0
43047,3,3,150589,150593,150596,4,7,0
43048,4,3,150593,150596,150599,3,6,0
43049,6,3,150599,150599,150602,0,3,0
43050,1,2,150600,150602,150604,2,4,0
43051,5,2,150605,150605,150607,0,2,1
43052,6,1,150611,150611,150612,0,1,4
43053,2,1,150613,150613,150614,0,1,1
43054,2,3,150615,150615,150618,0,3,1
43055,3,2,150618,150618,150620,0,2,0
43056,1,3,150619,150620,150623,1,4,0
43057,3,1,150622,150623,150624,1,2,0
43058,2,3,150624,150624,150627,0,3,0
43059,3,3,150627,150627,150630,0,3,0
43060,3,1,150630,150630,150631,0,1,0
43061,5,3,150635,150635,150638,0,3,4
43062,5,1,150640,150640,150641,0,1,2
43063,2,2,150642,150642,150644,0,2,1
43064,4,3,150646,150646,150649,0,3,2
43065,5,2,150651,150651,150653,0,2,2
43066,6,1,150657,150657,150658,0,1,4
43067,1,1,150658,150658,150659,0,1,0
43068,5,2,150663,150663,150665,0,2,4
43069,4,1,150667,150667,150668,0,1,2
43070,6,2,150673,150673,150675,0,2,5
43071,5,1,150678,150678,150679,0,1,3
43072,1,3,150679,150679,150682,0,3,0
43073,5,1,150684,150684,150685,0,1,2
43074,1,3,150685,150685,150688,0,3,0
43075,5,1,150690,150690,150691,0,1,2
43076,6,2,150696,150696,150698,0,2,5
43077,3,2,150699,150699,150701,0,2,1
43078,2,3,150701,150701,150704,0,3,0
43079,2,2,150703,150704,150706,1,3,0
43080,1,2,150704,150706,150708,2,4,0
43081,3,3,150707,150708,150711,1,4,0
43082,2,1,150709,150711,150712,2,3,0
43083,4,2,150713,150713,150715,0,2,1
43084,5,2,150718,150718,150720,0,2,3
43085,1,2,150719,150720,150722,1,3,0
43086,6,2,150725,150725,150727,0,2,3
43087,1,1,150726,150727,150728,1,2,0
43088,2,1,150728,150728,150729,0,1,0
43089,3,2,150731,150731,150733,0,2,2
43090,1,2,150732,150733,150735,1,3,0
43091,3,2,150735,150735,150737,0,2,0
43092,5,3,150740,150740,150743,0,3,3
43093,4,1,150744,150744,150745,0,1,1
43094,2,1,150746,150746,150747,0,1,1
43095,4,3,150750,150750,150753,0,3,3
43096,2,2,150752,150753,150755,1,3,0
43097,6,1,150758,150758,150759,0,1,3
43098,6,2,150764,150764,150766,0,2,5
43099,3,1,150767,150767,150768,0,1,1
43100,6,2,150773,150773,150775,0,2,5
43101,5,1,150778,150778,150779,0,1,3
43102,1,1,150779,150779,150780,0,1,0
43103,4,1,150783,150783,150784,0,1,3
43104,6,3,150789,150789,150792,0,3,5
43105,3,2,150792,150792,150794,0,2,0
43106,5,2,150797,150797,150799,0,2,3
43107,4,2,150801,150801,150803,0,2,2
43108,6,3,150807,150807,150810,0,3,4
43109,4,2,150811,150811,150813,0,2,1
43110,3,2,150814,150814,150816,0,2,1
43111,2,2,150816,150816,150818,0,2,0
43112,1,2,150817,150818,150820,1,3,0
43113,6,2,150823,150823,150825,0,2,3
43114,1,2,150824,150825,150827,1,3,0
43115,5,2,150829,150829,150831,0,2,2
43116,1,3,150830,150831,150834,1,4,0
43117,2,3,150832,150834,150837,2,5,0
43118,6,3,150838,150838,150841,0,3,1
43119,4,3,150842,150842,150845,0,3,1
43120,6,2,150848,150848,150850,0,2,3
43121,1,2,150849,150850,150852,1,3,0
43122,3,1,150852,150852,150853,0,1,0
43123,4,1,150856,150856,150857,0,1,3
43124,3,2,150859,150859,150861,0,2,2
43125,1,3,150860,150861,150864,1,4,0
43126,2,2,150862,150864,150866,2,4,0
43127,6,2,150868,150868,150870,0,2,2
43128,4,1,150872,150872,150873,0,1,2
43129,2,1,150874,150874,150875,0,1,1
43130,2,3,150876,150876,150879,0,3,1
43131,3,1,150879,150879,150880,0,1,0
43132,3,2,150882,150882,150884,0,2,2
43133,6,1,150888,150888,150889,0,1,4
43134,3,2,150891,150891,150893,0,2,2
43135,4,1,150895,150895,150896,0,1,2
43136,1,1,150896,150896,150897,0,1,0
43137,4,2,150900,150900,150902,0,2,3
43138,6,1,150906,150906,150907,0,1,4
43139,6,1,150912,150912,150913,0,1,5
43140,6,2,150918,150918,150920,0,2,5
43141,6,2,150924,150924,150926,0,2,4
43142,5,2,150929,150929,150931,0,2,3
43143,1,1,150930,150931,150932,1,2,0
43144,6,2,150936,150936,150938,0,2,4
43145,2,2,150938,150938,150940,0,2,0
43146,4,1,150942,150942,150943,0,1,2
43147,2,1,150944,150944,150945,0,1,1
43148,4,3,150948,150948,150951,0,3,3
43149,5,3,150953,150953,150956,0,3,2
43150,3,3,150956,150956,150959,0,3,0
43151,6,1,150962,150962,150963,0,1,3
43152,1,2,150963,150963,150965,0,2,0
43153,1,1,150964,150965,150966,1,2,0
43154,2,1,150966,150966,150967,0,1,0
43155,6,3,150972,150972,150975,0,3,5
43156,6,2,150978,150978,150980,0,2,3
43157,5,2,150983,150983,150985,0,2,3
43158,2,2,150985,150985,150987,0,2,0
43159,3,2,150988,150988,150990,0,2,1
43160,1,2,150989,150990,150992,1,3,0
43161,4,1,150993,150993,150994,0,1,1
43162,1,3,150994,150994,150997,0,3,0
43163,4,1,150998,150998,150999,0,1,1
43164,3,3,151001,151001,151004,0,3,2
43165,1,3,151002,151004,151007,2,5,0
43166,1,2,151003,151007,151009,4,6,0
43167,4,1,151007,151009,151010,2,3,0
43168,2,1,151009,151010,151011,1,2,0
43169,4,1,151013,151013,151014,0,1,2
43170,3,1,151016,151016,151017,0,1,2
43171,4,1,151020,151020,151021,0,1,3
43172,1,1,151021,151021,151022,0,1,0
43173,3,1,151024,151024,151025,0,1,2
43174,5,3,151029,151029,151032,0,3,4
43175,6,2,151035,151035,151037,0,2,3
43176,5,3,151040,151040,151043,0,3,3
43177,4,1,151044,151044,151045,0,1,1
43178,6,2,151050,151050,151052,0,2,5
43179,3,2,151053,151053,151055,0,2,1
43180,6,3,151059,151059,151062,0,3,4
43181,4,3,151063,151063,151066,0,3,1
43182,1,2,151064,151066,151068,2,4,0
43183,3,1,151067,151068,151069,1,2,0
43184,2,2,151069,151069,151071,0,2,0
43185,1,2,151070,151071,151073,1,3,0
43186,3,2,151073,151073,151075,0,2,0
43187,3,3,151076,151076,151079,0,3,1
43188,4,2,151080,151080,151082,0,2,1
43189,4,1,151084,151084,151085,0,1,2
43190,6,1,151090,151090,151091,0,1,5
43191,4,1,151094,151094,151095,0,1,3
43192,2,2,151096,151096,151098,0,2,1
43193,1,1,151097,151098,151099,1,2,0
43194,2,2,151099,151099,151101,0,2,0
43195,2,3,151101,151101,151104,0,3,0
43196,3,3,151104,151104,151107,0,3,0
43197,2,3,151106,151107,151110,1,4,0
43198,2,2,151108,151110,151112,2,4,0
43199,4,1,151112,151112,151113,0,1,0
43200,5,3,151117,151117,151120,0,3,4
43201,5,1,151122,151122,151123,0,1,2
43202,1,2,151123,151123,151125,0,2,0
43203,3,1,151126,151126,151127,0,1,1
43204,4,1,151130,151130,151131,0,1,3
43205,1,2,151131,151131,151133,0,2,0
43206,4,3,151135,151135,151138,0,3,2
43207,1,1,151136,151138,151139,2,3,0
43208,1,2,151137,151139,151141,2,4,0
43209,3,2,151140,151141,151143,1,3,0
43210,3,1,151143,151143,151144,0,1,0
43211,3,3,151146,151146,151149,0,3,2
43212,4,2,151150,151150,151152,0,2,1
43213,2,3,151152,151152,151155,0,3,0
43214,1,2,151153,151155,151157,2,4,0
43215,3,2,151156,151157,151159,1,3,0
43216,2,1,151158,151159,151160,1,2,0
43217,1,1,151159,151160,151161,1,2,0
43218,1,2,151160,151161,151163,1,3,0
43219,6,2,151166,151166,151168,0,2,3
43220,1,3,151167,151168,151171,1,4,0
43221,5,2,151172,151172,151174,0,2,1
43222,4,1,151176,151176,151177,0,1,2
43223,1,3,151177,151177,151180,0,3,0
43224,2,1,151179,151180,151181,1,2,0
43225,6,2,151185,151185,151187,0,2,4
43226,4,3,151189,151189,151192,0,3,2
43227,4,1,151193,151193,151194,0,1,1
43228,5,3,151198,151198,151201,0,3,4
43229,5,1,151203,151203,151204,0,1,2
43230,6,1,151209,151209,151210,0,1,5
43231,2,3,151211,151211,151214,0,3,1
43232,5,1,151216,151216,151217,0,1,2
43233,3,2,151219,151219,151221,0,2,2
43234,6,1,151225,151225,151226,0,1,4
43235,1,1,151226,151226,151227,0,1,0
43236,5,1,151231,151231,151232,0,1,4
43237,3,3,151234,151234,151237,0,3,2
43238,4,1,151238,151238,151239,0,1,1
43239,3,2,151241,151241,151243,0,2,2
43240,4,2,151245,151245,151247,0,2,2
43241,4,2,151249,151249,151251,0,2,2
43242,4,1,151253,151253,151254,0,1,2
43243,6,2,151259,151259,151261,0,2,5
43244,6,3,151265,151265,151268,0,3,4
43245,5,1,151270,151270,151271,0,1,2
43246,5,2,151275,151275,151277,0,2,4
43247,3,1,151278,151278,151279,0,1,1
43248,5,2,151283,151283,151285,0,2,4
43249,4,2,151287,151287,151289,0,2,2
43250,5,1,151292,151292,151293,0,1,3
43251,2,3,151294,151294,151297,0,3,1
43252,4,3,151298,151298,151301,0,3,1
43253,4,2,151302,151302,151304,0,2,1
43254,4,3,151306,151306,151309,0,3,2
43255,4,3,151310,151310,151313,0,3,1
43256,1,3,151311,151313,151316,2,5,0
43257,3,1,151314,151316,151317,2,3,0
43258,5,1,151319,151319,151320,0,1,2
43259,4,1,151323,151323,151324,0,1,3
43260,2,3,151325,151325,151328,0,3,1
43261,5,2,151330,151330,151332,0,2,2
43262,5,2,151335,151335,151337,0,2,3
43263,1,3,151336,151337,151340,1,4,0
43264,5,1,151341,151341,151342,0,1,1
43265,4,1,151345,151345,151346,0,1,3
43266,6,2,151351,151351,151353,0,2,5
43267,4,3,151355,151355,151358,0,3,2
43268,1,2,151356,151358,151360,2,4,0
43269,5,1,151361,151361,151362,0,1,1
43270,3,1,151364,151364,151365,0,1,2
43271,5,3,151369,151369,151372,0,3,4
43272,6,2,151375,151375,151377,0,2,3
43273,6,3,151381,151381,151384,0,3,4
43274,4,1,151385,151385,151386,0,1,1
43275,4,1,151389,151389,151390,0,1,3
43276,6,1,151395,151395,151396,0,1,5
43277,2,3,151397,151397,151400,0,3,1
43278,2,3,151399,151400,151403,1,4,0
43279,5,3,151404,151404,151407,0,3,1
43280,1,2,151405,151407,151409,2,4,0
43281,4,3,151409,151409,151412,0,3,0
43282,2,1,151411,151412,151413,1,2,0
43283,1,1,151412,151413,151414,1,2,0
43284,2,3,151414,151414,151417,0,3,0
43285,6,2,151420,151420,151422,0,2,3
43286,5,1,151425,151425,151426,0,1,3
43287,4,1,151429,151429,151430,0,1,3
43288,5,1,151434,151434,151435,0,1,4
43289,5,3,151439,151439,151442,0,3,4
43290,6,3,151445,151445,151448,0,3,3
43291,3,2,151448,151448,151450,0,2,0
43292,3,3,151451,151451,151454,0,3,1
43293,2,3,151453,151454,151457,1,4,0
43294,6,2,151459,151459,151461,0,2,2
43295,4,2,151463,151463,151465,0,2,2
43296,2,2,151465,151465,151467,0,2,0
43297,2,2,151467,151467,151469,0,2,0
43298,1,3,151468,151469,151472,1,4,0
43299,1,1,151469,151472,151473,3,4,0
43300,4,1,151473,151473,151474,0,1,0
43301,6,2,151479,151479,151481,0,2,5
43302,2,3,151481,151481,151484,0,3,0
43303,5,3,151486,151486,151489,0,3,2
43304,3,1,151489,151489,151490,0,1,0
43305,5,1,151494,151494,151495,0,1,4
43306,1,3,151495,151495,151498,0,3,0
43307,3,3,151498,151498,151501,0,3,0
43308,5,3,151503,151503,151506,0,3,2
43309,1,1,151504,151506,151507,2,3,0
43310,5,1,151509,151509,151510,0,1,2
43311,3,3,151512,151512,151515,0,3,2
43312,2,3,151514,151515,151518,1,4,0
43313,1,1,151515,151518,151519,3,4,0
43314,5,3,151520,151520,151523,0,3,1
43315,6,3,151526,151526,151529,0,3,3
43316,5,1,151531,151531,151532,0,1,2
43317,2,1,151533,151533,151534,0,1,1
43318,4,2,151537,151537,151539,0,2,3
43319,2,2,151539,151539,151541,0,2,0
43320,3,3,151542,151542,151545,0,3,1
43321,5,2,151547,151547,151549,0,2,2
43322,3,1,151550,151550,151551,0,1,1
43323,5,2,151555,151555,151557,0,2,4
43324,5,1,151560,151560,151561,0,1,3
43325,1,2,151561,151561,151563,0,2,0
43326,1,1,151562,151563,151564,1,2,0
43327,4,1,151566,151566,151567,0,1,2
43328,5,1,151571,151571,151572,0,1,4
43329,4,2,151575,151575,151577,0,2,3
43330,1,3,151576,151577,151580,1,4,0
43331,1,2,151577,151580,151582,3,5,0
43332,1,3,151578,151582,151585,4,7,0
43333,5,2,151583,151585,151587,2,4,0
43334,1,2,151584,151587,151589,3,5,0
43335,6,3,151590,151590,151593,0,3,1
43336,6,3,151596,151596,151599,0,3,3
43337,5,2,151601,151601,151603,0,2,2
43338,2,2,151603,151603,151605,0,2,0
43339,6,3,151609,151609,151612,0,3,4
43340,4,2,151613,151613,151615,0,2,1
43341,1,3,151614,151615,151618,1,4,0
43342,4,3,151618,151618,151621,0,3,0
43343,4,1,151622,151622,151623,0,1,1
43344,1,1,151623,151623,151624,0,1,0
43345,6,3,151629,151629,151632,0,3,5
43346,2,2,151631,151632,151634,1,3,0
43347,1,3,151632,151634,151637,2,5,0
43348,3,1,151635,151637,151638,2,3,0
43349,2,3,151637,151638,151641,1,4,0
43350,4,1,151641,151641,151642,0,1,0
43351,4,2,151645,151645,151647,0,2,3
43352,6,1,151651,151651,151652,0,1,4
43353,1,2,151652,151652,151654,0,2,0
43354,4,2,151656,151656,151658,0,2,2
43355,5,2,151661,151661,151663,0,2,3
43356,5,2,151666,151666,151668,0,2,3
43357,3,1,151669,151669,151670,0,1,1
43358,6,2,151675,151675,151677,0,2,5
43359,1,1,151676,151677,151678,1,2,0
43360,4,1,151680,151680,151681,0,1,2
43361,5,1,151685,151685,151686,0,1,4
43362,4,2,151689,151689,151691,0,2,3
43363,3,2,151692,151692,151694,0,2,1
43364,4,3,151696,151696,151699,0,3,2
43365,4,3,151700,151700,151703,0,3,1
43366,6,3,151706,151706,151709,0,3,3
43367,4,2,151710,151710,151712,0,2,1
43368,2,3,151712,151712,151715,0,3,0
43369,6,2,151718,151718,151720,0,2,3
43370,1,3,151719,151720,151723,1,4,0
43371,1,2,151720,151723,151725,3,5,0
43372,6,2,151726,151726,151728,0,2,1
43373,1,3,151727,151728,151731,1,4,0
43374,4,1,151731,151731,151732,0,1,0
43375,5,1,151736,151736,151737,0,1,4
43376,1,2,151737,151737,151739,0,2,0
43377,5,2,151742,151742,151744,0,2,3
43378,3,3,151745,151745,151748,0,3,1
43379,5,1,151750,151750,151751,0,1,2
43380,5,3,151755,151755,151758,0,3,4
43381,6,2,151761,151761,151763,0,2,3
43382,4,1,151765,151765,151766,0,1,2
43383,3,1,151768,151768,151769,0,1,2
43384,1,2,151769,151769,151771,0,2,0
43385,2,2,151771,151771,151773,0,2,0
43386,6,3,151777,151777,151780,0,3,4
43387,5,2,151782,151782,151784,0,2,2
43388,3,1,151785,151785,151786,0,1,1
43389,4,3,151789,151789,151792,0,3,3
43390,4,2,151793,151793,151795,0,2,1
43391,2,2,151795,151795,151797,0,2,0
43392,6,3,151801,151801,151804,0,3,4
43393,1,1,151802,151804,151805,2,3,0
43394,4,1,151806,151806,151807,0,1,1
43395,6,1,151812,151812,151813,0,1,5
43396,5,2,151817,151817,151819,0,2,4
43397,4,3,151821,151821,151824,0,3,2
43398,4,1,151825,151825,151826,0,1,1
43399,6,1,151831,151831,151832,0,1,5
43400,3,2,151834,151834,151836,0,2,2
43401,2,3,151836,151836,151839,0,3,0
43402,6,1,151842,151842,151843,0,1,3
43403,2,2,151844,151844,151846,0,2,1
43404,1,2,151845,151846,151848,1,3,0
43405,2,2,151847,151848,151850,1,3,0
43406,4,1,151851,151851,151852,0,1,1
43407,5,2,151856,151856,151858,0,2,4
43408,2,3,151858,151858,151861,0,3,0
43409,4,2,151862,151862,151864,0,2,1
43410,5,2,151867,151867,151869,0,2,3
43411,2,1,151869,151869,151870,0,1,0
43412,4,3,151873,151873,151876,0,3,3
43413,3,1,151876,151876,151877,0,1,0
43414,6,1,151882,151882,151883,0,1,5
43415,3,1,151885,151885,151886,0,1,2
43416,5,3,151890,151890,151893,0,3,4
43417,1,3,151891,151893,151896,2,5,0
43418,2,3,151893,151896,151899,3,6,0
43419,6,2,151899,151899,151901,0,2,0
43420,4,2,151903,151903,151905,0,2,2
43421,5,3,151908,151908,151911,0,3,3
43422,1,3,151909,151911,151914,2,5,0
43423,5,1,151914,151914,151915,0,1,0
43424,6,3,151920,151920,151923,0,3,5
43425,5,1,151925,151925,151926,0,1,2
43426,3,2,151928,151928,151930,0,2,2
43427,6,2,151934,151934,151936,0,2,4
43428,1,1,151935,151936,151937,1,2,0
43429,5,2,151940,151940,151942,0,2,3
43430,1,3,151941,151942,151945,1,4,0
43431,4,1,151945,151945,151946,0,1,0
43432,4,3,151949,151949,151952,0,3,3
43433,6,1,151955,151955,151956,0,1,3
43434,6,3,151961,151961,151964,0,3,5
43435,5,1,151966,151966,151967,0,1,2
43436,2,3,151968,151968,151971,0,3,1
43437,2,3,151970,151971,151974,1,4,0
43438,4,2,151974,151974,151976,0,2,0
43439,5,2,151979,151979,151981,0,2,3
43440,3,3,151982,151982,151985,0,3,1
43441,2,1,151984,151985,151986,1,2,0
43442,4,2,151988,151988,151990,0,2,2
43443,3,3,151991,151991,151994,0,3,1
43444,2,2,151993,151994,151996,1,3,0
43445,2,3,151995,151996,151999,1,4,0
43446,6,1,152001,152001,152002,0,1,2
43447,4,3,152005,152005,152008,0,3,3
43448,1,2,152006,152008,152010,2,4,0
43449,2,3,152008,152010,152013,2,5,0
43450,6,1,152014,152014,152015,0,1,1
43451,1,3,152015,152015,152018,0,3,0
43452,5,3,152020,152020,152023,0,3,2
43453,3,2,152023,152023,152025,0,2,0
43454,2,1,152025,152025,152026,0,1,0
43455,5,1,152030,152030,152031,0,1,4
43456,4,2,152034,152034,152036,0,2,3
43457,2,1,152036,152036,152037,0,1,0
43458,6,3,152042,152042,152045,0,3,5
43459,3,3,152045,152045,152048,0,3,0
43460,1,3,152046,152048,152051,2,5,0
43461,2,3,152048,152051,152054,3,6,0
43462,2,3,152050,152054,152057,4,7,0
43463,1,3,152051,152057,152060,6,9,0
43464,2,1,152053,152060,152061,7,8,0
43465,3,1,152056,152061,152062,5,6,0
43466,2,1,152058,152062,152063,4,5,0
43467,2,2,152060,152063,152065,3,5,0
43468,3,2,152063,152065,152067,2,4,0
43469,6,2,152069,152069,152071,0,2,2
43470,5,1,152074,152074,152075,0,1,3
43471,6,2,152080,152080,152082,0,2,5
43472,1,1,152081,152082,152083,1,2,0
43473,2,3,152083,152083,152086,0,3,0
43474,5,3,152088,152088,152091,0,3,2
43475,3,3,152091,152091,152094,0,3,0
43476,4,1,152095,152095,152096,0,1,1
43477,6,3,152101,152101,152104,0,3,5
43478,6,3,152107,152107,152110,0,3,3
43479,5,1,152112,152112,152113,0,1,2
43480,2,2,152114,152114,152116,0,2,1
43481,5,3,152119,152119,152122,0,3,3
43482,1,2,152120,152122,152124,2,4,0
43483,5,2,152125,152125,152127,0,2,1
43484,5,1,152130,152130,152131,0,1,3
43485,6,3,152136,152136,152139,0,3,5
43486,1,2,152137,152139,152141,2,4,0
43487,2,1,152139,152141,152142,2,3,0
43488,5,3,152144,152144,152147,0,3,2
43489,5,1,152149,152149,152150,0,1,2
43490,5,3,152154,152154,152157,0,3,4
43491,4,3,152158,152158,152161,0,3,1
43492,4,3,152162,152162,152165,0,3,1
43493,2,2,152164,152165,152167,1,3,0
43494,1,2,152165,152167,152169,2,4,0
43495,5,3,152170,152170,152173,0,3,1
43496,1,2,152171,152173,152175,2,4,0
43497,1,3,152172,152175,152178,3,6,0
43498,1,3,152173,152178,152181,5,8,0
43499,1,1,152174,152181,152182,7,8,0
43500,5,1,152179,152182,152183,3,4,0
43501,2,2,152181,152183,152185,2,4,0
43502,1,1,152182,152185,152186,3,4,0
43503,6,1,152188,152188,152189,0,1,2
43504,6,2,152194,152194,152196,0,2,5
43505,1,1,152195,152196,152197,1,2,0
43506,3,2,152198,152198,152200,0,2,1
43507,5,3,152203,152203,152206,0,3,3
43508,5,2,152208,152208,152210,0,2,2
43509,5,1,152213,152213,152214,0,1,3
43510,5,1,152218,152218,152219,0,1,4
43511,6,1,152224,152224,152225,0,1,5
43512,5,2,152229,152229,152231,0,2,4
43513,3,1,152232,152232,152233,0,1,1
43514,6,1,152238,152238,152239,0,1,5
43515,5,1,152243,152243,152244,0,1,4
43516,6,2,152249,152249,152251,0,2,5
43517,1,1,152250,152251,152252,1,2,0
43518,3,2,152253,152253,152255,0,2,1
43519,4,1,152257,152257,152258,0,1,2
43520,4,1,152261,152261,152262,0,1,3
43521,5,3,152266,152266,152269,0,3,4
43522,1,1,152267,152269,152270,2,3,0
43523,4,2,152271,152271,152273,0,2,1
43524,5,2,152276,152276,152278,0,2,3
43525,2,3,152278,152278,152281,0,3,0
43526,3,2,152281,152281,152283,0,2,0
43527,2,3,152283,152283,152286,0,3,0
43528,6,1,152289,152289,152290,0,1,3
43529,2,2,152291,152291,152293,0,2,1
43530,5,3,152296,152296,152299,0,3,3
43531,2,3,152298,152299,152302,1,4,0
43532,5,3,152303,152303,152306,0,3,1
43533,6,1,152309,152309,152310,0,1,3
43534,1,3,152310,152310,152313,0,3,0
43535,1,3,152311,152313,152316,2,5,0
43536,2,2,152313,152316,152318,3,5,0
43537,6,3,152319,152319,152322,0,3,1
43538,4,1,152323,152323,152324,0,1,1
43539,5,1,152328,152328,152329,0,1,4
43540,2,3,152330,152330,152333,0,3,1
43541,2,2,152332,152333,152335,1,3,0
43542,1,2,152333,152335,152337,2,4,0
43543,2,1,152335,152337,152338,2,3,0
43544,1,1,152336,152338,152339,2,3,0
43545,1,3,152337,152339,152342,2,5,0
43546,1,2,152338,152342,152344,4,6,0
43547,3,1,152341,152344,152345,3,4,0
43548,3,2,152344,152345,152347,1,3,0
43549,4,3,152348,152348,152351,0,3,1
43550,1,2,152349,152351,152353,2,4,0
43551,4,2,152353,152353,152355,0,2,0
43552,1,2,152354,152355,152357,1,3,0
43553,6,2,152360,152360,152362,0,2,3
43554,6,2,152366,152366,152368,0,2,4
43555,6,2,152372,152372,152374,0,2,4
43556,5,3,152377,152377,152380,0,3,3
43557,4,1,152381,152381,152382,0,1,1
43558,3,1,152384,152384,152385,0,1,2
43559,2,3,152386,152386,152389,0,3,1
43560,4,2,152390,152390,152392,0,2,1
43561,4,3,152394,152394,152397,0,3,2
43562,1,2,152395,152397,152399,2,4,0
43563,3,3,152398,152399,152402,1,4,0
43564,5,1,152403,152403,152404,0,1,1
43565,5,2,152408,152408,152410,0,2,4
43566,5,3,152413,152413,152416,0,3,3
43567,4,3,152417,152417,152420,0,3,1
43568,2,1,152419,152420,152421,1,2,0
43569,2,3,152421,152421,152424,0,3,0
43570,4,1,152425,152425,152426,0,1,1
43571,5,2,152430,152430,152432,0,2,4
43572,1,3,152431,152432,152435,1,4,0
43573,4,2,152435,152435,152437,0,2,0
43574,6,3,152441,152441,152444,0,3,4
43575,4,2,152445,152445,152447,0,2,1
43576,1,2,152446,152447,152449,1,3,0
43577,5,2,152451,152451,152453,0,2,2
43578,1,1,152452,152453,152454,1,2,0
43579,6,1,152458,152458,152459,0,1,4
43580,5,2,152463,152463,152465,0,2,4
43581,6,2,152469,152469,152471,0,2,4
43582,3,2,152472,152472,152474,0,2,1
43583,4,3,152476,152476,152479,0,3,2
43584,1,3,152477,152479,152482,2,5,0
43585,2,1,152479,152482,152483,3,4,0
43586,1,1,152480,152483,152484,3,4,0
43587,2,2,152482,152484,152486,2,4,0
43588,2,3,152484,152486,152489,2,5,0
43589,2,3,152486,152489,152492,3,6,0
43590,6,2,152492,152492,152494,0,2,0
43591,3,2,152495,152495,152497,0,2,1
43592,3,2,152498,152498,152500,0,2,1
43593,2,1,152500,152500,152501,0,1,0
43594,4,3,152504,152504,152507,0,3,3
43595,6,2,152510,152510,152512,0,2,3
43596,1,3,152511,152512,152515,1,4,0
43597,6,3,152517,152517,152520,0,3,2
43598,5,2,152522,152522,152524,0,2,2
43599,4,1,152526,152526,152527,0,1,2
43600,4,2,152530,152530,152532,0,2,3
43601,6,2,152536,152536,152538,0,2,4
43602,2,2,152538,152538,152540,0,2,0
43603,5,2,152543,152543,152545,0,2,3
43604,2,3,152545,152545,152548,0,3,0
43605,2,2,152547,152548,152550,1,3,0
43606,2,1,152549,152550,152551,1,2,0
43607,3,3,152552,152552,152555,0,3,1
43608,5,1,152557,152557,152558,0,1,2
43609,5,3,152562,152562,152565,0,3,4
43610,2,1,152564,152565,152566,1,2,0
43611,6,3,152570,152570,152573,0,3,4
43612,2,3,152572,152573,152576,1,4,0
43613,2,1,152574,152576,152577,2,3,0
43614,6,3,152580,152580,152583,0,3,3
43615,4,1,152584,152584,152585,0,1,1
43616,1,1,152585,152585,152586,0,1,0
43617,4,1,152589,152589,152590,0,1,3
43618,1,2,152590,152590,152592,0,2,0
43619,1,2,152591,152592,152594,1,3,0
43620,6,1,152597,152597,152598,0,1,3
43621,5,1,152602,152602,152603,0,1,4
43622,1,2,152603,152603,152605,0,2,0
43623,2,2,152605,152605,152607,0,2,0
43624,4,3,152609,152609,152612,0,3,2
43625,3,2,152612,152612,152614,0,2,0
43626,5,3,152617,152617,152620,0,3,3
43627,5,2,152622,152622,152624,0,2,2
43628,4,1,152626,152626,152627,0,1,2
43629,3,2,152629,152629,152631,0,2,2
43630,1,1,152630,152631,152632,1,2,0
43631,2,1,152632,152632,152633,0,1,0
43632,2,1,152634,152634,152635,0,1,1
43633,3,2,152637,152637,152639,0,2,2
43634,5,2,152642,152642,152644,0,2,3
43635,1,2,152643,152644,152646,1,3,0
43636,3,3,152646,152646,152649,0,3,0
43637,1,2,152647,152649,152651,2,4,0
43638,6,1,152653,152653,152654,0,1,2
43639,5,3,152658,152658,152661,0,3,4
43640,2,3,152660,152661,152664,1,4,0
43641,3,1,152663,152664,152665,1,2,0
43642,1,2,152664,152665,152667,1,3,0
43643,2,3,152666,152667,152670,1,4,0
43644,2,2,152668,152670,152672,2,4,0
43645,2,2,152670,152672,152674,2,4,0
43646,4,1,152674,152674,152675,0,1,0
43647,4,1,152678,152678,152679,0,1,3
43648,1,2,152679,152679,152681,0,2,0
43649,1,3,152680,152681,152684,1,4,0
43650,1,1,152681,152684,152685,3,4,0
43651,1,2,152682,152685,152687,3,5,0
43652,5,3,152687,152687,152690,0,3,0
43653,2,3,152689,152690,152693,1,4,0
43654,5,2,152694,152694,152696,0,2,1
43655,3,2,152697,152697,152699,0,2,1
43656,6,1,152703,152703,152704,0,1,4
43657,4,2,152707,152707,152709,0,2,3
43658,3,1,152710,152710,152711,0,1,1
43659,5,2,152715,152715,152717,0,2,4
43660,4,2,152719,152719,152721,0,2,2
43661,1,1,152720,152721,152722,1,2,0
43662,1,1,152721,152722,152723,1,2,0
43663,5,3,152726,152726,152729,0,3,3
43664,2,3,152728,152729,152732,1,4,0
43665,3,1,152731,152732,152733,1,2,0
43666,4,3,152735,152735,152738,0,3,2
43667,1,1,152736,152738,152739,2,3,0
43668,3,1,152739,152739,152740,0,1,0
43669,5,3,152744,152744,152747,0,3,4
43670,6,1,152750,152750,152751,0,1,3
43671,4,2,152754,152754,152756,0,2,3
43672,2,2,152756,152756,152758,0,2,0
43673,3,1,152759,152759,152760,0,1,1
43674,3,3,152762,152762,152765,0,3,2
43675,3,2,152765,152765,152767,0,2,0
43676,6,3,152771,152771,152774,0,3,4
43677,4,3,152775,152775,152778,0,3,1
43678,4,3,152779,152779,152782,0,3,1
43679,4,2,152783,152783,152785,0,2,1
43680,1,2,152784,152785,152787,1,3,0
43681,1,2,152785,152787,152789,2,4,0
43682,6,1,152791,152791,152792,0,1,2
43683,6,2,152797,152797,152799,0,2,5
43684,4,1,152801,152801,152802,0,1,2
43685,2,1,152803,152803,152804,0,1,1
43686,3,3,152806,152806,152809,0,3,2
43687,3,2,152809,152809,152811,0,2,0
43688,6,1,152815,152815,152816,0,1,4
43689,1,1,152816,152816,152817,0,1,0
43690,3,2,152819,152819,152821,0,2,2
43691,3,1,152822,152822,152823,0,1,1
43692,5,3,152827,152827,152830,0,3,4
43693,4,3,152831,152831,152834,0,3,1
43694,2,3,152833,152834,152837,1,4,0
43695,1,3,152834,152837,152840,3,6,0
43696,5,3,152839,152840,152843,1,4,0
43697,2,2,152841,152843,152845,2,4,0
43698,6,3,152847,152847,152850,0,3,2
43699,2,1,152849,152850,152851,1,2,0
43700,5,2,152854,152854,152856,0,2,3
43701,6,1,152860,152860,152861,0,1,4
43702,1,2,152861,152861,152863,0,2,0
43703,5,3,152866,152866,152869,0,3,3
43704,4,3,152870,152870,152873,0,3,1
43705,4,1,152874,152874,152875,0,1,1
43706,3,3,152877,152877,152880,0,3,2
43707,2,2,152879,152880,152882,1,3,0
43708,6,1,152885,152885,152886,0,1,3
43709,6,3,152891,152891,152894,0,3,5
43710,3,2,152894,152894,152896,0,2,0
43711,3,2,152897,152897,152899,0,2,1
43712,6,1,152903,152903,152904,0,1,4
43713,2,3,152905,152905,152908,0,3,1
43714,6,1,152911,152911,152912,0,1,3
43715,5,2,152916,152916,152918,0,2,4
43716,4,3,152920,152920,152923,0,3,2
43717,5,3,152925,152925,152928,0,3,2
43718,2,3,152927,152928,152931,1,4,0
43719,6,3,152933,152933,152936,0,3,2
43720,2,3,152935,152936,152939,1,4,0
43721,2,2,152937,152939,152941,2,4,0
43722,6,1,152943,152943,152944,0,1,2
43723,5,2,152948,152948,152950,0,2,4
43724,3,3,152951,152951,152954,0,3,1
43725,1,3,152952,152954,152957,2,5,0
43726,2,2,152954,152957,152959,3,5,0
43727,5,2,152959,152959,152961,0,2,0
43728,5,2,152964,152964,152966,0,2,3
43729,4,3,152968,152968,152971,0,3,2
43730,2,2,152970,152971,152973,1,3,0
43731,4,2,152974,152974,152976,0,2,1
43732,2,1,152976,152976,152977,0,1,0
43733,5,1,152981,152981,152982,0,1,4
43734,3,3,152984,152984,152987,0,3,2
43735,6,2,152990,152990,152992,0,2,3
43736,5,3,152995,152995,152998,0,3,3
43737,4,2,152999,152999,153001,0,2,1
43738,5,3,153004,153004,153007,0,3,3
43739,2,1,153006,153007,153008,1,2,0
43740,3,1,153009,153009,153010,0,1,1
43741,6,2,153015,153015,153017,0,2,5
43742,4,1,153019,153019,153020,0,1,2
43743,5,3,153024,153024,153027,0,3,4
43744,6,3,153030,153030,153033,0,3,3
43745,3,3,153033,153033,153036,0,3,0
43746,1,1,153034,153036,153037,2,3,0
43747,3,2,153037,153037,153039,0,2,0
43748,4,3,153041,153041,153044,0,3,2
43749,2,1,153043,153044,153045,1,2,0
43750,4,3,153047,153047,153050,0,3,2
43751,5,2,153052,153052,153054,0,2,2
43752,1,1,153053,153054,153055,1,2,0
43753,4,3,153057,153057,153060,0,3,2
43754,2,1,153059,153060,153061,1,2,0
43755,2,2,153061,153061,153063,0,2,0
43756,1,1,153062,153063,153064,1,2,0
43757,3,3,153065,153065,153068,0,3,1
43758,5,3,153070,153070,153073,0,3,2
43759,6,1,153076,153076,153077,0,1,3
43760,1,1,153077,153077,153078,0,1,0
43761,6,1,153083,153083,153084,0,1,5
43762,6,1,153089,153089,153090,0,1,5
43763,2,3,153091,153091,153094,0,3,1
43764,6,2,153097,153097,153099,0,2,3
43765,5,2,153102,153102,153104,0,2,3
43766,6,3,153108,153108,153111,0,3,4
43767,5,2,153113,153113,153115,0,2,2
43768,2,1,153115,153115,153116,0,1,0
43769,2,2,153117,153117,153119,0,2,1
43770,1,3,153118,153119,153122,1,4,0
43771,6,1,153124,153124,153125,0,1,2
43772,6,1,153130,153130,153131,0,1,5
43773,3,2,153133,153133,153135,0,2,2
43774,2,2,153135,153135,153137,0,2,0
43775,5,1,153140,153140,153141,0,1,3
43776,3,2,153143,153143,153145,0,2,2
43777,5,3,153148,153148,153151,0,3,3
43778,2,3,153150,153151,153154,1,4,0
43779,6,3,153156,153156,153159,0,3,2
43780,1,3,153157,153159,153162,2,5,0
43781,3,1,153160,153162,153163,2,3,0
43782,3,1,153163,153163,153164,0,1,0
43783,4,1,153167,153167,153168,0,1,3
43784,4,1,153171,153171,153172,0,1,3
43785,6,2,153177,153177,153179,0,2,5
43786,2,3,153179,153179,153182,0,3,0
43787,3,1,153182,153182,153183,0,1,0
43788,3,3,153185,153185,153188,0,3,2
43789,3,3,153188,153188,153191,0,3,0
43790,5,2,153193,153193,153195,0,2,2
43791,3,3,153196,153196,153199,0,3,1
43792,3,2,153199,153199,153201,0,2,0
43793,5,1,153204,153204,153205,0,1,3
43794,5,3,153209,153209,153212,0,3,4
43795,6,2,153215,153215,153217,0,2,3
43796,6,2,153221,153221,153223,0,2,4
43797,4,1,153225,153225,153226,0,1,2
43798,4,1,153229,153229,153230,0,1,3
43799,6,3,153235,153235,153238,0,3,5
43800,4,2,153239,153239,153241,0,2,1
43801,1,1,153240,153241,153242,1,2,0
43802,4,3,153244,153244,153247,0,3,2
43803,2,2,153246,153247,153249,1,3,0
43804,4,1,153250,153250,153251,0,1,1
43805,6,1,153256,153256,153257,0,1,5
43806,4,2,153260,153260,153262,0,2,3
43807,3,3,153263,153263,153266,0,3,1
43808,1,2,153264,153266,153268,2,4,0
43809,6,3,153270,153270,153273,0,3,2
43810,6,1,153276,153276,153277,0,1,3
43811,4,3,153280,153280,153283,0,3,3
43812,3,2,153283,153283,153285,0,2,0
43813,3,1,153286,153286,153287,0,1,1
43814,1,2,153287,153287,153289,0,2,0
43815,6,1,153293,153293,153294,0,1,4
43816,4,3,153297,153297,153300,0,3,3
43817,4,2,153301,153301,153303,0,2,1
43818,5,3,153306,153306,153309,0,3,3
43819,3,1,153309,153309,153310,0,1,0
43820,1,3,153310,153310,153313,0,3,0
43821,1,1,153311,153313,153314,2,3,0
43822,3,3,153314,153314,153317,0,3,0
43823,4,1,153318,153318,153319,0,1,1
43824,2,1,153320,153320,153321,0,1,1
43825,2,2,153322,153322,153324,0,2,1
43826,1,3,153323,153324,153327,1,4,0
43827,4,1,153327,153327,153328,0,1,0
43828,3,1,153330,153330,153331,0,1,2
43829,5,2,153335,153335,153337,0,2,4
43830,2,1,153337,153337,153338,0,1,0
43831,4,3,153341,153341,153344,0,3,3
43832,1,1,153342,153344,153345,2,3,0
43833,1,2,153343,153345,153347,2,4,0
43834,1,3,153344,153347,153350,3,6,0
43835,1,3,153345,153350,153353,5,8,0
43836,2,3,153347,153353,153356,6,9,0
43837,2,3,153349,153356,153359,7,10,0
43838,1,1,153350,153359,153360,9,10,0
43839,6,1,153356,153360,153361,4,5,0
43840,2,3,153358,153361,153364,3,6,0
43841,5,2,153363,153364,153366,1,3,0
43842,6,3,153369,153369,153372,0,3,3
43843,2,3,153371,153372,153375,1,4,0
43844,2,2,153373,153375,153377,2,4,0
43845,1,3,153374,153377,153380,3,6,0
43846,5,3,153379,153380,153383,1,4,0
43847,6,1,153385,153385,153386,0,1,2
43848,4,2,153389,153389,153391,0,2,3
43849,2,1,153391,153391,153392,0,1,0
43850,4,3,153395,153395,153398,0,3,3
43851,2,3,153397,153398,153401,1,4,0
43852,4,1,153401,153401,153402,0,1,0
43853,5,1,153406,153406,153407,0,1,4
43854,3,3,153409,153409,153412,0,3,2
43855,1,1,153410,153412,153413,2,3,0
43856,1,3,153411,153413,153416,2,5,0
43857,3,3,153414,153416,153419,2,5,0
43858,5,3,153419,153419,153422,0,3,0
43859,6,2,153425,153425,153427,0,2,3
43860,1,2,153426,153427,153429,1,3,0
43861,2,3,153428,153429,153432,1,4,0
43862,3,2,153431,153432,153434,1,3,0
43863,2,1,153433,153434,153435,1,2,0
43864,2,3,153435,153435,153438,0,3,0
43865,3,3,153438,153438,153441,0,3,0
43866,2,1,153440,153441,153442,1,2,0
43867,6,2,153446,153446,153448,0,2,4
43868,4,2,153450,153450,153452,0,2,2
43869,2,3,153452,153452,153455,0,3,0
43870,6,1,153458,153458,153459,0,1,3
43871,1,3,153459,153459,153462,0,3,0
43872,2,2,153461,153462,153464,1,3,0
43873,3,1,153464,153464,153465,0,1,0
43874,2,3,153466,153466,153469,0,3,1
43875,3,3,153469,153469,153472,0,3,0
43876,2,3,153471,153472,153475,1,4,0
43877,1,3,153472,153475,153478,3,6,0
43878,3,1,153475,153478,153479,3,4,0
43879,5,1,153480,153480,153481,0,1,1
43880,2,2,153482,153482,153484,0,2,1
43881,5,3,153487,153487,153490,0,3,3
43882,3,2,153490,153490,153492,0,2,0
43883,2,3,153492,153492,153495,0,3,0
43884,2,2,153494,153495,153497,1,3,0
43885,1,3,153495,153497,153500,2,5,0
43886,5,1,153500,153500,153501,0,1,0
43887,4,1,153504,153504,153505,0,1,3
43888,1,1,153505,153505,153506,0,1,0
43889,3,1,153508,153508,153509,0,1,2
43890,5,2,153513,153513,153515,0,2,4
43891,3,2,153516,153516,153518,0,2,1
43892,5,2,153521,153521,153523,0,2,3
43893,6,3,153527,153527,153530,0,3,4
43894,3,1,153530,153530,153531,0,1,0
43895,4,2,153534,153534,153536,0,2,3
43896,2,1,153536,153536,153537,0,1,0
43897,5,3,153541,153541,153544,0,3,4
43898,4,2,153545,153545,153547,0,2,1
43899,6,3,153551,153551,153554,0,3,4
43900,1,1,153552,153554,153555,2,3,0
43901,4,2,153556,153556,153558,0,2,1
43902,6,3,153562,153562,153565,0,3,4
43903,1,3,153563,153565,153568,2,5,0
43904,2,2,153565,153568,153570,3,5,0
43905,5,3,153570,153570,153573,0,3,0
43906,1,1,153571,153573,153574,2,3,0
43907,5,1,153576,153576,153577,0,1,2
43908,3,3,153579,153579,153582,0,3,2
43909,1,2,153580,153582,153584,2,4,0
43910,5,1,153585,153585,153586,0,1,1
43911,5,2,153590,153590,153592,0,2,4
43912,1,1,153591,153592,153593,1,2,0
43913,2,3,153593,153593,153596,0,3,0
43914,3,3,153596,153596,153599,0,3,0
43915,1,3,153597,153599,153602,2,5,0
43916,3,2,153600,153602,153604,2,4,0
43917,4,3,153604,153604,153607,0,3,0
43918,5,3,153609,153609,153612,0,3,2
43919,2,1,153611,153612,153613,1,2,0
43920,1,2,153612,153613,153615,1,3,0
43921,5,2,153617,153617,153619,0,2,2
43922,2,1,153619,153619,153620,0,1,0
43923,6,3,153625,153625,153628,0,3,5
43924,5,1,153630,153630,153631,0,1,2
43925,2,1,153632,153632,153633,0,1,1
43926,1,2,153633,153633,153635,0,2,0
43927,5,1,153638,153638,153639,0,1,3
43928,4,3,153642,153642,153645,0,3,3
43929,1,1,153643,153645,153646,2,3,0
43930,5,2,153648,153648,153650,0,2,2
43931,6,2,153654,153654,153656,0,2,4
43932,4,2,153658,153658,153660,0,2,2
43933,3,1,153661,153661,153662,0,1,1
43934,5,2,153666,153666,153668,0,2,4
43935,2,2,153668,153668,153670,0,2,0
43936,3,3,153671,153671,153674,0,3,1
43937,6,1,153677,153677,153678,0,1,3
43938,1,1,153678,153678,153679,0,1,0
43939,5,3,153683,153683,153686,0,3,4
43940,3,2,153686,153686,153688,0,2,0
43941,4,3,153690,153690,153693,0,3,2
43942,6,1,153696,153696,153697,0,1,3
43943,5,1,153701,153701,153702,0,1,4
43944,1,2,153702,153702,153704,0,2,0
43945,5,3,153707,153707,153710,0,3,3
43946,1,2,153708,153710,153712,2,4,0
43947,4,1,153712,153712,153713,0,1,0
43948,3,2,153715,153715,153717,0,2,2
43949,2,3,153717,153717,153720,0,3,0
43950,6,3,153723,153723,153726,0,3,3
43951,4,3,153727,153727,153730,0,3,1
43952,6,3,153733,153733,153736,0,3,3
43953,3,2,153736,153736,153738,0,2,0
43954,6,1,153742,153742,153743,0,1,4
43955,6,3,153748,153748,153751,0,3,5
43956,1,1,153749,153751,153752,2,3,0
43957,1,2,153750,153752,153754,2,4,0
43958,1,2,153751,153754,153756,3,5,0
43959,4,1,153755,153756,153757,1,2,0
43960,2,2,153757,153757,153759,0,2,0
43961,1,2,153758,153759,153761,1,3,0
43962,5,1,153763,153763,153764,0,1,2
43963,3,3,153766,153766,153769,0,3,2
43964,1,1,153767,153769,153770,2,3,0
43965,5,2,153772,153772,153774,0,2,2
43966,1,1,153773,153774,153775,1,2,0
43967,1,1,153774,153775,153776,1,2,0
43968,2,1,153776,153776,153777,0,1,0
43969,5,2,153781,153781,153783,0,2,4
43970,3,2,153784,153784,153786,0,2,1
43971,6,2,153790,153790,153792,0,2,4
43972,6,2,153796,153796,153798,0,2,4
43973,1,1,153797,153798,153799,1,2,0
43974,5,3,153802,153802,153805,0,3,3
43975,2,1,153804,153805,153806,1,2,0
43976,2,1,153806,153806,153807,0,1,0
43977,1,3,153807,153807,153810,0,3,0
43978,4,1,153811,153811,153812,0,1,1
43979,3,2,153814,153814,153816,0,2,2
43980,4,1,153818,153818,153819,0,1,2
43981,4,2,153822,153822,153824,0,2,3
43982,1,3,153823,153824,153827,1,4,0
43983,2,2,153825,153827,153829,2,4,0
43984,2,2,153827,153829,153831,2,4,0
43985,2,1,153829,153831,153832,2,3,0
43986,6,1,153835,153835,153836,0,1,3
43987,3,2,153838,153838,153840,0,2,2
43988,2,2,153840,153840,153842,0,2,0
43989,4,2,153844,153844,153846,0,2,2
43990,3,1,153847,153847,153848,0,1,1
43991,4,2,153851,153851,153853,0,2,3
43992,4,1,153855,153855,153856,0,1,2
43993,6,2,153861,153861,153863,0,2,5
43994,1,2,153862,153863,153865,1,3,0
43995,2,1,153864,153865,153866,1,2,0
43996,4,2,153868,153868,153870,0,2,2
43997,1,3,153869,153870,153873,1,4,0
43998,5,3,153874,153874,153877,0,3,1
43999,6,2,153880,153880,153882,0,2,3
44000,6,1,153886,153886,153887,0,1,4
44001,5,3,153891,153891,153894,0,3,4
44002,5,2,153896,153896,153898,0,2,2
44003,5,1,153901,153901,153902,0,1,3
44004,1,2,153902,153902,153904,0,2,0
44005,5,2,153907,153907,153909,0,2,3
44006,6,3,153913,153913,153916,0,3,4
44007,4,1,153917,153917,153918,0,1,1
44008,2,1,153919,153919,153920,0,1,1
44009,6,3,153925,153925,153928,0,3,5
44010,2,3,153927,153928,153931,1,4,0
44011,4,2,153931,153931,153933,0,2,0
44012,1,1,153932,153933,153934,1,2,0
44013,5,2,153937,153937,153939,0,2,3
44014,1,2,153938,153939,153941,1,3,0
44015,4,2,153942,153942,153944,0,2,1
44016,3,1,153945,153945,153946,0,1,1
44017,2,2,153947,153947,153949,0,2,1
44018,2,2,153949,153949,153951,0,2,0
44019,1,1,153950,153951,153952,1,2,0
44020,2,3,153952,153952,153955,0,3,0
44021,4,2,153956,153956,153958,0,2,1
44022,1,2,153957,153958,153960,1,3,0
44023,2,1,153959,153960,153961,1,2,0
44024,1,3,153960,153961,153964,1,4,0
44025,5,1,153965,153965,153966,0,1,1
44026,3,1,153968,153968,153969,0,1,2
44027,4,2,153972,153972,153974,0,2,3
44028,3,2,153975,153975,153977,0,2,1
44029,5,2,153980,153980,153982,0,2,3
44030,2,1,153982,153982,153983,0,1,0
44031,2,2,153984,153984,153986,0,2,1
44032,1,2,153985,153986,153988,1,3,0
44033,2,1,153987,153988,153989,1,2,0
44034,1,1,153988,153989,153990,1,2,0
44035,6,3,153994,153994,153997,0,3,4
44036,3,3,153997,153997,154000,0,3,0
44037,2,2,153999,154000,154002,1,3,0
44038,4,1,154003,154003,154004,0,1,1
44039,5,1,154008,154008,154009,0,1,4
44040,2,1,154010,154010,154011,0,1,1
44041,5,3,154015,154015,154018,0,3,4
44042,4,3,154019,154019,154022,0,3,1
44043,4,1,154023,154023,154024,0,1,1
44044,2,1,154025,154025,154026,0,1,1
44045,1,2,154026,154026,154028,0,2,0
44046,1,2,154027,154028,154030,1,3,0
44047,3,3,154030,154030,154033,0,3,0
44048,4,1,154034,154034,154035,0,1,1
44049,5,1,154039,154039,154040,0,1,4
44050,3,3,154042,154042,154045,0,3,2
44051,3,1,154045,154045,154046,0,1,0
44052,2,2,154047,154047,154049,0,2,1
44053,2,3,154049,154049,154052,0,3,0
44054,2,1,154051,154052,154053,1,2,0
44055,4,3,154055,154055,154058,0,3,2
44056,4,3,154059,154059,154062,0,3,1
44057,6,1,154065,154065,154066,0,1,3
44058,4,1,154069,154069,154070,0,1,3
44059,3,2,154072,154072,154074,0,2,2
44060,4,2,154076,154076,154078,0,2,2
44061,2,3,154078,154078,154081,0,3,0
44062,3,1,154081,154081,154082,0,1,0
44063,6,2,154087,154087,154089,0,2,5
44064,3,3,154090,154090,154093,0,3,1
44065,3,2,154093,154093,154095,0,2,0
44066,5,1,154098,154098,154099,0,1,3
44067,2,1,154100,154100,154101,0,1,1
44068,1,3,154101,154101,154104,0,3,0
44069,5,2,154106,154106,154108,0,2,2
44070,5,3,154111,154111,154114,0,3,3
44071,4,1,154115,154115,154116,0,1,1
44072,5,3,154120,154120,154123,0,3,4
44073,5,3,154125,154125,154128,0,3,2
44074,4,1,154129,154129,154130,0,1,1
44075,1,3,154130,154130,154133,0,3,0
44076,3,2,154133,154133,154135,0,2,0
44077,1,1,154134,154135,154136,1,2,0
44078,1,2,154135,154136,154138,1,3,0
44079,1,1,154136,154138,154139,2,3,0
44080,5,3,154141,154141,154144,0,3,2
44081,4,1,154145,154145,154146,0,1,1
44082,4,2,154149,154149,154151,0,2,3
44083,1,3,154150,154151,154154,1,4,0
44084,4,3,154154,154154,154157,0,3,0
44085,4,3,154158,154158,154161,0,3,1
44086,2,2,154160,154161,154163,1,3,0
44087,2,2,154162,154163,154165,1,3,0
44088,6,1,154168,154168,154169,0,1,3
44089,2,2,154170,154170,154172,0,2,1
44090,6,3,154176,154176,154179,0,3,4
44091,1,3,154177,154179,154182,2,5,0
44092,2,3,154179,154182,154185,3,6,0
44093,4,1,154183,154185,154186,2,3,0
44094,4,2,154187,154187,154189,0,2,1
44095,3,1,154190,154190,154191,0,1,1
44096,3,3,154193,154193,154196,0,3,2
44097,1,3,154194,154196,154199,2,5,0
44098,5,1,154199,154199,154200,0,1,0
44099,5,1,154204,154204,154205,0,1,4
44100,4,2,154208,154208,154210,0,2,3
44101,2,1,154210,154210,154211,0,1,0
44102,2,1,154212,154212,154213,0,1,1
44103,5,2,154217,154217,154219,0,2,4
44104,6,2,154223,154223,154225,0,2,4
44105,1,2,154224,154225,154227,1,3,0
44106,6,1,154230,154230,154231,0,1,3
44107,5,1,154235,154235,154236,0,1,4
44108,3,3,154238,154238,154241,0,3,2
44109,5,3,154243,154243,154246,0,3,2
44110,1,3,154244,154246,154249,2,5,0
44111,4,3,154248,154249,154252,1,4,0
44112,5,1,154253,154253,154254,0,1,1
44113,5,1,154258,154258,154259,0,1,4
44114,2,2,154260,154260,154262,0,2,1
44115,4,3,154264,154264,154267,0,3,2
44116,6,1,154270,154270,154271,0,1,3
44117,3,2,154273,154273,154275,0,2,2
44118,2,2,154275,154275,154277,0,2,0
44119,2,3,154277,154277,154280,0,3,0
44120,3,1,154280,154280,154281,0,1,0
44121,4,2,154284,154284,154286,0,2,3
44122,1,2,154285,154286,154288,1,3,0
44123,5,2,154290,154290,154292,0,2,2
44124,1,3,154291,154292,154295,1,4,0
44125,6,2,154297,154297,154299,0,2,2
44126,4,1,154301,154301,154302,0,1,2
44127,6,1,154307,154307,154308,0,1,5
44128,6,2,154313,154313,154315,0,2,5
44129,2,2,154315,154315,154317,0,2,0
44130,2,3,154317,154317,154320,0,3,0
44131,3,3,154320,154320,154323,0,3,0
44132,5,2,154325,154325,154327,0,2,2
44133,3,3,154328,154328,154331,0,3,1
44134,3,1,154331,154331,154332,0,1,0
44135,4,3,154335,154335,154338,0,3,3
44136,3,2,154338,154338,154340,0,2,0
44137,5,3,154343,154343,154346,0,3,3
44138,4,2,154347,154347,154349,0,2,1
44139,4,1,154351,154351,154352,0,1,2
44140,6,1,154357,154357,154358,0,1,5
44141,1,3,154358,154358,154361,0,3,0
44142,6,1,154364,154364,154365,0,1,3
44143,2,1,154366,154366,154367,0,1,1
44144,4,1,154370,154370,154371,0,1,3
44145,6,3,154376,154376,154379,0,3,5
44146,2,1,154378,154379,154380,1,2,0
44147,6,3,154384,154384,154387,0,3,4
44148,2,1,154386,154387,154388,1,2,0
44149,1,2,154387,154388,154390,1,3,0
44150,5,2,154392,154392,154394,0,2,2
44151,5,1,154397,154397,154398,0,1,3
44152,2,1,154399,154399,154400,0,1,1
44153,2,1,154401,154401,154402,0,1,1
44154,1,1,154402,154402,154403,0,1,0
44155,5,2,154407,154407,154409,0,2,4
44156,3,3,154410,154410,154413,0,3,1
44157,2,1,154412,154413,154414,1,2,0
44158,6,2,154418,154418,154420,0,2,4
44159,4,3,154422,154422,154425,0,3,2
44160,2,1,154424,154425,154426,1,2,0
44161,2,2,154426,154426,154428,0,2,0
44162,5,2,154431,154431,154433,0,2,3
44163,5,3,154436,154436,154439,0,3,3
44164,3,3,154439,154439,154442,0,3,0
44165,2,1,154441,154442,154443,1,2,0
44166,2,3,154443,154443,154446,0,3,0
44167,4,1,154447,154447,154448,0,1,1
44168,5,2,154452,154452,154454,0,2,4
44169,4,3,154456,154456,154459,0,3,2
44170,2,3,154458,154459,154462,1,4,0
44171,6,1,154464,154464,154465,0,1,2
44172,1,1,154465,154465,154466,0,1,0
44173,5,2,154470,154470,154472,0,2,4
44174,4,3,154474,154474,154477,0,3,2
44175,3,2,154477,154477,154479,0,2,0
44176,6,2,154483,154483,154485,0,2,4
44177,3,3,154486,154486,154489,0,3,1
44178,2,1,154488,154489,154490,1,2,0
44179,1,3,154489,154490,154493,1,4,0
44180,3,2,154492,154493,154495,1,3,0
44181,3,3,154495,154495,154498,0,3,0
44182,4,1,154499,154499,154500,0,1,1
44183,6,1,154505,154505,154506,0,1,5
44184,5,1,154510,154510,154511,0,1,4
44185,3,3,154513,154513,154516,0,3,2
44186,2,1,154515,154516,154517,1,2,0
44187,2,3,154517,154517,154520,0,3,0
44188,5,2,154522,154522,154524,0,2,2
44189,1,1,154523,154524,154525,1,2,0
44190,6,2,154529,154529,154531,0,2,4
44191,1,3,154530,154531,154534,1,4,0
44192,1,3,154531,154534,154537,3,6,0
44193,4,2,154535,154537,154539,2,4,0
44194,6,2,154541,154541,154543,0,2,2
44195,5,2,154546,154546,154548,0,2,3
44196,3,1,154549,154549,154550,0,1,1
44197,5,1,154554,154554,154555,0,1,4
44198,2,2,154556,154556,154558,0,2,1
44199,3,3,154559,154559,154562,0,3,1
44200,3,1,154562,154562,154563,0,1,0
44201,1,1,154563,154563,154564,0,1,0
44202,5,2,154568,154568,154570,0,2,4
44203,1,2,154569,154570,154572,1,3,0
44204,2,2,154571,154572,154574,1,3,0
44205,3,3,154574,154574,154577,0,3,0
44206,4,2,154578,154578,154580,0,2,1
44207,6,1,154584,154584,154585,0,1,4
44208,4,3,154588,154588,154591,0,3,3
44209,3,1,154591,154591,154592,0,1,0
44210,5,3,154596,154596,154599,0,3,4
44211,5,2,154601,154601,154603,0,2,2
44212,1,1,154602,154603,154604,1,2,0
44213,5,3,154607,154607,154610,0,3,3
44214,2,1,154609,154610,154611,1,2,0
44215,1,2,154610,154611,154613,1,3,0
44216,1,3,154611,154613,154616,2,5,0
44217,4,1,154615,154616,154617,1,2,0
44218,1,3,154616,154617,154620,1,4,0
44219,2,2,154618,154620,154622,2,4,0
44220,4,3,154622,154622,154625,0,3,0
44221,2,3,154624,154625,154628,1,4,0
44222,6,3,154630,154630,154633,0,3,2
44223,2,1,154632,154633,154634,1,2,0
44224,3,1,154635,154635,154636,0,1,1
44225,3,2,154638,154638,154640,0,2,2
44226,1,3,154639,154640,154643,1,4,0
44227,2,3,154641,154643,154646,2,5,0
44228,1,3,154642,154646,154649,4,7,0
44229,6,2,154648,154649,154651,1,3,0
44230,4,2,154652,154652,154654,0,2,1
44231,2,1,154654,154654,154655,0,1,0
44232,5,3,154659,154659,154662,0,3,4
44233,6,3,154665,154665,154668,0,3,3
44234,1,1,154666,154668,154669,2,3,0
44235,3,2,154669,154669,154671,0,2,0
44236,6,2,154675,154675,154677,0,2,4
44237,6,3,154681,154681,154684,0,3,4
44238,4,3,154685,154685,154688,0,3,1
44239,4,1,154689,154689,154690,0,1,1
44240,1,3,154690,154690,154693,0,3,0
44241,1,3,154691,154693,154696,2,5,0
44242,1,3,154692,154696,154699,4,7,0
44243,5,1,154697,154699,154700,2,3,0
44244,3,1,154700,154700,154701,0,1,0
44245,1,1,154701,154701,154702,0,1,0
44246,3,1,154704,154704,154705,0,1,2
44247,3,1,154707,154707,154708,0,1,2
44248,1,3,154708,154708,154711,0,3,0
44249,5,2,154713,154713,154715,0,2,2
44250,3,3,154716,154716,154719,0,3,1
44251,1,1,154717,154719,154720,2,3,0
44252,1,1,154718,154720,154721,2,3,0
44253,3,2,154721,154721,154723,0,2,0
44254,6,3,154727,154727,154730,0,3,4
44255,5,3,154732,154732,154735,0,3,2
44256,5,2,154737,154737,154739,0,2,2
44257,2,3,154739,154739,154742,0,3,0
44258,2,3,154741,154742,154745,1,4,0
44259,2,2,154743,154745,154747,2,4,0
44260,5,2,154748,154748,154750,0,2,1
44261,2,2,154750,154750,154752,0,2,0
44262,6,3,154756,154756,154759,0,3,4
44263,4,2,154760,154760,154762,0,2,1
44264,6,1,154766,154766,154767,0,1,4
44265,1,1,154767,154767,154768,0,1,0
44266,1,1,154768,154768,154769,0,1,0
44267,1,2,154769,154769,154771,0,2,0
44268,1,3,154770,154771,154774,1,4,0
44269,1,1,154771,154774,154775,3,4,0
44270,3,3,154774,154775,154778,1,4,0
44271,3,1,154777,154778,154779,1,2,0
44272,2,3,154779,154779,154782,0,3,0
44273,5,3,154784,154784,154787,0,3,2
44274,3,2,154787,154787,154789,0,2,0
44275,1,1,154788,154789,154790,1,2,0
44276,6,1,154794,154794,154795,0,1,4
44277,1,1,154795,154795,154796,0,1,0
44278,6,2,154801,154801,154803,0,2,5
44279,4,2,154805,154805,154807,0,2,2
44280,3,1,154808,154808,154809,0,1,1
44281,3,3,154811,154811,154814,0,3,2
44282,4,1,154815,154815,154816,0,1,1
44283,6,3,154821,154821,154824,0,3,5
44284,3,2,154824,154824,154826,0,2,0
44285,1,1,154825,154826,154827,1,2,0
44286,6,3,154831,154831,154834,0,3,4
44287,4,2,154835,154835,154837,0,2,1
44288,1,1,154836,154837,154838,1,2,0
44289,4,2,154840,154840,154842,0,2,2
44290,2,1,154842,154842,154843,0,1,0
44291,5,1,154847,154847,154848,0,1,4
44292,1,1,154848,154848,154849,0,1,0
44293,2,2,154850,154850,154852,0,2,1
44294,6,1,154856,154856,154857,0,1,4
44295,3,3,154859,154859,154862,0,3,2
44296,1,1,154860,154862,154863,2,3,0
44297,5,3,154865,154865,154868,0,3,2
44298,5,3,154870,154870,154873,0,3,2
44299,5,1,154875,154875,154876,0,1,2
44300,3,2,154878,154878,154880,0,2,2
44301,5,2,154883,154883,154885,0,2,3
44302,2,3,154885,154885,154888,0,3,0
44303,2,3,154887,154888,154891,1,4,0
44304,2,2,154889,154891,154893,2,4,0
44305,6,1,154895,154895,154896,0,1,2
44306,5,2,154900,154900,154902,0,2,4
44307,3,2,154903,154903,154905,0,2,1
44308,1,1,154904,154905,154906,1,2,0
44309,6,2,154910,154910,154912,0,2,4
44310,4,2,154914,154914,154916,0,2,2
44311,3,2,154917,154917,154919,0,2,1
44312,3,1,154920,154920,154921,0,1,1
44313,2,3,154922,154922,154925,0,3,1
44314,2,2,154924,154925,154927,1,3,0
44315,3,2,154927,154927,154929,0,2,0
44316,4,2,154931,154931,154933,0,2,2
44317,3,2,154934,154934,154936,0,2,1
44318,1,1,154935,154936,154937,1,2,0
44319,5,3,154940,154940,154943,0,3,3
44320,1,3,154941,154943,154946,2,5,0
44321,4,2,154945,154946,154948,1,3,0
44322,6,2,154951,154951,154953,0,2,3
44323,1,1,154952,154953,154954,1,2,0
44324,1,2,154953,154954,154956,1,3,0
44325,6,1,154959,154959,154960,0,1,3
44326,5,1,154964,154964,154965,0,1,4
44327,6,1,154970,154970,154971,0,1,5
44328,4,1,154974,154974,154975,0,1,3
44329,5,3,154979,154979,154982,0,3,4
44330,5,3,154984,154984,154987,0,3,2
44331,6,1,154990,154990,154991,0,1,3
44332,5,1,154995,154995,154996,0,1,4
44333,2,2,154997,154997,154999,0,2,1
44334,1,1,154998,154999,155000,1,2,0
44335,5,1,155003,155003,155004,0,1,3
44336,4,1,155007,155007,155008,0,1,3
44337,6,1,155013,155013,155014,0,1,5
44338,4,1,155017,155017,155018,0,1,3
44339,3,2,155020,155020,155022,0,2,2
44340,2,2,155022,155022,155024,0,2,0
44341,6,1,155028,155028,155029,0,1,4
44342,6,2,155034,155034,155036,0,2,5
44343,4,1,155038,155038,155039,0,1,2
44344,4,3,155042,155042,155045,0,3,3
44345,6,1,155048,155048,155049,0,1,3
44346,2,1,155050,155050,155051,0,1,1
44347,2,1,155052,155052,155053,0,1,1
44348,3,1,155055,155055,155056,0,1,2
44349,6,2,155061,155061,155063,0,2,5
44350,4,2,155065,155065,155067,0,2,2
44351,2,1,155067,155067,155068,0,1,0
44352,3,2,155070,155070,155072,0,2,2
44353,4,2,155074,155074,155076,0,2,2
44354,4,1,155078,155078,155079,0,1,2
44355,4,1,155082,155082,155083,0,1,3
44356,2,2,155084,155084,155086,0,2,1
44357,2,1,155086,155086,155087,0,1,0
44358,6,2,155092,155092,155094,0,2,5
44359,6,3,155098,155098,155101,0,3,4
44360,6,3,155104,155104,155107,0,3,3
44361,6,2,155110,155110,155112,0,2,3
44362,4,2,155114,155114,155116,0,2,2
44363,6,1,155120,155120,155121,0,1,4
44364,4,3,155124,155124,155127,0,3,3
44365,1,3,155125,155127,155130,2,5,0
44366,3,3,155128,155130,155133,2,5,0
44367,5,2,155133,155133,155135,0,2,0
44368,3,1,155136,155136,155137,0,1,1
44369,6,3,155142,155142,155145,0,3,5
44370,2,2,155144,155145,155147,1,3,0
44371,1,3,155145,155147,155150,2,5,0
44372,6,3,155151,155151,155154,0,3,1
44373,1,2,155152,155154,155156,2,4,0
44374,1,1,155153,155156,155157,3,4,0
44375,1,1,155154,155157,155158,3,4,0
44376,5,1,155159,155159,155160,0,1,1
44377,3,2,155162,155162,155164,0,2,2
44378,3,1,155165,155165,155166,0,1,1
44379,4,1,155169,155169,155170,0,1,3
44380,2,2,155171,155171,155173,0,2,1
44381,5,2,155176,155176,155178,0,2,3
44382,1,2,155177,155178,155180,1,3,0
44383,4,2,155181,155181,155183,0,2,1
44384,3,2,155184,155184,155186,0,2,1
44385,6,1,155190,155190,155191,0,1,4
44386,1,2,155191,155191,155193,0,2,0
44387,1,1,155192,155193,155194,1,2,0
44388,1,2,155193,155194,155196,1,3,0
44389,5,3,155198,155198,155201,0,3,2
44390,3,1,155201,155201,155202,0,1,0
44391,4,1,155205,155205,155206,0,1,3
44392,1,1,155206,155206,155207,0,1,0
44393,3,1,155209,155209,155210,0,1,2
44394,3,1,155212,155212,155213,0,1,2
44395,5,3,155217,155217,155220,0,3,4
44396,3,1,155220,155220,155221,0,1,0
44397,2,3,155222,155222,155225,0,3,1
44398,5,1,155227,155227,155228,0,1,2
44399,3,2,155230,155230,155232,0,2,2
44400,2,2,155232,155232,155234,0,2,0
44401,6,1,155238,155238,155239,0,1,4
44402,6,3,155244,155244,155247,0,3,5
44403,4,2,155248,155248,155250,0,2,1
44404,4,3,155252,155252,155255,0,3,2
44405,5,2,155257,155257,155259,0,2,2
44406,1,1,155258,155259,155260,1,2,0
44407,5,2,155263,155263,155265,0,2,3
44408,5,1,155268,155268,155269,0,1,3
44409,4,2,155272,155272,155274,0,2,3
44410,3,2,155275,155275,155277,0,2,1
44411,3,3,155278,155278,155281,0,3,1
44412,3,1,155281,155281,155282,0,1,0
44413,3,1,155284,155284,155285,0,1,2
44414,4,1,155288,155288,155289,0,1,3
44415,5,3,155293,155293,155296,0,3,4
44416,4,2,155297,155297,155299,0,2,1
44417,3,1,155300,155300,155301,0,1,1
44418,5,3,155305,155305,155308,0,3,4
44419,3,3,155308,155308,155311,0,3,0
44420,6,3,155314,155314,155317,0,3,3
44421,3,2,155317,155317,155319,0,2,0
44422,1,1,155318,155319,155320,1,2,0
44423,3,2,155321,155321,155323,0,2,1
44424,1,1,155322,155323,155324,1,2,0
44425,4,2,155326,155326,155328,0,2,2
44426,1,3,155327,155328,155331,1,4,0
44427,3,2,155330,155331,155333,1,3,0
44428,4,2,155334,155334,155336,0,2,1
44429,3,3,155337,155337,155340,0,3,1
44430,3,3,155340,155340,155343,0,3,0
44431,2,2,155342,155343,155345,1,3,0
44432,1,3,155343,155345,155348,2,5,0
44433,2,2,155345,155348,155350,3,5,0
44434,4,1,155349,155350,155351,1,2,0
44435,1,2,155350,155351,155353,1,3,0
44436,4,2,155354,155354,155356,0,2,1
44437,4,3,155358,155358,155361,0,3,2
44438,5,1,155363,155363,155364,0,1,2
44439,5,2,155368,155368,155370,0,2,4
44440,4,1,155372,155372,155373,0,1,2
44441,2,3,155374,155374,155377,0,3,1
44442,4,1,155378,155378,155379,0,1,1
44443,2,1,155380,155380,155381,0,1,1
44444,6,3,155386,155386,155389,0,3,5
44445,1,2,155387,155389,155391,2,4,0
44446,6,3,155393,155393,155396,0,3,2
44447,6,3,155399,155399,155402,0,3,3
44448,2,2,155401,155402,155404,1,3,0
44449,1,3,155402,155404,155407,2,5,0
44450,5,1,155407,155407,155408,0,1,0
44451,1,2,155408,155408,155410,0,2,0
44452,6,3,155414,155414,155417,0,3,4
44453,3,1,155417,155417,155418,0,1,0
44454,3,3,155420,155420,155423,0,3,2
44455,2,3,155422,155423,155426,1,4,0
44456,2,3,155424,155426,155429,2,5,0
44457,5,2,155429,155429,155431,0,2,0
44458,3,3,155432,155432,155435,0,3,1
44459,3,1,155435,155435,155436,0,1,0
44460,2,1,155437,155437,155438,0,1,1
44461,1,3,155438,155438,155441,0,3,0
44462,4,3,155442,155442,155445,0,3,1
44463,5,2,155447,155447,155449,0,2,2
44464,4,3,155451,155451,155454,0,3,2
44465,5,2,155456,155456,155458,0,2,2
44466,4,1,155460,155460,155461,0,1,2
44467,1,1,155461,155461,155462,0,1,0
44468,2,2,155463,155463,155465,0,2,1
44469,5,3,155468,155468,155471,0,3,3
44470,4,1,155472,155472,155473,0,1,1
44471,2,2,155474,155474,155476,0,2,1
44472,5,3,155479,155479,155482,0,3,3
44473,4,3,155483,155483,155486,0,3,1
44474,4,2,155487,155487,155489,0,2,1
44475,5,1,155492,155492,155493,0,1,3
44476,6,2,155498,155498,155500,0,2,5
44477,6,2,155504,155504,155506,0,2,4
44478,6,1,155510,155510,155511,0,1,4
44479,1,2,155511,155511,155513,0,2,0
44480,4,2,155515,155515,155517,0,2,2
44481,3,3,155518,155518,155521,0,3,1
44482,2,3,155520,155521,155524,1,4,0
44483,4,3,155524,155524,155527,0,3,0
44484,2,3,155526,155527,155530,1,4,0
44485,4,3,155530,155530,155533,0,3,0
44486,6,2,155536,155536,155538,0,2,3
44487,1,1,155537,155538,155539,1,2,0
44488,6,2,155543,155543,155545,0,2,4
44489,4,1,155547,155547,155548,0,1,2
44490,1,3,155548,155548,155551,0,3,0
44491,1,2,155549,155551,155553,2,4,0
44492,4,1,155553,155553,155554,0,1,0
44493,4,3,155557,155557,155560,0,3,3
44494,6,2,155563,155563,155565,0,2,3
44495,2,2,155565,155565,155567,0,2,0
44496,5,1,155570,155570,155571,0,1,3
44497,3,3,155573,155573,155576,0,3,2
44498,1,3,155574,155576,155579,2,5,0
44499,2,2,155576,155579,155581,3,5,0
44500,6,2,155582,155582,155584,0,2,1
44501,6,2,155588,155588,155590,0,2,4
44502,2,3,155590,155590,155593,0,3,0
44503,2,1,155592,155593,155594,1,2,0
44504,6,1,155598,155598,155599,0,1,4
44505,6,2,155604,155604,155606,0,2,5
44506,3,1,155607,155607,155608,0,1,1
44507,5,3,155612,155612,155615,0,3,4
44508,2,3,155614,155615,155618,1,4,0
44509,5,1,155619,155619,155620,0,1,1
44510,1,2,155620,155620,155622,0,2,0
44511,4,3,155624,155624,155627,0,3,2
44512,2,3,155626,155627,155630,1,4,0
44513,6,2,155632,155632,155634,0,2,2
44514,2,3,155634,155634,155637,0,3,0
44515,2,1,155636,155637,155638,1,2,0
44516,2,1,155638,155638,155639,0,1,0
44517,1,3,155639,155639,155642,0,3,0
44518,1,1,155640,155642,155643,2,3,0
44519,5,1,155645,155645,155646,0,1,2
44520,5,2,155650,155650,155652,0,2,4
44521,4,2,155654,155654,155656,0,2,2
44522,1,3,155655,155656,155659,1,4,0
44523,6,2,155661,155661,155663,0,2,2
44524,3,3,155664,155664,155667,0,3,1
44525,5,1,155669,155669,155670,0,1,2
44526,3,3,155672,155672,155675,0,3,2
44527,1,3,155673,155675,155678,2,5,0
44528,4,2,155677,155678,155680,1,3,0
44529,6,1,155683,155683,155684,0,1,3
44530,4,1,155687,155687,155688,0,1,3
44531,1,1,155688,155688,155689,0,1,0
44532,6,1,155694,155694,155695,0,1,5
44533,1,1,155695,155695,155696,0,1,0
44534,6,3,155701,155701,155704,0,3,5
44535,1,1,155702,155704,155705,2,3,0
44536,4,1,155706,155706,155707,0,1,1
44537,1,2,155707,155707,155709,0,2,0
44538,2,1,155709,155709,155710,0,1,0
44539,3,3,155712,155712,155715,0,3,2
44540,5,1,155717,155717,155718,0,1,2
44541,4,2,155721,155721,155723,0,2,3
44542,3,3,155724,155724,155727,0,3,1
44543,5,3,155729,155729,155732,0,3,2
44544,3,1,155732,155732,155733,0,1,0
44545,3,3,155735,155735,155738,0,3,2
44546,3,1,155738,155738,155739,0,1,0
44547,4,3,155742,155742,155745,0,3,3
44548,4,2,155746,155746,155748,0,2,1
44549,5,1,155751,155751,155752,0,1,3
44550,6,3,155757,155757,155760,0,3,5
44551,3,1,155760,155760,155761,0,1,0
44552,1,2,155761,155761,155763,0,2,0
44553,5,1,155766,155766,155767,0,1,3
44554,5,1,155771,155771,155772,0,1,4
44555,4,1,155775,155775,155776,0,1,3
44556,3,2,155778,155778,155780,0,2,2
44557,5,3,155783,155783,155786,0,3,3
44558,1,2,155784,155786,155788,2,4,0
44559,4,1,155788,155788,155789,0,1,0
44560,4,3,155792,155792,155795,0,3,3
44561,5,1,155797,155797,155798,0,1,2
44562,4,3,155801,155801,155804,0,3,3
44563,1,1,155802,155804,155805,2,3,0
44564,2,1,155804,155805,155806,1,2,0
44565,6,1,155810,155810,155811,0,1,4
44566,6,1,155816,155816,155817,0,1,5
44567,5,3,155821,155821,155824,0,3,4
44568,1,3,155822,155824,155827,2,5,0
44569,3,1,155825,155827,155828,2,3,0
44570,3,1,155828,155828,155829,0,1,0
44571,1,1,155829,155829,155830,0,1,0
44572,1,2,155830,155830,155832,0,2,0
44573,2,1,155832,155832,155833,0,1,0
44574,1,3,155833,155833,155836,0,3,0
44575,1,1,155834,155836,155837,2,3,0
44576,4,2,155838,155838,155840,0,2,1
44577,1,3,155839,155840,155843,1,4,0
44578,6,1,155845,155845,155846,0,1,2
44579,2,2,155847,155847,155849,0,2,1
44580,2,3,155849,155849,155852,0,3,0
44581,1,3,155850,155852,155855,2,5,0
44582,5,3,155855,155855,155858,0,3,0
44583,5,3,155860,155860,155863,0,3,2
44584,2,2,155862,155863,155865,1,3,0
44585,2,2,155864,155865,155867,1,3,0
44586,5,1,155869,155869,155870,0,1,2
44587,3,1,155872,155872,155873,0,1,2
44588,5,2,155877,155877,155879,0,2,4
44589,5,3,155882,155882,155885,0,3,3
44590,3,1,155885,155885,155886,0,1,0
44591,4,3,155889,155889,155892,0,3,3
44592,4,2,155893,155893,155895,0,2,1
44593,3,3,155896,155896,155899,0,3,1
44594,3,2,155899,155899,155901,0,2,0
44595,2,2,155901,155901,155903,0,2,0
44596,3,2,155904,155904,155906,0,2,1
44597,2,3,155906,155906,155909,0,3,0
44598,1,1,155907,155909,155910,2,3,0
44599,4,3,155911,155911,155914,0,3,1
44600,3,2,155914,155914,155916,0,2,0
44601,3,2,155917,155917,155919,0,2,1
44602,6,1,155923,155923,155924,0,1,4
44603,3,2,155926,155926,155928,0,2,2
44604,3,1,155929,155929,155930,0,1,1
44605,2,3,155931,155931,155934,0,3,1
44606,2,1,155933,155934,155935,1,2,0
44607,3,2,155936,155936,155938,0,2,1
44608,1,3,155937,155938,155941,1,4,0
44609,1,3,155938,155941,155944,3,6,0
44610,3,2,155941,155944,155946,3,5,0
44611,4,2,155945,155946,155948,1,3,0
44612,5,2,155950,155950,155952,0,2,2
44613,1,1,155951,155952,155953,1,2,0
44614,5,3,155956,155956,155959,0,3,3
44615,4,2,155960,155960,155962,0,2,1
44616,5,3,155965,155965,155968,0,3,3
44617,6,3,155971,155971,155974,0,3,3
44618,6,2,155977,155977,155979,0,2,3
44619,6,2,155983,155983,155985,0,2,4
44620,5,1,155988,155988,155989,0,1,3
44621,4,2,155992,155992,155994,0,2,3
44622,3,3,155995,155995,155998,0,3,1
44623,4,2,155999,155999,156001,0,2,1
44624,4,3,156003,156003,156006,0,3,2
44625,4,1,156007,156007,156008,0,1,1
44626,5,1,156012,156012,156013,0,1,4
44627,2,1,156014,156014,156015,0,1,1
44628,6,2,156020,156020,156022,0,2,5
44629,2,1,156022,156022,156023,0,1,0
44630,3,3,156025,156025,156028,0,3,2
44631,2,3,156027,156028,156031,1,4,0
44632,4,2,156031,156031,156033,0,2,0
44633,1,3,156032,156033,156036,1,4,0
44634,4,2,156036,156036,156038,0,2,0
44635,1,3,156037,156038,156041,1,4,0
44636,3,1,156040,156041,156042,1,2,0
44637,1,3,156041,156042,156045,1,4,0
44638,2,1,156043,156045,156046,2,3,0
44639,6,2,156049,156049,156051,0,2,3
44640,2,2,156051,156051,156053,0,2,0
44641,1,1,156052,156053,156054,1,2,0
44642,5,3,156057,156057,156060,0,3,3
44643,6,1,156063,156063,156064,0,1,3
44644,4,3,156067,156067,156070,0,3,3
44645,1,3,156068,156070,156073,2,5,0
44646,2,2,156070,156073,156075,3,5,0
44647,3,2,156073,156075,156077,2,4,0
44648,6,3,156079,156079,156082,0,3,2
44649,5,3,156084,156084,156087,0,3,2
44650,2,2,156086,156087,156089,1,3,0
44651,2,2,156088,156089,156091,1,3,0
44652,3,2,156091,156091,156093,0,2,0
44653,5,2,156096,156096,156098,0,2,3
44654,2,3,156098,156098,156101,0,3,0
44655,4,1,156102,156102,156103,0,1,1
44656,4,2,156106,156106,156108,0,2,3
44657,1,3,156107,156108,156111,1,4,0
44658,3,3,156110,156111,156114,1,4,0
44659,2,2,156112,156114,156116,2,4,0
44660,5,2,156117,156117,156119,0,2,1
44661,4,3,156121,156121,156124,0,3,2
44662,1,2,156122,156124,156126,2,4,0
44663,1,2,156123,156126,156128,3,5,0
44664,2,2,156125,156128,156130,3,5,0
44665,4,3,156129,156130,156133,1,4,0
44666,6,2,156135,156135,156137,0,2,2
44667,6,2,156141,156141,156143,0,2,4
44668,5,1,156146,156146,156147,0,1,3
44669,5,3,156151,156151,156154,0,3,4
44670,3,3,156154,156154,156157,0,3,0
44671,3,1,156157,156157,156158,0,1,0
44672,3,3,156160,156160,156163,0,3,2
44673,5,3,156165,156165,156168,0,3,2
44674,5,2,156170,156170,156172,0,2,2
44675,4,2,156174,156174,156176,0,2,2
44676,6,2,156180,156180,156182,0,2,4
44677,2,3,156182,156182,156185,0,3,0
44678,6,1,156188,156188,156189,0,1,3
44679,1,2,156189,156189,156191,0,2,0
44680,3,3,156192,156192,156195,0,3,1
44681,6,3,156198,156198,156201,0,3,3
44682,3,2,156201,156201,156203,0,2,0
44683,3,1,156204,156204,156205,0,1,1
44684,6,1,156210,156210,156211,0,1,5
44685,2,3,156212,156212,156215,0,3,1
44686,2,1,156214,156215,156216,1,2,0
44687,1,3,156215,156216,156219,1,4,0
44688,1,2,156216,156219,156221,3,5,0
44689,5,3,156221,156221,156224,0,3,0
44690,2,2,156223,156224,156226,1,3,0
44691,5,3,156228,156228,156231,0,3,2
44692,1,3,156229,156231,156234,2,5,0
44693,2,3,156231,156234,156237,3,6,0
44694,6,3,156237,156237,156240,0,3,0
44695,3,3,156240,156240,156243,0,3,0
44696,4,1,156244,156244,156245,0,1,1
44697,5,1,156249,156249,156250,0,1,4
44698,2,2,156251,156251,156253,0,2,1
44699,2,2,156253,156253,156255,0,2,0
44700,5,1,156258,156258,156259,0,1,3
44701,3,2,156261,156261,156263,0,2,2
44702,3,2,156264,156264,156266,0,2,1
44703,3,1,156267,156267,156268,0,1,1
44704,3,1,156270,156270,156271,0,1,2
44705,6,3,156276,156276,156279,0,3,5
44706,2,1,156278,156279,156280,1,2,0
44707,5,3,156283,156283,156286,0,3,3
44708,1,1,156284,156286,156287,2,3,0
44709,6,1,156290,156290,156291,0,1,3
44710,1,3,156291,156291,156294,0,3,0
44711,2,2,156293,156294,156296,1,3,0
44712,6,3,156299,156299,156302,0,3,3
44713,4,2,156303,156303,156305,0,2,1
44714,1,1,156304,156305,156306,1,2,0
44715,5,1,156309,156309,156310,0,1,3
44716,1,2,156310,156310,156312,0,2,0
44717,6,3,156316,156316,156319,0,3,4
44718,5,2,156321,156321,156323,0,2,2
44719,2,3,156323,156323,156326,0,3,0
44720,4,2,156327,156327,156329,0,2,1
44721,2,3,156329,156329,156332,0,3,0
44722,6,1,156335,156335,156336,0,1,3
44723,3,1,156338,156338,156339,0,1,2
44724,1,2,156339,156339,156341,0,2,0
44725,6,2,156345,156345,156347,0,2,4
44726,2,3,156347,156347,156350,0,3,0
44727,1,1,156348,156350,156351,2,3,0
44728,4,3,156352,156352,156355,0,3,1
44729,3,3,156355,156355,156358,0,3,0
44730,1,1,156356,156358,156359,2,3,0
44731,2,3,156358,156359,156362,1,4,0
44732,2,3,156360,156362,156365,2,5,0
44733,6,1,156366,156366,156367,0,1,1
44734,2,1,156368,156368,156369,0,1,1
44735,6,1,156374,156374,156375,0,1,5
44736,3,1,156377,156377,156378,0,1,2
44737,2,2,156379,156379,156381,0,2,1
44738,5,3,156384,156384,156387,0,3,3
44739,4,2,156388,156388,156390,0,2,1
44740,3,1,156391,156391,156392,0,1,1
44741,6,3,156397,156397,156400,0,3,5
44742,2,2,156399,156400,156402,1,3,0
44743,6,1,156405,156405,156406,0,1,3
44744,1,2,156406,156406,156408,0,2,0
44745,1,2,156407,156408,156410,1,3,0
44746,4,1,156411,156411,156412,0,1,1
44747,5,1,156416,156416,156417,0,1,4
44748,5,1,156421,156421,156422,0,1,4
44749,6,1,156427,156427,156428,0,1,5
44750,6,2,156433,156433,156435,0,2,5
44751,2,2,156435,156435,156437,0,2,0
44752,3,2,156438,156438,156440,0,2,1
44753,4,1,156442,156442,156443,0,1,2
44754,1,1,156443,156443,156444,0,1,0
44755,5,1,156448,156448,156449,0,1,4
44756,4,2,156452,156452,156454,0,2,3
44757,6,1,156458,156458,156459,0,1,4
44758,1,1,156459,156459,156460,0,1,0
44759,2,2,156461,156461,156463,0,2,1
44760,2,2,156463,156463,156465,0,2,0
44761,3,3,156466,156466,156469,0,3,1
44762,5,3,156471,156471,156474,0,3,2
44763,1,2,156472,156474,156476,2,4,0
44764,2,2,156474,156476,156478,2,4,0
44765,5,1,156479,156479,156480,0,1,1
44766,1,1,156480,156480,156481,0,1,0
44767,3,1,156483,156483,156484,0,1,2
44768,2,2,156485,156485,156487,0,2,1
44769,3,1,156488,156488,156489,0,1,1
44770,4,3,156492,156492,156495,0,3,3
44771,4,2,156496,156496,156498,0,2,1
44772,2,1,156498,156498,156499,0,1,0
44773,5,2,156503,156503,156505,0,2,4
44774,2,3,156505,156505,156508,0,3,0
44775,6,2,156511,156511,156513,0,2,3
44776,6,3,156517,156517,156520,0,3,4
44777,1,2,156518,156520,156522,2,4,0
44778,2,1,156520,156522,156523,2,3,0
44779,5,2,156525,156525,156527,0,2,2
44780,5,3,156530,156530,156533,0,3,3
44781,2,1,156532,156533,156534,1,2,0
44782,1,3,156533,156534,156537,1,4,0
44783,2,3,156535,156537,156540,2,5,0
44784,1,2,156536,156540,156542,4,6,0
44785,4,1,156540,156542,156543,2,3,0
44786,4,3,156544,156544,156547,0,3,1
44787,1,2,156545,156547,156549,2,4,0
44788,2,1,156547,156549,156550,2,3,0
44789,5,2,156552,156552,156554,0,2,2
44790,6,1,156558,156558,156559,0,1,4
44791,2,2,156560,156560,156562,0,2,1
44792,4,2,156564,156564,156566,0,2,2
44793,3,1,156567,156567,156568,0,1,1
44794,5,3,156572,156572,156575,0,3,4
44795,2,1,156574,156575,156576,1,2,0
44796,4,1,156578,156578,156579,0,1,2
44797,6,3,156584,156584,156587,0,3,5
44798,3,2,156587,156587,156589,0,2,0
44799,5,1,156592,156592,156593,0,1,3
44800,4,1,156596,156596,156597,0,1,3
44801,1,1,156597,156597,156598,0,1,0
44802,6,1,156603,156603,156604,0,1,5
44803,1,3,156604,156604,156607,0,3,0
44804,6,1,156610,156610,156611,0,1,3
44805,5,1,156615,156615,156616,0,1,4
44806,4,2,156619,156619,156621,0,2,3
44807,6,3,156625,156625,156628,0,3,4
44808,1,1,156626,156628,156629,2,3,0
44809,6,1,156632,156632,156633,0,1,3
44810,6,3,156638,156638,156641,0,3,5
44811,2,3,156640,156641,156644,1,4,0
44812,5,3,156645,156645,156648,0,3,1
44813,3,1,156648,156648,156649,0,1,0
44814,6,3,156654,156654,156657,0,3,5
44815,4,3,156658,156658,156661,0,3,1
44816,4,1,156662,156662,156663,0,1,1
44817,3,3,156665,156665,156668,0,3,2
44818,4,1,156669,156669,156670,0,1,1
44819,1,1,156670,156670,156671,0,1,0
44820,5,3,156675,156675,156678,0,3,4
44821,2,1,156677,156678,156679,1,2,0
44822,4,1,156681,156681,156682,0,1,2
44823,5,3,156686,156686,156689,0,3,4
44824,1,1,156687,156689,156690,2,3,0
44825,2,1,156689,156690,156691,1,2,0
44826,3,1,156692,156692,156693,0,1,1
44827,4,2,156696,156696,156698,0,2,3
44828,1,1,156697,156698,156699,1,2,0
44829,6,1,156703,156703,156704,0,1,4
44830,6,2,156709,156709,156711,0,2,5
44831,3,1,156712,156712,156713,0,1,1
44832,4,2,156716,156716,156718,0,2,3
44833,3,1,156719,156719,156720,0,1,1
44834,3,1,156722,156722,156723,0,1,2
44835,1,3,156723,156723,156726,0,3,0
44836,3,1,156726,156726,156727,0,1,0
44837,5,2,156731,156731,156733,0,2,4
44838,2,3,156733,156733,156736,0,3,0
44839,6,1,156739,156739,156740,0,1,3
44840,4,3,156743,156743,156746,0,3,3
44841,4,1,156747,156747,156748,0,1,1
44842,4,3,156751,156751,156754,0,3,3
44843,3,2,156754,156754,156756,0,2,0
44844,4,3,156758,156758,156761,0,3,2
44845,3,3,156761,156761,156764,0,3,0
44846,2,2,156763,156764,156766,1,3,0
44847,4,1,156767,156767,156768,0,1,1
44848,3,3,156770,156770,156773,0,3,2
44849,6,2,156776,156776,156778,0,2,3
44850,5,2,156781,156781,156783,0,2,3
44851,2,1,156783,156783,156784,0,1,0
44852,5,3,156788,156788,156791,0,3,4
44853,3,1,156791,156791,156792,0,1,0
44854,5,1,156796,156796,156797,0,1,4
44855,6,3,156802,156802,156805,0,3,5
44856,5,1,156807,156807,156808,0,1,2
44857,2,3,156809,156809,156812,0,3,1
44858,4,2,156813,156813,156815,0,2,1
44859,4,1,156817,156817,156818,0,1,2
44860,1,2,156818,156818,156820,0,2,0
44861,3,1,156821,156821,156822,0,1,1
44862,5,1,156826,156826,156827,0,1,4
44863,1,1,156827,156827,156828,0,1,0
44864,6,3,156833,156833,156836,0,3,5
44865,2,3,156835,156836,156839,1,4,0
44866,2,2,156837,156839,156841,2,4,0
44867,4,1,156841,156841,156842,0,1,0
44868,5,2,156846,156846,156848,0,2,4
44869,3,3,156849,156849,156852,0,3,1
44870,1,1,156850,156852,156853,2,3,0
44871,4,3,156854,156854,156857,0,3,1
44872,2,3,156856,156857,156860,1,4,0
44873,4,3,156860,156860,156863,0,3,0
44874,4,3,156864,156864,156867,0,3,1
44875,2,3,156866,156867,156870,1,4,0
44876,1,1,156867,156870,156871,3,4,0
44877,3,2,156870,156871,156873,1,3,0
44878,4,2,156874,156874,156876,0,2,1
44879,4,2,156878,156878,156880,0,2,2
44880,1,2,156879,156880,156882,1,3,0
44881,6,3,156885,156885,156888,0,3,3
44882,6,2,156891,156891,156893,0,2,3
44883,1,2,156892,156893,156895,1,3,0
44884,6,3,156898,156898,156901,0,3,3
44885,6,3,156904,156904,156907,0,3,3
44886,4,2,156908,156908,156910,0,2,1
44887,6,3,156914,156914,156917,0,3,4
44888,2,2,156916,156917,156919,1,3,0
44889,2,2,156918,156919,156921,1,3,0
44890,3,1,156921,156921,156922,0,1,0
44891,4,3,156925,156925,156928,0,3,3
44892,2,2,156927,156928,156930,1,3,0
44893,5,3,156932,156932,156935,0,3,2
44894,4,3,156936,156936,156939,0,3,1
44895,1,3,156937,156939,156942,2,5,0
44896,2,1,156939,156942,156943,3,4,0
44897,2,1,156941,156943,156944,2,3,0
44898,2,1,156943,156944,156945,1,2,0
44899,1,3,156944,156945,156948,1,4,0
44900,5,1,156949,156949,156950,0,1,1
44901,6,2,156955,156955,156957,0,2,5
44902,4,2,156959,156959,156961,0,2,2
44903,5,3,156964,156964,156967,0,3,3
44904,2,2,156966,156967,156969,1,3,0
44905,6,3,156972,156972,156975,0,3,3
44906,2,2,156974,156975,156977,1,3,0
44907,5,1,156979,156979,156980,0,1,2
44908,4,3,156983,156983,156986,0,3,3
44909,5,3,156988,156988,156991,0,3,2
44910,5,1,156993,156993,156994,0,1,2
44911,6,3,156999,156999,157002,0,3,5
44912,1,2,157000,157002,157004,2,4,0
44913,6,1,157006,157006,157007,0,1,2
44914,3,3,157009,157009,157012,0,3,2
44915,5,1,157014,157014,157015,0,1,2
44916,3,3,157017,157017,157020,0,3,2
44917,3,1,157020,157020,157021,0,1,0
44918,6,3,157026,157026,157029,0,3,5
44919,4,1,157030,157030,157031,0,1,1
44920,3,2,157033,157033,157035,0,2,2
44921,2,3,157035,157035,157038,0,3,0
44922,1,2,157036,157038,157040,2,4,0
44923,6,3,157042,157042,157045,0,3,2
44924,1,1,157043,157045,157046,2,3,0
44925,1,1,157044,157046,157047,2,3,0
44926,2,3,157046,157047,157050,1,4,0
44927,5,2,157051,157051,157053,0,2,1
44928,4,1,157055,157055,157056,0,1,2
44929,4,1,157059,157059,157060,0,1,3
44930,3,3,157062,157062,157065,0,3,2
44931,3,1,157065,157065,157066,0,1,0
44932,5,1,157070,157070,157071,0,1,4
44933,4,3,157074,157074,157077,0,3,3
44934,1,3,157075,157077,157080,2,5,0
44935,1,1,157076,157080,157081,4,5,0
44936,4,3,157080,157081,157084,1,4,0
44937,6,3,157086,157086,157089,0,3,2
44938,4,2,157090,157090,157092,0,2,1
44939,3,3,157093,157093,157096,0,3,1
44940,6,3,157099,157099,157102,0,3,3
44941,1,3,157100,157102,157105,2,5,0
44942,4,3,157104,157105,157108,1,4,0
44943,2,3,157106,157108,157111,2,5,0
44944,2,3,157108,157111,157114,3,6,0
44945,6,3,157114,157114,157117,0,3,0
44946,4,3,157118,157118,157121,0,3,1
44947,6,1,157124,157124,157125,0,1,3
44948,4,1,157128,157128,157129,0,1,3
44949,3,3,157131,157131,157134,0,3,2
44950,6,3,157137,157137,157140,0,3,3
44951,5,2,157142,157142,157144,0,2,2
44952,6,3,157148,157148,157151,0,3,4
44953,2,3,157150,157151,157154,1,4,0
44954,6,1,157156,157156,157157,0,1,2
44955,4,3,157160,157160,157163,0,3,3
44956,5,1,157165,157165,157166,0,1,2
44957,6,2,157171,157171,157173,0,2,5
44958,5,3,157176,157176,157179,0,3,3
44959,1,2,157177,157179,157181,2,4,0
44960,3,3,157180,157181,157184,1,4,0
44961,6,1,157186,157186,157187,0,1,2
44962,3,2,157189,157189,157191,0,2,2
44963,4,2,157193,157193,157195,0,2,2
44964,3,1,157196,157196,157197,0,1,1
44965,6,1,157202,157202,157203,0,1,5
44966,6,1,157208,157208,157209,0,1,5
44967,1,3,157209,157209,157212,0,3,0
44968,6,3,157215,157215,157218,0,3,3
44969,2,3,157217,157218,157221,1,4,0
44970,6,2,157223,157223,157225,0,2,2
44971,1,3,157224,157225,157228,1,4,0
44972,6,2,157230,157230,157232,0,2,2
44973,1,3,157231,157232,157235,1,4,0
44974,1,3,157232,157235,157238,3,6,0
44975,6,2,157238,157238,157240,0,2,0
44976,5,2,157243,157243,157245,0,2,3
44977,5,3,157248,157248,157251,0,3,3
44978,3,2,157251,157251,157253,0,2,0
44979,1,2,157252,157253,157255,1,3,0
44980,5,2,157257,157257,157259,0,2,2
44981,6,2,157263,157263,157265,0,2,4
44982,5,1,157268,157268,157269,0,1,3
44983,6,1,157274,157274,157275,0,1,5
44984,4,3,157278,157278,157281,0,3,3
44985,2,1,157280,157281,157282,1,2,0
44986,2,1,157282,157282,157283,0,1,0
44987,1,1,157283,157283,157284,0,1,0
44988,4,3,157287,157287,157290,0,3,3
44989,4,1,157291,157291,157292,0,1,1
44990,6,1,157297,157297,157298,0,1,5
44991,4,2,157301,157301,157303,0,2,3
44992,3,1,157304,157304,157305,0,1,1
44993,4,3,157308,157308,157311,0,3,3
44994,1,1,157309,157311,157312,2,3,0
44995,1,2,157310,157312,157314,2,4,0
44996,6,2,157316,157316,157318,0,2,2
44997,2,1,157318,157318,157319,0,1,0
44998,3,3,157321,157321,157324,0,3,2
44999,4,2,157325,157325,157327,0,2,1
45000,6,1,157331,157331,157332,0,1,4
45001,3,1,157334,157334,157335,0,1,2
45002,1,3,157335,157335,157338,0,3,0
45003,2,2,157337,157338,157340,1,3,0
45004,3,2,157340,157340,157342,0,2,0
45005,4,1,157344,157344,157345,0,1,2
45006,2,1,157346,157346,157347,0,1,1
45007,2,2,157348,157348,157350,0,2,1
45008,3,1,157351,157351,157352,0,1,1
45009,2,1,157353,157353,157354,0,1,1
45010,2,1,157355,157355,157356,0,1,1
45011,3,1,157358,157358,157359,0,1,2
45012,5,3,157363,157363,157366,0,3,4
45013,2,2,157365,157366,157368,1,3,0
45014,6,1,157371,157371,157372,0,1,3
45015,2,3,157373,157373,157376,0,3,1
45016,1,1,157374,157376,157377,2,3,0
45017,1,3,157375,157377,157380,2,5,0
45018,1,2,157376,157380,157382,4,6,0
45019,5,2,157381,157382,157384,1,3,0
45020,6,2,157387,157387,157389,0,2,3
45021,2,1,157389,157389,157390,0,1,0
45022,2,1,157391,157391,157392,0,1,1
45023,1,2,157392,157392,157394,0,2,0
45024,3,1,157395,157395,157396,0,1,1
45025,6,2,157401,157401,157403,0,2,5
45026,5,1,157406,157406,157407,0,1,3
45027,1,2,157407,157407,157409,0,2,0
45028,1,1,157408,157409,157410,1,2,0
45029,5,2,157413,157413,157415,0,2,3
45030,4,2,157417,157417,157419,0,2,2
45031,4,2,157421,157421,157423,0,2,2
45032,5,2,157426,157426,157428,0,2,3
45033,1,2,157427,157428,157430,1,3,0
45034,4,1,157431,157431,157432,0,1,1
45035,4,2,157435,157435,157437,0,2,3
45036,1,2,157436,157437,157439,1,3,0
45037,5,2,157441,157441,157443,0,2,2
45038,1,3,157442,157443,157446,1,4,0
45039,2,2,157444,157446,157448,2,4,0
45040,6,1,157450,157450,157451,0,1,2
45041,4,3,157454,157454,157457,0,3,3
45042,6,3,157460,157460,157463,0,3,3
45043,2,2,157462,157463,157465,1,3,0
45044,4,2,157466,157466,157468,0,2,1
45045,1,2,157467,157468,157470,1,3,0
45046,6,1,157473,157473,157474,0,1,3
45047,1,3,157474,157474,157477,0,3,0
45048,3,2,157477,157477,157479,0,2,0
45049,5,3,157482,157482,157485,0,3,3
45050,6,1,157488,157488,157489,0,1,3
45051,1,2,157489,157489,157491,0,2,0
45052,5,2,157494,157494,157496,0,2,3
45053,1,3,157495,157496,157499,1,4,0
45054,6,3,157501,157501,157504,0,3,2
45055,6,3,157507,157507,157510,0,3,3
45056,2,2,157509,157510,157512,1,3,0
45057,3,1,157512,157512,157513,0,1,0
45058,3,1,157515,157515,157516,0,1,2
45059,1,1,157516,157516,157517,0,1,0
45060,6,1,157522,157522,157523,0,1,5
45061,3,1,157525,157525,157526,0,1,2
45062,5,1,157530,157530,157531,0,1,4
45063,3,2,157533,157533,157535,0,2,2
45064,2,1,157535,157535,157536,0,1,0
45065,5,2,157540,157540,157542,0,2,4
45066,1,1,157541,157542,157543,1,2,0
45067,2,3,157543,157543,157546,0,3,0
45068,4,2,157547,157547,157549,0,2,1
45069,5,1,157552,157552,157553,0,1,3
45070,6,3,157558,157558,157561,0,3,5
45071,6,2,157564,157564,157566,0,2,3
45072,2,3,157566,157566,157569,0,3,0
45073,6,3,157572,157572,157575,0,3,3
45074,3,2,157575,157575,157577,0,2,0
45075,4,1,157579,157579,157580,0,1,2
45076,2,1,157581,157581,157582,0,1,1
45077,3,1,157584,157584,157585,0,1,2
45078,4,1,157588,157588,157589,0,1,3
45079,6,3,157594,157594,157597,0,3,5
45080,4,1,157598,157598,157599,0,1,1
45081,6,1,157604,157604,157605,0,1,5
45082,4,2,157608,157608,157610,0,2,3
45083,2,3,157610,157610,157613,0,3,0
45084,1,2,157611,157613,157615,2,4,0
45085,3,3,157614,157615,157618,1,4,0
45086,6,2,157620,157620,157622,0,2,2
45087,4,2,157624,157624,157626,0,2,2
45088,4,2,157628,157628,157630,0,2,2
45089,2,1,157630,157630,157631,0,1,0
45090,2,1,157632,157632,157633,0,1,1
45091,6,3,157638,157638,157641,0,3,5
45092,1,2,157639,157641,157643,2,4,0
45093,1,1,157640,157643,157644,3,4,0
45094,2,1,157642,157644,157645,2,3,0
45095,2,1,157644,157645,157646,1,2,0
45096,2,3,157646,157646,157649,0,3,0
45097,5,3,157651,157651,157654,0,3,2
45098,4,3,157655,157655,157658,0,3,1
45099,3,2,157658,157658,157660,0,2,0
45100,6,1,157664,157664,157665,0,1,4
45101,1,3,157665,157665,157668,0,3,0
45102,3,2,157668,157668,157670,0,2,0
45103,2,2,157670,157670,157672,0,2,0
45104,2,2,157672,157672,157674,0,2,0
45105,2,3,157674,157674,157677,0,3,0
45106,3,3,157677,157677,157680,0,3,0
45107,2,1,157679,157680,157681,1,2,0
45108,2,3,157681,157681,157684,0,3,0
45109,6,1,157687,157687,157688,0,1,3
45110,2,1,157689,157689,157690,0,1,1
45111,4,3,157693,157693,157696,0,3,3
45112,1,3,157694,157696,157699,2,5,0
45113,4,3,157698,157699,157702,1,4,0
45114,4,2,157702,157702,157704,0,2,0
45115,1,1,157703,157704,157705,1,2,0
45116,4,2,157707,157707,157709,0,2,2
45117,6,2,157713,157713,157715,0,2,4
45118,1,3,157714,157715,157718,1,4,0
45119,5,1,157719,157719,157720,0,1,1
45120,2,3,157721,157721,157724,0,3,1
45121,3,2,157724,157724,157726,0,2,0
45122,2,1,157726,157726,157727,0,1,0
45123,1,3,157727,157727,157730,0,3,0
45124,4,3,157731,157731,157734,0,3,1
45125,3,1,157734,157734,157735,0,1,0
45126,2,3,157736,157736,157739,0,3,1
45127,6,1,157742,157742,157743,0,1,3
45128,4,2,157746,157746,157748,0,2,3
45129,4,1,157750,157750,157751,0,1,2
45130,6,2,157756,157756,157758,0,2,5
45131,5,3,157761,157761,157764,0,3,3
45132,1,3,157762,157764,157767,2,5,0
45133,2,1,157764,157767,157768,3,4,0
45134,3,2,157767,157768,157770,1,3,0
45135,4,1,157771,157771,157772,0,1,1
45136,3,2,157774,157774,157776,0,2,2
45137,6,2,157780,157780,157782,0,2,4
45138,3,1,157783,157783,157784,0,1,1
45139,6,1,157789,157789,157790,0,1,5
45140,5,3,157794,157794,157797,0,3,4
45141,3,1,157797,157797,157798,0,1,0
45142,2,3,157799,157799,157802,0,3,1
45143,6,2,157805,157805,157807,0,2,3
45144,4,1,157809,157809,157810,0,1,2
45145,4,3,157813,157813,157816,0,3,3
45146,1,3,157814,157816,157819,2,5,0
45147,5,2,157819,157819,157821,0,2,0
45148,3,1,157822,157822,157823,0,1,1
45149,3,3,157825,157825,157828,0,3,2
45150,4,3,157829,157829,157832,0,3,1
45151,5,2,157834,157834,157836,0,2,2
45152,3,3,157837,157837,157840,0,3,1
45153,6,1,157843,157843,157844,0,1,3
45154,3,2,157846,157846,157848,0,2,2
45155,1,2,157847,157848,157850,1,3,0
45156,3,2,157850,157850,157852,0,2,0
45157,4,1,157854,157854,157855,0,1,2
45158,6,3,157860,157860,157863,0,3,5
45159,5,3,157865,157865,157868,0,3,2
45160,6,1,157871,157871,157872,0,1,3
45161,2,3,157873,157873,157876,0,3,1
45162,1,2,157874,157876,157878,2,4,0
45163,4,3,157878,157878,157881,0,3,0
45164,6,3,157884,157884,157887,0,3,3
45165,5,1,157889,157889,157890,0,1,2
45166,1,2,157890,157890,157892,0,2,0
45167,1,1,157891,157892,157893,1,2,0
45168,1,2,157892,157893,157895,1,3,0
45169,4,3,157896,157896,157899,0,3,1
45170,6,1,157902,157902,157903,0,1,3
45171,4,2,157906,157906,157908,0,2,3
45172,4,2,157910,157910,157912,0,2,2
45173,3,1,157913,157913,157914,0,1,1
45174,4,2,157917,157917,157919,0,2,3
45175,1,3,157918,157919,157922,1,4,0
45176,6,1,157924,157924,157925,0,1,2
45177,1,3,157925,157925,157928,0,3,0
45178,4,1,157929,157929,157930,0,1,1
45179,6,1,157935,157935,157936,0,1,5
45180,3,3,157938,157938,157941,0,3,2
45181,3,3,157941,157941,157944,0,3,0
45182,3,2,157944,157944,157946,0,2,0
45183,4,2,157948,157948,157950,0,2,2
45184,3,1,157951,157951,157952,0,1,1
45185,4,2,157955,157955,157957,0,2,3
45186,2,1,157957,157957,157958,0,1,0
45187,3,3,157960,157960,157963,0,3,2
45188,1,3,157961,157963,157966,2,5,0
45189,2,1,157963,157966,157967,3,4,0
45190,2,1,157965,157967,157968,2,3,0
45191,6,1,157971,157971,157972,0,1,3
45192,4,3,157975,157975,157978,0,3,3
45193,4,3,157979,157979,157982,0,3,1
45194,2,2,157981,157982,157984,1,3,0
45195,5,2,157986,157986,157988,0,2,2
45196,6,1,157992,157992,157993,0,1,4
45197,1,2,157993,157993,157995,0,2,0
45198,6,1,157999,157999,158000,0,1,4
45199,4,1,158003,158003,158004,0,1,3
45200,2,2,158005,158005,158007,0,2,1
45201,5,3,158010,158010,158013,0,3,3
45202,1,1,158011,158013,158014,2,3,0
45203,6,2,158017,158017,158019,0,2,3
45204,5,3,158022,158022,158025,0,3,3
45205,6,1,158028,158028,158029,0,1,3
45206,5,2,158033,158033,158035,0,2,4
45207,6,3,158039,158039,158042,0,3,4
45208,1,3,158040,158042,158045,2,5,0
45209,5,2,158045,158045,158047,0,2,0
45210,3,1,158048,158048,158049,0,1,1
45211,5,1,158053,158053,158054,0,1,4
45212,3,3,158056,158056,158059,0,3,2
45213,4,1,158060,158060,158061,0,1,1
45214,3,3,158063,158063,158066,0,3,2
45215,6,3,158069,158069,158072,0,3,3
45216,2,1,158071,158072,158073,1,2,0
45217,3,3,158074,158074,158077,0,3,1
45218,4,1,158078,158078,158079,0,1,1
45219,1,3,158079,158079,158082,0,3,0
45220,1,2,158080,158082,158084,2,4,0
45221,1,1,158081,158084,158085,3,4,0
45222,6,1,158087,158087,158088,0,1,2
45223,2,1,158089,158089,158090,0,1,1
45224,2,3,158091,158091,158094,0,3,1
45225,2,3,158093,158094,158097,1,4,0
45226,3,3,158096,158097,158100,1,4,0
45227,6,3,158102,158102,158105,0,3,2
45228,1,1,158103,158105,158106,2,3,0
45229,1,1,158104,158106,158107,2,3,0
45230,5,2,158109,158109,158111,0,2,2
45231,6,2,158115,158115,158117,0,2,4
45232,6,3,158121,158121,158124,0,3,4
45233,5,2,158126,158126,158128,0,2,2
45234,3,2,158129,158129,158131,0,2,1
45235,3,2,158132,158132,158134,0,2,1
45236,3,2,158135,158135,158137,0,2,1
45237,2,2,158137,158137,158139,0,2,0
45238,6,3,158143,158143,158146,0,3,4
45239,5,1,158148,158148,158149,0,1,2
45240,3,3,158151,158151,158154,0,3,2
45241,2,3,158153,158154,158157,1,4,0
45242,1,3,158154,158157,158160,3,6,0
45243,1,2,158155,158160,158162,5,7,0
45244,4,1,158159,158162,158163,3,4,0
45245,6,2,158165,158165,158167,0,2,2
45246,2,1,158167,158167,158168,0,1,0
45247,6,2,158173,158173,158175,0,2,5
45248,4,3,158177,158177,158180,0,3,2
45249,4,1,158181,158181,158182,0,1,1
45250,4,1,158185,158185,158186,0,1,3
45251,2,2,158187,158187,158189,0,2,1
45252,3,3,158190,158190,158193,0,3,1
45253,3,1,158193,158193,158194,0,1,0
45254,4,2,158197,158197,158199,0,2,3
45255,3,2,158200,158200,158202,0,2,1
45256,5,3,158205,158205,158208,0,3,3
45257,3,1,158208,158208,158209,0,1,0
45258,3,1,158211,158211,158212,0,1,2
45259,5,2,158216,158216,158218,0,2,4
45260,4,1,158220,158220,158221,0,1,2
45261,5,1,158225,158225,158226,0,1,4
45262,5,2,158230,158230,158232,0,2,4
45263,3,2,158233,158233,158235,0,2,1
45264,1,1,158234,158235,158236,1,2,0
45265,5,1,158239,158239,158240,0,1,3
45266,1,2,158240,158240,158242,0,2,0
45267,3,1,158243,158243,158244,0,1,1
45268,3,1,158246,158246,158247,0,1,2
45269,3,3,158249,158249,158252,0,3,2
45270,5,1,158254,158254,158255,0,1,2
45271,6,3,158260,158260,158263,0,3,5
45272,4,2,158264,158264,158266,0,2,1
45273,6,3,158270,158270,158273,0,3,4
45274,6,3,158276,158276,158279,0,3,3
45275,2,1,158278,158279,158280,1,2,0
45276,2,2,158280,158280,158282,0,2,0
45277,1,1,158281,158282,158283,1,2,0
45278,2,2,158283,158283,158285,0,2,0
45279,3,2,158286,158286,158288,0,2,1
45280,5,2,158291,158291,158293,0,2,3
45281,3,2,158294,158294,158296,0,2,1
45282,1,1,158295,158296,158297,1,2,0
45283,1,3,158296,158297,158300,1,4,0
45284,1,2,158297,158300,158302,3,5,0
45285,4,2,158301,158302,158304,1,3,0
45286,6,1,158307,158307,158308,0,1,3
45287,1,2,158308,158308,158310,0,2,0
45288,3,1,158311,158311,158312,0,1,1
45289,4,2,158315,158315,158317,0,2,3
45290,5,1,158320,158320,158321,0,1,3
45291,6,2,158326,158326,158328,0,2,5
45292,6,1,158332,158332,158333,0,1,4
45293,6,1,158338,158338,158339,0,1,5
45294,6,1,158344,158344,158345,0,1,5
45295,6,3,158350,158350,158353,0,3,5
45296,4,2,158354,158354,158356,0,2,1
45297,4,2,158358,158358,158360,0,2,2
45298,2,2,158360,158360,158362,0,2,0
45299,3,2,158363,158363,158365,0,2,1
45300,1,1,158364,158365,158366,1,2,0
45301,1,2,158365,158366,158368,1,3,0
45302,3,3,158368,158368,158371,0,3,0
45303,5,3,158373,158373,158376,0,3,2
45304,5,1,158378,158378,158379,0,1,2
45305,4,3,158382,158382,158385,0,3,3
45306,5,1,158387,158387,158388,0,1,2
45307,3,3,158390,158390,158393,0,3,2
45308,3,3,158393,158393,158396,0,3,0
45309,3,2,158396,158396,158398,0,2,0
45310,2,2,158398,158398,158400,0,2,0
45311,1,1,158399,158400,158401,1,2,0
45312,2,2,158401,158401,158403,0,2,0
45313,4,3,158405,158405,158408,0,3,2
45314,6,3,158411,158411,158414,0,3,3
45315,1,2,158412,158414,158416,2,4,0
45316,6,2,158418,158418,158420,0,2,2
45317,2,1,158420,158420,158421,0,1,0
45318,3,1,158423,158423,158424,0,1,2
45319,6,3,158429,158429,158432,0,3,5
45320,5,1,158434,158434,158435,0,1,2
45321,3,2,158437,158437,158439,0,2,2
45322,1,3,158438,158439,158442,1,4,0
45323,5,2,158443,158443,158445,0,2,1
45324,3,1,158446,158446,158447,0,1,1
45325,1,3,158447,158447,158450,0,3,0
45326,3,1,158450,158450,158451,0,1,0
45327,5,2,158455,158455,158457,0,2,4
45328,2,1,158457,158457,158458,0,1,0
45329,1,2,158458,158458,158460,0,2,0
45330,2,3,158460,158460,158463,0,3,0
45331,1,3,158461,158463,158466,2,5,0
45332,6,2,158467,158467,158469,0,2,1
45333,5,2,158472,158472,158474,0,2,3
45334,3,2,158475,158475,158477,0,2,1
45335,6,1,158481,158481,158482,0,1,4
45336,6,3,158487,158487,158490,0,3,5
45337,1,2,158488,158490,158492,2,4,0
45338,5,1,158493,158493,158494,0,1,1
45339,2,2,158495,158495,158497,0,2,1
45340,1,2,158496,158497,158499,1,3,0
45341,2,1,158498,158499,158500,1,2,0
45342,1,3,158499,158500,158503,1,4,0
45343,3,1,158502,158503,158504,1,2,0
45344,3,1,158505,158505,158506,0,1,1
45345,2,1,158507,158507,158508,0,1,1
45346,2,1,158509,158509,158510,0,1,1
45347,2,1,158511,158511,158512,0,1,1
45348,5,3,158516,158516,158519,0,3,4
45349,4,1,158520,158520,158521,0,1,1
45350,1,1,158521,158521,158522,0,1,0
45351,3,3,158524,158524,158527,0,3,2
45352,1,2,158525,158527,158529,2,4,0
45353,4,3,158529,158529,158532,0,3,0
45354,4,2,158533,158533,158535,0,2,1
45355,3,2,158536,158536,158538,0,2,1
45356,1,1,158537,158538,158539,1,2,0
45357,5,3,158542,158542,158545,0,3,3
45358,2,3,158544,158545,158548,1,4,0
45359,2,1,158546,158548,158549,2,3,0
45360,6,3,158552,158552,158555,0,3,3
45361,2,1,158554,158555,158556,1,2,0
45362,3,1,158557,158557,158558,0,1,1
45363,4,1,158561,158561,158562,0,1,3
45364,5,1,158566,158566,158567,0,1,4
45365,5,1,158571,158571,158572,0,1,4
45366,1,3,158572,158572,158575,0,3,0
45367,3,1,158575,158575,158576,0,1,0
45368,1,2,158576,158576,158578,0,2,0
45369,2,2,158578,158578,158580,0,2,0
45370,3,1,158581,158581,158582,0,1,1
45371,6,1,158587,158587,158588,0,1,5
45372,3,2,158590,158590,158592,0,2,2
45373,3,3,158593,158593,158596,0,3,1
45374,4,2,158597,158597,158599,0,2,1
45375,4,3,158601,158601,158604,0,3,2
45376,4,1,158605,158605,158606,0,1,1
45377,4,2,158609,158609,158611,0,2,3
45378,3,3,158612,158612,158615,0,3,1
45379,2,2,158614,158615,158617,1,3,0
45380,4,1,158618,158618,158619,0,1,1
45381,4,3,158622,158622,158625,0,3,3
45382,3,3,158625,158625,158628,0,3,0
45383,3,2,158628,158628,158630,0,2,0
45384,1,1,158629,158630,158631,1,2,0
45385,6,2,158635,158635,158637,0,2,4
45386,5,3,158640,158640,158643,0,3,3
45387,4,1,158644,158644,158645,0,1,1
45388,2,2,158646,158646,158648,0,2,1
45389,3,2,158649,158649,158651,0,2,1
45390,2,3,158651,158651,158654,0,3,0
45391,3,3,158654,158654,158657,0,3,0
45392,2,3,158656,158657,158660,1,4,0
45393,4,3,158660,158660,158663,0,3,0
45394,1,1,158661,158663,158664,2,3,0
45395,1,1,158662,158664,158665,2,3,0
45396,2,3,158664,158665,158668,1,4,0
45397,2,3,158666,158668,158671,2,5,0
45398,2,1,158668,158671,158672,3,4,0
45399,3,3,158671,158672,158675,1,4,0
45400,2,2,158673,158675,158677,2,4,0
45401,2,3,158675,158677,158680,2,5,0
45402,6,3,158681,158681,158684,0,3,1
45403,4,2,158685,158685,158687,0,2,1
45404,5,3,158690,158690,158693,0,3,3
45405,2,2,158692,158693,158695,1,3,0
45406,4,3,158696,158696,158699,0,3,1
45407,1,1,158697,158699,158700,2,3,0
45408,4,1,158701,158701,158702,0,1,1
45409,3,2,158704,158704,158706,0,2,2
45410,1,1,158705,158706,158707,1,2,0
45411,1,1,158706,158707,158708,1,2,0
45412,5,2,158711,158711,158713,0,2,3
45413,5,3,158716,158716,158719,0,3,3
45414,5,3,158721,158721,158724,0,3,2
45415,1,1,158722,158724,158725,2,3,0
45416,6,2,158728,158728,158730,0,2,3
45417,4,2,158732,158732,158734,0,2,2
45418,1,1,158733,158734,158735,1,2,0
45419,4,1,158737,158737,158738,0,1,2
45420,3,2,158740,158740,158742,0,2,2
45421,3,1,158743,158743,158744,0,1,1
45422,1,2,158744,158744,158746,0,2,0
45423,2,3,158746,158746,158749,0,3,0
45424,5,2,158751,158751,158753,0,2,2
45425,5,2,158756,158756,158758,0,2,3
45426,4,3,158760,158760,158763,0,3,2
45427,3,3,158763,158763,158766,0,3,0
45428,6,1,158769,158769,158770,0,1,3
45429,1,2,158770,158770,158772,0,2,0
45430,5,3,158775,158775,158778,0,3,3
45431,4,1,158779,158779,158780,0,1,1
45432,1,3,158780,158780,158783,0,3,0
45433,6,2,158786,158786,158788,0,2,3
45434,6,3,158792,158792,158795,0,3,4
45435,1,1,158793,158795,158796,2,3,0
45436,4,3,158797,158797,158800,0,3,1
45437,3,3,158800,158800,158803,0,3,0
45438,5,3,158805,158805,158808,0,3,2
45439,5,3,158810,158810,158813,0,3,2
45440,5,3,158815,158815,158818,0,3,2
45441,4,1,158819,158819,158820,0,1,1
45442,4,1,158823,158823,158824,0,1,3
45443,1,2,158824,158824,158826,0,2,0
45444,2,2,158826,158826,158828,0,2,0
45445,4,1,158830,158830,158831,0,1,2
45446,3,3,158833,158833,158836,0,3,2
45447,1,1,158834,158836,158837,2,3,0
45448,5,3,158839,158839,158842,0,3,2
45449,1,2,158840,158842,158844,2,4,0
45450,5,3,158845,158845,158848,0,3,1
45451,3,1,158848,158848,158849,0,1,0
45452,1,1,158849,158849,158850,0,1,0
45453,2,3,158851,158851,158854,0,3,1
45454,5,2,158856,158856,158858,0,2,2
45455,3,2,158859,158859,158861,0,2,1
45456,4,3,158863,158863,158866,0,3,2
45457,5,3,158868,158868,158871,0,3,2
45458,3,1,158871,158871,158872,0,1,0
45459,4,2,158875,158875,158877,0,2,3
45460,4,1,158879,158879,158880,0,1,2
45461,4,2,158883,158883,158885,0,2,3
45462,3,3,158886,158886,158889,0,3,1
45463,2,1,158888,158889,158890,1,2,0
45464,6,2,158894,158894,158896,0,2,4
45465,1,3,158895,158896,158899,1,4,0
45466,2,1,158897,158899,158900,2,3,0
45467,1,2,158898,158900,158902,2,4,0
45468,6,2,158904,158904,158906,0,2,2
45469,5,2,158909,158909,158911,0,2,3
45470,5,3,158914,158914,158917,0,3,3
45471,6,2,158920,158920,158922,0,2,3
45472,5,3,158925,158925,158928,0,3,3
45473,6,2,158931,158931,158933,0,2,3
45474,5,3,158936,158936,158939,0,3,3
45475,5,2,158941,158941,158943,0,2,2
45476,3,2,158944,158944,158946,0,2,1
45477,6,1,158950,158950,158951,0,1,4
45478,3,3,158953,158953,158956,0,3,2
45479,2,1,158955,158956,158957,1,2,0
45480,2,2,158957,158957,158959,0,2,0
45481,5,2,158962,158962,158964,0,2,3
45482,5,2,158967,158967,158969,0,2,3
45483,2,3,158969,158969,158972,0,3,0
45484,4,1,158973,158973,158974,0,1,1
45485,2,3,158975,158975,158978,0,3,1
45486,5,1,158980,158980,158981,0,1,2
45487,5,1,158985,158985,158986,0,1,4
45488,4,2,158989,158989,158991,0,2,3
45489,6,1,158995,158995,158996,0,1,4
45490,1,3,158996,158996,158999,0,3,0
45491,2,3,158998,158999,159002,1,4,0
45492,5,1,159003,159003,159004,0,1,1
45493,3,3,159006,159006,159009,0,3,2
45494,5,2,159011,159011,159013,0,2,2
45495,6,1,159017,159017,159018,0,1,4
45496,2,3,159019,159019,159022,0,3,1
45497,5,3,159024,159024,159027,0,3,2
45498,4,2,159028,159028,159030,0,2,1
45499,6,3,159034,159034,159037,0,3,4
45500,3,2,159037,159037,159039,0,2,0
45501,4,3,159041,159041,159044,0,3,2
45502,6,1,159047,159047,159048,0,1,3
45503,5,1,159052,159052,159053,0,1,4
45504,1,1,159053,159053,159054,0,1,0
45505,1,2,159054,159054,159056,0,2,0
45506,1,2,159055,159056,159058,1,3,0
45507,4,3,159059,159059,159062,0,3,1
45508,6,1,159065,159065,159066,0,1,3
45509,6,1,159071,159071,159072,0,1,5
45510,3,2,159074,159074,159076,0,2,2
45511,5,1,159079,159079,159080,0,1,3
45512,2,1,159081,159081,159082,0,1,1
45513,6,2,159087,159087,159089,0,2,5
45514,4,2,159091,159091,159093,0,2,2
45515,3,2,159094,159094,159096,0,2,1
45516,5,3,159099,159099,159102,0,3,3
45517,2,2,159101,159102,159104,1,3,0
45518,6,3,159107,159107,159110,0,3,3
45519,3,2,159110,159110,159112,0,2,0
45520,5,1,159115,159115,159116,0,1,3
45521,6,3,159121,159121,159124,0,3,5
45522,1,3,159122,159124,159127,2,5,0
45523,6,3,159128,159128,159131,0,3,1
45524,2,2,159130,159131,159133,1,3,0
45525,1,3,159131,159133,159136,2,5,0
45526,1,1,159132,159136,159137,4,5,0
45527,4,2,159136,159137,159139,1,3,0
45528,3,2,159139,159139,159141,0,2,0
45529,2,1,159141,159141,159142,0,1,0
45530,3,1,159144,159144,159145,0,1,2
45531,4,1,159148,159148,159149,0,1,3
45532,1,1,159149,159149,159150,0,1,0
45533,4,2,159153,159153,159155,0,2,3
45534,5,2,159158,159158,159160,0,2,3
45535,3,3,159161,159161,159164,0,3,1
45536,2,1,159163,159164,159165,1,2,0
45537,4,3,159167,159167,159170,0,3,2
45538,2,1,159169,159170,159171,1,2,0
45539,1,1,159170,159171,159172,1,2,0
45540,6,3,159176,159176,159179,0,3,4
45541,4,2,159180,159180,159182,0,2,1
45542,3,2,159183,159183,159185,0,2,1
45543,4,3,159187,159187,159190,0,3,2
45544,5,1,159192,159192,159193,0,1,2
45545,4,2,159196,159196,159198,0,2,3
45546,3,2,159199,159199,159201,0,2,1
45547,6,3,159205,159205,159208,0,3,4
45548,3,2,159208,159208,159210,0,2,0
45549,3,1,159211,159211,159212,0,1,1
45550,5,2,159216,159216,159218,0,2,4
45551,3,3,159219,159219,159222,0,3,1
45552,2,3,159221,159222,159225,1,4,0
45553,5,3,159226,159226,159229,0,3,1
45554,5,2,159231,159231,159233,0,2,2
45555,1,2,159232,159233,159235,1,3,0
45556,1,1,159233,159235,159236,2,3,0
45557,4,1,159237,159237,159238,0,1,1
45558,5,2,159242,159242,159244,0,2,4
45559,3,1,159245,159245,159246,0,1,1
45560,1,3,159246,159246,159249,0,3,0
45561,6,2,159252,159252,159254,0,2,3
45562,1,2,159253,159254,159256,1,3,0
45563,4,3,159257,159257,159260,0,3,1
45564,3,1,159260,159260,159261,0,1,0
45565,2,2,159262,159262,159264,0,2,1
45566,5,2,159267,159267,159269,0,2,3
45567,5,1,159272,159272,159273,0,1,3
45568,2,2,159274,159274,159276,0,2,1
45569,1,3,159275,159276,159279,1,4,0
45570,2,2,159277,159279,159281,2,4,0
45571,5,3,159282,159282,159285,0,3,1
45572,6,1,159288,159288,159289,0,1,3
45573,1,3,159289,159289,159292,0,3,0
45574,5,3,159294,159294,159297,0,3,2
45575,5,1,159299,159299,159300,0,1,2
45576,6,1,159305,159305,159306,0,1,5
45577,5,1,159310,159310,159311,0,1,4
45578,6,2,159316,159316,159318,0,2,5
45579,5,3,159321,159321,159324,0,3,3
45580,4,2,159325,159325,159327,0,2,1
45581,4,2,159329,159329,159331,0,2,2
45582,4,3,159333,159333,159336,0,3,2
45583,6,3,159339,159339,159342,0,3,3
45584,2,2,159341,159342,159344,1,3,0
45585,6,2,159347,159347,159349,0,2,3
45586,3,2,159350,159350,159352,0,2,1
45587,2,3,159352,159352,159355,0,3,0
45588,4,2,159356,159356,159358,0,2,1
45589,1,3,159357,159358,159361,1,4,0
45590,1,3,159358,159361,159364,3,6,0
45591,3,2,159361,159364,159366,3,5,0
45592,5,2,159366,159366,159368,0,2,0
45593,2,1,159368,159368,159369,0,1,0
45594,3,3,159371,159371,159374,0,3,2
45595,2,3,159373,159374,159377,1,4,0
45596,4,1,159377,159377,159378,0,1,0
45597,6,3,159383,159383,159386,0,3,5
45598,6,1,159389,159389,159390,0,1,3
45599,2,3,159391,159391,159394,0,3,1
45600,1,3,159392,159394,159397,2,5,0
45601,4,3,159396,159397,159400,1,4,0
45602,5,2,159401,159401,159403,0,2,1
45603,5,1,159406,159406,159407,0,1,3
45604,5,3,159411,159411,159414,0,3,4
45605,5,2,159416,159416,159418,0,2,2
45606,1,2,159417,159418,159420,1,3,0
45607,6,1,159423,159423,159424,0,1,3
45608,6,1,159429,159429,159430,0,1,5
45609,1,3,159430,159430,159433,0,3,0
45610,1,3,159431,159433,159436,2,5,0
45611,6,2,159437,159437,159439,0,2,1
45612,1,1,159438,159439,159440,1,2,0
45613,2,3,159440,159440,159443,0,3,0
45614,3,1,159443,159443,159444,0,1,0
45615,5,2,159448,159448,159450,0,2,4
45616,6,1,159454,159454,159455,0,1,4
45617,2,3,159456,159456,159459,0,3,1
45618,6,3,159462,159462,159465,0,3,3
45619,1,3,159463,159465,159468,2,5,0
45620,4,1,159467,159468,159469,1,2,0
45621,4,3,159471,159471,159474,0,3,2
45622,4,1,159475,159475,159476,0,1,1
45623,2,2,159477,159477,159479,0,2,1
45624,1,1,159478,159479,159480,1,2,0
45625,3,1,159481,159481,159482,0,1,1
45626,4,2,159485,159485,159487,0,2,3
45627,4,2,159489,159489,159491,0,2,2
45628,3,2,159492,159492,159494,0,2,1
45629,5,3,159497,159497,159500,0,3,3
45630,4,3,159501,159501,159504,0,3,1
45631,4,1,159505,159505,159506,0,1,1
45632,6,3,159511,159511,159514,0,3,5
45633,1,1,159512,159514,159515,2,3,0
45634,4,1,159516,159516,159517,0,1,1
45635,3,2,159519,159519,159521,0,2,2
45636,4,3,159523,159523,159526,0,3,2
45637,6,1,159529,159529,159530,0,1,3
45638,6,2,159535,159535,159537,0,2,5
45639,5,2,159540,159540,159542,0,2,3
45640,5,2,159545,159545,159547,0,2,3
45641,1,3,159546,159547,159550,1,4,0
45642,2,3,159548,159550,159553,2,5,0
45643,5,2,159553,159553,159555,0,2,0
45644,3,2,159556,159556,159558,0,2,1
45645,4,1,159560,159560,159561,0,1,2
45646,1,1,159561,159561,159562,0,1,0
45647,4,1,159565,159565,159566,0,1,3
45648,1,3,159566,159566,159569,0,3,0
45649,4,1,159570,159570,159571,0,1,1
45650,3,3,159573,159573,159576,0,3,2
45651,6,3,159579,159579,159582,0,3,3
45652,2,2,159581,159582,159584,1,3,0
45653,2,3,159583,159584,159587,1,4,0
45654,1,2,159584,159587,159589,3,5,0
45655,1,1,159585,159589,159590,4,5,0
45656,3,1,159588,159590,159591,2,3,0
45657,3,2,159591,159591,159593,0,2,0
45658,6,2,159597,159597,159599,0,2,4
45659,5,3,159602,159602,159605,0,3,3
45660,2,2,159604,159605,159607,1,3,0
45661,3,1,159607,159607,159608,0,1,0
45662,2,3,159609,159609,159612,0,3,1
45663,4,1,159613,159613,159614,0,1,1
45664,4,2,159617,159617,159619,0,2,3
45665,5,3,159622,159622,159625,0,3,3
45666,4,3,159626,159626,159629,0,3,1
45667,3,2,159629,159629,159631,0,2,0
45668,6,2,159635,159635,159637,0,2,4
45669,2,3,159637,159637,159640,0,3,0
45670,6,2,159643,159643,159645,0,2,3
45671,6,3,159649,159649,159652,0,3,4
45672,5,3,159654,159654,159657,0,3,2
45673,5,3,159659,159659,159662,0,3,2
45674,4,1,159663,159663,159664,0,1,1
45675,1,2,159664,159664,159666,0,2,0
45676,6,3,159670,159670,159673,0,3,4
45677,3,2,159673,159673,159675,0,2,0
45678,1,2,159674,159675,159677,1,3,0
45679,4,1,159678,159678,159679,0,1,1
45680,2,2,159680,159680,159682,0,2,1
45681,4,3,159684,159684,159687,0,3,2
45682,6,3,159690,159690,159693,0,3,3
45683,2,2,159692,159693,159695,1,3,0
45684,6,1,159698,159698,159699,0,1,3
45685,3,3,159701,159701,159704,0,3,2
45686,1,2,159702,159704,159706,2,4,0
45687,3,1,159705,159706,159707,1,2,0
45688,5,1,159710,159710,159711,0,1,3
45689,4,2,159714,159714,159716,0,2,3
45690,6,3,159720,159720,159723,0,3,4
45691,6,2,159726,159726,159728,0,2,3
45692,3,3,159729,159729,159732,0,3,1
45693,5,2,159734,159734,159736,0,2,2
45694,4,3,159738,159738,159741,0,3,2
45695,4,3,159742,159742,159745,0,3,1
45696,1,2,159743,159745,159747,2,4,0
45697,6,3,159749,159749,159752,0,3,2
45698,3,2,159752,159752,159754,0,2,0
45699,3,2,159755,159755,159757,0,2,1
45700,6,2,159761,159761,159763,0,2,4
45701,1,1,159762,159763,159764,1,2,0
45702,3,3,159765,159765,159768,0,3,1
45703,6,1,159771,159771,159772,0,1,3
45704,6,2,159777,159777,159779,0,2,5
45705,2,3,159779,159779,159782,0,3,0
45706,2,1,159781,159782,159783,1,2,0
45707,4,1,159785,159785,159786,0,1,2
45708,5,2,159790,159790,159792,0,2,4
45709,6,2,159796,159796,159798,0,2,4
45710,3,2,159799,159799,159801,0,2,1
45711,6,1,159805,159805,159806,0,1,4
45712,2,3,159807,159807,159810,0,3,1
45713,6,2,159813,159813,159815,0,2,3
45714,3,2,159816,159816,159818,0,2,1
45715,3,1,159819,159819,159820,0,1,1
45716,1,3,159820,159820,159823,0,3,0
45717,1,3,159821,159823,159826,2,5,0
45718,5,3,159826,159826,159829,0,3,0
45719,4,1,159830,159830,159831,0,1,1
45720,1,1,159831,159831,159832,0,1,0
45721,1,1,159832,159832,159833,0,1,0
45722,5,2,159837,159837,159839,0,2,4
45723,5,1,159842,159842,159843,0,1,3
45724,2,3,159844,159844,159847,0,3,1
45725,6,2,159850,159850,159852,0,2,3
45726,4,3,159854,159854,159857,0,3,2
45727,1,2,159855,159857,159859,2,4,0
45728,6,2,159861,159861,159863,0,2,2
45729,4,2,159865,159865,159867,0,2,2
45730,4,3,159869,159869,159872,0,3,2
45731,2,3,159871,159872,159875,1,4,0
45732,1,3,159872,159875,159878,3,6,0
45733,5,2,159877,159878,159880,1,3,0
45734,6,1,159883,159883,159884,0,1,3
45735,3,2,159886,159886,159888,0,2,2
45736,6,2,159892,159892,159894,0,2,4
45737,3,1,159895,159895,159896,0,1,1
45738,3,3,159898,159898,159901,0,3,2
45739,2,2,159900,159901,159903,1,3,0
45740,1,3,159901,159903,159906,2,5,0
45741,6,2,159907,159907,159909,0,2,1
45742,6,3,159913,159913,159916,0,3,4
45743,1,2,159914,159916,159918,2,4,0
45744,2,2,159916,159918,159920,2,4,0
45745,5,2,159921,159921,159923,0,2,1
45746,5,3,159926,159926,159929,0,3,3
45747,4,1,159930,159930,159931,0,1,1
45748,1,3,159931,159931,159934,0,3,0
45749,2,2,159933,159934,159936,1,3,0
45750,2,1,159935,159936,159937,1,2,0
45751,2,2,159937,159937,159939,0,2,0
45752,4,3,159941,159941,159944,0,3,2
45753,4,3,159945,159945,159948,0,3,1
45754,3,2,159948,159948,159950,0,2,0
45755,6,2,159954,159954,159956,0,2,4
45756,1,3,159955,159956,159959,1,4,0
45757,6,3,159961,159961,159964,0,3,2
45758,4,2,159965,159965,159967,0,2,1
45759,6,1,159971,159971,159972,0,1,4
45760,4,1,159975,159975,159976,0,1,3
45761,5,2,159980,159980,159982,0,2,4
45762,5,3,159985,159985,159988,0,3,3
45763,3,1,159988,159988,159989,0,1,0
45764,4,1,159992,159992,159993,0,1,3
45765,5,2,159997,159997,159999,0,2,4
45766,4,1,160001,160001,160002,0,1,2
45767,6,2,160007,160007,160009,0,2,5
45768,4,1,160011,160011,160012,0,1,2
45769,6,3,160017,160017,160020,0,3,5
45770,2,2,160019,160020,160022,1,3,0
45771,5,3,160024,160024,160027,0,3,2
45772,3,3,160027,160027,160030,0,3,0
45773,3,3,160030,160030,160033,0,3,0
45774,4,3,160034,160034,160037,0,3,1
45775,6,2,160040,160040,160042,0,2,3
45776,2,2,160042,160042,160044,0,2,0
45777,1,3,160043,160044,160047,1,4,0
45778,2,1,160045,160047,160048,2,3,0
45779,4,2,160049,160049,160051,0,2,1
45780,2,3,160051,160051,160054,0,3,0
45781,1,1,160052,160054,160055,2,3,0
45782,1,3,160053,160055,160058,2,5,0
45783,4,3,160057,160058,160061,1,4,0
45784,6,2,160063,160063,160065,0,2,2
45785,2,2,160065,160065,160067,0,2,0
45786,5,3,160070,160070,160073,0,3,3
45787,3,2,160073,160073,160075,0,2,0
45788,1,3,160074,160075,160078,1,4,0
45789,3,3,160077,160078,160081,1,4,0
45790,5,2,160082,160082,160084,0,2,1
45791,6,2,160088,160088,160090,0,2,4
45792,5,3,160093,160093,160096,0,3,3
45793,6,3,160099,160099,160102,0,3,3
45794,4,2,160103,160103,160105,0,2,1
45795,4,3,160107,160107,160110,0,3,2
45796,4,3,160111,160111,160114,0,3,1
45797,4,1,160115,160115,160116,0,1,1
45798,2,2,160117,160117,160119,0,2,1
45799,6,1,160123,160123,160124,0,1,4
45800,1,3,160124,160124,160127,0,3,0
45801,6,2,160130,160130,160132,0,2,3
45802,2,3,160132,160132,160135,0,3,0
45803,5,3,160137,160137,160140,0,3,2
45804,3,3,160140,160140,160143,0,3,0
45805,3,1,160143,160143,160144,0,1,0
45806,6,2,160149,160149,160151,0,2,5
45807,6,3,160155,160155,160158,0,3,4
45808,2,1,160157,160158,160159,1,2,0
45809,4,3,160161,160161,160164,0,3,2
45810,4,3,160165,160165,160168,0,3,1
45811,1,3,160166,160168,160171,2,5,0
45812,5,3,160171,160171,160174,0,3,0
45813,2,2,160173,160174,160176,1,3,0
45814,5,3,160178,160178,160181,0,3,2
45815,4,3,160182,160182,160185,0,3,1
45816,4,1,160186,160186,160187,0,1,1
45817,5,2,160191,160191,160193,0,2,4
45818,1,2,160192,160193,160195,1,3,0
45819,4,1,160196,160196,160197,0,1,1
45820,6,1,160202,160202,160203,0,1,5
45821,1,2,160203,160203,160205,0,2,0
45822,5,2,160208,160208,160210,0,2,3
45823,3,2,160211,160211,160213,0,2,1
45824,6,1,160217,160217,160218,0,1,4
45825,2,1,160219,160219,160220,0,1,1
45826,2,1,160221,160221,160222,0,1,1
45827,3,2,160224,160224,160226,0,2,2
45828,3,1,160227,160227,160228,0,1,1
45829,2,3,160229,160229,160232,0,3,1
45830,1,3,160230,160232,160235,2,5,0
45831,1,2,160231,160235,160237,4,6,0
45832,2,2,160233,160237,160239,4,6,0
45833,3,2,160236,160239,160241,3,5,0
45834,4,1,160240,160241,160242,1,2,0
45835,4,1,160244,160244,160245,0,1,2
45836,5,2,160249,160249,160251,0,2,4
45837,3,3,160252,160252,160255,0,3,1
45838,4,3,160256,160256,160259,0,3,1
45839,2,3,160258,160259,160262,1,4,0
45840,4,1,160262,160262,160263,0,1,0
45841,2,3,160264,160264,160267,0,3,1
45842,4,2,160268,160268,160270,0,2,1
45843,2,1,160270,160270,160271,0,1,0
45844,2,2,160272,160272,160274,0,2,1
45845,6,3,160278,160278,160281,0,3,4
45846,6,2,160284,160284,160286,0,2,3
45847,2,2,160286,160286,160288,0,2,0
45848,3,3,160289,160289,160292,0,3,1
45849,1,3,160290,160292,160295,2,5,0
45850,5,1,160295,160295,160296,0,1,0
45851,6,3,160301,160301,160304,0,3,5
45852,6,3,160307,160307,160310,0,3,3
45853,1,1,160308,160310,160311,2,3,0
45854,5,2,160313,160313,160315,0,2,2
45855,4,1,160317,160317,160318,0,1,2
45856,3,1,160320,160320,160321,0,1,2
45857,1,3,160321,160321,160324,0,3,0
45858,1,2,160322,160324,160326,2,4,0
45859,4,2,160326,160326,160328,0,2,0
45860,6,1,160332,160332,160333,0,1,4
45861,4,2,160336,160336,160338,0,2,3
45862,6,3,160342,160342,160345,0,3,4
45863,6,3,160348,160348,160351,0,3,3
45864,6,1,160354,160354,160355,0,1,3
45865,5,2,160359,160359,160361,0,2,4
45866,2,3,160361,160361,160364,0,3,0
45867,3,2,160364,160364,160366,0,2,0
45868,4,2,160368,160368,160370,0,2,2
45869,3,2,160371,160371,160373,0,2,1
45870,1,2,160372,160373,160375,1,3,0
45871,4,2,160376,160376,160378,0,2,1
45872,1,1,160377,160378,160379,1,2,0
45873,1,1,160378,160379,160380,1,2,0
45874,2,3,160380,160380,160383,0,3,0
45875,2,3,160382,160383,160386,1,4,0
45876,6,2,160388,160388,160390,0,2,2
45877,4,2,160392,160392,160394,0,2,2
45878,2,3,160394,160394,160397,0,3,0
45879,1,2,160395,160397,160399,2,4,0
45880,3,1,160398,160399,160400,1,2,0
45881,4,1,160402,160402,160403,0,1,2
45882,2,1,160404,160404,160405,0,1,1
45883,5,1,160409,160409,160410,0,1,4
45884,4,3,160413,160413,160416,0,3,3
45885,4,1,160417,160417,160418,0,1,1
45886,1,2,160418,160418,160420,0,2,0
45887,4,2,160422,160422,160424,0,2,2
45888,2,1,160424,160424,160425,0,1,0
45889,3,3,160427,160427,160430,0,3,2
45890,4,1,160431,160431,160432,0,1,1
45891,2,1,160433,160433,160434,0,1,1
45892,4,2,160437,160437,160439,0,2,3
45893,1,2,160438,160439,160441,1,3,0
45894,2,1,160440,160441,160442,1,2,0
45895,1,3,160441,160442,160445,1,4,0
45896,5,1,160446,160446,160447,0,1,1
45897,6,1,160452,160452,160453,0,1,5
45898,3,2,160455,160455,160457,0,2,2
45899,1,3,160456,160457,160460,1,4,0
45900,6,2,160462,160462,160464,0,2,2
45901,2,1,160464,160464,160465,0,1,0
45902,4,3,160468,160468,160471,0,3,3
45903,6,1,160474,160474,160475,0,1,3
45904,2,3,160476,160476,160479,0,3,1
45905,4,1,160480,160480,160481,0,1,1
45906,1,2,160481,160481,160483,0,2,0
45907,4,1,160485,160485,160486,0,1,2
45908,6,2,160491,160491,160493,0,2,5
45909,3,2,160494,160494,160496,0,2,1
45910,3,1,160497,160497,160498,0,1,1
45911,3,1,160500,160500,160501,0,1,2
45912,1,2,160501,160501,160503,0,2,0
45913,2,1,160503,160503,160504,0,1,0
45914,6,3,160509,160509,160512,0,3,5
45915,5,3,160514,160514,160517,0,3,2
45916,2,3,160516,160517,160520,1,4,0
45917,3,2,160519,160520,160522,1,3,0
45918,3,1,160522,160522,160523,0,1,0
45919,6,2,160528,160528,160530,0,2,5
45920,6,2,160534,160534,160536,0,2,4
45921,5,3,160539,160539,160542,0,3,3
45922,6,3,160545,160545,160548,0,3,3
45923,5,2,160550,160550,160552,0,2,2
45924,6,1,160556,160556,160557,0,1,4
45925,3,3,160559,160559,160562,0,3,2
45926,5,2,160564,160564,160566,0,2,2
45927,1,3,160565,160566,160569,1,4,0
45928,6,1,160571,160571,160572,0,1,2
45929,1,3,160572,160572,160575,0,3,0
45930,6,1,160578,160578,160579,0,1,3
45931,3,2,160581,160581,160583,0,2,2
45932,2,2,160583,160583,160585,0,2,0
45933,6,3,160589,160589,160592,0,3,4
45934,6,2,160595,160595,160597,0,2,3
45935,3,3,160598,160598,160601,0,3,1
45936,5,3,160603,160603,160606,0,3,2
45937,4,3,160607,160607,160610,0,3,1
45938,5,2,160612,160612,160614,0,2,2
45939,1,3,160613,160614,160617,1,4,0
45940,6,3,160619,160619,160622,0,3,2
45941,3,2,160622,160622,160624,0,2,0
45942,6,2,160628,160628,160630,0,2,4
45943,1,2,160629,160630,160632,1,3,0
45944,5,2,160634,160634,160636,0,2,2
45945,2,2,160636,160636,160638,0,2,0
45946,4,3,160640,160640,160643,0,3,2
45947,1,2,160641,160643,160645,2,4,0
45948,3,1,160644,160645,160646,1,2,0
45949,6,1,160650,160650,160651,0,1,4
45950,5,3,160655,160655,160658,0,3,4
45951,1,3,160656,160658,160661,2,5,0
45952,4,1,160660,160661,160662,1,2,0
45953,2,2,160662,160662,160664,0,2,0
45954,4,1,160666,160666,160667,0,1,2
45955,1,3,160667,160667,160670,0,3,0
45956,3,3,160670,160670,160673,0,3,0
45957,4,3,160674,160674,160677,0,3,1
45958,2,1,160676,160677,160678,1,2,0
45959,5,3,160681,160681,160684,0,3,3
45960,6,1,160687,160687,160688,0,1,3
45961,4,1,160691,160691,160692,0,1,3
45962,5,1,160696,160696,160697,0,1,4
45963,4,3,160700,160700,160703,0,3,3
45964,5,2,160705,160705,160707,0,2,2
45965,3,1,160708,160708,160709,0,1,1
45966,4,3,160712,160712,160715,0,3,3
45967,3,2,160715,160715,160717,0,2,0
45968,2,3,160717,160717,160720,0,3,0
45969,4,2,160721,160721,160723,0,2,1
45970,4,2,160725,160725,160727,0,2,2
45971,3,3,160728,160728,160731,0,3,1
45972,2,2,160730,160731,160733,1,3,0
45973,1,3,160731,160733,160736,2,5,0
45974,5,2,160736,160736,160738,0,2,0
45975,1,2,160737,160738,160740,1,3,0
45976,6,1,160743,160743,160744,0,1,3
45977,3,1,160746,160746,160747,0,1,2
45978,3,1,160749,160749,160750,0,1,2
45979,5,3,160754,160754,160757,0,3,4
45980,1,3,160755,160757,160760,2,5,0
45981,5,1,160760,160760,160761,0,1,0
45982,3,3,160763,160763,160766,0,3,2
45983,3,1,160766,160766,160767,0,1,0
45984,2,1,160768,160768,160769,0,1,1
45985,6,1,160774,160774,160775,0,1,5
45986,5,1,160779,160779,160780,0,1,4
45987,1,3,160780,160780,160783,0,3,0
45988,6,1,160786,160786,160787,0,1,3
45989,1,2,160787,160787,160789,0,2,0
45990,2,3,160789,160789,160792,0,3,0
45991,4,1,160793,160793,160794,0,1,1
45992,5,2,160798,160798,160800,0,2,4
45993,5,3,160803,160803,160806,0,3,3
45994,2,1,160805,160806,160807,1,2,0
45995,1,3,160806,160807,160810,1,4,0
45996,4,1,160810,160810,160811,0,1,0
45997,3,1,160813,160813,160814,0,1,2
45998,3,2,160816,160816,160818,0,2,2
45999,5,3,160821,160821,160824,0,3,3
46000,2,1,160823,160824,160825,1,2,0
46001,5,2,160828,160828,160830,0,2,3
46002,1,1,160829,160830,160831,1,2,0
46003,1,1,160830,160831,160832,1,2,0
46004,2,3,160832,160832,160835,0,3,0
46005,3,2,160835,160835,160837,0,2,0
46006,4,1,160839,160839,160840,0,1,2
46007,2,2,160841,160841,160843,0,2,1
46008,1,3,160842,160843,160846,1,4,0
46009,6,3,160848,160848,160851,0,3,2
46010,4,1,160852,160852,160853,0,1,1
46011,4,2,160856,160856,160858,0,2,3
46012,1,1,160857,160858,160859,1,2,0
46013,6,2,160863,160863,160865,0,2,4
46014,2,3,160865,160865,160868,0,3,0
46015,5,3,160870,160870,160873,0,3,2
46016,4,2,160874,160874,160876,0,2,1
46017,4,3,160878,160878,160881,0,3,2
46018,1,3,160879,160881,160884,2,5,0
46019,2,1,160881,160884,160885,3,4,0
46020,4,2,160885,160885,160887,0,2,0
46021,6,3,160891,160891,160894,0,3,4
46022,4,2,160895,160895,160897,0,2,1
46023,6,2,160901,160901,160903,0,2,4
46024,3,3,160904,160904,160907,0,3,1
46025,1,2,160905,160907,160909,2,4,0
46026,4,2,160909,160909,160911,0,2,0
46027,2,1,160911,160911,160912,0,1,0
46028,6,3,160917,160917,160920,0,3,5
46029,2,1,160919,160920,160921,1,2,0
46030,1,3,160920,160921,160924,1,4,0
46031,2,3,160922,160924,160927,2,5,0
46032,4,1,160926,160927,160928,1,2,0
46033,5,1,160931,160931,160932,0,1,3
46034,6,2,160937,160937,160939,0,2,5
46035,5,1,160942,160942,160943,0,1,3
46036,4,2,160946,160946,160948,0,2,3
46037,2,3,160948,160948,160951,0,3,0
46038,5,1,160953,160953,160954,0,1,2
46039,5,1,160958,160958,160959,0,1,4
46040,5,2,160963,160963,160965,0,2,4
46041,4,3,160967,160967,160970,0,3,2
46042,6,1,160973,160973,160974,0,1,3
46043,1,2,160974,160974,160976,0,2,0
46044,2,1,160976,160976,160977,0,1,0
46045,5,1,160981,160981,160982,0,1,4
46046,3,2,160984,160984,160986,0,2,2
46047,4,2,160988,160988,160990,0,2,2
46048,1,2,160989,160990,160992,1,3,0
46049,3,3,160992,160992,160995,0,3,0
46050,4,2,160996,160996,160998,0,2,1
46051,4,2,161000,161000,161002,0,2,2
46052,3,3,161003,161003,161006,0,3,1
46053,5,3,161008,161008,161011,0,3,2
46054,3,1,161011,161011,161012,0,1,0
46055,3,1,161014,161014,161015,0,1,2
46056,2,2,161016,161016,161018,0,2,1
46057,5,2,161021,161021,161023,0,2,3
46058,2,3,161023,161023,161026,0,3,0
46059,2,1,161025,161026,161027,1,2,0
46060,1,3,161026,161027,161030,1,4,0
46061,4,1,161030,161030,161031,0,1,0
46062,1,3,161031,161031,161034,0,3,0
46063,4,3,161035,161035,161038,0,3,1
46064,2,3,161037,161038,161041,1,4,0
46065,5,3,161042,161042,161045,0,3,1
46066,4,2,161046,161046,161048,0,2,1
46067,3,1,161049,161049,161050,0,1,1
46068,5,1,161054,161054,161055,0,1,4
46069,1,3,161055,161055,161058,0,3,0
46070,2,3,161057,161058,161061,1,4,0
46071,6,3,161063,161063,161066,0,3,2
46072,6,1,161069,161069,161070,0,1,3
46073,1,3,161070,161070,161073,0,3,0
46074,4,3,161074,161074,161077,0,3,1
46075,6,2,161080,161080,161082,0,2,3
46076,5,2,161085,161085,161087,0,2,3
46077,4,2,161089,161089,161091,0,2,2
46078,6,2,161095,161095,161097,0,2,4
46079,1,1,161096,161097,161098,1,2,0
46080,5,3,161101,161101,161104,0,3,3
46081,1,1,161102,161104,161105,2,3,0
46082,6,1,161108,161108,161109,0,1,3
46083,3,3,161111,161111,161114,0,3,2
46084,1,3,161112,161114,161117,2,5,0
46085,5,2,161117,161117,161119,0,2,0
46086,2,3,161119,161119,161122,0,3,0
46087,6,3,161125,161125,161128,0,3,3
46088,4,1,161129,161129,161130,0,1,1
46089,2,2,161131,161131,161133,0,2,1
46090,1,3,161132,161133,161136,1,4,0
46091,3,1,161135,161136,161137,1,2,0
46092,3,3,161138,161138,161141,0,3,1
46093,2,3,161140,161141,161144,1,4,0
46094,1,2,161141,161144,161146,3,5,0
46095,5,3,161146,161146,161149,0,3,0
46096,4,1,161150,161150,161151,0,1,1
46097,4,3,161154,161154,161157,0,3,3
46098,6,3,161160,161160,161163,0,3,3
46099,6,2,161166,161166,161168,0,2,3
46100,6,3,161172,161172,161175,0,3,4
46101,2,2,161174,161175,161177,1,3,0
46102,5,1,161179,161179,161180,0,1,2
46103,5,1,161184,161184,161185,0,1,4
46104,1,3,161185,161185,161188,0,3,0
46105,4,3,161189,161189,161192,0,3,1
46106,4,2,161193,161193,161195,0,2,1
46107,6,3,161199,161199,161202,0,3,4
46108,4,1,161203,161203,161204,0,1,1
46109,3,1,161206,161206,161207,0,1,2
46110,6,2,161212,161212,161214,0,2,5
46111,3,3,161215,161215,161218,0,3,1
46112,2,3,161217,161218,161221,1,4,0
46113,1,1,161218,161221,161222,3,4,0
46114,1,1,161219,161222,161223,3,4,0
46115,4,2,161223,161223,161225,0,2,0
46116,1,2,161224,161225,161227,1,3,0
46117,2,2,161226,161227,161229,1,3,0
46118,5,3,161231,161231,161234,0,3,2
46119,1,3,161232,161234,161237,2,5,0
46120,4,1,161236,161237,161238,1,2,0
46121,4,3,161240,161240,161243,0,3,2
46122,5,3,161245,161245,161248,0,3,2
46123,1,2,161246,161248,161250,2,4,0
46124,5,2,161251,161251,161253,0,2,1
46125,2,1,161253,161253,161254,0,1,0
46126,5,1,161258,161258,161259,0,1,4
46127,1,1,161259,161259,161260,0,1,0
46128,2,1,161261,161261,161262,0,1,1
46129,2,2,161263,161263,161265,0,2,1
46130,5,2,161268,161268,161270,0,2,3
46131,1,2,161269,161270,161272,1,3,0
46132,1,3,161270,161272,161275,2,5,0
46133,1,3,161271,161275,161278,4,7,0
46134,6,3,161277,161278,161281,1,4,0
46135,1,2,161278,161281,161283,3,5,0
46136,6,1,161284,161284,161285,0,1,1
46137,6,1,161290,161290,161291,0,1,5
46138,6,2,161296,161296,161298,0,2,5
46139,4,1,161300,161300,161301,0,1,2
46140,6,1,161306,161306,161307,0,1,5
46141,3,1,161309,161309,161310,0,1,2
46142,4,3,161313,161313,161316,0,3,3
46143,1,2,161314,161316,161318,2,4,0
46144,3,3,161317,161318,161321,1,4,0
46145,4,1,161321,161321,161322,0,1,0
46146,1,2,161322,161322,161324,0,2,0
46147,2,1,161324,161324,161325,0,1,0
46148,6,3,161330,161330,161333,0,3,5
46149,2,1,161332,161333,161334,1,2,0
46150,4,2,161336,161336,161338,0,2,2
46151,5,1,161341,161341,161342,0,1,3
46152,4,1,161345,161345,161346,0,1,3
46153,5,2,161350,161350,161352,0,2,4
46154,3,2,161353,161353,161355,0,2,1
46155,3,2,161356,161356,161358,0,2,1
46156,3,3,161359,161359,161362,0,3,1
46157,5,2,161364,161364,161366,0,2,2
46158,4,1,161368,161368,161369,0,1,2
46159,1,3,161369,161369,161372,0,3,0
46160,5,3,161374,161374,161377,0,3,2
46161,5,1,161379,161379,161380,0,1,2
46162,2,1,161381,161381,161382,0,1,1
46163,4,2,161385,161385,161387,0,2,3
46164,1,1,161386,161387,161388,1,2,0
46165,2,2,161388,161388,161390,0,2,0
46166,5,2,161393,161393,161395,0,2,3
46167,5,1,161398,161398,161399,0,1,3
46168,5,3,161403,161403,161406,0,3,4
46169,5,3,161408,161408,161411,0,3,2
46170,2,3,161410,161411,161414,1,4,0
46171,3,2,161413,161414,161416,1,3,0
46172,4,1,161417,161417,161418,0,1,1
46173,4,1,161421,161421,161422,0,1,3
46174,4,3,161425,161425,161428,0,3,3
46175,4,2,161429,161429,161431,0,2,1
46176,6,2,161435,161435,161437,0,2,4
46177,3,3,161438,161438,161441,0,3,1
46178,4,3,161442,161442,161445,0,3,1
46179,5,1,161447,161447,161448,0,1,2
46180,4,1,161451,161451,161452,0,1,3
46181,1,2,161452,161452,161454,0,2,0
46182,5,3,161457,161457,161460,0,3,3
46183,4,1,161461,161461,161462,0,1,1
46184,4,1,161465,161465,161466,0,1,3
46185,2,3,161467,161467,161470,0,3,1
46186,1,2,161468,161470,161472,2,4,0
46187,1,1,161469,161472,161473,3,4,0
46188,3,2,161472,161473,161475,1,3,0
46189,4,3,161476,161476,161479,0,3,1
46190,3,2,161479,161479,161481,0,2,0
46191,5,3,161484,161484,161487,0,3,3
46192,2,3,161486,161487,161490,1,4,0
46193,4,1,161490,161490,161491,0,1,0
46194,6,2,161496,161496,161498,0,2,5
46195,4,2,161500,161500,161502,0,2,2
46196,5,2,161505,161505,161507,0,2,3
46197,6,1,161511,161511,161512,0,1,4
46198,2,3,161513,161513,161516,0,3,1
46199,2,3,161515,161516,161519,1,4,0
46200,3,2,161518,161519,161521,1,3,0
46201,1,1,161519,161521,161522,2,3,0
46202,4,2,161523,161523,161525,0,2,1
46203,6,1,161529,161529,161530,0,1,4
46204,6,3,161535,161535,161538,0,3,5
46205,2,1,161537,161538,161539,1,2,0
46206,3,1,161540,161540,161541,0,1,1
46207,1,2,161541,161541,161543,0,2,0
46208,6,1,161547,161547,161548,0,1,4
46209,6,1,161553,161553,161554,0,1,5
46210,4,3,161557,161557,161560,0,3,3
46211,3,1,161560,161560,161561,0,1,0
46212,2,2,161562,161562,161564,0,2,1
46213,6,3,161568,161568,161571,0,3,4
46214,4,1,161572,161572,161573,0,1,1
46215,5,3,161577,161577,161580,0,3,4
46216,1,2,161578,161580,161582,2,4,0
46217,2,2,161580,161582,161584,2,4,0
46218,1,2,161581,161584,161586,3,5,0
46219,4,2,161585,161586,161588,1,3,0
46220,1,1,161586,161588,161589,2,3,0
46221,2,2,161588,161589,161591,1,3,0
46222,1,2,161589,161591,161593,2,4,0
46223,1,2,161590,161593,161595,3,5,0
46224,5,2,161595,161595,161597,0,2,0
46225,3,2,161598,161598,161600,0,2,1
46226,2,3,161600,161600,161603,0,3,0
46227,2,2,161602,161603,161605,1,3,0
46228,6,1,161608,161608,161609,0,1,3
46229,5,3,161613,161613,161616,0,3,4
46230,2,1,161615,161616,161617,1,2,0
46231,3,3,161618,161618,161621,0,3,1
46232,3,1,161621,161621,161622,0,1,0
46233,3,3,161624,161624,161627,0,3,2
46234,3,3,161627,161627,161630,0,3,0
46235,4,1,161631,161631,161632,0,1,1
46236,1,1,161632,161632,161633,0,1,0
46237,5,2,161637,161637,161639,0,2,4
46238,5,2,161642,161642,161644,0,2,3
46239,5,1,161647,161647,161648,0,1,3
46240,6,3,161653,161653,161656,0,3,5
46241,4,1,161657,161657,161658,0,1,1
46242,2,3,161659,161659,161662,0,3,1
46243,2,1,161661,161662,161663,1,2,0
46244,3,2,161664,161664,161666,0,2,1
46245,1,3,161665,161666,161669,1,4,0
46246,3,3,161668,161669,161672,1,4,0
46247,5,1,161673,161673,161674,0,1,1
46248,2,1,161675,161675,161676,0,1,1
46249,4,1,161679,161679,161680,0,1,3
46250,5,1,161684,161684,161685,0,1,4
46251,6,3,161690,161690,161693,0,3,5
46252,2,1,161692,161693,161694,1,2,0
46253,6,2,161698,161698,161700,0,2,4
46254,6,1,161704,161704,161705,0,1,4
46255,4,2,161708,161708,161710,0,2,3
46256,4,3,161712,161712,161715,0,3,2
46257,4,1,161716,161716,161717,0,1,1
46258,4,1,161720,161720,161721,0,1,3
46259,5,1,161725,161725,161726,0,1,4
46260,4,2,161729,161729,161731,0,2,3
46261,3,1,161732,161732,161733,0,1,1
46262,5,1,161737,161737,161738,0,1,4
46263,4,1,161741,161741,161742,0,1,3
46264,3,1,161744,161744,161745,0,1,2
46265,2,2,161746,161746,161748,0,2,1
46266,2,1,161748,161748,161749,0,1,0
46267,6,2,161754,161754,161756,0,2,5
46268,1,2,161755,161756,161758,1,3,0
46269,5,1,161760,161760,161761,0,1,2
46270,5,2,161765,161765,161767,0,2,4
46271,5,3,161770,161770,161773,0,3,3
46272,4,2,161774,161774,161776,0,2,1
46273,5,1,161779,161779,161780,0,1,3
46274,4,3,161783,161783,161786,0,3,3
46275,2,1,161785,161786,161787,1,2,0
46276,1,1,161786,161787,161788,1,2,0
46277,1,1,161787,161788,161789,1,2,0
46278,2,1,161789,161789,161790,0,1,0
46279,1,3,161790,161790,161793,0,3,0
46280,2,1,161792,161793,161794,1,2,0
46281,6,2,161798,161798,161800,0,2,4
46282,1,3,161799,161800,161803,1,4,0
46283,3,3,161802,161803,161806,1,4,0
46284,6,1,161808,161808,161809,0,1,2
46285,4,1,161812,161812,161813,0,1,3
46286,6,1,161818,161818,161819,0,1,5
46287,6,1,161824,161824,161825,0,1,5
46288,6,1,161830,161830,161831,0,1,5
46289,1,2,161831,161831,161833,0,2,0
46290,1,1,161832,161833,161834,1,2,0
46291,4,3,161836,161836,161839,0,3,2
46292,2,1,161838,161839,161840,1,2,0
46293,2,1,161840,161840,161841,0,1,0
46294,6,1,161846,161846,161847,0,1,5
46295,4,2,161850,161850,161852,0,2,3
46296,6,2,161856,161856,161858,0,2,4
46297,5,1,161861,161861,161862,0,1,3
46298,4,3,161865,161865,161868,0,3,3
46299,4,2,161869,161869,161871,0,2,1
46300,1,2,161870,161871,161873,1,3,0
46301,4,1,161874,161874,161875,0,1,1
46302,3,3,161877,161877,161880,0,3,2
46303,1,2,161878,161880,161882,2,4,0
46304,5,3,161883,161883,161886,0,3,1
46305,3,2,161886,161886,161888,0,2,0
46306,2,1,161888,161888,161889,0,1,0
46307,4,2,161892,161892,161894,0,2,3
46308,3,1,161895,161895,161896,0,1,1
46309,1,1,161896,161896,161897,0,1,0
46310,6,3,161902,161902,161905,0,3,5
46311,6,1,161908,161908,161909,0,1,3
46312,5,2,161913,161913,161915,0,2,4
46313,1,3,161914,161915,161918,1,4,0
46314,6,3,161920,161920,161923,0,3,2
46315,1,1,161921,161923,161924,2,3,0
46316,1,3,161922,161924,161927,2,5,0
46317,6,1,161928,161928,161929,0,1,1
46318,3,2,161931,161931,161933,0,2,2
46319,1,1,161932,161933,161934,1,2,0
46320,4,1,161936,161936,161937,0,1,2
46321,6,1,161942,161942,161943,0,1,5
46322,3,3,161945,161945,161948,0,3,2
46323,2,3,161947,161948,161951,1,4,0
46324,2,1,161949,161951,161952,2,3,0
46325,6,3,161955,161955,161958,0,3,3
46326,2,3,161957,161958,161961,1,4,0
46327,1,1,161958,161961,161962,3,4,0
46328,4,2,161962,161962,161964,0,2,0
46329,1,1,161963,161964,161965,1,2,0
46330,6,1,161969,161969,161970,0,1,4
46331,4,3,161973,161973,161976,0,3,3
46332,2,3,161975,161976,161979,1,4,0
46333,3,2,161978,161979,161981,1,3,0
46334,1,2,161979,161981,161983,2,4,0
46335,6,3,161985,161985,161988,0,3,2
46336,1,1,161986,161988,161989,2,3,0
46337,1,1,161987,161989,161990,2,3,0
46338,5,3,161992,161992,161995,0,3,2
46339,2,1,161994,161995,161996,1,2,0
46340,1,1,161995,161996,161997,1,2,0
46341,1,3,161996,161997,162000,1,4,0
46342,2,1,161998,162000,162001,2,3,0
46343,3,1,162001,162001,162002,0,1,0
46344,2,3,162003,162003,162006,0,3,1
46345,5,3,162008,162008,162011,0,3,2
46346,4,1,162012,162012,162013,0,1,1
46347,1,1,162013,162013,162014,0,1,0
46348,5,1,162018,162018,162019,0,1,4
46349,4,2,162022,162022,162024,0,2,3
46350,6,3,162028,162028,162031,0,3,4
46351,5,3,162033,162033,162036,0,3,2
46352,2,3,162035,162036,162039,1,4,0
46353,5,2,162040,162040,162042,0,2,1
46354,3,3,162043,162043,162046,0,3,1
46355,3,1,162046,162046,162047,0,1,0
46356,2,3,162048,162048,162051,0,3,1
46357,1,3,162049,162051,162054,2,5,0
46358,1,1,162050,162054,162055,4,5,0
46359,4,3,162054,162055,162058,1,4,0
46360,1,2,162055,162058,162060,3,5,0
46361,3,3,162058,162060,162063,2,5,0
46362,5,1,162063,162063,162064,0,1,0
46363,4,3,162067,162067,162070,0,3,3
46364,3,1,162070,162070,162071,0,1,0
46365,2,1,162072,162072,162073,0,1,1
46366,1,1,162073,162073,162074,0,1,0
46367,2,1,162075,162075,162076,0,1,1
46368,5,1,162080,162080,162081,0,1,4
46369,2,2,162082,162082,162084,0,2,1
46370,4,2,162086,162086,162088,0,2,2
46371,5,1,162091,162091,162092,0,1,3
46372,2,3,162093,162093,162096,0,3,1
46373,1,3,162094,162096,162099,2,5,0
46374,1,1,162095,162099,162100,4,5,0
46375,6,3,162101,162101,162104,0,3,1
46376,3,3,162104,162104,162107,0,3,0
46377,3,2,162107,162107,162109,0,2,0
46378,5,1,162112,162112,162113,0,1,3
46379,3,2,162115,162115,162117,0,2,2
46380,3,3,162118,162118,162121,0,3,1
46381,6,2,162124,162124,162126,0,2,3
46382,5,2,162129,162129,162131,0,2,3
46383,5,3,162134,162134,162137,0,3,3
46384,2,3,162136,162137,162140,1,4,0
46385,2,2,162138,162140,162142,2,4,0
46386,2,3,162140,162142,162145,2,5,0
46387,6,1,162146,162146,162147,0,1,1
46388,4,3,162150,162150,162153,0,3,3
46389,2,1,162152,162153,162154,1,2,0
46390,4,2,162156,162156,162158,0,2,2
46391,3,1,162159,162159,162160,0,1,1
46392,2,1,162161,162161,162162,0,1,1
46393,1,2,162162,162162,162164,0,2,0
46394,1,1,162163,162164,162165,1,2,0
46395,5,1,162168,162168,162169,0,1,3
46396,4,2,162172,162172,162174,0,2,3
46397,6,1,162178,162178,162179,0,1,4
46398,4,3,162182,162182,162185,0,3,3
46399,3,1,162185,162185,162186,0,1,0
46400,2,3,162187,162187,162190,0,3,1
46401,3,3,162190,162190,162193,0,3,0
46402,2,2,162192,162193,162195,1,3,0
46403,2,3,162194,162195,162198,1,4,0
46404,6,3,162200,162200,162203,0,3,2
46405,2,3,162202,162203,162206,1,4,0
46406,2,2,162204,162206,162208,2,4,0
46407,1,2,162205,162208,162210,3,5,0
46408,4,3,162209,162210,162213,1,4,0
46409,5,2,162214,162214,162216,0,2,1
46410,6,1,162220,162220,162221,0,1,4
46411,5,3,162225,162225,162228,0,3,4
46412,1,2,162226,162228,162230,2,4,0
46413,5,3,162231,162231,162234,0,3,1
46414,3,1,162234,162234,162235,0,1,0
46415,3,1,162237,162237,162238,0,1,2
46416,3,2,162240,162240,162242,0,2,2
46417,3,2,162243,162243,162245,0,2,1
46418,4,2,162247,162247,162249,0,2,2
46419,6,1,162253,162253,162254,0,1,4
46420,3,3,162256,162256,162259,0,3,2
46421,2,3,162258,162259,162262,1,4,0
46422,4,1,162262,162262,162263,0,1,0
46423,3,2,162265,162265,162267,0,2,2
46424,5,1,162270,162270,162271,0,1,3
46425,3,2,162273,162273,162275,0,2,2
46426,3,2,162276,162276,162278,0,2,1
46427,2,3,162278,162278,162281,0,3,0
46428,6,2,162284,162284,162286,0,2,3
46429,4,1,162288,162288,162289,0,1,2
46430,6,2,162294,162294,162296,0,2,5
46431,4,3,162298,162298,162301,0,3,2
46432,2,1,162300,162301,162302,1,2,0
46433,2,3,162302,162302,162305,0,3,0
46434,4,1,162306,162306,162307,0,1,1
46435,2,1,162308,162308,162309,0,1,1
46436,5,2,162313,162313,162315,0,2,4
46437,2,1,162315,162315,162316,0,1,0
46438,5,2,162320,162320,162322,0,2,4
46439,2,2,162322,162322,162324,0,2,0
46440,2,3,162324,162324,162327,0,3,0
46441,6,3,162330,162330,162333,0,3,3
46442,6,2,162336,162336,162338,0,2,3
46443,5,1,162341,162341,162342,0,1,3
46444,2,1,162343,162343,162344,0,1,1
46445,5,2,162348,162348,162350,0,2,4
46446,2,1,162350,162350,162351,0,1,0
46447,5,1,162355,162355,162356,0,1,4
46448,3,1,162358,162358,162359,0,1,2
46449,2,2,162360,162360,162362,0,2,1
46450,2,3,162362,162362,162365,0,3,0
46451,2,1,162364,162365,162366,1,2,0
46452,3,2,162367,162367,162369,0,2,1
46453,2,2,162369,162369,162371,0,2,0
46454,1,2,162370,162371,162373,1,3,0
46455,5,1,162375,162375,162376,0,1,2
46456,3,2,162378,162378,162380,0,2,2
46457,2,2,162380,162380,162382,0,2,0
46458,3,3,162383,162383,162386,0,3,1
46459,6,3,162389,162389,162392,0,3,3
46460,5,3,162394,162394,162397,0,3,2
46461,4,1,162398,162398,162399,0,1,1
46462,5,1,162403,162403,162404,0,1,4
46463,1,1,162404,162404,162405,0,1,0
46464,4,2,162408,162408,162410,0,2,3
46465,6,2,162414,162414,162416,0,2,4
46466,4,3,162418,162418,162421,0,3,2
46467,5,3,162423,162423,162426,0,3,2
46468,1,2,162424,162426,162428,2,4,0
46469,3,1,162427,162428,162429,1,2,0
46470,4,2,162431,162431,162433,0,2,2
46471,1,2,162432,162433,162435,1,3,0
46472,2,2,162434,162435,162437,1,3,0
46473,3,1,162437,162437,162438,0,1,0
46474,2,2,162439,162439,162441,0,2,1
46475,5,1,162444,162444,162445,0,1,3
46476,6,1,162450,162450,162451,0,1,5
46477,1,2,162451,162451,162453,0,2,0
46478,6,3,162457,162457,162460,0,3,4
46479,1,3,162458,162460,162463,2,5,0
46480,4,3,162462,162463,162466,1,4,0
46481,2,1,162464,162466,162467,2,3,0
46482,3,3,162467,162467,162470,0,3,0
46483,3,3,162470,162470,162473,0,3,0
46484,5,2,162475,162475,162477,0,2,2
46485,1,3,162476,162477,162480,1,4,0
46486,4,2,162480,162480,162482,0,2,0
46487,3,3,162483,162483,162486,0,3,1
46488,4,1,162487,162487,162488,0,1,1
46489,1,2,162488,162488,162490,0,2,0
46490,4,1,162492,162492,162493,0,1,2
46491,1,2,162493,162493,162495,0,2,0
46492,5,3,162498,162498,162501,0,3,3
46493,6,2,162504,162504,162506,0,2,3
46494,5,3,162509,162509,162512,0,3,3
46495,3,1,162512,162512,162513,0,1,0
46496,4,3,162516,162516,162519,0,3,3
46497,1,1,162517,162519,162520,2,3,0
46498,2,3,162519,162520,162523,1,4,0
46499,2,3,162521,162523,162526,2,5,0
46500,1,1,162522,162526,162527,4,5,0
46501,4,2,162526,162527,162529,1,3,0
46502,5,2,162531,162531,162533,0,2,2
46503,3,2,162534,162534,162536,0,2,1
46504,5,3,162539,162539,162542,0,3,3
46505,6,1,162545,162545,162546,0,1,3
46506,5,2,162550,162550,162552,0,2,4
46507,4,2,162554,162554,162556,0,2,2
46508,5,2,162559,162559,162561,0,2,3
46509,5,1,162564,162564,162565,0,1,3
46510,1,2,162565,162565,162567,0,2,0
46511,3,1,162568,162568,162569,0,1,1
46512,3,3,162571,162571,162574,0,3,2
46513,6,2,162577,162577,162579,0,2,3
46514,2,3,162579,162579,162582,0,3,0
46515,1,1,162580,162582,162583,2,3,0
46516,4,3,162584,162584,162587,0,3,1
46517,2,3,162586,162587,162590,1,4,0
46518,5,2,162591,162591,162593,0,2,1
46519,5,1,162596,162596,162597,0,1,3
46520,5,3,162601,162601,162604,0,3,4
46521,6,3,162607,162607,162610,0,3,3
46522,1,3,162608,162610,162613,2,5,0
46523,4,1,162612,162613,162614,1,2,0
46524,4,1,162616,162616,162617,0,1,2
46525,1,2,162617,162617,162619,0,2,0
46526,2,1,162619,162619,162620,0,1,0
46527,3,2,162622,162622,162624,0,2,2
46528,6,3,162628,162628,162631,0,3,4
46529,2,1,162630,162631,162632,1,2,0
46530,2,3,162632,162632,162635,0,3,0
46531,3,3,162635,162635,162638,0,3,0
46532,4,3,162639,162639,162642,0,3,1
46533,5,2,162644,162644,162646,0,2,2
46534,5,1,162649,162649,162650,0,1,3
46535,1,2,162650,162650,162652,0,2,0
46536,4,2,162654,162654,162656,0,2,2
46537,2,1,162656,162656,162657,0,1,0
46538,5,1,162661,162661,162662,0,1,4
46539,3,1,162664,162664,162665,0,1,2
46540,2,3,162666,162666,162669,0,3,1
46541,4,2,162670,162670,162672,0,2,1
46542,6,3,162676,162676,162679,0,3,4
46543,1,1,162677,162679,162680,2,3,0
46544,2,2,162679,162680,162682,1,3,0
46545,2,3,162681,162682,162685,1,4,0
46546,5,2,162686,162686,162688,0,2,1
46547,4,2,162690,162690,162692,0,2,2
46548,3,1,162693,162693,162694,0,1,1
46549,5,3,162698,162698,162701,0,3,4
46550,4,3,162702,162702,162705,0,3,1
46551,6,1,162708,162708,162709,0,1,3
46552,1,3,162709,162709,162712,0,3,0
46553,6,1,162715,162715,162716,0,1,3
46554,2,2,162717,162717,162719,0,2,1
46555,5,3,162722,162722,162725,0,3,3
46556,1,2,162723,162725,162727,2,4,0
46557,1,3,162724,162727,162730,3,6,0
46558,5,3,162729,162730,162733,1,4,0
46559,6,3,162735,162735,162738,0,3,2
46560,2,1,162737,162738,162739,1,2,0
46561,3,3,162740,162740,162743,0,3,1
46562,5,1,162745,162745,162746,0,1,2
46563,1,3,162746,162746,162749,0,3,0
46564,5,2,162751,162751,162753,0,2,2
46565,2,1,162753,162753,162754,0,1,0
46566,3,3,162756,162756,162759,0,3,2
46567,2,3,162758,162759,162762,1,4,0
46568,5,2,162763,162763,162765,0,2,1
46569,1,1,162764,162765,162766,1,2,0
46570,3,1,162767,162767,162768,0,1,1
46571,2,2,162769,162769,162771,0,2,1
46572,5,2,162774,162774,162776,0,2,3
46573,2,3,162776,162776,162779,0,3,0
46574,3,2,162779,162779,162781,0,2,0
46575,6,1,162785,162785,162786,0,1,4
46576,4,2,162789,162789,162791,0,2,3
46577,6,2,162795,162795,162797,0,2,4
46578,2,1,162797,162797,162798,0,1,0
46579,5,2,162802,162802,162804,0,2,4
46580,4,3,162806,162806,162809,0,3,2
46581,1,1,162807,162809,162810,2,3,0
46582,4,3,162811,162811,162814,0,3,1
46583,1,3,162812,162814,162817,2,5,0
46584,1,1,162813,162817,162818,4,5,0
46585,1,2,162814,162818,162820,4,6,0
46586,6,2,162820,162820,162822,0,2,0
46587,2,1,162822,162822,162823,0,1,0
46588,5,3,162827,162827,162830,0,3,4
46589,1,2,162828,162830,162832,2,4,0
46590,4,2,162832,162832,162834,0,2,0
46591,4,3,162836,162836,162839,0,3,2
46592,1,2,162837,162839,162841,2,4,0
46593,3,1,162840,162841,162842,1,2,0
46594,1,3,162841,162842,162845,1,4,0
46595,1,3,162842,162845,162848,3,6,0
46596,4,3,162846,162848,162851,2,5,0
46597,2,2,162848,162851,162853,3,5,0
46598,6,3,162854,162854,162857,0,3,1
46599,1,1,162855,162857,162858,2,3,0
46600,6,2,162861,162861,162863,0,2,3
46601,2,1,162863,162863,162864,0,1,0
46602,5,1,162868,162868,162869,0,1,4
46603,5,1,162873,162873,162874,0,1,4
46604,1,3,162874,162874,162877,0,3,0
46605,5,2,162879,162879,162881,0,2,2
46606,5,2,162884,162884,162886,0,2,3
46607,6,1,162890,162890,162891,0,1,4
46608,4,1,162894,162894,162895,0,1,3
46609,3,3,162897,162897,162900,0,3,2
46610,1,3,162898,162900,162903,2,5,0
46611,2,1,162900,162903,162904,3,4,0
46612,5,3,162905,162905,162908,0,3,1
46613,2,1,162907,162908,162909,1,2,0
46614,6,2,162913,162913,162915,0,2,4
46615,4,3,162917,162917,162920,0,3,2
46616,1,1,162918,162920,162921,2,3,0
46617,1,2,162919,162921,162923,2,4,0
46618,3,2,162922,162923,162925,1,3,0
46619,2,1,162924,162925,162926,1,2,0
46620,2,2,162926,162926,162928,0,2,0
46621,5,1,162931,162931,162932,0,1,3
46622,1,2,162932,162932,162934,0,2,0
46623,5,2,162937,162937,162939,0,2,3
46624,1,2,162938,162939,162941,1,3,0
46625,1,3,162939,162941,162944,2,5,0
46626,3,1,162942,162944,162945,2,3,0
46627,5,3,162947,162947,162950,0,3,2
46628,3,1,162950,162950,162951,0,1,0
46629,2,3,162952,162952,162955,0,3,1
46630,5,3,162957,162957,162960,0,3,2
46631,5,1,162962,162962,162963,0,1,2
46632,2,3,162964,162964,162967,0,3,1
46633,1,1,162965,162967,162968,2,3,0
46634,1,1,162966,162968,162969,2,3,0
46635,5,2,162971,162971,162973,0,2,2
46636,6,2,162977,162977,162979,0,2,4
46637,6,2,162983,162983,162985,0,2,4
46638,4,2,162987,162987,162989,0,2,2
46639,6,1,162993,162993,162994,0,1,4
46640,5,1,162998,162998,162999,0,1,4
46641,5,1,163003,163003,163004,0,1,4
46642,4,2,163007,163007,163009,0,2,3
46643,5,1,163012,163012,163013,0,1,3
46644,6,1,163018,163018,163019,0,1,5
46645,6,1,163024,163024,163025,0,1,5
46646,6,2,163030,163030,163032,0,2,5
46647,6,3,163036,163036,163039,0,3,4
46648,4,1,163040,163040,163041,0,1,1
46649,4,1,163044,163044,163045,0,1,3
46650,2,1,163046,163046,163047,0,1,1
46651,2,3,163048,163048,163051,0,3,1
46652,5,2,163053,163053,163055,0,2,2
46653,1,1,163054,163055,163056,1,2,0
46654,4,1,163058,163058,163059,0,1,2
46655,3,3,163061,163061,163064,0,3,2
46656,6,3,163067,163067,163070,0,3,3
46657,3,2,163070,163070,163072,0,2,0
46658,2,2,163072,163072,163074,0,2,0
46659,6,3,163078,163078,163081,0,3,4
46660,1,1,163079,163081,163082,2,3,0
46661,6,3,163085,163085,163088,0,3,3
46662,1,1,163086,163088,163089,2,3,0
46663,2,3,163088,163089,163092,1,4,0
46664,1,1,163089,163092,163093,3,4,0
46665,6,3,163095,163095,163098,0,3,2
46666,4,1,163099,163099,163100,0,1,1
46667,3,3,163102,163102,163105,0,3,2
46668,5,2,163107,163107,163109,0,2,2
46669,5,1,163112,163112,163113,0,1,3
46670,2,3,163114,163114,163117,0,3,1
46671,4,2,163118,163118,163120,0,2,1
46672,1,3,163119,163120,163123,1,4,0
46673,6,2,163125,163125,163127,0,2,2
46674,2,1,163127,163127,163128,0,1,0
46675,3,1,163130,163130,163131,0,1,2
46676,3,1,163133,163133,163134,0,1,2
46677,6,2,163139,163139,163141,0,2,5
46678,4,3,163143,163143,163146,0,3,2
46679,4,2,163147,163147,163149,0,2,1
46680,6,2,163153,163153,163155,0,2,4
46681,3,3,163156,163156,163159,0,3,1
46682,1,3,163157,163159,163162,2,5,0
46683,5,1,163162,163162,163163,0,1,0
46684,1,1,163163,163163,163164,0,1,0
46685,3,2,163166,163166,163168,0,2,2
46686,4,1,163170,163170,163171,0,1,2
46687,6,2,163176,163176,163178,0,2,5
46688,2,1,163178,163178,163179,0,1,0
46689,2,1,163180,163180,163181,0,1,1
46690,3,1,163183,163183,163184,0,1,2
46691,6,2,163189,163189,163191,0,2,5
46692,3,2,163192,163192,163194,0,2,1
46693,1,1,163193,163194,163195,1,2,0
46694,2,1,163195,163195,163196,0,1,0
46695,4,3,163199,163199,163202,0,3,3
46696,2,3,163201,163202,163205,1,4,0
46697,6,3,163207,163207,163210,0,3,2
46698,1,1,163208,163210,163211,2,3,0
46699,4,3,163212,163212,163215,0,3,1
46700,1,3,163213,163215,163218,2,5,0
46701,5,3,163218,163218,163221,0,3,0
46702,1,3,163219,163221,163224,2,5,0
46703,5,1,163224,163224,163225,0,1,0
46704,1,1,163225,163225,163226,0,1,0
46705,3,2,163228,163228,163230,0,2,2
46706,5,3,163233,163233,163236,0,3,3
46707,6,2,163239,163239,163241,0,2,3
46708,1,2,163240,163241,163243,1,3,0
46709,5,3,163245,163245,163248,0,3,2
46710,5,3,163250,163250,163253,0,3,2
46711,1,3,163251,163253,163256,2,5,0
46712,4,1,163255,163256,163257,1,2,0
46713,2,3,163257,163257,163260,0,3,0
46714,2,1,163259,163260,163261,1,2,0
46715,5,3,163264,163264,163267,0,3,3
46716,4,2,163268,163268,163270,0,2,1
46717,6,2,163274,163274,163276,0,2,4
46718,5,3,163279,163279,163282,0,3,3
46719,6,3,163285,163285,163288,0,3,3
46720,3,2,163288,163288,163290,0,2,0
46721,2,3,163290,163290,163293,0,3,0
46722,3,3,163293,163293,163296,0,3,0
46723,3,1,163296,163296,163297,0,1,0
46724,5,2,163301,163301,163303,0,2,4
46725,3,3,163304,163304,163307,0,3,1
46726,3,3,163307,163307,163310,0,3,0
46727,5,3,163312,163312,163315,0,3,2
46728,3,2,163315,163315,163317,0,2,0
46729,4,2,163319,163319,163321,0,2,2
46730,2,3,163321,163321,163324,0,3,0
46731,4,1,163325,163325,163326,0,1,1
46732,5,1,163330,163330,163331,0,1,4
46733,4,2,163334,163334,163336,0,2,3
46734,2,3,163336,163336,163339,0,3,0
46735,2,1,163338,163339,163340,1,2,0
46736,3,2,163341,163341,163343,0,2,1
46737,5,1,163346,163346,163347,0,1,3
46738,6,1,163352,163352,163353,0,1,5
46739,2,1,163354,163354,163355,0,1,1
46740,5,1,163359,163359,163360,0,1,4
46741,6,2,163365,163365,163367,0,2,5
46742,4,3,163369,163369,163372,0,3,2
46743,4,1,163373,163373,163374,0,1,1
46744,5,2,163378,163378,163380,0,2,4
46745,5,1,163383,163383,163384,0,1,3
46746,3,2,163386,163386,163388,0,2,2
46747,1,1,163387,163388,163389,1,2,0
46748,4,2,163391,163391,163393,0,2,2
46749,5,1,163396,163396,163397,0,1,3
46750,1,2,163397,163397,163399,0,2,0
46751,5,1,163402,163402,163403,0,1,3
46752,5,3,163407,163407,163410,0,3,4
46753,1,1,163408,163410,163411,2,3,0
46754,5,1,163413,163413,163414,0,1,2
46755,6,2,163419,163419,163421,0,2,5
46756,5,1,163424,163424,163425,0,1,3
46757,1,2,163425,163425,163427,0,2,0
46758,4,1,163429,163429,163430,0,1,2
46759,4,3,163433,163433,163436,0,3,3
46760,6,1,163439,163439,163440,0,1,3
46761,5,3,163444,163444,163447,0,3,4
46762,1,1,163445,163447,163448,2,3,0
46763,4,2,163449,163449,163451,0,2,1
46764,1,1,163450,163451,163452,1,2,0
46765,3,2,163453,163453,163455,0,2,1
46766,2,3,163455,163455,163458,0,3,0
46767,6,3,163461,163461,163464,0,3,3
46768,3,3,163464,163464,163467,0,3,0
46769,4,3,163468,163468,163471,0,3,1
46770,6,3,163474,163474,163477,0,3,3
46771,3,3,163477,163477,163480,0,3,0
46772,4,3,163481,163481,163484,0,3,1
46773,5,1,163486,163486,163487,0,1,2
46774,3,2,163489,163489,163491,0,2,2
46775,6,1,163495,163495,163496,0,1,4
46776,2,3,163497,163497,163500,0,3,1
46777,6,1,163503,163503,163504,0,1,3
46778,5,1,163508,163508,163509,0,1,4
46779,4,2,163512,163512,163514,0,2,3
46780,6,3,163518,163518,163521,0,3,4
46781,2,3,163520,163521,163524,1,4,0
46782,2,3,163522,163524,163527,2,5,0
46783,5,1,163527,163527,163528,0,1,0
46784,2,1,163529,163529,163530,0,1,1
46785,5,3,163534,163534,163537,0,3,4
46786,2,2,163536,163537,163539,1,3,0
46787,3,2,163539,163539,163541,0,2,0
46788,1,2,163540,163541,163543,1,3,0
46789,3,2,163543,163543,163545,0,2,0
46790,5,3,163548,163548,163551,0,3,3
46791,6,3,163554,163554,163557,0,3,3
46792,6,3,163560,163560,163563,0,3,3
46793,1,1,163561,163563,163564,2,3,0
46794,6,3,163567,163567,163570,0,3,3
46795,4,3,163571,163571,163574,0,3,1
46796,4,2,163575,163575,163577,0,2,1
46797,4,1,163579,163579,163580,0,1,2
46798,5,3,163584,163584,163587,0,3,4
46799,2,2,163586,163587,163589,1,3,0
46800,3,3,163589,163589,163592,0,3,0
46801,6,2,163595,163595,163597,0,2,3
46802,2,2,163597,163597,163599,0,2,0
46803,3,3,163600,163600,163603,0,3,1
46804,6,3,163606,163606,163609,0,3,3
46805,1,1,163607,163609,163610,2,3,0
46806,4,1,163611,163611,163612,0,1,1
46807,5,1,163616,163616,163617,0,1,4
46808,5,3,163621,163621,163624,0,3,4
46809,5,2,163626,163626,163628,0,2,2
46810,2,3,163628,163628,163631,0,3,0
46811,4,1,163632,163632,163633,0,1,1
46812,1,3,163633,163633,163636,0,3,0
46813,4,1,163637,163637,163638,0,1,1
46814,6,3,163643,163643,163646,0,3,5
46815,3,2,163646,163646,163648,0,2,0
46816,4,1,163650,163650,163651,0,1,2
46817,6,2,163656,163656,163658,0,2,5
46818,5,2,163661,163661,163663,0,2,3
46819,4,3,163665,163665,163668,0,3,2
46820,5,3,163670,163670,163673,0,3,2
46821,5,3,163675,163675,163678,0,3,2
46822,4,1,163679,163679,163680,0,1,1
46823,5,3,163684,163684,163687,0,3,4
46824,3,3,163687,163687,163690,0,3,0
46825,1,3,163688,163690,163693,2,5,0
46826,1,1,163689,163693,163694,4,5,0
46827,3,3,163692,163694,163697,2,5,0
46828,3,1,163695,163697,163698,2,3,0
46829,4,1,163699,163699,163700,0,1,1
46830,6,1,163705,163705,163706,0,1,5
46831,5,3,163710,163710,163713,0,3,4
46832,6,3,163716,163716,163719,0,3,3
46833,2,3,163718,163719,163722,1,4,0
46834,4,2,163722,163722,163724,0,2,0
46835,2,1,163724,163724,163725,0,1,0
46836,3,1,163727,163727,163728,0,1,2
46837,1,2,163728,163728,163730,0,2,0
46838,1,3,163729,163730,163733,1,4,0
46839,6,1,163735,163735,163736,0,1,2
46840,4,2,163739,163739,163741,0,2,3
46841,3,3,163742,163742,163745,0,3,1
46842,4,3,163746,163746,163749,0,3,1
46843,6,1,163752,163752,163753,0,1,3
46844,4,1,163756,163756,163757,0,1,3
46845,4,3,163760,163760,163763,0,3,3
46846,4,3,163764,163764,163767,0,3,1
46847,1,2,163765,163767,163769,2,4,0
46848,4,3,163769,163769,163772,0,3,0
46849,1,3,163770,163772,163775,2,5,0
46850,1,2,163771,163775,163777,4,6,0
46851,3,3,163774,163777,163780,3,6,0
46852,4,1,163778,163780,163781,2,3,0
46853,6,1,163784,163784,163785,0,1,3
46854,4,1,163788,163788,163789,0,1,3
46855,5,2,163793,163793,163795,0,2,4
46856,3,3,163796,163796,163799,0,3,1
46857,4,1,163800,163800,163801,0,1,1
46858,1,2,163801,163801,163803,0,2,0
46859,5,2,163806,163806,163808,0,2,3
46860,3,2,163809,163809,163811,0,2,1
46861,5,2,163814,163814,163816,0,2,3
46862,6,1,163820,163820,163821,0,1,4
46863,1,1,163821,163821,163822,0,1,0
46864,3,3,163824,163824,163827,0,3,2
46865,6,3,163830,163830,163833,0,3,3
46866,6,2,163836,163836,163838,0,2,3
46867,5,2,163841,163841,163843,0,2,3
46868,5,1,163846,163846,163847,0,1,3
46869,6,1,163852,163852,163853,0,1,5
46870,5,2,163857,163857,163859,0,2,4
46871,6,2,163863,163863,163865,0,2,4
46872,5,2,163868,163868,163870,0,2,3
46873,6,3,163874,163874,163877,0,3,4
46874,6,1,163880,163880,163881,0,1,3
46875,3,3,163883,163883,163886,0,3,2
46876,1,2,163884,163886,163888,2,4,0
46877,3,3,163887,163888,163891,1,4,0
46878,3,3,163890,163891,163894,1,4,0
46879,5,1,163895,163895,163896,0,1,1
46880,1,1,163896,163896,163897,0,1,0
46881,2,1,163898,163898,163899,0,1,1
46882,5,1,163903,163903,163904,0,1,4
46883,3,2,163906,163906,163908,0,2,2
46884,3,3,163909,163909,163912,0,3,1
46885,5,3,163914,163914,163917,0,3,2
46886,2,3,163916,163917,163920,1,4,0
46887,1,1,163917,163920,163921,3,4,0
46888,4,2,163921,163921,163923,0,2,0
46889,2,3,163923,163923,163926,0,3,0
46890,1,3,163924,163926,163929,2,5,0
46891,6,3,163930,163930,163933,0,3,1
46892,6,2,163936,163936,163938,0,2,3
46893,1,1,163937,163938,163939,1,2,0
46894,6,2,163943,163943,163945,0,2,4
46895,2,3,163945,163945,163948,0,3,0
46896,4,2,163949,163949,163951,0,2,1
46897,6,1,163955,163955,163956,0,1,4
46898,4,2,163959,163959,163961,0,2,3
46899,3,1,163962,163962,163963,0,1,1
46900,3,3,163965,163965,163968,0,3,2
46901,4,1,163969,163969,163970,0,1,1
46902,6,1,163975,163975,163976,0,1,5
46903,3,1,163978,163978,163979,0,1,2
46904,1,3,163979,163979,163982,0,3,0
46905,2,1,163981,163982,163983,1,2,0
46906,4,2,163985,163985,163987,0,2,2
46907,3,1,163988,163988,163989,0,1,1
46908,4,1,163992,163992,163993,0,1,3
46909,3,3,163995,163995,163998,0,3,2
46910,1,3,163996,163998,164001,2,5,0
46911,6,2,164002,164002,164004,0,2,1
46912,4,2,164006,164006,164008,0,2,2
46913,3,3,164009,164009,164012,0,3,1
46914,4,3,164013,164013,164016,0,3,1
46915,5,2,164018,164018,164020,0,2,2
46916,5,3,164023,164023,164026,0,3,3
46917,5,3,164028,164028,164031,0,3,2
46918,6,3,164034,164034,164037,0,3,3
46919,2,2,164036,164037,164039,1,3,0
46920,6,1,164042,164042,164043,0,1,3
46921,6,1,164048,164048,164049,0,1,5
46922,6,2,164054,164054,164056,0,2,5
46923,5,2,164059,164059,164061,0,2,3
46924,6,3,164065,164065,164068,0,3,4
46925,1,3,164066,164068,164071,2,5,0
46926,4,3,164070,164071,164074,1,4,0
46927,5,1,164075,164075,164076,0,1,1
46928,3,1,164078,164078,164079,0,1,2
46929,1,3,164079,164079,164082,0,3,0
46930,5,1,164084,164084,164085,0,1,2
46931,1,1,164085,164085,164086,0,1,0
46932,6,1,164091,164091,164092,0,1,5
46933,3,2,164094,164094,164096,0,2,2
46934,2,3,164096,164096,164099,0,3,0
46935,3,1,164099,164099,164100,0,1,0
46936,2,1,164101,164101,164102,0,1,1
46937,2,3,164103,164103,164106,0,3,1
46938,2,2,164105,164106,164108,1,3,0
46939,2,3,164107,164108,164111,1,4,0
46940,3,2,164110,164111,164113,1,3,0
46941,2,1,164112,164113,164114,1,2,0
46942,5,3,164117,164117,164120,0,3,3
46943,4,3,164121,164121,164124,0,3,1
46944,1,1,164122,164124,164125,2,3,0
46945,1,2,164123,164125,164127,2,4,0
46946,4,1,164127,164127,164128,0,1,0
46947,3,3,164130,164130,164133,0,3,2
46948,3,1,164133,164133,164134,0,1,0
46949,5,2,164138,164138,164140,0,2,4
46950,3,2,164141,164141,164143,0,2,1
46951,3,2,164144,164144,164146,0,2,1
46952,6,3,164150,164150,164153,0,3,4
46953,2,2,164152,164153,164155,1,3,0
46954,1,3,164153,164155,164158,2,5,0
46955,4,2,164157,164158,164160,1,3,0
46956,5,2,164162,164162,164164,0,2,2
46957,5,3,164167,164167,164170,0,3,3
46958,4,3,164171,164171,164174,0,3,1
46959,6,3,164177,164177,164180,0,3,3
46960,4,3,164181,164181,164184,0,3,1
46961,1,3,164182,164184,164187,2,5,0
46962,2,1,164184,164187,164188,3,4,0
46963,5,2,164189,164189,164191,0,2,1
46964,2,2,164191,164191,164193,0,2,0
46965,3,1,164194,164194,164195,0,1,1
46966,6,1,164200,164200,164201,0,1,5
46967,3,3,164203,164203,164206,0,3,2
46968,2,1,164205,164206,164207,1,2,0
46969,4,1,164209,164209,164210,0,1,2
46970,2,2,164211,164211,164213,0,2,1
46971,4,2,164215,164215,164217,0,2,2
46972,5,2,164220,164220,164222,0,2,3
46973,6,1,164226,164226,164227,0,1,4
46974,3,1,164229,164229,164230,0,1,2
46975,6,1,164235,164235,164236,0,1,5
46976,2,3,164237,164237,164240,0,3,1
46977,1,2,164238,164240,164242,2,4,0
46978,6,3,164244,164244,164247,0,3,2
46979,1,3,164245,164247,164250,2,5,0
46980,5,1,164250,164250,164251,0,1,0
46981,6,1,164256,164256,164257,0,1,5
46982,6,3,164262,164262,164265,0,3,5
46983,5,2,164267,164267,164269,0,2,2
46984,1,1,164268,164269,164270,1,2,0
46985,3,2,164271,164271,164273,0,2,1
46986,4,1,164275,164275,164276,0,1,2
46987,3,3,164278,164278,164281,0,3,2
46988,4,3,164282,164282,164285,0,3,1
46989,1,3,164283,164285,164288,2,5,0
46990,2,1,164285,164288,164289,3,4,0
46991,5,3,164290,164290,164293,0,3,1
46992,5,3,164295,164295,164298,0,3,2
46993,3,1,164298,164298,164299,0,1,0
46994,4,2,164302,164302,164304,0,2,3
46995,5,2,164307,164307,164309,0,2,3
46996,1,1,164308,164309,164310,1,2,0
46997,2,2,164310,164310,164312,0,2,0
46998,2,3,164312,164312,164315,0,3,0
46999,2,1,164314,164315,164316,1,2,0
47000,5,1,164319,164319,164320,0,1,3
47001,1,2,164320,164320,164322,0,2,0
47002,6,2,164326,164326,164328,0,2,4
47003,3,1,164329,164329,164330,0,1,1
47004,2,2,164331,164331,164333,0,2,1
47005,5,1,164336,164336,164337,0,1,3
47006,3,3,164339,164339,164342,0,3,2
47007,5,1,164344,164344,164345,0,1,2
47008,6,1,164350,164350,164351,0,1,5
47009,2,1,164352,164352,164353,0,1,1
47010,4,2,164356,164356,164358,0,2,3
47011,6,2,164362,164362,164364,0,2,4
47012,4,1,164366,164366,164367,0,1,2
47013,6,1,164372,164372,164373,0,1,5
47014,4,2,164376,164376,164378,0,2,3
47015,4,3,164380,164380,164383,0,3,2
47016,2,2,164382,164383,164385,1,3,0
47017,6,3,164388,164388,164391,0,3,3
47018,1,1,164389,164391,164392,2,3,0
47019,1,2,164390,164392,164394,2,4,0
47020,2,3,164392,164394,164397,2,5,0
47021,4,1,164396,164397,164398,1,2,0
47022,4,2,164400,164400,164402,0,2,2
47023,6,1,164406,164406,164407,0,1,4
47024,1,1,164407,164407,164408,0,1,0
47025,5,2,164412,164412,164414,0,2,4
47026,4,2,164416,164416,164418,0,2,2
47027,1,2,164417,164418,164420,1,3,0
47028,5,1,164422,164422,164423,0,1,2
47029,1,2,164423,164423,164425,0,2,0
47030,5,1,164428,164428,164429,0,1,3
47031,1,2,164429,164429,164431,0,2,0
47032,1,2,164430,164431,164433,1,3,0
47033,5,2,164435,164435,164437,0,2,2
47034,6,2,164441,164441,164443,0,2,4
47035,6,3,164447,164447,164450,0,3,4
47036,1,1,164448,164450,164451,2,3,0
47037,5,2,164453,164453,164455,0,2,2
47038,3,1,164456,164456,164457,0,1,1
47039,6,1,164462,164462,164463,0,1,5
47040,3,2,164465,164465,164467,0,2,2
47041,1,3,164466,164467,164470,1,4,0
47042,1,1,164467,164470,164471,3,4,0
47043,2,1,164469,164471,164472,2,3,0
47044,6,2,164475,164475,164477,0,2,3
47045,3,3,164478,164478,164481,0,3,1
47046,5,3,164483,164483,164486,0,3,2
47047,6,1,164489,164489,164490,0,1,3
47048,6,2,164495,164495,164497,0,2,5
47049,6,1,164501,164501,164502,0,1,4
47050,2,1,164503,164503,164504,0,1,1
47051,3,2,164506,164506,164508,0,2,2
47052,1,1,164507,164508,164509,1,2,0
47053,5,1,164512,164512,164513,0,1,3
47054,1,2,164513,164513,164515,0,2,0
47055,5,2,164518,164518,164520,0,2,3
47056,4,2,164522,164522,164524,0,2,2
47057,3,3,164525,164525,164528,0,3,1
47058,3,2,164528,164528,164530,0,2,0
47059,3,3,164531,164531,164534,0,3,1
47060,5,3,164536,164536,164539,0,3,2
47061,4,1,164540,164540,164541,0,1,1
47062,5,2,164545,164545,164547,0,2,4
47063,2,1,164547,164547,164548,0,1,0
47064,2,3,164549,164549,164552,0,3,1
47065,5,2,164554,164554,164556,0,2,2
47066,1,3,164555,164556,164559,1,4,0
47067,5,2,164560,164560,164562,0,2,1
47068,4,3,164564,164564,164567,0,3,2
47069,2,1,164566,164567,164568,1,2,0
47070,3,2,164569,164569,164571,0,2,1
47071,4,3,164573,164573,164576,0,3,2
47072,2,2,164575,164576,164578,1,3,0
47073,3,3,164578,164578,164581,0,3,0
47074,5,3,164583,164583,164586,0,3,2
47075,5,3,164588,164588,164591,0,3,2
47076,5,1,164593,164593,164594,0,1,2
47077,3,3,164596,164596,164599,0,3,2
47078,5,2,164601,164601,164603,0,2,2
47079,4,1,164605,164605,164606,0,1,2
47080,1,2,164606,164606,164608,0,2,0
47081,2,3,164608,164608,164611,0,3,0
47082,6,1,164614,164614,164615,0,1,3
47083,3,1,164617,164617,164618,0,1,2
47084,6,1,164623,164623,164624,0,1,5
47085,6,3,164629,164629,164632,0,3,5
47086,2,2,164631,164632,164634,1,3,0
47087,2,3,164633,164634,164637,1,4,0
47088,2,2,164635,164637,164639,2,4,0
47089,2,3,164637,164639,164642,2,5,0
47090,2,2,164639,164642,164644,3,5,0
47091,4,1,164643,164644,164645,1,2,0
47092,3,3,164646,164646,164649,0,3,1
47093,1,2,164647,164649,164651,2,4,0
47094,5,3,164652,164652,164655,0,3,1
47095,2,3,164654,164655,164658,1,4,0
47096,4,3,164658,164658,164661,0,3,0
47097,6,1,164664,164664,164665,0,1,3
47098,6,2,164670,164670,164672,0,2,5
47099,1,1,164671,164672,164673,1,2,0
47100,3,2,164674,164674,164676,0,2,1
47101,6,1,164680,164680,164681,0,1,4
47102,5,1,164685,164685,164686,0,1,4
47103,5,1,164690,164690,164691,0,1,4
47104,2,2,164692,164692,164694,0,2,1
47105,5,3,164697,164697,164700,0,3,3
47106,6,1,164703,164703,164704,0,1,3
47107,3,2,164706,164706,164708,0,2,2
47108,3,1,164709,164709,164710,0,1,1
47109,2,1,164711,164711,164712,0,1,1
47110,1,3,164712,164712,164715,0,3,0
47111,2,2,164714,164715,164717,1,3,0
47112,4,1,164718,164718,164719,0,1,1
47113,4,2,164722,164722,164724,0,2,3
47114,4,3,164726,164726,164729,0,3,2
47115,3,3,164729,164729,164732,0,3,0
47116,4,2,164733,164733,164735,0,2,1
47117,3,2,164736,164736,164738,0,2,1
47118,1,2,164737,164738,164740,1,3,0
47119,1,3,164738,164740,164743,2,5,0
47120,6,3,164744,164744,164747,0,3,1
47121,1,3,164745,164747,164750,2,5,0
47122,3,3,164748,164750,164753,2,5,0
47123,4,1,164752,164753,164754,1,2,0
47124,3,1,164755,164755,164756,0,1,1
47125,3,2,164758,164758,164760,0,2,2
47126,2,1,164760,164760,164761,0,1,0
47127,2,3,164762,164762,164765,0,3,1
47128,1,1,164763,164765,164766,2,3,0
47129,4,2,164767,164767,164769,0,2,1
47130,3,3,164770,164770,164773,0,3,1
47131,3,3,164773,164773,164776,0,3,0
47132,3,2,164776,164776,164778,0,2,0
47133,2,3,164778,164778,164781,0,3,0
47134,2,2,164780,164781,164783,1,3,0
47135,4,1,164784,164784,164785,0,1,1
47136,1,2,164785,164785,164787,0,2,0
47137,6,2,164791,164791,164793,0,2,4
47138,1,3,164792,164793,164796,1,4,0
47139,6,1,164798,164798,164799,0,1,2
47140,2,2,164800,164800,164802,0,2,1
47141,4,2,164804,164804,164806,0,2,2
47142,2,2,164806,164806,164808,0,2,0
47143,3,1,164809,164809,164810,0,1,1
47144,3,3,164812,164812,164815,0,3,2
47145,3,2,164815,164815,164817,0,2,0
47146,6,3,164821,164821,164824,0,3,4
47147,3,2,164824,164824,164826,0,2,0
47148,3,1,164827,164827,164828,0,1,1
47149,1,2,164828,164828,164830,0,2,0
47150,6,2,164834,164834,164836,0,2,4
47151,5,1,164839,164839,164840,0,1,3
47152,3,2,164842,164842,164844,0,2,2
47153,5,2,164847,164847,164849,0,2,3
47154,2,3,164849,164849,164852,0,3,0
47155,5,3,164854,164854,164857,0,3,2
47156,5,3,164859,164859,164862,0,3,2
47157,5,3,164864,164864,164867,0,3,2
47158,3,3,164867,164867,164870,0,3,0
47159,1,1,164868,164870,164871,2,3,0
47160,2,3,164870,164871,164874,1,4,0
47161,1,1,164871,164874,164875,3,4,0
47162,3,1,164874,164875,164876,1,2,0
47163,3,2,164877,164877,164879,0,2,1
47164,3,1,164880,164880,164881,0,1,1
47165,2,1,164882,164882,164883,0,1,1
47166,1,1,164883,164883,164884,0,1,0
47167,4,3,164887,164887,164890,0,3,3
47168,6,3,164893,164893,164896,0,3,3
47169,3,3,164896,164896,164899,0,3,0
47170,4,1,164900,164900,164901,0,1,1
47171,6,1,164906,164906,164907,0,1,5
47172,6,3,164912,164912,164915,0,3,5
47173,6,3,164918,164918,164921,0,3,3
47174,4,1,164922,164922,164923,0,1,1
47175,5,2,164927,164927,164929,0,2,4
47176,2,1,164929,164929,164930,0,1,0
47177,3,2,164932,164932,164934,0,2,2
47178,6,2,164938,164938,164940,0,2,4
47179,6,1,164944,164944,164945,0,1,4
47180,5,3,164949,164949,164952,0,3,4
47181,2,1,164951,164952,164953,1,2,0
47182,5,1,164956,164956,164957,0,1,3
47183,6,1,164962,164962,164963,0,1,5
47184,2,3,164964,164964,164967,0,3,1
47185,3,2,164967,164967,164969,0,2,0
47186,2,3,164969,164969,164972,0,3,0
47187,2,3,164971,164972,164975,1,4,0
47188,6,3,164977,164977,164980,0,3,2
47189,1,1,164978,164980,164981,2,3,0
47190,1,1,164979,164981,164982,2,3,0
47191,1,2,164980,164982,164984,2,4,0
47192,5,3,164985,164985,164988,0,3,1
47193,1,2,164986,164988,164990,2,4,0
47194,4,2,164990,164990,164992,0,2,0
47195,5,3,164995,164995,164998,0,3,3
47196,5,2,165000,165000,165002,0,2,2
47197,2,2,165002,165002,165004,0,2,0
47198,4,3,165006,165006,165009,0,3,2
47199,2,3,165008,165009,165012,1,4,0
47200,5,3,165013,165013,165016,0,3,1
47201,4,1,165017,165017,165018,0,1,1
47202,4,3,165021,165021,165024,0,3,3
47203,1,2,165022,165024,165026,2,4,0
47204,4,2,165026,165026,165028,0,2,0
47205,1,2,165027,165028,165030,1,3,0
47206,5,3,165032,165032,165035,0,3,2
47207,2,2,165034,165035,165037,1,3,0
47208,5,3,165039,165039,165042,0,3,2
47209,4,3,165043,165043,165046,0,3,1
47210,6,1,165049,165049,165050,0,1,3
47211,5,3,165054,165054,165057,0,3,4
47212,3,2,165057,165057,165059,0,2,0
47213,1,1,165058,165059,165060,1,2,0
47214,5,2,165063,165063,165065,0,2,3
47215,2,3,165065,165065,165068,0,3,0
47216,5,3,165070,165070,165073,0,3,2
47217,6,1,165076,165076,165077,0,1,3
47218,1,2,165077,165077,165079,0,2,0
47219,2,3,165079,165079,165082,0,3,0
47220,3,1,165082,165082,165083,0,1,0
47221,6,3,165088,165088,165091,0,3,5
47222,1,2,165089,165091,165093,2,4,0
47223,5,1,165094,165094,165095,0,1,1
47224,6,1,165100,165100,165101,0,1,5
47225,3,1,165103,165103,165104,0,1,2
47226,4,1,165107,165107,165108,0,1,3
47227,1,2,165108,165108,165110,0,2,0
47228,5,3,165113,165113,165116,0,3,3
47229,2,2,165115,165116,165118,1,3,0
47230,6,3,165121,165121,165124,0,3,3
47231,6,2,165127,165127,165129,0,2,3
47232,6,2,165133,165133,165135,0,2,4
47233,2,3,165135,165135,165138,0,3,0
47234,5,3,165140,165140,165143,0,3,2
47235,4,1,165144,165144,165145,0,1,1
47236,6,3,165150,165150,165153,0,3,5
47237,5,1,165155,165155,165156,0,1,2
47238,6,1,165161,165161,165162,0,1,5
47239,1,1,165162,165162,165163,0,1,0
47240,4,1,165166,165166,165167,0,1,3
47241,3,3,165169,165169,165172,0,3,2
47242,5,3,165174,165174,165177,0,3,2
47243,5,1,165179,165179,165180,0,1,2
47244,1,2,165180,165180,165182,0,2,0
47245,6,3,165186,165186,165189,0,3,4
47246,2,3,165188,165189,165192,1,4,0
47247,6,1,165194,165194,165195,0,1,2
47248,2,2,165196,165196,165198,0,2,1
47249,3,2,165199,165199,165201,0,2,1
47250,3,3,165202,165202,165205,0,3,1
47251,2,2,165204,165205,165207,1,3,0
47252,3,1,165207,165207,165208,0,1,0
47253,1,3,165208,165208,165211,0,3,0
47254,2,2,165210,165211,165213,1,3,0
47255,2,3,165212,165213,165216,1,4,0
47256,2,2,165214,165216,165218,2,4,0
47257,6,3,165220,165220,165223,0,3,2
47258,3,3,165223,165223,165226,0,3,0
47259,2,3,165225,165226,165229,1,4,0
47260,1,2,165226,165229,165231,3,5,0
47261,3,3,165229,165231,165234,2,5,0
47262,2,3,165231,165234,165237,3,6,0
47263,3,3,165234,165237,165240,3,6,0
47264,4,1,165238,165240,165241,2,3,0
47265,4,1,165242,165242,165243,0,1,1
47266,6,3,165248,165248,165251,0,3,5
47267,5,1,165253,165253,165254,0,1,2
47268,4,2,165257,165257,165259,0,2,3
47269,5,3,165262,165262,165265,0,3,3
47270,5,3,165267,165267,165270,0,3,2
47271,3,2,165270,165270,165272,0,2,0
47272,1,2,165271,165272,165274,1,3,0
47273,5,1,165276,165276,165277,0,1,2
47274,5,3,165281,165281,165284,0,3,4
47275,1,2,165282,165284,165286,2,4,0
47276,2,1,165284,165286,165287,2,3,0
47277,1,1,165285,165287,165288,2,3,0
47278,1,1,165286,165288,165289,2,3,0
47279,3,3,165289,165289,165292,0,3,0
47280,4,3,165293,165293,165296,0,3,1
47281,1,3,165294,165296,165299,2,5,0
47282,2,2,165296,165299,165301,3,5,0
47283,2,2,165298,165301,165303,3,5,0
47284,3,1,165301,165303,165304,2,3,0
47285,4,3,165305,165305,165308,0,3,1
47286,5,1,165310,165310,165311,0,1,2
47287,4,1,165314,165314,165315,0,1,3
47288,5,2,165319,165319,165321,0,2,4
47289,4,1,165323,165323,165324,0,1,2
47290,2,3,165325,165325,165328,0,3,1
47291,3,2,165328,165328,165330,0,2,0
47292,5,3,165333,165333,165336,0,3,3
47293,1,3,165334,165336,165339,2,5,0
47294,5,1,165339,165339,165340,0,1,0
47295,4,2,165343,165343,165345,0,2,3
47296,6,1,165349,165349,165350,0,1,4
47297,4,1,165353,165353,165354,0,1,3
47298,5,1,165358,165358,165359,0,1,4
47299,5,1,165363,165363,165364,0,1,4
47300,2,1,165365,165365,165366,0,1,1
47301,1,2,165366,165366,165368,0,2,0
47302,6,2,165372,165372,165374,0,2,4
47303,3,1,165375,165375,165376,0,1,1
47304,4,1,165379,165379,165380,0,1,3
47305,4,3,165383,165383,165386,0,3,3
47306,2,1,165385,165386,165387,1,2,0
47307,4,1,165389,165389,165390,0,1,2
47308,4,1,165393,165393,165394,0,1,3
47309,2,3,165395,165395,165398,0,3,1
47310,2,1,165397,165398,165399,1,2,0
47311,4,3,165401,165401,165404,0,3,2
47312,4,2,165405,165405,165407,0,2,1
47313,5,3,165410,165410,165413,0,3,3
47314,2,3,165412,165413,165416,1,4,0
47315,1,2,165413,165416,165418,3,5,0
47316,6,1,165419,165419,165420,0,1,1
47317,6,2,165425,165425,165427,0,2,5
47318,2,2,165427,165427,165429,0,2,0
47319,3,1,165430,165430,165431,0,1,1
47320,4,3,165434,165434,165437,0,3,3
47321,2,3,165436,165437,165440,1,4,0
47322,4,2,165440,165440,165442,0,2,0
47323,5,1,165445,165445,165446,0,1,3
47324,6,2,165451,165451,165453,0,2,5
47325,5,3,165456,165456,165459,0,3,3
47326,6,3,165462,165462,165465,0,3,3
47327,4,2,165466,165466,165468,0,2,1
47328,1,1,165467,165468,165469,1,2,0
47329,6,2,165473,165473,165475,0,2,4
47330,2,1,165475,165475,165476,0,1,0
47331,6,2,165481,165481,165483,0,2,5
47332,2,2,165483,165483,165485,0,2,0
47333,6,1,165489,165489,165490,0,1,4
47334,3,2,165492,165492,165494,0,2,2
47335,2,3,165494,165494,165497,0,3,0
47336,2,2,165496,165497,165499,1,3,0
47337,4,3,165500,165500,165503,0,3,1
47338,6,1,165506,165506,165507,0,1,3
47339,3,3,165509,165509,165512,0,3,2
47340,3,1,165512,165512,165513,0,1,0
47341,3,1,165515,165515,165516,0,1,2
47342,4,2,165519,165519,165521,0,2,3
47343,4,1,165523,165523,165524,0,1,2
47344,3,3,165526,165526,165529,0,3,2
47345,6,2,165532,165532,165534,0,2,3
47346,2,2,165534,165534,165536,0,2,0
47347,6,2,165540,165540,165542,0,2,4
47348,2,1,165542,165542,165543,0,1,0
47349,3,3,165545,165545,165548,0,3,2
47350,6,2,165551,165551,165553,0,2,3
47351,5,1,165556,165556,165557,0,1,3
47352,6,1,165562,165562,165563,0,1,5
47353,6,3,165568,165568,165571,0,3,5
47354,3,3,165571,165571,165574,0,3,0
47355,5,1,165576,165576,165577,0,1,2
47356,2,1,165578,165578,165579,0,1,1
47357,6,3,165584,165584,165587,0,3,5
47358,1,1,165585,165587,165588,2,3,0
47359,6,1,165591,165591,165592,0,1,3
47360,2,1,165593,165593,165594,0,1,1
47361,4,3,165597,165597,165600,0,3,3
47362,4,3,165601,165601,165604,0,3,1
47363,3,2,165604,165604,165606,0,2,0
47364,1,1,165605,165606,165607,1,2,0
47365,5,2,165610,165610,165612,0,2,3
47366,6,2,165616,165616,165618,0,2,4
47367,5,2,165621,165621,165623,0,2,3
47368,1,3,165622,165623,165626,1,4,0
47369,3,1,165625,165626,165627,1,2,0
47370,6,3,165631,165631,165634,0,3,4
47371,4,1,165635,165635,165636,0,1,1
47372,3,2,165638,165638,165640,0,2,2
47373,2,2,165640,165640,165642,0,2,0
47374,4,3,165644,165644,165647,0,3,2
47375,2,1,165646,165647,165648,1,2,0
47376,1,3,165647,165648,165651,1,4,0
47377,1,1,165648,165651,165652,3,4,0
47378,3,1,165651,165652,165653,1,2,0
47379,2,2,165653,165653,165655,0,2,0
47380,2,3,165655,165655,165658,0,3,0
47381,1,2,165656,165658,165660,2,4,0
47382,2,3,165658,165660,165663,2,5,0
47383,1,2,165659,165663,165665,4,6,0
47384,3,1,165662,165665,165666,3,4,0
47385,5,3,165667,165667,165670,0,3,1
47386,2,2,165669,165670,165672,1,3,0
47387,4,2,165673,165673,165675,0,2,1
47388,1,3,165674,165675,165678,1,4,0
47389,2,3,165676,165678,165681,2,5,0
47390,6,1,165682,165682,165683,0,1,1
47391,6,1,165688,165688,165689,0,1,5
47392,1,1,165689,165689,165690,0,1,0
47393,4,1,165693,165693,165694,0,1,3
47394,4,2,165697,165697,165699,0,2,3
47395,6,3,165703,165703,165706,0,3,4
47396,3,1,165706,165706,165707,0,1,0
47397,3,3,165709,165709,165712,0,3,2
47398,3,3,165712,165712,165715,0,3,0
47399,1,2,165713,165715,165717,2,4,0
47400,2,1,165715,165717,165718,2,3,0
47401,3,1,165718,165718,165719,0,1,0
47402,1,3,165719,165719,165722,0,3,0
47403,1,2,165720,165722,165724,2,4,0
47404,5,1,165725,165725,165726,0,1,1
47405,1,3,165726,165726,165729,0,3,0
47406,3,1,165729,165729,165730,0,1,0
47407,5,1,165734,165734,165735,0,1,4
47408,2,1,165736,165736,165737,0,1,1
47409,1,2,165737,165737,165739,0,2,0
47410,1,1,165738,165739,165740,1,2,0
47411,3,3,165741,165741,165744,0,3,1
47412,1,3,165742,165744,165747,2,5,0
47413,2,2,165744,165747,165749,3,5,0
47414,1,2,165745,165749,165751,4,6,0
47415,5,2,165750,165751,165753,1,3,0
47416,4,2,165754,165754,165756,0,2,1
47417,1,3,165755,165756,165759,1,4,0
47418,5,3,165760,165760,165763,0,3,1
47419,6,1,165766,165766,165767,0,1,3
47420,1,2,165767,165767,165769,0,2,0
47421,3,2,165770,165770,165772,0,2,1
47422,3,3,165773,165773,165776,0,3,1
47423,3,1,165776,165776,165777,0,1,0
47424,2,3,165778,165778,165781,0,3,1
47425,2,2,165780,165781,165783,1,3,0
47426,4,3,165784,165784,165787,0,3,1
47427,5,3,165789,165789,165792,0,3,2
47428,4,1,165793,165793,165794,0,1,1
47429,3,3,165796,165796,165799,0,3,2
47430,3,3,165799,165799,165802,0,3,0
47431,2,3,165801,165802,165805,1,4,0
47432,6,1,165807,165807,165808,0,1,2
47433,4,2,165811,165811,165813,0,2,3
47434,6,2,165817,165817,165819,0,2,4
47435,6,3,165823,165823,165826,0,3,4
47436,4,2,165827,165827,165829,0,2,1
47437,3,1,165830,165830,165831,0,1,1
47438,3,1,165833,165833,165834,0,1,2
47439,6,2,165839,165839,165841,0,2,5
47440,4,2,165843,165843,165845,0,2,2
47441,1,1,165844,165845,165846,1,2,0
47442,3,2,165847,165847,165849,0,2,1
47443,4,1,165851,165851,165852,0,1,2
47444,1,3,165852,165852,165855,0,3,0
47445,5,2,165857,165857,165859,0,2,2
47446,4,2,165861,165861,165863,0,2,2
47447,4,2,165865,165865,165867,0,2,2
47448,2,3,165867,165867,165870,0,3,0
47449,4,2,165871,165871,165873,0,2,1
47450,5,2,165876,165876,165878,0,2,3
47451,6,2,165882,165882,165884,0,2,4
47452,4,3,165886,165886,165889,0,3,2
47453,6,3,165892,165892,165895,0,3,3
47454,1,1,165893,165895,165896,2,3,0
47455,3,3,165896,165896,165899,0,3,0
47456,3,3,165899,165899,165902,0,3,0
47457,4,2,165903,165903,165905,0,2,1
47458,3,3,165906,165906,165909,0,3,1
47459,6,3,165912,165912,165915,0,3,3
47460,1,3,165913,165915,165918,2,5,0
47461,2,3,165915,165918,165921,3,6,0
47462,3,3,165918,165921,165924,3,6,0
47463,6,2,165924,165924,165926,0,2,0
47464,2,3,165926,165926,165929,0,3,0
47465,6,2,165932,165932,165934,0,2,3
47466,1,1,165933,165934,165935,1,2,0
47467,2,3,165935,165935,165938,0,3,0
47468,3,1,165938,165938,165939,0,1,0
47469,5,3,165943,165943,165946,0,3,4
47470,2,3,165945,165946,165949,1,4,0
47471,5,2,165950,165950,165952,0,2,1
47472,1,3,165951,165952,165955,1,4,0
47473,5,2,165956,165956,165958,0,2,1
47474,4,2,165960,165960,165962,0,2,2
47475,6,3,165966,165966,165969,0,3,4
47476,3,2,165969,165969,165971,0,2,0
47477,1,3,165970,165971,165974,1,4,0
47478,3,2,165973,165974,165976,1,3,0
47479,6,1,165979,165979,165980,0,1,3
47480,6,3,165985,165985,165988,0,3,5
47481,4,3,165989,165989,165992,0,3,1
47482,3,1,165992,165992,165993,0,1,0
47483,3,2,165995,165995,165997,0,2,2
47484,4,2,165999,165999,166001,0,2,2
47485,2,2,166001,166001,166003,0,2,0
47486,3,2,166004,166004,166006,0,2,1
47487,4,2,166008,166008,166010,0,2,2
47488,4,1,166012,166012,166013,0,1,2
47489,5,3,166017,166017,166020,0,3,4
47490,1,2,166018,166020,166022,2,4,0
47491,3,1,166021,166022,166023,1,2,0
47492,2,1,166023,166023,166024,0,1,0
47493,5,3,166028,166028,166031,0,3,4
47494,3,2,166031,166031,166033,0,2,0
47495,3,1,166034,166034,166035,0,1,1
47496,2,1,166036,166036,166037,0,1,1
47497,4,2,166040,166040,166042,0,2,3
47498,5,1,166045,166045,166046,0,1,3
47499,3,2,166048,166048,166050,0,2,2
47500,2,3,166050,166050,166053,0,3,0
47501,5,1,166055,166055,166056,0,1,2
47502,6,3,166061,166061,166064,0,3,5
47503,4,1,166065,166065,166066,0,1,1
47504,4,2,166069,166069,166071,0,2,3
47505,4,1,166073,166073,166074,0,1,2
47506,5,2,166078,166078,166080,0,2,4
47507,5,2,166083,166083,166085,0,2,3
47508,2,1,166085,166085,166086,0,1,0
47509,2,1,166087,166087,166088,0,1,1
47510,3,2,166090,166090,166092,0,2,2
47511,2,1,166092,166092,166093,0,1,0
47512,5,1,166097,166097,166098,0,1,4
47513,6,1,166103,166103,166104,0,1,5
47514,2,3,166105,166105,166108,0,3,1
47515,3,1,166108,166108,166109,0,1,0
47516,6,2,166114,166114,166116,0,2,5
47517,2,1,166116,166116,166117,0,1,0
47518,6,2,166122,166122,166124,0,2,5
47519,5,2,166127,166127,166129,0,2,3
47520,4,1,166131,166131,166132,0,1,2
47521,2,2,166133,166133,166135,0,2,1
47522,2,2,166135,166135,166137,0,2,0
47523,1,2,166136,166137,166139,1,3,0
47524,4,3,166140,166140,166143,0,3,1
47525,5,3,166145,166145,166148,0,3,2
47526,6,2,166151,166151,166153,0,2,3
47527,1,1,166152,166153,166154,1,2,0
47528,1,3,166153,166154,166157,1,4,0
47529,5,1,166158,166158,166159,0,1,1
47530,6,2,166164,166164,166166,0,2,5
47531,2,2,166166,166166,166168,0,2,0
47532,4,3,166170,166170,166173,0,3,2
47533,3,3,166173,166173,166176,0,3,0
47534,3,3,166176,166176,166179,0,3,0
47535,2,1,166178,166179,166180,1,2,0
47536,3,2,166181,166181,166183,0,2,1
47537,3,3,166184,166184,166187,0,3,1
47538,5,2,166189,166189,166191,0,2,2
47539,2,3,166191,166191,166194,0,3,0
47540,1,1,166192,166194,166195,2,3,0
47541,3,3,166195,166195,166198,0,3,0
47542,6,2,166201,166201,166203,0,2,3
47543,3,1,166204,166204,166205,0,1,1
47544,3,2,166207,166207,166209,0,2,2
47545,2,2,166209,166209,166211,0,2,0
47546,3,2,166212,166212,166214,0,2,1
47547,1,3,166213,166214,166217,1,4,0
47548,4,2,166217,166217,166219,0,2,0
47549,3,3,166220,166220,166223,0,3,1
47550,2,1,166222,166223,166224,1,2,0
47551,5,1,166227,166227,166228,0,1,3
47552,1,1,166228,166228,166229,0,1,0
47553,2,1,166230,166230,166231,0,1,1
47554,3,1,166233,166233,166234,0,1,2
47555,6,3,166239,166239,166242,0,3,5
47556,2,2,166241,166242,166244,1,3,0
47557,3,2,166244,166244,166246,0,2,0
47558,5,3,166249,166249,166252,0,3,3
47559,1,3,166250,166252,166255,2,5,0
47560,1,3,166251,166255,166258,4,7,0
47561,6,3,166257,166258,166261,1,4,0
47562,2,1,166259,166261,166262,2,3,0
47563,1,1,166260,166262,166263,2,3,0
47564,6,1,166266,166266,166267,0,1,3
47565,3,1,166269,166269,166270,0,1,2
47566,2,1,166271,166271,166272,0,1,1
47567,3,1,166274,166274,166275,0,1,2
47568,4,1,166278,166278,166279,0,1,3
47569,4,3,166282,166282,166285,0,3,3
47570,1,2,166283,166285,166287,2,4,0
47571,6,3,166289,166289,166292,0,3,2
47572,5,2,166294,166294,166296,0,2,2
47573,6,1,166300,166300,166301,0,1,4
47574,5,3,166305,166305,166308,0,3,4
47575,6,1,166311,166311,166312,0,1,3
47576,6,3,166317,166317,166320,0,3,5
47577,2,1,166319,166320,166321,1,2,0
47578,4,1,166323,166323,166324,0,1,2
47579,3,2,166326,166326,166328,0,2,2
47580,3,1,166329,166329,166330,0,1,1
47581,2,3,166331,166331,166334,0,3,1
47582,1,1,166332,166334,166335,2,3,0
47583,6,1,166338,166338,166339,0,1,3
47584,3,1,166341,166341,166342,0,1,2
47585,4,3,166345,166345,166348,0,3,3
47586,3,3,166348,166348,166351,0,3,0
47587,2,3,166350,166351,166354,1,4,0
47588,5,2,166355,166355,166357,0,2,1
47589,2,2,166357,166357,166359,0,2,0
47590,4,1,166361,166361,166362,0,1,2
47591,1,2,166362,166362,166364,0,2,0
47592,6,1,166368,166368,166369,0,1,4
47593,1,1,166369,166369,166370,0,1,0
47594,2,3,166371,166371,166374,0,3,1
47595,6,3,166377,166377,166380,0,3,3
47596,2,3,166379,166380,166383,1,4,0
47597,3,2,166382,166383,166385,1,3,0
47598,6,2,166388,166388,166390,0,2,3
47599,4,3,166392,166392,166395,0,3,2
47600,5,2,166397,166397,166399,0,2,2
47601,5,2,166402,166402,166404,0,2,3
47602,1,2,166403,166404,166406,1,3,0
47603,6,1,166409,166409,166410,0,1,3
47604,3,1,166412,166412,166413,0,1,2
47605,6,1,166418,166418,166419,0,1,5
47606,3,3,166421,166421,166424,0,3,2
47607,5,2,166426,166426,166428,0,2,2
47608,4,1,166430,166430,166431,0,1,2
47609,6,2,166436,166436,166438,0,2,5
47610,2,1,166438,166438,166439,0,1,0
47611,2,2,166440,166440,166442,0,2,1
47612,5,2,166445,166445,166447,0,2,3
47613,1,2,166446,166447,166449,1,3,0
47614,6,2,166452,166452,166454,0,2,3
47615,3,1,166455,166455,166456,0,1,1
47616,5,1,166460,166460,166461,0,1,4
47617,6,1,166466,166466,166467,0,1,5
47618,6,3,166472,166472,166475,0,3,5
47619,6,3,166478,166478,166481,0,3,3
47620,4,2,166482,166482,166484,0,2,1
47621,5,3,166487,166487,166490,0,3,3
47622,3,2,166490,166490,166492,0,2,0
47623,6,2,166496,166496,166498,0,2,4
47624,4,3,166500,166500,166503,0,3,2
47625,6,2,166506,166506,166508,0,2,3
47626,6,3,166512,166512,166515,0,3,4
47627,2,3,166514,166515,166518,1,4,0
47628,3,3,166517,166518,166521,1,4,0
47629,5,2,166522,166522,166524,0,2,1
47630,6,2,166528,166528,166530,0,2,4
47631,3,3,166531,166531,166534,0,3,1
47632,3,2,166534,166534,166536,0,2,0
47633,1,3,166535,166536,166539,1,4,0
47634,1,3,166536,166539,166542,3,6,0
47635,6,1,166542,166542,166543,0,1,0
47636,4,3,166546,166546,166549,0,3,3
47637,6,3,166552,166552,166555,0,3,3
47638,6,2,166558,166558,166560,0,2,3
47639,6,3,166564,166564,166567,0,3,4
47640,2,1,166566,166567,166568,1,2,0
47641,3,3,166569,166569,166572,0,3,1
47642,5,2,166574,166574,166576,0,2,2
47643,6,3,166580,166580,166583,0,3,4
47644,3,3,166583,166583,166586,0,3,0
47645,1,1,166584,166586,166587,2,3,0
47646,3,3,166587,166587,166590,0,3,0
47647,4,1,166591,166591,166592,0,1,1
47648,2,2,166593,166593,166595,0,2,1
47649,3,2,166596,166596,166598,0,2,1
47650,3,1,166599,166599,166600,0,1,1
47651,2,2,166601,166601,166603,0,2,1
47652,2,2,166603,166603,166605,0,2,0
47653,2,1,166605,166605,166606,0,1,0
47654,5,3,166610,166610,166613,0,3,4
47655,4,3,166614,166614,166617,0,3,1
47656,1,1,166615,166617,166618,2,3,0
47657,3,2,166618,166618,166620,0,2,0
47658,1,2,166619,166620,166622,1,3,0
47659,2,2,166621,166622,166624,1,3,0
47660,1,2,166622,166624,166626,2,4,0
47661,3,1,166625,166626,166627,1,2,0
47662,5,3,166630,166630,166633,0,3,3
47663,5,1,166635,166635,166636,0,1,2
47664,6,3,166641,166641,166644,0,3,5
47665,4,1,166645,166645,166646,0,1,1
47666,1,3,166646,166646,166649,0,3,0
47667,2,1,166648,166649,166650,1,2,0
47668,5,1,166653,166653,166654,0,1,3
47669,4,2,166657,166657,166659,0,2,3
47670,1,3,166658,166659,166662,1,4,0
47671,3,2,166661,166662,166664,1,3,0
47672,4,2,166665,166665,166667,0,2,1
47673,5,1,166670,166670,166671,0,1,3
47674,2,2,166672,166672,166674,0,2,1
47675,3,1,166675,166675,166676,0,1,1
47676,1,3,166676,166676,166679,0,3,0
47677,2,3,166678,166679,166682,1,4,0
47678,1,3,166679,166682,166685,3,6,0
47679,2,2,166681,166685,166687,4,6,0
47680,5,2,166686,166687,166689,1,3,0
47681,4,1,166690,166690,166691,0,1,1
47682,1,1,166691,166691,166692,0,1,0
47683,2,2,166693,166693,166695,0,2,1
47684,1,3,166694,166695,166698,1,4,0
47685,6,1,166700,166700,166701,0,1,2
47686,4,1,166704,166704,166705,0,1,3
47687,4,1,166708,166708,166709,0,1,3
47688,1,2,166709,166709,166711,0,2,0
47689,6,1,166715,166715,166716,0,1,4
47690,5,2,166720,166720,166722,0,2,4
47691,5,3,166725,166725,166728,0,3,3
47692,5,2,166730,166730,166732,0,2,2
47693,1,3,166731,166732,166735,1,4,0
47694,2,2,166733,166735,166737,2,4,0
47695,2,3,166735,166737,166740,2,5,0
47696,2,3,166737,166740,166743,3,6,0
47697,4,3,166741,166743,166746,2,5,0
47698,6,2,166747,166747,166749,0,2,1
47699,3,1,166750,166750,166751,0,1,1
47700,4,2,166754,166754,166756,0,2,3
47701,1,1,166755,166756,166757,1,2,0
47702,2,2,166757,166757,166759,0,2,0
47703,6,2,166763,166763,166765,0,2,4
47704,2,3,166765,166765,166768,0,3,0
47705,4,1,166769,166769,166770,0,1,1
47706,2,3,166771,166771,166774,0,3,1
47707,4,2,166775,166775,166777,0,2,1
47708,4,2,166779,166779,166781,0,2,2
47709,1,2,166780,166781,166783,1,3,0
47710,5,2,166785,166785,166787,0,2,2
47711,2,3,166787,166787,166790,0,3,0
47712,1,1,166788,166790,166791,2,3,0
47713,4,1,166792,166792,166793,0,1,1
47714,3,2,166795,166795,166797,0,2,2
47715,2,1,166797,166797,166798,0,1,0
47716,6,2,166803,166803,166805,0,2,5
47717,4,1,166807,166807,166808,0,1,2
47718,6,2,166813,166813,166815,0,2,5
47719,5,1,166818,166818,166819,0,1,3
47720,5,2,166823,166823,166825,0,2,4
47721,2,1,166825,166825,166826,0,1,0
47722,6,3,166831,166831,166834,0,3,5
47723,4,3,166835,166835,166838,0,3,1
47724,3,3,166838,166838,166841,0,3,0
47725,6,3,166844,166844,166847,0,3,3
47726,5,1,166849,166849,166850,0,1,2
47727,3,3,166852,166852,166855,0,3,2
47728,3,2,166855,166855,166857,0,2,0
47729,4,1,166859,166859,166860,0,1,2
47730,5,2,166864,166864,166866,0,2,4
47731,6,1,166870,166870,166871,0,1,4
47732,4,3,166874,166874,166877,0,3,3
47733,3,3,166877,166877,166880,0,3,0
47734,3,1,166880,166880,166881,0,1,0
47735,1,3,166881,166881,166884,0,3,0
47736,1,1,166882,166884,166885,2,3,0
47737,1,3,166883,166885,166888,2,5,0
47738,2,3,166885,166888,166891,3,6,0
47739,6,2,166891,166891,166893,0,2,0
47740,1,3,166892,166893,166896,1,4,0
47741,5,3,166897,166897,166900,0,3,1
47742,4,3,166901,166901,166904,0,3,1
47743,2,3,166903,166904,166907,1,4,0
47744,3,2,166906,166907,166909,1,3,0
47745,2,3,166908,166909,166912,1,4,0
47746,4,1,166912,166912,166913,0,1,0
47747,5,1,166917,166917,166918,0,1,4
47748,1,2,166918,166918,166920,0,2,0
47749,3,2,166921,166921,166923,0,2,1
47750,4,3,166925,166925,166928,0,3,2
47751,6,2,166931,166931,166933,0,2,3
47752,2,3,166933,166933,166936,0,3,0
47753,3,2,166936,166936,166938,0,2,0
47754,3,3,166939,166939,166942,0,3,1
47755,1,1,166940,166942,166943,2,3,0
47756,1,1,166941,166943,166944,2,3,0
47757,5,2,166946,166946,166948,0,2,2
47758,1,3,166947,166948,166951,1,4,0
47759,5,3,166952,166952,166955,0,3,1
47760,6,2,166958,166958,166960,0,2,3
47761,4,3,166962,166962,166965,0,3,2
47762,3,2,166965,166965,166967,0,2,0
47763,3,2,166968,166968,166970,0,2,1
47764,4,1,166972,166972,166973,0,1,2
47765,4,1,166976,166976,166977,0,1,3
47766,1,2,166977,166977,166979,0,2,0
47767,2,3,166979,166979,166982,0,3,0
47768,3,3,166982,166982,166985,0,3,0
47769,4,2,166986,166986,166988,0,2,1
47770,1,3,166987,166988,166991,1,4,0
47771,5,2,166992,166992,166994,0,2,1
47772,6,3,166998,166998,167001,0,3,4
47773,1,3,166999,167001,167004,2,5,0
47774,6,3,167005,167005,167008,0,3,1
47775,1,1,167006,167008,167009,2,3,0
47776,4,1,167010,167010,167011,0,1,1
47777,2,2,167012,167012,167014,0,2,1
47778,4,2,167016,167016,167018,0,2,2
47779,3,3,167019,167019,167022,0,3,1
47780,4,3,167023,167023,167026,0,3,1
47781,1,1,167024,167026,167027,2,3,0
47782,4,1,167028,167028,167029,0,1,1
47783,3,2,167031,167031,167033,0,2,2
47784,5,2,167036,167036,167038,0,2,3
47785,5,3,167041,167041,167044,0,3,3
47786,5,2,167046,167046,167048,0,2,2
47787,5,3,167051,167051,167054,0,3,3
47788,4,1,167055,167055,167056,0,1,1
47789,3,3,167058,167058,167061,0,3,2
47790,5,2,167063,167063,167065,0,2,2
47791,5,2,167068,167068,167070,0,2,3
47792,6,2,167074,167074,167076,0,2,4
47793,2,1,167076,167076,167077,0,1,0
47794,2,2,167078,167078,167080,0,2,1
47795,4,1,167082,167082,167083,0,1,2
47796,5,3,167087,167087,167090,0,3,4
47797,4,2,167091,167091,167093,0,2,1
47798,2,2,167093,167093,167095,0,2,0
47799,2,1,167095,167095,167096,0,1,0
47800,6,2,167101,167101,167103,0,2,5
47801,5,1,167106,167106,167107,0,1,3
47802,1,1,167107,167107,167108,0,1,0
47803,3,1,167110,167110,167111,0,1,2
47804,1,1,167111,167111,167112,0,1,0
47805,5,3,167116,167116,167119,0,3,4
47806,4,1,167120,167120,167121,0,1,1
47807,5,3,167125,167125,167128,0,3,4
47808,4,1,167129,167129,167130,0,1,1
47809,3,1,167132,167132,167133,0,1,2
47810,1,3,167133,167133,167136,0,3,0
47811,1,1,167134,167136,167137,2,3,0
47812,3,3,167137,167137,167140,0,3,0
47813,4,3,167141,167141,167144,0,3,1
47814,2,1,167143,167144,167145,1,2,0
47815,2,1,167145,167145,167146,0,1,0
47816,4,1,167149,167149,167150,0,1,3
47817,4,3,167153,167153,167156,0,3,3
47818,6,2,167159,167159,167161,0,2,3
47819,2,1,167161,167161,167162,0,1,0
47820,4,2,167165,167165,167167,0,2,3
47821,3,3,167168,167168,167171,0,3,1
47822,4,1,167172,167172,167173,0,1,1
47823,4,1,167176,167176,167177,0,1,3
47824,1,2,167177,167177,167179,0,2,0
47825,2,3,167179,167179,167182,0,3,0
47826,5,2,167184,167184,167186,0,2,2
47827,4,3,167188,167188,167191,0,3,2
47828,3,2,167191,167191,167193,0,2,0
47829,1,2,167192,167193,167195,1,3,0
47830,5,2,167197,167197,167199,0,2,2
47831,3,3,167200,167200,167203,0,3,1
47832,4,2,167204,167204,167206,0,2,1
47833,5,1,167209,167209,167210,0,1,3
47834,1,3,167210,167210,167213,0,3,0
47835,1,2,167211,167213,167215,2,4,0
47836,3,1,167214,167215,167216,1,2,0
47837,3,1,167217,167217,167218,0,1,1
47838,4,1,167221,167221,167222,0,1,3
47839,6,2,167227,167227,167229,0,2,5
47840,4,3,167231,167231,167234,0,3,2
47841,1,1,167232,167234,167235,2,3,0
47842,5,1,167237,167237,167238,0,1,2
47843,4,2,167241,167241,167243,0,2,3
47844,3,2,167244,167244,167246,0,2,1
47845,4,1,167248,167248,167249,0,1,2
47846,1,3,167249,167249,167252,0,3,0
47847,6,1,167255,167255,167256,0,1,3
47848,6,1,167261,167261,167262,0,1,5
47849,4,1,167265,167265,167266,0,1,3
47850,2,2,167267,167267,167269,0,2,1
47851,6,2,167273,167273,167275,0,2,4
47852,1,2,167274,167275,167277,1,3,0
47853,1,3,167275,167277,167280,2,5,0
47854,6,2,167281,167281,167283,0,2,1
47855,1,3,167282,167283,167286,1,4,0
47856,5,2,167287,167287,167289,0,2,1
47857,6,3,167293,167293,167296,0,3,4
47858,5,3,167298,167298,167301,0,3,2
47859,2,1,167300,167301,167302,1,2,0
47860,2,2,167302,167302,167304,0,2,0
47861,1,1,167303,167304,167305,1,2,0
47862,4,2,167307,167307,167309,0,2,2
47863,6,1,167313,167313,167314,0,1,4
47864,3,3,167316,167316,167319,0,3,2
47865,3,1,167319,167319,167320,0,1,0
47866,2,3,167321,167321,167324,0,3,1
47867,1,2,167322,167324,167326,2,4,0
47868,3,2,167325,167326,167328,1,3,0
47869,1,1,167326,167328,167329,2,3,0
47870,3,2,167329,167329,167331,0,2,0
47871,2,2,167331,167331,167333,0,2,0
47872,3,1,167334,167334,167335,0,1,1
47873,3,3,167337,167337,167340,0,3,2
47874,2,1,167339,167340,167341,1,2,0
47875,3,3,167342,167342,167345,0,3,1
47876,3,2,167345,167345,167347,0,2,0
47877,6,1,167351,167351,167352,0,1,4
47878,2,1,167353,167353,167354,0,1,1
47879,2,1,167355,167355,167356,0,1,1
47880,5,2,167360,167360,167362,0,2,4
47881,3,2,167363,167363,167365,0,2,1
47882,1,1,167364,167365,167366,1,2,0
47883,3,3,167367,167367,167370,0,3,1
47884,6,1,167373,167373,167374,0,1,3
47885,5,2,167378,167378,167380,0,2,4
47886,1,2,167379,167380,167382,1,3,0
47887,2,1,167381,167382,167383,1,2,0
47888,6,3,167387,167387,167390,0,3,4
47889,5,2,167392,167392,167394,0,2,2
47890,6,3,167398,167398,167401,0,3,4
47891,2,3,167400,167401,167404,1,4,0
47892,1,2,167401,167404,167406,3,5,0
47893,5,3,167406,167406,167409,0,3,0
47894,1,3,167407,167409,167412,2,5,0
47895,1,3,167408,167412,167415,4,7,0
47896,4,2,167412,167415,167417,3,5,0
47897,5,1,167417,167417,167418,0,1,0
47898,2,3,167419,167419,167422,0,3,1
47899,6,3,167425,167425,167428,0,3,3
47900,2,3,167427,167428,167431,1,4,0
47901,1,2,167428,167431,167433,3,5,0
47902,5,1,167433,167433,167434,0,1,0
47903,1,2,167434,167434,167436,0,2,0
47904,3,3,167437,167437,167440,0,3,1
47905,6,3,167443,167443,167446,0,3,3
47906,5,3,167448,167448,167451,0,3,2
47907,5,1,167453,167453,167454,0,1,2
47908,6,2,167459,167459,167461,0,2,5
47909,2,3,167461,167461,167464,0,3,0
47910,4,3,167465,167465,167468,0,3,1
47911,4,3,167469,167469,167472,0,3,1
47912,4,3,167473,167473,167476,0,3,1
47913,1,2,167474,167476,167478,2,4,0
47914,2,3,167476,167478,167481,2,5,0
47915,5,3,167481,167481,167484,0,3,0
47916,1,2,167482,167484,167486,2,4,0
47917,2,1,167484,167486,167487,2,3,0
47918,5,3,167489,167489,167492,0,3,2
47919,6,3,167495,167495,167498,0,3,3
47920,4,2,167499,167499,167501,0,2,1
47921,2,3,167501,167501,167504,0,3,0
47922,5,2,167506,167506,167508,0,2,2
47923,4,2,167510,167510,167512,0,2,2
47924,6,2,167516,167516,167518,0,2,4
47925,5,3,167521,167521,167524,0,3,3
47926,5,2,167526,167526,167528,0,2,2
47927,3,3,167529,167529,167532,0,3,1
47928,5,1,167534,167534,167535,0,1,2
47929,2,2,167536,167536,167538,0,2,1
47930,3,3,167539,167539,167542,0,3,1
47931,6,2,167545,167545,167547,0,2,3
47932,2,2,167547,167547,167549,0,2,0
47933,2,3,167549,167549,167552,0,3,0
47934,1,3,167550,167552,167555,2,5,0
47935,3,3,167553,167555,167558,2,5,0
47936,4,1,167557,167558,167559,1,2,0
47937,2,3,167559,167559,167562,0,3,0
47938,1,2,167560,167562,167564,2,4,0
47939,6,2,167566,167566,167568,0,2,2
47940,3,1,167569,167569,167570,0,1,1
47941,3,1,167572,167572,167573,0,1,2
47942,5,2,167577,167577,167579,0,2,4
47943,3,1,167580,167580,167581,0,1,1
47944,5,3,167585,167585,167588,0,3,4
47945,3,2,167588,167588,167590,0,2,0
47946,2,3,167590,167590,167593,0,3,0
47947,2,3,167592,167593,167596,1,4,0
47948,4,1,167596,167596,167597,0,1,0
47949,4,3,167600,167600,167603,0,3,3
47950,2,2,167602,167603,167605,1,3,0
47951,3,1,167605,167605,167606,0,1,0
47952,4,1,167609,167609,167610,0,1,3
47953,5,1,167614,167614,167615,0,1,4
47954,3,2,167617,167617,167619,0,2,2
47955,5,2,167622,167622,167624,0,2,3
47956,3,3,167625,167625,167628,0,3,1
47957,1,1,167626,167628,167629,2,3,0
47958,2,1,167628,167629,167630,1,2,0
47959,3,3,167631,167631,167634,0,3,1
47960,3,1,167634,167634,167635,0,1,0
47961,2,3,167636,167636,167639,0,3,1
47962,1,3,167637,167639,167642,2,5,0
47963,1,2,167638,167642,167644,4,6,0
47964,6,3,167644,167644,167647,0,3,0
47965,1,2,167645,167647,167649,2,4,0
47966,5,2,167650,167650,167652,0,2,1
47967,3,1,167653,167653,167654,0,1,1
47968,4,2,167657,167657,167659,0,2,3
47969,5,3,167662,167662,167665,0,3,3
47970,2,2,167664,167665,167667,1,3,0
47971,4,2,167668,167668,167670,0,2,1
47972,3,3,167671,167671,167674,0,3,1
47973,3,3,167674,167674,167677,0,3,0
47974,5,2,167679,167679,167681,0,2,2
47975,3,2,167682,167682,167684,0,2,1
47976,4,2,167686,167686,167688,0,2,2
47977,1,2,167687,167688,167690,1,3,0
47978,1,3,167688,167690,167693,2,5,0
47979,4,3,167692,167693,167696,1,4,0
47980,1,1,167693,167696,167697,3,4,0
47981,5,1,167698,167698,167699,0,1,1
47982,3,2,167701,167701,167703,0,2,2
47983,6,3,167707,167707,167710,0,3,4
47984,1,3,167708,167710,167713,2,5,0
47985,3,2,167711,167713,167715,2,4,0
47986,1,1,167712,167715,167716,3,4,0
47987,2,2,167714,167716,167718,2,4,0
47988,6,1,167720,167720,167721,0,1,2
47989,6,1,167726,167726,167727,0,1,5
47990,2,3,167728,167728,167731,0,3,1
47991,1,2,167729,167731,167733,2,4,0
47992,5,3,167734,167734,167737,0,3,1
47993,3,2,167737,167737,167739,0,2,0
47994,1,3,167738,167739,167742,1,4,0
47995,6,3,167744,167744,167747,0,3,2
47996,4,3,167748,167748,167751,0,3,1
47997,5,1,167753,167753,167754,0,1,2
47998,1,1,167754,167754,167755,0,1,0
47999,3,2,167757,167757,167759,0,2,2
48000,1,2,167758,167759,167761,1,3,0
48001,5,2,167763,167763,167765,0,2,2
48002,6,3,167769,167769,167772,0,3,4
48003,5,3,167774,167774,167777,0,3,2
48004,3,1,167777,167777,167778,0,1,0
48005,3,1,167780,167780,167781,0,1,2
48006,3,3,167783,167783,167786,0,3,2
48007,2,2,167785,167786,167788,1,3,0
48008,4,1,167789,167789,167790,0,1,1
48009,5,2,167794,167794,167796,0,2,4
48010,6,2,167800,167800,167802,0,2,4
48011,5,3,167805,167805,167808,0,3,3
48012,3,2,167808,167808,167810,0,2,0
48013,1,2,167809,167810,167812,1,3,0
48014,2,2,167811,167812,167814,1,3,0
48015,5,2,167816,167816,167818,0,2,2
48016,2,2,167818,167818,167820,0,2,0
48017,3,3,167821,167821,167824,0,3,1
48018,3,3,167824,167824,167827,0,3,0
48019,2,1,167826,167827,167828,1,2,0
48020,5,2,167831,167831,167833,0,2,3
48021,3,3,167834,167834,167837,0,3,1
48022,2,3,167836,167837,167840,1,4,0
48023,6,3,167842,167842,167845,0,3,2
48024,3,1,167845,167845,167846,0,1,0
48025,1,1,167846,167846,167847,0,1,0
48026,6,1,167852,167852,167853,0,1,5
48027,5,1,167857,167857,167858,0,1,4
48028,4,3,167861,167861,167864,0,3,3
48029,4,2,167865,167865,167867,0,2,1
48030,3,1,167868,167868,167869,0,1,1
48031,3,1,167871,167871,167872,0,1,2
48032,2,3,167873,167873,167876,0,3,1
48033,6,2,167879,167879,167881,0,2,3
48034,6,1,167885,167885,167886,0,1,4
48035,1,2,167886,167886,167888,0,2,0
48036,3,2,167889,167889,167891,0,2,1
48037,6,1,167895,167895,167896,0,1,4
48038,6,3,167901,167901,167904,0,3,5
48039,2,3,167903,167904,167907,1,4,0
48040,4,1,167907,167907,167908,0,1,0
48041,1,3,167908,167908,167911,0,3,0
48042,5,2,167913,167913,167915,0,2,2
48043,4,1,167917,167917,167918,0,1,2
48044,4,1,167921,167921,167922,0,1,3
48045,6,1,167927,167927,167928,0,1,5
48046,2,2,167929,167929,167931,0,2,1
48047,6,3,167935,167935,167938,0,3,4
48048,6,1,167941,167941,167942,0,1,3
48049,4,1,167945,167945,167946,0,1,3
48050,4,3,167949,167949,167952,0,3,3
48051,3,1,167952,167952,167953,0,1,0
48052,3,1,167955,167955,167956,0,1,2
48053,4,2,167959,167959,167961,0,2,3
48054,4,1,167963,167963,167964,0,1,2
48055,5,2,167968,167968,167970,0,2,4
48056,2,3,167970,167970,167973,0,3,0
48057,1,1,167971,167973,167974,2,3,0
48058,5,2,167976,167976,167978,0,2,2
48059,3,1,167979,167979,167980,0,1,1
48060,6,2,167985,167985,167987,0,2,5
48061,3,2,167988,167988,167990,0,2,1
48062,5,2,167993,167993,167995,0,2,3
48063,4,3,167997,167997,168000,0,3,2
48064,1,1,167998,168000,168001,2,3,0
48065,2,2,168000,168001,168003,1,3,0
48066,6,2,168006,168006,168008,0,2,3
48067,6,3,168012,168012,168015,0,3,4
48068,2,3,168014,168015,168018,1,4,0
48069,3,3,168017,168018,168021,1,4,0
48070,2,2,168019,168021,168023,2,4,0
48071,6,2,168025,168025,168027,0,2,2
48072,4,3,168029,168029,168032,0,3,2
48073,1,1,168030,168032,168033,2,3,0
48074,4,3,168034,168034,168037,0,3,1
48075,5,2,168039,168039,168041,0,2,2
48076,2,2,168041,168041,168043,0,2,0
48077,5,3,168046,168046,168049,0,3,3
48078,4,2,168050,168050,168052,0,2,1
48079,5,1,168055,168055,168056,0,1,3
48080,6,1,168061,168061,168062,0,1,5
48081,6,3,168067,168067,168070,0,3,5
48082,1,2,168068,168070,168072,2,4,0
48083,2,3,168070,168072,168075,2,5,0
48084,5,3,168075,168075,168078,0,3,0
48085,1,2,168076,168078,168080,2,4,0
48086,2,1,168078,168080,168081,2,3,0
48087,3,2,168081,168081,168083,0,2,0
48088,3,1,168084,168084,168085,0,1,1
48089,4,3,168088,168088,168091,0,3,3
48090,1,1,168089,168091,168092,2,3,0
48091,1,1,168090,168092,168093,2,3,0
48092,2,1,168092,168093,168094,1,2,0
48093,3,2,168095,168095,168097,0,2,1
48094,3,1,168098,168098,168099,0,1,1
48095,4,1,168102,168102,168103,0,1,3
48096,5,1,168107,168107,168108,0,1,4
48097,3,2,168110,168110,168112,0,2,2
48098,3,2,168113,168113,168115,0,2,1
48099,5,2,168118,168118,168120,0,2,3
48100,6,1,168124,168124,168125,0,1,4
48101,1,2,168125,168125,168127,0,2,0
48102,3,1,168128,168128,168129,0,1,1
48103,2,2,168130,168130,168132,0,2,1
48104,6,2,168136,168136,168138,0,2,4
48105,3,3,168139,168139,168142,0,3,1
48106,4,2,168143,168143,168145,0,2,1
48107,5,3,168148,168148,168151,0,3,3
48108,4,1,168152,168152,168153,0,1,1
48109,2,1,168154,168154,168155,0,1,1
48110,5,1,168159,168159,168160,0,1,4
48111,6,3,168165,168165,168168,0,3,5
48112,4,1,168169,168169,168170,0,1,1
48113,1,1,168170,168170,168171,0,1,0
48114,5,3,168175,168175,168178,0,3,4
48115,6,3,168181,168181,168184,0,3,3
48116,4,2,168185,168185,168187,0,2,1
48117,6,2,168191,168191,168193,0,2,4
48118,1,3,168192,168193,168196,1,4,0
48119,2,1,168194,168196,168197,2,3,0
48120,4,3,168198,168198,168201,0,3,1
48121,4,2,168202,168202,168204,0,2,1
48122,2,2,168204,168204,168206,0,2,0
48123,2,1,168206,168206,168207,0,1,0
48124,6,1,168212,168212,168213,0,1,5
48125,4,1,168216,168216,168217,0,1,3
48126,1,2,168217,168217,168219,0,2,0
48127,2,1,168219,168219,168220,0,1,0
48128,6,3,168225,168225,168228,0,3,5
48129,1,1,168226,168228,168229,2,3,0
48130,5,3,168231,168231,168234,0,3,2
48131,4,2,168235,168235,168237,0,2,1
48132,1,2,168236,168237,168239,1,3,0
48133,3,3,168239,168239,168242,0,3,0
48134,2,2,168241,168242,168244,1,3,0
48135,4,2,168245,168245,168247,0,2,1
48136,4,2,168249,168249,168251,0,2,2
48137,2,2,168251,168251,168253,0,2,0
48138,6,1,168257,168257,168258,0,1,4
48139,2,3,168259,168259,168262,0,3,1
48140,1,1,168260,168262,168263,2,3,0
48141,1,1,168261,168263,168264,2,3,0
48142,2,3,168263,168264,168267,1,4,0
48143,5,1,168268,168268,168269,0,1,1
48144,4,3,168272,168272,168275,0,3,3
48145,4,2,168276,168276,168278,0,2,1
48146,1,2,168277,168278,168280,1,3,0
48147,6,2,168283,168283,168285,0,2,3
48148,2,3,168285,168285,168288,0,3,0
48149,6,1,168291,168291,168292,0,1,3
48150,6,3,168297,168297,168300,0,3,5
48151,1,2,168298,168300,168302,2,4,0
48152,2,3,168300,168302,168305,2,5,0
48153,4,1,168304,168305,168306,1,2,0
48154,3,1,168307,168307,168308,0,1,1
48155,1,1,168308,168308,168309,0,1,0
48156,5,3,168313,168313,168316,0,3,4
48157,3,1,168316,168316,168317,0,1,0
48158,1,2,168317,168317,168319,0,2,0
48159,5,3,168322,168322,168325,0,3,3
48160,6,1,168328,168328,168329,0,1,3
48161,5,1,168333,168333,168334,0,1,4
48162,3,3,168336,168336,168339,0,3,2
48163,1,1,168337,168339,168340,2,3,0
48164,6,1,168343,168343,168344,0,1,3
48165,3,1,168346,168346,168347,0,1,2
48166,1,1,168347,168347,168348,0,1,0
48167,6,1,168353,168353,168354,0,1,5
48168,2,2,168355,168355,168357,0,2,1
48169,3,2,168358,168358,168360,0,2,1
48170,1,3,168359,168360,168363,1,4,0
48171,2,1,168361,168363,168364,2,3,0
48172,1,1,168362,168364,168365,2,3,0
48173,5,1,168367,168367,168368,0,1,2
48174,3,3,168370,168370,168373,0,3,2
48175,2,3,168372,168373,168376,1,4,0
48176,3,1,168375,168376,168377,1,2,0
48177,6,2,168381,168381,168383,0,2,4
48178,2,1,168383,168383,168384,0,1,0
48179,1,2,168384,168384,168386,0,2,0
48180,5,2,168389,168389,168391,0,2,3
48181,1,2,168390,168391,168393,1,3,0
48182,3,2,168393,168393,168395,0,2,0
48183,6,2,168399,168399,168401,0,2,4
48184,2,2,168401,168401,168403,0,2,0
48185,1,2,168402,168403,168405,1,3,0
48186,1,1,168403,168405,168406,2,3,0
48187,4,3,168407,168407,168410,0,3,1
48188,6,2,168413,168413,168415,0,2,3
48189,6,1,168419,168419,168420,0,1,4
48190,3,2,168422,168422,168424,0,2,2
48191,3,1,168425,168425,168426,0,1,1
48192,5,2,168430,168430,168432,0,2,4
48193,5,3,168435,168435,168438,0,3,3
48194,3,3,168438,168438,168441,0,3,0
48195,1,3,168439,168441,168444,2,5,0
48196,3,1,168442,168444,168445,2,3,0
48197,3,2,168445,168445,168447,0,2,0
48198,3,2,168448,168448,168450,0,2,1
48199,2,2,168450,168450,168452,0,2,0
48200,2,2,168452,168452,168454,0,2,0
48201,4,1,168456,168456,168457,0,1,2
48202,4,3,168460,168460,168463,0,3,3
48203,6,3,168466,168466,168469,0,3,3
48204,5,1,168471,168471,168472,0,1,2
48205,4,3,168475,168475,168478,0,3,3
48206,5,1,168480,168480,168481,0,1,2
48207,5,2,168485,168485,168487,0,2,4
48208,4,1,168489,168489,168490,0,1,2
48209,4,3,168493,168493,168496,0,3,3
48210,3,1,168496,168496,168497,0,1,0
48211,2,2,168498,168498,168500,0,2,1
48212,2,1,168500,168500,168501,0,1,0
48213,2,3,168502,168502,168505,0,3,1
48214,3,2,168505,168505,168507,0,2,0
48215,3,1,168508,168508,168509,0,1,1
48216,5,3,168513,168513,168516,0,3,4
48217,1,2,168514,168516,168518,2,4,0
48218,1,1,168515,168518,168519,3,4,0
48219,4,3,168519,168519,168522,0,3,0
48220,4,1,168523,168523,168524,0,1,1
48221,2,2,168525,168525,168527,0,2,1
48222,6,3,168531,168531,168534,0,3,4
48223,6,2,168537,168537,168539,0,2,3
48224,2,1,168539,168539,168540,0,1,0
48225,1,2,168540,168540,168542,0,2,0
48226,3,3,168543,168543,168546,0,3,1
48227,4,2,168547,168547,168549,0,2,1
48228,4,2,168551,168551,168553,0,2,2
48229,2,2,168553,168553,168555,0,2,0
48230,2,2,168555,168555,168557,0,2,0
48231,2,3,168557,168557,168560,0,3,0
48232,6,1,168563,168563,168564,0,1,3
48233,1,1,168564,168564,168565,0,1,0
48234,1,2,168565,168565,168567,0,2,0
48235,1,2,168566,168567,168569,1,3,0
48236,4,3,168570,168570,168573,0,3,1
48237,2,1,168572,168573,168574,1,2,0
48238,5,3,168577,168577,168580,0,3,3
48239,5,1,168582,168582,168583,0,1,2
48240,6,2,168588,168588,168590,0,2,5
48241,6,3,168594,168594,168597,0,3,4
48242,1,3,168595,168597,168600,2,5,0
48243,2,1,168597,168600,168601,3,4,0
48244,4,3,168601,168601,168604,0,3,0
48245,3,1,168604,168604,168605,0,1,0
48246,4,3,168608,168608,168611,0,3,3
48247,6,2,168614,168614,168616,0,2,3
48248,6,1,168620,168620,168621,0,1,4
48249,1,3,168621,168621,168624,0,3,0
48250,1,3,168622,168624,168627,2,5,0
48251,5,3,168627,168627,168630,0,3,0
48252,2,3,168629,168630,168633,1,4,0
48253,4,1,168633,168633,168634,0,1,0
48254,5,3,168638,168638,168641,0,3,4
48255,2,2,168640,168641,168643,1,3,0
48256,4,3,168644,168644,168647,0,3,1
48257,2,1,168646,168647,168648,1,2,0
48258,6,3,168652,168652,168655,0,3,4
48259,5,2,168657,168657,168659,0,2,2
48260,1,2,168658,168659,168661,1,3,0
48261,1,3,168659,168661,168664,2,5,0
48262,1,2,168660,168664,168666,4,6,0
48263,5,3,168665,168666,168669,1,4,0
48264,6,1,168671,168671,168672,0,1,2
48265,3,1,168674,168674,168675,0,1,2
48266,5,1,168679,168679,168680,0,1,4
48267,1,2,168680,168680,168682,0,2,0
48268,5,1,168685,168685,168686,0,1,3
48269,3,2,168688,168688,168690,0,2,2
48270,1,2,168689,168690,168692,1,3,0
48271,2,3,168691,168692,168695,1,4,0
48272,6,1,168697,168697,168698,0,1,2
48273,2,2,168699,168699,168701,0,2,1
48274,3,2,168702,168702,168704,0,2,1
48275,5,3,168707,168707,168710,0,3,3
48276,2,1,168709,168710,168711,1,2,0
48277,3,2,168712,168712,168714,0,2,1
48278,3,2,168715,168715,168717,0,2,1
48279,1,3,168716,168717,168720,1,4,0
48280,3,1,168719,168720,168721,1,2,0
48281,4,1,168723,168723,168724,0,1,2
48282,2,1,168725,168725,168726,0,1,1
48283,4,2,168729,168729,168731,0,2,3
48284,6,1,168735,168735,168736,0,1,4
48285,3,3,168738,168738,168741,0,3,2
48286,3,2,168741,168741,168743,0,2,0
48287,4,1,168745,168745,168746,0,1,2
48288,3,3,168748,168748,168751,0,3,2
48289,1,1,168749,168751,168752,2,3,0
48290,6,3,168755,168755,168758,0,3,3
48291,6,2,168761,168761,168763,0,2,3
48292,1,1,168762,168763,168764,1,2,0
48293,1,1,168763,168764,168765,1,2,0
48294,6,2,168769,168769,168771,0,2,4
48295,5,2,168774,168774,168776,0,2,3
48296,2,3,168776,168776,168779,0,3,0
48297,4,3,168780,168780,168783,0,3,1
48298,1,2,168781,168783,168785,2,4,0
48299,1,3,168782,168785,168788,3,6,0
48300,4,2,168786,168788,168790,2,4,0
48301,3,1,168789,168790,168791,1,2,0
48302,6,3,168795,168795,168798,0,3,4
48303,5,3,168800,168800,168803,0,3,2
48304,1,1,168801,168803,168804,2,3,0
48305,6,2,168807,168807,168809,0,2,3
48306,3,1,168810,168810,168811,0,1,1
48307,1,2,168811,168811,168813,0,2,0
48308,6,1,168817,168817,168818,0,1,4
48309,1,3,168818,168818,168821,0,3,0
48310,3,1,168821,168821,168822,0,1,0
48311,4,2,168825,168825,168827,0,2,3
48312,2,1,168827,168827,168828,0,1,0
48313,1,1,168828,168828,168829,0,1,0
48314,1,2,168829,168829,168831,0,2,0
48315,6,1,168835,168835,168836,0,1,4
48316,4,1,168839,168839,168840,0,1,3
48317,1,1,168840,168840,168841,0,1,0
48318,3,2,168843,168843,168845,0,2,2
48319,6,2,168849,168849,168851,0,2,4
48320,3,2,168852,168852,168854,0,2,1
48321,2,3,168854,168854,168857,0,3,0
48322,6,2,168860,168860,168862,0,2,3
48323,1,2,168861,168862,168864,1,3,0
48324,1,1,168862,168864,168865,2,3,0
48325,1,1,168863,168865,168866,2,3,0
48326,2,1,168865,168866,168867,1,2,0
48327,4,3,168869,168869,168872,0,3,2
48328,2,3,168871,168872,168875,1,4,0
48329,1,1,168872,168875,168876,3,4,0
48330,4,3,168876,168876,168879,0,3,0
48331,6,3,168882,168882,168885,0,3,3
48332,4,3,168886,168886,168889,0,3,1
48333,6,3,168892,168892,168895,0,3,3
48334,6,1,168898,168898,168899,0,1,3
48335,3,2,168901,168901,168903,0,2,2
48336,1,1,168902,168903,168904,1,2,0
48337,4,2,168906,168906,168908,0,2,2
48338,4,3,168910,168910,168913,0,3,2
48339,6,3,168916,168916,168919,0,3,3
48340,4,3,168920,168920,168923,0,3,1
48341,1,3,168921,168923,168926,2,5,0
48342,3,3,168924,168926,168929,2,5,0
48343,5,1,168929,168929,168930,0,1,0
48344,3,3,168932,168932,168935,0,3,2
48345,6,1,168938,168938,168939,0,1,3
48346,1,1,168939,168939,168940,0,1,0
48347,2,3,168941,168941,168944,0,3,1
48348,2,2,168943,168944,168946,1,3,0
48349,5,3,168948,168948,168951,0,3,2
48350,2,3,168950,168951,168954,1,4,0
48351,3,3,168953,168954,168957,1,4,0
48352,3,2,168956,168957,168959,1,3,0
48353,6,2,168962,168962,168964,0,2,3
48354,4,3,168966,168966,168969,0,3,2
48355,3,1,168969,168969,168970,0,1,0
48356,4,1,168973,168973,168974,0,1,3
48357,5,3,168978,168978,168981,0,3,4
48358,3,1,168981,168981,168982,0,1,0
48359,2,1,168983,168983,168984,0,1,1
48360,1,1,168984,168984,168985,0,1,0
48361,4,3,168988,168988,168991,0,3,3
48362,4,1,168992,168992,168993,0,1,1
48363,3,3,168995,168995,168998,0,3,2
48364,2,3,168997,168998,169001,1,4,0
48365,5,3,169002,169002,169005,0,3,1
48366,1,2,169003,169005,169007,2,4,0
48367,1,1,169004,169007,169008,3,4,0
48368,6,2,169010,169010,169012,0,2,2
48369,4,1,169014,169014,169015,0,1,2
48370,5,2,169019,169019,169021,0,2,4
48371,3,3,169022,169022,169025,0,3,1
48372,5,3,169027,169027,169030,0,3,2
48373,6,3,169033,169033,169036,0,3,3
48374,1,3,169034,169036,169039,2,5,0
48375,3,3,169037,169039,169042,2,5,0
48376,2,3,169039,169042,169045,3,6,0
48377,6,3,169045,169045,169048,0,3,0
48378,6,2,169051,169051,169053,0,2,3
48379,2,1,169053,169053,169054,0,1,0
48380,5,3,169058,169058,169061,0,3,4
48381,4,3,169062,169062,169065,0,3,1
48382,4,3,169066,169066,169069,0,3,1
48383,4,1,169070,169070,169071,0,1,1
48384,1,1,169071,169071,169072,0,1,0
48385,1,3,169072,169072,169075,0,3,0
48386,2,1,169074,169075,169076,1,2,0
48387,6,1,169080,169080,169081,0,1,4
48388,4,2,169084,169084,169086,0,2,3
48389,6,3,169090,169090,169093,0,3,4
48390,3,1,169093,169093,169094,0,1,0
48391,6,3,169099,169099,169102,0,3,5
48392,6,2,169105,169105,169107,0,2,3
48393,4,1,169109,169109,169110,0,1,2
48394,4,1,169113,169113,169114,0,1,3
48395,6,3,169119,169119,169122,0,3,5
48396,5,2,169124,169124,169126,0,2,2
48397,3,2,169127,169127,169129,0,2,1
48398,5,3,169132,169132,169135,0,3,3
48399,3,3,169135,169135,169138,0,3,0
48400,2,3,169137,169138,169141,1,4,0
48401,5,3,169142,169142,169145,0,3,1
48402,3,2,169145,169145,169147,0,2,0
48403,4,3,169149,169149,169152,0,3,2
48404,6,3,169155,169155,169158,0,3,3
48405,1,3,169156,169158,169161,2,5,0
48406,6,2,169162,169162,169164,0,2,1
48407,4,2,169166,169166,169168,0,2,2
48408,6,2,169172,169172,169174,0,2,4
48409,4,3,169176,169176,169179,0,3,2
48410,6,3,169182,169182,169185,0,3,3
48411,4,1,169186,169186,169187,0,1,1
48412,3,2,169189,169189,169191,0,2,2
48413,1,1,169190,169191,169192,1,2,0
48414,4,2,169194,169194,169196,0,2,2
48415,1,1,169195,169196,169197,1,2,0
48416,3,2,169198,169198,169200,0,2,1
48417,6,1,169204,169204,169205,0,1,4
48418,2,1,169206,169206,169207,0,1,1
48419,2,3,169208,169208,169211,0,3,1
48420,4,1,169212,169212,169213,0,1,1
48421,5,2,169217,169217,169219,0,2,4
48422,1,3,169218,169219,169222,1,4,0
48423,4,2,169222,169222,169224,0,2,0
48424,4,1,169226,169226,169227,0,1,2
48425,3,1,169229,169229,169230,0,1,2
48426,3,1,169232,169232,169233,0,1,2
48427,4,3,169236,169236,169239,0,3,3
48428,6,1,169242,169242,169243,0,1,3
48429,1,3,169243,169243,169246,0,3,0
48430,5,1,169248,169248,169249,0,1,2
48431,5,3,169253,169253,169256,0,3,4
48432,2,2,169255,169256,169258,1,3,0
48433,1,2,169256,169258,169260,2,4,0
48434,6,1,169262,169262,169263,0,1,2
48435,1,3,169263,169263,169266,0,3,0
48436,6,3,169269,169269,169272,0,3,3
48437,5,2,169274,169274,169276,0,2,2
48438,1,1,169275,169276,169277,1,2,0
48439,5,2,169280,169280,169282,0,2,3
48440,2,3,169282,169282,169285,0,3,0
48441,4,3,169286,169286,169289,0,3,1
48442,6,1,169292,169292,169293,0,1,3
48443,6,1,169298,169298,169299,0,1,5
48444,3,1,169301,169301,169302,0,1,2
48445,6,2,169307,169307,169309,0,2,5
48446,3,2,169310,169310,169312,0,2,1
48447,1,2,169311,169312,169314,1,3,0
48448,6,3,169317,169317,169320,0,3,3
48449,2,1,169319,169320,169321,1,2,0
48450,3,3,169322,169322,169325,0,3,1
48451,2,3,169324,169325,169328,1,4,0
48452,6,1,169330,169330,169331,0,1,2
48453,5,2,169335,169335,169337,0,2,4
48454,2,1,169337,169337,169338,0,1,0
48455,5,1,169342,169342,169343,0,1,4
48456,1,3,169343,169343,169346,0,3,0
48457,1,3,169344,169346,169349,2,5,0
48458,5,3,169349,169349,169352,0,3,0
48459,5,3,169354,169354,169357,0,3,2
48460,6,2,169360,169360,169362,0,2,3
48461,5,2,169365,169365,169367,0,2,3
48462,5,3,169370,169370,169373,0,3,3
48463,3,2,169373,169373,169375,0,2,0
48464,4,1,169377,169377,169378,0,1,2
48465,2,3,169379,169379,169382,0,3,1
48466,3,2,169382,169382,169384,0,2,0
48467,1,3,169383,169384,169387,1,4,0
48468,6,1,169389,169389,169390,0,1,2
48469,2,2,169391,169391,169393,0,2,1
48470,1,3,169392,169393,169396,1,4,0
48471,1,2,169393,169396,169398,3,5,0
48472,2,2,169395,169398,169400,3,5,0
48473,4,1,169399,169400,169401,1,2,0
48474,1,1,169400,169401,169402,1,2,0
48475,2,1,169402,169402,169403,0,1,0
48476,2,1,169404,169404,169405,0,1,1
48477,4,2,169408,169408,169410,0,2,3
48478,4,3,169412,169412,169415,0,3,2
48479,5,2,169417,169417,169419,0,2,2
48480,4,2,169421,169421,169423,0,2,2
48481,3,2,169424,169424,169426,0,2,1
48482,4,2,169428,169428,169430,0,2,2
48483,5,1,169433,169433,169434,0,1,3
48484,6,2,169439,169439,169441,0,2,5
48485,6,1,169445,169445,169446,0,1,4
48486,5,2,169450,169450,169452,0,2,4
48487,1,3,169451,169452,169455,1,4,0
48488,5,1,169456,169456,169457,0,1,1
48489,2,1,169458,169458,169459,0,1,1
48490,4,1,169462,169462,169463,0,1,3
48491,6,3,169468,169468,169471,0,3,5
48492,2,3,169470,169471,169474,1,4,0
48493,3,1,169473,169474,169475,1,2,0
48494,5,1,169478,169478,169479,0,1,3
48495,5,1,169483,169483,169484,0,1,4
48496,6,1,169489,169489,169490,0,1,5
48497,6,2,169495,169495,169497,0,2,5
48498,2,1,169497,169497,169498,0,1,0
48499,5,1,169502,169502,169503,0,1,4
48500,1,2,169503,169503,169505,0,2,0
48501,3,1,169506,169506,169507,0,1,1
48502,3,1,169509,169509,169510,0,1,2
48503,3,2,169512,169512,169514,0,2,2
48504,1,2,169513,169514,169516,1,3,0
48505,6,1,169519,169519,169520,0,1,3
48506,2,3,169521,169521,169524,0,3,1
48507,6,1,169527,169527,169528,0,1,3
48508,1,1,169528,169528,169529,0,1,0
48509,4,2,169532,169532,169534,0,2,3
48510,2,2,169534,169534,169536,0,2,0
48511,4,2,169538,169538,169540,0,2,2
48512,5,2,169543,169543,169545,0,2,3
48513,2,1,169545,169545,169546,0,1,0
48514,1,3,169546,169546,169549,0,3,0
48515,5,3,169551,169551,169554,0,3,2
48516,1,2,169552,169554,169556,2,4,0
48517,1,3,169553,169556,169559,3,6,0
48518,4,3,169557,169559,169562,2,5,0
48519,2,3,169559,169562,169565,3,6,0
48520,4,2,169563,169565,169567,2,4,0
48521,4,1,169567,169567,169568,0,1,0
48522,1,2,169568,169568,169570,0,2,0
48523,6,3,169574,169574,169577,0,3,4
48524,6,2,169580,169580,169582,0,2,3
48525,6,2,169586,169586,169588,0,2,4
48526,4,2,169590,169590,169592,0,2,2
48527,2,1,169592,169592,169593,0,1,0
48528,5,1,169597,169597,169598,0,1,4
48529,6,1,169603,169603,169604,0,1,5
48530,1,1,169604,169604,169605,0,1,0
48531,1,2,169605,169605,169607,0,2,0
48532,5,2,169610,169610,169612,0,2,3
48533,2,2,169612,169612,169614,0,2,0
48534,3,2,169615,169615,169617,0,2,1
48535,4,1,169619,169619,169620,0,1,2
48536,2,2,169621,169621,169623,0,2,1
48537,6,3,169627,169627,169630,0,3,4
48538,4,2,169631,169631,169633,0,2,1
48539,3,2,169634,169634,169636,0,2,1
48540,2,2,169636,169636,169638,0,2,0
48541,6,3,169642,169642,169645,0,3,4
48542,1,3,169643,169645,169648,2,5,0
48543,1,3,169644,169648,169651,4,7,0
48544,2,1,169646,169651,169652,5,6,0
48545,3,3,169649,169652,169655,3,6,0
48546,3,3,169652,169655,169658,3,6,0
48547,3,1,169655,169658,169659,3,4,0
48548,1,3,169656,169659,169662,3,6,0
48549,3,1,169659,169662,169663,3,4,0
48550,6,1,169665,169665,169666,0,1,2
48551,3,2,169668,169668,169670,0,2,2
48552,3,1,169671,169671,169672,0,1,1
48553,1,3,169672,169672,169675,0,3,0
48554,6,3,169678,169678,169681,0,3,3
48555,4,2,169682,169682,169684,0,2,1
48556,3,1,169685,169685,169686,0,1,1
48557,4,1,169689,169689,169690,0,1,3
48558,3,1,169692,169692,169693,0,1,2
48559,4,3,169696,169696,169699,0,3,3
48560,6,2,169702,169702,169704,0,2,3
48561,6,3,169708,169708,169711,0,3,4
48562,5,1,169713,169713,169714,0,1,2
48563,3,3,169716,169716,169719,0,3,2
48564,1,1,169717,169719,169720,2,3,0
48565,5,2,169722,169722,169724,0,2,2
48566,3,2,169725,169725,169727,0,2,1
48567,5,3,169730,169730,169733,0,3,3
48568,2,1,169732,169733,169734,1,2,0
48569,6,2,169738,169738,169740,0,2,4
48570,2,2,169740,169740,169742,0,2,0
48571,5,3,169745,169745,169748,0,3,3
48572,4,3,169749,169749,169752,0,3,1
48573,3,2,169752,169752,169754,0,2,0
48574,5,3,169757,169757,169760,0,3,3
48575,5,2,169762,169762,169764,0,2,2
48576,4,2,169766,169766,169768,0,2,2
48577,4,1,169770,169770,169771,0,1,2
48578,3,3,169773,169773,169776,0,3,2
48579,4,2,169777,169777,169779,0,2,1
48580,5,1,169782,169782,169783,0,1,3
48581,5,1,169787,169787,169788,0,1,4
48582,2,2,169789,169789,169791,0,2,1
48583,6,2,169795,169795,169797,0,2,4
48584,2,2,169797,169797,169799,0,2,0
48585,6,1,169803,169803,169804,0,1,4
48586,2,2,169805,169805,169807,0,2,1
48587,5,3,169810,169810,169813,0,3,3
48588,5,2,169815,169815,169817,0,2,2
48589,3,3,169818,169818,169821,0,3,1
48590,6,2,169824,169824,169826,0,2,3
48591,4,2,169828,169828,169830,0,2,2
48592,4,1,169832,169832,169833,0,1,2
48593,2,3,169834,169834,169837,0,3,1
48594,1,2,169835,169837,169839,2,4,0
48595,1,1,169836,169839,169840,3,4,0
48596,3,3,169839,169840,169843,1,4,0
48597,4,3,169843,169843,169846,0,3,0
48598,3,1,169846,169846,169847,0,1,0
48599,1,2,169847,169847,169849,0,2,0
48600,5,2,169852,169852,169854,0,2,3
48601,2,2,169854,169854,169856,0,2,0
48602,1,2,169855,169856,169858,1,3,0
48603,5,1,169860,169860,169861,0,1,2
48604,6,3,169866,169866,169869,0,3,5
48605,2,1,169868,169869,169870,1,2,0
48606,4,2,169872,169872,169874,0,2,2
48607,3,3,169875,169875,169878,0,3,1
48608,1,2,169876,169878,169880,2,4,0
48609,6,3,169882,169882,169885,0,3,2
48610,5,2,169887,169887,169889,0,2,2
48611,2,2,169889,169889,169891,0,2,0
48612,4,3,169893,169893,169896,0,3,2
48613,1,1,169894,169896,169897,2,3,0
48614,5,3,169899,169899,169902,0,3,2
48615,2,1,169901,169902,169903,1,2,0
48616,2,2,169903,169903,169905,0,2,0
48617,4,2,169907,169907,169909,0,2,2
48618,6,3,169913,169913,169916,0,3,4
48619,1,1,169914,169916,169917,2,3,0
48620,6,2,169920,169920,169922,0,2,3
48621,5,1,169925,169925,169926,0,1,3
48622,2,2,169927,169927,169929,0,2,1
48623,4,3,169931,169931,169934,0,3,2
48624,4,1,169935,169935,169936,0,1,1
48625,1,3,169936,169936,169939,0,3,0
48626,6,3,169942,169942,169945,0,3,3
48627,6,1,169948,169948,169949,0,1,3
48628,4,3,169952,169952,169955,0,3,3
48629,5,2,169957,169957,169959,0,2,2
48630,5,1,169962,169962,169963,0,1,3
48631,2,1,169964,169964,169965,0,1,1
48632,4,1,169968,169968,169969,0,1,3
48633,4,3,169972,169972,169975,0,3,3
48634,2,1,169974,169975,169976,1,2,0
48635,6,3,169980,169980,169983,0,3,4
48636,6,3,169986,169986,169989,0,3,3
48637,6,3,169992,169992,169995,0,3,3
48638,4,1,169996,169996,169997,0,1,1
48639,1,1,169997,169997,169998,0,1,0
48640,6,2,170003,170003,170005,0,2,5
48641,3,1,170006,170006,170007,0,1,1
48642,6,1,170012,170012,170013,0,1,5
48643,3,1,170015,170015,170016,0,1,2
48644,2,2,170017,170017,170019,0,2,1
48645,3,2,170020,170020,170022,0,2,1
48646,2,1,170022,170022,170023,0,1,0
48647,4,3,170026,170026,170029,0,3,3
48648,2,1,170028,170029,170030,1,2,0
48649,2,3,170030,170030,170033,0,3,0
48650,4,1,170034,170034,170035,0,1,1
48651,1,1,170035,170035,170036,0,1,0
48652,3,1,170038,170038,170039,0,1,2
48653,6,3,170044,170044,170047,0,3,5
48654,5,3,170049,170049,170052,0,3,2
48655,5,1,170054,170054,170055,0,1,2
48656,2,3,170056,170056,170059,0,3,1
48657,2,3,170058,170059,170062,1,4,0
48658,1,2,170059,170062,170064,3,5,0
48659,6,1,170065,170065,170066,0,1,1
48660,3,3,170068,170068,170071,0,3,2
48661,4,1,170072,170072,170073,0,1,1
48662,4,1,170076,170076,170077,0,1,3
48663,4,3,170080,170080,170083,0,3,3
48664,3,3,170083,170083,170086,0,3,0
48665,2,3,170085,170086,170089,1,4,0
48666,6,2,170091,170091,170093,0,2,2
48667,6,2,170097,170097,170099,0,2,4
48668,5,1,170102,170102,170103,0,1,3
48669,1,1,170103,170103,170104,0,1,0
48670,2,1,170105,170105,170106,0,1,1
48671,6,1,170111,170111,170112,0,1,5
48672,3,2,170114,170114,170116,0,2,2
48673,3,1,170117,170117,170118,0,1,1
48674,4,1,170121,170121,170122,0,1,3
48675,2,3,170123,170123,170126,0,3,1
48676,4,1,170127,170127,170128,0,1,1
48677,3,1,170130,170130,170131,0,1,2
48678,3,2,170133,170133,170135,0,2,2
48679,5,1,170138,170138,170139,0,1,3
48680,6,2,170144,170144,170146,0,2,5
48681,2,1,170146,170146,170147,0,1,0
48682,1,3,170147,170147,170150,0,3,0
48683,1,2,170148,170150,170152,2,4,0
48684,2,1,170150,170152,170153,2,3,0
48685,2,3,170152,170153,170156,1,4,0
48686,4,2,170156,170156,170158,0,2,0
48687,6,3,170162,170162,170165,0,3,4
48688,6,3,170168,170168,170171,0,3,3
48689,2,3,170170,170171,170174,1,4,0
48690,1,1,170171,170174,170175,3,4,0
48691,6,3,170177,170177,170180,0,3,2
48692,2,3,170179,170180,170183,1,4,0
48693,1,2,170180,170183,170185,3,5,0
48694,3,3,170183,170185,170188,2,5,0
48695,1,2,170184,170188,170190,4,6,0
48696,1,1,170185,170190,170191,5,6,0
48697,3,2,170188,170191,170193,3,5,0
48698,2,2,170190,170193,170195,3,5,0
48699,6,3,170196,170196,170199,0,3,1
48700,4,2,170200,170200,170202,0,2,1
48701,6,1,170206,170206,170207,0,1,4
48702,1,1,170207,170207,170208,0,1,0
48703,2,3,170209,170209,170212,0,3,1
48704,6,3,170215,170215,170218,0,3,3
48705,3,1,170218,170218,170219,0,1,0
48706,4,2,170222,170222,170224,0,2,3
48707,2,2,170224,170224,170226,0,2,0
48708,3,1,170227,170227,170228,0,1,1
48709,5,3,170232,170232,170235,0,3,4
48710,2,3,170234,170235,170238,1,4,0
48711,1,2,170235,170238,170240,3,5,0
48712,6,1,170241,170241,170242,0,1,1
48713,5,1,170246,170246,170247,0,1,4
48714,6,2,170252,170252,170254,0,2,5
48715,5,2,170257,170257,170259,0,2,3
48716,2,1,170259,170259,170260,0,1,0
48717,1,2,170260,170260,170262,0,2,0
48718,1,2,170261,170262,170264,1,3,0
48719,4,3,170265,170265,170268,0,3,1
48720,2,2,170267,170268,170270,1,3,0
48721,5,1,170272,170272,170273,0,1,2
48722,1,1,170273,170273,170274,0,1,0
48723,5,1,170278,170278,170279,0,1,4
48724,3,3,170281,170281,170284,0,3,2
48725,6,1,170287,170287,170288,0,1,3
48726,2,3,170289,170289,170292,0,3,1
48727,2,3,170291,170292,170295,1,4,0
48728,1,1,170292,170295,170296,3,4,0
48729,3,1,170295,170296,170297,1,2,0
48730,2,1,170297,170297,170298,0,1,0
48731,5,1,170302,170302,170303,0,1,4
48732,1,1,170303,170303,170304,0,1,0
48733,2,1,170305,170305,170306,0,1,1
48734,5,3,170310,170310,170313,0,3,4
48735,1,3,170311,170313,170316,2,5,0
48736,2,1,170313,170316,170317,3,4,0
48737,4,2,170317,170317,170319,0,2,0
48738,5,1,170322,170322,170323,0,1,3
48739,3,3,170325,170325,170328,0,3,2
48740,5,3,170330,170330,170333,0,3,2
48741,4,3,170334,170334,170337,0,3,1
48742,4,1,170338,170338,170339,0,1,1
48743,5,1,170343,170343,170344,0,1,4
48744,4,1,170347,170347,170348,0,1,3
48745,2,3,170349,170349,170352,0,3,1
48746,1,1,170350,170352,170353,2,3,0
48747,3,1,170353,170353,170354,0,1,0
48748,5,2,170358,170358,170360,0,2,4
48749,5,3,170363,170363,170366,0,3,3
48750,3,2,170366,170366,170368,0,2,0
48751,2,1,170368,170368,170369,0,1,0
48752,2,3,170370,170370,170373,0,3,1
48753,4,3,170374,170374,170377,0,3,1
48754,3,1,170377,170377,170378,0,1,0
48755,6,3,170383,170383,170386,0,3,5
48756,2,1,170385,170386,170387,1,2,0
48757,4,3,170389,170389,170392,0,3,2
48758,1,3,170390,170392,170395,2,5,0
48759,5,2,170395,170395,170397,0,2,0
48760,3,3,170398,170398,170401,0,3,1
48761,6,1,170404,170404,170405,0,1,3
48762,3,2,170407,170407,170409,0,2,2
48763,2,1,170409,170409,170410,0,1,0
48764,2,3,170411,170411,170414,0,3,1
48765,1,3,170412,170414,170417,2,5,0
48766,2,3,170414,170417,170420,3,6,0
48767,4,2,170418,170420,170422,2,4,0
48768,4,1,170422,170422,170423,0,1,0
48769,3,1,170425,170425,170426,0,1,2
48770,4,1,170429,170429,170430,0,1,3
48771,4,1,170433,170433,170434,0,1,3
48772,4,2,170437,170437,170439,0,2,3
48773,1,2,170438,170439,170441,1,3,0
48774,5,2,170443,170443,170445,0,2,2
48775,4,2,170447,170447,170449,0,2,2
48776,6,1,170453,170453,170454,0,1,4
48777,3,3,170456,170456,170459,0,3,2
48778,1,1,170457,170459,170460,2,3,0
48779,4,2,170461,170461,170463,0,2,1
48780,1,3,170462,170463,170466,1,4,0
48781,3,3,170465,170466,170469,1,4,0
48782,1,1,170466,170469,170470,3,4,0
48783,6,2,170472,170472,170474,0,2,2
48784,4,2,170476,170476,170478,0,2,2
48785,2,3,170478,170478,170481,0,3,0
48786,6,2,170484,170484,170486,0,2,3
48787,4,2,170488,170488,170490,0,2,2
48788,3,2,170491,170491,170493,0,2,1
48789,4,2,170495,170495,170497,0,2,2
48790,2,2,170497,170497,170499,0,2,0
48791,5,2,170502,170502,170504,0,2,3
48792,2,1,170504,170504,170505,0,1,0
48793,6,2,170510,170510,170512,0,2,5
48794,2,2,170512,170512,170514,0,2,0
48795,2,3,170514,170514,170517,0,3,0
48796,1,2,170515,170517,170519,2,4,0
48797,5,3,170520,170520,170523,0,3,1
48798,2,2,170522,170523,170525,1,3,0
48799,4,1,170526,170526,170527,0,1,1
48800,5,3,170531,170531,170534,0,3,4
48801,2,3,170533,170534,170537,1,4,0
48802,2,3,170535,170537,170540,2,5,0
48803,6,3,170541,170541,170544,0,3,1
48804,3,1,170544,170544,170545,0,1,0
48805,4,2,170548,170548,170550,0,2,3
48806,5,2,170553,170553,170555,0,2,3
48807,5,2,170558,170558,170560,0,2,3
48808,2,3,170560,170560,170563,0,3,0
48809,4,1,170564,170564,170565,0,1,1
48810,6,1,170570,170570,170571,0,1,5
48811,3,2,170573,170573,170575,0,2,2
48812,5,3,170578,170578,170581,0,3,3
48813,4,1,170582,170582,170583,0,1,1
48814,3,2,170585,170585,170587,0,2,2
48815,2,3,170587,170587,170590,0,3,0
48816,2,2,170589,170590,170592,1,3,0
48817,2,3,170591,170592,170595,1,4,0
48818,5,3,170596,170596,170599,0,3,1
48819,2,2,170598,170599,170601,1,3,0
48820,2,2,170600,170601,170603,1,3,0
48821,1,2,170601,170603,170605,2,4,0
48822,6,3,170607,170607,170610,0,3,2
48823,3,2,170610,170610,170612,0,2,0
48824,6,3,170616,170616,170619,0,3,4
48825,4,3,170620,170620,170623,0,3,1
48826,1,3,170621,170623,170626,2,5,0
48827,5,2,170626,170626,170628,0,2,0
48828,5,1,170631,170631,170632,0,1,3
48829,6,2,170637,170637,170639,0,2,5
48830,5,2,170642,170642,170644,0,2,3
48831,3,2,170645,170645,170647,0,2,1
48832,5,1,170650,170650,170651,0,1,3
48833,1,1,170651,170651,170652,0,1,0
48834,2,3,170653,170653,170656,0,3,1
48835,3,1,170656,170656,170657,0,1,0
48836,2,2,170658,170658,170660,0,2,1
48837,4,1,170662,170662,170663,0,1,2
48838,3,2,170665,170665,170667,0,2,2
48839,6,3,170671,170671,170674,0,3,4
48840,6,3,170677,170677,170680,0,3,3
48841,5,3,170682,170682,170685,0,3,2
48842,2,1,170684,170685,170686,1,2,0
48843,2,1,170686,170686,170687,0,1,0
48844,4,2,170690,170690,170692,0,2,3
48845,6,1,170696,170696,170697,0,1,4
48846,3,2,170699,170699,170701,0,2,2
48847,2,1,170701,170701,170702,0,1,0
48848,1,2,170702,170702,170704,0,2,0
48849,1,1,170703,170704,170705,1,2,0
48850,1,1,170704,170705,170706,1,2,0
48851,4,3,170708,170708,170711,0,3,2
48852,2,2,170710,170711,170713,1,3,0
48853,1,1,170711,170713,170714,2,3,0
48854,3,1,170714,170714,170715,0,1,0
48855,6,2,170720,170720,170722,0,2,5
48856,6,3,170726,170726,170729,0,3,4
48857,2,1,170728,170729,170730,1,2,0
48858,4,3,170732,170732,170735,0,3,2
48859,2,3,170734,170735,170738,1,4,0
48860,5,2,170739,170739,170741,0,2,1
48861,2,1,170741,170741,170742,0,1,0
48862,2,1,170743,170743,170744,0,1,1
48863,6,2,170749,170749,170751,0,2,5
48864,5,1,170754,170754,170755,0,1,3
48865,3,1,170757,170757,170758,0,1,2
48866,3,3,170760,170760,170763,0,3,2
48867,4,2,170764,170764,170766,0,2,1
48868,3,1,170767,170767,170768,0,1,1
48869,3,2,170770,170770,170772,0,2,2
48870,3,1,170773,170773,170774,0,1,1
48871,4,2,170777,170777,170779,0,2,3
48872,2,3,170779,170779,170782,0,3,0
48873,5,1,170784,170784,170785,0,1,2
48874,5,1,170789,170789,170790,0,1,4
48875,6,1,170795,170795,170796,0,1,5
48876,3,3,170798,170798,170801,0,3,2
48877,6,2,170804,170804,170806,0,2,3
48878,4,3,170808,170808,170811,0,3,2
48879,5,2,170813,170813,170815,0,2,2
48880,5,1,170818,170818,170819,0,1,3
48881,5,1,170823,170823,170824,0,1,4
48882,1,2,170824,170824,170826,0,2,0
48883,2,3,170826,170826,170829,0,3,0
48884,5,3,170831,170831,170834,0,3,2
48885,5,2,170836,170836,170838,0,2,2
48886,5,1,170841,170841,170842,0,1,3
48887,6,2,170847,170847,170849,0,2,5
48888,1,1,170848,170849,170850,1,2,0
48889,2,2,170850,170850,170852,0,2,0
48890,6,2,170856,170856,170858,0,2,4
48891,3,1,170859,170859,170860,0,1,1
48892,2,2,170861,170861,170863,0,2,1
48893,2,3,170863,170863,170866,0,3,0
48894,5,2,170868,170868,170870,0,2,2
48895,6,2,170874,170874,170876,0,2,4
48896,6,3,170880,170880,170883,0,3,4
48897,5,3,170885,170885,170888,0,3,2
48898,2,3,170887,170888,170891,1,4,0
48899,3,2,170890,170891,170893,1,3,0
48900,6,1,170896,170896,170897,0,1,3
48901,5,1,170901,170901,170902,0,1,4
48902,5,2,170906,170906,170908,0,2,4
48903,2,2,170908,170908,170910,0,2,0
48904,4,2,170912,170912,170914,0,2,2
48905,2,2,170914,170914,170916,0,2,0
48906,5,3,170919,170919,170922,0,3,3
48907,6,2,170925,170925,170927,0,2,3
48908,4,3,170929,170929,170932,0,3,2
48909,6,2,170935,170935,170937,0,2,3
48910,5,1,170940,170940,170941,0,1,3
48911,1,1,170941,170941,170942,0,1,0
48912,1,3,170942,170942,170945,0,3,0
48913,3,2,170945,170945,170947,0,2,0
48914,2,2,170947,170947,170949,0,2,0
48915,2,1,170949,170949,170950,0,1,0
48916,3,3,170952,170952,170955,0,3,2
48917,3,1,170955,170955,170956,0,1,0
48918,6,2,170961,170961,170963,0,2,5
48919,2,3,170963,170963,170966,0,3,0
48920,1,1,170964,170966,170967,2,3,0
48921,6,1,170970,170970,170971,0,1,3
48922,4,3,170974,170974,170977,0,3,3
48923,1,3,170975,170977,170980,2,5,0
48924,1,1,170976,170980,170981,4,5,0
48925,3,2,170979,170981,170983,2,4,0
48926,5,2,170984,170984,170986,0,2,1
48927,4,1,170988,170988,170989,0,1,2
48928,3,2,170991,170991,170993,0,2,2
48929,2,1,170993,170993,170994,0,1,0
48930,1,1,170994,170994,170995,0,1,0
48931,6,3,171000,171000,171003,0,3,5
48932,3,2,171003,171003,171005,0,2,0
48933,1,1,171004,171005,171006,1,2,0
48934,1,3,171005,171006,171009,1,4,0
48935,3,2,171008,171009,171011,1,3,0
48936,5,2,171013,171013,171015,0,2,2
48937,2,3,171015,171015,171018,0,3,0
48938,3,1,171018,171018,171019,0,1,0
48939,6,1,171024,171024,171025,0,1,5
48940,6,3,171030,171030,171033,0,3,5
48941,5,1,171035,171035,171036,0,1,2
48942,4,1,171039,171039,171040,0,1,3
48943,3,3,171042,171042,171045,0,3,2
48944,3,1,171045,171045,171046,0,1,0
48945,1,1,171046,171046,171047,0,1,0
48946,3,3,171049,171049,171052,0,3,2
48947,3,2,171052,171052,171054,0,2,0
48948,1,1,171053,171054,171055,1,2,0
48949,2,1,171055,171055,171056,0,1,0
48950,4,2,171059,171059,171061,0,2,3
48951,1,2,171060,171061,171063,1,3,0
48952,6,2,171066,171066,171068,0,2,3
48953,2,1,171068,171068,171069,0,1,0
48954,2,3,171070,171070,171073,0,3,1
48955,4,3,171074,171074,171077,0,3,1
48956,6,1,171080,171080,171081,0,1,3
48957,5,2,171085,171085,171087,0,2,4
48958,2,2,171087,171087,171089,0,2,0
48959,5,3,171092,171092,171095,0,3,3
48960,1,3,171093,171095,171098,2,5,0
48961,3,2,171096,171098,171100,2,4,0
48962,6,2,171102,171102,171104,0,2,2
48963,3,3,171105,171105,171108,0,3,1
48964,3,3,171108,171108,171111,0,3,0
48965,2,1,171110,171111,171112,1,2,0
48966,3,2,171113,171113,171115,0,2,1
48967,3,3,171116,171116,171119,0,3,1
48968,4,2,171120,171120,171122,0,2,1
48969,1,2,171121,171122,171124,1,3,0
48970,4,3,171125,171125,171128,0,3,1
48971,5,3,171130,171130,171133,0,3,2
48972,3,2,171133,171133,171135,0,2,0
48973,6,2,171139,171139,171141,0,2,4
48974,1,3,171140,171141,171144,1,4,0
48975,2,1,171142,171144,171145,2,3,0
48976,6,1,171148,171148,171149,0,1,3
48977,3,3,171151,171151,171154,0,3,2
48978,3,1,171154,171154,171155,0,1,0
48979,2,2,171156,171156,171158,0,2,1
48980,5,2,171161,171161,171163,0,2,3
48981,3,1,171164,171164,171165,0,1,1
48982,2,2,171166,171166,171168,0,2,1
48983,3,2,171169,171169,171171,0,2,1
48984,5,3,171174,171174,171177,0,3,3
48985,6,2,171180,171180,171182,0,2,3
48986,6,3,171186,171186,171189,0,3,4
48987,3,2,171189,171189,171191,0,2,0
48988,3,2,171192,171192,171194,0,2,1
48989,5,2,171197,171197,171199,0,2,3
48990,3,1,171200,171200,171201,0,1,1
48991,2,1,171202,171202,171203,0,1,1
48992,1,2,171203,171203,171205,0,2,0
48993,4,1,171207,171207,171208,0,1,2
48994,2,2,171209,171209,171211,0,2,1
48995,4,2,171213,171213,171215,0,2,2
48996,5,2,171218,171218,171220,0,2,3
48997,3,3,171221,171221,171224,0,3,1
48998,3,1,171224,171224,171225,0,1,0
48999,6,1,171230,171230,171231,0,1,5
49000,2,1,171232,171232,171233,0,1,1
49001,3,1,171235,171235,171236,0,1,2
49002,2,3,171237,171237,171240,0,3,1
49003,5,3,171242,171242,171245,0,3,2
49004,5,2,171247,171247,171249,0,2,2
49005,6,2,171253,171253,171255,0,2,4
49006,2,1,171255,171255,171256,0,1,0
49007,4,3,171259,171259,171262,0,3,3
49008,3,3,171262,171262,171265,0,3,0
49009,2,3,171264,171265,171268,1,4,0
49010,3,2,171267,171268,171270,1,3,0
49011,5,3,171272,171272,171275,0,3,2
49012,1,1,171273,171275,171276,2,3,0
49013,3,3,171276,171276,171279,0,3,0
49014,1,3,171277,171279,171282,2,5,0
49015,1,1,171278,171282,171283,4,5,0
49016,2,3,171280,171283,171286,3,6,0
49017,2,3,171282,171286,171289,4,7,0
49018,3,3,171285,171289,171292,4,7,0
49019,4,1,171289,171292,171293,3,4,0
49020,4,1,171293,171293,171294,0,1,0
49021,1,2,171294,171294,171296,0,2,0
49022,2,3,171296,171296,171299,0,3,0
49023,2,1,171298,171299,171300,1,2,0
49024,1,1,171299,171300,171301,1,2,0
49025,1,1,171300,171301,171302,1,2,0
49026,6,3,171306,171306,171309,0,3,4
49027,6,3,171312,171312,171315,0,3,3
49028,2,3,171314,171315,171318,1,4,0
49029,3,1,171317,171318,171319,1,2,0
49030,6,2,171323,171323,171325,0,2,4
49031,2,1,171325,171325,171326,0,1,0
49032,4,1,171329,171329,171330,0,1,3
49033,3,1,171332,171332,171333,0,1,2
49034,5,1,171337,171337,171338,0,1,4
49035,6,3,171343,171343,171346,0,3,5
49036,2,2,171345,171346,171348,1,3,0
49037,2,3,171347,171348,171351,1,4,0
49038,6,2,171353,171353,171355,0,2,2
49039,4,1,171357,171357,171358,0,1,2
49040,1,1,171358,171358,171359,0,1,0
49041,5,2,171363,171363,171365,0,2,4
49042,1,3,171364,171365,171368,1,4,0
49043,4,3,171368,171368,171371,0,3,0
49044,5,2,171373,171373,171375,0,2,2
49045,6,2,171379,171379,171381,0,2,4
49046,4,2,171383,171383,171385,0,2,2
49047,1,3,171384,171385,171388,1,4,0
49048,3,1,171387,171388,171389,1,2,0
49049,1,3,171388,171389,171392,1,4,0
49050,3,3,171391,171392,171395,1,4,0
49051,3,3,171394,171395,171398,1,4,0
49052,2,3,171396,171398,171401,2,5,0
49053,6,2,171402,171402,171404,0,2,1
49054,1,1,171403,171404,171405,1,2,0
49055,4,3,171407,171407,171410,0,3,2
49056,5,3,171412,171412,171415,0,3,2
49057,2,1,171414,171415,171416,1,2,0
49058,3,1,171417,171417,171418,0,1,1
49059,1,2,171418,171418,171420,0,2,0
49060,4,3,171422,171422,171425,0,3,2
49061,3,3,171425,171425,171428,0,3,0
49062,4,1,171429,171429,171430,0,1,1
49063,2,3,171431,171431,171434,0,3,1
49064,4,2,171435,171435,171437,0,2,1
49065,1,1,171436,171437,171438,1,2,0
49066,4,1,171440,171440,171441,0,1,2
49067,1,3,171441,171441,171444,0,3,0
49068,5,1,171446,171446,171447,0,1,2
49069,2,3,171448,171448,171451,0,3,1
49070,6,3,171454,171454,171457,0,3,3
49071,4,3,171458,171458,171461,0,3,1
49072,6,1,171464,171464,171465,0,1,3
49073,4,1,171468,171468,171469,0,1,3
49074,1,1,171469,171469,171470,0,1,0
49075,2,3,171471,171471,171474,0,3,1
49076,2,2,171473,171474,171476,1,3,0
49077,6,2,171479,171479,171481,0,2,3
49078,5,3,171484,171484,171487,0,3,3
49079,2,3,171486,171487,171490,1,4,0
49080,1,2,171487,171490,171492,3,5,0
49081,1,3,171488,171492,171495,4,7,0
49082,4,1,171492,171495,171496,3,4,0
49083,5,3,171497,171497,171500,0,3,1
49084,3,3,171500,171500,171503,0,3,0
49085,1,3,171501,171503,171506,2,5,0
49086,6,1,171507,171507,171508,0,1,1
49087,5,3,171512,171512,171515,0,3,4
49088,3,1,171515,171515,171516,0,1,0
49089,3,3,171518,171518,171521,0,3,2
49090,4,3,171522,171522,171525,0,3,1
49091,4,3,171526,171526,171529,0,3,1
49092,2,3,171528,171529,171532,1,4,0
49093,5,2,171533,171533,171535,0,2,1
49094,3,2,171536,171536,171538,0,2,1
49095,1,2,171537,171538,171540,1,3,0
49096,2,2,171539,171540,171542,1,3,0
49097,2,2,171541,171542,171544,1,3,0
49098,4,2,171545,171545,171547,0,2,1
49099,4,2,171549,171549,171551,0,2,2
49100,5,2,171554,171554,171556,0,2,3
49101,1,3,171555,171556,171559,1,4,0
49102,4,2,171559,171559,171561,0,2,0
49103,2,1,171561,171561,171562,0,1,0
49104,1,1,171562,171562,171563,0,1,0
49105,4,1,171566,171566,171567,0,1,3
49106,4,1,171570,171570,171571,0,1,3
49107,3,1,171573,171573,171574,0,1,2
49108,6,1,171579,171579,171580,0,1,5
49109,2,1,171581,171581,171582,0,1,1
49110,2,1,171583,171583,171584,0,1,1
49111,3,2,171586,171586,171588,0,2,2
49112,1,2,171587,171588,171590,1,3,0
49113,4,2,171591,171591,171593,0,2,1
49114,3,3,171594,171594,171597,0,3,1
49115,4,3,171598,171598,171601,0,3,1
49116,4,3,171602,171602,171605,0,3,1
49117,2,2,171604,171605,171607,1,3,0
49118,1,3,171605,171607,171610,2,5,0
49119,4,2,171609,171610,171612,1,3,0
49120,2,3,171611,171612,171615,1,4,0
49121,3,2,171614,171615,171617,1,3,0
49122,2,1,171616,171617,171618,1,2,0
49123,3,2,171619,171619,171621,0,2,1
49124,5,2,171624,171624,171626,0,2,3
49125,2,3,171626,171626,171629,0,3,0
49126,6,1,171632,171632,171633,0,1,3
49127,3,3,171635,171635,171638,0,3,2
49128,1,3,171636,171638,171641,2,5,0
49129,2,3,171638,171641,171644,3,6,0
49130,3,2,171641,171644,171646,3,5,0
49131,3,2,171644,171646,171648,2,4,0
49132,1,3,171645,171648,171651,3,6,0
49133,4,1,171649,171651,171652,2,3,0
49134,2,3,171651,171652,171655,1,4,0
49135,6,2,171657,171657,171659,0,2,2
49136,6,3,171663,171663,171666,0,3,4
49137,2,2,171665,171666,171668,1,3,0
49138,3,3,171668,171668,171671,0,3,0
49139,3,1,171671,171671,171672,0,1,0
49140,3,3,171674,171674,171677,0,3,2
49141,3,1,171677,171677,171678,0,1,0
49142,5,3,171682,171682,171685,0,3,4
49143,5,2,171687,171687,171689,0,2,2
49144,5,3,171692,171692,171695,0,3,3
49145,5,2,171697,171697,171699,0,2,2
49146,5,1,171702,171702,171703,0,1,3
49147,3,1,171705,171705,171706,0,1,2
49148,4,1,171709,171709,171710,0,1,3
49149,3,1,171712,171712,171713,0,1,2
49150,6,2,171718,171718,171720,0,2,5
49151,4,3,171722,171722,171725,0,3,2
49152,4,2,171726,171726,171728,0,2,1
49153,3,1,171729,171729,171730,0,1,1
49154,3,2,171732,171732,171734,0,2,2
49155,4,1,171736,171736,171737,0,1,2
49156,4,3,171740,171740,171743,0,3,3
49157,6,3,171746,171746,171749,0,3,3
49158,6,2,171752,171752,171754,0,2,3
49159,4,1,171756,171756,171757,0,1,2
49160,2,3,171758,171758,171761,0,3,1
49161,1,3,171759,171761,171764,2,5,0
49162,5,1,171764,171764,171765,0,1,0
49163,4,2,171768,171768,171770,0,2,3
49164,5,3,171773,171773,171776,0,3,3
49165,1,2,171774,171776,171778,2,4,0
49166,1,3,171775,171778,171781,3,6,0
49167,2,3,171777,171781,171784,4,7,0
49168,5,2,171782,171784,171786,2,4,0
49169,1,3,171783,171786,171789,3,6,0
49170,2,2,171785,171789,171791,4,6,0
49171,1,2,171786,171791,171793,5,7,0
49172,3,1,171789,171793,171794,4,5,0
49173,6,2,171795,171795,171797,0,2,1
49174,6,3,171801,171801,171804,0,3,4
49175,2,3,171803,171804,171807,1,4,0
49176,2,3,171805,171807,171810,2,5,0
49177,1,2,171806,171810,171812,4,6,0
49178,2,2,171808,171812,171814,4,6,0
49179,5,1,171813,171814,171815,1,2,0
49180,4,2,171817,171817,171819,0,2,2
49181,3,2,171820,171820,171822,0,2,1
49182,2,1,171822,171822,171823,0,1,0
49183,6,1,171828,171828,171829,0,1,5
49184,5,1,171833,171833,171834,0,1,4
49185,6,3,171839,171839,171842,0,3,5
49186,1,2,171840,171842,171844,2,4,0
49187,3,2,171843,171844,171846,1,3,0
49188,6,2,171849,171849,171851,0,2,3
49189,1,2,171850,171851,171853,1,3,0
49190,1,1,171851,171853,171854,2,3,0
49191,6,3,171857,171857,171860,0,3,3
49192,4,3,171861,171861,171864,0,3,1
49193,6,1,171867,171867,171868,0,1,3
49194,5,2,171872,171872,171874,0,2,4
49195,5,3,171877,171877,171880,0,3,3
49196,6,1,171883,171883,171884,0,1,3
49197,5,1,171888,171888,171889,0,1,4
49198,1,1,171889,171889,171890,0,1,0
49199,4,3,171893,171893,171896,0,3,3
49200,2,1,171895,171896,171897,1,2,0
49201,4,2,171899,171899,171901,0,2,2
49202,5,2,171904,171904,171906,0,2,3
49203,4,2,171908,171908,171910,0,2,2
49204,6,2,171914,171914,171916,0,2,4
49205,6,2,171920,171920,171922,0,2,4
49206,3,2,171923,171923,171925,0,2,1
49207,2,1,171925,171925,171926,0,1,0
49208,6,2,171931,171931,171933,0,2,5
49209,6,2,171937,171937,171939,0,2,4
49210,6,2,171943,171943,171945,0,2,4
49211,4,3,171947,171947,171950,0,3,2
49212,6,3,171953,171953,171956,0,3,3
49213,1,2,171954,171956,171958,2,4,0
49214,1,2,171955,171958,171960,3,5,0
49215,2,2,171957,171960,171962,3,5,0
49216,3,1,171960,171962,171963,2,3,0
49217,5,3,171965,171965,171968,0,3,2
49218,5,2,171970,171970,171972,0,2,2
49219,1,3,171971,171972,171975,1,4,0
49220,1,2,171972,171975,171977,3,5,0
49221,6,2,171978,171978,171980,0,2,1
49222,2,2,171980,171980,171982,0,2,0
49223,3,3,171983,171983,171986,0,3,1
49224,1,3,171984,171986,171989,2,5,0
49225,6,2,171990,171990,171992,0,2,1
49226,1,3,171991,171992,171995,1,4,0
49227,4,3,171995,171995,171998,0,3,0
49228,2,2,171997,171998,172000,1,3,0
49229,4,3,172001,172001,172004,0,3,1
49230,6,1,172007,172007,172008,0,1,3
49231,5,2,172012,172012,172014,0,2,4
49232,6,3,172018,172018,172021,0,3,4
49233,1,2,172019,172021,172023,2,4,0
49234,1,3,172020,172023,172026,3,6,0
49235,3,2,172023,172026,172028,3,5,0
49236,4,2,172027,172028,172030,1,3,0
49237,6,1,172033,172033,172034,0,1,3
49238,5,3,172038,172038,172041,0,3,4
49239,1,2,172039,172041,172043,2,4,0
49240,1,2,172040,172043,172045,3,5,0
49241,6,2,172046,172046,172048,0,2,1
49242,1,3,172047,172048,172051,1,4,0
49243,2,3,172049,172051,172054,2,5,0
49244,3,3,172052,172054,172057,2,5,0
49245,2,3,172054,172057,172060,3,6,0
49246,6,1,172060,172060,172061,0,1,0
49247,6,2,172066,172066,172068,0,2,5
49248,5,3,172071,172071,172074,0,3,3
49249,2,2,172073,172074,172076,1,3,0
49250,5,2,172078,172078,172080,0,2,2
49251,6,3,172084,172084,172087,0,3,4
49252,1,3,172085,172087,172090,2,5,0
49253,6,3,172091,172091,172094,0,3,1
49254,5,2,172096,172096,172098,0,2,2
49255,1,3,172097,172098,172101,1,4,0
49256,4,2,172101,172101,172103,0,2,0
49257,1,3,172102,172103,172106,1,4,0
49258,2,2,172104,172106,172108,2,4,0
49259,1,3,172105,172108,172111,3,6,0
49260,6,2,172111,172111,172113,0,2,0
49261,1,2,172112,172113,172115,1,3,0
49262,4,3,172116,172116,172119,0,3,1
49263,3,3,172119,172119,172122,0,3,0
49264,2,1,172121,172122,172123,1,2,0
49265,4,1,172125,172125,172126,0,1,2
49266,3,2,172128,172128,172130,0,2,2
49267,5,1,172133,172133,172134,0,1,3
49268,4,1,172137,172137,172138,0,1,3
49269,2,3,172139,172139,172142,0,3,1
49270,6,1,172145,172145,172146,0,1,3
49271,2,1,172147,172147,172148,0,1,1
49272,6,3,172153,172153,172156,0,3,5
49273,1,1,172154,172156,172157,2,3,0
49274,5,3,172159,172159,172162,0,3,2
49275,5,3,172164,172164,172167,0,3,2
49276,5,3,172169,172169,172172,0,3,2
49277,1,3,172170,172172,172175,2,5,0
49278,1,3,172171,172175,172178,4,7,0
49279,5,2,172176,172178,172180,2,4,0
49280,5,3,172181,172181,172184,0,3,1
49281,2,1,172183,172184,172185,1,2,0
49282,6,3,172189,172189,172192,0,3,4
49283,4,2,172193,172193,172195,0,2,1
49284,1,1,172194,172195,172196,1,2,0
49285,4,3,172198,172198,172201,0,3,2
49286,6,3,172204,172204,172207,0,3,3
49287,2,1,172206,172207,172208,1,2,0
49288,3,3,172209,172209,172212,0,3,1
49289,3,3,172212,172212,172215,0,3,0
49290,3,1,172215,172215,172216,0,1,0
49291,5,1,172220,172220,172221,0,1,4
49292,1,2,172221,172221,172223,0,2,0
49293,4,3,172225,172225,172228,0,3,2
49294,2,2,172227,172228,172230,1,3,0
49295,5,3,172232,172232,172235,0,3,2
49296,1,3,172233,172235,172238,2,5,0
49297,1,3,172234,172238,172241,4,7,0
49298,5,3,172239,172241,172244,2,5,0
49299,1,2,172240,172244,172246,4,6,0
49300,2,1,172242,172246,172247,4,5,0
49301,6,3,172248,172248,172251,0,3,1
49302,3,1,172251,172251,172252,0,1,0
49303,2,3,172253,172253,172256,0,3,1
49304,4,2,172257,172257,172259,0,2,1
49305,3,3,172260,172260,172263,0,3,1
49306,6,1,172266,172266,172267,0,1,3
49307,1,3,172267,172267,172270,0,3,0
49308,5,2,172272,172272,172274,0,2,2
49309,1,3,172273,172274,172277,1,4,0
49310,2,2,172275,172277,172279,2,4,0
49311,3,3,172278,172279,172282,1,4,0
49312,2,1,172280,172282,172283,2,3,0
49313,4,3,172284,172284,172287,0,3,1
49314,3,3,172287,172287,172290,0,3,0
49315,1,1,172288,172290,172291,2,3,0
49316,5,1,172293,172293,172294,0,1,2
49317,1,1,172294,172294,172295,0,1,0
49318,2,1,172296,172296,172297,0,1,1
49319,1,3,172297,172297,172300,0,3,0
49320,2,2,172299,172300,172302,1,3,0
49321,4,3,172303,172303,172306,0,3,1
49322,3,3,172306,172306,172309,0,3,0
49323,6,2,172312,172312,172314,0,2,3
49324,2,1,172314,172314,172315,0,1,0
49325,2,2,172316,172316,172318,0,2,1
49326,4,3,172320,172320,172323,0,3,2
49327,6,3,172326,172326,172329,0,3,3
49328,3,1,172329,172329,172330,0,1,0
49329,1,1,172330,172330,172331,0,1,0
49330,3,3,172333,172333,172336,0,3,2
49331,3,2,172336,172336,172338,0,2,0
49332,2,3,172338,172338,172341,0,3,0
49333,2,1,172340,172341,172342,1,2,0
49334,1,3,172341,172342,172345,1,4,0
49335,2,1,172343,172345,172346,2,3,0
49336,4,1,172347,172347,172348,0,1,1
49337,3,2,172350,172350,172352,0,2,2
49338,1,2,172351,172352,172354,1,3,0
49339,1,1,172352,172354,172355,2,3,0
49340,4,1,172356,172356,172357,0,1,1
49341,5,2,172361,172361,172363,0,2,4
49342,1,2,172362,172363,172365,1,3,0
49343,1,2,172363,172365,172367,2,4,0
49344,6,3,172369,172369,172372,0,3,2
49345,5,2,172374,172374,172376,0,2,2
49346,3,2,172377,172377,172379,0,2,1
49347,5,2,172382,172382,172384,0,2,3
49348,5,1,172387,172387,172388,0,1,3
49349,6,1,172393,172393,172394,0,1,5
49350,3,2,172396,172396,172398,0,2,2
49351,1,3,172397,172398,172401,1,4,0
49352,4,3,172401,172401,172404,0,3,0
49353,3,2,172404,172404,172406,0,2,0
49354,1,2,172405,172406,172408,1,3,0
49355,4,3,172409,172409,172412,0,3,1
49356,2,2,172411,172412,172414,1,3,0
49357,6,2,172417,172417,172419,0,2,3
49358,3,2,172420,172420,172422,0,2,1
49359,5,3,172425,172425,172428,0,3,3
49360,6,2,172431,172431,172433,0,2,3
49361,1,3,172432,172433,172436,1,4,0
49362,2,2,172434,172436,172438,2,4,0
49363,4,1,172438,172438,172439,0,1,0
49364,5,2,172443,172443,172445,0,2,4
49365,2,3,172445,172445,172448,0,3,0
49366,4,3,172449,172449,172452,0,3,1
49367,4,2,172453,172453,172455,0,2,1
49368,1,2,172454,172455,172457,1,3,0
49369,2,3,172456,172457,172460,1,4,0
49370,2,2,172458,172460,172462,2,4,0
49371,5,2,172463,172463,172465,0,2,1
49372,5,3,172468,172468,172471,0,3,3
49373,2,3,172470,172471,172474,1,4,0
49374,1,3,172471,172474,172477,3,6,0
49375,1,2,172472,172477,172479,5,7,0
49376,4,2,172476,172479,172481,3,5,0
49377,6,3,172482,172482,172485,0,3,1
49378,5,3,172487,172487,172490,0,3,2
49379,6,1,172493,172493,172494,0,1,3
49380,6,1,172499,172499,172500,0,1,5
49381,6,2,172505,172505,172507,0,2,5
49382,4,3,172509,172509,172512,0,3,2
49383,2,3,172511,172512,172515,1,4,0
49384,6,3,172517,172517,172520,0,3,2
49385,1,1,172518,172520,172521,2,3,0
49386,6,2,172524,172524,172526,0,2,3
49387,3,3,172527,172527,172530,0,3,1
49388,2,1,172529,172530,172531,1,2,0
49389,5,1,172534,172534,172535,0,1,3
49390,4,1,172538,172538,172539,0,1,3
49391,6,2,172544,172544,172546,0,2,5
49392,3,2,172547,172547,172549,0,2,1
49393,5,2,172552,172552,172554,0,2,3
49394,5,1,172557,172557,172558,0,1,3
49395,2,2,172559,172559,172561,0,2,1
49396,6,2,172565,172565,172567,0,2,4
49397,2,3,172567,172567,172570,0,3,0
49398,3,2,172570,172570,172572,0,2,0
49399,2,2,172572,172572,172574,0,2,0
49400,2,3,172574,172574,172577,0,3,0
49401,1,3,172575,172577,172580,2,5,0
49402,2,3,172577,172580,172583,3,6,0
49403,4,1,172581,172583,172584,2,3,0
49404,1,1,172582,172584,172585,2,3,0
49405,5,3,172587,172587,172590,0,3,2
49406,1,2,172588,172590,172592,2,4,0
49407,6,3,172594,172594,172597,0,3,2
49408,6,2,172600,172600,172602,0,2,3
49409,3,1,172603,172603,172604,0,1,1
49410,3,2,172606,172606,172608,0,2,2
49411,5,1,172611,172611,172612,0,1,3
49412,4,3,172615,172615,172618,0,3,3
49413,6,1,172621,172621,172622,0,1,3
49414,1,2,172622,172622,172624,0,2,0
49415,1,3,172623,172624,172627,1,4,0
49416,3,1,172626,172627,172628,1,2,0
49417,1,3,172627,172628,172631,1,4,0
49418,2,1,172629,172631,172632,2,3,0
49419,6,3,172635,172635,172638,0,3,3
49420,3,3,172638,172638,172641,0,3,0
49421,2,3,172640,172641,172644,1,4,0
49422,6,3,172646,172646,172649,0,3,2
49423,6,3,172652,172652,172655,0,3,3
49424,6,2,172658,172658,172660,0,2,3
49425,4,3,172662,172662,172665,0,3,2
49426,6,3,172668,172668,172671,0,3,3
49427,3,3,172671,172671,172674,0,3,0
49428,2,3,172673,172674,172677,1,4,0
49429,2,2,172675,172677,172679,2,4,0
49430,1,3,172676,172679,172682,3,6,0
49431,2,2,172678,172682,172684,4,6,0
49432,5,2,172683,172684,172686,1,3,0
49433,3,1,172686,172686,172687,0,1,0
49434,4,2,172690,172690,172692,0,2,3
49435,5,1,172695,172695,172696,0,1,3
49436,4,1,172699,172699,172700,0,1,3
49437,4,3,172703,172703,172706,0,3,3
49438,2,2,172705,172706,172708,1,3,0
49439,3,2,172708,172708,172710,0,2,0
49440,5,1,172713,172713,172714,0,1,3
49441,2,3,172715,172715,172718,0,3,1
49442,5,2,172720,172720,172722,0,2,2
49443,1,2,172721,172722,172724,1,3,0
49444,4,1,172725,172725,172726,0,1,1
49445,6,1,172731,172731,172732,0,1,5
49446,2,3,172733,172733,172736,0,3,1
49447,5,2,172738,172738,172740,0,2,2
49448,4,2,172742,172742,172744,0,2,2
49449,6,1,172748,172748,172749,0,1,4
49450,2,3,172750,172750,172753,0,3,1
49451,3,1,172753,172753,172754,0,1,0
49452,1,3,172754,172754,172757,0,3,0
49453,1,3,172755,172757,172760,2,5,0
49454,4,3,172759,172760,172763,1,4,0
49455,3,3,172762,172763,172766,1,4,0
49456,1,3,172763,172766,172769,3,6,0
49457,5,2,172768,172769,172771,1,3,0
49458,6,1,172774,172774,172775,0,1,3
49459,1,3,172775,172775,172778,0,3,0
49460,6,1,172781,172781,172782,0,1,3
49461,4,2,172785,172785,172787,0,2,3
49462,3,2,172788,172788,172790,0,2,1
49463,3,2,172791,172791,172793,0,2,1
49464,2,1,172793,172793,172794,0,1,0
49465,1,3,172794,172794,172797,0,3,0
49466,6,2,172800,172800,172802,0,2,3
49467,6,1,172806,172806,172807,0,1,4
49468,2,2,172808,172808,172810,0,2,1
49469,1,2,172809,172810,172812,1,3,0
49470,2,2,172811,172812,172814,1,3,0
49471,2,3,172813,172814,172817,1,4,0
49472,2,2,172815,172817,172819,2,4,0
49473,1,3,172816,172819,172822,3,6,0
49474,6,3,172822,172822,172825,0,3,0
49475,6,1,172828,172828,172829,0,1,3
49476,4,1,172832,172832,172833,0,1,3
49477,2,1,172834,172834,172835,0,1,1
49478,6,2,172840,172840,172842,0,2,5
49479,3,1,172843,172843,172844,0,1,1
49480,4,3,172847,172847,172850,0,3,3
49481,2,1,172849,172850,172851,1,2,0
49482,5,2,172854,172854,172856,0,2,3
49483,6,1,172860,172860,172861,0,1,4
49484,2,1,172862,172862,172863,0,1,1
49485,1,3,172863,172863,172866,0,3,0
49486,3,1,172866,172866,172867,0,1,0
49487,1,2,172867,172867,172869,0,2,0
49488,1,1,172868,172869,172870,1,2,0
49489,5,1,172873,172873,172874,0,1,3
49490,4,3,172877,172877,172880,0,3,3
49491,3,2,172880,172880,172882,0,2,0
49492,3,2,172883,172883,172885,0,2,1
49493,4,1,172887,172887,172888,0,1,2
49494,2,2,172889,172889,172891,0,2,1
49495,6,1,172895,172895,172896,0,1,4
49496,1,3,172896,172896,172899,0,3,0
49497,5,3,172901,172901,172904,0,3,2
49498,6,2,172907,172907,172909,0,2,3
49499,2,2,172909,172909,172911,0,2,0
49500,4,1,172913,172913,172914,0,1,2
49501,2,2,172915,172915,172917,0,2,1
49502,6,3,172921,172921,172924,0,3,4
49503,5,2,172926,172926,172928,0,2,2
49504,1,1,172927,172928,172929,1,2,0
49505,3,3,172930,172930,172933,0,3,1
49506,3,3,172933,172933,172936,0,3,0
49507,4,3,172937,172937,172940,0,3,1
49508,3,3,172940,172940,172943,0,3,0
49509,2,2,172942,172943,172945,1,3,0
49510,5,2,172947,172947,172949,0,2,2
49511,3,2,172950,172950,172952,0,2,1
49512,5,1,172955,172955,172956,0,1,3
49513,5,2,172960,172960,172962,0,2,4
49514,1,3,172961,172962,172965,1,4,0
49515,3,1,172964,172965,172966,1,2,0
49516,5,2,172969,172969,172971,0,2,3
49517,2,3,172971,172971,172974,0,3,0
49518,3,1,172974,172974,172975,0,1,0
49519,4,1,172978,172978,172979,0,1,3
49520,3,1,172981,172981,172982,0,1,2
49521,6,2,172987,172987,172989,0,2,5
49522,4,3,172991,172991,172994,0,3,2
49523,2,2,172993,172994,172996,1,3,0
49524,1,1,172994,172996,172997,2,3,0
49525,1,1,172995,172997,172998,2,3,0
49526,6,1,173001,173001,173002,0,1,3
49527,3,2,173004,173004,173006,0,2,2
49528,3,2,173007,173007,173009,0,2,1
49529,5,1,173012,173012,173013,0,1,3
49530,2,3,173014,173014,173017,0,3,1
49531,4,3,173018,173018,173021,0,3,1
49532,1,2,173019,173021,173023,2,4,0
49533,2,3,173021,173023,173026,2,5,0
49534,2,2,173023,173026,173028,3,5,0
49535,3,1,173026,173028,173029,2,3,0
49536,4,3,173030,173030,173033,0,3,1
49537,2,3,173032,173033,173036,1,4,0
49538,2,2,173034,173036,173038,2,4,0
49539,5,2,173039,173039,173041,0,2,1
49540,4,3,173043,173043,173046,0,3,2
49541,6,1,173049,173049,173050,0,1,3
49542,2,3,173051,173051,173054,0,3,1
49543,3,1,173054,173054,173055,0,1,0
49544,1,3,173055,173055,173058,0,3,0
49545,3,2,173058,173058,173060,0,2,0
49546,1,1,173059,173060,173061,1,2,0
49547,5,2,173064,173064,173066,0,2,3
49548,3,1,173067,173067,173068,0,1,1
49549,2,3,173069,173069,173072,0,3,1
49550,3,1,173072,173072,173073,0,1,0
49551,3,2,173075,173075,173077,0,2,2
49552,5,2,173080,173080,173082,0,2,3
49553,3,3,173083,173083,173086,0,3,1
49554,5,3,173088,173088,173091,0,3,2
49555,5,2,173093,173093,173095,0,2,2
49556,6,3,173099,173099,173102,0,3,4
49557,1,2,173100,173102,173104,2,4,0
49558,5,1,173105,173105,173106,0,1,1
49559,2,2,173107,173107,173109,0,2,1
49560,4,2,173111,173111,173113,0,2,2
49561,1,2,173112,173113,173115,1,3,0
49562,1,3,173113,173115,173118,2,5,0
49563,1,1,173114,173118,173119,4,5,0
49564,2,3,173116,173119,173122,3,6,0
49565,6,3,173122,173122,173125,0,3,0
49566,2,3,173124,173125,173128,1,4,0
49567,2,2,173126,173128,173130,2,4,0
49568,4,1,173130,173130,173131,0,1,0
49569,1,2,173131,173131,173133,0,2,0
49570,4,1,173135,173135,173136,0,1,2
49571,2,3,173137,173137,173140,0,3,1
49572,5,3,173142,173142,173145,0,3,2
49573,5,3,173147,173147,173150,0,3,2
49574,2,1,173149,173150,173151,1,2,0
49575,3,2,173152,173152,173154,0,2,1
49576,3,3,173155,173155,173158,0,3,1
49577,5,1,173160,173160,173161,0,1,2
49578,4,1,173164,173164,173165,0,1,3
49579,2,2,173166,173166,173168,0,2,1
49580,6,3,173172,173172,173175,0,3,4
49581,4,3,173176,173176,173179,0,3,1
49582,4,2,173180,173180,173182,0,2,1
49583,4,2,173184,173184,173186,0,2,2
49584,4,1,173188,173188,173189,0,1,2
49585,3,3,173191,173191,173194,0,3,2
49586,2,3,173193,173194,173197,1,4,0
49587,3,2,173196,173197,173199,1,3,0
49588,4,3,173200,173200,173203,0,3,1
49589,3,3,173203,173203,173206,0,3,0
49590,1,2,173204,173206,173208,2,4,0
49591,1,1,173205,173208,173209,3,4,0
49592,1,2,173206,173209,173211,3,5,0
49593,1,3,173207,173211,173214,4,7,0
49594,4,3,173211,173214,173217,3,6,0
49595,5,2,173216,173217,173219,1,3,0
49596,5,2,173221,173221,173223,0,2,2
49597,1,1,173222,173223,173224,1,2,0
49598,6,3,173228,173228,173231,0,3,4
49599,4,1,173232,173232,173233,0,1,1
49600,4,1,173236,173236,173237,0,1,3
49601,4,2,173240,173240,173242,0,2,3
49602,5,2,173245,173245,173247,0,2,3
49603,2,2,173247,173247,173249,0,2,0
49604,6,1,173253,173253,173254,0,1,4
49605,6,2,173259,173259,173261,0,2,5
49606,2,3,173261,173261,173264,0,3,0
49607,3,2,173264,173264,173266,0,2,0
49608,2,1,173266,173266,173267,0,1,0
49609,6,2,173272,173272,173274,0,2,5
49610,2,1,173274,173274,173275,0,1,0
49611,3,1,173277,173277,173278,0,1,2
49612,1,1,173278,173278,173279,0,1,0
49613,5,1,173283,173283,173284,0,1,4
49614,4,3,173287,173287,173290,0,3,3
49615,6,3,173293,173293,173296,0,3,3
49616,5,3,173298,173298,173301,0,3,2
49617,5,1,173303,173303,173304,0,1,2
49618,2,3,173305,173305,173308,0,3,1
49619,2,1,173307,173308,173309,1,2,0
49620,6,1,173313,173313,173314,0,1,4
49621,1,1,173314,173314,173315,0,1,0
49622,4,1,173318,173318,173319,0,1,3
49623,1,2,173319,173319,173321,0,2,0
49624,1,1,173320,173321,173322,1,2,0
49625,5,3,173325,173325,173328,0,3,3
49626,1,1,173326,173328,173329,2,3,0
49627,5,3,173331,173331,173334,0,3,2
49628,2,3,173333,173334,173337,1,4,0
49629,4,3,173337,173337,173340,0,3,0
49630,1,1,173338,173340,173341,2,3,0
49631,5,1,173343,173343,173344,0,1,2
49632,5,3,173348,173348,173351,0,3,4
49633,4,1,173352,173352,173353,0,1,1
49634,3,2,173355,173355,173357,0,2,2
49635,3,3,173358,173358,173361,0,3,1
49636,3,2,173361,173361,173363,0,2,0
49637,6,2,173367,173367,173369,0,2,4
49638,1,2,173368,173369,173371,1,3,0
49639,6,1,173374,173374,173375,0,1,3
49640,6,1,173380,173380,173381,0,1,5
49641,3,3,173383,173383,173386,0,3,2
49642,4,1,173387,173387,173388,0,1,1
49643,2,1,173389,173389,173390,0,1,1
49644,5,1,173394,173394,173395,0,1,4
49645,3,3,173397,173397,173400,0,3,2
49646,5,1,173402,173402,173403,0,1,2
49647,6,3,173408,173408,173411,0,3,5
49648,3,3,173411,173411,173414,0,3,0
49649,6,2,173417,173417,173419,0,2,3
49650,4,1,173421,173421,173422,0,1,2
49651,1,3,173422,173422,173425,0,3,0
49652,2,1,173424,173425,173426,1,2,0
49653,2,1,173426,173426,173427,0,1,0
49654,6,2,173432,173432,173434,0,2,5
49655,1,3,173433,173434,173437,1,4,0
49656,1,1,173434,173437,173438,3,4,0
49657,3,1,173437,173438,173439,1,2,0
49658,6,2,173443,173443,173445,0,2,4
49659,2,1,173445,173445,173446,0,1,0
49660,3,1,173448,173448,173449,0,1,2
49661,5,1,173453,173453,173454,0,1,4
49662,3,1,173456,173456,173457,0,1,2
49663,2,3,173458,173458,173461,0,3,1
49664,4,1,173462,173462,173463,0,1,1
49665,4,3,173466,173466,173469,0,3,3
49666,5,3,173471,173471,173474,0,3,2
49667,2,3,173473,173474,173477,1,4,0
49668,4,2,173477,173477,173479,0,2,0
49669,1,3,173478,173479,173482,1,4,0
49670,6,2,173484,173484,173486,0,2,2
49671,1,3,173485,173486,173489,1,4,0
49672,4,2,173489,173489,173491,0,2,0
49673,3,2,173492,173492,173494,0,2,1
49674,3,2,173495,173495,173497,0,2,1
49675,3,3,173498,173498,173501,0,3,1
49676,5,3,173503,173503,173506,0,3,2
49677,1,1,173504,173506,173507,2,3,0
49678,5,2,173509,173509,173511,0,2,2
49679,4,3,173513,173513,173516,0,3,2
49680,6,1,173519,173519,173520,0,1,3
49681,1,2,173520,173520,173522,0,2,0
49682,3,1,173523,173523,173524,0,1,1
49683,2,3,173525,173525,173528,0,3,1
49684,5,2,173530,173530,173532,0,2,2
49685,2,3,173532,173532,173535,0,3,0
49686,1,3,173533,173535,173538,2,5,0
49687,2,1,173535,173538,173539,3,4,0
49688,4,2,173539,173539,173541,0,2,0
49689,2,3,173541,173541,173544,0,3,0
49690,1,2,173542,173544,173546,2,4,0
49691,3,1,173545,173546,173547,1,2,0
49692,2,1,173547,173547,173548,0,1,0
49693,2,3,173549,173549,173552,0,3,1
49694,3,1,173552,173552,173553,0,1,0
49695,3,1,173555,173555,173556,0,1,2
49696,4,1,173559,173559,173560,0,1,3
49697,2,3,173561,173561,173564,0,3,1
49698,4,2,173565,173565,173567,0,2,1
49699,3,3,173568,173568,173571,0,3,1
49700,6,2,173574,173574,173576,0,2,3
49701,5,2,173579,173579,173581,0,2,3
49702,2,3,173581,173581,173584,0,3,0
49703,6,3,173587,173587,173590,0,3,3
49704,3,1,173590,173590,173591,0,1,0
49705,3,1,173593,173593,173594,0,1,2
49706,4,3,173597,173597,173600,0,3,3
49707,2,1,173599,173600,173601,1,2,0
49708,6,2,173605,173605,173607,0,2,4
49709,4,2,173609,173609,173611,0,2,2
49710,2,1,173611,173611,173612,0,1,0
49711,5,3,173616,173616,173619,0,3,4
49712,5,1,173621,173621,173622,0,1,2
49713,4,2,173625,173625,173627,0,2,3
49714,1,3,173626,173627,173630,1,4,0
49715,6,1,173632,173632,173633,0,1,2
49716,3,1,173635,173635,173636,0,1,2
49717,6,1,173641,173641,173642,0,1,5
49718,1,1,173642,173642,173643,0,1,0
49719,4,3,173646,173646,173649,0,3,3
49720,1,3,173647,173649,173652,2,5,0
49721,4,1,173651,173652,173653,1,2,0
49722,5,3,173656,173656,173659,0,3,3
49723,6,2,173662,173662,173664,0,2,3
49724,3,3,173665,173665,173668,0,3,1
49725,3,2,173668,173668,173670,0,2,0
49726,3,2,173671,173671,173673,0,2,1
49727,3,2,173674,173674,173676,0,2,1
49728,5,1,173679,173679,173680,0,1,3
49729,5,3,173684,173684,173687,0,3,4
49730,5,2,173689,173689,173691,0,2,2
49731,1,2,173690,173691,173693,1,3,0
49732,1,1,173691,173693,173694,2,3,0
49733,3,3,173694,173694,173697,0,3,0
49734,5,3,173699,173699,173702,0,3,2
49735,1,1,173700,173702,173703,2,3,0
49736,3,3,173703,173703,173706,0,3,0
49737,2,3,173705,173706,173709,1,4,0
49738,6,2,173711,173711,173713,0,2,2
49739,5,1,173716,173716,173717,0,1,3
49740,5,1,173721,173721,173722,0,1,4
49741,3,2,173724,173724,173726,0,2,2
49742,2,1,173726,173726,173727,0,1,0
49743,3,2,173729,173729,173731,0,2,2
49744,5,2,173734,173734,173736,0,2,3
49745,3,2,173737,173737,173739,0,2,1
49746,2,3,173739,173739,173742,0,3,0
49747,5,1,173744,173744,173745,0,1,2
49748,4,3,173748,173748,173751,0,3,3
49749,6,1,173754,173754,173755,0,1,3
49750,3,1,173757,173757,173758,0,1,2
49751,2,1,173759,173759,173760,0,1,1
49752,3,2,173762,173762,173764,0,2,2
49753,3,3,173765,173765,173768,0,3,1
49754,4,2,173769,173769,173771,0,2,1
49755,5,1,173774,173774,173775,0,1,3
49756,4,3,173778,173778,173781,0,3,3
49757,2,3,173780,173781,173784,1,4,0
49758,6,1,173786,173786,173787,0,1,2
49759,5,1,173791,173791,173792,0,1,4
49760,1,1,173792,173792,173793,0,1,0
49761,2,2,173794,173794,173796,0,2,1
49762,1,1,173795,173796,173797,1,2,0
49763,1,1,173796,173797,173798,1,2,0
49764,4,2,173800,173800,173802,0,2,2
49765,2,1,173802,173802,173803,0,1,0
49766,1,3,173803,173803,173806,0,3,0
49767,2,3,173805,173806,173809,1,4,0
49768,4,3,173809,173809,173812,0,3,0
49769,4,2,173813,173813,173815,0,2,1
49770,3,1,173816,173816,173817,0,1,1
49771,6,1,173822,173822,173823,0,1,5
49772,6,1,173828,173828,173829,0,1,5
49773,1,3,173829,173829,173832,0,3,0
49774,2,2,173831,173832,173834,1,3,0
49775,5,3,173836,173836,173839,0,3,2
49776,5,3,173841,173841,173844,0,3,2
49777,6,3,173847,173847,173850,0,3,3
49778,6,2,173853,173853,173855,0,2,3
49779,1,1,173854,173855,173856,1,2,0
49780,3,1,173857,173857,173858,0,1,1
49781,6,1,173863,173863,173864,0,1,5
49782,3,1,173866,173866,173867,0,1,2
49783,3,2,173869,173869,173871,0,2,2
49784,3,2,173872,173872,173874,0,2,1
49785,5,1,173877,173877,173878,0,1,3
49786,1,2,173878,173878,173880,0,2,0
49787,1,2,173879,173880,173882,1,3,0
49788,4,3,173883,173883,173886,0,3,1
49789,5,3,173888,173888,173891,0,3,2
49790,5,2,173893,173893,173895,0,2,2
49791,6,3,173899,173899,173902,0,3,4
49792,3,3,173902,173902,173905,0,3,0
49793,4,2,173906,173906,173908,0,2,1
49794,4,3,173910,173910,173913,0,3,2
49795,3,1,173913,173913,173914,0,1,0
49796,4,2,173917,173917,173919,0,2,3
49797,4,1,173921,173921,173922,0,1,2
49798,3,2,173924,173924,173926,0,2,2
49799,5,3,173929,173929,173932,0,3,3
49800,2,3,173931,173932,173935,1,4,0
49801,4,1,173935,173935,173936,0,1,0
49802,4,3,173939,173939,173942,0,3,3
49803,3,3,173942,173942,173945,0,3,0
49804,3,1,173945,173945,173946,0,1,0
49805,1,2,173946,173946,173948,0,2,0
49806,6,2,173952,173952,173954,0,2,4
49807,5,2,173957,173957,173959,0,2,3
49808,3,1,173960,173960,173961,0,1,1
49809,2,1,173962,173962,173963,0,1,1
49810,5,1,173967,173967,173968,0,1,4
49811,4,1,173971,173971,173972,0,1,3
49812,6,3,173977,173977,173980,0,3,5
49813,6,3,173983,173983,173986,0,3,3
49814,6,3,173989,173989,173992,0,3,3
49815,3,1,173992,173992,173993,0,1,0
49816,6,2,173998,173998,174000,0,2,5
49817,3,2,174001,174001,174003,0,2,1
49818,6,3,174007,174007,174010,0,3,4
49819,5,1,174012,174012,174013,0,1,2
49820,5,2,174017,174017,174019,0,2,4
49821,6,1,174023,174023,174024,0,1,4
49822,5,1,174028,174028,174029,0,1,4
49823,1,2,174029,174029,174031,0,2,0
49824,6,1,174035,174035,174036,0,1,4
49825,1,3,174036,174036,174039,0,3,0
49826,1,2,174037,174039,174041,2,4,0
49827,5,3,174042,174042,174045,0,3,1
49828,3,2,174045,174045,174047,0,2,0
49829,1,1,174046,174047,174048,1,2,0
49830,2,3,174048,174048,174051,0,3,0
49831,5,2,174053,174053,174055,0,2,2
49832,5,3,174058,174058,174061,0,3,3
49833,5,1,174063,174063,174064,0,1,2
49834,2,1,174065,174065,174066,0,1,1
49835,4,3,174069,174069,174072,0,3,3
49836,5,1,174074,174074,174075,0,1,2
49837,3,3,174077,174077,174080,0,3,2
49838,1,3,174078,174080,174083,2,5,0
49839,5,1,174083,174083,174084,0,1,0
49840,6,2,174089,174089,174091,0,2,5
49841,3,3,174092,174092,174095,0,3,1
49842,3,1,174095,174095,174096,0,1,0
49843,3,1,174098,174098,174099,0,1,2
49844,1,1,174099,174099,174100,0,1,0
49845,6,3,174105,174105,174108,0,3,5
49846,2,1,174107,174108,174109,1,2,0
49847,2,1,174109,174109,174110,0,1,0
49848,6,2,174115,174115,174117,0,2,5
49849,1,1,174116,174117,174118,1,2,0
49850,4,3,174120,174120,174123,0,3,2
49851,1,2,174121,174123,174125,2,4,0
49852,5,1,174126,174126,174127,0,1,1
49853,5,2,174131,174131,174133,0,2,4
49854,3,3,174134,174134,174137,0,3,1
49855,5,3,174139,174139,174142,0,3,2
49856,1,2,174140,174142,174144,2,4,0
49857,4,3,174144,174144,174147,0,3,0
49858,3,3,174147,174147,174150,0,3,0
49859,3,1,174150,174150,174151,0,1,0
49860,1,3,174151,174151,174154,0,3,0
49861,2,2,174153,174154,174156,1,3,0
49862,1,1,174154,174156,174157,2,3,0
49863,3,3,174157,174157,174160,0,3,0
49864,2,2,174159,174160,174162,1,3,0
49865,2,3,174161,174162,174165,1,4,0
49866,6,1,174167,174167,174168,0,1,2
49867,4,1,174171,174171,174172,0,1,3
49868,1,1,174172,174172,174173,0,1,0
49869,4,2,174176,174176,174178,0,2,3
49870,3,2,174179,174179,174181,0,2,1
49871,2,3,174181,174181,174184,0,3,0
49872,2,2,174183,174184,174186,1,3,0
49873,5,3,174188,174188,174191,0,3,2
49874,1,3,174189,174191,174194,2,5,0
49875,2,3,174191,174194,174197,3,6,0
49876,4,2,174195,174197,174199,2,4,0
49877,3,2,174198,174199,174201,1,3,0
49878,1,3,174199,174201,174204,2,5,0
49879,1,3,174200,174204,174207,4,7,0
49880,4,3,174204,174207,174210,3,6,0
49881,2,1,174206,174210,174211,4,5,0
49882,2,2,174208,174211,174213,3,5,0
49883,4,1,174212,174213,174214,1,2,0
49884,4,1,174216,174216,174217,0,1,2
49885,3,1,174219,174219,174220,0,1,2
49886,3,3,174222,174222,174225,0,3,2
49887,3,3,174225,174225,174228,0,3,0
49888,5,1,174230,174230,174231,0,1,2
49889,2,3,174232,174232,174235,0,3,1
49890,1,1,174233,174235,174236,2,3,0
49891,5,3,174238,174238,174241,0,3,2
49892,3,1,174241,174241,174242,0,1,0
49893,5,3,174246,174246,174249,0,3,4
49894,3,3,174249,174249,174252,0,3,0
49895,5,3,174254,174254,174257,0,3,2
49896,4,3,174258,174258,174261,0,3,1
49897,3,3,174261,174261,174264,0,3,0
49898,4,2,174265,174265,174267,0,2,1
49899,5,2,174270,174270,174272,0,2,3
49900,4,1,174274,174274,174275,0,1,2
49901,2,2,174276,174276,174278,0,2,1
49902,1,1,174277,174278,174279,1,2,0
49903,5,1,174282,174282,174283,0,1,3
49904,4,2,174286,174286,174288,0,2,3
49905,6,3,174292,174292,174295,0,3,4
49906,5,2,174297,174297,174299,0,2,2
49907,6,2,174303,174303,174305,0,2,4
49908,1,1,174304,174305,174306,1,2,0
49909,5,1,174309,174309,174310,0,1,3
49910,5,2,174314,174314,174316,0,2,4
49911,4,3,174318,174318,174321,0,3,2
49912,2,3,174320,174321,174324,1,4,0
49913,6,3,174326,174326,174329,0,3,2
49914,4,1,174330,174330,174331,0,1,1
49915,4,3,174334,174334,174337,0,3,3
49916,1,1,174335,174337,174338,2,3,0
49917,2,1,174337,174338,174339,1,2,0
49918,6,1,174343,174343,174344,0,1,4
49919,5,1,174348,174348,174349,0,1,4
49920,2,1,174350,174350,174351,0,1,1
49921,4,1,174354,174354,174355,0,1,3
49922,6,3,174360,174360,174363,0,3,5
49923,4,1,174364,174364,174365,0,1,1
49924,5,1,174369,174369,174370,0,1,4
49925,6,1,174375,174375,174376,0,1,5
49926,6,2,174381,174381,174383,0,2,5
49927,1,3,174382,174383,174386,1,4,0
49928,4,2,174386,174386,174388,0,2,0
49929,1,2,174387,174388,174390,1,3,0
49930,6,1,174393,174393,174394,0,1,3
49931,6,1,174399,174399,174400,0,1,5
49932,6,2,174405,174405,174407,0,2,5
49933,6,2,174411,174411,174413,0,2,4
49934,6,3,174417,174417,174420,0,3,4
49935,5,2,174422,174422,174424,0,2,2
49936,2,3,174424,174424,174427,0,3,0
49937,6,1,174430,174430,174431,0,1,3
49938,6,2,174436,174436,174438,0,2,5
49939,6,3,174442,174442,174445,0,3,4
49940,3,1,174445,174445,174446,0,1,0
49941,3,3,174448,174448,174451,0,3,2
49942,6,2,174454,174454,174456,0,2,3
49943,1,1,174455,174456,174457,1,2,0
49944,4,1,174459,174459,174460,0,1,2
49945,3,1,174462,174462,174463,0,1,2
49946,4,2,174466,174466,174468,0,2,3
49947,1,1,174467,174468,174469,1,2,0
49948,1,2,174468,174469,174471,1,3,0
49949,4,3,174472,174472,174475,0,3,1
49950,3,3,174475,174475,174478,0,3,0
49951,1,1,174476,174478,174479,2,3,0
49952,4,1,174480,174480,174481,0,1,1
49953,5,1,174485,174485,174486,0,1,4
49954,6,1,174491,174491,174492,0,1,5
49955,4,2,174495,174495,174497,0,2,3
49956,5,3,174500,174500,174503,0,3,3
49957,3,3,174503,174503,174506,0,3,0
49958,1,2,174504,174506,174508,2,4,0
49959,4,3,174508,174508,174511,0,3,0
49960,6,2,174514,174514,174516,0,2,3
49961,6,3,174520,174520,174523,0,3,4
49962,2,2,174522,174523,174525,1,3,0
49963,3,1,174525,174525,174526,0,1,0
49964,3,3,174528,174528,174531,0,3,2
49965,1,3,174529,174531,174534,2,5,0
49966,5,3,174534,174534,174537,0,3,0
49967,1,3,174535,174537,174540,2,5,0
49968,6,1,174541,174541,174542,0,1,1
49969,3,2,174544,174544,174546,0,2,2
49970,4,1,174548,174548,174549,0,1,2
49971,3,1,174551,174551,174552,0,1,2
49972,4,1,174555,174555,174556,0,1,3
49973,1,1,174556,174556,174557,0,1,0
49974,2,3,174558,174558,174561,0,3,1
49975,6,3,174564,174564,174567,0,3,3
49976,5,1,174569,174569,174570,0,1,2
49977,5,3,174574,174574,174577,0,3,4
49978,4,2,174578,174578,174580,0,2,1
49979,3,2,174581,174581,174583,0,2,1
49980,1,2,174582,174583,174585,1,3,0
49981,6,1,174588,174588,174589,0,1,3
49982,5,2,174593,174593,174595,0,2,4
49983,2,1,174595,174595,174596,0,1,0
49984,6,2,174601,174601,174603,0,2,5
49985,5,3,174606,174606,174609,0,3,3
49986,1,1,174607,174609,174610,2,3,0
49987,2,3,174609,174610,174613,1,4,0
49988,5,3,174614,174614,174617,0,3,1
49989,1,3,174615,174617,174620,2,5,0
49990,2,3,174617,174620,174623,3,6,0
49991,5,1,174622,174623,174624,1,2,0
49992,5,1,174627,174627,174628,0,1,3
49993,6,2,174633,174633,174635,0,2,5
49994,3,3,174636,174636,174639,0,3,1
49995,5,2,174641,174641,174643,0,2,2
49996,3,1,174644,174644,174645,0,1,1
49997,2,2,174646,174646,174648,0,2,1
49998,6,2,174652,174652,174654,0,2,4
49999,5,3,174657,174657,174660,0,3,3
50000,4,3,174661,174661,174664,0,3,1
50001,6,2,174667,174667,174669,0,2,3
50002,5,1,174672,174672,174673,0,1,3
50003,1,2,174673,174673,174675,0,2,0
50004,1,3,174674,174675,174678,1,4,0
50005,4,1,174678,174678,174679,0,1,0
50006,1,1,174679,174679,174680,0,1,0
50007,4,1,174683,174683,174684,0,1,3
50008,4,3,174687,174687,174690,0,3,3
50009,5,3,174692,174692,174695,0,3,2
50010,6,3,174698,174698,174701,0,3,3
50011,5,1,174703,174703,174704,0,1,2
50012,5,2,174708,174708,174710,0,2,4
50013,1,2,174709,174710,174712,1,3,0
50014,1,1,174710,174712,174713,2,3,0
50015,1,1,174711,174713,174714,2,3,0
50016,3,3,174714,174714,174717,0,3,0
50017,3,2,174717,174717,174719,0,2,0
50018,3,1,174720,174720,174721,0,1,1
50019,3,3,174723,174723,174726,0,3,2
50020,6,2,174729,174729,174731,0,2,3
50021,6,2,174735,174735,174737,0,2,4
50022,1,2,174736,174737,174739,1,3,0
50023,3,2,174739,174739,174741,0,2,0
50024,2,3,174741,174741,174744,0,3,0
50025,4,1,174745,174745,174746,0,1,1
50026,1,3,174746,174746,174749,0,3,0
50027,5,1,174751,174751,174752,0,1,2
50028,1,3,174752,174752,174755,0,3,0
50029,4,3,174756,174756,174759,0,3,1
50030,1,1,174757,174759,174760,2,3,0
50031,2,3,174759,174760,174763,1,4,0
50032,5,2,174764,174764,174766,0,2,1
50033,3,2,174767,174767,174769,0,2,1
50034,5,3,174772,174772,174775,0,3,3
50035,4,2,174776,174776,174778,0,2,1
50036,3,2,174779,174779,174781,0,2,1
50037,4,3,174783,174783,174786,0,3,2
50038,2,3,174785,174786,174789,1,4,0
50039,2,1,174787,174789,174790,2,3,0
50040,4,1,174791,174791,174792,0,1,1
50041,4,3,174795,174795,174798,0,3,3
50042,4,3,174799,174799,174802,0,3,1
50043,6,3,174805,174805,174808,0,3,3
50044,3,3,174808,174808,174811,0,3,0
50045,4,3,174812,174812,174815,0,3,1
50046,3,3,174815,174815,174818,0,3,0
50047,5,3,174820,174820,174823,0,3,2
50048,1,1,174821,174823,174824,2,3,0
50049,5,1,174826,174826,174827,0,1,2
50050,3,2,174829,174829,174831,0,2,2
50051,3,3,174832,174832,174835,0,3,1
50052,1,3,174833,174835,174838,2,5,0
50053,2,3,174835,174838,174841,3,6,0
50054,4,1,174839,174841,174842,2,3,0
50055,5,2,174844,174844,174846,0,2,2
50056,5,2,174849,174849,174851,0,2,3
50057,1,2,174850,174851,174853,1,3,0
50058,2,1,174852,174853,174854,1,2,0
50059,6,1,174858,174858,174859,0,1,4
50060,4,1,174862,174862,174863,0,1,3
50061,3,2,174865,174865,174867,0,2,2
50062,3,3,174868,174868,174871,0,3,1
50063,5,3,174873,174873,174876,0,3,2
50064,4,2,174877,174877,174879,0,2,1
50065,3,1,174880,174880,174881,0,1,1
50066,4,1,174884,174884,174885,0,1,3
50067,2,2,174886,174886,174888,0,2,1
50068,1,1,174887,174888,174889,1,2,0
50069,6,1,174893,174893,174894,0,1,4
50070,3,1,174896,174896,174897,0,1,2
50071,4,1,174900,174900,174901,0,1,3
50072,3,2,174903,174903,174905,0,2,2
50073,2,1,174905,174905,174906,0,1,0
50074,6,1,174911,174911,174912,0,1,5
50075,2,2,174913,174913,174915,0,2,1
50076,4,1,174917,174917,174918,0,1,2
50077,4,3,174921,174921,174924,0,3,3
50078,1,2,174922,174924,174926,2,4,0
50079,4,3,174926,174926,174929,0,3,0
50080,4,2,174930,174930,174932,0,2,1
50081,1,1,174931,174932,174933,1,2,0
50082,6,3,174937,174937,174940,0,3,4
50083,4,3,174941,174941,174944,0,3,1
50084,6,1,174947,174947,174948,0,1,3
50085,2,3,174949,174949,174952,0,3,1
50086,2,1,174951,174952,174953,1,2,0
50087,3,2,174954,174954,174956,0,2,1
50088,1,1,174955,174956,174957,1,2,0
50089,6,1,174961,174961,174962,0,1,4
50090,2,3,174963,174963,174966,0,3,1
50091,2,3,174965,174966,174969,1,4,0
50092,2,1,174967,174969,174970,2,3,0
50093,5,3,174972,174972,174975,0,3,2
50094,4,3,174976,174976,174979,0,3,1
50095,1,3,174977,174979,174982,2,5,0
50096,4,1,174981,174982,174983,1,2,0
50097,1,3,174982,174983,174986,1,4,0
50098,2,3,174984,174986,174989,2,5,0
50099,2,2,174986,174989,174991,3,5,0
50100,1,3,174987,174991,174994,4,7,0
50101,5,2,174992,174994,174996,2,4,0
50102,4,2,174996,174996,174998,0,2,0
50103,4,3,175000,175000,175003,0,3,2
50104,1,1,175001,175003,175004,2,3,0
50105,4,2,175005,175005,175007,0,2,1
50106,2,2,175007,175007,175009,0,2,0
50107,4,3,175011,175011,175014,0,3,2
50108,3,2,175014,175014,175016,0,2,0
50109,6,3,175020,175020,175023,0,3,4
50110,5,2,175025,175025,175027,0,2,2
50111,5,2,175030,175030,175032,0,2,3
50112,2,3,175032,175032,175035,0,3,0
50113,1,2,175033,175035,175037,2,4,0
50114,3,1,175036,175037,175038,1,2,0
50115,2,2,175038,175038,175040,0,2,0
50116,3,1,175041,175041,175042,0,1,1
50117,1,1,175042,175042,175043,0,1,0
50118,6,2,175048,175048,175050,0,2,5
50119,4,2,175052,175052,175054,0,2,2
50120,4,2,175056,175056,175058,0,2,2
50121,4,2,175060,175060,175062,0,2,2
50122,6,3,175066,175066,175069,0,3,4
50123,1,1,175067,175069,175070,2,3,0
50124,5,1,175072,175072,175073,0,1,2
50125,2,1,175074,175074,175075,0,1,1
50126,4,3,175078,175078,175081,0,3,3
50127,6,3,175084,175084,175087,0,3,3
50128,2,3,175086,175087,175090,1,4,0
50129,5,3,175091,175091,175094,0,3,1
50130,3,2,175094,175094,175096,0,2,0
50131,1,1,175095,175096,175097,1,2,0
50132,3,1,175098,175098,175099,0,1,1
50133,4,3,175102,175102,175105,0,3,3
50134,3,3,175105,175105,175108,0,3,0
50135,2,1,175107,175108,175109,1,2,0
50136,3,1,175110,175110,175111,0,1,1
50137,4,3,175114,175114,175117,0,3,3
50138,3,2,175117,175117,175119,0,2,0
50139,1,1,175118,175119,175120,1,2,0
50140,2,1,175120,175120,175121,0,1,0
50141,4,1,175124,175124,175125,0,1,3
50142,5,2,175129,175129,175131,0,2,4
50143,2,2,175131,175131,175133,0,2,0
50144,2,2,175133,175133,175135,0,2,0
50145,6,3,175139,175139,175142,0,3,4
50146,4,2,175143,175143,175145,0,2,1
50147,5,3,175148,175148,175151,0,3,3
50148,4,3,175152,175152,175155,0,3,1
50149,5,2,175157,175157,175159,0,2,2
50150,1,3,175158,175159,175162,1,4,0
50151,1,3,175159,175162,175165,3,6,0
50152,6,3,175165,175165,175168,0,3,0
50153,6,2,175171,175171,175173,0,2,3
50154,1,1,175172,175173,175174,1,2,0
50155,3,1,175175,175175,175176,0,1,1
50156,6,2,175181,175181,175183,0,2,5
50157,5,2,175186,175186,175188,0,2,3
50158,5,3,175191,175191,175194,0,3,3
50159,4,3,175195,175195,175198,0,3,1
50160,6,3,175201,175201,175204,0,3,3
50161,4,2,175205,175205,175207,0,2,1
50162,2,1,175207,175207,175208,0,1,0
50163,5,2,175212,175212,175214,0,2,4
50164,4,2,175216,175216,175218,0,2,2
50165,5,3,175221,175221,175224,0,3,3
50166,6,2,175227,175227,175229,0,2,3
50167,4,2,175231,175231,175233,0,2,2
50168,3,1,175234,175234,175235,0,1,1
50169,6,2,175240,175240,175242,0,2,5
50170,6,2,175246,175246,175248,0,2,4
50171,6,1,175252,175252,175253,0,1,4
50172,1,1,175253,175253,175254,0,1,0
50173,2,1,175255,175255,175256,0,1,1
50174,2,1,175257,175257,175258,0,1,1
50175,6,1,175263,175263,175264,0,1,5
50176,4,1,175267,175267,175268,0,1,3
50177,3,2,175270,175270,175272,0,2,2
50178,6,2,175276,175276,175278,0,2,4
50179,2,3,175278,175278,175281,0,3,0
50180,5,2,175283,175283,175285,0,2,2
50181,1,3,175284,175285,175288,1,4,0
50182,6,1,175290,175290,175291,0,1,2
50183,6,3,175296,175296,175299,0,3,5
50184,5,2,175301,175301,175303,0,2,2
50185,1,2,175302,175303,175305,1,3,0
50186,5,1,175307,175307,175308,0,1,2
50187,1,2,175308,175308,175310,0,2,0
50188,1,2,175309,175310,175312,1,3,0
50189,5,2,175314,175314,175316,0,2,2
50190,2,3,175316,175316,175319,0,3,0
50191,1,1,175317,175319,175320,2,3,0
50192,3,2,175320,175320,175322,0,2,0
50193,1,2,175321,175322,175324,1,3,0
50194,4,1,175325,175325,175326,0,1,1
50195,2,3,175327,175327,175330,0,3,1
50196,3,1,175330,175330,175331,0,1,0
50197,2,2,175332,175332,175334,0,2,1
50198,5,1,175337,175337,175338,0,1,3
50199,5,3,175342,175342,175345,0,3,4
50200,1,3,175343,175345,175348,2,5,0
50201,5,2,175348,175348,175350,0,2,0
50202,6,1,175354,175354,175355,0,1,4
50203,4,2,175358,175358,175360,0,2,3
50204,6,2,175364,175364,175366,0,2,4
50205,1,3,175365,175366,175369,1,4,0
50206,4,2,175369,175369,175371,0,2,0
50207,1,1,175370,175371,175372,1,2,0
50208,1,1,175371,175372,175373,1,2,0
50209,2,1,175373,175373,175374,0,1,0
50210,6,2,175379,175379,175381,0,2,5
50211,3,1,175382,175382,175383,0,1,1
50212,6,3,175388,175388,175391,0,3,5
50213,2,3,175390,175391,175394,1,4,0
50214,1,2,175391,175394,175396,3,5,0
50215,5,2,175396,175396,175398,0,2,0
50216,5,3,175401,175401,175404,0,3,3
50217,3,3,175404,175404,175407,0,3,0
50218,3,3,175407,175407,175410,0,3,0
50219,4,3,175411,175411,175414,0,3,1
50220,2,1,175413,175414,175415,1,2,0
50221,5,2,175418,175418,175420,0,2,3
50222,2,2,175420,175420,175422,0,2,0
50223,4,2,175424,175424,175426,0,2,2
50224,1,1,175425,175426,175427,1,2,0
50225,3,1,175428,175428,175429,0,1,1
50226,6,1,175434,175434,175435,0,1,5
50227,2,1,175436,175436,175437,0,1,1
50228,3,3,175439,175439,175442,0,3,2
50229,2,3,175441,175442,175445,1,4,0
50230,1,2,175442,175445,175447,3,5,0
50231,4,2,175446,175447,175449,1,3,0
50232,5,1,175451,175451,175452,0,1,2
50233,3,2,175454,175454,175456,0,2,2
50234,1,1,175455,175456,175457,1,2,0
50235,1,3,175456,175457,175460,1,4,0
50236,2,3,175458,175460,175463,2,5,0
50237,4,1,175462,175463,175464,1,2,0
50238,2,1,175464,175464,175465,0,1,0
50239,2,2,175466,175466,175468,0,2,1
50240,4,1,175470,175470,175471,0,1,2
50241,1,1,175471,175471,175472,0,1,0
50242,3,2,175474,175474,175476,0,2,2
50243,4,3,175478,175478,175481,0,3,2
50244,1,1,175479,175481,175482,2,3,0
50245,4,2,175483,175483,175485,0,2,1
50246,2,1,175485,175485,175486,0,1,0
50247,1,3,175486,175486,175489,0,3,0
50248,5,1,175491,175491,175492,0,1,2
50249,3,2,175494,175494,175496,0,2,2
50250,4,1,175498,175498,175499,0,1,2
50251,1,3,175499,175499,175502,0,3,0
50252,1,1,175500,175502,175503,2,3,0
50253,5,1,175505,175505,175506,0,1,2
50254,1,2,175506,175506,175508,0,2,0
50255,1,3,175507,175508,175511,1,4,0
50256,2,2,175509,175511,175513,2,4,0
50257,6,1,175515,175515,175516,0,1,2
50258,2,2,175517,175517,175519,0,2,1
50259,3,3,175520,175520,175523,0,3,1
50260,6,1,175526,175526,175527,0,1,3
50261,1,2,175527,175527,175529,0,2,0
50262,1,1,175528,175529,175530,1,2,0
50263,5,2,175533,175533,175535,0,2,3
50264,2,1,175535,175535,175536,0,1,0
50265,2,3,175537,175537,175540,0,3,1
50266,6,3,175543,175543,175546,0,3,3
50267,3,3,175546,175546,175549,0,3,0
50268,1,2,175547,175549,175551,2,4,0
50269,2,1,175549,175551,175552,2,3,0
50270,5,1,175554,175554,175555,0,1,2
50271,1,1,175555,175555,175556,0,1,0
50272,4,3,175559,175559,175562,0,3,3
50273,3,1,175562,175562,175563,0,1,0
50274,4,1,175566,175566,175567,0,1,3
50275,5,2,175571,175571,175573,0,2,4
50276,1,2,175572,175573,175575,1,3,0
50277,4,3,175576,175576,175579,0,3,1
50278,3,1,175579,175579,175580,0,1,0
50279,2,1,175581,175581,175582,0,1,1
50280,2,1,175583,175583,175584,0,1,1
50281,3,2,175586,175586,175588,0,2,2
50282,5,2,175591,175591,175593,0,2,3
50283,2,3,175593,175593,175596,0,3,0
50284,6,1,175599,175599,175600,0,1,3
50285,1,3,175600,175600,175603,0,3,0
50286,5,3,175605,175605,175608,0,3,2
50287,5,2,175610,175610,175612,0,2,2
50288,2,3,175612,175612,175615,0,3,0
50289,1,3,175613,175615,175618,2,5,0
50290,2,1,175615,175618,175619,3,4,0
50291,2,2,175617,175619,175621,2,4,0
50292,6,3,175623,175623,175626,0,3,2
50293,2,3,175625,175626,175629,1,4,0
50294,4,2,175629,175629,175631,0,2,0
50295,3,2,175632,175632,175634,0,2,1
50296,6,1,175638,175638,175639,0,1,4
50297,1,2,175639,175639,175641,0,2,0
50298,3,3,175642,175642,175645,0,3,1
50299,6,2,175648,175648,175650,0,2,3
50300,6,1,175654,175654,175655,0,1,4
50301,2,1,175656,175656,175657,0,1,1
50302,5,1,175661,175661,175662,0,1,4
50303,4,3,175665,175665,175668,0,3,3
50304,3,2,175668,175668,175670,0,2,0
50305,1,3,175669,175670,175673,1,4,0
50306,5,1,175674,175674,175675,0,1,1
50307,2,3,175676,175676,175679,0,3,1
50308,5,3,175681,175681,175684,0,3,2
50309,1,3,175682,175684,175687,2,5,0
50310,5,1,175687,175687,175688,0,1,0
50311,2,3,175689,175689,175692,0,3,1
50312,6,3,175695,175695,175698,0,3,3
50313,5,2,175700,175700,175702,0,2,2
50314,6,3,175706,175706,175709,0,3,4
50315,4,2,175710,175710,175712,0,2,1
50316,5,1,175715,175715,175716,0,1,3
50317,3,2,175718,175718,175720,0,2,2
50318,5,2,175723,175723,175725,0,2,3
50319,5,1,175728,175728,175729,0,1,3
50320,2,1,175730,175730,175731,0,1,1
50321,4,3,175734,175734,175737,0,3,3
50322,1,2,175735,175737,175739,2,4,0
50323,3,2,175738,175739,175741,1,3,0
50324,2,1,175740,175741,175742,1,2,0
50325,1,2,175741,175742,175744,1,3,0
50326,5,3,175746,175746,175749,0,3,2
50327,2,2,175748,175749,175751,1,3,0
50328,6,2,175754,175754,175756,0,2,3
50329,1,3,175755,175756,175759,1,4,0
50330,5,1,175760,175760,175761,0,1,1
50331,6,2,175766,175766,175768,0,2,5
50332,2,3,175768,175768,175771,0,3,0
50333,3,3,175771,175771,175774,0,3,0
50334,5,2,175776,175776,175778,0,2,2
50335,6,1,175782,175782,175783,0,1,4
50336,4,3,175786,175786,175789,0,3,3
50337,4,1,175790,175790,175791,0,1,1
50338,5,3,175795,175795,175798,0,3,4
50339,2,3,175797,175798,175801,1,4,0
50340,3,1,175800,175801,175802,1,2,0
50341,1,1,175801,175802,175803,1,2,0
50342,6,3,175807,175807,175810,0,3,4
50343,1,3,175808,175810,175813,2,5,0
50344,6,3,175814,175814,175817,0,3,1
50345,2,1,175816,175817,175818,1,2,0
50346,5,2,175821,175821,175823,0,2,3
50347,2,2,175823,175823,175825,0,2,0
50348,5,2,175828,175828,175830,0,2,3
50349,5,3,175833,175833,175836,0,3,3
50350,2,2,175835,175836,175838,1,3,0
50351,4,2,175839,175839,175841,0,2,1
50352,5,1,175844,175844,175845,0,1,3
50353,2,2,175846,175846,175848,0,2,1
50354,3,1,175849,175849,175850,0,1,1
50355,6,1,175855,175855,175856,0,1,5
50356,3,1,175858,175858,175859,0,1,2
50357,4,3,175862,175862,175865,0,3,3
50358,6,3,175868,175868,175871,0,3,3
50359,5,1,175873,175873,175874,0,1,2
50360,6,2,175879,175879,175881,0,2,5
50361,2,3,175881,175881,175884,0,3,0
50362,1,3,175882,175884,175887,2,5,0
50363,3,3,175885,175887,175890,2,5,0
50364,5,2,175890,175890,175892,0,2,0
50365,5,2,175895,175895,175897,0,2,3
50366,2,3,175897,175897,175900,0,3,0
50367,6,1,175903,175903,175904,0,1,3
50368,6,2,175909,175909,175911,0,2,5
50369,5,1,175914,175914,175915,0,1,3
50370,6,2,175920,175920,175922,0,2,5
50371,1,3,175921,175922,175925,1,4,0
50372,2,1,175923,175925,175926,2,3,0
50373,6,1,175929,175929,175930,0,1,3
50374,1,3,175930,175930,175933,0,3,0
50375,5,1,175935,175935,175936,0,1,2
50376,3,3,175938,175938,175941,0,3,2
50377,5,3,175943,175943,175946,0,3,2
50378,6,3,175949,175949,175952,0,3,3
50379,4,2,175953,175953,175955,0,2,1
50380,5,1,175958,175958,175959,0,1,3
50381,6,2,175964,175964,175966,0,2,5
50382,6,3,175970,175970,175973,0,3,4
50383,4,2,175974,175974,175976,0,2,1
50384,2,3,175976,175976,175979,0,3,0
50385,5,1,175981,175981,175982,0,1,2
50386,6,3,175987,175987,175990,0,3,5
50387,3,3,175990,175990,175993,0,3,0
50388,3,2,175993,175993,175995,0,2,0
50389,1,1,175994,175995,175996,1,2,0
50390,4,3,175998,175998,176001,0,3,2
50391,5,3,176003,176003,176006,0,3,2
50392,1,1,176004,176006,176007,2,3,0
50393,1,3,176005,176007,176010,2,5,0
50394,2,3,176007,176010,176013,3,6,0
50395,6,1,176013,176013,176014,0,1,0
50396,2,2,176015,176015,176017,0,2,1
50397,4,2,176019,176019,176021,0,2,2
50398,1,2,176020,176021,176023,1,3,0
50399,5,3,176025,176025,176028,0,3,2
50400,2,2,176027,176028,176030,1,3,0
50401,4,2,176031,176031,176033,0,2,1
50402,4,2,176035,176035,176037,0,2,2
50403,5,3,176040,176040,176043,0,3,3
50404,3,2,176043,176043,176045,0,2,0
50405,6,1,176049,176049,176050,0,1,4
50406,6,2,176055,176055,176057,0,2,5
50407,6,1,176061,176061,176062,0,1,4
50408,5,2,176066,176066,176068,0,2,4
50409,3,1,176069,176069,176070,0,1,1
50410,1,2,176070,176070,176072,0,2,0
50411,1,3,176071,176072,176075,1,4,0
50412,2,2,176073,176075,176077,2,4,0
50413,3,2,176076,176077,176079,1,3,0
50414,2,3,176078,176079,176082,1,4,0
50415,2,1,176080,176082,176083,2,3,0
50416,4,1,176084,176084,176085,0,1,1
50417,6,3,176090,176090,176093,0,3,5
50418,5,3,176095,176095,176098,0,3,2
50419,3,1,176098,176098,176099,0,1,0
50420,3,2,176101,176101,176103,0,2,2
50421,3,1,176104,176104,176105,0,1,1
50422,1,1,176105,176105,176106,0,1,0
50423,1,1,176106,176106,176107,0,1,0
50424,3,2,176109,176109,176111,0,2,2
50425,1,2,176110,176111,176113,1,3,0
50426,4,3,176114,176114,176117,0,3,1
50427,3,3,176117,176117,176120,0,3,0
50428,2,2,176119,176120,176122,1,3,0
50429,4,3,176123,176123,176126,0,3,1
50430,3,2,176126,176126,176128,0,2,0
50431,5,2,176131,176131,176133,0,2,3
50432,3,3,176134,176134,176137,0,3,1
50433,5,2,176139,176139,176141,0,2,2
50434,4,2,176143,176143,176145,0,2,2
50435,5,2,176148,176148,176150,0,2,3
50436,6,3,176154,176154,176157,0,3,4
50437,2,3,176156,176157,176160,1,4,0
50438,6,3,176162,176162,176165,0,3,2
50439,6,1,176168,176168,176169,0,1,3
50440,2,2,176170,176170,176172,0,2,1
50441,3,2,176173,176173,176175,0,2,1
50442,5,2,176178,176178,176180,0,2,3
50443,4,2,176182,176182,176184,0,2,2
50444,4,1,176186,176186,176187,0,1,2
50445,5,2,176191,176191,176193,0,2,4
50446,1,3,176192,176193,176196,1,4,0
50447,2,2,176194,176196,176198,2,4,0
50448,3,3,176197,176198,176201,1,4,0
50449,2,1,176199,176201,176202,2,3,0
50450,6,1,176205,176205,176206,0,1,3
50451,5,2,176210,176210,176212,0,2,4
50452,6,2,176216,176216,176218,0,2,4
50453,2,3,176218,176218,176221,0,3,0
50454,4,2,176222,176222,176224,0,2,1
50455,3,2,176225,176225,176227,0,2,1
50456,6,2,176231,176231,176233,0,2,4
50457,4,3,176235,176235,176238,0,3,2
50458,2,3,176237,176238,176241,1,4,0
50459,1,2,176238,176241,176243,3,5,0
50460,1,2,176239,176243,176245,4,6,0
50461,4,1,176243,176245,176246,2,3,0
50462,4,2,176247,176247,176249,0,2,1
50463,4,2,176251,176251,176253,0,2,2
50464,6,2,176257,176257,176259,0,2,4
50465,2,1,176259,176259,176260,0,1,0
50466,3,3,176262,176262,176265,0,3,2
50467,1,3,176263,176265,176268,2,5,0
50468,1,2,176264,176268,176270,4,6,0
50469,3,1,176267,176270,176271,3,4,0
50470,5,2,176272,176272,176274,0,2,1
50471,4,1,176276,176276,176277,0,1,2
50472,3,3,176279,176279,176282,0,3,2
50473,3,2,176282,176282,176284,0,2,0
50474,3,2,176285,176285,176287,0,2,1
50475,1,1,176286,176287,176288,1,2,0
50476,5,3,176291,176291,176294,0,3,3
50477,6,1,176297,176297,176298,0,1,3
50478,1,2,176298,176298,176300,0,2,0
50479,4,3,176302,176302,176305,0,3,2
50480,2,1,176304,176305,176306,1,2,0
50481,5,1,176309,176309,176310,0,1,3
50482,1,1,176310,176310,176311,0,1,0
50483,6,3,176316,176316,176319,0,3,5
50484,5,3,176321,176321,176324,0,3,2
50485,4,1,176325,176325,176326,0,1,1
50486,3,2,176328,176328,176330,0,2,2
50487,5,3,176333,176333,176336,0,3,3
50488,6,3,176339,176339,176342,0,3,3
50489,1,2,176340,176342,176344,2,4,0
50490,5,3,176345,176345,176348,0,3,1
50491,2,3,176347,176348,176351,1,4,0
50492,2,2,176349,176351,176353,2,4,0
50493,6,3,176355,176355,176358,0,3,2
50494,4,2,176359,176359,176361,0,2,1
50495,1,3,176360,176361,176364,1,4,0
50496,4,2,176364,176364,176366,0,2,0
50497,5,1,176369,176369,176370,0,1,3
50498,2,2,176371,176371,176373,0,2,1
50499,4,1,176375,176375,176376,0,1,2
50500,3,3,176378,176378,176381,0,3,2
50501,4,3,176382,176382,176385,0,3,1
50502,4,1,176386,176386,176387,0,1,1
50503,2,1,176388,176388,176389,0,1,1
50504,3,3,176391,176391,176394,0,3,2
50505,6,3,176397,176397,176400,0,3,3
50506,5,1,176402,176402,176403,0,1,2
50507,6,1,176408,176408,176409,0,1,5
50508,3,2,176411,176411,176413,0,2,2
50509,4,1,176415,176415,176416,0,1,2
50510,4,3,176419,176419,176422,0,3,3
50511,6,3,176425,176425,176428,0,3,3
50512,3,1,176428,176428,176429,0,1,0
50513,1,1,176429,176429,176430,0,1,0
50514,6,2,176435,176435,176437,0,2,5
50515,5,3,176440,176440,176443,0,3,3
50516,5,1,176445,176445,176446,0,1,2
50517,5,1,176450,176450,176451,0,1,4
50518,5,1,176455,176455,176456,0,1,4
50519,6,2,176461,176461,176463,0,2,5
50520,5,1,176466,176466,176467,0,1,3
50521,4,2,176470,176470,176472,0,2,3
50522,4,1,176474,176474,176475,0,1,2
50523,5,2,176479,176479,176481,0,2,4
50524,1,1,176480,176481,176482,1,2,0
50525,5,1,176485,176485,176486,0,1,3
50526,3,1,176488,176488,176489,0,1,2
50527,2,3,176490,176490,176493,0,3,1
50528,3,3,176493,176493,176496,0,3,0
50529,4,3,176497,176497,176500,0,3,1
50530,5,1,176502,176502,176503,0,1,2
50531,3,1,176505,176505,176506,0,1,2
50532,2,1,176507,176507,176508,0,1,1
50533,4,1,176511,176511,176512,0,1,3
50534,2,2,176513,176513,176515,0,2,1
50535,3,1,176516,176516,176517,0,1,1
50536,3,2,176519,176519,176521,0,2,2
50537,6,2,176525,176525,176527,0,2,4
50538,1,3,176526,176527,176530,1,4,0
50539,3,3,176529,176530,176533,1,4,0
50540,5,3,176534,176534,176537,0,3,1
50541,2,3,176536,176537,176540,1,4,0
50542,6,2,176542,176542,176544,0,2,2
50543,5,3,176547,176547,176550,0,3,3
50544,4,2,176551,176551,176553,0,2,1
50545,5,1,176556,176556,176557,0,1,3
50546,2,2,176558,176558,176560,0,2,1
50547,2,1,176560,176560,176561,0,1,0
50548,4,1,176564,176564,176565,0,1,3
50549,4,2,176568,176568,176570,0,2,3
50550,2,3,176570,176570,176573,0,3,0
50551,6,3,176576,176576,176579,0,3,3
50552,4,2,176580,176580,176582,0,2,1
50553,4,3,176584,176584,176587,0,3,2
50554,4,3,176588,176588,176591,0,3,1
50555,4,3,176592,176592,176595,0,3,1
50556,4,3,176596,176596,176599,0,3,1
50557,4,1,176600,176600,176601,0,1,1
50558,4,1,176604,176604,176605,0,1,3
50559,1,2,176605,176605,176607,0,2,0
50560,4,2,176609,176609,176611,0,2,2
50561,5,1,176614,176614,176615,0,1,3
50562,6,1,176620,176620,176621,0,1,5
50563,3,3,176623,176623,176626,0,3,2
50564,2,3,176625,176626,176629,1,4,0
50565,4,3,176629,176629,176632,0,3,0
50566,5,3,176634,176634,176637,0,3,2
50567,2,1,176636,176637,176638,1,2,0
50568,4,3,176640,176640,176643,0,3,2
50569,4,3,176644,176644,176647,0,3,1
50570,2,3,176646,176647,176650,1,4,0
50571,5,1,176651,176651,176652,0,1,1
50572,4,1,176655,176655,176656,0,1,3
50573,6,2,176661,176661,176663,0,2,5
50574,1,3,176662,176663,176666,1,4,0
50575,5,1,176667,176667,176668,0,1,1
50576,1,3,176668,176668,176671,0,3,0
50577,4,2,176672,176672,176674,0,2,1
50578,2,1,176674,176674,176675,0,1,0
50579,2,2,176676,176676,176678,0,2,1
50580,6,1,176682,176682,176683,0,1,4
50581,4,2,176686,176686,176688,0,2,3
50582,6,3,176692,176692,176695,0,3,4
50583,5,3,176697,176697,176700,0,3,2
50584,6,3,176703,176703,176706,0,3,3
50585,4,3,176707,176707,176710,0,3,1
50586,2,2,176709,176710,176712,1,3,0
50587,3,2,176712,176712,176714,0,2,0
50588,1,2,176713,176714,176716,1,3,0
50589,3,2,176716,176716,176718,0,2,0
50590,5,1,176721,176721,176722,0,1,3
50591,5,2,176726,176726,176728,0,2,4
50592,5,1,176731,176731,176732,0,1,3
50593,5,1,176736,176736,176737,0,1,4
50594,2,3,176738,176738,176741,0,3,1
50595,3,2,176741,176741,176743,0,2,0
50596,4,1,176745,176745,176746,0,1,2
50597,3,2,176748,176748,176750,0,2,2
50598,4,1,176752,176752,176753,0,1,2
50599,2,1,176754,176754,176755,0,1,1
50600,2,1,176756,176756,176757,0,1,1
50601,6,1,176762,176762,176763,0,1,5
50602,2,3,176764,176764,176767,0,3,1
50603,3,1,176767,176767,176768,0,1,0
50604,3,2,176770,176770,176772,0,2,2
50605,5,2,176775,176775,176777,0,2,3
50606,6,2,176781,176781,176783,0,2,4
50607,2,3,176783,176783,176786,0,3,0
50608,2,2,176785,176786,176788,1,3,0
50609,4,3,176789,176789,176792,0,3,1
50610,5,1,176794,176794,176795,0,1,2
50611,5,1,176799,176799,176800,0,1,4
50612,2,1,176801,176801,176802,0,1,1
50613,6,3,176807,176807,176810,0,3,5
50614,3,3,176810,176810,176813,0,3,0
50615,1,1,176811,176813,176814,2,3,0
50616,6,3,176817,176817,176820,0,3,3
50617,1,3,176818,176820,176823,2,5,0
50618,4,3,176822,176823,176826,1,4,0
50619,2,2,176824,176826,176828,2,4,0
50620,6,3,176830,176830,176833,0,3,2
50621,1,2,176831,176833,176835,2,4,0
50622,4,1,176835,176835,176836,0,1,0
50623,5,1,176840,176840,176841,0,1,4
50624,4,2,176844,176844,176846,0,2,3
50625,5,3,176849,176849,176852,0,3,3
50626,1,3,176850,176852,176855,2,5,0
50627,1,3,176851,176855,176858,4,7,0
50628,4,2,176855,176858,176860,3,5,0
50629,6,3,176861,176861,176864,0,3,1
50630,3,3,176864,176864,176867,0,3,0
50631,2,1,176866,176867,176868,1,2,0
50632,5,2,176871,176871,176873,0,2,3
50633,3,2,176874,176874,176876,0,2,1
50634,6,1,176880,176880,176881,0,1,4
50635,1,3,176881,176881,176884,0,3,0
50636,4,3,176885,176885,176888,0,3,1
50637,3,1,176888,176888,176889,0,1,0
50638,2,3,176890,176890,176893,0,3,1
50639,5,2,176895,176895,176897,0,2,2
50640,4,3,176899,176899,176902,0,3,2
50641,2,1,176901,176902,176903,1,2,0
50642,2,3,176903,176903,176906,0,3,0
50643,3,3,176906,176906,176909,0,3,0
50644,4,3,176910,176910,176913,0,3,1
50645,3,1,176913,176913,176914,0,1,0
50646,1,1,176914,176914,176915,0,1,0
50647,3,3,176917,176917,176920,0,3,2
50648,6,2,176923,176923,176925,0,2,3
50649,5,3,176928,176928,176931,0,3,3
50650,5,2,176933,176933,176935,0,2,2
50651,3,1,176936,176936,176937,0,1,1
50652,6,2,176942,176942,176944,0,2,5
50653,3,3,176945,176945,176948,0,3,1
50654,4,2,176949,176949,176951,0,2,1
50655,2,2,176951,176951,176953,0,2,0
50656,2,2,176953,176953,176955,0,2,0
50657,5,1,176958,176958,176959,0,1,3
50658,2,2,176960,176960,176962,0,2,1
50659,1,1,176961,176962,176963,1,2,0
50660,1,3,176962,176963,176966,1,4,0
50661,3,3,176965,176966,176969,1,4,0
50662,5,3,176970,176970,176973,0,3,1
50663,2,3,176972,176973,176976,1,4,0
50664,1,1,176973,176976,176977,3,4,0
50665,6,3,176979,176979,176982,0,3,2
50666,4,2,176983,176983,176985,0,2,1
50667,1,2,176984,176985,176987,1,3,0
50668,1,2,176985,176987,176989,2,4,0
50669,3,1,176988,176989,176990,1,2,0
50670,1,2,176989,176990,176992,1,3,0
50671,3,1,176992,176992,176993,0,1,0
50672,2,3,176994,176994,176997,0,3,1
50673,2,1,176996,176997,176998,1,2,0
50674,3,1,176999,176999,177000,0,1,1
50675,1,2,177000,177000,177002,0,2,0
50676,1,1,177001,177002,177003,1,2,0
50677,1,1,177002,177003,177004,1,2,0
50678,5,2,177007,177007,177009,0,2,3
50679,2,3,177009,177009,177012,0,3,0
50680,2,3,177011,177012,177015,1,4,0
50681,3,2,177014,177015,177017,1,3,0
50682,4,2,177018,177018,177020,0,2,1
50683,2,3,177020,177020,177023,0,3,0
50684,1,1,177021,177023,177024,2,3,0
50685,1,2,177022,177024,177026,2,4,0
50686,3,3,177025,177026,177029,1,4,0
50687,5,2,177030,177030,177032,0,2,1
50688,5,3,177035,177035,177038,0,3,3
50689,2,1,177037,177038,177039,1,2,0
50690,4,2,177041,177041,177043,0,2,2
50691,2,1,177043,177043,177044,0,1,0
50692,5,3,177048,177048,177051,0,3,4
50693,2,1,177050,177051,177052,1,2,0
50694,1,3,177051,177052,177055,1,4,0
50695,6,2,177057,177057,177059,0,2,2
50696,3,3,177060,177060,177063,0,3,1
50697,1,1,177061,177063,177064,2,3,0
50698,3,1,177064,177064,177065,0,1,0
50699,2,3,177066,177066,177069,0,3,1
50700,4,3,177070,177070,177073,0,3,1
50701,4,1,177074,177074,177075,0,1,1
50702,4,3,177078,177078,177081,0,3,3
50703,2,3,177080,177081,177084,1,4,0
50704,5,1,177085,177085,177086,0,1,1
50705,3,3,177088,177088,177091,0,3,2
50706,3,2,177091,177091,177093,0,2,0
50707,6,1,177097,177097,177098,0,1,4
50708,1,2,177098,177098,177100,0,2,0
50709,5,3,177103,177103,177106,0,3,3
50710,4,3,177107,177107,177110,0,3,1
50711,1,3,177108,177110,177113,2,5,0
50712,2,3,177110,177113,177116,3,6,0
50713,6,1,177116,177116,177117,0,1,0
50714,6,2,177122,177122,177124,0,2,5
50715,2,1,177124,177124,177125,0,1,0
50716,5,3,177129,177129,177132,0,3,4
50717,5,2,177134,177134,177136,0,2,2
50718,6,3,177140,177140,177143,0,3,4
50719,5,3,177145,177145,177148,0,3,2
50720,5,1,177150,177150,177151,0,1,2
50721,3,3,177153,177153,177156,0,3,2
50722,2,3,177155,177156,177159,1,4,0
50723,1,1,177156,177159,177160,3,4,0
50724,1,3,177157,177160,177163,3,6,0
50725,4,3,177161,177163,177166,2,5,0
50726,5,1,177166,177166,177167,0,1,0
50727,6,3,177172,177172,177175,0,3,5
50728,6,2,177178,177178,177180,0,2,3
50729,3,2,177181,177181,177183,0,2,1
50730,1,3,177182,177183,177186,1,4,0
50731,1,1,177183,177186,177187,3,4,0
50732,6,3,177189,177189,177192,0,3,2
50733,3,1,177192,177192,177193,0,1,0
50734,6,2,177198,177198,177200,0,2,5
50735,6,3,177204,177204,177207,0,3,4
50736,1,1,177205,177207,177208,2,3,0
50737,2,1,177207,177208,177209,1,2,0
50738,6,3,177213,177213,177216,0,3,4
50739,6,2,177219,177219,177221,0,2,3
50740,5,2,177224,177224,177226,0,2,3
50741,1,3,177225,177226,177229,1,4,0
50742,2,2,177227,177229,177231,2,4,0
50743,6,1,177233,177233,177234,0,1,2
50744,5,3,177238,177238,177241,0,3,4
50745,6,3,177244,177244,177247,0,3,3
50746,1,3,177245,177247,177250,2,5,0
50747,3,2,177248,177250,177252,2,4,0
50748,1,1,177249,177252,177253,3,4,0
50749,2,3,177251,177253,177256,2,5,0
50750,6,2,177257,177257,177259,0,2,1
50751,5,2,177262,177262,177264,0,2,3
50752,4,2,177266,177266,177268,0,2,2
50753,5,2,177271,177271,177273,0,2,3
50754,1,3,177272,177273,177276,1,4,0
50755,3,2,177275,177276,177278,1,3,0
50756,4,2,177279,177279,177281,0,2,1
50757,6,2,177285,177285,177287,0,2,4
50758,6,3,177291,177291,177294,0,3,4
50759,4,1,177295,177295,177296,0,1,1
50760,1,1,177296,177296,177297,0,1,0
50761,1,2,177297,177297,177299,0,2,0
50762,6,1,177303,177303,177304,0,1,4
50763,2,2,177305,177305,177307,0,2,1
50764,5,3,177310,177310,177313,0,3,3
50765,5,3,177315,177315,177318,0,3,2
50766,3,3,177318,177318,177321,0,3,0
50767,1,2,177319,177321,177323,2,4,0
50768,3,2,177322,177323,177325,1,3,0
50769,3,3,177325,177325,177328,0,3,0
50770,2,1,177327,177328,177329,1,2,0
50771,1,1,177328,177329,177330,1,2,0
50772,3,1,177331,177331,177332,0,1,1
50773,5,3,177336,177336,177339,0,3,4
50774,1,3,177337,177339,177342,2,5,0
50775,3,3,177340,177342,177345,2,5,0
50776,4,1,177344,177345,177346,1,2,0
50777,1,1,177345,177346,177347,1,2,0
50778,5,1,177350,177350,177351,0,1,3
50779,6,2,177356,177356,177358,0,2,5
50780,4,3,177360,177360,177363,0,3,2
50781,2,3,177362,177363,177366,1,4,0
50782,1,2,177363,177366,177368,3,5,0
50783,1,2,177364,177368,177370,4,6,0
50784,3,2,177367,177370,177372,3,5,0
50785,4,3,177371,177372,177375,1,4,0
50786,2,3,177373,177375,177378,2,5,0
50787,5,1,177378,177378,177379,0,1,0
50788,4,2,177382,177382,177384,0,2,3
50789,4,3,177386,177386,177389,0,3,2
50790,2,3,177388,177389,177392,1,4,0
50791,6,2,177394,177394,177396,0,2,2
50792,6,1,177400,177400,177401,0,1,4
50793,3,3,177403,177403,177406,0,3,2
50794,1,1,177404,177406,177407,2,3,0
50795,3,1,177407,177407,177408,0,1,0
50796,4,1,177411,177411,177412,0,1,3
50797,1,1,177412,177412,177413,0,1,0
50798,5,1,177417,177417,177418,0,1,4
50799,1,2,177418,177418,177420,0,2,0
50800,2,2,177420,177420,177422,0,2,0
50801,3,3,177423,177423,177426,0,3,1
50802,2,1,177425,177426,177427,1,2,0
50803,3,1,177428,177428,177429,0,1,1
50804,2,1,177430,177430,177431,0,1,1
50805,2,1,177432,177432,177433,0,1,1
50806,4,3,177436,177436,177439,0,3,3
50807,3,1,177439,177439,177440,0,1,0
50808,3,3,177442,177442,177445,0,3,2
50809,5,3,177447,177447,177450,0,3,2
50810,1,1,177448,177450,177451,2,3,0
50811,6,3,177454,177454,177457,0,3,3
50812,3,1,177457,177457,177458,0,1,0
50813,1,3,177458,177458,177461,0,3,0
50814,3,3,177461,177461,177464,0,3,0
50815,4,3,177465,177465,177468,0,3,1
50816,4,1,177469,177469,177470,0,1,1
50817,2,2,177471,177471,177473,0,2,1
50818,6,1,177477,177477,177478,0,1,4
50819,2,2,177479,177479,177481,0,2,1
50820,1,1,177480,177481,177482,1,2,0
50821,6,3,177486,177486,177489,0,3,4
50822,3,1,177489,177489,177490,0,1,0
50823,2,1,177491,177491,177492,0,1,1
50824,4,3,177495,177495,177498,0,3,3
50825,6,2,177501,177501,177503,0,2,3
50826,2,1,177503,177503,177504,0,1,0
50827,2,2,177505,177505,177507,0,2,1
50828,6,2,177511,177511,177513,0,2,4
50829,6,2,177517,177517,177519,0,2,4
50830,5,2,177522,177522,177524,0,2,3
50831,2,1,177524,177524,177525,0,1,0
50832,5,2,177529,177529,177531,0,2,4
50833,5,2,177534,177534,177536,0,2,3
50834,6,3,177540,177540,177543,0,3,4
50835,4,2,177544,177544,177546,0,2,1
50836,5,2,177549,177549,177551,0,2,3
50837,1,2,177550,177551,177553,1,3,0
50838,4,3,177554,177554,177557,0,3,1
50839,5,3,177559,177559,177562,0,3,2
50840,4,3,177563,177563,177566,0,3,1
50841,2,3,177565,177566,177569,1,4,0
50842,5,1,177570,177570,177571,0,1,1
50843,3,2,177573,177573,177575,0,2,2
50844,5,1,177578,177578,177579,0,1,3
50845,3,3,177581,177581,177584,0,3,2
50846,4,3,177585,177585,177588,0,3,1
50847,2,3,177587,177588,177591,1,4,0
50848,5,3,177592,177592,177595,0,3,1
50849,6,3,177598,177598,177601,0,3,3
50850,6,3,177604,177604,177607,0,3,3
50851,3,1,177607,177607,177608,0,1,0
50852,1,3,177608,177608,177611,0,3,0
50853,4,3,177612,177612,177615,0,3,1
50854,1,3,177613,177615,177618,2,5,0
50855,2,2,177615,177618,177620,3,5,0
50856,5,3,177620,177620,177623,0,3,0
50857,3,1,177623,177623,177624,0,1,0
50858,2,2,177625,177625,177627,0,2,1
50859,3,1,177628,177628,177629,0,1,1
50860,6,3,177634,177634,177637,0,3,5
50861,4,3,177638,177638,177641,0,3,1
50862,4,1,177642,177642,177643,0,1,1
50863,6,2,177648,177648,177650,0,2,5
50864,6,1,177654,177654,177655,0,1,4
50865,1,2,177655,177655,177657,0,2,0
50866,1,2,177656,177657,177659,1,3,0
50867,2,1,177658,177659,177660,1,2,0
50868,5,1,177663,177663,177664,0,1,3
50869,6,2,177669,177669,177671,0,2,5
50870,1,1,177670,177671,177672,1,2,0
50871,4,2,177674,177674,177676,0,2,2
50872,6,1,177680,177680,177681,0,1,4
50873,5,3,177685,177685,177688,0,3,4
50874,2,2,177687,177688,177690,1,3,0
50875,1,2,177688,177690,177692,2,4,0
50876,5,3,177693,177693,177696,0,3,1
50877,3,3,177696,177696,177699,0,3,0
50878,2,2,177698,177699,177701,1,3,0
50879,5,2,177703,177703,177705,0,2,2
50880,2,2,177705,177705,177707,0,2,0
50881,6,3,177711,177711,177714,0,3,4
50882,6,1,177717,177717,177718,0,1,3
50883,4,3,177721,177721,177724,0,3,3
50884,6,1,177727,177727,177728,0,1,3
50885,5,3,177732,177732,177735,0,3,4
50886,3,3,177735,177735,177738,0,3,0
50887,2,2,177737,177738,177740,1,3,0
50888,3,1,177740,177740,177741,0,1,0
50889,4,3,177744,177744,177747,0,3,3
50890,6,3,177750,177750,177753,0,3,3
50891,4,1,177754,177754,177755,0,1,1
50892,5,1,177759,177759,177760,0,1,4
50893,1,3,177760,177760,177763,0,3,0
50894,3,3,177763,177763,177766,0,3,0
50895,5,1,177768,177768,177769,0,1,2
50896,5,3,177773,177773,177776,0,3,4
50897,6,2,177779,177779,177781,0,2,3
50898,1,1,177780,177781,177782,1,2,0
50899,3,2,177783,177783,177785,0,2,1
50900,2,3,177785,177785,177788,0,3,0
50901,3,3,177788,177788,177791,0,3,0
50902,2,3,177790,177791,177794,1,4,0
50903,5,3,177795,177795,177798,0,3,1
50904,1,1,177796,177798,177799,2,3,0
50905,2,1,177798,177799,177800,1,2,0
50906,1,3,177799,177800,177803,1,4,0
50907,5,3,177804,177804,177807,0,3,1
50908,4,3,177808,177808,177811,0,3,1
50909,3,3,177811,177811,177814,0,3,0
50910,5,1,177816,177816,177817,0,1,2
50911,1,1,177817,177817,177818,0,1,0
50912,4,1,177821,177821,177822,0,1,3
50913,1,2,177822,177822,177824,0,2,0
50914,5,1,177827,177827,177828,0,1,3
50915,4,2,177831,177831,177833,0,2,3
50916,3,2,177834,177834,177836,0,2,1
50917,2,3,177836,177836,177839,0,3,0
50918,2,2,177838,177839,177841,1,3,0
50919,5,3,177843,177843,177846,0,3,2
50920,5,3,177848,177848,177851,0,3,2
50921,2,2,177850,177851,177853,1,3,0
50922,5,3,177855,177855,177858,0,3,2
50923,2,2,177857,177858,177860,1,3,0
50924,3,2,177860,177860,177862,0,2,0
50925,2,2,177862,177862,177864,0,2,0
50926,1,2,177863,177864,177866,1,3,0
50927,1,1,177864,177866,177867,2,3,0
50928,3,1,177867,177867,177868,0,1,0
50929,4,1,177871,177871,177872,0,1,3
50930,2,2,177873,177873,177875,0,2,1
50931,6,1,177879,177879,177880,0,1,4
50932,2,1,177881,177881,177882,0,1,1
50933,5,2,177886,177886,177888,0,2,4
50934,6,2,177892,177892,177894,0,2,4
50935,3,2,177895,177895,177897,0,2,1
50936,4,2,177899,177899,177901,0,2,2
50937,4,2,177903,177903,177905,0,2,2
50938,2,2,177905,177905,177907,0,2,0
50939,2,1,177907,177907,177908,0,1,0
50940,4,1,177911,177911,177912,0,1,3
50941,2,1,177913,177913,177914,0,1,1
50942,5,1,177918,177918,177919,0,1,4
50943,1,3,177919,177919,177922,0,3,0
50944,6,3,177925,177925,177928,0,3,3
50945,1,3,177926,177928,177931,2,5,0
50946,2,1,177928,177931,177932,3,4,0
50947,2,2,177930,177932,177934,2,4,0
50948,5,1,177935,177935,177936,0,1,1
50949,3,2,177938,177938,177940,0,2,2
50950,1,3,177939,177940,177943,1,4,0
50951,1,2,177940,177943,177945,3,5,0
50952,3,2,177943,177945,177947,2,4,0
50953,5,2,177948,177948,177950,0,2,1
50954,4,2,177952,177952,177954,0,2,2
50955,1,1,177953,177954,177955,1,2,0
50956,3,1,177956,177956,177957,0,1,1
50957,6,1,177962,177962,177963,0,1,5
50958,2,1,177964,177964,177965,0,1,1
50959,4,2,177968,177968,177970,0,2,3
50960,6,3,177974,177974,177977,0,3,4
50961,3,3,177977,177977,177980,0,3,0
50962,2,1,177979,177980,177981,1,2,0
50963,6,3,177985,177985,177988,0,3,4
50964,3,3,177988,177988,177991,0,3,0
50965,3,2,177991,177991,177993,0,2,0
50966,1,1,177992,177993,177994,1,2,0
50967,1,1,177993,177994,177995,1,2,0
50968,5,2,177998,177998,178000,0,2,3
50969,6,2,178004,178004,178006,0,2,4
50970,3,1,178007,178007,178008,0,1,1
50971,5,3,178012,178012,178015,0,3,4
50972,3,3,178015,178015,178018,0,3,0
50973,2,2,178017,178018,178020,1,3,0
50974,5,1,178022,178022,178023,0,1,2
50975,5,1,178027,178027,178028,0,1,4
50976,1,1,178028,178028,178029,0,1,0
50977,2,2,178030,178030,178032,0,2,1
50978,3,3,178033,178033,178036,0,3,1
50979,2,3,178035,178036,178039,1,4,0
50980,3,1,178038,178039,178040,1,2,0
50981,1,2,178039,178040,178042,1,3,0
50982,3,2,178042,178042,178044,0,2,0
50983,2,2,178044,178044,178046,0,2,0
50984,3,3,178047,178047,178050,0,3,1
50985,4,1,178051,178051,178052,0,1,1
50986,1,2,178052,178052,178054,0,2,0
50987,4,3,178056,178056,178059,0,3,2
50988,3,1,178059,178059,178060,0,1,0
50989,6,2,178065,178065,178067,0,2,5
50990,1,3,178066,178067,178070,1,4,0
50991,6,1,178072,178072,178073,0,1,2
50992,6,2,178078,178078,178080,0,2,5
50993,2,2,178080,178080,178082,0,2,0
50994,1,1,178081,178082,178083,1,2,0
50995,4,1,178085,178085,178086,0,1,2
50996,2,1,178087,178087,178088,0,1,1
50997,1,1,178088,178088,178089,0,1,0
50998,1,2,178089,178089,178091,0,2,0
50999,2,3,178091,178091,178094,0,3,0
51000,2,1,178093,178094,178095,1,2,0
51001,5,2,178098,178098,178100,0,2,3
51002,2,3,178100,178100,178103,0,3,0
51003,4,1,178104,178104,178105,0,1,1
51004,1,3,178105,178105,178108,0,3,0
51005,4,1,178109,178109,178110,0,1,1
51006,4,1,178113,178113,178114,0,1,3
51007,5,2,178118,178118,178120,0,2,4
51008,6,2,178124,178124,178126,0,2,4
51009,1,2,178125,178126,178128,1,3,0
51010,2,1,178127,178128,178129,1,2,0
51011,6,3,178133,178133,178136,0,3,4
51012,1,1,178134,178136,178137,2,3,0
51013,1,3,178135,178137,178140,2,5,0
51014,5,1,178140,178140,178141,0,1,0
51015,3,3,178143,178143,178146,0,3,2
51016,1,2,178144,178146,178148,2,4,0
51017,4,2,178148,178148,178150,0,2,0
51018,6,1,178154,178154,178155,0,1,4
51019,2,1,178156,178156,178157,0,1,1
51020,3,1,178159,178159,178160,0,1,2
51021,3,3,178162,178162,178165,0,3,2
51022,2,1,178164,178165,178166,1,2,0
51023,4,2,178168,178168,178170,0,2,2
51024,4,1,178172,178172,178173,0,1,2
51025,5,2,178177,178177,178179,0,2,4
51026,4,3,178181,178181,178184,0,3,2
51027,5,2,178186,178186,178188,0,2,2
51028,4,1,178190,178190,178191,0,1,2
51029,1,2,178191,178191,178193,0,2,0
51030,6,1,178197,178197,178198,0,1,4
51031,5,1,178202,178202,178203,0,1,4
51032,4,2,178206,178206,178208,0,2,3
51033,3,3,178209,178209,178212,0,3,1
51034,1,1,178210,178212,178213,2,3,0
51035,5,2,178215,178215,178217,0,2,2
51036,6,1,178221,178221,178222,0,1,4
51037,2,1,178223,178223,178224,0,1,1
51038,4,2,178227,178227,178229,0,2,3
51039,4,2,178231,178231,178233,0,2,2
51040,1,3,178232,178233,178236,1,4,0
51041,4,2,178236,178236,178238,0,2,0
51042,1,1,178237,178238,178239,1,2,0
51043,6,2,178243,178243,178245,0,2,4
51044,3,3,178246,178246,178249,0,3,1
51045,6,1,178252,178252,178253,0,1,3
51046,4,1,178256,178256,178257,0,1,3
51047,1,3,178257,178257,178260,0,3,0
51048,6,1,178263,178263,178264,0,1,3
51049,4,1,178267,178267,178268,0,1,3
51050,2,1,178269,178269,178270,0,1,1
51051,4,2,178273,178273,178275,0,2,3
51052,6,3,178279,178279,178282,0,3,4
51053,6,3,178285,178285,178288,0,3,3
51054,4,1,178289,178289,178290,0,1,1
51055,5,2,178294,178294,178296,0,2,4
51056,4,2,178298,178298,178300,0,2,2
51057,6,3,178304,178304,178307,0,3,4
51058,2,1,178306,178307,178308,1,2,0
51059,6,1,178312,178312,178313,0,1,4
51060,5,3,178317,178317,178320,0,3,4
51061,4,3,178321,178321,178324,0,3,1
51062,3,2,178324,178324,178326,0,2,0
51063,4,3,178328,178328,178331,0,3,2
51064,3,1,178331,178331,178332,0,1,0
51065,5,3,178336,178336,178339,0,3,4
51066,6,3,178342,178342,178345,0,3,3
51067,2,2,178344,178345,178347,1,3,0
51068,3,3,178347,178347,178350,0,3,0
51069,3,3,178350,178350,178353,0,3,0
51070,2,1,178352,178353,178354,1,2,0
51071,4,1,178356,178356,178357,0,1,2
51072,2,1,178358,178358,178359,0,1,1
51073,5,2,178363,178363,178365,0,2,4
51074,4,2,178367,178367,178369,0,2,2
51075,3,1,178370,178370,178371,0,1,1
51076,1,3,178371,178371,178374,0,3,0
51077,3,2,178374,178374,178376,0,2,0
51078,6,2,178380,178380,178382,0,2,4
51079,5,2,178385,178385,178387,0,2,3
51080,3,1,178388,178388,178389,0,1,1
51081,6,1,178394,178394,178395,0,1,5
51082,2,1,178396,178396,178397,0,1,1
51083,3,1,178399,178399,178400,0,1,2
51084,3,2,178402,178402,178404,0,2,2
51085,3,1,178405,178405,178406,0,1,1
51086,2,3,178407,178407,178410,0,3,1
51087,5,2,178412,178412,178414,0,2,2
51088,1,2,178413,178414,178416,1,3,0
51089,2,1,178415,178416,178417,1,2,0
51090,4,3,178419,178419,178422,0,3,2
51091,1,1,178420,178422,178423,2,3,0
51092,4,1,178424,178424,178425,0,1,1
51093,4,2,178428,178428,178430,0,2,3
51094,4,3,178432,178432,178435,0,3,2
51095,3,3,178435,178435,178438,0,3,0
51096,3,1,178438,178438,178439,0,1,0
51097,3,3,178441,178441,178444,0,3,2
51098,1,3,178442,178444,178447,2,5,0
51099,3,1,178445,178447,178448,2,3,0
51100,5,2,178450,178450,178452,0,2,2
51101,4,1,178454,178454,178455,0,1,2
51102,2,1,178456,178456,178457,0,1,1
51103,1,3,178457,178457,178460,0,3,0
51104,5,3,178462,178462,178465,0,3,2
51105,4,1,178466,178466,178467,0,1,1
51106,6,3,178472,178472,178475,0,3,5
51107,5,3,178477,178477,178480,0,3,2
51108,2,1,178479,178480,178481,1,2,0
51109,3,2,178482,178482,178484,0,2,1
51110,6,1,178488,178488,178489,0,1,4
51111,4,1,178492,178492,178493,0,1,3
51112,5,1,178497,178497,178498,0,1,4
51113,4,1,178501,178501,178502,0,1,3
51114,2,3,178503,178503,178506,0,3,1
51115,5,1,178508,178508,178509,0,1,2
51116,3,2,178511,178511,178513,0,2,2
51117,4,2,178515,178515,178517,0,2,2
51118,1,2,178516,178517,178519,1,3,0
51119,6,3,178522,178522,178525,0,3,3
51120,5,3,178527,178527,178530,0,3,2
51121,6,2,178533,178533,178535,0,2,3
51122,3,3,178536,178536,178539,0,3,1
51123,1,3,178537,178539,178542,2,5,0
51124,2,3,178539,178542,178545,3,6,0
51125,1,2,178540,178545,178547,5,7,0
51126,4,1,178544,178547,178548,3,4,0
51127,5,2,178549,178549,178551,0,2,1
51128,2,3,178551,178551,178554,0,3,0
51129,1,2,178552,178554,178556,2,4,0
51130,4,2,178556,178556,178558,0,2,0
51131,2,1,178558,178558,178559,0,1,0
51132,1,2,178559,178559,178561,0,2,0
51133,5,2,178564,178564,178566,0,2,3
51134,6,3,178570,178570,178573,0,3,4
51135,3,1,178573,178573,178574,0,1,0
51136,2,2,178575,178575,178577,0,2,1
51137,6,3,178581,178581,178584,0,3,4
51138,6,2,178587,178587,178589,0,2,3
51139,3,3,178590,178590,178593,0,3,1
51140,1,3,178591,178593,178596,2,5,0
51141,2,3,178593,178596,178599,3,6,0
51142,1,3,178594,178599,178602,5,8,0
51143,4,3,178598,178602,178605,4,7,0
51144,6,2,178604,178605,178607,1,3,0
51145,3,1,178607,178607,178608,0,1,0
51146,1,3,178608,178608,178611,0,3,0
51147,5,2,178613,178613,178615,0,2,2
51148,6,2,178619,178619,178621,0,2,4
51149,3,2,178622,178622,178624,0,2,1
51150,2,2,178624,178624,178626,0,2,0
51151,3,3,178627,178627,178630,0,3,1
51152,5,1,178632,178632,178633,0,1,2
51153,5,1,178637,178637,178638,0,1,4
51154,2,2,178639,178639,178641,0,2,1
51155,6,1,178645,178645,178646,0,1,4
51156,2,3,178647,178647,178650,0,3,1
51157,3,2,178650,178650,178652,0,2,0
51158,3,2,178653,178653,178655,0,2,1
51159,2,2,178655,178655,178657,0,2,0
51160,2,3,178657,178657,178660,0,3,0
51161,1,1,178658,178660,178661,2,3,0
51162,4,2,178662,178662,178664,0,2,1
51163,2,2,178664,178664,178666,0,2,0
51164,4,3,178668,178668,178671,0,3,2
51165,2,3,178670,178671,178674,1,4,0
51166,4,1,178674,178674,178675,0,1,0
51167,2,3,178676,178676,178679,0,3,1
51168,4,1,178680,178680,178681,0,1,1
51169,6,2,178686,178686,178688,0,2,5
51170,2,2,178688,178688,178690,0,2,0
51171,3,1,178691,178691,178692,0,1,1
51172,4,2,178695,178695,178697,0,2,3
51173,4,2,178699,178699,178701,0,2,2
51174,6,2,178705,178705,178707,0,2,4
51175,2,1,178707,178707,178708,0,1,0
51176,2,3,178709,178709,178712,0,3,1
51177,2,1,178711,178712,178713,1,2,0
51178,3,3,178714,178714,178717,0,3,1
51179,6,2,178720,178720,178722,0,2,3
51180,6,3,178726,178726,178729,0,3,4
51181,6,3,178732,178732,178735,0,3,3
51182,3,3,178735,178735,178738,0,3,0
51183,4,1,178739,178739,178740,0,1,1
51184,2,3,178741,178741,178744,0,3,1
51185,4,2,178745,178745,178747,0,2,1
51186,1,1,178746,178747,178748,1,2,0
51187,4,3,178750,178750,178753,0,3,2
51188,2,3,178752,178753,178756,1,4,0
51189,5,1,178757,178757,178758,0,1,1
51190,5,2,178762,178762,178764,0,2,4
51191,4,3,178766,178766,178769,0,3,2
51192,5,2,178771,178771,178773,0,2,2
51193,2,3,178773,178773,178776,0,3,0
51194,5,3,178778,178778,178781,0,3,2
51195,1,1,178779,178781,178782,2,3,0
51196,3,2,178782,178782,178784,0,2,0
51197,1,3,178783,178784,178787,1,4,0
51198,1,2,178784,178787,178789,3,5,0
51199,2,1,178786,178789,178790,3,4,0
51200,5,2,178791,178791,178793,0,2,1
51201,4,2,178795,178795,178797,0,2,2
51202,4,1,178799,178799,178800,0,1,2
51203,2,1,178801,178801,178802,0,1,1
51204,4,2,178805,178805,178807,0,2,3
51205,1,2,178806,178807,178809,1,3,0
51206,5,2,178811,178811,178813,0,2,2
51207,4,3,178815,178815,178818,0,3,2
51208,6,3,178821,178821,178824,0,3,3
51209,5,1,178826,178826,178827,0,1,2
51210,5,2,178831,178831,178833,0,2,4
51211,4,1,178835,178835,178836,0,1,2
51212,1,2,178836,178836,178838,0,2,0
51213,1,3,178837,178838,178841,1,4,0
51214,3,2,178840,178841,178843,1,3,0
51215,1,2,178841,178843,178845,2,4,0
51216,6,1,178847,178847,178848,0,1,2
51217,6,1,178853,178853,178854,0,1,5
51218,4,1,178857,178857,178858,0,1,3
51219,2,3,178859,178859,178862,0,3,1
51220,2,1,178861,178862,178863,1,2,0
51221,6,3,178867,178867,178870,0,3,4
51222,5,1,178872,178872,178873,0,1,2
51223,6,1,178878,178878,178879,0,1,5
51224,3,2,178881,178881,178883,0,2,2
51225,6,3,178887,178887,178890,0,3,4
51226,6,3,178893,178893,178896,0,3,3
51227,6,3,178899,178899,178902,0,3,3
51228,3,2,178902,178902,178904,0,2,0
51229,3,1,178905,178905,178906,0,1,1
51230,3,1,178908,178908,178909,0,1,2
51231,2,2,178910,178910,178912,0,2,1
51232,5,2,178915,178915,178917,0,2,3
51233,3,2,178918,178918,178920,0,2,1
51234,5,2,178923,178923,178925,0,2,3
51235,1,1,178924,178925,178926,1,2,0
51236,1,2,178925,178926,178928,1,3,0
51237,3,3,178928,178928,178931,0,3,0
51238,2,1,178930,178931,178932,1,2,0
51239,6,2,178936,178936,178938,0,2,4
51240,1,2,178937,178938,178940,1,3,0
51241,3,2,178940,178940,178942,0,2,0
51242,3,2,178943,178943,178945,0,2,1
51243,2,2,178945,178945,178947,0,2,0
51244,3,1,178948,178948,178949,0,1,1
51245,6,1,178954,178954,178955,0,1,5
51246,1,3,178955,178955,178958,0,3,0
51247,5,3,178960,178960,178963,0,3,2
51248,1,2,178961,178963,178965,2,4,0
51249,3,2,178964,178965,178967,1,3,0
51250,6,2,178970,178970,178972,0,2,3
51251,5,2,178975,178975,178977,0,2,3
51252,4,1,178979,178979,178980,0,1,2
51253,1,2,178980,178980,178982,0,2,0
51254,1,3,178981,178982,178985,1,4,0
51255,5,3,178986,178986,178989,0,3,1
51256,1,3,178987,178989,178992,2,5,0
51257,6,1,178993,178993,178994,0,1,1
51258,4,1,178997,178997,178998,0,1,3
51259,1,1,178998,178998,178999,0,1,0
51260,3,1,179001,179001,179002,0,1,2
51261,5,1,179006,179006,179007,0,1,4
51262,2,2,179008,179008,179010,0,2,1
51263,6,2,179014,179014,179016,0,2,4
51264,2,3,179016,179016,179019,0,3,0
51265,5,3,179021,179021,179024,0,3,2
51266,5,1,179026,179026,179027,0,1,2
51267,2,3,179028,179028,179031,0,3,1
51268,1,1,179029,179031,179032,2,3,0
51269,5,1,179034,179034,179035,0,1,2
51270,2,2,179036,179036,179038,0,2,1
51271,5,1,179041,179041,179042,0,1,3
51272,5,3,179046,179046,179049,0,3,4
51273,1,2,179047,179049,179051,2,4,0
51274,6,1,179053,179053,179054,0,1,2
51275,1,1,179054,179054,179055,0,1,0
51276,1,1,179055,179055,179056,0,1,0
51277,2,1,179057,179057,179058,0,1,1
51278,4,1,179061,179061,179062,0,1,3
51279,2,3,179063,179063,179066,0,3,1
51280,6,2,179069,179069,179071,0,2,3
51281,2,2,179071,179071,179073,0,2,0
51282,5,2,179076,179076,179078,0,2,3
51283,2,3,179078,179078,179081,0,3,0
51284,5,2,179083,179083,179085,0,2,2
51285,5,1,179088,179088,179089,0,1,3
51286,1,2,179089,179089,179091,0,2,0
51287,4,1,179093,179093,179094,0,1,2
51288,5,2,179098,179098,179100,0,2,4
51289,3,3,179101,179101,179104,0,3,1
51290,3,3,179104,179104,179107,0,3,0
51291,4,1,179108,179108,179109,0,1,1
51292,1,3,179109,179109,179112,0,3,0
51293,5,1,179114,179114,179115,0,1,2
51294,1,2,179115,179115,179117,0,2,0
51295,5,2,179120,179120,179122,0,2,3
51296,4,3,179124,179124,179127,0,3,2
51297,4,1,179128,179128,179129,0,1,1
51298,2,3,179130,179130,179133,0,3,1
51299,5,3,179135,179135,179138,0,3,2
51300,5,2,179140,179140,179142,0,2,2
51301,6,2,179146,179146,179148,0,2,4
51302,3,2,179149,179149,179151,0,2,1
51303,3,3,179152,179152,179155,0,3,1
51304,3,2,179155,179155,179157,0,2,0
51305,4,1,179159,179159,179160,0,1,2
51306,6,1,179165,179165,179166,0,1,5
51307,6,2,179171,179171,179173,0,2,5
51308,5,2,179176,179176,179178,0,2,3
51309,1,1,179177,179178,179179,1,2,0
51310,5,2,179182,179182,179184,0,2,3
51311,6,3,179188,179188,179191,0,3,4
51312,5,1,179193,179193,179194,0,1,2
51313,6,2,179199,179199,179201,0,2,5
51314,4,2,179203,179203,179205,0,2,2
51315,1,3,179204,179205,179208,1,4,0
51316,3,2,179207,179208,179210,1,3,0
51317,1,1,179208,179210,179211,2,3,0
51318,4,3,179212,179212,179215,0,3,1
51319,1,1,179213,179215,179216,2,3,0
51320,1,1,179214,179216,179217,2,3,0
51321,6,3,179220,179220,179223,0,3,3
51322,1,2,179221,179223,179225,2,4,0
51323,4,1,179225,179225,179226,0,1,0
51324,6,2,179231,179231,179233,0,2,5
51325,4,1,179235,179235,179236,0,1,2
51326,5,3,179240,179240,179243,0,3,4
51327,6,3,179246,179246,179249,0,3,3
51328,3,1,179249,179249,179250,0,1,0
51329,6,3,179255,179255,179258,0,3,5
51330,6,2,179261,179261,179263,0,2,3
51331,1,1,179262,179263,179264,1,2,0
51332,5,3,179267,179267,179270,0,3,3
51333,5,3,179272,179272,179275,0,3,2
51334,1,1,179273,179275,179276,2,3,0
51335,4,1,179277,179277,179278,0,1,1
51336,3,1,179280,179280,179281,0,1,2
51337,2,1,179282,179282,179283,0,1,1
51338,4,1,179286,179286,179287,0,1,3
51339,2,2,179288,179288,179290,0,2,1
51340,1,3,179289,179290,179293,1,4,0
51341,1,3,179290,179293,179296,3,6,0
51342,3,3,179293,179296,179299,3,6,0
51343,5,2,179298,179299,179301,1,3,0
51344,5,1,179303,179303,179304,0,1,2
51345,1,1,179304,179304,179305,0,1,0
51346,1,1,179305,179305,179306,0,1,0
51347,5,1,179310,179310,179311,0,1,4
51348,2,1,179312,179312,179313,0,1,1
51349,1,1,179313,179313,179314,0,1,0
51350,1,1,179314,179314,179315,0,1,0
51351,6,3,179320,179320,179323,0,3,5
51352,3,2,179323,179323,179325,0,2,0
51353,4,1,179327,179327,179328,0,1,2
51354,6,1,179333,179333,179334,0,1,5
51355,3,1,179336,179336,179337,0,1,2
51356,4,3,179340,179340,179343,0,3,3
51357,3,1,179343,179343,179344,0,1,0
51358,1,2,179344,179344,179346,0,2,0
51359,3,3,179347,179347,179350,0,3,1
51360,3,1,179350,179350,179351,0,1,0
51361,3,3,179353,179353,179356,0,3,2
51362,3,3,179356,179356,179359,0,3,0
51363,5,3,179361,179361,179364,0,3,2
51364,5,2,179366,179366,179368,0,2,2
51365,3,3,179369,179369,179372,0,3,1
51366,1,3,179370,179372,179375,2,5,0
51367,2,1,179372,179375,179376,3,4,0
51368,2,3,179374,179376,179379,2,5,0
51369,1,2,179375,179379,179381,4,6,0
51370,4,2,179379,179381,179383,2,4,0
51371,4,3,179383,179383,179386,0,3,0
51372,4,2,179387,179387,179389,0,2,1
51373,1,2,179388,179389,179391,1,3,0
51374,3,3,179391,179391,179394,0,3,0
51375,5,2,179396,179396,179398,0,2,2
51376,5,3,179401,179401,179404,0,3,3
51377,3,3,179404,179404,179407,0,3,0
51378,1,1,179405,179407,179408,2,3,0
51379,6,1,179411,179411,179412,0,1,3
51380,5,2,179416,179416,179418,0,2,4
51381,1,2,179417,179418,179420,1,3,0
51382,2,3,179419,179420,179423,1,4,0
51383,4,1,179423,179423,179424,0,1,0
51384,3,1,179426,179426,179427,0,1,2
51385,6,3,179432,179432,179435,0,3,5
51386,2,2,179434,179435,179437,1,3,0
51387,1,1,179435,179437,179438,2,3,0
51388,1,2,179436,179438,179440,2,4,0
51389,4,3,179440,179440,179443,0,3,0
51390,5,2,179445,179445,179447,0,2,2
51391,2,2,179447,179447,179449,0,2,0
51392,3,3,179450,179450,179453,0,3,1
51393,2,1,179452,179453,179454,1,2,0
51394,4,1,179456,179456,179457,0,1,2
51395,2,3,179458,179458,179461,0,3,1
51396,1,2,179459,179461,179463,2,4,0
51397,2,1,179461,179463,179464,2,3,0
51398,1,1,179462,179464,179465,2,3,0
51399,2,1,179464,179465,179466,1,2,0
51400,6,1,179470,179470,179471,0,1,4
51401,4,2,179474,179474,179476,0,2,3
51402,2,2,179476,179476,179478,0,2,0
51403,1,2,179477,179478,179480,1,3,0
51404,1,1,179478,179480,179481,2,3,0
51405,6,3,179484,179484,179487,0,3,3
51406,3,1,179487,179487,179488,0,1,0
51407,1,1,179488,179488,179489,0,1,0
51408,1,2,179489,179489,179491,0,2,0
51409,5,3,179494,179494,179497,0,3,3
51410,3,1,179497,179497,179498,0,1,0
51411,4,1,179501,179501,179502,0,1,3
51412,5,2,179506,179506,179508,0,2,4
51413,4,1,179510,179510,179511,0,1,2
51414,4,1,179514,179514,179515,0,1,3
51415,2,3,179516,179516,179519,0,3,1
51416,1,2,179517,179519,179521,2,4,0
51417,6,3,179523,179523,179526,0,3,2
51418,3,2,179526,179526,179528,0,2,0
51419,2,3,179528,179528,179531,0,3,0
51420,4,3,179532,179532,179535,0,3,1
51421,6,2,179538,179538,179540,0,2,3
51422,3,2,179541,179541,179543,0,2,1
51423,5,3,179546,179546,179549,0,3,3
51424,1,1,179547,179549,179550,2,3,0
51425,2,1,179549,179550,179551,1,2,0
51426,4,3,179553,179553,179556,0,3,2
51427,2,2,179555,179556,179558,1,3,0
51428,2,1,179557,179558,179559,1,2,0
51429,4,2,179561,179561,179563,0,2,2
51430,6,3,179567,179567,179570,0,3,4
51431,3,3,179570,179570,179573,0,3,0
51432,3,2,179573,179573,179575,0,2,0
51433,6,2,179579,179579,179581,0,2,4
51434,6,3,179585,179585,179588,0,3,4
51435,5,3,179590,179590,179593,0,3,2
51436,3,3,179593,179593,179596,0,3,0
51437,1,3,179594,179596,179599,2,5,0
51438,4,1,179598,179599,179600,1,2,0
51439,2,3,179600,179600,179603,0,3,0
51440,4,2,179604,179604,179606,0,2,1
51441,2,2,179606,179606,179608,0,2,0
51442,5,2,179611,179611,179613,0,2,3
51443,6,3,179617,179617,179620,0,3,4
51444,5,1,179622,179622,179623,0,1,2
51445,1,2,179623,179623,179625,0,2,0
51446,3,1,179626,179626,179627,0,1,1
51447,2,1,179628,179628,179629,0,1,1
51448,5,3,179633,179633,179636,0,3,4
51449,3,1,179636,179636,179637,0,1,0
51450,1,1,179637,179637,179638,0,1,0
51451,6,1,179643,179643,179644,0,1,5
51452,2,2,179645,179645,179647,0,2,1
51453,6,1,179651,179651,179652,0,1,4
51454,5,2,179656,179656,179658,0,2,4
51455,6,2,179662,179662,179664,0,2,4
51456,2,3,179664,179664,179667,0,3,0
51457,6,1,179670,179670,179671,0,1,3
51458,1,2,179671,179671,179673,0,2,0
51459,4,1,179675,179675,179676,0,1,2
51460,2,3,179677,179677,179680,0,3,1
51461,3,3,179680,179680,179683,0,3,0
51462,6,2,179686,179686,179688,0,2,3
51463,4,2,179690,179690,179692,0,2,2
51464,3,1,179693,179693,179694,0,1,1
51465,5,2,179698,179698,179700,0,2,4
51466,1,3,179699,179700,179703,1,4,0
51467,3,2,179702,179703,179705,1,3,0
51468,2,1,179704,179705,179706,1,2,0
51469,3,3,179707,179707,179710,0,3,1
51470,3,2,179710,179710,179712,0,2,0
51471,4,2,179714,179714,179716,0,2,2
51472,5,3,179719,179719,179722,0,3,3
51473,5,1,179724,179724,179725,0,1,2
51474,6,2,179730,179730,179732,0,2,5
51475,4,2,179734,179734,179736,0,2,2
51476,4,1,179738,179738,179739,0,1,2
51477,5,1,179743,179743,179744,0,1,4
51478,5,3,179748,179748,179751,0,3,4
51479,5,3,179753,179753,179756,0,3,2
51480,3,2,179756,179756,179758,0,2,0
51481,4,2,179760,179760,179762,0,2,2
51482,1,2,179761,179762,179764,1,3,0
51483,5,3,179766,179766,179769,0,3,2
51484,4,2,179770,179770,179772,0,2,1
51485,5,1,179775,179775,179776,0,1,3
51486,1,2,179776,179776,179778,0,2,0
51487,5,3,179781,179781,179784,0,3,3
51488,5,3,179786,179786,179789,0,3,2
51489,3,1,179789,179789,179790,0,1,0
51490,1,2,179790,179790,179792,0,2,0
51491,5,3,179795,179795,179798,0,3,3
51492,1,3,179796,179798,179801,2,5,0
51493,6,3,179802,179802,179805,0,3,1
51494,3,1,179805,179805,179806,0,1,0
51495,6,3,179811,179811,179814,0,3,5
51496,5,1,179816,179816,179817,0,1,2
51497,6,3,179822,179822,179825,0,3,5
51498,6,2,179828,179828,179830,0,2,3
51499,1,1,179829,179830,179831,1,2,0
51500,6,1,179835,179835,179836,0,1,4
51501,4,1,179839,179839,179840,0,1,3
51502,5,2,179844,179844,179846,0,2,4
51503,6,1,179850,179850,179851,0,1,4
51504,2,3,179852,179852,179855,0,3,1
51505,1,2,179853,179855,179857,2,4,0
51506,1,3,179854,179857,179860,3,6,0
51507,1,2,179855,179860,179862,5,7,0
51508,1,2,179856,179862,179864,6,8,0
51509,2,1,179858,179864,179865,6,7,0
51510,3,3,179861,179865,179868,4,7,0
51511,5,3,179866,179868,179871,2,5,0
51512,2,2,179868,179871,179873,3,5,0
51513,2,2,179870,179873,179875,3,5,0
51514,1,2,179871,179875,179877,4,6,0
51515,2,3,179873,179877,179880,4,7,0
51516,4,2,179877,179880,179882,3,5,0
51517,3,1,179880,179882,179883,2,3,0
51518,6,2,179886,179886,179888,0,2,3
51519,4,3,179890,179890,179893,0,3,2
51520,1,2,179891,179893,179895,2,4,0
51521,1,1,179892,179895,179896,3,4,0
51522,4,1,179896,179896,179897,0,1,0
51523,3,2,179899,179899,179901,0,2,2
51524,6,1,179905,179905,179906,0,1,4
51525,2,1,179907,179907,179908,0,1,1
51526,3,3,179910,179910,179913,0,3,2
51527,2,2,179912,179913,179915,1,3,0
51528,4,1,179916,179916,179917,0,1,1
51529,4,1,179920,179920,179921,0,1,3
51530,2,3,179922,179922,179925,0,3,1
51531,4,1,179926,179926,179927,0,1,1
51532,5,2,179931,179931,179933,0,2,4
51533,4,2,179935,179935,179937,0,2,2
51534,5,1,179940,179940,179941,0,1,3
51535,4,2,179944,179944,179946,0,2,3
51536,1,2,179945,179946,179948,1,3,0
51537,4,2,179949,179949,179951,0,2,1
51538,4,3,179953,179953,179956,0,3,2
51539,3,2,179956,179956,179958,0,2,0
51540,2,1,179958,179958,179959,0,1,0
51541,3,1,179961,179961,179962,0,1,2
51542,1,1,179962,179962,179963,0,1,0
51543,4,1,179966,179966,179967,0,1,3
51544,2,2,179968,179968,179970,0,2,1
51545,6,3,179974,179974,179977,0,3,4
51546,6,2,179980,179980,179982,0,2,3
51547,3,3,179983,179983,179986,0,3,1
51548,6,2,179989,179989,179991,0,2,3
51549,4,2,179993,179993,179995,0,2,2
51550,3,2,179996,179996,179998,0,2,1
51551,3,3,179999,179999,180002,0,3,1
51552,3,3,180002,180002,180005,0,3,0
51553,3,1,180005,180005,180006,0,1,0
51554,1,3,180006,180006,180009,0,3,0
51555,3,2,180009,180009,180011,0,2,0
51556,6,1,180015,180015,180016,0,1,4
51557,4,1,180019,180019,180020,0,1,3
51558,5,3,180024,180024,180027,0,3,4
51559,3,1,180027,180027,180028,0,1,0
51560,6,2,180033,180033,180035,0,2,5
51561,6,1,180039,180039,180040,0,1,4
51562,2,2,180041,180041,180043,0,2,1
51563,1,2,180042,180043,180045,1,3,0
51564,2,1,180044,180045,180046,1,2,0
51565,3,3,180047,180047,180050,0,3,1
51566,5,3,180052,180052,180055,0,3,2
51567,5,2,180057,180057,180059,0,2,2
51568,6,2,180063,180063,180065,0,2,4
51569,4,2,180067,180067,180069,0,2,2
51570,3,1,180070,180070,180071,0,1,1
51571,2,2,180072,180072,180074,0,2,1
51572,5,1,180077,180077,180078,0,1,3
51573,1,1,180078,180078,180079,0,1,0
51574,2,2,180080,180080,180082,0,2,1
51575,2,3,180082,180082,180085,0,3,0
51576,6,3,180088,180088,180091,0,3,3
51577,1,2,180089,180091,180093,2,4,0
51578,2,1,180091,180093,180094,2,3,0
51579,4,3,180095,180095,180098,0,3,1
51580,1,3,180096,180098,180101,2,5,0
51581,4,2,180100,180101,180103,1,3,0
51582,2,2,180102,180103,180105,1,3,0
51583,6,2,180108,180108,180110,0,2,3
51584,5,1,180113,180113,180114,0,1,3
51585,6,1,180119,180119,180120,0,1,5
51586,1,1,180120,180120,180121,0,1,0
51587,1,2,180121,180121,180123,0,2,0
51588,1,2,180122,180123,180125,1,3,0
51589,1,1,180123,180125,180126,2,3,0
51590,5,3,180128,180128,180131,0,3,2
51591,3,1,180131,180131,180132,0,1,0
51592,4,1,180135,180135,180136,0,1,3
51593,4,2,180139,180139,180141,0,2,3
51594,3,1,180142,180142,180143,0,1,1
51595,6,1,180148,180148,180149,0,1,5
51596,2,2,180150,180150,180152,0,2,1
51597,5,1,180155,180155,180156,0,1,3
51598,3,2,180158,180158,180160,0,2,2
51599,6,2,180164,180164,180166,0,2,4
51600,4,1,180168,180168,180169,0,1,2
51601,3,2,180171,180171,180173,0,2,2
51602,2,2,180173,180173,180175,0,2,0
51603,6,3,180179,180179,180182,0,3,4
51604,6,3,180185,180185,180188,0,3,3
51605,5,2,180190,180190,180192,0,2,2
51606,3,3,180193,180193,180196,0,3,1
51607,2,3,180195,180196,180199,1,4,0
51608,6,3,180201,180201,180204,0,3,2
51609,3,2,180204,180204,180206,0,2,0
51610,3,3,180207,180207,180210,0,3,1
51611,6,2,180213,180213,180215,0,2,3
51612,3,3,180216,180216,180219,0,3,1
51613,1,1,180217,180219,180220,2,3,0
51614,6,3,180223,180223,180226,0,3,3
51615,5,1,180228,180228,180229,0,1,2
51616,6,1,180234,180234,180235,0,1,5
51617,5,2,180239,180239,180241,0,2,4
51618,2,3,180241,180241,180244,0,3,0
51619,2,1,180243,180244,180245,1,2,0
51620,5,3,180248,180248,180251,0,3,3
51621,1,2,180249,180251,180253,2,4,0
51622,5,1,180254,180254,180255,0,1,1
51623,1,3,180255,180255,180258,0,3,0
51624,3,3,180258,180258,180261,0,3,0
51625,5,2,180263,180263,180265,0,2,2
51626,1,1,180264,180265,180266,1,2,0
51627,2,2,180266,180266,180268,0,2,0
51628,5,3,180271,180271,180274,0,3,3
51629,6,2,180277,180277,180279,0,2,3
51630,2,3,180279,180279,180282,0,3,0
51631,2,1,180281,180282,180283,1,2,0
51632,4,2,180285,180285,180287,0,2,2
51633,4,2,180289,180289,180291,0,2,2
51634,3,3,180292,180292,180295,0,3,1
51635,3,1,180295,180295,180296,0,1,0
51636,5,1,180300,180300,180301,0,1,4
51637,2,1,180302,180302,180303,0,1,1
51638,1,1,180303,180303,180304,0,1,0
51639,1,2,180304,180304,180306,0,2,0
51640,6,1,180310,180310,180311,0,1,4
51641,1,1,180311,180311,180312,0,1,0
51642,1,1,180312,180312,180313,0,1,0
51643,3,1,180315,180315,180316,0,1,2
51644,6,2,180321,180321,180323,0,2,5
51645,4,3,180325,180325,180328,0,3,2
51646,2,3,180327,180328,180331,1,4,0
51647,3,3,180330,180331,180334,1,4,0
51648,4,3,180334,180334,180337,0,3,0
51649,4,1,180338,180338,180339,0,1,1
51650,5,3,180343,180343,180346,0,3,4
51651,3,1,180346,180346,180347,0,1,0
51652,1,2,180347,180347,180349,0,2,0
51653,5,2,180352,180352,180354,0,2,3
51654,1,1,180353,180354,180355,1,2,0
51655,1,1,180354,180355,180356,1,2,0
51656,3,3,180357,180357,180360,0,3,1
51657,5,3,180362,180362,180365,0,3,2
51658,4,1,180366,180366,180367,0,1,1
51659,4,2,180370,180370,180372,0,2,3
51660,2,1,180372,180372,180373,0,1,0
51661,2,3,180374,180374,180377,0,3,1
51662,5,2,180379,180379,180381,0,2,2
51663,6,3,180385,180385,180388,0,3,4
51664,3,3,180388,180388,180391,0,3,0
51665,2,1,180390,180391,180392,1,2,0
51666,1,1,180391,180392,180393,1,2,0
51667,1,1,180392,180393,180394,1,2,0
51668,6,2,180398,180398,180400,0,2,4
51669,4,3,180402,180402,180405,0,3,2
51670,1,2,180403,180405,180407,2,4,0
51671,3,3,180406,180407,180410,1,4,0
51672,2,1,180408,180410,180411,2,3,0
51673,5,3,180413,180413,180416,0,3,2
51674,2,2,180415,180416,180418,1,3,0
51675,2,3,180417,180418,180421,1,4,0
51676,3,2,180420,180421,180423,1,3,0
51677,3,1,180423,180423,180424,0,1,0
51678,3,2,180426,180426,180428,0,2,2
51679,6,3,180432,180432,180435,0,3,4
51680,1,3,180433,180435,180438,2,5,0
51681,1,3,180434,180438,180441,4,7,0
51682,2,2,180436,180441,180443,5,7,0
51683,2,3,180438,180443,180446,5,8,0
51684,4,1,180442,180446,180447,4,5,0
51685,3,2,180445,180447,180449,2,4,0
51686,4,1,180449,180449,180450,0,1,0
51687,4,1,180453,180453,180454,0,1,3
51688,4,1,180457,180457,180458,0,1,3
51689,1,2,180458,180458,180460,0,2,0
51690,6,2,180464,180464,180466,0,2,4
51691,5,3,180469,180469,180472,0,3,3
51692,5,3,180474,180474,180477,0,3,2
51693,4,3,180478,180478,180481,0,3,1
51694,3,3,180481,180481,180484,0,3,0
51695,4,3,180485,180485,180488,0,3,1
51696,2,3,180487,180488,180491,1,4,0
51697,1,3,180488,180491,180494,3,6,0
51698,2,1,180490,180494,180495,4,5,0
51699,5,3,180495,180495,180498,0,3,0
51700,4,1,180499,180499,180500,0,1,1
51701,1,1,180500,180500,180501,0,1,0
51702,2,2,180502,180502,180504,0,2,1
51703,4,1,180506,180506,180507,0,1,2
51704,3,3,180509,180509,180512,0,3,2
51705,5,3,180514,180514,180517,0,3,2
51706,1,1,180515,180517,180518,2,3,0
51707,3,1,180518,180518,180519,0,1,0
51708,4,2,180522,180522,180524,0,2,3
51709,2,3,180524,180524,180527,0,3,0
51710,2,3,180526,180527,180530,1,4,0
51711,1,2,180527,180530,180532,3,5,0
51712,6,1,180533,180533,180534,0,1,1
51713,3,1,180536,180536,180537,0,1,2
51714,2,2,180538,180538,180540,0,2,1
51715,2,2,180540,180540,180542,0,2,0
51716,2,3,180542,180542,180545,0,3,0
51717,2,1,180544,180545,180546,1,2,0
51718,4,2,180548,180548,180550,0,2,2
51719,2,1,180550,180550,180551,0,1,0
51720,3,3,180553,180553,180556,0,3,2
51721,3,2,180556,180556,180558,0,2,0
51722,3,3,180559,180559,180562,0,3,1
51723,3,3,180562,180562,180565,0,3,0
51724,1,1,180563,180565,180566,2,3,0
51725,5,1,180568,180568,180569,0,1,2
51726,5,1,180573,180573,180574,0,1,4
51727,1,3,180574,180574,180577,0,3,0
51728,4,1,180578,180578,180579,0,1,1
51729,1,3,180579,180579,180582,0,3,0
51730,3,2,180582,180582,180584,0,2,0
51731,3,1,180585,180585,180586,0,1,1
51732,6,3,180591,180591,180594,0,3,5
51733,6,3,180597,180597,180600,0,3,3
51734,3,1,180600,180600,180601,0,1,0
51735,6,3,180606,180606,180609,0,3,5
51736,2,3,180608,180609,180612,1,4,0
51737,1,2,180609,180612,180614,3,5,0
51738,3,2,180612,180614,180616,2,4,0
51739,1,2,180613,180616,180618,3,5,0
51740,6,2,180619,180619,180621,0,2,1
51741,6,1,180625,180625,180626,0,1,4
51742,1,1,180626,180626,180627,0,1,0
51743,6,1,180632,180632,180633,0,1,5
51744,6,3,180638,180638,180641,0,3,5
51745,6,3,180644,180644,180647,0,3,3
51746,2,2,180646,180647,180649,1,3,0
51747,1,1,180647,180649,180650,2,3,0
51748,6,1,180653,180653,180654,0,1,3
51749,4,2,180657,180657,180659,0,2,3
51750,3,3,180660,180660,180663,0,3,1
51751,1,1,180661,180663,180664,2,3,0
51752,1,3,180662,180664,180667,2,5,0
51753,3,2,180665,180667,180669,2,4,0
51754,6,1,180671,180671,180672,0,1,2
51755,2,3,180673,180673,180676,0,3,1
51756,5,3,180678,180678,180681,0,3,2
51757,6,3,180684,180684,180687,0,3,3
51758,1,2,180685,180687,180689,2,4,0
51759,1,3,180686,180689,180692,3,6,0
51760,6,3,180692,180692,180695,0,3,0
51761,2,2,180694,180695,180697,1,3,0
51762,5,1,180699,180699,180700,0,1,2
51763,1,2,180700,180700,180702,0,2,0
51764,2,3,180702,180702,180705,0,3,0
51765,2,3,180704,180705,180708,1,4,0
51766,5,2,180709,180709,180711,0,2,1
51767,1,1,180710,180711,180712,1,2,0
51768,4,1,180714,180714,180715,0,1,2
51769,1,1,180715,180715,180716,0,1,0
51770,1,3,180716,180716,180719,0,3,0
51771,5,3,180721,180721,180724,0,3,2
51772,5,3,180726,180726,180729,0,3,2
51773,5,2,180731,180731,180733,0,2,2
51774,3,1,180734,180734,180735,0,1,1
51775,4,1,180738,180738,180739,0,1,3
51776,5,2,180743,180743,180745,0,2,4
51777,6,3,180749,180749,180752,0,3,4
51778,6,2,180755,180755,180757,0,2,3
51779,5,3,180760,180760,180763,0,3,3
51780,3,2,180763,180763,180765,0,2,0
51781,3,1,180766,180766,180767,0,1,1
51782,4,1,180770,180770,180771,0,1,3
51783,2,3,180772,180772,180775,0,3,1
51784,6,2,180778,180778,180780,0,2,3
51785,6,3,180784,180784,180787,0,3,4
51786,6,1,180790,180790,180791,0,1,3
51787,2,1,180792,180792,180793,0,1,1
51788,4,2,180796,180796,180798,0,2,3
51789,2,3,180798,180798,180801,0,3,0
51790,5,2,180803,180803,180805,0,2,2
51791,5,1,180808,180808,180809,0,1,3
51792,2,1,180810,180810,180811,0,1,1
51793,2,3,180812,180812,180815,0,3,1
51794,2,3,180814,180815,180818,1,4,0
51795,1,2,180815,180818,180820,3,5,0
51796,6,2,180821,180821,180823,0,2,1
51797,4,1,180825,180825,180826,0,1,2
51798,4,3,180829,180829,180832,0,3,3
51799,2,3,180831,180832,180835,1,4,0
51800,5,1,180836,180836,180837,0,1,1
51801,6,1,180842,180842,180843,0,1,5
51802,2,3,180844,180844,180847,0,3,1
51803,5,1,180849,180849,180850,0,1,2
51804,1,1,180850,180850,180851,0,1,0
51805,1,1,180851,180851,180852,0,1,0
51806,4,3,180855,180855,180858,0,3,3
51807,3,3,180858,180858,180861,0,3,0
51808,6,3,180864,180864,180867,0,3,3
51809,4,1,180868,180868,180869,0,1,1
51810,3,3,180871,180871,180874,0,3,2
51811,2,2,180873,180874,180876,1,3,0
51812,1,1,180874,180876,180877,2,3,0
51813,4,3,180878,180878,180881,0,3,1
51814,2,2,180880,180881,180883,1,3,0
51815,3,1,180883,180883,180884,0,1,0
51816,2,2,180885,180885,180887,0,2,1
51817,1,2,180886,180887,180889,1,3,0
51818,5,3,180891,180891,180894,0,3,2
51819,5,2,180896,180896,180898,0,2,2
51820,5,2,180901,180901,180903,0,2,3
51821,6,2,180907,180907,180909,0,2,4
51822,4,2,180911,180911,180913,0,2,2
51823,2,1,180913,180913,180914,0,1,0
51824,5,2,180918,180918,180920,0,2,4
51825,5,3,180923,180923,180926,0,3,3
51826,2,2,180925,180926,180928,1,3,0
51827,3,3,180928,180928,180931,0,3,0
51828,4,1,180932,180932,180933,0,1,1
51829,1,3,180933,180933,180936,0,3,0
51830,6,2,180939,180939,180941,0,2,3
51831,1,3,180940,180941,180944,1,4,0
51832,3,1,180943,180944,180945,1,2,0
51833,1,2,180944,180945,180947,1,3,0
51834,4,1,180948,180948,180949,0,1,1
51835,4,3,180952,180952,180955,0,3,3
51836,5,1,180957,180957,180958,0,1,2
51837,6,3,180963,180963,180966,0,3,5
51838,3,3,180966,180966,180969,0,3,0
51839,3,2,180969,180969,180971,0,2,0
51840,4,3,180973,180973,180976,0,3,2
51841,5,2,180978,180978,180980,0,2,2
51842,3,3,180981,180981,180984,0,3,1
51843,1,2,180982,180984,180986,2,4,0
51844,2,2,180984,180986,180988,2,4,0
51845,2,3,180986,180988,180991,2,5,0
51846,2,2,180988,180991,180993,3,5,0
51847,1,2,180989,180993,180995,4,6,0
51848,4,3,180993,180995,180998,2,5,0
51849,6,3,180999,180999,181002,0,3,1
51850,4,2,181003,181003,181005,0,2,1
51851,2,3,181005,181005,181008,0,3,0
51852,4,3,181009,181009,181012,0,3,1
51853,2,1,181011,181012,181013,1,2,0
51854,3,2,181014,181014,181016,0,2,1
51855,5,2,181019,181019,181021,0,2,3
51856,1,1,181020,181021,181022,1,2,0
51857,3,2,181023,181023,181025,0,2,1
51858,5,2,181028,181028,181030,0,2,3
51859,3,1,181031,181031,181032,0,1,1
51860,2,3,181033,181033,181036,0,3,1
51861,2,2,181035,181036,181038,1,3,0
51862,4,3,181039,181039,181042,0,3,1
51863,1,3,181040,181042,181045,2,5,0
51864,2,2,181042,181045,181047,3,5,0
51865,1,2,181043,181047,181049,4,6,0
51866,4,1,181047,181049,181050,2,3,0
51867,6,3,181053,181053,181056,0,3,3
51868,5,2,181058,181058,181060,0,2,2
51869,3,3,181061,181061,181064,0,3,1
51870,5,3,181066,181066,181069,0,3,2
51871,2,1,181068,181069,181070,1,2,0
51872,3,1,181071,181071,181072,0,1,1
51873,1,1,181072,181072,181073,0,1,0
51874,1,3,181073,181073,181076,0,3,0
51875,1,1,181074,181076,181077,2,3,0
51876,2,3,181076,181077,181080,1,4,0
51877,4,2,181080,181080,181082,0,2,0
51878,3,1,181083,181083,181084,0,1,1
51879,5,2,181088,181088,181090,0,2,4
51880,3,3,181091,181091,181094,0,3,1
51881,6,3,181097,181097,181100,0,3,3
51882,4,3,181101,181101,181104,0,3,1
51883,4,2,181105,181105,181107,0,2,1
51884,5,1,181110,181110,181111,0,1,3
51885,4,2,181114,181114,181116,0,2,3
51886,2,3,181116,181116,181119,0,3,0
51887,5,2,181121,181121,181123,0,2,2
51888,3,3,181124,181124,181127,0,3,1
51889,2,2,181126,181127,181129,1,3,0
51890,1,3,181127,181129,181132,2,5,0
51891,3,3,181130,181132,181135,2,5,0
51892,3,2,181133,181135,181137,2,4,0
51893,2,3,181135,181137,181140,2,5,0
51894,3,3,181138,181140,181143,2,5,0
51895,5,2,181143,181143,181145,0,2,0
51896,3,2,181146,181146,181148,0,2,1
51897,5,3,181151,181151,181154,0,3,3
51898,4,1,181155,181155,181156,0,1,1
51899,2,2,181157,181157,181159,0,2,1
51900,6,1,181163,181163,181164,0,1,4
51901,1,1,181164,181164,181165,0,1,0
51902,6,3,181170,181170,181173,0,3,5
51903,1,1,181171,181173,181174,2,3,0
51904,1,2,181172,181174,181176,2,4,0
51905,6,1,181178,181178,181179,0,1,2
51906,3,3,181181,181181,181184,0,3,2
51907,1,3,181182,181184,181187,2,5,0
51908,3,3,181185,181187,181190,2,5,0
51909,4,3,181189,181190,181193,1,4,0
51910,5,2,181194,181194,181196,0,2,1
51911,1,1,181195,181196,181197,1,2,0
51912,1,1,181196,181197,181198,1,2,0
51913,3,1,181199,181199,181200,0,1,1
51914,6,3,181205,181205,181208,0,3,5
51915,2,2,181207,181208,181210,1,3,0
51916,6,3,181213,181213,181216,0,3,3
51917,6,3,181219,181219,181222,0,3,3
51918,4,3,181223,181223,181226,0,3,1
51919,2,2,181225,181226,181228,1,3,0
51920,5,2,181230,181230,181232,0,2,2
51921,3,3,181233,181233,181236,0,3,1
51922,1,2,181234,181236,181238,2,4,0
51923,2,1,181236,181238,181239,2,3,0
51924,5,2,181241,181241,181243,0,2,2
51925,3,2,181244,181244,181246,0,2,1
51926,5,1,181249,181249,181250,0,1,3
51927,4,2,181253,181253,181255,0,2,3
51928,2,3,181255,181255,181258,0,3,0
51929,5,3,181260,181260,181263,0,3,2
51930,6,2,181266,181266,181268,0,2,3
51931,3,3,181269,181269,181272,0,3,1
51932,3,2,181272,181272,181274,0,2,0
51933,6,3,181278,181278,181281,0,3,4
51934,2,3,181280,181281,181284,1,4,0
51935,5,1,181285,181285,181286,0,1,1
51936,3,2,181288,181288,181290,0,2,2
51937,4,3,181292,181292,181295,0,3,2
51938,4,2,181296,181296,181298,0,2,1
51939,3,2,181299,181299,181301,0,2,1
51940,4,2,181303,181303,181305,0,2,2
51941,5,3,181308,181308,181311,0,3,3
51942,4,1,181312,181312,181313,0,1,1
51943,5,3,181317,181317,181320,0,3,4
51944,6,2,181323,181323,181325,0,2,3
51945,3,2,181326,181326,181328,0,2,1
51946,5,1,181331,181331,181332,0,1,3
51947,2,1,181333,181333,181334,0,1,1
51948,6,3,181339,181339,181342,0,3,5
51949,1,3,181340,181342,181345,2,5,0
51950,3,3,181343,181345,181348,2,5,0
51951,3,3,181346,181348,181351,2,5,0
51952,1,3,181347,181351,181354,4,7,0
51953,1,1,181348,181354,181355,6,7,0
51954,3,1,181351,181355,181356,4,5,0
51955,5,1,181356,181356,181357,0,1,0
51956,4,1,181360,181360,181361,0,1,3
51957,6,2,181366,181366,181368,0,2,5
51958,4,3,181370,181370,181373,0,3,2
51959,5,3,181375,181375,181378,0,3,2
51960,2,3,181377,181378,181381,1,4,0
51961,6,1,181383,181383,181384,0,1,2
51962,5,1,181388,181388,181389,0,1,4
51963,2,1,181390,181390,181391,0,1,1
51964,2,1,181392,181392,181393,0,1,1
51965,1,3,181393,181393,181396,0,3,0
51966,1,2,181394,181396,181398,2,4,0
51967,3,3,181397,181398,181401,1,4,0
51968,1,2,181398,181401,181403,3,5,0
51969,4,3,181402,181403,181406,1,4,0
51970,5,3,181407,181407,181410,0,3,1
51971,2,2,181409,181410,181412,1,3,0
51972,6,3,181415,181415,181418,0,3,3
51973,2,3,181417,181418,181421,1,4,0
51974,5,1,181422,181422,181423,0,1,1
51975,6,3,181428,181428,181431,0,3,5
51976,4,3,181432,181432,181435,0,3,1
51977,6,3,181438,181438,181441,0,3,3
51978,6,1,181444,181444,181445,0,1,3
51979,1,2,181445,181445,181447,0,2,0
51980,2,3,181447,181447,181450,0,3,0
51981,1,1,181448,181450,181451,2,3,0
51982,6,1,181454,181454,181455,0,1,3
51983,5,2,181459,181459,181461,0,2,4
51984,4,2,181463,181463,181465,0,2,2
51985,4,1,181467,181467,181468,0,1,2
51986,1,3,181468,181468,181471,0,3,0
51987,3,1,181471,181471,181472,0,1,0
51988,2,2,181473,181473,181475,0,2,1
51989,4,3,181477,181477,181480,0,3,2
51990,5,3,181482,181482,181485,0,3,2
51991,3,1,181485,181485,181486,0,1,0
51992,1,1,181486,181486,181487,0,1,0
51993,3,1,181489,181489,181490,0,1,2
51994,4,1,181493,181493,181494,0,1,3
51995,4,2,181497,181497,181499,0,2,3
51996,5,2,181502,181502,181504,0,2,3
51997,1,3,181503,181504,181507,1,4,0
51998,5,3,181508,181508,181511,0,3,1
51999,6,1,181514,181514,181515,0,1,3
52000,4,3,181518,181518,181521,0,3,3
52001,3,3,181521,181521,181524,0,3,0
52002,3,3,181524,181524,181527,0,3,0
52003,3,3,181527,181527,181530,0,3,0
52004,2,3,181529,181530,181533,1,4,0
52005,3,1,181532,181533,181534,1,2,0
52006,6,1,181538,181538,181539,0,1,4
52007,6,1,181544,181544,181545,0,1,5
52008,6,2,181550,181550,181552,0,2,5
52009,3,1,181553,181553,181554,0,1,1
52010,4,2,181557,181557,181559,0,2,3
52011,5,2,181562,181562,181564,0,2,3
52012,5,1,181567,181567,181568,0,1,3
52013,3,3,181570,181570,181573,0,3,2
52014,1,2,181571,181573,181575,2,4,0
52015,2,2,181573,181575,181577,2,4,0
52016,3,2,181576,181577,181579,1,3,0
52017,5,2,181581,181581,181583,0,2,2
52018,5,2,181586,181586,181588,0,2,3
52019,5,2,181591,181591,181593,0,2,3
52020,4,3,181595,181595,181598,0,3,2
52021,6,3,181601,181601,181604,0,3,3
52022,3,3,181604,181604,181607,0,3,0
52023,1,1,181605,181607,181608,2,3,0
52024,1,2,181606,181608,181610,2,4,0
52025,5,3,181611,181611,181614,0,3,1
52026,2,2,181613,181614,181616,1,3,0
52027,6,2,181619,181619,181621,0,2,3
52028,1,2,181620,181621,181623,1,3,0
52029,6,3,181626,181626,181629,0,3,3
52030,4,2,181630,181630,181632,0,2,1
52031,2,1,181632,181632,181633,0,1,0
52032,5,3,181637,181637,181640,0,3,4
52033,2,3,181639,181640,181643,1,4,0
52034,5,1,181644,181644,181645,0,1,1
52035,6,1,181650,181650,181651,0,1,5
52036,3,2,181653,181653,181655,0,2,2
52037,4,3,181657,181657,181660,0,3,2
52038,3,1,181660,181660,181661,0,1,0
52039,6,1,181666,181666,181667,0,1,5
52040,5,2,181671,181671,181673,0,2,4
52041,5,2,181676,181676,181678,0,2,3
52042,2,3,181678,181678,181681,0,3,0
52043,2,3,181680,181681,181684,1,4,0
52044,6,2,181686,181686,181688,0,2,2
52045,2,2,181688,181688,181690,0,2,0
52046,3,1,181691,181691,181692,0,1,1
52047,6,1,181697,181697,181698,0,1,5
52048,1,2,181698,181698,181700,0,2,0
52049,6,3,181704,181704,181707,0,3,4
52050,1,3,181705,181707,181710,2,5,0
52051,2,2,181707,181710,181712,3,5,0
52052,4,1,181711,181712,181713,1,2,0
52053,2,2,181713,181713,181715,0,2,0
52054,3,3,181716,181716,181719,0,3,1
52055,1,3,181717,181719,181722,2,5,0
52056,3,1,181720,181722,181723,2,3,0
52057,4,2,181724,181724,181726,0,2,1
52058,3,3,181727,181727,181730,0,3,1
52059,6,1,181733,181733,181734,0,1,3
52060,4,2,181737,181737,181739,0,2,3
52061,2,3,181739,181739,181742,0,3,0
52062,3,2,181742,181742,181744,0,2,0
52063,2,2,181744,181744,181746,0,2,0
52064,3,1,181747,181747,181748,0,1,1
52065,2,1,181749,181749,181750,0,1,1
52066,6,1,181755,181755,181756,0,1,5
52067,5,3,181760,181760,181763,0,3,4
52068,4,3,181764,181764,181767,0,3,1
52069,4,3,181768,181768,181771,0,3,1
52070,6,2,181774,181774,181776,0,2,3
52071,5,2,181779,181779,181781,0,2,3
52072,4,3,181783,181783,181786,0,3,2
52073,2,2,181785,181786,181788,1,3,0
52074,6,2,181791,181791,181793,0,2,3
52075,3,2,181794,181794,181796,0,2,1
52076,3,2,181797,181797,181799,0,2,1
52077,2,1,181799,181799,181800,0,1,0
52078,5,1,181804,181804,181805,0,1,4
52079,2,2,181806,181806,181808,0,2,1
52080,5,3,181811,181811,181814,0,3,3
52081,2,2,181813,181814,181816,1,3,0
52082,3,1,181816,181816,181817,0,1,0
52083,2,3,181818,181818,181821,0,3,1
52084,3,2,181821,181821,181823,0,2,0
52085,6,1,181827,181827,181828,0,1,4
52086,2,1,181829,181829,181830,0,1,1
52087,3,1,181832,181832,181833,0,1,2
52088,2,3,181834,181834,181837,0,3,1
52089,5,3,181839,181839,181842,0,3,2
52090,5,2,181844,181844,181846,0,2,2
52091,1,1,181845,181846,181847,1,2,0
52092,2,3,181847,181847,181850,0,3,0
52093,5,1,181852,181852,181853,0,1,2
52094,4,2,181856,181856,181858,0,2,3
52095,6,1,181862,181862,181863,0,1,4
52096,4,1,181866,181866,181867,0,1,3
52097,4,2,181870,181870,181872,0,2,3
52098,5,1,181875,181875,181876,0,1,3
52099,4,1,181879,181879,181880,0,1,3
52100,2,3,181881,181881,181884,0,3,1
52101,4,1,181885,181885,181886,0,1,1
52102,2,1,181887,181887,181888,0,1,1
52103,6,3,181893,181893,181896,0,3,5
52104,4,3,181897,181897,181900,0,3,1
52105,4,3,181901,181901,181904,0,3,1
52106,2,1,181903,181904,181905,1,2,0
52107,1,1,181904,181905,181906,1,2,0
52108,4,2,181908,181908,181910,0,2,2
52109,2,3,181910,181910,181913,0,3,0
52110,5,3,181915,181915,181918,0,3,2
52111,2,1,181917,181918,181919,1,2,0
52112,5,1,181922,181922,181923,0,1,3
52113,1,3,181923,181923,181926,0,3,0
52114,1,2,181924,181926,181928,2,4,0
52115,6,2,181930,181930,181932,0,2,2
52116,5,2,181935,181935,181937,0,2,3
52117,3,1,181938,181938,181939,0,1,1
52118,6,2,181944,181944,181946,0,2,5
52119,2,2,181946,181946,181948,0,2,0
52120,1,1,181947,181948,181949,1,2,0
52121,2,3,181949,181949,181952,0,3,0
52122,6,3,181955,181955,181958,0,3,3
52123,4,1,181959,181959,181960,0,1,1
52124,3,2,181962,181962,181964,0,2,2
52125,2,1,181964,181964,181965,0,1,0
52126,5,3,181969,181969,181972,0,3,4
52127,1,2,181970,181972,181974,2,4,0
52128,3,1,181973,181974,181975,1,2,0
52129,6,2,181979,181979,181981,0,2,4
52130,2,3,181981,181981,181984,0,3,0
52131,5,2,181986,181986,181988,0,2,2
52132,5,1,181991,181991,181992,0,1,3
52133,5,2,181996,181996,181998,0,2,4
52134,5,1,182001,182001,182002,0,1,3
52135,2,1,182003,182003,182004,0,1,1
52136,6,1,182009,182009,182010,0,1,5
52137,6,3,182015,182015,182018,0,3,5
52138,3,3,182018,182018,182021,0,3,0
52139,2,2,182020,182021,182023,1,3,0
52140,2,3,182022,182023,182026,1,4,0
52141,2,1,182024,182026,182027,2,3,0
52142,3,2,182027,182027,182029,0,2,0
52143,5,1,182032,182032,182033,0,1,3
52144,3,3,182035,182035,182038,0,3,2
52145,2,2,182037,182038,182040,1,3,0
52146,5,1,182042,182042,182043,0,1,2
52147,4,2,182046,182046,182048,0,2,3
52148,2,2,182048,182048,182050,0,2,0
52149,2,1,182050,182050,182051,0,1,0
52150,6,1,182056,182056,182057,0,1,5
52151,3,2,182059,182059,182061,0,2,2
52152,4,1,182063,182063,182064,0,1,2
52153,6,2,182069,182069,182071,0,2,5
52154,5,2,182074,182074,182076,0,2,3
52155,2,1,182076,182076,182077,0,1,0
52156,1,1,182077,182077,182078,0,1,0
52157,6,1,182083,182083,182084,0,1,5
52158,6,1,182089,182089,182090,0,1,5
52159,2,2,182091,182091,182093,0,2,1
52160,2,3,182093,182093,182096,0,3,0
52161,6,3,182099,182099,182102,0,3,3
52162,6,2,182105,182105,182107,0,2,3
52163,6,2,182111,182111,182113,0,2,4
52164,5,1,182116,182116,182117,0,1,3
52165,5,2,182121,182121,182123,0,2,4
52166,3,1,182124,182124,182125,0,1,1
52167,2,3,182126,182126,182129,0,3,1
52168,3,2,182129,182129,182131,0,2,0
52169,6,1,182135,182135,182136,0,1,4
52170,6,3,182141,182141,182144,0,3,5
52171,4,1,182145,182145,182146,0,1,1
52172,6,2,182151,182151,182153,0,2,5
52173,5,1,182156,182156,182157,0,1,3
52174,4,3,182160,182160,182163,0,3,3
52175,3,2,182163,182163,182165,0,2,0
52176,3,2,182166,182166,182168,0,2,1
52177,3,2,182169,182169,182171,0,2,1
52178,1,3,182170,182171,182174,1,4,0
52179,6,3,182176,182176,182179,0,3,2
52180,1,2,182177,182179,182181,2,4,0
52181,6,2,182183,182183,182185,0,2,2
52182,4,3,182187,182187,182190,0,3,2
52183,3,1,182190,182190,182191,0,1,0
52184,5,3,182195,182195,182198,0,3,4
52185,2,3,182197,182198,182201,1,4,0
52186,6,3,182203,182203,182206,0,3,2
52187,1,2,182204,182206,182208,2,4,0
52188,4,1,182208,182208,182209,0,1,0
52189,4,2,182212,182212,182214,0,2,3
52190,6,2,182218,182218,182220,0,2,4
52191,1,3,182219,182220,182223,1,4,0
52192,1,2,182220,182223,182225,3,5,0
52193,2,1,182222,182225,182226,3,4,0
52194,2,1,182224,182226,182227,2,3,0
52195,1,3,182225,182227,182230,2,5,0
52196,6,2,182231,182231,182233,0,2,1
52197,2,2,182233,182233,182235,0,2,0
52198,1,3,182234,182235,182238,1,4,0
52199,6,3,182240,182240,182243,0,3,2
52200,6,1,182246,182246,182247,0,1,3
52201,2,1,182248,182248,182249,0,1,1
52202,5,2,182253,182253,182255,0,2,4
52203,6,3,182259,182259,182262,0,3,4
52204,6,3,182265,182265,182268,0,3,3
52205,6,1,182271,182271,182272,0,1,3
52206,6,2,182277,182277,182279,0,2,5
52207,3,2,182280,182280,182282,0,2,1
52208,1,1,182281,182282,182283,1,2,0
52209,1,2,182282,182283,182285,1,3,0
52210,2,2,182284,182285,182287,1,3,0
52211,2,2,182286,182287,182289,1,3,0
52212,2,2,182288,182289,182291,1,3,0
52213,5,1,182293,182293,182294,0,1,2
52214,6,3,182299,182299,182302,0,3,5
52215,3,2,182302,182302,182304,0,2,0
52216,6,2,182308,182308,182310,0,2,4
52217,2,3,182310,182310,182313,0,3,0
52218,1,3,182311,182313,182316,2,5,0
52219,3,3,182314,182316,182319,2,5,0
52220,5,1,182319,182319,182320,0,1,0
52221,5,3,182324,182324,182327,0,3,4
52222,2,2,182326,182327,182329,1,3,0
52223,5,3,182331,182331,182334,0,3,2
52224,4,1,182335,182335,182336,0,1,1
52225,1,2,182336,182336,182338,0,2,0
52226,4,3,182340,182340,182343,0,3,2
52227,2,1,182342,182343,182344,1,2,0
52228,4,3,182346,182346,182349,0,3,2
52229,6,3,182352,182352,182355,0,3,3
52230,3,1,182355,182355,182356,0,1,0
52231,5,2,182360,182360,182362,0,2,4
52232,3,3,182363,182363,182366,0,3,1
52233,6,1,182369,182369,182370,0,1,3
52234,5,2,182374,182374,182376,0,2,4
52235,5,3,182379,182379,182382,0,3,3
52236,6,3,182385,182385,182388,0,3,3
52237,5,3,182390,182390,182393,0,3,2
52238,1,3,182391,182393,182396,2,5,0
52239,3,1,182394,182396,182397,2,3,0
52240,6,1,182400,182400,182401,0,1,3
52241,1,2,182401,182401,182403,0,2,0
52242,5,1,182406,182406,182407,0,1,3
52243,2,3,182408,182408,182411,0,3,1
52244,5,2,182413,182413,182415,0,2,2
52245,6,2,182419,182419,182421,0,2,4
52246,1,1,182420,182421,182422,1,2,0
52247,3,1,182423,182423,182424,0,1,1
52248,3,2,182426,182426,182428,0,2,2
52249,5,1,182431,182431,182432,0,1,3
52250,3,1,182434,182434,182435,0,1,2
52251,5,1,182439,182439,182440,0,1,4
52252,6,1,182445,182445,182446,0,1,5
52253,2,1,182447,182447,182448,0,1,1
52254,3,2,182450,182450,182452,0,2,2
52255,4,2,182454,182454,182456,0,2,2
52256,1,1,182455,182456,182457,1,2,0
52257,1,1,182456,182457,182458,1,2,0
52258,4,1,182460,182460,182461,0,1,2
52259,5,3,182465,182465,182468,0,3,4
52260,6,2,182471,182471,182473,0,2,3
52261,1,1,182472,182473,182474,1,2,0
52262,4,3,182476,182476,182479,0,3,2
52263,6,1,182482,182482,182483,0,1,3
52264,2,1,182484,182484,182485,0,1,1
52265,6,3,182490,182490,182493,0,3,5
52266,6,2,182496,182496,182498,0,2,3
52267,1,2,182497,182498,182500,1,3,0
52268,4,1,182501,182501,182502,0,1,1
52269,3,2,182504,182504,182506,0,2,2
52270,2,3,182506,182506,182509,0,3,0
52271,1,1,182507,182509,182510,2,3,0
52272,2,1,182509,182510,182511,1,2,0
52273,5,2,182514,182514,182516,0,2,3
52274,3,2,182517,182517,182519,0,2,1
52275,6,1,182523,182523,182524,0,1,4
52276,6,2,182529,182529,182531,0,2,5
52277,1,1,182530,182531,182532,1,2,0
52278,5,2,182535,182535,182537,0,2,3
52279,3,3,182538,182538,182541,0,3,1
52280,1,1,182539,182541,182542,2,3,0
52281,6,1,182545,182545,182546,0,1,3
52282,1,2,182546,182546,182548,0,2,0
52283,4,1,182550,182550,182551,0,1,2
52284,6,1,182556,182556,182557,0,1,5
52285,3,3,182559,182559,182562,0,3,2
52286,5,3,182564,182564,182567,0,3,2
52287,6,1,182570,182570,182571,0,1,3
52288,3,1,182573,182573,182574,0,1,2
52289,2,1,182575,182575,182576,0,1,1
52290,2,3,182577,182577,182580,0,3,1
52291,1,1,182578,182580,182581,2,3,0
52292,6,3,182584,182584,182587,0,3,3
52293,3,1,182587,182587,182588,0,1,0
52294,2,3,182589,182589,182592,0,3,1
52295,3,1,182592,182592,182593,0,1,0
52296,6,3,182598,182598,182601,0,3,5
52297,3,1,182601,182601,182602,0,1,0
52298,2,1,182603,182603,182604,0,1,1
52299,1,3,182604,182604,182607,0,3,0
52300,6,1,182610,182610,182611,0,1,3
52301,2,2,182612,182612,182614,0,2,1
52302,5,1,182617,182617,182618,0,1,3
52303,4,2,182621,182621,182623,0,2,3
52304,4,2,182625,182625,182627,0,2,2
52305,4,2,182629,182629,182631,0,2,2
52306,2,2,182631,182631,182633,0,2,0
52307,4,2,182635,182635,182637,0,2,2
52308,4,2,182639,182639,182641,0,2,2
52309,3,3,182642,182642,182645,0,3,1
52310,4,1,182646,182646,182647,0,1,1
52311,6,2,182652,182652,182654,0,2,5
52312,6,1,182658,182658,182659,0,1,4
52313,3,1,182661,182661,182662,0,1,2
52314,5,3,182666,182666,182669,0,3,4
52315,2,1,182668,182669,182670,1,2,0
52316,6,1,182674,182674,182675,0,1,4
52317,2,3,182676,182676,182679,0,3,1
52318,5,2,182681,182681,182683,0,2,2
52319,6,3,182687,182687,182690,0,3,4
52320,4,3,182691,182691,182694,0,3,1
52321,1,1,182692,182694,182695,2,3,0
52322,5,1,182697,182697,182698,0,1,2
52323,1,3,182698,182698,182701,0,3,0
52324,5,2,182703,182703,182705,0,2,2
52325,5,2,182708,182708,182710,0,2,3
52326,1,2,182709,182710,182712,1,3,0
52327,3,1,182712,182712,182713,0,1,0
52328,4,1,182716,182716,182717,0,1,3
52329,5,3,182721,182721,182724,0,3,4
52330,4,1,182725,182725,182726,0,1,1
52331,6,1,182731,182731,182732,0,1,5
52332,2,3,182733,182733,182736,0,3,1
52333,5,1,182738,182738,182739,0,1,2
52334,6,3,182744,182744,182747,0,3,5
52335,4,2,182748,182748,182750,0,2,1
52336,3,1,182751,182751,182752,0,1,1
52337,4,2,182755,182755,182757,0,2,3
52338,5,1,182760,182760,182761,0,1,3
52339,6,2,182766,182766,182768,0,2,5
52340,2,3,182768,182768,182771,0,3,0
52341,1,3,182769,182771,182774,2,5,0
52342,6,2,182775,182775,182777,0,2,1
52343,1,3,182776,182777,182780,1,4,0
52344,3,1,182779,182780,182781,1,2,0
52345,4,3,182783,182783,182786,0,3,2
52346,2,2,182785,182786,182788,1,3,0
52347,2,1,182787,182788,182789,1,2,0
52348,2,1,182789,182789,182790,0,1,0
52349,6,2,182795,182795,182797,0,2,5
52350,2,3,182797,182797,182800,0,3,0
52351,2,2,182799,182800,182802,1,3,0
52352,1,1,182800,182802,182803,2,3,0
52353,2,2,182802,182803,182805,1,3,0
52354,3,2,182805,182805,182807,0,2,0
52355,3,1,182808,182808,182809,0,1,1
52356,3,3,182811,182811,182814,0,3,2
52357,2,2,182813,182814,182816,1,3,0
52358,6,2,182819,182819,182821,0,2,3
52359,1,3,182820,182821,182824,1,4,0
52360,3,2,182823,182824,182826,1,3,0
52361,3,2,182826,182826,182828,0,2,0
52362,2,3,182828,182828,182831,0,3,0
52363,6,3,182834,182834,182837,0,3,3
52364,1,1,182835,182837,182838,2,3,0
52365,5,3,182840,182840,182843,0,3,2
52366,6,1,182846,182846,182847,0,1,3
52367,2,2,182848,182848,182850,0,2,1
52368,5,3,182853,182853,182856,0,3,3
52369,4,1,182857,182857,182858,0,1,1
52370,4,2,182861,182861,182863,0,2,3
52371,6,1,182867,182867,182868,0,1,4
52372,2,2,182869,182869,182871,0,2,1
52373,1,2,182870,182871,182873,1,3,0
52374,3,2,182873,182873,182875,0,2,0
52375,4,1,182877,182877,182878,0,1,2
52376,5,3,182882,182882,182885,0,3,4
52377,4,2,182886,182886,182888,0,2,1
52378,2,1,182888,182888,182889,0,1,0
52379,2,3,182890,182890,182893,0,3,1
52380,3,3,182893,182893,182896,0,3,0
52381,6,3,182899,182899,182902,0,3,3
52382,4,2,182903,182903,182905,0,2,1
52383,4,1,182907,182907,182908,0,1,2
52384,1,1,182908,182908,182909,0,1,0
52385,4,2,182912,182912,182914,0,2,3
52386,3,2,182915,182915,182917,0,2,1
52387,2,1,182917,182917,182918,0,1,0
52388,4,1,182921,182921,182922,0,1,3
52389,6,1,182927,182927,182928,0,1,5
52390,2,2,182929,182929,182931,0,2,1
52391,4,1,182933,182933,182934,0,1,2
52392,6,1,182939,182939,182940,0,1,5
52393,1,1,182940,182940,182941,0,1,0
52394,6,2,182946,182946,182948,0,2,5
52395,3,2,182949,182949,182951,0,2,1
52396,1,1,182950,182951,182952,1,2,0
52397,2,2,182952,182952,182954,0,2,0
52398,2,2,182954,182954,182956,0,2,0
52399,1,3,182955,182956,182959,1,4,0
52400,4,3,182959,182959,182962,0,3,0
52401,4,3,182963,182963,182966,0,3,1
52402,1,2,182964,182966,182968,2,4,0
52403,4,2,182968,182968,182970,0,2,0
52404,5,3,182973,182973,182976,0,3,3
52405,5,3,182978,182978,182981,0,3,2
52406,4,2,182982,182982,182984,0,2,1
52407,6,3,182988,182988,182991,0,3,4
52408,1,2,182989,182991,182993,2,4,0
52409,3,1,182992,182993,182994,1,2,0
52410,3,1,182995,182995,182996,0,1,1
52411,3,1,182998,182998,182999,0,1,2
52412,6,3,183004,183004,183007,0,3,5
52413,6,1,183010,183010,183011,0,1,3
52414,5,1,183015,183015,183016,0,1,4
52415,3,3,183018,183018,183021,0,3,2
52416,4,3,183022,183022,183025,0,3,1
52417,2,1,183024,183025,183026,1,2,0
52418,6,2,183030,183030,183032,0,2,4
52419,5,3,183035,183035,183038,0,3,3
52420,3,1,183038,183038,183039,0,1,0
52421,1,3,183039,183039,183042,0,3,0
52422,4,2,183043,183043,183045,0,2,1
52423,2,3,183045,183045,183048,0,3,0
52424,4,1,183049,183049,183050,0,1,1
52425,2,3,183051,183051,183054,0,3,1
52426,4,3,183055,183055,183058,0,3,1
52427,5,3,183060,183060,183063,0,3,2
52428,3,2,183063,183063,183065,0,2,0
52429,1,1,183064,183065,183066,1,2,0
52430,6,1,183070,183070,183071,0,1,4
52431,3,1,183073,183073,183074,0,1,2
52432,2,3,183075,183075,183078,0,3,1
52433,1,3,183076,183078,183081,2,5,0
52434,3,3,183079,183081,183084,2,5,0
52435,6,3,183085,183085,183088,0,3,1
52436,5,2,183090,183090,183092,0,2,2
52437,3,3,183093,183093,183096,0,3,1
52438,5,2,183098,183098,183100,0,2,2
52439,1,1,183099,183100,183101,1,2,0
52440,4,3,183103,183103,183106,0,3,2
52441,3,3,183106,183106,183109,0,3,0
52442,6,3,183112,183112,183115,0,3,3
52443,5,2,183117,183117,183119,0,2,2
52444,5,1,183122,183122,183123,0,1,3
52445,4,1,183126,183126,183127,0,1,3
52446,3,2,183129,183129,183131,0,2,2
52447,2,1,183131,183131,183132,0,1,0
52448,2,2,183133,183133,183135,0,2,1
52449,2,3,183135,183135,183138,0,3,0
52450,4,3,183139,183139,183142,0,3,1
52451,3,1,183142,183142,183143,0,1,0
52452,3,3,183145,183145,183148,0,3,2
52453,5,2,183150,183150,183152,0,2,2
52454,6,3,183156,183156,183159,0,3,4
52455,2,2,183158,183159,183161,1,3,0
52456,1,3,183159,183161,183164,2,5,0
52457,5,2,183164,183164,183166,0,2,0
52458,5,1,183169,183169,183170,0,1,3
52459,2,3,183171,183171,183174,0,3,1
52460,3,3,183174,183174,183177,0,3,0
52461,5,1,183179,183179,183180,0,1,2
52462,5,1,183184,183184,183185,0,1,4
52463,4,1,183188,183188,183189,0,1,3
52464,5,3,183193,183193,183196,0,3,4
52465,2,2,183195,183196,183198,1,3,0
52466,3,3,183198,183198,183201,0,3,0
52467,1,1,183199,183201,183202,2,3,0
52468,5,2,183204,183204,183206,0,2,2
52469,1,1,183205,183206,183207,1,2,0
52470,4,1,183209,183209,183210,0,1,2
52471,4,1,183213,183213,183214,0,1,3
52472,5,1,183218,183218,183219,0,1,4
52473,2,3,183220,183220,183223,0,3,1
52474,2,2,183222,183223,183225,1,3,0
52475,6,1,183228,183228,183229,0,1,3
52476,1,2,183229,183229,183231,0,2,0
52477,5,1,183234,183234,183235,0,1,3
52478,4,1,183238,183238,183239,0,1,3
52479,2,2,183240,183240,183242,0,2,1
52480,3,1,183243,183243,183244,0,1,1
52481,3,2,183246,183246,183248,0,2,2
52482,5,3,183251,183251,183254,0,3,3
52483,6,1,183257,183257,183258,0,1,3
52484,3,3,183260,183260,183263,0,3,2
52485,5,2,183265,183265,183267,0,2,2
52486,3,3,183268,183268,183271,0,3,1
52487,1,3,183269,183271,183274,2,5,0
52488,1,2,183270,183274,183276,4,6,0
52489,1,2,183271,183276,183278,5,7,0
52490,5,2,183276,183278,183280,2,4,0
52491,4,2,183280,183280,183282,0,2,0
52492,6,3,183286,183286,183289,0,3,4
52493,5,3,183291,183291,183294,0,3,2
52494,1,1,183292,183294,183295,2,3,0
52495,3,3,183295,183295,183298,0,3,0
52496,4,1,183299,183299,183300,0,1,1
52497,2,1,183301,183301,183302,0,1,1
52498,1,3,183302,183302,183305,0,3,0
52499,5,1,183307,183307,183308,0,1,2
52500,5,2,183312,183312,183314,0,2,4
52501,4,2,183316,183316,183318,0,2,2
52502,5,3,183321,183321,183324,0,3,3
52503,6,3,183327,183327,183330,0,3,3
52504,5,1,183332,183332,183333,0,1,2
52505,1,1,183333,183333,183334,0,1,0
52506,1,3,183334,183334,183337,0,3,0
52507,3,3,183337,183337,183340,0,3,0
52508,3,1,183340,183340,183341,0,1,0
52509,6,2,183346,183346,183348,0,2,5
52510,6,1,183352,183352,183353,0,1,4
52511,4,1,183356,183356,183357,0,1,3
52512,3,1,183359,183359,183360,0,1,2
52513,2,2,183361,183361,183363,0,2,1
52514,5,2,183366,183366,183368,0,2,3
52515,4,3,183370,183370,183373,0,3,2
52516,5,2,183375,183375,183377,0,2,2
52517,5,3,183380,183380,183383,0,3,3
52518,2,1,183382,183383,183384,1,2,0
52519,2,2,183384,183384,183386,0,2,0
52520,3,3,183387,183387,183390,0,3,1
52521,1,3,183388,183390,183393,2,5,0
52522,2,1,183390,183393,183394,3,4,0
52523,1,3,183391,183394,183397,3,6,0
52524,2,1,183393,183397,183398,4,5,0
52525,6,3,183399,183399,183402,0,3,1
52526,2,2,183401,183402,183404,1,3,0
52527,6,2,183407,183407,183409,0,2,3
52528,3,2,183410,183410,183412,0,2,1
52529,6,1,183416,183416,183417,0,1,4
52530,3,3,183419,183419,183422,0,3,2
52531,6,3,183425,183425,183428,0,3,3
52532,6,1,183431,183431,183432,0,1,3
52533,3,3,183434,183434,183437,0,3,2
52534,6,3,183440,183440,183443,0,3,3
52535,3,2,183443,183443,183445,0,2,0
52536,4,2,183447,183447,183449,0,2,2
52537,6,1,183453,183453,183454,0,1,4
52538,6,3,183459,183459,183462,0,3,5
52539,6,2,183465,183465,183467,0,2,3
52540,3,1,183468,183468,183469,0,1,1
52541,4,1,183472,183472,183473,0,1,3
52542,2,3,183474,183474,183477,0,3,1
52543,4,3,183478,183478,183481,0,3,1
52544,6,1,183484,183484,183485,0,1,3
52545,6,1,183490,183490,183491,0,1,5
52546,3,2,183493,183493,183495,0,2,2
52547,4,3,183497,183497,183500,0,3,2
52548,6,2,183503,183503,183505,0,2,3
52549,4,3,183507,183507,183510,0,3,2
52550,5,2,183512,183512,183514,0,2,2
52551,4,3,183516,183516,183519,0,3,2
52552,4,3,183520,183520,183523,0,3,1
52553,4,3,183524,183524,183527,0,3,1
52554,3,2,183527,183527,183529,0,2,0
52555,3,2,183530,183530,183532,0,2,1
52556,4,3,183534,183534,183537,0,3,2
52557,4,2,183538,183538,183540,0,2,1
52558,3,1,183541,183541,183542,0,1,1
52559,6,3,183547,183547,183550,0,3,5
52560,1,1,183548,183550,183551,2,3,0
52561,2,3,183550,183551,183554,1,4,0
52562,6,3,183556,183556,183559,0,3,2
52563,1,3,183557,183559,183562,2,5,0
52564,2,2,183559,183562,183564,3,5,0
52565,4,1,183563,183564,183565,1,2,0
52566,6,2,183569,183569,183571,0,2,4
52567,2,1,183571,183571,183572,0,1,0
52568,3,1,183574,183574,183575,0,1,2
52569,2,2,183576,183576,183578,0,2,1
52570,5,1,183581,183581,183582,0,1,3
52571,1,1,183582,183582,183583,0,1,0
52572,5,2,183587,183587,183589,0,2,4
52573,1,2,183588,183589,183591,1,3,0
52574,3,2,183591,183591,183593,0,2,0
52575,2,3,183593,183593,183596,0,3,0
52576,1,1,183594,183596,183597,2,3,0
52577,6,3,183600,183600,183603,0,3,3
52578,2,1,183602,183603,183604,1,2,0
52579,5,1,183607,183607,183608,0,1,3
52580,2,3,183609,183609,183612,0,3,1
52581,2,1,183611,183612,183613,1,2,0
52582,3,2,183614,183614,183616,0,2,1
52583,5,1,183619,183619,183620,0,1,3
52584,4,3,183623,183623,183626,0,3,3
52585,2,1,183625,183626,183627,1,2,0
52586,2,2,183627,183627,183629,0,2,0
52587,3,3,183630,183630,183633,0,3,1
52588,1,1,183631,183633,183634,2,3,0
52589,2,1,183633,183634,183635,1,2,0
52590,3,2,183636,183636,183638,0,2,1
52591,5,2,183641,183641,183643,0,2,3
52592,6,1,183647,183647,183648,0,1,4
52593,6,1,183653,183653,183654,0,1,5
52594,4,3,183657,183657,183660,0,3,3
52595,4,2,183661,183661,183663,0,2,1
52596,6,3,183667,183667,183670,0,3,4
52597,3,3,183670,183670,183673,0,3,0
52598,6,1,183676,183676,183677,0,1,3
52599,6,1,183682,183682,183683,0,1,5
52600,4,3,183686,183686,183689,0,3,3
52601,5,2,183691,183691,183693,0,2,2
52602,1,3,183692,183693,183696,1,4,0
52603,6,3,183698,183698,183701,0,3,2
52604,2,3,183700,183701,183704,1,4,0
52605,3,2,183703,183704,183706,1,3,0
52606,6,2,183709,183709,183711,0,2,3
52607,4,2,183713,183713,183715,0,2,2
52608,4,1,183717,183717,183718,0,1,2
52609,6,2,183723,183723,183725,0,2,5
52610,6,1,183729,183729,183730,0,1,4
52611,2,2,183731,183731,183733,0,2,1
52612,2,1,183733,183733,183734,0,1,0
52613,2,2,183735,183735,183737,0,2,1
52614,2,3,183737,183737,183740,0,3,0
52615,5,1,183742,183742,183743,0,1,2
52616,6,3,183748,183748,183751,0,3,5
52617,4,2,183752,183752,183754,0,2,1
52618,4,1,183756,183756,183757,0,1,2
52619,3,2,183759,183759,183761,0,2,2
52620,4,1,183763,183763,183764,0,1,2
52621,6,1,183769,183769,183770,0,1,5
52622,5,2,183774,183774,183776,0,2,4
52623,5,1,183779,183779,183780,0,1,3
52624,1,1,183780,183780,183781,0,1,0
52625,2,2,183782,183782,183784,0,2,1
52626,2,1,183784,183784,183785,0,1,0
52627,6,1,183790,183790,183791,0,1,5
52628,1,3,183791,183791,183794,0,3,0
52629,4,1,183795,183795,183796,0,1,1
52630,5,2,183800,183800,183802,0,2,4
52631,3,2,183803,183803,183805,0,2,1
52632,3,2,183806,183806,183808,0,2,1
52633,1,3,183807,183808,183811,1,4,0
52634,4,2,183811,183811,183813,0,2,0
52635,6,2,183817,183817,183819,0,2,4
52636,2,1,183819,183819,183820,0,1,0
52637,6,1,183825,183825,183826,0,1,5
52638,6,2,183831,183831,183833,0,2,5
52639,6,1,183837,183837,183838,0,1,4
52640,3,2,183840,183840,183842,0,2,2
52641,3,1,183843,183843,183844,0,1,1
52642,1,1,183844,183844,183845,0,1,0
52643,3,3,183847,183847,183850,0,3,2
52644,3,3,183850,183850,183853,0,3,0
52645,4,1,183854,183854,183855,0,1,1
52646,6,3,183860,183860,183863,0,3,5
52647,5,1,183865,183865,183866,0,1,2
52648,3,3,183868,183868,183871,0,3,2
52649,6,3,183874,183874,183877,0,3,3
52650,1,3,183875,183877,183880,2,5,0
52651,5,3,183880,183880,183883,0,3,0
52652,4,2,183884,183884,183886,0,2,1
52653,4,3,183888,183888,183891,0,3,2
52654,4,1,183892,183892,183893,0,1,1
52655,2,1,183894,183894,183895,0,1,1
52656,2,3,183896,183896,183899,0,3,1
52657,1,1,183897,183899,183900,2,3,0
52658,5,2,183902,183902,183904,0,2,2
52659,4,2,183906,183906,183908,0,2,2
52660,1,2,183907,183908,183910,1,3,0
52661,4,2,183911,183911,183913,0,2,1
52662,6,1,183917,183917,183918,0,1,4
52663,1,2,183918,183918,183920,0,2,0
52664,1,2,183919,183920,183922,1,3,0
52665,6,2,183925,183925,183927,0,2,3
52666,3,1,183928,183928,183929,0,1,1
52667,2,3,183930,183930,183933,0,3,1
52668,4,2,183934,183934,183936,0,2,1
52669,5,1,183939,183939,183940,0,1,3
52670,3,3,183942,183942,183945,0,3,2
52671,5,2,183947,183947,183949,0,2,2
52672,3,2,183950,183950,183952,0,2,1
52673,5,2,183955,183955,183957,0,2,3
52674,6,1,183961,183961,183962,0,1,4
52675,4,2,183965,183965,183967,0,2,3
52676,3,2,183968,183968,183970,0,2,1
52677,4,2,183972,183972,183974,0,2,2
52678,2,1,183974,183974,183975,0,1,0
52679,6,3,183980,183980,183983,0,3,5
52680,4,2,183984,183984,183986,0,2,1
52681,6,2,183990,183990,183992,0,2,4
52682,3,3,183993,183993,183996,0,3,1
52683,4,2,183997,183997,183999,0,2,1
52684,6,2,184003,184003,184005,0,2,4
52685,5,1,184008,184008,184009,0,1,3
52686,1,3,184009,184009,184012,0,3,0
52687,5,2,184014,184014,184016,0,2,2
52688,2,1,184016,184016,184017,0,1,0
52689,4,2,184020,184020,184022,0,2,3
52690,2,1,184022,184022,184023,0,1,0
52691,5,3,184027,184027,184030,0,3,4
52692,3,1,184030,184030,184031,0,1,0
52693,1,1,184031,184031,184032,0,1,0
52694,4,2,184035,184035,184037,0,2,3
52695,6,3,184041,184041,184044,0,3,4
52696,5,3,184046,184046,184049,0,3,2
52697,1,1,184047,184049,184050,2,3,0
52698,5,2,184052,184052,184054,0,2,2
52699,3,1,184055,184055,184056,0,1,1
52700,1,3,184056,184056,184059,0,3,0
52701,6,3,184062,184062,184065,0,3,3
52702,3,2,184065,184065,184067,0,2,0
52703,3,2,184068,184068,184070,0,2,1
52704,4,1,184072,184072,184073,0,1,2
52705,1,1,184073,184073,184074,0,1,0
52706,6,3,184079,184079,184082,0,3,5
52707,4,3,184083,184083,184086,0,3,1
52708,3,3,184086,184086,184089,0,3,0
52709,1,2,184087,184089,184091,2,4,0
52710,2,1,184089,184091,184092,2,3,0
52711,5,3,184094,184094,184097,0,3,2
52712,3,1,184097,184097,184098,0,1,0
52713,1,3,184098,184098,184101,0,3,0
52714,3,2,184101,184101,184103,0,2,0
52715,1,2,184102,184103,184105,1,3,0
52716,3,3,184105,184105,184108,0,3,0
52717,4,3,184109,184109,184112,0,3,1
52718,3,2,184112,184112,184114,0,2,0
52719,2,3,184114,184114,184117,0,3,0
52720,6,2,184120,184120,184122,0,2,3
52721,3,2,184123,184123,184125,0,2,1
52722,3,2,184126,184126,184128,0,2,1
52723,4,3,184130,184130,184133,0,3,2
52724,5,2,184135,184135,184137,0,2,2
52725,6,1,184141,184141,184142,0,1,4
52726,2,2,184143,184143,184145,0,2,1
52727,2,2,184145,184145,184147,0,2,0
52728,2,3,184147,184147,184150,0,3,0
52729,6,2,184153,184153,184155,0,2,3
52730,6,2,184159,184159,184161,0,2,4
52731,3,1,184162,184162,184163,0,1,1
52732,4,1,184166,184166,184167,0,1,3
52733,5,2,184171,184171,184173,0,2,4
52734,5,2,184176,184176,184178,0,2,3
52735,3,1,184179,184179,184180,0,1,1
52736,6,3,184185,184185,184188,0,3,5
52737,2,2,184187,184188,184190,1,3,0
52738,6,2,184193,184193,184195,0,2,3
52739,3,2,184196,184196,184198,0,2,1
52740,3,2,184199,184199,184201,0,2,1
52741,1,3,184200,184201,184204,1,4,0
52742,4,1,184204,184204,184205,0,1,0
52743,4,3,184208,184208,184211,0,3,3
52744,2,1,184210,184211,184212,1,2,0
52745,5,2,184215,184215,184217,0,2,3
52746,5,3,184220,184220,184223,0,3,3
52747,6,1,184226,184226,184227,0,1,3
52748,3,2,184229,184229,184231,0,2,2
52749,1,2,184230,184231,184233,1,3,0
52750,5,2,184235,184235,184237,0,2,2
52751,3,1,184238,184238,184239,0,1,1
52752,1,3,184239,184239,184242,0,3,0
52753,2,3,184241,184242,184245,1,4,0
52754,6,1,184247,184247,184248,0,1,2
52755,3,2,184250,184250,184252,0,2,2
52756,6,1,184256,184256,184257,0,1,4
52757,6,3,184262,184262,184265,0,3,5
52758,1,2,184263,184265,184267,2,4,0
52759,5,1,184268,184268,184269,0,1,1
52760,2,2,184270,184270,184272,0,2,1
52761,1,2,184271,184272,184274,1,3,0
52762,3,2,184274,184274,184276,0,2,0
52763,1,2,184275,184276,184278,1,3,0
52764,6,2,184281,184281,184283,0,2,3
52765,4,3,184285,184285,184288,0,3,2
52766,4,3,184289,184289,184292,0,3,1
52767,5,2,184294,184294,184296,0,2,2
52768,4,3,184298,184298,184301,0,3,2
52769,3,1,184301,184301,184302,0,1,0
52770,5,2,184306,184306,184308,0,2,4
52771,5,1,184311,184311,184312,0,1,3
52772,5,3,184316,184316,184319,0,3,4
52773,1,2,184317,184319,184321,2,4,0
52774,5,3,184322,184322,184325,0,3,1
52775,4,3,184326,184326,184329,0,3,1
52776,6,1,184332,184332,184333,0,1,3
52777,1,3,184333,184333,184336,0,3,0
52778,5,3,184338,184338,184341,0,3,2
52779,3,1,184341,184341,184342,0,1,0
52780,2,2,184343,184343,184345,0,2,1
52781,4,1,184347,184347,184348,0,1,2
52782,2,3,184349,184349,184352,0,3,1
52783,1,3,184350,184352,184355,2,5,0
52784,2,1,184352,184355,184356,3,4,0
52785,3,1,184355,184356,184357,1,2,0
52786,4,2,184359,184359,184361,0,2,2
52787,1,3,184360,184361,184364,1,4,0
52788,1,1,184361,184364,184365,3,4,0
52789,6,2,184367,184367,184369,0,2,2
52790,6,1,184373,184373,184374,0,1,4
52791,2,2,184375,184375,184377,0,2,1
52792,4,1,184379,184379,184380,0,1,2
52793,6,1,184385,184385,184386,0,1,5
52794,3,3,184388,184388,184391,0,3,2
52795,6,1,184394,184394,184395,0,1,3
52796,3,3,184397,184397,184400,0,3,2
52797,6,2,184403,184403,184405,0,2,3
52798,3,3,184406,184406,184409,0,3,1
52799,1,2,184407,184409,184411,2,4,0
52800,3,2,184410,184411,184413,1,3,0
52801,1,2,184411,184413,184415,2,4,0
52802,4,1,184415,184415,184416,0,1,0
52803,1,2,184416,184416,184418,0,2,0
52804,2,3,184418,184418,184421,0,3,0
52805,1,3,184419,184421,184424,2,5,0
52806,5,2,184424,184424,184426,0,2,0
52807,2,2,184426,184426,184428,0,2,0
52808,1,1,184427,184428,184429,1,2,0
52809,6,2,184433,184433,184435,0,2,4
52810,2,3,184435,184435,184438,0,3,0
52811,2,2,184437,184438,184440,1,3,0
52812,2,3,184439,184440,184443,1,4,0
52813,2,2,184441,184443,184445,2,4,0
52814,2,1,184443,184445,184446,2,3,0
52815,4,3,184447,184447,184450,0,3,1
52816,1,1,184448,184450,184451,2,3,0
52817,6,2,184454,184454,184456,0,2,3
52818,2,1,184456,184456,184457,0,1,0
52819,6,2,184462,184462,184464,0,2,5
52820,6,2,184468,184468,184470,0,2,4
52821,5,2,184473,184473,184475,0,2,3
52822,2,2,184475,184475,184477,0,2,0
52823,3,3,184478,184478,184481,0,3,1
52824,2,3,184480,184481,184484,1,4,0
52825,4,2,184484,184484,184486,0,2,0
52826,1,2,184485,184486,184488,1,3,0
52827,6,3,184491,184491,184494,0,3,3
52828,5,2,184496,184496,184498,0,2,2
52829,3,3,184499,184499,184502,0,3,1
52830,5,1,184504,184504,184505,0,1,2
52831,6,1,184510,184510,184511,0,1,5
52832,2,2,184512,184512,184514,0,2,1
52833,5,2,184517,184517,184519,0,2,3
52834,4,3,184521,184521,184524,0,3,2
52835,4,1,184525,184525,184526,0,1,1
52836,2,1,184527,184527,184528,0,1,1
52837,4,2,184531,184531,184533,0,2,3
52838,1,3,184532,184533,184536,1,4,0
52839,2,1,184534,184536,184537,2,3,0
52840,5,2,184539,184539,184541,0,2,2
52841,2,2,184541,184541,184543,0,2,0
52842,5,1,184546,184546,184547,0,1,3
52843,1,2,184547,184547,184549,0,2,0
52844,1,3,184548,184549,184552,1,4,0
52845,1,1,184549,184552,184553,3,4,0
52846,2,1,184551,184553,184554,2,3,0
52847,2,2,184553,184554,184556,1,3,0
52848,3,2,184556,184556,184558,0,2,0
52849,1,3,184557,184558,184561,1,4,0
52850,2,3,184559,184561,184564,2,5,0
52851,5,2,184564,184564,184566,0,2,0
52852,2,3,184566,184566,184569,0,3,0
52853,6,2,184572,184572,184574,0,2,3
52854,5,2,184577,184577,184579,0,2,3
52855,3,3,184580,184580,184583,0,3,1
52856,2,1,184582,184583,184584,1,2,0
52857,2,2,184584,184584,184586,0,2,0
52858,6,1,184590,184590,184591,0,1,4
52859,1,2,184591,184591,184593,0,2,0
52860,5,2,184596,184596,184598,0,2,3
52861,3,2,184599,184599,184601,0,2,1
52862,1,3,184600,184601,184604,1,4,0
52863,4,2,184604,184604,184606,0,2,0
52864,2,3,184606,184606,184609,0,3,0
52865,4,2,184610,184610,184612,0,2,1
52866,4,3,184614,184614,184617,0,3,2
52867,1,1,184615,184617,184618,2,3,0
52868,2,1,184617,184618,184619,1,2,0
52869,6,1,184623,184623,184624,0,1,4
52870,6,1,184629,184629,184630,0,1,5
52871,2,3,184631,184631,184634,0,3,1
52872,3,3,184634,184634,184637,0,3,0
52873,6,3,184640,184640,184643,0,3,3
52874,3,1,184643,184643,184644,0,1,0
52875,1,3,184644,184644,184647,0,3,0
52876,6,2,184650,184650,184652,0,2,3
52877,6,1,184656,184656,184657,0,1,4
52878,6,2,184662,184662,184664,0,2,5
52879,3,2,184665,184665,184667,0,2,1
52880,3,3,184668,184668,184671,0,3,1
52881,3,1,184671,184671,184672,0,1,0
52882,4,3,184675,184675,184678,0,3,3
52883,5,1,184680,184680,184681,0,1,2
52884,4,1,184684,184684,184685,0,1,3
52885,5,2,184689,184689,184691,0,2,4
52886,2,1,184691,184691,184692,0,1,0
52887,2,1,184693,184693,184694,0,1,1
52888,1,3,184694,184694,184697,0,3,0
52889,4,3,184698,184698,184701,0,3,1
52890,6,2,184704,184704,184706,0,2,3
52891,1,3,184705,184706,184709,1,4,0
52892,3,3,184708,184709,184712,1,4,0
52893,1,1,184709,184712,184713,3,4,0
52894,1,2,184710,184713,184715,3,5,0
52895,6,3,184716,184716,184719,0,3,1
52896,5,3,184721,184721,184724,0,3,2
52897,4,2,184725,184725,184727,0,2,1
52898,6,3,184731,184731,184734,0,3,4
52899,2,2,184733,184734,184736,1,3,0
52900,3,3,184736,184736,184739,0,3,0
52901,4,2,184740,184740,184742,0,2,1
52902,2,3,184742,184742,184745,0,3,0
52903,2,2,184744,184745,184747,1,3,0
52904,6,1,184750,184750,184751,0,1,3
52905,3,1,184753,184753,184754,0,1,2
52906,3,3,184756,184756,184759,0,3,2
52907,6,1,184762,184762,184763,0,1,3
52908,3,1,184765,184765,184766,0,1,2
52909,4,3,184769,184769,184772,0,3,3
52910,5,2,184774,184774,184776,0,2,2
52911,1,3,184775,184776,184779,1,4,0
52912,3,1,184778,184779,184780,1,2,0
52913,6,3,184784,184784,184787,0,3,4
52914,6,3,184790,184790,184793,0,3,3
52915,3,1,184793,184793,184794,0,1,0
52916,6,2,184799,184799,184801,0,2,5
52917,6,2,184805,184805,184807,0,2,4
52918,5,2,184810,184810,184812,0,2,3
52919,2,1,184812,184812,184813,0,1,0
52920,3,1,184815,184815,184816,0,1,2
52921,4,2,184819,184819,184821,0,2,3
52922,3,3,184822,184822,184825,0,3,1
52923,5,2,184827,184827,184829,0,2,2
52924,3,1,184830,184830,184831,0,1,1
52925,6,3,184836,184836,184839,0,3,5
52926,4,1,184840,184840,184841,0,1,1
52927,5,3,184845,184845,184848,0,3,4
52928,2,3,184847,184848,184851,1,4,0
52929,4,3,184851,184851,184854,0,3,0
52930,6,3,184857,184857,184860,0,3,3
52931,4,1,184861,184861,184862,0,1,1
52932,5,2,184866,184866,184868,0,2,4
52933,4,3,184870,184870,184873,0,3,2
52934,1,1,184871,184873,184874,2,3,0
52935,4,1,184875,184875,184876,0,1,1
52936,4,1,184879,184879,184880,0,1,3
52937,1,3,184880,184880,184883,0,3,0
52938,3,1,184883,184883,184884,0,1,0
52939,6,2,184889,184889,184891,0,2,5
52940,2,2,184891,184891,184893,0,2,0
52941,1,2,184892,184893,184895,1,3,0
52942,5,2,184897,184897,184899,0,2,2
52943,5,3,184902,184902,184905,0,3,3
52944,3,1,184905,184905,184906,0,1,0
52945,4,3,184909,184909,184912,0,3,3
52946,6,2,184915,184915,184917,0,2,3
52947,1,1,184916,184917,184918,1,2,0
52948,2,1,184918,184918,184919,0,1,0
52949,3,1,184921,184921,184922,0,1,2
52950,1,1,184922,184922,184923,0,1,0
52951,1,2,184923,184923,184925,0,2,0
52952,5,2,184928,184928,184930,0,2,3
52953,3,1,184931,184931,184932,0,1,1
52954,6,1,184937,184937,184938,0,1,5
52955,3,1,184940,184940,184941,0,1,2
52956,1,2,184941,184941,184943,0,2,0
52957,2,3,184943,184943,184946,0,3,0
52958,6,2,184949,184949,184951,0,2,3
52959,5,3,184954,184954,184957,0,3,3
52960,4,3,184958,184958,184961,0,3,1
52961,1,1,184959,184961,184962,2,3,0
52962,1,2,184960,184962,184964,2,4,0
52963,4,2,184964,184964,184966,0,2,0
52964,1,1,184965,184966,184967,1,2,0
52965,3,3,184968,184968,184971,0,3,1
52966,4,2,184972,184972,184974,0,2,1
52967,4,2,184976,184976,184978,0,2,2
52968,2,1,184978,184978,184979,0,1,0
52969,1,2,184979,184979,184981,0,2,0
52970,3,3,184982,184982,184985,0,3,1
52971,4,1,184986,184986,184987,0,1,1
52972,1,1,184987,184987,184988,0,1,0
52973,2,3,184989,184989,184992,0,3,1
52974,3,2,184992,184992,184994,0,2,0
52975,6,3,184998,184998,185001,0,3,4
52976,5,1,185003,185003,185004,0,1,2
52977,4,1,185007,185007,185008,0,1,3
52978,6,1,185013,185013,185014,0,1,5
52979,4,3,185017,185017,185020,0,3,3
52980,6,2,185023,185023,185025,0,2,3
52981,3,2,185026,185026,185028,0,2,1
52982,5,1,185031,185031,185032,0,1,3
52983,4,1,185035,185035,185036,0,1,3
52984,4,2,185039,185039,185041,0,2,3
52985,3,2,185042,185042,185044,0,2,1
52986,2,2,185044,185044,185046,0,2,0
52987,1,2,185045,185046,185048,1,3,0
52988,6,1,185051,185051,185052,0,1,3
52989,5,2,185056,185056,185058,0,2,4
52990,1,1,185057,185058,185059,1,2,0
52991,1,2,185058,185059,185061,1,3,0
52992,3,1,185061,185061,185062,0,1,0
52993,4,3,185065,185065,185068,0,3,3
52994,5,2,185070,185070,185072,0,2,2
52995,1,3,185071,185072,185075,1,4,0
52996,2,3,185073,185075,185078,2,5,0
52997,5,1,185078,185078,185079,0,1,0
52998,5,1,185083,185083,185084,0,1,4
52999,1,1,185084,185084,185085,0,1,0
53000,4,1,185088,185088,185089,0,1,3
53001,5,3,185093,185093,185096,0,3,4
53002,4,3,185097,185097,185100,0,3,1
53003,5,2,185102,185102,185104,0,2,2
53004,1,2,185103,185104,185106,1,3,0
53005,5,2,185108,185108,185110,0,2,2
53006,2,1,185110,185110,185111,0,1,0
53007,6,1,185116,185116,185117,0,1,5
53008,3,2,185119,185119,185121,0,2,2
53009,5,2,185124,185124,185126,0,2,3
53010,2,3,185126,185126,185129,0,3,0
53011,6,1,185132,185132,185133,0,1,3
53012,4,2,185136,185136,185138,0,2,3
53013,6,2,185142,185142,185144,0,2,4
53014,5,3,185147,185147,185150,0,3,3
53015,5,2,185152,185152,185154,0,2,2
53016,5,2,185157,185157,185159,0,2,3
53017,6,2,185163,185163,185165,0,2,4
53018,2,2,185165,185165,185167,0,2,0
53019,2,1,185167,185167,185168,0,1,0
53020,1,2,185168,185168,185170,0,2,0
53021,3,3,185171,185171,185174,0,3,1
53022,1,1,185172,185174,185175,2,3,0
53023,2,3,185174,185175,185178,1,4,0
53024,5,3,185179,185179,185182,0,3,1
53025,3,3,185182,185182,185185,0,3,0
53026,5,2,185187,185187,185189,0,2,2
53027,3,2,185190,185190,185192,0,2,1
53028,6,1,185196,185196,185197,0,1,4
53029,3,2,185199,185199,185201,0,2,2
53030,2,3,185201,185201,185204,0,3,0
53031,2,3,185203,185204,185207,1,4,0
53032,5,2,185208,185208,185210,0,2,1
53033,5,2,185213,185213,185215,0,2,3
53034,3,2,185216,185216,185218,0,2,1
53035,4,2,185220,185220,185222,0,2,2
53036,1,3,185221,185222,185225,1,4,0
53037,6,1,185227,185227,185228,0,1,2
53038,1,2,185228,185228,185230,0,2,0
53039,1,3,185229,185230,185233,1,4,0
53040,4,3,185233,185233,185236,0,3,0
53041,2,2,185235,185236,185238,1,3,0
53042,4,1,185239,185239,185240,0,1,1
53043,3,2,185242,185242,185244,0,2,2
53044,4,1,185246,185246,185247,0,1,2
53045,5,1,185251,185251,185252,0,1,4
53046,4,2,185255,185255,185257,0,2,3
53047,3,2,185258,185258,185260,0,2,1
53048,3,2,185261,185261,185263,0,2,1
53049,3,1,185264,185264,185265,0,1,1
53050,1,3,185265,185265,185268,0,3,0
53051,2,3,185267,185268,185271,1,4,0
53052,3,2,185270,185271,185273,1,3,0
53053,3,1,185273,185273,185274,0,1,0
53054,1,1,185274,185274,185275,0,1,0
53055,4,3,185278,185278,185281,0,3,3
53056,5,2,185283,185283,185285,0,2,2
53057,6,1,185289,185289,185290,0,1,4
53058,5,2,185294,185294,185296,0,2,4
53059,1,2,185295,185296,185298,1,3,0
53060,2,3,185297,185298,185301,1,4,0
53061,1,3,185298,185301,185304,3,6,0
53062,1,3,185299,185304,185307,5,8,0
53063,6,3,185305,185307,185310,2,5,0
53064,4,1,185309,185310,185311,1,2,0
53065,3,2,185312,185312,185314,0,2,1
53066,4,1,185316,185316,185317,0,1,2
53067,2,1,185318,185318,185319,0,1,1
53068,1,3,185319,185319,185322,0,3,0
53069,4,2,185323,185323,185325,0,2,1
53070,2,3,185325,185325,185328,0,3,0
53071,4,3,185329,185329,185332,0,3,1
53072,2,3,185331,185332,185335,1,4,0
53073,5,2,185336,185336,185338,0,2,1
53074,4,2,185340,185340,185342,0,2,2
53075,1,1,185341,185342,185343,1,2,0
53076,1,3,185342,185343,185346,1,4,0
53077,2,3,185344,185346,185349,2,5,0
53078,2,3,185346,185349,185352,3,6,0
53079,5,2,185351,185352,185354,1,3,0
53080,2,3,185353,185354,185357,1,4,0
53081,6,3,185359,185359,185362,0,3,2
53082,3,3,185362,185362,185365,0,3,0
53083,5,3,185367,185367,185370,0,3,2
53084,4,2,185371,185371,185373,0,2,1
53085,2,2,185373,185373,185375,0,2,0
53086,4,2,185377,185377,185379,0,2,2
53087,1,3,185378,185379,185382,1,4,0
53088,2,1,185380,185382,185383,2,3,0
53089,4,3,185384,185384,185387,0,3,1
53090,1,2,185385,185387,185389,2,4,0
53091,6,3,185391,185391,185394,0,3,2
53092,4,2,185395,185395,185397,0,2,1
53093,6,1,185401,185401,185402,0,1,4
53094,4,1,185405,185405,185406,0,1,3
53095,1,1,185406,185406,185407,0,1,0
53096,1,2,185407,185407,185409,0,2,0
53097,4,3,185411,185411,185414,0,3,2
53098,1,1,185412,185414,185415,2,3,0
53099,2,2,185414,185415,185417,1,3,0
53100,5,2,185419,185419,185421,0,2,2
53101,4,2,185423,185423,185425,0,2,2
53102,1,2,185424,185425,185427,1,3,0
53103,3,3,185427,185427,185430,0,3,0
53104,4,3,185431,185431,185434,0,3,1
53105,2,2,185433,185434,185436,1,3,0
53106,2,3,185435,185436,185439,1,4,0
53107,5,2,185440,185440,185442,0,2,1
53108,2,3,185442,185442,185445,0,3,0
53109,2,3,185444,185445,185448,1,4,0
53110,1,1,185445,185448,185449,3,4,0
53111,4,2,185449,185449,185451,0,2,0
53112,6,2,185455,185455,185457,0,2,4
53113,2,2,185457,185457,185459,0,2,0
53114,1,2,185458,185459,185461,1,3,0
53115,5,2,185463,185463,185465,0,2,2
53116,4,2,185467,185467,185469,0,2,2
53117,3,1,185470,185470,185471,0,1,1
53118,1,2,185471,185471,185473,0,2,0
53119,2,1,185473,185473,185474,0,1,0
53120,4,2,185477,185477,185479,0,2,3
53121,1,1,185478,185479,185480,1,2,0
53122,6,3,185484,185484,185487,0,3,4
53123,4,1,185488,185488,185489,0,1,1
53124,2,1,185490,185490,185491,0,1,1
53125,1,1,185491,185491,185492,0,1,0
53126,1,1,185492,185492,185493,0,1,0
53127,2,1,185494,185494,185495,0,1,1
53128,2,1,185496,185496,185497,0,1,1
53129,1,1,185497,185497,185498,0,1,0
53130,2,2,185499,185499,185501,0,2,1
53131,6,2,185505,185505,185507,0,2,4
53132,2,1,185507,185507,185508,0,1,0
53133,1,1,185508,185508,185509,0,1,0
53134,6,3,185514,185514,185517,0,3,5
53135,6,1,185520,185520,185521,0,1,3
53136,3,2,185523,185523,185525,0,2,2
53137,1,2,185524,185525,185527,1,3,0
53138,6,2,185530,185530,185532,0,2,3
53139,3,2,185533,185533,185535,0,2,1
53140,5,1,185538,185538,185539,0,1,3
53141,6,2,185544,185544,185546,0,2,5
53142,3,2,185547,185547,185549,0,2,1
53143,5,2,185552,185552,185554,0,2,3
53144,3,3,185555,185555,185558,0,3,1
53145,6,2,185561,185561,185563,0,2,3
53146,6,1,185567,185567,185568,0,1,4
53147,2,1,185569,185569,185570,0,1,1
53148,1,1,185570,185570,185571,0,1,0
53149,1,2,185571,185571,185573,0,2,0
53150,5,2,185576,185576,185578,0,2,3
53151,2,3,185578,185578,185581,0,3,0
53152,2,1,185580,185581,185582,1,2,0
53153,3,2,185583,185583,185585,0,2,1
53154,4,3,185587,185587,185590,0,3,2
53155,3,1,185590,185590,185591,0,1,0
53156,4,3,185594,185594,185597,0,3,3
53157,4,3,185598,185598,185601,0,3,1
53158,5,3,185603,185603,185606,0,3,2
53159,5,1,185608,185608,185609,0,1,2
53160,1,1,185609,185609,185610,0,1,0
53161,4,1,185613,185613,185614,0,1,3
53162,3,2,185616,185616,185618,0,2,2
53163,5,3,185621,185621,185624,0,3,3
53164,5,1,185626,185626,185627,0,1,2
53165,6,1,185632,185632,185633,0,1,5
53166,6,3,185638,185638,185641,0,3,5
53167,5,3,185643,185643,185646,0,3,2
53168,3,2,185646,185646,185648,0,2,0
53169,5,3,185651,185651,185654,0,3,3
53170,2,3,185653,185654,185657,1,4,0
53171,3,3,185656,185657,185660,1,4,0
53172,3,2,185659,185660,185662,1,3,0
53173,6,1,185665,185665,185666,0,1,3
53174,1,1,185666,185666,185667,0,1,0
53175,4,2,185670,185670,185672,0,2,3
53176,2,2,185672,185672,185674,0,2,0
53177,5,2,185677,185677,185679,0,2,3
53178,6,2,185683,185683,185685,0,2,4
53179,5,3,185688,185688,185691,0,3,3
53180,4,2,185692,185692,185694,0,2,1
53181,5,2,185697,185697,185699,0,2,3
53182,3,2,185700,185700,185702,0,2,1
53183,2,2,185702,185702,185704,0,2,0
53184,1,3,185703,185704,185707,1,4,0
53185,2,2,185705,185707,185709,2,4,0
53186,4,2,185709,185709,185711,0,2,0
53187,4,2,185713,185713,185715,0,2,2
53188,1,1,185714,185715,185716,1,2,0
53189,1,1,185715,185716,185717,1,2,0
53190,2,3,185717,185717,185720,0,3,0
53191,3,1,185720,185720,185721,0,1,0
53192,1,1,185721,185721,185722,0,1,0
53193,6,3,185727,185727,185730,0,3,5
53194,5,3,185732,185732,185735,0,3,2
53195,4,3,185736,185736,185739,0,3,1
53196,2,3,185738,185739,185742,1,4,0
53197,6,3,185744,185744,185747,0,3,2
53198,5,3,185749,185749,185752,0,3,2
53199,4,2,185753,185753,185755,0,2,1
53200,6,2,185759,185759,185761,0,2,4
53201,3,2,185762,185762,185764,0,2,1
53202,6,2,185768,185768,185770,0,2,4
53203,4,3,185772,185772,185775,0,3,2
53204,5,1,185777,185777,185778,0,1,2
53205,5,2,185782,185782,185784,0,2,4
53206,6,3,185788,185788,185791,0,3,4
53207,5,1,185793,185793,185794,0,1,2
53208,4,2,185797,185797,185799,0,2,3
53209,6,3,185803,185803,185806,0,3,4
53210,6,2,185809,185809,185811,0,2,3
53211,4,2,185813,185813,185815,0,2,2
53212,3,2,185816,185816,185818,0,2,1
53213,6,2,185822,185822,185824,0,2,4
53214,2,1,185824,185824,185825,0,1,0
53215,3,3,185827,185827,185830,0,3,2
53216,1,2,185828,185830,185832,2,4,0
53217,4,3,185832,185832,185835,0,3,0
53218,1,3,185833,185835,185838,2,5,0
53219,1,1,185834,185838,185839,4,5,0
53220,1,1,185835,185839,185840,4,5,0
53221,1,1,185836,185840,185841,4,5,0
53222,2,3,185838,185841,185844,3,6,0
53223,6,3,185844,185844,185847,0,3,0
53224,4,1,185848,185848,185849,0,1,1
53225,3,3,185851,185851,185854,0,3,2
53226,1,3,185852,185854,185857,2,5,0
53227,2,1,185854,185857,185858,3,4,0
53228,1,3,185855,185858,185861,3,6,0
53229,1,2,185856,185861,185863,5,7,0
53230,1,2,185857,185863,185865,6,8,0
53231,3,2,185860,185865,185867,5,7,0
53232,3,3,185863,185867,185870,4,7,0
53233,2,3,185865,185870,185873,5,8,0
53234,5,1,185870,185873,185874,3,4,0
53235,1,2,185871,185874,185876,3,5,0
53236,4,2,185875,185876,185878,1,3,0
53237,6,2,185881,185881,185883,0,2,3
53238,1,3,185882,185883,185886,1,4,0
53239,6,1,185888,185888,185889,0,1,2
53240,5,2,185893,185893,185895,0,2,4
53241,1,2,185894,185895,185897,1,3,0
53242,6,2,185900,185900,185902,0,2,3
53243,3,2,185903,185903,185905,0,2,1
53244,3,1,185906,185906,185907,0,1,1
53245,5,2,185911,185911,185913,0,2,4
53246,1,3,185912,185913,185916,1,4,0
53247,1,1,185913,185916,185917,3,4,0
53248,6,3,185919,185919,185922,0,3,2
53249,2,3,185921,185922,185925,1,4,0
53250,6,1,185927,185927,185928,0,1,2
53251,1,2,185928,185928,185930,0,2,0
53252,3,2,185931,185931,185933,0,2,1
53253,6,3,185937,185937,185940,0,3,4
53254,5,2,185942,185942,185944,0,2,2
53255,3,2,185945,185945,185947,0,2,1
53256,2,3,185947,185947,185950,0,3,0
53257,6,3,185953,185953,185956,0,3,3
53258,5,3,185958,185958,185961,0,3,2
53259,1,2,185959,185961,185963,2,4,0
53260,3,1,185962,185963,185964,1,2,0
53261,1,2,185963,185964,185966,1,3,0
53262,3,2,185966,185966,185968,0,2,0
53263,3,3,185969,185969,185972,0,3,1
53264,4,2,185973,185973,185975,0,2,1
53265,6,1,185979,185979,185980,0,1,4
53266,6,3,185985,185985,185988,0,3,5
53267,6,3,185991,185991,185994,0,3,3
53268,1,1,185992,185994,185995,2,3,0
53269,6,1,185998,185998,185999,0,1,3
53270,5,1,186003,186003,186004,0,1,4
53271,3,2,186006,186006,186008,0,2,2
53272,4,2,186010,186010,186012,0,2,2
53273,4,1,186014,186014,186015,0,1,2
53274,6,3,186020,186020,186023,0,3,5
53275,2,1,186022,186023,186024,1,2,0
53276,6,2,186028,186028,186030,0,2,4
53277,4,3,186032,186032,186035,0,3,2
53278,5,3,186037,186037,186040,0,3,2
53279,1,3,186038,186040,186043,2,5,0
53280,2,3,186040,186043,186046,3,6,0
53281,1,1,186041,186046,186047,5,6,0
53282,1,1,186042,186047,186048,5,6,0
53283,4,1,186046,186048,186049,2,3,0
53284,1,1,186047,186049,186050,2,3,0
53285,4,2,186051,186051,186053,0,2,1
53286,2,1,186053,186053,186054,0,1,0
53287,4,1,186057,186057,186058,0,1,3
53288,2,3,186059,186059,186062,0,3,1
53289,2,2,186061,186062,186064,1,3,0
53290,2,1,186063,186064,186065,1,2,0
53291,2,2,186065,186065,186067,0,2,0
53292,1,3,186066,186067,186070,1,4,0
53293,4,3,186070,186070,186073,0,3,0
53294,6,3,186076,186076,186079,0,3,3
53295,2,2,186078,186079,186081,1,3,0
53296,6,1,186084,186084,186085,0,1,3
53297,4,2,186088,186088,186090,0,2,3
53298,4,1,186092,186092,186093,0,1,2
53299,3,2,186095,186095,186097,0,2,2
53300,1,1,186096,186097,186098,1,2,0
53301,3,1,186099,186099,186100,0,1,1
53302,3,1,186102,186102,186103,0,1,2
53303,4,3,186106,186106,186109,0,3,3
53304,1,1,186107,186109,186110,2,3,0
53305,4,2,186111,186111,186113,0,2,1
53306,5,2,186116,186116,186118,0,2,3
53307,5,3,186121,186121,186124,0,3,3
53308,5,1,186126,186126,186127,0,1,2
53309,4,3,186130,186130,186133,0,3,3
53310,4,2,186134,186134,186136,0,2,1
53311,3,1,186137,186137,186138,0,1,1
53312,1,1,186138,186138,186139,0,1,0
53313,6,3,186144,186144,186147,0,3,5
53314,2,3,186146,186147,186150,1,4,0
53315,4,1,186150,186150,186151,0,1,0
53316,1,3,186151,186151,186154,0,3,0
53317,4,1,186155,186155,186156,0,1,1
53318,6,3,186161,186161,186164,0,3,5
53319,5,2,186166,186166,186168,0,2,2
53320,2,1,186168,186168,186169,0,1,0
53321,2,2,186170,186170,186172,0,2,1
53322,6,3,186176,186176,186179,0,3,4
53323,4,2,186180,186180,186182,0,2,1
53324,5,2,186185,186185,186187,0,2,3
53325,3,1,186188,186188,186189,0,1,1
53326,1,1,186189,186189,186190,0,1,0
53327,5,1,186194,186194,186195,0,1,4
53328,3,2,186197,186197,186199,0,2,2
53329,6,1,186203,186203,186204,0,1,4
53330,4,2,186207,186207,186209,0,2,3
53331,3,1,186210,186210,186211,0,1,1
53332,5,3,186215,186215,186218,0,3,4
53333,1,3,186216,186218,186221,2,5,0
53334,1,1,186217,186221,186222,4,5,0
53335,6,3,186223,186223,186226,0,3,1
53336,5,3,186228,186228,186231,0,3,2
53337,5,3,186233,186233,186236,0,3,2
53338,4,2,186237,186237,186239,0,2,1
53339,6,1,186243,186243,186244,0,1,4
53340,2,1,186245,186245,186246,0,1,1
53341,3,3,186248,186248,186251,0,3,2
53342,5,1,186253,186253,186254,0,1,2
53343,1,3,186254,186254,186257,0,3,0
53344,5,3,186259,186259,186262,0,3,2
53345,3,2,186262,186262,186264,0,2,0
53346,2,2,186264,186264,186266,0,2,0
53347,4,3,186268,186268,186271,0,3,2
53348,4,2,186272,186272,186274,0,2,1
53349,4,2,186276,186276,186278,0,2,2
53350,5,2,186281,186281,186283,0,2,3
53351,2,3,186283,186283,186286,0,3,0
53352,3,2,186286,186286,186288,0,2,0
53353,6,2,186292,186292,186294,0,2,4
53354,6,2,186298,186298,186300,0,2,4
53355,5,3,186303,186303,186306,0,3,3
53356,4,3,186307,186307,186310,0,3,1
53357,5,2,186312,186312,186314,0,2,2
53358,6,2,186318,186318,186320,0,2,4
53359,5,2,186323,186323,186325,0,2,3
53360,6,3,186329,186329,186332,0,3,4
53361,3,2,186332,186332,186334,0,2,0
53362,5,2,186337,186337,186339,0,2,3
53363,5,1,186342,186342,186343,0,1,3
53364,1,2,186343,186343,186345,0,2,0
53365,2,1,186345,186345,186346,0,1,0
53366,6,2,186351,186351,186353,0,2,5
53367,4,3,186355,186355,186358,0,3,2
53368,1,2,186356,186358,186360,2,4,0
53369,3,1,186359,186360,186361,1,2,0
53370,6,2,186365,186365,186367,0,2,4
53371,2,2,186367,186367,186369,0,2,0
53372,1,3,186368,186369,186372,1,4,0
53373,5,1,186373,186373,186374,0,1,1
53374,2,1,186375,186375,186376,0,1,1
53375,3,2,186378,186378,186380,0,2,2
53376,2,2,186380,186380,186382,0,2,0
53377,6,2,186386,186386,186388,0,2,4
53378,4,2,186390,186390,186392,0,2,2
53379,5,1,186395,186395,186396,0,1,3
53380,6,1,186401,186401,186402,0,1,5
53381,4,1,186405,186405,186406,0,1,3
53382,6,2,186411,186411,186413,0,2,5
53383,1,3,186412,186413,186416,1,4,0
53384,3,1,186415,186416,186417,1,2,0
53385,2,1,186417,186417,186418,0,1,0
53386,4,1,186421,186421,186422,0,1,3
53387,3,1,186424,186424,186425,0,1,2
53388,5,1,186429,186429,186430,0,1,4
53389,6,2,186435,186435,186437,0,2,5
53390,1,3,186436,186437,186440,1,4,0
53391,6,2,186442,186442,186444,0,2,2
53392,1,2,186443,186444,186446,1,3,0
53393,3,2,186446,186446,186448,0,2,0
53394,5,3,186451,186451,186454,0,3,3
53395,4,3,186455,186455,186458,0,3,1
53396,4,3,186459,186459,186462,0,3,1
53397,3,2,186462,186462,186464,0,2,0
53398,1,2,186463,186464,186466,1,3,0
53399,5,3,186468,186468,186471,0,3,2
53400,3,1,186471,186471,186472,0,1,0
53401,5,1,186476,186476,186477,0,1,4
53402,4,1,186480,186480,186481,0,1,3
53403,2,1,186482,186482,186483,0,1,1
53404,3,2,186485,186485,186487,0,2,2
53405,5,2,186490,186490,186492,0,2,3
53406,3,2,186493,186493,186495,0,2,1
53407,4,1,186497,186497,186498,0,1,2
53408,2,1,186499,186499,186500,0,1,1
53409,2,3,186501,186501,186504,0,3,1
53410,5,3,186506,186506,186509,0,3,2
53411,6,2,186512,186512,186514,0,2,3
53412,3,1,186515,186515,186516,0,1,1
53413,2,1,186517,186517,186518,0,1,1
53414,4,1,186521,186521,186522,0,1,3
53415,2,3,186523,186523,186526,0,3,1
53416,2,2,186525,186526,186528,1,3,0
53417,6,3,186531,186531,186534,0,3,3
53418,5,3,186536,186536,186539,0,3,2
53419,4,3,186540,186540,186543,0,3,1
53420,4,3,186544,186544,186547,0,3,1
53421,1,2,186545,186547,186549,2,4,0
53422,5,2,186550,186550,186552,0,2,1
53423,4,2,186554,186554,186556,0,2,2
53424,3,3,186557,186557,186560,0,3,1
53425,4,3,186561,186561,186564,0,3,1
53426,1,1,186562,186564,186565,2,3,0
53427,2,2,186564,186565,186567,1,3,0
53428,2,1,186566,186567,186568,1,2,0
53429,2,3,186568,186568,186571,0,3,0
53430,1,3,186569,186571,186574,2,5,0
53431,5,2,186574,186574,186576,0,2,0
53432,1,3,186575,186576,186579,1,4,0
53433,6,2,186581,186581,186583,0,2,2
53434,2,2,186583,186583,186585,0,2,0
53435,5,2,186588,186588,186590,0,2,3
53436,1,1,186589,186590,186591,1,2,0
53437,2,3,186591,186591,186594,0,3,0
53438,4,3,186595,186595,186598,0,3,1
53439,1,3,186596,186598,186601,2,5,0
53440,1,3,186597,186601,186604,4,7,0
53441,1,1,186598,186604,186605,6,7,0
53442,5,1,186603,186605,186606,2,3,0
53443,6,3,186609,186609,186612,0,3,3
53444,4,1,186613,186613,186614,0,1,1
53445,3,3,186616,186616,186619,0,3,2
53446,6,1,186622,186622,186623,0,1,3
53447,1,2,186623,186623,186625,0,2,0
53448,6,1,186629,186629,186630,0,1,4
53449,4,3,186633,186633,186636,0,3,3
53450,3,1,186636,186636,186637,0,1,0
53451,3,1,186639,186639,186640,0,1,2
53452,5,2,186644,186644,186646,0,2,4
53453,6,2,186650,186650,186652,0,2,4
53454,6,2,186656,186656,186658,0,2,4
53455,3,1,186659,186659,186660,0,1,1
53456,6,1,186665,186665,186666,0,1,5
53457,3,1,186668,186668,186669,0,1,2
53458,2,2,186670,186670,186672,0,2,1
53459,6,3,186676,186676,186679,0,3,4
53460,2,2,186678,186679,186681,1,3,0
53461,3,3,186681,186681,186684,0,3,0
53462,5,3,186686,186686,186689,0,3,2
53463,4,2,186690,186690,186692,0,2,1
53464,5,3,186695,186695,186698,0,3,3
53465,6,3,186701,186701,186704,0,3,3
53466,6,2,186707,186707,186709,0,2,3
53467,6,2,186713,186713,186715,0,2,4
53468,3,1,186716,186716,186717,0,1,1
53469,3,1,186719,186719,186720,0,1,2
53470,4,3,186723,186723,186726,0,3,3
53471,3,1,186726,186726,186727,0,1,0
53472,5,3,186731,186731,186734,0,3,4
53473,5,3,186736,186736,186739,0,3,2
53474,1,2,186737,186739,186741,2,4,0
53475,5,1,186742,186742,186743,0,1,1
53476,4,2,186746,186746,186748,0,2,3
53477,1,1,186747,186748,186749,1,2,0
53478,6,2,186753,186753,186755,0,2,4
53479,1,1,186754,186755,186756,1,2,0
53480,5,3,186759,186759,186762,0,3,3
53481,4,2,186763,186763,186765,0,2,1
53482,4,2,186767,186767,186769,0,2,2
53483,1,1,186768,186769,186770,1,2,0
53484,1,2,186769,186770,186772,1,3,0
53485,4,2,186773,186773,186775,0,2,1
53486,1,3,186774,186775,186778,1,4,0
53487,3,2,186777,186778,186780,1,3,0
53488,6,2,186783,186783,186785,0,2,3
53489,2,3,186785,186785,186788,0,3,0
53490,2,1,186787,186788,186789,1,2,0
53491,5,1,186792,186792,186793,0,1,3
53492,5,1,186797,186797,186798,0,1,4
53493,1,2,186798,186798,186800,0,2,0
53494,4,1,186802,186802,186803,0,1,2
53495,2,3,186804,186804,186807,0,3,1
53496,1,1,186805,186807,186808,2,3,0
53497,5,3,186810,186810,186813,0,3,2
53498,2,3,186812,186813,186816,1,4,0
53499,4,3,186816,186816,186819,0,3,0
53500,5,1,186821,186821,186822,0,1,2
53501,4,1,186825,186825,186826,0,1,3
53502,5,2,186830,186830,186832,0,2,4
53503,2,3,186832,186832,186835,0,3,0
53504,3,1,186835,186835,186836,0,1,0
53505,5,2,186840,186840,186842,0,2,4
53506,6,1,186846,186846,186847,0,1,4
53507,5,3,186851,186851,186854,0,3,4
53508,2,2,186853,186854,186856,1,3,0
53509,4,3,186857,186857,186860,0,3,1
53510,5,2,186862,186862,186864,0,2,2
53511,5,1,186867,186867,186868,0,1,3
53512,1,1,186868,186868,186869,0,1,0
53513,2,2,186870,186870,186872,0,2,1
53514,4,2,186874,186874,186876,0,2,2
53515,5,3,186879,186879,186882,0,3,3
53516,5,2,186884,186884,186886,0,2,2
53517,4,3,186888,186888,186891,0,3,2
53518,1,3,186889,186891,186894,2,5,0
53519,5,3,186894,186894,186897,0,3,0
53520,1,1,186895,186897,186898,2,3,0
53521,6,2,186901,186901,186903,0,2,3
53522,6,3,186907,186907,186910,0,3,4
53523,4,2,186911,186911,186913,0,2,1
53524,1,2,186912,186913,186915,1,3,0
53525,1,1,186913,186915,186916,2,3,0
53526,3,1,186916,186916,186917,0,1,0
53527,4,3,186920,186920,186923,0,3,3
53528,6,2,186926,186926,186928,0,2,3
53529,5,2,186931,186931,186933,0,2,3
53530,3,1,186934,186934,186935,0,1,1
53531,2,2,186936,186936,186938,0,2,1
53532,2,2,186938,186938,186940,0,2,0
53533,5,2,186943,186943,186945,0,2,3
53534,6,3,186949,186949,186952,0,3,4
53535,2,1,186951,186952,186953,1,2,0
53536,5,1,186956,186956,186957,0,1,3
53537,1,1,186957,186957,186958,0,1,0
53538,3,3,186960,186960,186963,0,3,2
53539,3,1,186963,186963,186964,0,1,0
53540,6,3,186969,186969,186972,0,3,5
53541,3,3,186972,186972,186975,0,3,0
53542,6,2,186978,186978,186980,0,2,3
53543,5,3,186983,186983,186986,0,3,3
53544,6,2,186989,186989,186991,0,2,3
53545,1,2,186990,186991,186993,1,3,0
53546,2,2,186992,186993,186995,1,3,0
53547,5,1,186997,186997,186998,0,1,2
53548,6,1,187003,187003,187004,0,1,5
53549,1,3,187004,187004,187007,0,3,0
53550,1,3,187005,187007,187010,2,5,0
53551,3,2,187008,187010,187012,2,4,0
53552,3,2,187011,187012,187014,1,3,0
53553,2,1,187013,187014,187015,1,2,0
53554,3,3,187016,187016,187019,0,3,1
53555,1,2,187017,187019,187021,2,4,0
53556,2,2,187019,187021,187023,2,4,0
53557,1,1,187020,187023,187024,3,4,0
53558,3,1,187023,187024,187025,1,2,0
53559,5,3,187028,187028,187031,0,3,3
53560,6,2,187034,187034,187036,0,2,3
53561,4,1,187038,187038,187039,0,1,2
53562,1,3,187039,187039,187042,0,3,0
53563,4,3,187043,187043,187046,0,3,1
53564,6,2,187049,187049,187051,0,2,3
53565,3,1,187052,187052,187053,0,1,1
53566,4,2,187056,187056,187058,0,2,3
53567,6,2,187062,187062,187064,0,2,4
53568,5,1,187067,187067,187068,0,1,3
53569,5,3,187072,187072,187075,0,3,4
53570,2,1,187074,187075,187076,1,2,0
53571,6,2,187080,187080,187082,0,2,4
53572,3,1,187083,187083,187084,0,1,1
53573,3,1,187086,187086,187087,0,1,2
53574,2,3,187088,187088,187091,0,3,1
53575,2,1,187090,187091,187092,1,2,0
53576,5,1,187095,187095,187096,0,1,3
53577,1,1,187096,187096,187097,0,1,0
53578,2,2,187098,187098,187100,0,2,1
53579,1,2,187099,187100,187102,1,3,0
53580,1,1,187100,187102,187103,2,3,0
53581,1,2,187101,187103,187105,2,4,0
53582,4,1,187105,187105,187106,0,1,0
53583,2,3,187107,187107,187110,0,3,1
53584,4,3,187111,187111,187114,0,3,1
53585,6,1,187117,187117,187118,0,1,3
53586,3,3,187120,187120,187123,0,3,2
53587,3,1,187123,187123,187124,0,1,0
53588,3,2,187126,187126,187128,0,2,2
53589,4,3,187130,187130,187133,0,3,2
53590,1,1,187131,187133,187134,2,3,0
53591,2,1,187133,187134,187135,1,2,0
53592,1,1,187134,187135,187136,1,2,0
53593,4,2,187138,187138,187140,0,2,2
53594,6,1,187144,187144,187145,0,1,4
53595,3,1,187147,187147,187148,0,1,2
53596,6,2,187153,187153,187155,0,2,5
53597,6,1,187159,187159,187160,0,1,4
53598,1,2,187160,187160,187162,0,2,0
53599,6,1,187166,187166,187167,0,1,4
53600,4,1,187170,187170,187171,0,1,3
53601,1,1,187171,187171,187172,0,1,0
53602,2,3,187173,187173,187176,0,3,1
53603,3,1,187176,187176,187177,0,1,0
53604,2,2,187178,187178,187180,0,2,1
53605,2,2,187180,187180,187182,0,2,0
53606,2,1,187182,187182,187183,0,1,0
53607,1,2,187183,187183,187185,0,2,0
53608,2,3,187185,187185,187188,0,3,0
53609,3,2,187188,187188,187190,0,2,0
53610,2,3,187190,187190,187193,0,3,0
53611,3,3,187193,187193,187196,0,3,0
53612,2,1,187195,187196,187197,1,2,0
53613,3,1,187198,187198,187199,0,1,1
53614,4,1,187202,187202,187203,0,1,3
53615,4,3,187206,187206,187209,0,3,3
53616,3,2,187209,187209,187211,0,2,0
53617,3,2,187212,187212,187214,0,2,1
53618,4,1,187216,187216,187217,0,1,2
53619,2,2,187218,187218,187220,0,2,1
53620,2,2,187220,187220,187222,0,2,0
53621,3,2,187223,187223,187225,0,2,1
53622,5,1,187228,187228,187229,0,1,3
53623,2,2,187230,187230,187232,0,2,1
53624,1,3,187231,187232,187235,1,4,0
53625,5,2,187236,187236,187238,0,2,1
53626,5,2,187241,187241,187243,0,2,3
53627,2,3,187243,187243,187246,0,3,0
53628,6,3,187249,187249,187252,0,3,3
53629,5,2,187254,187254,187256,0,2,2
53630,5,1,187259,187259,187260,0,1,3
53631,4,1,187263,187263,187264,0,1,3
53632,3,1,187266,187266,187267,0,1,2
53633,3,3,187269,187269,187272,0,3,2
53634,1,2,187270,187272,187274,2,4,0
53635,3,3,187273,187274,187277,1,4,0
53636,4,3,187277,187277,187280,0,3,0
53637,1,3,187278,187280,187283,2,5,0
53638,5,3,187283,187283,187286,0,3,0
53639,1,3,187284,187286,187289,2,5,0
53640,6,1,187290,187290,187291,0,1,1
53641,5,3,187295,187295,187298,0,3,4
53642,2,1,187297,187298,187299,1,2,0
53643,2,3,187299,187299,187302,0,3,0
53644,5,3,187304,187304,187307,0,3,2
53645,6,3,187310,187310,187313,0,3,3
53646,3,2,187313,187313,187315,0,2,0
53647,2,2,187315,187315,187317,0,2,0
53648,4,2,187319,187319,187321,0,2,2
53649,2,3,187321,187321,187324,0,3,0
53650,4,2,187325,187325,187327,0,2,1
53651,3,2,187328,187328,187330,0,2,1
53652,1,1,187329,187330,187331,1,2,0
53653,5,3,187334,187334,187337,0,3,3
53654,3,3,187337,187337,187340,0,3,0
53655,1,1,187338,187340,187341,2,3,0
53656,2,3,187340,187341,187344,1,4,0
53657,4,2,187344,187344,187346,0,2,0
53658,1,2,187345,187346,187348,1,3,0
53659,5,1,187350,187350,187351,0,1,2
53660,2,1,187352,187352,187353,0,1,1
53661,2,1,187354,187354,187355,0,1,1
53662,1,1,187355,187355,187356,0,1,0
53663,6,1,187361,187361,187362,0,1,5
53664,1,3,187362,187362,187365,0,3,0
53665,5,3,187367,187367,187370,0,3,2
53666,4,1,187371,187371,187372,0,1,1
53667,4,2,187375,187375,187377,0,2,3
53668,3,1,187378,187378,187379,0,1,1
53669,2,3,187380,187380,187383,0,3,1
53670,5,1,187385,187385,187386,0,1,2
53671,3,2,187388,187388,187390,0,2,2
53672,3,2,187391,187391,187393,0,2,1
53673,3,1,187394,187394,187395,0,1,1
53674,2,1,187396,187396,187397,0,1,1
53675,6,1,187402,187402,187403,0,1,5
53676,2,2,187404,187404,187406,0,2,1
53677,1,1,187405,187406,187407,1,2,0
53678,4,2,187409,187409,187411,0,2,2
53679,5,2,187414,187414,187416,0,2,3
53680,5,1,187419,187419,187420,0,1,3
53681,4,2,187423,187423,187425,0,2,3
53682,3,2,187426,187426,187428,0,2,1
53683,2,1,187428,187428,187429,0,1,0
53684,4,1,187432,187432,187433,0,1,3
53685,5,2,187437,187437,187439,0,2,4
53686,1,3,187438,187439,187442,1,4,0
53687,4,3,187442,187442,187445,0,3,0
53688,5,2,187447,187447,187449,0,2,2
53689,2,3,187449,187449,187452,0,3,0
53690,5,2,187454,187454,187456,0,2,2
53691,4,1,187458,187458,187459,0,1,2
53692,2,3,187460,187460,187463,0,3,1
53693,1,2,187461,187463,187465,2,4,0
53694,1,1,187462,187465,187466,3,4,0
53695,2,3,187464,187466,187469,2,5,0
53696,3,2,187467,187469,187471,2,4,0
53697,5,1,187472,187472,187473,0,1,1
53698,4,3,187476,187476,187479,0,3,3
53699,6,3,187482,187482,187485,0,3,3
53700,2,2,187484,187485,187487,1,3,0
53701,5,1,187489,187489,187490,0,1,2
53702,1,3,187490,187490,187493,0,3,0
53703,6,1,187496,187496,187497,0,1,3
53704,2,2,187498,187498,187500,0,2,1
53705,6,1,187504,187504,187505,0,1,4
53706,1,1,187505,187505,187506,0,1,0
53707,5,2,187510,187510,187512,0,2,4
53708,3,3,187513,187513,187516,0,3,1
53709,4,2,187517,187517,187519,0,2,1
53710,5,1,187522,187522,187523,0,1,3
53711,6,1,187528,187528,187529,0,1,5
53712,4,2,187532,187532,187534,0,2,3
53713,4,3,187536,187536,187539,0,3,2
53714,2,2,187538,187539,187541,1,3,0
53715,3,1,187541,187541,187542,0,1,0
53716,3,1,187544,187544,187545,0,1,2
53717,1,2,187545,187545,187547,0,2,0
53718,2,1,187547,187547,187548,0,1,0
53719,1,2,187548,187548,187550,0,2,0
53720,6,2,187554,187554,187556,0,2,4
53721,1,2,187555,187556,187558,1,3,0
53722,3,3,187558,187558,187561,0,3,0
53723,4,3,187562,187562,187565,0,3,1
53724,2,1,187564,187565,187566,1,2,0
53725,4,1,187568,187568,187569,0,1,2
53726,4,3,187572,187572,187575,0,3,3
53727,5,1,187577,187577,187578,0,1,2
53728,3,3,187580,187580,187583,0,3,2
53729,1,2,187581,187583,187585,2,4,0
53730,6,2,187587,187587,187589,0,2,2
53731,4,3,187591,187591,187594,0,3,2
53732,4,2,187595,187595,187597,0,2,1
53733,2,1,187597,187597,187598,0,1,0
53734,3,3,187600,187600,187603,0,3,2
53735,4,3,187604,187604,187607,0,3,1
53736,5,1,187609,187609,187610,0,1,2
53737,6,3,187615,187615,187618,0,3,5
53738,3,2,187618,187618,187620,0,2,0
53739,3,1,187621,187621,187622,0,1,1
53740,3,2,187624,187624,187626,0,2,2
53741,3,1,187627,187627,187628,0,1,1
53742,3,1,187630,187630,187631,0,1,2
53743,6,3,187636,187636,187639,0,3,5
53744,6,3,187642,187642,187645,0,3,3
53745,5,2,187647,187647,187649,0,2,2
53746,3,1,187650,187650,187651,0,1,1
53747,4,3,187654,187654,187657,0,3,3
53748,1,3,187655,187657,187660,2,5,0
53749,4,2,187659,187660,187662,1,3,0
53750,2,2,187661,187662,187664,1,3,0
53751,3,3,187664,187664,187667,0,3,0
53752,1,1,187665,187667,187668,2,3,0
53753,3,3,187668,187668,187671,0,3,0
53754,2,3,187670,187671,187674,1,4,0
53755,4,2,187674,187674,187676,0,2,0
53756,4,3,187678,187678,187681,0,3,2
53757,6,3,187684,187684,187687,0,3,3
53758,4,1,187688,187688,187689,0,1,1
53759,4,2,187692,187692,187694,0,2,3
53760,3,3,187695,187695,187698,0,3,1
53761,4,3,187699,187699,187702,0,3,1
53762,2,2,187701,187702,187704,1,3,0
53763,1,2,187702,187704,187706,2,4,0
53764,3,3,187705,187706,187709,1,4,0
53765,1,1,187706,187709,187710,3,4,0
53766,3,3,187709,187710,187713,1,4,0
53767,3,2,187712,187713,187715,1,3,0
53768,1,1,187713,187715,187716,2,3,0
53769,4,3,187717,187717,187720,0,3,1
53770,6,2,187723,187723,187725,0,2,3
53771,5,2,187728,187728,187730,0,2,3
53772,3,2,187731,187731,187733,0,2,1
53773,2,2,187733,187733,187735,0,2,0
53774,1,3,187734,187735,187738,1,4,0
53775,6,1,187740,187740,187741,0,1,2
53776,6,2,187746,187746,187748,0,2,5
53777,4,3,187750,187750,187753,0,3,2
53778,1,1,187751,187753,187754,2,3,0
53779,2,1,187753,187754,187755,1,2,0
53780,4,3,187757,187757,187760,0,3,2
53781,6,2,187763,187763,187765,0,2,3
53782,6,1,187769,187769,187770,0,1,4
53783,4,3,187773,187773,187776,0,3,3
53784,3,1,187776,187776,187777,0,1,0
53785,1,1,187777,187777,187778,0,1,0
53786,5,3,187782,187782,187785,0,3,4
53787,6,1,187788,187788,187789,0,1,3
53788,6,3,187794,187794,187797,0,3,5
53789,6,1,187800,187800,187801,0,1,3
53790,1,3,187801,187801,187804,0,3,0
53791,4,1,187805,187805,187806,0,1,1
53792,2,3,187807,187807,187810,0,3,1
53793,6,2,187813,187813,187815,0,2,3
53794,5,2,187818,187818,187820,0,2,3
53795,4,2,187822,187822,187824,0,2,2
53796,4,2,187826,187826,187828,0,2,2
53797,2,1,187828,187828,187829,0,1,0
53798,6,2,187834,187834,187836,0,2,5
53799,3,1,187837,187837,187838,0,1,1
53800,4,2,187841,187841,187843,0,2,3
53801,4,1,187845,187845,187846,0,1,2
53802,1,1,187846,187846,187847,0,1,0
53803,4,3,187850,187850,187853,0,3,3
53804,1,3,187851,187853,187856,2,5,0
53805,1,3,187852,187856,187859,4,7,0
53806,1,2,187853,187859,187861,6,8,0
53807,6,2,187859,187861,187863,2,4,0
53808,4,2,187863,187863,187865,0,2,0
53809,6,3,187869,187869,187872,0,3,4
53810,2,3,187871,187872,187875,1,4,0
53811,5,2,187876,187876,187878,0,2,1
53812,1,2,187877,187878,187880,1,3,0
53813,5,2,187882,187882,187884,0,2,2
53814,2,3,187884,187884,187887,0,3,0
53815,4,2,187888,187888,187890,0,2,1
53816,2,3,187890,187890,187893,0,3,0
53817,2,1,187892,187893,187894,1,2,0
53818,6,3,187898,187898,187901,0,3,4
53819,5,3,187903,187903,187906,0,3,2
53820,6,2,187909,187909,187911,0,2,3
53821,4,1,187913,187913,187914,0,1,2
53822,1,2,187914,187914,187916,0,2,0
53823,4,3,187918,187918,187921,0,3,2
53824,5,1,187923,187923,187924,0,1,2
53825,6,3,187929,187929,187932,0,3,5
53826,5,2,187934,187934,187936,0,2,2
53827,5,2,187939,187939,187941,0,2,3
53828,4,1,187943,187943,187944,0,1,2
53829,6,2,187949,187949,187951,0,2,5
53830,3,3,187952,187952,187955,0,3,1
53831,1,1,187953,187955,187956,2,3,0
53832,2,3,187955,187956,187959,1,4,0
53833,1,3,187956,187959,187962,3,6,0
53834,5,3,187961,187962,187965,1,4,0
53835,1,3,187962,187965,187968,3,6,0
53836,4,2,187966,187968,187970,2,4,0
53837,5,2,187971,187971,187973,0,2,1
53838,4,1,187975,187975,187976,0,1,2
53839,3,1,187978,187978,187979,0,1,2
53840,5,1,187983,187983,187984,0,1,4
53841,6,2,187989,187989,187991,0,2,5
53842,2,3,187991,187991,187994,0,3,0
53843,4,1,187995,187995,187996,0,1,1
53844,1,2,187996,187996,187998,0,2,0
53845,3,1,187999,187999,188000,0,1,1
53846,2,1,188001,188001,188002,0,1,1
53847,4,2,188005,188005,188007,0,2,3
53848,1,2,188006,188007,188009,1,3,0
53849,4,2,188010,188010,188012,0,2,1
53850,2,1,188012,188012,188013,0,1,0
53851,3,2,188015,188015,188017,0,2,2
53852,4,1,188019,188019,188020,0,1,2
53853,6,1,188025,188025,188026,0,1,5
53854,3,1,188028,188028,188029,0,1,2
53855,3,3,188031,188031,188034,0,3,2
53856,5,1,188036,188036,188037,0,1,2
53857,4,2,188040,188040,188042,0,2,3
53858,4,3,188044,188044,188047,0,3,2
53859,4,1,188048,188048,188049,0,1,1
53860,2,1,188050,188050,188051,0,1,1
53861,2,3,188052,188052,188055,0,3,1
53862,4,3,188056,188056,188059,0,3,1
53863,6,2,188062,188062,188064,0,2,3
53864,6,3,188068,188068,188071,0,3,4
53865,3,3,188071,188071,188074,0,3,0
53866,2,3,188073,188074,188077,1,4,0
53867,6,3,188079,188079,188082,0,3,2
53868,6,2,188085,188085,188087,0,2,3
53869,2,3,188087,188087,188090,0,3,0
53870,4,2,188091,188091,188093,0,2,1
53871,1,3,188092,188093,188096,1,4,0
53872,6,1,188098,188098,188099,0,1,2
53873,4,1,188102,188102,188103,0,1,3
53874,1,1,188103,188103,188104,0,1,0
53875,2,1,188105,188105,188106,0,1,1
53876,2,3,188107,188107,188110,0,3,1
53877,1,2,188108,188110,188112,2,4,0
53878,1,1,188109,188112,188113,3,4,0
53879,1,3,188110,188113,188116,3,6,0
53880,1,3,188111,188116,188119,5,8,0
53881,1,1,188112,188119,188120,7,8,0
53882,4,2,188116,188120,188122,4,6,0
53883,3,3,188119,188122,188125,3,6,0
53884,5,3,188124,188125,188128,1,4,0
53885,4,1,188128,188128,188129,0,1,0
53886,4,3,188132,188132,188135,0,3,3
53887,6,1,188138,188138,188139,0,1,3
53888,6,2,188144,188144,188146,0,2,5
53889,6,2,188150,188150,188152,0,2,4
53890,5,1,188155,188155,188156,0,1,3
53891,3,1,188158,188158,188159,0,1,2
53892,2,2,188160,188160,188162,0,2,1
53893,1,1,188161,188162,188163,1,2,0
53894,3,3,188164,188164,188167,0,3,1
53895,5,2,188169,188169,188171,0,2,2
53896,4,3,188173,188173,188176,0,3,2
53897,3,2,188176,188176,188178,0,2,0
53898,5,1,188181,188181,188182,0,1,3
53899,2,2,188183,188183,188185,0,2,1
53900,2,2,188185,188185,188187,0,2,0
53901,2,3,188187,188187,188190,0,3,0
53902,1,3,188188,188190,188193,2,5,0
53903,5,2,188193,188193,188195,0,2,0
53904,4,1,188197,188197,188198,0,1,2
53905,4,2,188201,188201,188203,0,2,3
53906,3,2,188204,188204,188206,0,2,1
53907,5,1,188209,188209,188210,0,1,3
53908,5,1,188214,188214,188215,0,1,4
53909,6,2,188220,188220,188222,0,2,5
53910,3,1,188223,188223,188224,0,1,1
53911,6,2,188229,188229,188231,0,2,5
53912,1,1,188230,188231,188232,1,2,0
53913,1,3,188231,188232,188235,1,4,0
53914,4,2,188235,188235,188237,0,2,0
53915,3,2,188238,188238,188240,0,2,1
53916,6,3,188244,188244,188247,0,3,4
53917,4,2,188248,188248,188250,0,2,1
53918,3,2,188251,188251,188253,0,2,1
53919,2,3,188253,188253,188256,0,3,0
53920,5,2,188258,188258,188260,0,2,2
53921,5,2,188263,188263,188265,0,2,3
53922,2,2,188265,188265,188267,0,2,0
53923,4,1,188269,188269,188270,0,1,2
53924,3,2,188272,188272,188274,0,2,2
53925,5,3,188277,188277,188280,0,3,3
53926,2,1,188279,188280,188281,1,2,0
53927,4,3,188283,188283,188286,0,3,2
53928,6,2,188289,188289,188291,0,2,3
53929,4,3,188293,188293,188296,0,3,2
53930,6,2,188299,188299,188301,0,2,3
53931,4,3,188303,188303,188306,0,3,2
53932,3,3,188306,188306,188309,0,3,0
53933,2,2,188308,188309,188311,1,3,0
53934,4,2,188312,188312,188314,0,2,1
53935,2,1,188314,188314,188315,0,1,0
53936,5,3,188319,188319,188322,0,3,4
53937,2,2,188321,188322,188324,1,3,0
53938,2,2,188323,188324,188326,1,3,0
53939,5,2,188328,188328,188330,0,2,2
53940,4,1,188332,188332,188333,0,1,2
53941,5,1,188337,188337,188338,0,1,4
53942,2,2,188339,188339,188341,0,2,1
53943,2,2,188341,188341,188343,0,2,0
53944,6,3,188347,188347,188350,0,3,4
53945,1,1,188348,188350,188351,2,3,0
53946,4,1,188352,188352,188353,0,1,1
53947,4,3,188356,188356,188359,0,3,3
53948,6,2,188362,188362,188364,0,2,3
53949,2,2,188364,188364,188366,0,2,0
53950,5,3,188369,188369,188372,0,3,3
53951,6,1,188375,188375,188376,0,1,3
53952,4,1,188379,188379,188380,0,1,3
53953,1,2,188380,188380,188382,0,2,0
53954,5,1,188385,188385,188386,0,1,3
53955,1,3,188386,188386,188389,0,3,0
53956,5,2,188391,188391,188393,0,2,2
53957,5,1,188396,188396,188397,0,1,3
53958,4,2,188400,188400,188402,0,2,3
53959,2,2,188402,188402,188404,0,2,0
53960,5,2,188407,188407,188409,0,2,3
53961,6,2,188413,188413,188415,0,2,4
53962,5,3,188418,188418,188421,0,3,3
53963,3,2,188421,188421,188423,0,2,0
53964,1,2,188422,188423,188425,1,3,0
53965,6,2,188428,188428,188430,0,2,3
53966,5,2,188433,188433,188435,0,2,3
53967,2,1,188435,188435,188436,0,1,0
53968,4,2,188439,188439,188441,0,2,3
53969,4,2,188443,188443,188445,0,2,2
53970,4,3,188447,188447,188450,0,3,2
53971,6,2,188453,188453,188455,0,2,3
53972,5,2,188458,188458,188460,0,2,3
53973,2,3,188460,188460,188463,0,3,0
53974,4,2,188464,188464,188466,0,2,1
53975,6,3,188470,188470,188473,0,3,4
53976,1,3,188471,188473,188476,2,5,0
53977,5,2,188476,188476,188478,0,2,0
53978,5,1,188481,188481,188482,0,1,3
53979,1,2,188482,188482,188484,0,2,0
53980,2,3,188484,188484,188487,0,3,0
53981,6,1,188490,188490,188491,0,1,3
53982,4,3,188494,188494,188497,0,3,3
53983,2,2,188496,188497,188499,1,3,0
53984,6,3,188502,188502,188505,0,3,3
53985,2,1,188504,188505,188506,1,2,0
53986,3,3,188507,188507,188510,0,3,1
53987,6,3,188513,188513,188516,0,3,3
53988,3,1,188516,188516,188517,0,1,0
53989,1,1,188517,188517,188518,0,1,0
53990,6,2,188523,188523,188525,0,2,5
53991,2,1,188525,188525,188526,0,1,0
53992,6,3,188531,188531,188534,0,3,5
53993,5,1,188536,188536,188537,0,1,2
53994,1,1,188537,188537,188538,0,1,0
53995,1,2,188538,188538,188540,0,2,0
53996,3,1,188541,188541,188542,0,1,1
53997,2,3,188543,188543,188546,0,3,1
53998,2,2,188545,188546,188548,1,3,0
53999,4,2,188549,188549,188551,0,2,1
54000,1,1,188550,188551,188552,1,2,0
54001,5,1,188555,188555,188556,0,1,3
54002,2,2,188557,188557,188559,0,2,1
54003,4,1,188561,188561,188562,0,1,2
54004,1,3,188562,188562,188565,0,3,0
54005,3,1,188565,188565,188566,0,1,0
54006,1,2,188566,188566,188568,0,2,0
54007,1,1,188567,188568,188569,1,2,0
54008,3,1,188570,188570,188571,0,1,1
54009,1,3,188571,188571,188574,0,3,0
54010,6,3,188577,188577,188580,0,3,3
54011,6,1,188583,188583,188584,0,1,3
54012,5,3,188588,188588,188591,0,3,4
54013,3,2,188591,188591,188593,0,2,0
54014,2,2,188593,188593,188595,0,2,0
54015,1,2,188594,188595,188597,1,3,0
54016,4,3,188598,188598,188601,0,3,1
54017,5,1,188603,188603,188604,0,1,2
54018,2,3,188605,188605,188608,0,3,1
54019,5,1,188610,188610,188611,0,1,2
54020,2,3,188612,188612,188615,0,3,1
54021,4,1,188616,188616,188617,0,1,1
54022,1,2,188617,188617,188619,0,2,0
54023,1,2,188618,188619,188621,1,3,0
54024,5,3,188623,188623,188626,0,3,2
54025,5,1,188628,188628,188629,0,1,2
54026,4,2,188632,188632,188634,0,2,3
54027,5,2,188637,188637,188639,0,2,3
54028,6,2,188643,188643,188645,0,2,4
54029,4,3,188647,188647,188650,0,3,2
54030,6,1,188653,188653,188654,0,1,3
54031,5,1,188658,188658,188659,0,1,4
54032,2,2,188660,188660,188662,0,2,1
54033,3,3,188663,188663,188666,0,3,1
54034,1,2,188664,188666,188668,2,4,0
54035,4,2,188668,188668,188670,0,2,0
54036,6,2,188674,188674,188676,0,2,4
54037,3,2,188677,188677,188679,0,2,1
54038,1,2,188678,188679,188681,1,3,0
54039,6,3,188684,188684,188687,0,3,3
54040,5,1,188689,188689,188690,0,1,2
54041,3,1,188692,188692,188693,0,1,2
54042,3,3,188695,188695,188698,0,3,2
54043,5,2,188700,188700,188702,0,2,2
54044,5,3,188705,188705,188708,0,3,3
54045,5,1,188710,188710,188711,0,1,2
54046,2,1,188712,188712,188713,0,1,1
54047,6,3,188718,188718,188721,0,3,5
54048,5,1,188723,188723,188724,0,1,2
54049,3,3,188726,188726,188729,0,3,2
54050,1,1,188727,188729,188730,2,3,0
54051,2,3,188729,188730,188733,1,4,0
54052,5,3,188734,188734,188737,0,3,1
54053,3,3,188737,188737,188740,0,3,0
54054,2,2,188739,188740,188742,1,3,0
54055,3,3,188742,188742,188745,0,3,0
54056,5,3,188747,188747,188750,0,3,2
54057,6,2,188753,188753,188755,0,2,3
54058,2,1,188755,188755,188756,0,1,0
54059,6,1,188761,188761,188762,0,1,5
54060,6,2,188767,188767,188769,0,2,5
54061,4,2,188771,188771,188773,0,2,2
54062,3,3,188774,188774,188777,0,3,1
54063,3,3,188777,188777,188780,0,3,0
54064,4,3,188781,188781,188784,0,3,1
54065,5,3,188786,188786,188789,0,3,2
54066,3,3,188789,188789,188792,0,3,0
54067,3,1,188792,188792,188793,0,1,0
54068,1,3,188793,188793,188796,0,3,0
54069,6,3,188799,188799,188802,0,3,3
54070,3,2,188802,188802,188804,0,2,0
54071,3,2,188805,188805,188807,0,2,1
54072,6,3,188811,188811,188814,0,3,4
54073,2,1,188813,188814,188815,1,2,0
54074,2,2,188815,188815,188817,0,2,0
54075,2,1,188817,188817,188818,0,1,0
54076,4,1,188821,188821,188822,0,1,3
54077,5,3,188826,188826,188829,0,3,4
54078,3,3,188829,188829,188832,0,3,0
54079,6,1,188835,188835,188836,0,1,3
54080,5,3,188840,188840,188843,0,3,4
54081,6,1,188846,188846,188847,0,1,3
54082,5,3,188851,188851,188854,0,3,4
54083,2,1,188853,188854,188855,1,2,0
54084,3,2,188856,188856,188858,0,2,1
54085,4,2,188860,188860,188862,0,2,2
54086,4,2,188864,188864,188866,0,2,2
54087,5,1,188869,188869,188870,0,1,3
54088,2,3,188871,188871,188874,0,3,1
54089,5,2,188876,188876,188878,0,2,2
54090,3,2,188879,188879,188881,0,2,1
54091,5,1,188884,188884,188885,0,1,3
54092,1,3,188885,188885,188888,0,3,0
54093,4,3,188889,188889,188892,0,3,1
54094,5,1,188894,188894,188895,0,1,2
54095,2,2,188896,188896,188898,0,2,1
54096,4,1,188900,188900,188901,0,1,2
54097,3,3,188903,188903,188906,0,3,2
54098,4,2,188907,188907,188909,0,2,1
54099,1,3,188908,188909,188912,1,4,0
54100,1,3,188909,188912,188915,3,6,0
54101,4,1,188913,188915,188916,2,3,0
54102,6,3,188919,188919,188922,0,3,3
54103,4,3,188923,188923,188926,0,3,1
54104,5,1,188928,188928,188929,0,1,2
54105,5,1,188933,188933,188934,0,1,4
54106,5,2,188938,188938,188940,0,2,4
54107,2,1,188940,188940,188941,0,1,0
54108,2,3,188942,188942,188945,0,3,1
54109,5,3,188947,188947,188950,0,3,2
54110,2,3,188949,188950,188953,1,4,0
54111,1,1,188950,188953,188954,3,4,0
54112,6,3,188956,188956,188959,0,3,2
54113,1,1,188957,188959,188960,2,3,0
54114,5,3,188962,188962,188965,0,3,2
54115,6,2,188968,188968,188970,0,2,3
54116,2,3,188970,188970,188973,0,3,0
54117,2,2,188972,188973,188975,1,3,0
54118,6,1,188978,188978,188979,0,1,3
54119,4,2,188982,188982,188984,0,2,3
54120,3,3,188985,188985,188988,0,3,1
54121,4,3,188989,188989,188992,0,3,1
54122,1,1,188990,188992,188993,2,3,0
54123,3,1,188993,188993,188994,0,1,0
54124,1,1,188994,188994,188995,0,1,0
54125,5,1,188999,188999,189000,0,1,4
54126,5,3,189004,189004,189007,0,3,4
54127,6,1,189010,189010,189011,0,1,3
54128,6,3,189016,189016,189019,0,3,5
54129,1,2,189017,189019,189021,2,4,0
54130,1,1,189018,189021,189022,3,4,0
54131,4,1,189022,189022,189023,0,1,0
54132,1,2,189023,189023,189025,0,2,0
54133,3,2,189026,189026,189028,0,2,1
54134,6,3,189032,189032,189035,0,3,4
54135,5,2,189037,189037,189039,0,2,2
54136,6,3,189043,189043,189046,0,3,4
54137,5,1,189048,189048,189049,0,1,2
54138,4,2,189052,189052,189054,0,2,3
54139,3,2,189055,189055,189057,0,2,1
54140,4,2,189059,189059,189061,0,2,2
54141,3,3,189062,189062,189065,0,3,1
54142,5,1,189067,189067,189068,0,1,2
54143,4,2,189071,189071,189073,0,2,3
54144,5,3,189076,189076,189079,0,3,3
54145,3,3,189079,189079,189082,0,3,0
54146,2,1,189081,189082,189083,1,2,0
54147,6,3,189087,189087,189090,0,3,4
54148,1,1,189088,189090,189091,2,3,0
54149,4,1,189092,189092,189093,0,1,1
54150,2,2,189094,189094,189096,0,2,1
54151,2,2,189096,189096,189098,0,2,0
54152,4,1,189100,189100,189101,0,1,2
54153,6,3,189106,189106,189109,0,3,5
54154,3,1,189109,189109,189110,0,1,0
54155,6,1,189115,189115,189116,0,1,5
54156,4,1,189119,189119,189120,0,1,3
54157,6,2,189125,189125,189127,0,2,5
54158,1,3,189126,189127,189130,1,4,0
54159,4,1,189130,189130,189131,0,1,0
54160,1,1,189131,189131,189132,0,1,0
54161,5,3,189136,189136,189139,0,3,4
54162,1,3,189137,189139,189142,2,5,0
54163,6,1,189143,189143,189144,0,1,1
54164,4,1,189147,189147,189148,0,1,3
54165,5,1,189152,189152,189153,0,1,4
54166,6,1,189158,189158,189159,0,1,5
54167,4,1,189162,189162,189163,0,1,3
54168,5,2,189167,189167,189169,0,2,4
54169,6,1,189173,189173,189174,0,1,4
54170,2,2,189175,189175,189177,0,2,1
54171,4,3,189179,189179,189182,0,3,2
54172,6,3,189185,189185,189188,0,3,3
54173,6,1,189191,189191,189192,0,1,3
54174,2,1,189193,189193,189194,0,1,1
54175,2,3,189195,189195,189198,0,3,1
54176,1,1,189196,189198,189199,2,3,0
54177,4,3,189200,189200,189203,0,3,1
54178,1,1,189201,189203,189204,2,3,0
54179,6,1,189207,189207,189208,0,1,3
54180,2,1,189209,189209,189210,0,1,1
54181,4,3,189213,189213,189216,0,3,3
54182,1,3,189214,189216,189219,2,5,0
54183,2,2,189216,189219,189221,3,5,0
54184,6,1,189222,189222,189223,0,1,1
54185,3,2,189225,189225,189227,0,2,2
54186,1,2,189226,189227,189229,1,3,0
54187,6,1,189232,189232,189233,0,1,3
54188,2,1,189234,189234,189235,0,1,1
54189,1,2,189235,189235,189237,0,2,0
54190,3,1,189238,189238,189239,0,1,1
54191,5,2,189243,189243,189245,0,2,4
54192,2,2,189245,189245,189247,0,2,0
54193,4,1,189249,189249,189250,0,1,2
54194,3,1,189252,189252,189253,0,1,2
54195,2,2,189254,189254,189256,0,2,1
54196,5,2,189259,189259,189261,0,2,3
54197,2,1,189261,189261,189262,0,1,0
54198,3,2,189264,189264,189266,0,2,2
54199,4,1,189268,189268,189269,0,1,2
54200,4,1,189272,189272,189273,0,1,3
54201,5,1,189277,189277,189278,0,1,4
54202,3,3,189280,189280,189283,0,3,2
54203,3,2,189283,189283,189285,0,2,0
54204,2,1,189285,189285,189286,0,1,0
54205,3,2,189288,189288,189290,0,2,2
54206,1,3,189289,189290,189293,1,4,0
54207,4,2,189293,189293,189295,0,2,0
54208,3,1,189296,189296,189297,0,1,1
54209,6,1,189302,189302,189303,0,1,5
54210,1,2,189303,189303,189305,0,2,0
54211,6,1,189309,189309,189310,0,1,4
54212,6,3,189315,189315,189318,0,3,5
54213,5,2,189320,189320,189322,0,2,2
54214,3,2,189323,189323,189325,0,2,1
54215,6,2,189329,189329,189331,0,2,4
54216,6,3,189335,189335,189338,0,3,4
54217,3,3,189338,189338,189341,0,3,0
54218,2,3,189340,189341,189344,1,4,0
54219,3,2,189343,189344,189346,1,3,0
54220,1,3,189344,189346,189349,2,5,0
54221,5,1,189349,189349,189350,0,1,0
54222,1,1,189350,189350,189351,0,1,0
54223,4,1,189354,189354,189355,0,1,3
54224,5,3,189359,189359,189362,0,3,4
54225,2,2,189361,189362,189364,1,3,0
54226,1,2,189362,189364,189366,2,4,0
54227,6,2,189368,189368,189370,0,2,2
54228,1,1,189369,189370,189371,1,2,0
54229,1,2,189370,189371,189373,1,3,0
54230,4,3,189374,189374,189377,0,3,1
54231,1,1,189375,189377,189378,2,3,0
54232,4,2,189379,189379,189381,0,2,1
54233,4,1,189383,189383,189384,0,1,2
54234,5,2,189388,189388,189390,0,2,4
54235,1,3,189389,189390,189393,1,4,0
54236,2,1,189391,189393,189394,2,3,0
54237,5,3,189396,189396,189399,0,3,2
54238,3,3,189399,189399,189402,0,3,0
54239,1,1,189400,189402,189403,2,3,0
54240,5,1,189405,189405,189406,0,1,2
54241,6,3,189411,189411,189414,0,3,5
54242,1,1,189412,189414,189415,2,3,0
54243,6,3,189418,189418,189421,0,3,3
54244,1,1,189419,189421,189422,2,3,0
54245,5,2,189424,189424,189426,0,2,2
54246,2,3,189426,189426,189429,0,3,0
54247,1,2,189427,189429,189431,2,4,0
54248,1,3,189428,189431,189434,3,6,0
54249,5,3,189433,189434,189437,1,4,0
54250,4,3,189437,189437,189440,0,3,0
54251,1,3,189438,189440,189443,2,5,0
54252,5,1,189443,189443,189444,0,1,0
54253,6,3,189449,189449,189452,0,3,5
54254,2,1,189451,189452,189453,1,2,0
54255,6,1,189457,189457,189458,0,1,4
54256,6,3,189463,189463,189466,0,3,5
54257,1,1,189464,189466,189467,2,3,0
54258,1,2,189465,189467,189469,2,4,0
54259,4,1,189469,189469,189470,0,1,0
54260,4,1,189473,189473,189474,0,1,3
54261,5,3,189478,189478,189481,0,3,4
54262,6,3,189484,189484,189487,0,3,3
54263,2,1,189486,189487,189488,1,2,0
54264,1,1,189487,189488,189489,1,2,0
54265,5,1,189492,189492,189493,0,1,3
54266,1,2,189493,189493,189495,0,2,0
54267,2,3,189495,189495,189498,0,3,0
54268,5,2,189500,189500,189502,0,2,2
54269,5,2,189505,189505,189507,0,2,3
54270,5,3,189510,189510,189513,0,3,3
54271,5,2,189515,189515,189517,0,2,2
54272,1,1,189516,189517,189518,1,2,0
54273,2,2,189518,189518,189520,0,2,0
54274,4,2,189522,189522,189524,0,2,2
54275,6,3,189528,189528,189531,0,3,4
54276,4,2,189532,189532,189534,0,2,1
54277,1,1,189533,189534,189535,1,2,0
54278,2,1,189535,189535,189536,0,1,0
54279,2,1,189537,189537,189538,0,1,1
54280,6,3,189543,189543,189546,0,3,5
54281,4,3,189547,189547,189550,0,3,1
54282,1,3,189548,189550,189553,2,5,0
54283,6,3,189554,189554,189557,0,3,1
54284,2,2,189556,189557,189559,1,3,0
54285,4,3,189560,189560,189563,0,3,1
54286,6,1,189566,189566,189567,0,1,3
54287,5,2,189571,189571,189573,0,2,4
54288,2,2,189573,189573,189575,0,2,0
54289,6,2,189579,189579,189581,0,2,4
54290,4,1,189583,189583,189584,0,1,2
54291,2,2,189585,189585,189587,0,2,1
54292,3,3,189588,189588,189591,0,3,1
54293,2,3,189590,189591,189594,1,4,0
54294,4,3,189594,189594,189597,0,3,0
54295,5,3,189599,189599,189602,0,3,2
54296,4,2,189603,189603,189605,0,2,1
54297,6,3,189609,189609,189612,0,3,4
54298,5,2,189614,189614,189616,0,2,2
54299,2,2,189616,189616,189618,0,2,0
54300,3,2,189619,189619,189621,0,2,1
54301,6,3,189625,189625,189628,0,3,4
54302,5,3,189630,189630,189633,0,3,2
54303,5,3,189635,189635,189638,0,3,2
54304,2,1,189637,189638,189639,1,2,0
54305,2,2,189639,189639,189641,0,2,0
54306,5,1,189644,189644,189645,0,1,3
54307,2,3,189646,189646,189649,0,3,1
54308,5,1,189651,189651,189652,0,1,2
54309,6,2,189657,189657,189659,0,2,5
54310,6,1,189663,189663,189664,0,1,4
54311,6,2,189669,189669,189671,0,2,5
54312,5,1,189674,189674,189675,0,1,3
54313,1,3,189675,189675,189678,0,3,0
54314,2,3,189677,189678,189681,1,4,0
54315,1,1,189678,189681,189682,3,4,0
54316,1,2,189679,189682,189684,3,5,0
54317,5,1,189684,189684,189685,0,1,0
54318,1,1,189685,189685,189686,0,1,0
54319,6,1,189691,189691,189692,0,1,5
54320,5,2,189696,189696,189698,0,2,4
54321,2,2,189698,189698,189700,0,2,0
54322,4,3,189702,189702,189705,0,3,2
54323,4,1,189706,189706,189707,0,1,1
54324,4,3,189710,189710,189713,0,3,3
54325,2,2,189712,189713,189715,1,3,0
54326,1,2,189713,189715,189717,2,4,0
54327,1,1,189714,189717,189718,3,4,0
54328,6,3,189720,189720,189723,0,3,2
54329,3,3,189723,189723,189726,0,3,0
54330,1,1,189724,189726,189727,2,3,0
54331,6,1,189730,189730,189731,0,1,3
54332,6,1,189736,189736,189737,0,1,5
54333,3,2,189739,189739,189741,0,2,2
54334,6,1,189745,189745,189746,0,1,4
54335,5,2,189750,189750,189752,0,2,4
54336,2,2,189752,189752,189754,0,2,0
54337,5,2,189757,189757,189759,0,2,3
54338,5,3,189762,189762,189765,0,3,3
54339,3,1,189765,189765,189766,0,1,0
54340,4,1,189769,189769,189770,0,1,3
54341,1,1,189770,189770,189771,0,1,0
54342,5,1,189775,189775,189776,0,1,4
54343,6,2,189781,189781,189783,0,2,5
54344,1,2,189782,189783,189785,1,3,0
54345,2,1,189784,189785,189786,1,2,0
54346,2,2,189786,189786,189788,0,2,0
54347,3,3,189789,189789,189792,0,3,1
54348,4,3,189793,189793,189796,0,3,1
54349,4,2,189797,189797,189799,0,2,1
54350,6,2,189803,189803,189805,0,2,4
54351,2,1,189805,189805,189806,0,1,0
54352,6,1,189811,189811,189812,0,1,5
54353,3,2,189814,189814,189816,0,2,2
54354,1,2,189815,189816,189818,1,3,0
54355,4,3,189819,189819,189822,0,3,1
54356,5,2,189824,189824,189826,0,2,2
54357,2,2,189826,189826,189828,0,2,0
54358,6,2,189832,189832,189834,0,2,4
54359,6,3,189838,189838,189841,0,3,4
54360,2,1,189840,189841,189842,1,2,0
54361,5,1,189845,189845,189846,0,1,3
54362,4,2,189849,189849,189851,0,2,3
54363,1,1,189850,189851,189852,1,2,0
54364,1,3,189851,189852,189855,1,4,0
54365,4,2,189855,189855,189857,0,2,0
54366,4,1,189859,189859,189860,0,1,2
54367,1,2,189860,189860,189862,0,2,0
54368,4,1,189864,189864,189865,0,1,2
54369,1,1,189865,189865,189866,0,1,0
54370,5,3,189870,189870,189873,0,3,4
54371,4,3,189874,189874,189877,0,3,1
54372,1,1,189875,189877,189878,2,3,0
54373,1,1,189876,189878,189879,2,3,0
54374,5,1,189881,189881,189882,0,1,2
54375,1,3,189882,189882,189885,0,3,0
54376,4,3,189886,189886,189889,0,3,1
54377,3,3,189889,189889,189892,0,3,0
54378,3,2,189892,189892,189894,0,2,0
54379,4,1,189896,189896,189897,0,1,2
54380,5,3,189901,189901,189904,0,3,4
54381,6,1,189907,189907,189908,0,1,3
54382,1,3,189908,189908,189911,0,3,0
54383,3,1,189911,189911,189912,0,1,0
54384,4,2,189915,189915,189917,0,2,3
54385,4,3,189919,189919,189922,0,3,2
54386,4,2,189923,189923,189925,0,2,1
54387,2,1,189925,189925,189926,0,1,0
54388,4,3,189929,189929,189932,0,3,3
54389,4,2,189933,189933,189935,0,2,1
54390,5,2,189938,189938,189940,0,2,3
54391,3,1,189941,189941,189942,0,1,1
54392,5,1,189946,189946,189947,0,1,4
54393,5,2,189951,189951,189953,0,2,4
54394,4,3,189955,189955,189958,0,3,2
54395,2,3,189957,189958,189961,1,4,0
54396,2,1,189959,189961,189962,2,3,0
54397,1,3,189960,189962,189965,2,5,0
54398,3,3,189963,189965,189968,2,5,0
54399,3,2,189966,189968,189970,2,4,0
54400,5,2,189971,189971,189973,0,2,1
54401,6,3,189977,189977,189980,0,3,4
54402,1,2,189978,189980,189982,2,4,0
54403,1,2,189979,189982,189984,3,5,0
54404,6,3,189985,189985,189988,0,3,1
54405,5,1,189990,189990,189991,0,1,2
54406,5,1,189995,189995,189996,0,1,4
54407,6,1,190001,190001,190002,0,1,5
54408,3,2,190004,190004,190006,0,2,2
54409,3,2,190007,190007,190009,0,2,1
54410,5,3,190012,190012,190015,0,3,3
54411,5,1,190017,190017,190018,0,1,2
54412,2,1,190019,190019,190020,0,1,1
54413,5,3,190024,190024,190027,0,3,4
54414,5,3,190029,190029,190032,0,3,2
54415,2,1,190031,190032,190033,1,2,0
54416,2,2,190033,190033,190035,0,2,0
54417,4,1,190037,190037,190038,0,1,2
54418,5,3,190042,190042,190045,0,3,4
54419,2,3,190044,190045,190048,1,4,0
54420,3,3,190047,190048,190051,1,4,0
54421,3,2,190050,190051,190053,1,3,0
54422,3,3,190053,190053,190056,0,3,0
54423,6,2,190059,190059,190061,0,2,3
54424,2,1,190061,190061,190062,0,1,0
54425,5,1,190066,190066,190067,0,1,4
54426,6,1,190072,190072,190073,0,1,5
54427,6,3,190078,190078,190081,0,3,5
54428,1,1,190079,190081,190082,2,3,0
54429,5,1,190084,190084,190085,0,1,2
54430,3,2,190087,190087,190089,0,2,2
54431,4,1,190091,190091,190092,0,1,2
54432,1,2,190092,190092,190094,0,2,0
54433,2,2,190094,190094,190096,0,2,0
54434,6,2,190100,190100,190102,0,2,4
54435,5,2,190105,190105,190107,0,2,3
54436,6,3,190111,190111,190114,0,3,4
54437,4,2,190115,190115,190117,0,2,1
54438,5,2,190120,190120,190122,0,2,3
54439,3,1,190123,190123,190124,0,1,1
54440,5,2,190128,190128,190130,0,2,4
54441,6,3,190134,190134,190137,0,3,4
54442,1,3,190135,190137,190140,2,5,0
54443,2,1,190137,190140,190141,3,4,0
54444,4,3,190141,190141,190144,0,3,0
54445,1,1,190142,190144,190145,2,3,0
54446,6,3,190148,190148,190151,0,3,3
54447,5,1,190153,190153,190154,0,1,2
54448,2,2,190155,190155,190157,0,2,1
54449,5,2,190160,190160,190162,0,2,3
54450,1,3,190161,190162,190165,1,4,0
54451,3,3,190164,190165,190168,1,4,0
54452,3,1,190167,190168,190169,1,2,0
54453,1,1,190168,190169,190170,1,2,0
54454,3,2,190171,190171,190173,0,2,1
54455,1,2,190172,190173,190175,1,3,0
54456,2,2,190174,190175,190177,1,3,0
54457,5,3,190179,190179,190182,0,3,2
54458,5,1,190184,190184,190185,0,1,2
54459,2,3,190186,190186,190189,0,3,1
54460,4,2,190190,190190,190192,0,2,1
54461,1,2,190191,190192,190194,1,3,0
54462,4,2,190195,190195,190197,0,2,1
54463,5,1,190200,190200,190201,0,1,3
54464,2,1,190202,190202,190203,0,1,1
54465,1,3,190203,190203,190206,0,3,0
54466,2,1,190205,190206,190207,1,2,0
54467,4,3,190209,190209,190212,0,3,2
54468,5,1,190214,190214,190215,0,1,2
54469,6,1,190220,190220,190221,0,1,5
54470,5,3,190225,190225,190228,0,3,4
54471,4,2,190229,190229,190231,0,2,1
54472,4,2,190233,190233,190235,0,2,2
54473,1,3,190234,190235,190238,1,4,0
54474,1,1,190235,190238,190239,3,4,0
54475,4,3,190239,190239,190242,0,3,0
54476,4,2,190243,190243,190245,0,2,1
54477,5,3,190248,190248,190251,0,3,3
54478,1,3,190249,190251,190254,2,5,0
54479,3,2,190252,190254,190256,2,4,0
54480,3,1,190255,190256,190257,1,2,0
54481,4,3,190259,190259,190262,0,3,2
54482,2,2,190261,190262,190264,1,3,0
54483,3,3,190264,190264,190267,0,3,0
54484,2,2,190266,190267,190269,1,3,0
54485,6,2,190272,190272,190274,0,2,3
54486,6,2,190278,190278,190280,0,2,4
54487,3,2,190281,190281,190283,0,2,1
54488,6,1,190287,190287,190288,0,1,4
54489,3,1,190290,190290,190291,0,1,2
54490,3,1,190293,190293,190294,0,1,2
54491,2,1,190295,190295,190296,0,1,1
54492,1,1,190296,190296,190297,0,1,0
54493,6,3,190302,190302,190305,0,3,5
54494,4,1,190306,190306,190307,0,1,1
54495,1,2,190307,190307,190309,0,2,0
54496,3,2,190310,190310,190312,0,2,1
54497,2,3,190312,190312,190315,0,3,0
54498,5,3,190317,190317,190320,0,3,2
54499,4,3,190321,190321,190324,0,3,1
54500,3,1,190324,190324,190325,0,1,0
54501,1,2,190325,190325,190327,0,2,0
54502,2,2,190327,190327,190329,0,2,0
54503,4,1,190331,190331,190332,0,1,2
54504,3,2,190334,190334,190336,0,2,2
54505,3,1,190337,190337,190338,0,1,1
54506,2,1,190339,190339,190340,0,1,1
54507,4,1,190343,190343,190344,0,1,3
54508,5,1,190348,190348,190349,0,1,4
54509,1,1,190349,190349,190350,0,1,0
54510,3,1,190352,190352,190353,0,1,2
54511,1,2,190353,190353,190355,0,2,0
54512,2,3,190355,190355,190358,0,3,0
54513,6,2,190361,190361,190363,0,2,3
54514,5,2,190366,190366,190368,0,2,3
54515,6,1,190372,190372,190373,0,1,4
54516,6,1,190378,190378,190379,0,1,5
54517,1,3,190379,190379,190382,0,3,0
54518,6,3,190385,190385,190388,0,3,3
54519,4,1,190389,190389,190390,0,1,1
54520,2,2,190391,190391,190393,0,2,1
54521,6,1,190397,190397,190398,0,1,4
54522,3,1,190400,190400,190401,0,1,2
54523,3,1,190403,190403,190404,0,1,2
54524,3,1,190406,190406,190407,0,1,2
54525,2,1,190408,190408,190409,0,1,1
54526,4,1,190412,190412,190413,0,1,3
54527,1,3,190413,190413,190416,0,3,0
54528,1,1,190414,190416,190417,2,3,0
54529,4,1,190418,190418,190419,0,1,1
54530,6,1,190424,190424,190425,0,1,5
54531,6,3,190430,190430,190433,0,3,5
54532,1,1,190431,190433,190434,2,3,0
54533,6,3,190437,190437,190440,0,3,3
54534,5,1,190442,190442,190443,0,1,2
54535,6,3,190448,190448,190451,0,3,5
54536,2,2,190450,190451,190453,1,3,0
54537,4,2,190454,190454,190456,0,2,1
54538,5,2,190459,190459,190461,0,2,3
54539,6,1,190465,190465,190466,0,1,4
54540,5,1,190470,190470,190471,0,1,4
54541,1,2,190471,190471,190473,0,2,0
54542,5,3,190476,190476,190479,0,3,3
54543,1,1,190477,190479,190480,2,3,0
54544,4,3,190481,190481,190484,0,3,1
54545,3,2,190484,190484,190486,0,2,0
54546,5,2,190489,190489,190491,0,2,3
54547,2,2,190491,190491,190493,0,2,0
54548,3,3,190494,190494,190497,0,3,1
54549,2,1,190496,190497,190498,1,2,0
54550,4,2,190500,190500,190502,0,2,2
54551,4,3,190504,190504,190507,0,3,2
54552,5,3,190509,190509,190512,0,3,2
54553,5,1,190514,190514,190515,0,1,2
54554,2,3,190516,190516,190519,0,3,1
54555,5,1,190521,190521,190522,0,1,2
54556,3,1,190524,190524,190525,0,1,2
54557,4,1,190528,190528,190529,0,1,3
54558,6,1,190534,190534,190535,0,1,5
54559,6,3,190540,190540,190543,0,3,5
54560,6,1,190546,190546,190547,0,1,3
54561,1,3,190547,190547,190550,0,3,0
54562,2,1,190549,190550,190551,1,2,0
54563,2,3,190551,190551,190554,0,3,0
54564,4,3,190555,190555,190558,0,3,1
54565,2,3,190557,190558,190561,1,4,0
54566,6,1,190563,190563,190564,0,1,2
54567,3,1,190566,190566,190567,0,1,2
54568,4,3,190570,190570,190573,0,3,3
54569,6,3,190576,190576,190579,0,3,3
54570,1,2,190577,190579,190581,2,4,0
54571,5,3,190582,190582,190585,0,3,1
54572,2,3,190584,190585,190588,1,4,0
54573,3,2,190587,190588,190590,1,3,0
54574,4,1,190591,190591,190592,0,1,1
54575,5,3,190596,190596,190599,0,3,4
54576,4,1,190600,190600,190601,0,1,1
54577,3,3,190603,190603,190606,0,3,2
54578,1,3,190604,190606,190609,2,5,0
54579,2,3,190606,190609,190612,3,6,0
54580,2,2,190608,190612,190614,4,6,0
54581,2,3,190610,190614,190617,4,7,0
54582,5,1,190615,190617,190618,2,3,0
54583,2,2,190617,190618,190620,1,3,0
54584,4,3,190621,190621,190624,0,3,1
54585,5,3,190626,190626,190629,0,3,2
54586,1,1,190627,190629,190630,2,3,0
54587,3,3,190630,190630,190633,0,3,0
54588,4,3,190634,190634,190637,0,3,1
54589,6,3,190640,190640,190643,0,3,3
54590,6,2,190646,190646,190648,0,2,3
54591,2,3,190648,190648,190651,0,3,0
54592,6,1,190654,190654,190655,0,1,3
54593,2,2,190656,190656,190658,0,2,1
54594,3,2,190659,190659,190661,0,2,1
54595,2,2,190661,190661,190663,0,2,0
54596,2,3,190663,190663,190666,0,3,0
54597,2,3,190665,190666,190669,1,4,0
54598,3,3,190668,190669,190672,1,4,0
54599,3,2,190671,190672,190674,1,3,0
54600,1,1,190672,190674,190675,2,3,0
54601,2,3,190674,190675,190678,1,4,0
54602,3,2,190677,190678,190680,1,3,0
54603,3,2,190680,190680,190682,0,2,0
54604,1,1,190681,190682,190683,1,2,0
54605,2,3,190683,190683,190686,0,3,0
54606,6,1,190689,190689,190690,0,1,3
54607,6,2,190695,190695,190697,0,2,5
54608,4,1,190699,190699,190700,0,1,2
54609,3,1,190702,190702,190703,0,1,2
54610,4,3,190706,190706,190709,0,3,3
54611,3,2,190709,190709,190711,0,2,0
54612,6,1,190715,190715,190716,0,1,4
54613,3,1,190718,190718,190719,0,1,2
54614,5,2,190723,190723,190725,0,2,4
54615,4,3,190727,190727,190730,0,3,2
54616,3,3,190730,190730,190733,0,3,0
54617,6,2,190736,190736,190738,0,2,3
54618,5,2,190741,190741,190743,0,2,3
54619,4,1,190745,190745,190746,0,1,2
54620,6,2,190751,190751,190753,0,2,5
54621,1,1,190752,190753,190754,1,2,0
54622,2,3,190754,190754,190757,0,3,0
54623,1,2,190755,190757,190759,2,4,0
54624,1,3,190756,190759,190762,3,6,0
54625,2,2,190758,190762,190764,4,6,0
54626,4,2,190762,190764,190766,2,4,0
54627,6,2,190768,190768,190770,0,2,2
54628,5,2,190773,190773,190775,0,2,3
54629,6,2,190779,190779,190781,0,2,4
54630,3,2,190782,190782,190784,0,2,1
54631,5,2,190787,190787,190789,0,2,3
54632,5,1,190792,190792,190793,0,1,3
54633,4,3,190796,190796,190799,0,3,3
54634,4,1,190800,190800,190801,0,1,1
54635,5,1,190805,190805,190806,0,1,4
54636,1,2,190806,190806,190808,0,2,0
54637,1,3,190807,190808,190811,1,4,0
54638,6,1,190813,190813,190814,0,1,2
54639,4,1,190817,190817,190818,0,1,3
54640,3,2,190820,190820,190822,0,2,2
54641,6,2,190826,190826,190828,0,2,4
54642,5,2,190831,190831,190833,0,2,3
54643,3,2,190834,190834,190836,0,2,1
54644,1,2,190835,190836,190838,1,3,0
54645,6,3,190841,190841,190844,0,3,3
54646,6,2,190847,190847,190849,0,2,3
54647,2,1,190849,190849,190850,0,1,0
54648,2,1,190851,190851,190852,0,1,1
54649,2,1,190853,190853,190854,0,1,1
54650,6,2,190859,190859,190861,0,2,5
54651,5,1,190864,190864,190865,0,1,3
54652,2,1,190866,190866,190867,0,1,1
54653,3,1,190869,190869,190870,0,1,2
54654,5,1,190874,190874,190875,0,1,4
54655,4,3,190878,190878,190881,0,3,3
54656,1,3,190879,190881,190884,2,5,0
54657,2,2,190881,190884,190886,3,5,0
54658,2,3,190883,190886,190889,3,6,0
54659,2,3,190885,190889,190892,4,7,0
54660,5,1,190890,190892,190893,2,3,0
54661,5,1,190895,190895,190896,0,1,2
54662,6,3,190901,190901,190904,0,3,5
54663,4,3,190905,190905,190908,0,3,1
54664,2,3,190907,190908,190911,1,4,0
54665,2,3,190909,190911,190914,2,5,0
54666,6,3,190915,190915,190918,0,3,1
54667,6,3,190921,190921,190924,0,3,3
54668,2,2,190923,190924,190926,1,3,0
54669,1,1,190924,190926,190927,2,3,0
54670,2,3,190926,190927,190930,1,4,0
54671,3,3,190929,190930,190933,1,4,0
54672,4,3,190933,190933,190936,0,3,0
54673,1,1,190934,190936,190937,2,3,0
54674,4,1,190938,190938,190939,0,1,1
54675,2,2,190940,190940,190942,0,2,1
54676,1,1,190941,190942,190943,1,2,0
54677,6,2,190947,190947,190949,0,2,4
54678,4,1,190951,190951,190952,0,1,2
54679,6,3,190957,190957,190960,0,3,5
54680,4,1,190961,190961,190962,0,1,1
54681,1,3,190962,190962,190965,0,3,0
54682,3,2,190965,190965,190967,0,2,0
54683,4,1,190969,190969,190970,0,1,2
54684,2,3,190971,190971,190974,0,3,1
54685,1,2,190972,190974,190976,2,4,0
54686,2,1,190974,190976,190977,2,3,0
54687,3,1,190977,190977,190978,0,1,0
54688,1,2,190978,190978,190980,0,2,0
54689,2,2,190980,190980,190982,0,2,0
54690,4,1,190984,190984,190985,0,1,2
54691,2,3,190986,190986,190989,0,3,1
54692,3,2,190989,190989,190991,0,2,0
54693,6,3,190995,190995,190998,0,3,4
54694,4,1,190999,190999,191000,0,1,1
54695,5,2,191004,191004,191006,0,2,4
54696,6,3,191010,191010,191013,0,3,4
54697,3,1,191013,191013,191014,0,1,0
54698,1,2,191014,191014,191016,0,2,0
54699,3,1,191017,191017,191018,0,1,1
54700,3,1,191020,191020,191021,0,1,2
54701,5,3,191025,191025,191028,0,3,4
54702,6,1,191031,191031,191032,0,1,3
54703,5,1,191036,191036,191037,0,1,4
54704,3,2,191039,191039,191041,0,2,2
54705,4,3,191043,191043,191046,0,3,2
54706,4,1,191047,191047,191048,0,1,1
54707,4,3,191051,191051,191054,0,3,3
54708,3,3,191054,191054,191057,0,3,0
54709,1,3,191055,191057,191060,2,5,0
54710,4,2,191059,191060,191062,1,3,0
54711,1,1,191060,191062,191063,2,3,0
54712,6,1,191066,191066,191067,0,1,3
54713,1,1,191067,191067,191068,0,1,0
54714,4,1,191071,191071,191072,0,1,3
54715,1,1,191072,191072,191073,0,1,0
54716,2,3,191074,191074,191077,0,3,1
54717,1,3,191075,191077,191080,2,5,0
54718,2,2,191077,191080,191082,3,5,0
54719,5,3,191082,191082,191085,0,3,0
54720,4,3,191086,191086,191089,0,3,1
54721,2,2,191088,191089,191091,1,3,0
54722,4,3,191092,191092,191095,0,3,1
54723,2,1,191094,191095,191096,1,2,0
54724,2,3,191096,191096,191099,0,3,0
54725,6,2,191102,191102,191104,0,2,3
54726,2,1,191104,191104,191105,0,1,0
54727,1,1,191105,191105,191106,0,1,0
54728,2,3,191107,191107,191110,0,3,1
54729,4,2,191111,191111,191113,0,2,1
54730,1,2,191112,191113,191115,1,3,0
54731,2,3,191114,191115,191118,1,4,0
54732,4,3,191118,191118,191121,0,3,0
54733,4,3,191122,191122,191125,0,3,1
54734,3,2,191125,191125,191127,0,2,0
54735,6,3,191131,191131,191134,0,3,4
54736,2,3,191133,191134,191137,1,4,0
54737,4,2,191137,191137,191139,0,2,0
54738,6,2,191143,191143,191145,0,2,4
54739,3,3,191146,191146,191149,0,3,1
54740,2,2,191148,191149,191151,1,3,0
54741,3,1,191151,191151,191152,0,1,0
54742,1,1,191152,191152,191153,0,1,0
54743,3,2,191155,191155,191157,0,2,2
54744,1,3,191156,191157,191160,1,4,0
54745,1,3,191157,191160,191163,3,6,0
54746,1,1,191158,191163,191164,5,6,0
54747,3,3,191161,191164,191167,3,6,0
54748,2,3,191163,191167,191170,4,7,0
54749,1,3,191164,191170,191173,6,9,0
54750,1,3,191165,191173,191176,8,11,0
54751,2,2,191167,191176,191178,9,11,0
54752,2,3,191169,191178,191181,9,12,0
54753,2,3,191171,191181,191184,10,13,0
54754,2,3,191173,191184,191187,11,14,0
54755,5,3,191178,191187,191190,9,12,0
54756,3,3,191181,191190,191193,9,12,0
54757,5,2,191186,191193,191195,7,9,0
54758,1,2,191187,191195,191197,8,10,0
54759,6,2,191193,191197,191199,4,6,0
54760,2,2,191195,191199,191201,4,6,0
54761,6,2,191201,191201,191203,0,2,0
54762,3,1,191204,191204,191205,0,1,1
54763,6,2,191210,191210,191212,0,2,5
54764,2,3,191212,191212,191215,0,3,0
54765,2,3,191214,191215,191218,1,4,0
54766,3,1,191217,191218,191219,1,2,0
54767,1,1,191218,191219,191220,1,2,0
54768,4,1,191222,191222,191223,0,1,2
54769,5,3,191227,191227,191230,0,3,4
54770,3,1,191230,191230,191231,0,1,0
54771,5,1,191235,191235,191236,0,1,4
54772,5,2,191240,191240,191242,0,2,4
54773,2,3,191242,191242,191245,0,3,0
54774,5,2,191247,191247,191249,0,2,2
54775,6,2,191253,191253,191255,0,2,4
54776,4,2,191257,191257,191259,0,2,2
54777,1,3,191258,191259,191262,1,4,0
54778,5,2,191263,191263,191265,0,2,1
54779,3,2,191266,191266,191268,0,2,1
54780,3,1,191269,191269,191270,0,1,1
54781,6,2,191275,191275,191277,0,2,5
54782,3,3,191278,191278,191281,0,3,1
54783,5,2,191283,191283,191285,0,2,2
54784,3,2,191286,191286,191288,0,2,1
54785,4,1,191290,191290,191291,0,1,2
54786,6,1,191296,191296,191297,0,1,5
54787,3,2,191299,191299,191301,0,2,2
54788,4,3,191303,191303,191306,0,3,2
54789,4,2,191307,191307,191309,0,2,1
54790,3,3,191310,191310,191313,0,3,1
54791,1,1,191311,191313,191314,2,3,0
54792,6,1,191317,191317,191318,0,1,3
54793,2,2,191319,191319,191321,0,2,1
54794,6,1,191325,191325,191326,0,1,4
54795,4,3,191329,191329,191332,0,3,3
54796,1,1,191330,191332,191333,2,3,0
54797,5,2,191335,191335,191337,0,2,2
54798,6,2,191341,191341,191343,0,2,4
54799,5,1,191346,191346,191347,0,1,3
54800,2,3,191348,191348,191351,0,3,1
54801,5,2,191353,191353,191355,0,2,2
54802,6,3,191359,191359,191362,0,3,4
54803,2,3,191361,191362,191365,1,4,0
54804,1,1,191362,191365,191366,3,4,0
54805,1,2,191363,191366,191368,3,5,0
54806,6,2,191369,191369,191371,0,2,1
54807,2,3,191371,191371,191374,0,3,0
54808,6,1,191377,191377,191378,0,1,3
54809,4,2,191381,191381,191383,0,2,3
54810,3,1,191384,191384,191385,0,1,1
54811,1,2,191385,191385,191387,0,2,0
54812,2,3,191387,191387,191390,0,3,0
54813,1,1,191388,191390,191391,2,3,0
54814,6,1,191394,191394,191395,0,1,3
54815,6,3,191400,191400,191403,0,3,5
54816,6,3,191406,191406,191409,0,3,3
54817,6,1,191412,191412,191413,0,1,3
54818,5,1,191417,191417,191418,0,1,4
54819,4,3,191421,191421,191424,0,3,3
54820,2,3,191423,191424,191427,1,4,0
54821,4,3,191427,191427,191430,0,3,0
54822,5,2,191432,191432,191434,0,2,2
54823,5,3,191437,191437,191440,0,3,3
54824,5,3,191442,191442,191445,0,3,2
54825,2,3,191444,191445,191448,1,4,0
54826,3,2,191447,191448,191450,1,3,0
54827,4,1,191451,191451,191452,0,1,1
54828,1,3,191452,191452,191455,0,3,0
54829,3,1,191455,191455,191456,0,1,0
54830,2,1,191457,191457,191458,0,1,1
54831,2,3,191459,191459,191462,0,3,1
54832,1,3,191460,191462,191465,2,5,0
54833,5,1,191465,191465,191466,0,1,0
54834,6,1,191471,191471,191472,0,1,5
54835,4,1,191475,191475,191476,0,1,3
54836,3,3,191478,191478,191481,0,3,2
54837,2,1,191480,191481,191482,1,2,0
54838,5,2,191485,191485,191487,0,2,3
54839,5,3,191490,191490,191493,0,3,3
54840,1,3,191491,191493,191496,2,5,0
54841,2,2,191493,191496,191498,3,5,0
54842,2,3,191495,191498,191501,3,6,0
54843,2,2,191497,191501,191503,4,6,0
54844,2,3,191499,191503,191506,4,7,0
54845,1,1,191500,191506,191507,6,7,0
54846,6,1,191506,191507,191508,1,2,0
54847,4,1,191510,191510,191511,0,1,2
54848,2,2,191512,191512,191514,0,2,1
54849,1,2,191513,191514,191516,1,3,0
54850,1,2,191514,191516,191518,2,4,0
54851,3,2,191517,191518,191520,1,3,0
54852,5,1,191522,191522,191523,0,1,2
54853,2,1,191524,191524,191525,0,1,1
54854,5,3,191529,191529,191532,0,3,4
54855,1,2,191530,191532,191534,2,4,0
54856,6,3,191536,191536,191539,0,3,2
54857,2,3,191538,191539,191542,1,4,0
54858,2,1,191540,191542,191543,2,3,0
54859,1,1,191541,191543,191544,2,3,0
54860,2,1,191543,191544,191545,1,2,0
54861,2,3,191545,191545,191548,0,3,0
54862,5,3,191550,191550,191553,0,3,2
54863,5,1,191555,191555,191556,0,1,2
54864,2,2,191557,191557,191559,0,2,1
54865,6,2,191563,191563,191565,0,2,4
54866,1,2,191564,191565,191567,1,3,0
54867,4,1,191568,191568,191569,0,1,1
54868,3,1,191571,191571,191572,0,1,2
54869,2,3,191573,191573,191576,0,3,1
54870,3,1,191576,191576,191577,0,1,0
54871,6,3,191582,191582,191585,0,3,5
54872,5,3,191587,191587,191590,0,3,2
54873,6,2,191593,191593,191595,0,2,3
54874,1,2,191594,191595,191597,1,3,0
54875,2,3,191596,191597,191600,1,4,0
54876,4,3,191600,191600,191603,0,3,0
54877,3,2,191603,191603,191605,0,2,0
54878,6,2,191609,191609,191611,0,2,4
54879,6,3,191615,191615,191618,0,3,4
54880,4,2,191619,191619,191621,0,2,1
54881,6,3,191625,191625,191628,0,3,4
54882,6,1,191631,191631,191632,0,1,3
54883,4,1,191635,191635,191636,0,1,3
54884,3,2,191638,191638,191640,0,2,2
54885,2,3,191640,191640,191643,0,3,0
54886,2,3,191642,191643,191646,1,4,0
54887,2,2,191644,191646,191648,2,4,0
54888,6,1,191650,191650,191651,0,1,2
54889,3,2,191653,191653,191655,0,2,2
54890,4,3,191657,191657,191660,0,3,2
54891,6,2,191663,191663,191665,0,2,3
54892,2,2,191665,191665,191667,0,2,0
54893,3,1,191668,191668,191669,0,1,1
54894,1,2,191669,191669,191671,0,2,0
54895,6,1,191675,191675,191676,0,1,4
54896,1,2,191676,191676,191678,0,2,0
54897,2,1,191678,191678,191679,0,1,0
54898,2,1,191680,191680,191681,0,1,1
54899,6,1,191686,191686,191687,0,1,5
54900,1,1,191687,191687,191688,0,1,0
54901,5,2,191692,191692,191694,0,2,4
54902,3,3,191695,191695,191698,0,3,1
54903,6,1,191701,191701,191702,0,1,3
54904,4,2,191705,191705,191707,0,2,3
54905,5,1,191710,191710,191711,0,1,3
54906,5,3,191715,191715,191718,0,3,4
54907,1,1,191716,191718,191719,2,3,0
54908,2,2,191718,191719,191721,1,3,0
54909,2,1,191720,191721,191722,1,2,0
54910,6,2,191726,191726,191728,0,2,4
54911,3,3,191729,191729,191732,0,3,1
54912,3,2,191732,191732,191734,0,2,0
54913,2,1,191734,191734,191735,0,1,0
54914,1,1,191735,191735,191736,0,1,0
54915,3,1,191738,191738,191739,0,1,2
54916,2,3,191740,191740,191743,0,3,1
54917,5,3,191745,191745,191748,0,3,2
54918,3,1,191748,191748,191749,0,1,0
54919,2,3,191750,191750,191753,0,3,1
54920,5,1,191755,191755,191756,0,1,2
54921,1,3,191756,191756,191759,0,3,0
54922,5,1,191761,191761,191762,0,1,2
54923,4,2,191765,191765,191767,0,2,3
54924,5,3,191770,191770,191773,0,3,3
54925,4,1,191774,191774,191775,0,1,1
54926,6,1,191780,191780,191781,0,1,5
54927,2,1,191782,191782,191783,0,1,1
54928,6,3,191788,191788,191791,0,3,5
54929,4,3,191792,191792,191795,0,3,1
54930,1,3,191793,191795,191798,2,5,0
54931,3,2,191796,191798,191800,2,4,0
54932,3,3,191799,191800,191803,1,4,0
54933,5,2,191804,191804,191806,0,2,1
54934,1,2,191805,191806,191808,1,3,0
54935,3,2,191808,191808,191810,0,2,0
54936,5,1,191813,191813,191814,0,1,3
54937,5,3,191818,191818,191821,0,3,4
54938,4,1,191822,191822,191823,0,1,1
54939,1,2,191823,191823,191825,0,2,0
54940,2,3,191825,191825,191828,0,3,0
54941,6,1,191831,191831,191832,0,1,3
54942,4,2,191835,191835,191837,0,2,3
54943,4,3,191839,191839,191842,0,3,2
54944,4,3,191843,191843,191846,0,3,1
54945,5,2,191848,191848,191850,0,2,2
54946,1,1,191849,191850,191851,1,2,0
54947,4,1,191853,191853,191854,0,1,2
54948,3,3,191856,191856,191859,0,3,2
54949,3,2,191859,191859,191861,0,2,0
54950,4,1,191863,191863,191864,0,1,2
54951,1,2,191864,191864,191866,0,2,0
54952,2,1,191866,191866,191867,0,1,0
54953,3,2,191869,191869,191871,0,2,2
54954,4,1,191873,191873,191874,0,1,2
54955,6,3,191879,191879,191882,0,3,5
54956,5,1,191884,191884,191885,0,1,2
54957,6,1,191890,191890,191891,0,1,5
54958,3,2,191893,191893,191895,0,2,2
54959,5,3,191898,191898,191901,0,3,3
54960,1,1,191899,191901,191902,2,3,0
54961,6,3,191905,191905,191908,0,3,3
54962,1,3,191906,191908,191911,2,5,0
54963,6,1,191912,191912,191913,0,1,1
54964,5,2,191917,191917,191919,0,2,4
54965,2,3,191919,191919,191922,0,3,0
54966,4,1,191923,191923,191924,0,1,1
54967,5,1,191928,191928,191929,0,1,4
54968,1,1,191929,191929,191930,0,1,0
54969,4,3,191933,191933,191936,0,3,3
54970,5,1,191938,191938,191939,0,1,2
54971,3,2,191941,191941,191943,0,2,2
54972,2,2,191943,191943,191945,0,2,0
54973,1,1,191944,191945,191946,1,2,0
54974,5,1,191949,191949,191950,0,1,3
54975,1,3,191950,191950,191953,0,3,0
54976,1,1,191951,191953,191954,2,3,0
54977,4,2,191955,191955,191957,0,2,1
54978,1,1,191956,191957,191958,1,2,0
54979,3,1,191959,191959,191960,0,1,1
54980,4,3,191963,191963,191966,0,3,3
54981,3,3,191966,191966,191969,0,3,0
54982,6,3,191972,191972,191975,0,3,3
54983,4,1,191976,191976,191977,0,1,1
54984,1,2,191977,191977,191979,0,2,0
54985,4,1,191981,191981,191982,0,1,2
54986,4,1,191985,191985,191986,0,1,3
54987,5,1,191990,191990,191991,0,1,4
54988,4,3,191994,191994,191997,0,3,3
54989,4,1,191998,191998,191999,0,1,1
54990,1,1,191999,191999,192000,0,1,0
54991,3,2,192002,192002,192004,0,2,2
54992,2,2,192004,192004,192006,0,2,0
54993,3,3,192007,192007,192010,0,3,1
54994,2,1,192009,192010,192011,1,2,0
54995,4,3,192013,192013,192016,0,3,2
54996,5,1,192018,192018,192019,0,1,2
54997,5,2,192023,192023,192025,0,2,4
54998,1,1,192024,192025,192026,1,2,0
54999,3,1,192027,192027,192028,0,1,1
55000,2,2,192029,192029,192031,0,2,1
55001,6,2,192035,192035,192037,0,2,4
55002,3,1,192038,192038,192039,0,1,1
55003,4,1,192042,192042,192043,0,1,3
55004,2,2,192044,192044,192046,0,2,1
55005,5,1,192049,192049,192050,0,1,3
55006,5,3,192054,192054,192057,0,3,4
55007,5,3,192059,192059,192062,0,3,2
55008,3,3,192062,192062,192065,0,3,0
55009,1,1,192063,192065,192066,2,3,0
55010,4,3,192067,192067,192070,0,3,1
55011,3,3,192070,192070,192073,0,3,0
55012,4,3,192074,192074,192077,0,3,1
55013,3,1,192077,192077,192078,0,1,0
55014,5,2,192082,192082,192084,0,2,4
55015,6,2,192088,192088,192090,0,2,4
55016,2,2,192090,192090,192092,0,2,0
55017,2,3,192092,192092,192095,0,3,0
55018,2,1,192094,192095,192096,1,2,0
55019,3,1,192097,192097,192098,0,1,1
55020,3,2,192100,192100,192102,0,2,2
55021,5,1,192105,192105,192106,0,1,3
55022,6,2,192111,192111,192113,0,2,5
55023,3,2,192114,192114,192116,0,2,1
55024,2,2,192116,192116,192118,0,2,0
55025,1,2,192117,192118,192120,1,3,0
55026,4,3,192121,192121,192124,0,3,1
55027,6,1,192127,192127,192128,0,1,3
55028,5,1,192132,192132,192133,0,1,4
55029,4,1,192136,192136,192137,0,1,3
55030,6,3,192142,192142,192145,0,3,5
55031,3,1,192145,192145,192146,0,1,0
55032,5,3,192150,192150,192153,0,3,4
55033,2,1,192152,192153,192154,1,2,0
55034,4,1,192156,192156,192157,0,1,2
55035,5,1,192161,192161,192162,0,1,4
55036,4,3,192165,192165,192168,0,3,3
55037,1,3,192166,192168,192171,2,5,0
55038,2,2,192168,192171,192173,3,5,0
55039,3,3,192171,192173,192176,2,5,0
55040,2,3,192173,192176,192179,3,6,0
55041,2,1,192175,192179,192180,4,5,0
55042,4,3,192179,192180,192183,1,4,0
55043,6,2,192185,192185,192187,0,2,2
55044,5,1,192190,192190,192191,0,1,3
55045,4,1,192194,192194,192195,0,1,3
55046,4,1,192198,192198,192199,0,1,3
55047,6,2,192204,192204,192206,0,2,5
55048,2,3,192206,192206,192209,0,3,0
55049,3,3,192209,192209,192212,0,3,0
55050,4,2,192213,192213,192215,0,2,1
55051,3,1,192216,192216,192217,0,1,1
55052,1,2,192217,192217,192219,0,2,0
55053,1,2,192218,192219,192221,1,3,0
55054,1,1,192219,192221,192222,2,3,0
55055,4,1,192223,192223,192224,0,1,1
55056,6,3,192229,192229,192232,0,3,5
55057,4,2,192233,192233,192235,0,2,1
55058,1,1,192234,192235,192236,1,2,0
55059,1,2,192235,192236,192238,1,3,0
55060,1,2,192236,192238,192240,2,4,0
55061,3,3,192239,192240,192243,1,4,0
55062,3,1,192242,192243,192244,1,2,0
55063,6,3,192248,192248,192251,0,3,4
55064,5,3,192253,192253,192256,0,3,2
55065,3,1,192256,192256,192257,0,1,0
55066,2,1,192258,192258,192259,0,1,1
55067,2,3,192260,192260,192263,0,3,1
55068,4,2,192264,192264,192266,0,2,1
55069,2,3,192266,192266,192269,0,3,0
55070,4,3,192270,192270,192273,0,3,1
55071,2,1,192272,192273,192274,1,2,0
55072,1,3,192273,192274,192277,1,4,0
55073,1,3,192274,192277,192280,3,6,0
55074,1,2,192275,192280,192282,5,7,0
55075,4,2,192279,192282,192284,3,5,0
55076,3,2,192282,192284,192286,2,4,0
55077,3,1,192285,192286,192287,1,2,0
55078,6,1,192291,192291,192292,0,1,4
55079,3,3,192294,192294,192297,0,3,2
55080,5,1,192299,192299,192300,0,1,2
55081,5,1,192304,192304,192305,0,1,4
55082,2,1,192306,192306,192307,0,1,1
55083,6,1,192312,192312,192313,0,1,5
55084,3,1,192315,192315,192316,0,1,2
55085,5,3,192320,192320,192323,0,3,4
55086,3,2,192323,192323,192325,0,2,0
55087,4,1,192327,192327,192328,0,1,2
55088,6,1,192333,192333,192334,0,1,5
55089,5,3,192338,192338,192341,0,3,4
55090,4,3,192342,192342,192345,0,3,1
55091,3,1,192345,192345,192346,0,1,0
55092,6,3,192351,192351,192354,0,3,5
55093,5,1,192356,192356,192357,0,1,2
55094,3,3,192359,192359,192362,0,3,2
55095,6,2,192365,192365,192367,0,2,3
55096,1,3,192366,192367,192370,1,4,0
55097,5,2,192371,192371,192373,0,2,1
55098,1,2,192372,192373,192375,1,3,0
55099,3,3,192375,192375,192378,0,3,0
55100,6,1,192381,192381,192382,0,1,3
55101,5,1,192386,192386,192387,0,1,4
55102,3,3,192389,192389,192392,0,3,2
55103,3,2,192392,192392,192394,0,2,0
55104,1,1,192393,192394,192395,1,2,0
55105,3,1,192396,192396,192397,0,1,1
55106,4,2,192400,192400,192402,0,2,3
55107,1,2,192401,192402,192404,1,3,0
55108,6,3,192407,192407,192410,0,3,3
55109,4,1,192411,192411,192412,0,1,1
55110,5,2,192416,192416,192418,0,2,4
55111,1,2,192417,192418,192420,1,3,0
55112,4,1,192421,192421,192422,0,1,1
55113,2,1,192423,192423,192424,0,1,1
55114,3,1,192426,192426,192427,0,1,2
55115,5,1,192431,192431,192432,0,1,4
55116,3,2,192434,192434,192436,0,2,2
55117,6,1,192440,192440,192441,0,1,4
55118,2,2,192442,192442,192444,0,2,1
55119,4,3,192446,192446,192449,0,3,2
55120,1,1,192447,192449,192450,2,3,0
55121,1,2,192448,192450,192452,2,4,0
55122,2,1,192450,192452,192453,2,3,0
55123,6,1,192456,192456,192457,0,1,3
55124,2,1,192458,192458,192459,0,1,1
55125,4,1,192462,192462,192463,0,1,3
55126,2,3,192464,192464,192467,0,3,1
55127,4,3,192468,192468,192471,0,3,1
55128,6,2,192474,192474,192476,0,2,3
55129,2,2,192476,192476,192478,0,2,0
55130,1,3,192477,192478,192481,1,4,0
55131,2,3,192479,192481,192484,2,5,0
55132,6,3,192485,192485,192488,0,3,1
55133,1,1,192486,192488,192489,2,3,0
55134,3,2,192489,192489,192491,0,2,0
55135,5,2,192494,192494,192496,0,2,3
55136,3,3,192497,192497,192500,0,3,1
55137,1,3,192498,192500,192503,2,5,0
55138,4,2,192502,192503,192505,1,3,0
55139,6,3,192508,192508,192511,0,3,3
55140,5,2,192513,192513,192515,0,2,2
55141,6,2,192519,192519,192521,0,2,4
55142,6,2,192525,192525,192527,0,2,4
55143,6,1,192531,192531,192532,0,1,4
55144,2,3,192533,192533,192536,0,3,1
55145,2,1,192535,192536,192537,1,2,0
55146,6,3,192541,192541,192544,0,3,4
55147,3,3,192544,192544,192547,0,3,0
55148,2,3,192546,192547,192550,1,4,0
55149,5,1,192551,192551,192552,0,1,1
55150,2,3,192553,192553,192556,0,3,1
55151,6,1,192559,192559,192560,0,1,3
55152,3,1,192562,192562,192563,0,1,2
55153,5,1,192567,192567,192568,0,1,4
55154,2,2,192569,192569,192571,0,2,1
55155,3,3,192572,192572,192575,0,3,1
55156,2,2,192574,192575,192577,1,3,0
55157,1,3,192575,192577,192580,2,5,0
55158,1,3,192576,192580,192583,4,7,0
55159,2,1,192578,192583,192584,5,6,0
55160,4,1,192582,192584,192585,2,3,0
55161,1,3,192583,192585,192588,2,5,0
55162,6,2,192589,192589,192591,0,2,1
55163,4,1,192593,192593,192594,0,1,2
55164,2,3,192595,192595,192598,0,3,1
55165,3,3,192598,192598,192601,0,3,0
55166,3,3,192601,192601,192604,0,3,0
55167,2,1,192603,192604,192605,1,2,0
55168,6,3,192609,192609,192612,0,3,4
55169,4,1,192613,192613,192614,0,1,1
55170,2,1,192615,192615,192616,0,1,1
55171,5,2,192620,192620,192622,0,2,4
55172,1,1,192621,192622,192623,1,2,0
55173,1,2,192622,192623,192625,1,3,0
55174,5,1,192627,192627,192628,0,1,2
55175,1,3,192628,192628,192631,0,3,0
55176,6,2,192634,192634,192636,0,2,3
55177,4,3,192638,192638,192641,0,3,2
55178,5,2,192643,192643,192645,0,2,2
55179,4,1,192647,192647,192648,0,1,2
55180,5,2,192652,192652,192654,0,2,4
55181,4,3,192656,192656,192659,0,3,2
55182,2,3,192658,192659,192662,1,4,0
55183,1,3,192659,192662,192665,3,6,0
55184,2,1,192661,192665,192666,4,5,0
55185,2,1,192663,192666,192667,3,4,0
55186,1,2,192664,192667,192669,3,5,0
55187,1,2,192665,192669,192671,4,6,0
55188,5,3,192670,192671,192674,1,4,0
55189,3,2,192673,192674,192676,1,3,0
55190,1,3,192674,192676,192679,2,5,0
55191,4,3,192678,192679,192682,1,4,0
55192,1,2,192679,192682,192684,3,5,0
55193,1,2,192680,192684,192686,4,6,0
55194,6,2,192686,192686,192688,0,2,0
55195,1,2,192687,192688,192690,1,3,0
55196,1,1,192688,192690,192691,2,3,0
55197,6,2,192694,192694,192696,0,2,3
55198,3,3,192697,192697,192700,0,3,1
55199,4,3,192701,192701,192704,0,3,1
55200,1,1,192702,192704,192705,2,3,0
55201,5,3,192707,192707,192710,0,3,2
55202,4,1,192711,192711,192712,0,1,1
55203,1,1,192712,192712,192713,0,1,0
55204,4,3,192716,192716,192719,0,3,3
55205,1,3,192717,192719,192722,2,5,0
55206,3,2,192720,192722,192724,2,4,0
55207,5,3,192725,192725,192728,0,3,1
55208,6,1,192731,192731,192732,0,1,3
55209,4,3,192735,192735,192738,0,3,3
55210,4,2,192739,192739,192741,0,2,1
55211,2,3,192741,192741,192744,0,3,0
55212,6,2,192747,192747,192749,0,2,3
55213,1,2,192748,192749,192751,1,3,0
55214,3,1,192751,192751,192752,0,1,0
55215,2,3,192753,192753,192756,0,3,1
55216,4,1,192757,192757,192758,0,1,1
55217,1,3,192758,192758,192761,0,3,0
55218,6,3,192764,192764,192767,0,3,3
55219,6,3,192770,192770,192773,0,3,3
55220,1,3,192771,192773,192776,2,5,0
55221,5,3,192776,192776,192779,0,3,0
55222,2,1,192778,192779,192780,1,2,0
55223,6,2,192784,192784,192786,0,2,4
55224,2,1,192786,192786,192787,0,1,0
55225,1,1,192787,192787,192788,0,1,0
55226,1,3,192788,192788,192791,0,3,0
55227,6,3,192794,192794,192797,0,3,3
55228,4,3,192798,192798,192801,0,3,1
55229,5,1,192803,192803,192804,0,1,2
55230,1,1,192804,192804,192805,0,1,0
55231,1,1,192805,192805,192806,0,1,0
55232,3,3,192808,192808,192811,0,3,2
55233,5,2,192813,192813,192815,0,2,2
55234,4,1,192817,192817,192818,0,1,2
55235,2,1,192819,192819,192820,0,1,1
55236,5,3,192824,192824,192827,0,3,4
55237,2,3,192826,192827,192830,1,4,0
55238,5,1,192831,192831,192832,0,1,1
55239,2,3,192833,192833,192836,0,3,1
55240,3,2,192836,192836,192838,0,2,0
55241,1,1,192837,192838,192839,1,2,0
55242,3,3,192840,192840,192843,0,3,1
55243,3,2,192843,192843,192845,0,2,0
55244,3,2,192846,192846,192848,0,2,1
55245,2,1,192848,192848,192849,0,1,0
55246,1,2,192849,192849,192851,0,2,0
55247,3,1,192852,192852,192853,0,1,1
55248,3,3,192855,192855,192858,0,3,2
55249,1,1,192856,192858,192859,2,3,0
55250,2,2,192858,192859,192861,1,3,0
55251,2,3,192860,192861,192864,1,4,0
55252,5,2,192865,192865,192867,0,2,1
55253,2,1,192867,192867,192868,0,1,0
55254,3,1,192870,192870,192871,0,1,2
55255,2,1,192872,192872,192873,0,1,1
55256,4,3,192876,192876,192879,0,3,3
55257,5,2,192881,192881,192883,0,2,2
55258,4,2,192885,192885,192887,0,2,2
55259,2,2,192887,192887,192889,0,2,0
55260,1,2,192888,192889,192891,1,3,0
55261,5,1,192893,192893,192894,0,1,2
55262,4,1,192897,192897,192898,0,1,3
55263,5,2,192902,192902,192904,0,2,4
55264,3,1,192905,192905,192906,0,1,1
55265,4,2,192909,192909,192911,0,2,3
55266,1,3,192910,192911,192914,1,4,0
55267,6,3,192916,192916,192919,0,3,2
55268,2,2,192918,192919,192921,1,3,0
55269,5,2,192923,192923,192925,0,2,2
55270,1,1,192924,192925,192926,1,2,0
55271,3,2,192927,192927,192929,0,2,1
55272,6,3,192933,192933,192936,0,3,4
55273,3,2,192936,192936,192938,0,2,0
55274,2,1,192938,192938,192939,0,1,0
55275,2,3,192940,192940,192943,0,3,1
55276,4,2,192944,192944,192946,0,2,1
55277,1,3,192945,192946,192949,1,4,0
55278,6,3,192951,192951,192954,0,3,2
55279,6,1,192957,192957,192958,0,1,3
55280,2,3,192959,192959,192962,0,3,1
55281,1,2,192960,192962,192964,2,4,0
55282,2,3,192962,192964,192967,2,5,0
55283,2,3,192964,192967,192970,3,6,0
55284,5,1,192969,192970,192971,1,2,0
55285,3,2,192972,192972,192974,0,2,1
55286,6,3,192978,192978,192981,0,3,4
55287,1,2,192979,192981,192983,2,4,0
55288,6,2,192985,192985,192987,0,2,2
55289,3,3,192988,192988,192991,0,3,1
55290,3,1,192991,192991,192992,0,1,0
55291,5,3,192996,192996,192999,0,3,4
55292,3,3,192999,192999,193002,0,3,0
55293,6,1,193005,193005,193006,0,1,3
55294,1,2,193006,193006,193008,0,2,0
55295,6,1,193012,193012,193013,0,1,4
55296,1,2,193013,193013,193015,0,2,0
55297,3,1,193016,193016,193017,0,1,1
55298,5,1,193021,193021,193022,0,1,4
55299,2,3,193023,193023,193026,0,3,1
55300,3,1,193026,193026,193027,0,1,0
55301,6,2,193032,193032,193034,0,2,5
55302,5,2,193037,193037,193039,0,2,3
55303,1,2,193038,193039,193041,1,3,0
55304,3,1,193041,193041,193042,0,1,0
55305,6,2,193047,193047,193049,0,2,5
55306,2,1,193049,193049,193050,0,1,0
55307,2,3,193051,193051,193054,0,3,1
55308,5,2,193056,193056,193058,0,2,2
55309,6,2,193062,193062,193064,0,2,4
55310,2,1,193064,193064,193065,0,1,0
55311,1,3,193065,193065,193068,0,3,0
55312,5,1,193070,193070,193071,0,1,2
55313,3,1,193073,193073,193074,0,1,2
55314,2,3,193075,193075,193078,0,3,1
55315,5,3,193080,193080,193083,0,3,2
55316,2,2,193082,193083,193085,1,3,0
55317,2,3,193084,193085,193088,1,4,0
55318,6,3,193090,193090,193093,0,3,2
55319,6,3,193096,193096,193099,0,3,3
55320,3,3,193099,193099,193102,0,3,0
55321,1,1,193100,193102,193103,2,3,0
55322,4,2,193104,193104,193106,0,2,1
55323,5,1,193109,193109,193110,0,1,3
55324,4,1,193113,193113,193114,0,1,3
55325,4,3,193117,193117,193120,0,3,3
55326,5,3,193122,193122,193125,0,3,2
55327,4,1,193126,193126,193127,0,1,1
55328,5,2,193131,193131,193133,0,2,4
55329,4,1,193135,193135,193136,0,1,2
55330,4,3,193139,193139,193142,0,3,3
55331,6,3,193145,193145,193148,0,3,3
55332,6,2,193151,193151,193153,0,2,3
55333,6,2,193157,193157,193159,0,2,4
55334,1,1,193158,193159,193160,1,2,0
55335,6,3,193164,193164,193167,0,3,4
55336,1,2,193165,193167,193169,2,4,0
55337,1,3,193166,193169,193172,3,6,0
55338,1,3,193167,193172,193175,5,8,0
55339,3,1,193170,193175,193176,5,6,0
55340,6,3,193176,193176,193179,0,3,0
55341,5,2,193181,193181,193183,0,2,2
55342,6,3,193187,193187,193190,0,3,4
55343,2,1,193189,193190,193191,1,2,0
55344,2,3,193191,193191,193194,0,3,0
55345,2,3,193193,193194,193197,1,4,0
55346,3,3,193196,193197,193200,1,4,0
55347,1,1,193197,193200,193201,3,4,0
55348,5,3,193202,193202,193205,0,3,1
55349,2,3,193204,193205,193208,1,4,0
55350,1,2,193205,193208,193210,3,5,0
55351,2,1,193207,193210,193211,3,4,0
55352,6,3,193213,193213,193216,0,3,2
55353,1,1,193214,193216,193217,2,3,0
55354,2,1,193216,193217,193218,1,2,0
55355,4,1,193220,193220,193221,0,1,2
55356,6,2,193226,193226,193228,0,2,5
55357,6,1,193232,193232,193233,0,1,4
55358,5,1,193237,193237,193238,0,1,4
55359,3,3,193240,193240,193243,0,3,2
55360,2,2,193242,193243,193245,1,3,0
55361,5,1,193247,193247,193248,0,1,2
55362,4,1,193251,193251,193252,0,1,3
55363,1,3,193252,193252,193255,0,3,0
55364,4,1,193256,193256,193257,0,1,1
55365,4,1,193260,193260,193261,0,1,3
55366,1,1,193261,193261,193262,0,1,0
55367,6,3,193267,193267,193270,0,3,5
55368,5,3,193272,193272,193275,0,3,2
55369,2,3,193274,193275,193278,1,4,0
55370,4,1,193278,193278,193279,0,1,0
55371,6,2,193284,193284,193286,0,2,5
55372,1,3,193285,193286,193289,1,4,0
55373,3,3,193288,193289,193292,1,4,0
55374,1,2,193289,193292,193294,3,5,0
55375,2,2,193291,193294,193296,3,5,0
55376,2,3,193293,193296,193299,3,6,0
55377,3,3,193296,193299,193302,3,6,0
55378,3,1,193299,193302,193303,3,4,0
55379,3,1,193302,193303,193304,1,2,0
55380,3,2,193305,193305,193307,0,2,1
55381,5,1,193310,193310,193311,0,1,3
55382,5,1,193315,193315,193316,0,1,4
55383,2,3,193317,193317,193320,0,3,1
55384,2,1,193319,193320,193321,1,2,0
55385,4,2,193323,193323,193325,0,2,2
55386,1,3,193324,193325,193328,1,4,0
55387,5,3,193329,193329,193332,0,3,1
55388,1,3,193330,193332,193335,2,5,0
55389,6,2,193336,193336,193338,0,2,1
55390,3,1,193339,193339,193340,0,1,1
55391,1,3,193340,193340,193343,0,3,0
55392,6,2,193346,193346,193348,0,2,3
55393,3,1,193349,193349,193350,0,1,1
55394,4,1,193353,193353,193354,0,1,3
55395,3,1,193356,193356,193357,0,1,2
55396,6,3,193362,193362,193365,0,3,5
55397,1,2,193363,193365,193367,2,4,0
55398,4,2,193367,193367,193369,0,2,0
55399,4,3,193371,193371,193374,0,3,2
55400,4,1,193375,193375,193376,0,1,1
55401,6,1,193381,193381,193382,0,1,5
55402,1,3,193382,193382,193385,0,3,0
55403,4,3,193386,193386,193389,0,3,1
55404,6,2,193392,193392,193394,0,2,3
55405,4,3,193396,193396,193399,0,3,2
55406,4,3,193400,193400,193403,0,3,1
55407,3,1,193403,193403,193404,0,1,0
55408,1,2,193404,193404,193406,0,2,0
55409,5,1,193409,193409,193410,0,1,3
55410,5,2,193414,193414,193416,0,2,4
55411,4,1,193418,193418,193419,0,1,2
55412,3,2,193421,193421,193423,0,2,2
55413,5,1,193426,193426,193427,0,1,3
55414,5,1,193431,193431,193432,0,1,4
55415,3,1,193434,193434,193435,0,1,2
55416,3,2,193437,193437,193439,0,2,2
55417,1,3,193438,193439,193442,1,4,0
55418,4,3,193442,193442,193445,0,3,0
55419,4,1,193446,193446,193447,0,1,1
55420,2,3,193448,193448,193451,0,3,1
55421,4,1,193452,193452,193453,0,1,1
55422,3,2,193455,193455,193457,0,2,2
55423,3,3,193458,193458,193461,0,3,1
55424,4,2,193462,193462,193464,0,2,1
55425,5,3,193467,193467,193470,0,3,3
55426,1,2,193468,193470,193472,2,4,0
55427,5,3,193473,193473,193476,0,3,1
55428,6,2,193479,193479,193481,0,2,3
55429,4,2,193483,193483,193485,0,2,2
55430,5,3,193488,193488,193491,0,3,3
55431,4,3,193492,193492,193495,0,3,1
55432,4,3,193496,193496,193499,0,3,1
55433,3,1,193499,193499,193500,0,1,0
55434,3,3,193502,193502,193505,0,3,2
55435,2,3,193504,193505,193508,1,4,0
55436,4,1,193508,193508,193509,0,1,0
55437,5,3,193513,193513,193516,0,3,4
55438,1,2,193514,193516,193518,2,4,0
55439,1,1,193515,193518,193519,3,4,0
55440,2,1,193517,193519,193520,2,3,0
55441,6,1,193523,193523,193524,0,1,3
55442,2,2,193525,193525,193527,0,2,1
55443,4,2,193529,193529,193531,0,2,2
55444,4,1,193533,193533,193534,0,1,2
55445,2,3,193535,193535,193538,0,3,1
55446,5,1,193540,193540,193541,0,1,2
55447,4,2,193544,193544,193546,0,2,3
55448,3,2,193547,193547,193549,0,2,1
55449,4,1,193551,193551,193552,0,1,2
55450,3,3,193554,193554,193557,0,3,2
55451,3,1,193557,193557,193558,0,1,0
55452,3,3,193560,193560,193563,0,3,2
55453,1,3,193561,193563,193566,2,5,0
55454,4,2,193565,193566,193568,1,3,0
55455,5,1,193570,193570,193571,0,1,2
55456,5,2,193575,193575,193577,0,2,4
55457,3,2,193578,193578,193580,0,2,1
55458,6,2,193584,193584,193586,0,2,4
55459,5,1,193589,193589,193590,0,1,3
55460,5,3,193594,193594,193597,0,3,4
55461,2,1,193596,193597,193598,1,2,0
55462,4,1,193600,193600,193601,0,1,2
55463,6,2,193606,193606,193608,0,2,5
55464,3,3,193609,193609,193612,0,3,1
55465,3,1,193612,193612,193613,0,1,0
55466,1,3,193613,193613,193616,0,3,0
55467,2,2,193615,193616,193618,1,3,0
55468,6,1,193621,193621,193622,0,1,3
55469,4,1,193625,193625,193626,0,1,3
55470,4,3,193629,193629,193632,0,3,3
55471,1,2,193630,193632,193634,2,4,0
55472,1,3,193631,193634,193637,3,6,0
55473,2,3,193633,193637,193640,4,7,0
55474,5,1,193638,193640,193641,2,3,0
55475,4,2,193642,193642,193644,0,2,1
55476,1,2,193643,193644,193646,1,3,0
55477,1,1,193644,193646,193647,2,3,0
55478,1,3,193645,193647,193650,2,5,0
55479,3,3,193648,193650,193653,2,5,0
55480,3,2,193651,193653,193655,2,4,0
55481,3,1,193654,193655,193656,1,2,0
55482,4,3,193658,193658,193661,0,3,2
55483,4,3,193662,193662,193665,0,3,1
55484,3,3,193665,193665,193668,0,3,0
55485,2,2,193667,193668,193670,1,3,0
55486,1,1,193668,193670,193671,2,3,0
55487,5,1,193673,193673,193674,0,1,2
55488,2,1,193675,193675,193676,0,1,1
55489,6,1,193681,193681,193682,0,1,5
55490,1,1,193682,193682,193683,0,1,0
55491,6,1,193688,193688,193689,0,1,5
55492,5,3,193693,193693,193696,0,3,4
55493,6,2,193699,193699,193701,0,2,3
55494,6,1,193705,193705,193706,0,1,4
55495,6,3,193711,193711,193714,0,3,5
55496,1,3,193712,193714,193717,2,5,0
55497,1,2,193713,193717,193719,4,6,0
55498,6,1,193719,193719,193720,0,1,0
55499,1,2,193720,193720,193722,0,2,0
55500,2,2,193722,193722,193724,0,2,0
55501,6,3,193728,193728,193731,0,3,4
55502,5,1,193733,193733,193734,0,1,2
55503,1,1,193734,193734,193735,0,1,0
55504,2,3,193736,193736,193739,0,3,1
55505,5,1,193741,193741,193742,0,1,2
55506,3,1,193744,193744,193745,0,1,2
55507,6,2,193750,193750,193752,0,2,5
55508,5,1,193755,193755,193756,0,1,3
55509,5,3,193760,193760,193763,0,3,4
55510,5,1,193765,193765,193766,0,1,2
55511,4,1,193769,193769,193770,0,1,3
55512,6,3,193775,193775,193778,0,3,5
55513,5,3,193780,193780,193783,0,3,2
55514,1,2,193781,193783,193785,2,4,0
55515,5,2,193786,193786,193788,0,2,1
55516,4,3,193790,193790,193793,0,3,2
55517,3,3,193793,193793,193796,0,3,0
55518,3,1,193796,193796,193797,0,1,0
55519,3,3,193799,193799,193802,0,3,2
55520,5,1,193804,193804,193805,0,1,2
55521,5,2,193809,193809,193811,0,2,4
55522,3,2,193812,193812,193814,0,2,1
55523,3,1,193815,193815,193816,0,1,1
55524,3,2,193818,193818,193820,0,2,2
55525,4,2,193822,193822,193824,0,2,2
55526,3,2,193825,193825,193827,0,2,1
55527,6,3,193831,193831,193834,0,3,4
55528,6,3,193837,193837,193840,0,3,3
55529,1,1,193838,193840,193841,2,3,0
55530,5,1,193843,193843,193844,0,1,2
55531,1,2,193844,193844,193846,0,2,0
55532,2,3,193846,193846,193849,0,3,0
55533,4,1,193850,193850,193851,0,1,1
55534,5,2,193855,193855,193857,0,2,4
55535,1,3,193856,193857,193860,1,4,0
55536,2,2,193858,193860,193862,2,4,0
55537,1,2,193859,193862,193864,3,5,0
55538,2,3,193861,193864,193867,3,6,0
55539,3,2,193864,193867,193869,3,5,0
55540,2,2,193866,193869,193871,3,5,0
55541,3,2,193869,193871,193873,2,4,0
55542,2,1,193871,193873,193874,2,3,0
55543,4,3,193875,193875,193878,0,3,1
55544,6,3,193881,193881,193884,0,3,3
55545,2,3,193883,193884,193887,1,4,0
55546,2,1,193885,193887,193888,2,3,0
55547,3,1,193888,193888,193889,0,1,0
55548,3,2,193891,193891,193893,0,2,2
55549,1,3,193892,193893,193896,1,4,0
55550,6,3,193898,193898,193901,0,3,2
55551,5,2,193903,193903,193905,0,2,2
55552,4,1,193907,193907,193908,0,1,2
55553,3,3,193910,193910,193913,0,3,2
55554,3,3,193913,193913,193916,0,3,0
55555,5,1,193918,193918,193919,0,1,2
55556,6,3,193924,193924,193927,0,3,5
55557,6,1,193930,193930,193931,0,1,3
55558,5,3,193935,193935,193938,0,3,4
55559,6,3,193941,193941,193944,0,3,3
55560,5,3,193946,193946,193949,0,3,2
55561,4,2,193950,193950,193952,0,2,1
55562,1,3,193951,193952,193955,1,4,0
55563,6,2,193957,193957,193959,0,2,2
55564,2,2,193959,193959,193961,0,2,0
55565,2,2,193961,193961,193963,0,2,0
55566,1,2,193962,193963,193965,1,3,0
55567,4,2,193966,193966,193968,0,2,1
55568,2,1,193968,193968,193969,0,1,0
55569,4,1,193972,193972,193973,0,1,3
55570,2,3,193974,193974,193977,0,3,1
55571,6,2,193980,193980,193982,0,2,3
55572,6,2,193986,193986,193988,0,2,4
55573,3,1,193989,193989,193990,0,1,1
55574,5,3,193994,193994,193997,0,3,4
55575,3,3,193997,193997,194000,0,3,0
55576,5,3,194002,194002,194005,0,3,2
55577,5,1,194007,194007,194008,0,1,2
55578,6,2,194013,194013,194015,0,2,5
55579,1,1,194014,194015,194016,1,2,0
55580,5,2,194019,194019,194021,0,2,3
55581,2,1,194021,194021,194022,0,1,0
55582,6,3,194027,194027,194030,0,3,5
55583,3,2,194030,194030,194032,0,2,0
55584,5,1,194035,194035,194036,0,1,3
55585,2,3,194037,194037,194040,0,3,1
55586,3,1,194040,194040,194041,0,1,0
55587,6,1,194046,194046,194047,0,1,5
55588,5,1,194051,194051,194052,0,1,4
55589,6,3,194057,194057,194060,0,3,5
55590,2,2,194059,194060,194062,1,3,0
55591,6,3,194065,194065,194068,0,3,3
55592,3,3,194068,194068,194071,0,3,0
55593,2,3,194070,194071,194074,1,4,0
55594,1,3,194071,194074,194077,3,6,0
55595,6,3,194077,194077,194080,0,3,0
55596,2,3,194079,194080,194083,1,4,0
55597,2,2,194081,194083,194085,2,4,0
55598,5,1,194086,194086,194087,0,1,1
55599,5,3,194091,194091,194094,0,3,4
55600,3,1,194094,194094,194095,0,1,0
55601,2,1,194096,194096,194097,0,1,1
55602,4,3,194100,194100,194103,0,3,3
55603,5,1,194105,194105,194106,0,1,2
55604,6,1,194111,194111,194112,0,1,5
55605,1,3,194112,194112,194115,0,3,0
55606,6,1,194118,194118,194119,0,1,3
55607,6,3,194124,194124,194127,0,3,5
55608,1,3,194125,194127,194130,2,5,0
55609,5,2,194130,194130,194132,0,2,0
55610,6,1,194136,194136,194137,0,1,4
55611,4,3,194140,194140,194143,0,3,3
55612,1,1,194141,194143,194144,2,3,0
55613,6,2,194147,194147,194149,0,2,3
55614,2,1,194149,194149,194150,0,1,0
55615,3,2,194152,194152,194154,0,2,2
55616,3,3,194155,194155,194158,0,3,1
55617,2,3,194157,194158,194161,1,4,0
55618,5,1,194162,194162,194163,0,1,1
55619,3,2,194165,194165,194167,0,2,2
55620,2,1,194167,194167,194168,0,1,0
55621,1,2,194168,194168,194170,0,2,0
55622,2,1,194170,194170,194171,0,1,0
55623,2,2,194172,194172,194174,0,2,1
55624,5,1,194177,194177,194178,0,1,3
55625,1,2,194178,194178,194180,0,2,0
55626,2,2,194180,194180,194182,0,2,0
55627,2,1,194182,194182,194183,0,1,0
55628,2,2,194184,194184,194186,0,2,1
55629,4,2,194188,194188,194190,0,2,2
55630,6,3,194194,194194,194197,0,3,4
55631,4,2,194198,194198,194200,0,2,1
55632,3,3,194201,194201,194204,0,3,1
55633,1,2,194202,194204,194206,2,4,0
55634,5,1,194207,194207,194208,0,1,1
55635,6,3,194213,194213,194216,0,3,5
55636,6,2,194219,194219,194221,0,2,3
55637,4,3,194223,194223,194226,0,3,2
55638,6,2,194229,194229,194231,0,2,3
55639,5,3,194234,194234,194237,0,3,3
55640,4,2,194238,194238,194240,0,2,1
55641,3,2,194241,194241,194243,0,2,1
55642,5,2,194246,194246,194248,0,2,3
55643,6,1,194252,194252,194253,0,1,4
55644,6,2,194258,194258,194260,0,2,5
55645,5,3,194263,194263,194266,0,3,3
55646,5,3,194268,194268,194271,0,3,2
55647,6,3,194274,194274,194277,0,3,3
55648,2,2,194276,194277,194279,1,3,0
55649,3,3,194279,194279,194282,0,3,0
55650,5,1,194284,194284,194285,0,1,2
55651,5,2,194289,194289,194291,0,2,4
55652,1,2,194290,194291,194293,1,3,0
55653,1,1,194291,194293,194294,2,3,0
55654,2,1,194293,194294,194295,1,2,0
55655,2,1,194295,194295,194296,0,1,0
55656,3,1,194298,194298,194299,0,1,2
55657,2,1,194300,194300,194301,0,1,1
55658,1,2,194301,194301,194303,0,2,0
55659,3,3,194304,194304,194307,0,3,1
55660,3,1,194307,194307,194308,0,1,0
55661,1,3,194308,194308,194311,0,3,0
55662,1,1,194309,194311,194312,2,3,0
55663,3,2,194312,194312,194314,0,2,0
55664,2,3,194314,194314,194317,0,3,0
55665,2,1,194316,194317,194318,1,2,0
55666,3,2,194319,194319,194321,0,2,1
55667,4,3,194323,194323,194326,0,3,2
55668,1,1,194324,194326,194327,2,3,0
55669,1,2,194325,194327,194329,2,4,0
55670,1,2,194326,194329,194331,3,5,0
55671,3,1,194329,194331,194332,2,3,0
55672,4,3,194333,194333,194336,0,3,1
55673,5,3,194338,194338,194341,0,3,2
55674,5,3,194343,194343,194346,0,3,2
55675,1,3,194344,194346,194349,2,5,0
55676,3,1,194347,194349,194350,2,3,0
55677,4,3,194351,194351,194354,0,3,1
55678,6,3,194357,194357,194360,0,3,3
55679,5,1,194362,194362,194363,0,1,2
55680,2,2,194364,194364,194366,0,2,1
55681,6,3,194370,194370,194373,0,3,4
55682,3,3,194373,194373,194376,0,3,0
55683,3,2,194376,194376,194378,0,2,0
55684,1,2,194377,194378,194380,1,3,0
55685,2,1,194379,194380,194381,1,2,0
55686,3,1,194382,194382,194383,0,1,1
55687,2,3,194384,194384,194387,0,3,1
55688,1,3,194385,194387,194390,2,5,0
55689,3,3,194388,194390,194393,2,5,0
55690,5,2,194393,194393,194395,0,2,0
55691,4,2,194397,194397,194399,0,2,2
55692,6,3,194403,194403,194406,0,3,4
55693,3,3,194406,194406,194409,0,3,0
55694,4,2,194410,194410,194412,0,2,1
55695,3,1,194413,194413,194414,0,1,1
55696,1,2,194414,194414,194416,0,2,0
55697,6,1,194420,194420,194421,0,1,4
55698,5,3,194425,194425,194428,0,3,4
55699,4,1,194429,194429,194430,0,1,1
55700,1,1,194430,194430,194431,0,1,0
55701,1,1,194431,194431,194432,0,1,0
55702,4,1,194435,194435,194436,0,1,3
55703,1,3,194436,194436,194439,0,3,0
55704,4,1,194440,194440,194441,0,1,1
55705,4,2,194444,194444,194446,0,2,3
55706,3,1,194447,194447,194448,0,1,1
55707,2,1,194449,194449,194450,0,1,1
55708,6,2,194455,194455,194457,0,2,5
55709,1,2,194456,194457,194459,1,3,0
55710,6,1,194462,194462,194463,0,1,3
55711,1,3,194463,194463,194466,0,3,0
55712,2,2,194465,194466,194468,1,3,0
55713,2,1,194467,194468,194469,1,2,0
55714,6,3,194473,194473,194476,0,3,4
55715,2,3,194475,194476,194479,1,4,0
55716,3,1,194478,194479,194480,1,2,0
55717,6,2,194484,194484,194486,0,2,4
55718,4,1,194488,194488,194489,0,1,2
55719,2,1,194490,194490,194491,0,1,1
55720,1,1,194491,194491,194492,0,1,0
55721,6,2,194497,194497,194499,0,2,5
55722,5,2,194502,194502,194504,0,2,3
55723,2,2,194504,194504,194506,0,2,0
55724,2,2,194506,194506,194508,0,2,0
55725,2,2,194508,194508,194510,0,2,0
55726,2,1,194510,194510,194511,0,1,0
55727,4,3,194514,194514,194517,0,3,3
55728,4,1,194518,194518,194519,0,1,1
55729,6,3,194524,194524,194527,0,3,5
55730,3,3,194527,194527,194530,0,3,0
55731,5,3,194532,194532,194535,0,3,2
55732,1,2,194533,194535,194537,2,4,0
55733,2,1,194535,194537,194538,2,3,0
55734,4,2,194539,194539,194541,0,2,1
55735,4,1,194543,194543,194544,0,1,2
55736,5,1,194548,194548,194549,0,1,4
55737,1,1,194549,194549,194550,0,1,0
55738,4,3,194553,194553,194556,0,3,3
55739,6,3,194559,194559,194562,0,3,3
55740,6,3,194565,194565,194568,0,3,3
55741,2,2,194567,194568,194570,1,3,0
55742,1,2,194568,194570,194572,2,4,0
55743,2,3,194570,194572,194575,2,5,0
55744,3,2,194573,194575,194577,2,4,0
55745,6,1,194579,194579,194580,0,1,2
55746,3,2,194582,194582,194584,0,2,2
55747,2,2,194584,194584,194586,0,2,0
55748,6,2,194590,194590,194592,0,2,4
55749,4,2,194594,194594,194596,0,2,2
55750,6,3,194600,194600,194603,0,3,4
55751,4,2,194604,194604,194606,0,2,1
55752,5,3,194609,194609,194612,0,3,3
55753,4,1,194613,194613,194614,0,1,1
55754,1,3,194614,194614,194617,0,3,0
55755,1,3,194615,194617,194620,2,5,0
55756,3,1,194618,194620,194621,2,3,0
55757,4,2,194622,194622,194624,0,2,1
55758,2,1,194624,194624,194625,0,1,0
55759,5,1,194629,194629,194630,0,1,4
55760,1,3,194630,194630,194633,0,3,0
55761,5,2,194635,194635,194637,0,2,2
55762,3,1,194638,194638,194639,0,1,1
55763,1,1,194639,194639,194640,0,1,0
55764,5,3,194644,194644,194647,0,3,4
55765,3,2,194647,194647,194649,0,2,0
55766,4,1,194651,194651,194652,0,1,2
55767,5,3,194656,194656,194659,0,3,4
55768,4,3,194660,194660,194663,0,3,1
55769,6,3,194666,194666,194669,0,3,3
55770,1,1,194667,194669,194670,2,3,0
55771,3,2,194670,194670,194672,0,2,0
55772,3,2,194673,194673,194675,0,2,1
55773,4,2,194677,194677,194679,0,2,2
55774,6,2,194683,194683,194685,0,2,4
55775,5,3,194688,194688,194691,0,3,3
55776,4,2,194692,194692,194694,0,2,1
55777,2,1,194694,194694,194695,0,1,0
55778,6,1,194700,194700,194701,0,1,5
55779,2,1,194702,194702,194703,0,1,1
55780,6,1,194708,194708,194709,0,1,5
55781,4,3,194712,194712,194715,0,3,3
55782,1,1,194713,194715,194716,2,3,0
55783,6,3,194719,194719,194722,0,3,3
55784,5,1,194724,194724,194725,0,1,2
55785,4,2,194728,194728,194730,0,2,3
55786,6,3,194734,194734,194737,0,3,4
55787,5,1,194739,194739,194740,0,1,2
55788,1,2,194740,194740,194742,0,2,0
55789,4,1,194744,194744,194745,0,1,2
55790,5,3,194749,194749,194752,0,3,4
55791,2,1,194751,194752,194753,1,2,0
55792,6,3,194757,194757,194760,0,3,4
55793,4,1,194761,194761,194762,0,1,1
55794,4,2,194765,194765,194767,0,2,3
55795,6,3,194771,194771,194774,0,3,4
55796,3,1,194774,194774,194775,0,1,0
55797,3,1,194777,194777,194778,0,1,2
55798,5,2,194782,194782,194784,0,2,4
55799,3,2,194785,194785,194787,0,2,1
55800,6,3,194791,194791,194794,0,3,4
55801,4,1,194795,194795,194796,0,1,1
55802,2,1,194797,194797,194798,0,1,1
55803,2,2,194799,194799,194801,0,2,1
55804,3,3,194802,194802,194805,0,3,1
55805,1,1,194803,194805,194806,2,3,0
55806,1,3,194804,194806,194809,2,5,0
55807,1,3,194805,194809,194812,4,7,0
55808,2,3,194807,194812,194815,5,8,0
55809,3,2,194810,194815,194817,5,7,0
55810,1,3,194811,194817,194820,6,9,0
55811,1,2,194812,194820,194822,8,10,0
55812,1,3,194813,194822,194825,9,12,0
55813,1,1,194814,194825,194826,11,12,0
55814,3,1,194817,194826,194827,9,10,0
55815,4,1,194821,194827,194828,6,7,0
55816,4,1,194825,194828,194829,3,4,0
55817,6,3,194831,194831,194834,0,3,2
55818,3,3,194834,194834,194837,0,3,0
55819,6,1,194840,194840,194841,0,1,3
55820,5,3,194845,194845,194848,0,3,4
55821,6,3,194851,194851,194854,0,3,3
55822,4,3,194855,194855,194858,0,3,1
55823,4,2,194859,194859,194861,0,2,1
55824,5,1,194864,194864,194865,0,1,3
55825,4,1,194868,194868,194869,0,1,3
55826,2,1,194870,194870,194871,0,1,1
55827,1,3,194871,194871,194874,0,3,0
55828,3,1,194874,194874,194875,0,1,0
55829,5,3,194879,194879,194882,0,3,4
55830,3,1,194882,194882,194883,0,1,0
55831,4,2,194886,194886,194888,0,2,3
55832,5,2,194891,194891,194893,0,2,3
55833,3,3,194894,194894,194897,0,3,1
55834,1,2,194895,194897,194899,2,4,0
55835,1,3,194896,194899,194902,3,6,0
55836,5,1,194901,194902,194903,1,2,0
55837,2,3,194903,194903,194906,0,3,0
55838,3,3,194906,194906,194909,0,3,0
55839,1,1,194907,194909,194910,2,3,0
55840,5,2,194912,194912,194914,0,2,2
55841,2,1,194914,194914,194915,0,1,0
55842,6,3,194920,194920,194923,0,3,5
55843,1,2,194921,194923,194925,2,4,0
55844,5,3,194926,194926,194929,0,3,1
55845,2,3,194928,194929,194932,1,4,0
55846,1,1,194929,194932,194933,3,4,0
55847,4,3,194933,194933,194936,0,3,0
55848,5,2,194938,194938,194940,0,2,2
55849,4,2,194942,194942,194944,0,2,2
55850,1,2,194943,194944,194946,1,3,0
55851,6,1,194949,194949,194950,0,1,3
55852,5,2,194954,194954,194956,0,2,4
55853,4,3,194958,194958,194961,0,3,2
55854,1,3,194959,194961,194964,2,5,0
55855,2,3,194961,194964,194967,3,6,0
55856,5,1,194966,194967,194968,1,2,0
55857,5,1,194971,194971,194972,0,1,3
55858,2,3,194973,194973,194976,0,3,1
55859,1,1,194974,194976,194977,2,3,0
55860,4,2,194978,194978,194980,0,2,1
55861,4,3,194982,194982,194985,0,3,2
55862,2,3,194984,194985,194988,1,4,0
55863,5,2,194989,194989,194991,0,2,1
55864,6,1,194995,194995,194996,0,1,4
55865,2,1,194997,194997,194998,0,1,1
55866,6,2,195003,195003,195005,0,2,5
55867,5,1,195008,195008,195009,0,1,3
55868,1,2,195009,195009,195011,0,2,0
55869,1,1,195010,195011,195012,1,2,0
55870,1,1,195011,195012,195013,1,2,0
55871,3,1,195014,195014,195015,0,1,1
55872,3,3,195017,195017,195020,0,3,2
55873,3,2,195020,195020,195022,0,2,0
55874,5,1,195025,195025,195026,0,1,3
55875,4,2,195029,195029,195031,0,2,3
55876,5,3,195034,195034,195037,0,3,3
55877,1,2,195035,195037,195039,2,4,0
55878,1,3,195036,195039,195042,3,6,0
55879,3,2,195039,195042,195044,3,5,0
55880,1,3,195040,195044,195047,4,7,0
55881,2,2,195042,195047,195049,5,7,0
55882,5,1,195047,195049,195050,2,3,0
55883,6,3,195053,195053,195056,0,3,3
55884,2,1,195055,195056,195057,1,2,0
55885,4,1,195059,195059,195060,0,1,2
55886,3,2,195062,195062,195064,0,2,2
55887,5,2,195067,195067,195069,0,2,3
55888,5,1,195072,195072,195073,0,1,3
55889,5,2,195077,195077,195079,0,2,4
55890,3,2,195080,195080,195082,0,2,1
55891,6,3,195086,195086,195089,0,3,4
55892,1,3,195087,195089,195092,2,5,0
55893,4,1,195091,195092,195093,1,2,0
55894,1,3,195092,195093,195096,1,4,0
55895,5,3,195097,195097,195100,0,3,1
55896,2,2,195099,195100,195102,1,3,0
55897,3,1,195102,195102,195103,0,1,0
55898,5,3,195107,195107,195110,0,3,4
55899,3,2,195110,195110,195112,0,2,0
55900,2,3,195112,195112,195115,0,3,0
55901,1,3,195113,195115,195118,2,5,0
55902,6,3,195119,195119,195122,0,3,1
55903,5,3,195124,195124,195127,0,3,2
55904,4,1,195128,195128,195129,0,1,1
55905,1,1,195129,195129,195130,0,1,0
55906,1,2,195130,195130,195132,0,2,0
55907,2,1,195132,195132,195133,0,1,0
55908,1,3,195133,195133,195136,0,3,0
55909,6,1,195139,195139,195140,0,1,3
55910,2,2,195141,195141,195143,0,2,1
55911,6,1,195147,195147,195148,0,1,4
55912,4,1,195151,195151,195152,0,1,3
55913,1,3,195152,195152,195155,0,3,0
55914,3,1,195155,195155,195156,0,1,0
55915,5,2,195160,195160,195162,0,2,4
55916,3,2,195163,195163,195165,0,2,1
55917,4,1,195167,195167,195168,0,1,2
55918,4,3,195171,195171,195174,0,3,3
55919,5,1,195176,195176,195177,0,1,2
55920,6,3,195182,195182,195185,0,3,5
55921,1,2,195183,195185,195187,2,4,0
55922,6,1,195189,195189,195190,0,1,2
55923,1,2,195190,195190,195192,0,2,0
55924,6,2,195196,195196,195198,0,2,4
55925,6,2,195202,195202,195204,0,2,4
55926,5,3,195207,195207,195210,0,3,3
55927,5,1,195212,195212,195213,0,1,2
55928,6,2,195218,195218,195220,0,2,5
55929,3,1,195221,195221,195222,0,1,1
55930,5,1,195226,195226,195227,0,1,4
55931,3,2,195229,195229,195231,0,2,2
55932,1,2,195230,195231,195233,1,3,0
55933,1,3,195231,195233,195236,2,5,0
55934,2,1,195233,195236,195237,3,4,0
55935,2,3,195235,195237,195240,2,5,0
55936,2,2,195237,195240,195242,3,5,0
55937,4,1,195241,195242,195243,1,2,0
55938,1,2,195242,195243,195245,1,3,0
55939,3,2,195245,195245,195247,0,2,0
55940,2,1,195247,195247,195248,0,1,0
55941,4,1,195251,195251,195252,0,1,3
55942,5,1,195256,195256,195257,0,1,4
55943,5,1,195261,195261,195262,0,1,4
55944,6,3,195267,195267,195270,0,3,5
55945,1,3,195268,195270,195273,2,5,0
55946,2,2,195270,195273,195275,3,5,0
55947,4,2,195274,195275,195277,1,3,0
55948,2,2,195276,195277,195279,1,3,0
55949,2,2,195278,195279,195281,1,3,0
55950,4,1,195282,195282,195283,0,1,1
55951,1,2,195283,195283,195285,0,2,0
55952,5,1,195288,195288,195289,0,1,3
55953,1,1,195289,195289,195290,0,1,0
55954,5,1,195294,195294,195295,0,1,4
55955,4,3,195298,195298,195301,0,3,3
55956,3,3,195301,195301,195304,0,3,0
55957,1,1,195302,195304,195305,2,3,0
55958,4,3,195306,195306,195309,0,3,1
55959,5,1,195311,195311,195312,0,1,2
55960,2,3,195313,195313,195316,0,3,1
55961,6,1,195319,195319,195320,0,1,3
55962,5,1,195324,195324,195325,0,1,4
55963,5,3,195329,195329,195332,0,3,4
55964,1,3,195330,195332,195335,2,5,0
55965,1,2,195331,195335,195337,4,6,0
55966,6,3,195337,195337,195340,0,3,0
55967,3,2,195340,195340,195342,0,2,0
55968,2,1,195342,195342,195343,0,1,0
55969,3,1,195345,195345,195346,0,1,2
55970,2,1,195347,195347,195348,0,1,1
55971,6,2,195353,195353,195355,0,2,5
55972,4,1,195357,195357,195358,0,1,2
55973,4,1,195361,195361,195362,0,1,3
55974,6,1,195367,195367,195368,0,1,5
55975,4,2,195371,195371,195373,0,2,3
55976,6,3,195377,195377,195380,0,3,4
55977,5,3,195382,195382,195385,0,3,2
55978,3,3,195385,195385,195388,0,3,0
55979,2,2,195387,195388,195390,1,3,0
55980,3,2,195390,195390,195392,0,2,0
55981,4,1,195394,195394,195395,0,1,2
55982,5,2,195399,195399,195401,0,2,4
55983,2,2,195401,195401,195403,0,2,0
55984,5,1,195406,195406,195407,0,1,3
55985,5,1,195411,195411,195412,0,1,4
55986,6,1,195417,195417,195418,0,1,5
55987,4,3,195421,195421,195424,0,3,3
55988,3,3,195424,195424,195427,0,3,0
55989,1,2,195425,195427,195429,2,4,0
55990,6,3,195431,195431,195434,0,3,2
55991,2,3,195433,195434,195437,1,4,0
55992,2,3,195435,195437,195440,2,5,0
55993,6,3,195441,195441,195444,0,3,1
55994,5,2,195446,195446,195448,0,2,2
55995,1,1,195447,195448,195449,1,2,0
55996,2,1,195449,195449,195450,0,1,0
55997,3,2,195452,195452,195454,0,2,2
55998,3,1,195455,195455,195456,0,1,1
55999,1,1,195456,195456,195457,0,1,0
56000,1,2,195457,195457,195459,0,2,0
56001,6,3,195463,195463,195466,0,3,4
56002,1,3,195464,195466,195469,2,5,0
56003,3,3,195467,195469,195472,2,5,0
56004,1,2,195468,195472,195474,4,6,0
56005,3,1,195471,195474,195475,3,4,0
56006,3,2,195474,195475,195477,1,3,0
56007,1,3,195475,195477,195480,2,5,0
56008,3,2,195478,195480,195482,2,4,0
56009,2,3,195480,195482,195485,2,5,0
56010,3,3,195483,195485,195488,2,5,0
56011,3,2,195486,195488,195490,2,4,0
56012,6,2,195492,195492,195494,0,2,2
56013,4,2,195496,195496,195498,0,2,2
56014,6,2,195502,195502,195504,0,2,4
56015,5,3,195507,195507,195510,0,3,3
56016,3,2,195510,195510,195512,0,2,0
56017,6,2,195516,195516,195518,0,2,4
56018,4,1,195520,195520,195521,0,1,2
56019,4,1,195524,195524,195525,0,1,3
56020,6,3,195530,195530,195533,0,3,5
56021,1,1,195531,195533,195534,2,3,0
56022,1,2,195532,195534,195536,2,4,0
56023,3,3,195535,195536,195539,1,4,0
56024,2,3,195537,195539,195542,2,5,0
56025,4,2,195541,195542,195544,1,3,0
56026,5,3,195546,195546,195549,0,3,2
56027,4,2,195550,195550,195552,0,2,1
56028,1,1,195551,195552,195553,1,2,0
56029,6,3,195557,195557,195560,0,3,4
56030,1,2,195558,195560,195562,2,4,0
56031,5,1,195563,195563,195564,0,1,1
56032,4,3,195567,195567,195570,0,3,3
56033,2,2,195569,195570,195572,1,3,0
56034,5,2,195574,195574,195576,0,2,2
56035,5,3,195579,195579,195582,0,3,3
56036,3,2,195582,195582,195584,0,2,0
56037,2,1,195584,195584,195585,0,1,0
56038,6,1,195590,195590,195591,0,1,5
56039,6,1,195596,195596,195597,0,1,5
56040,6,3,195602,195602,195605,0,3,5
56041,5,1,195607,195607,195608,0,1,2
56042,2,2,195609,195609,195611,0,2,1
56043,2,1,195611,195611,195612,0,1,0
56044,2,3,195613,195613,195616,0,3,1
56045,4,3,195617,195617,195620,0,3,1
56046,6,1,195623,195623,195624,0,1,3
56047,1,2,195624,195624,195626,0,2,0
56048,4,1,195628,195628,195629,0,1,2
56049,4,2,195632,195632,195634,0,2,3
56050,2,2,195634,195634,195636,0,2,0
56051,2,3,195636,195636,195639,0,3,0
56052,6,2,195642,195642,195644,0,2,3
56053,3,1,195645,195645,195646,0,1,1
56054,5,3,195650,195650,195653,0,3,4
56055,6,2,195656,195656,195658,0,2,3
56056,6,3,195662,195662,195665,0,3,4
56057,5,1,195667,195667,195668,0,1,2
56058,4,2,195671,195671,195673,0,2,3
56059,2,3,195673,195673,195676,0,3,0
56060,6,3,195679,195679,195682,0,3,3
56061,3,1,195682,195682,195683,0,1,0
56062,4,2,195686,195686,195688,0,2,3
56063,5,3,195691,195691,195694,0,3,3
56064,2,3,195693,195694,195697,1,4,0
56065,5,2,195698,195698,195700,0,2,1
56066,5,3,195703,195703,195706,0,3,3
56067,1,2,195704,195706,195708,2,4,0
56068,6,2,195710,195710,195712,0,2,2
56069,2,2,195712,195712,195714,0,2,0
56070,3,1,195715,195715,195716,0,1,1
56071,1,2,195716,195716,195718,0,2,0
56072,4,2,195720,195720,195722,0,2,2
56073,3,2,195723,195723,195725,0,2,1
56074,2,3,195725,195725,195728,0,3,0
56075,3,1,195728,195728,195729,0,1,0
56076,2,1,195730,195730,195731,0,1,1
56077,2,1,195732,195732,195733,0,1,1
56078,6,2,195738,195738,195740,0,2,5
56079,5,3,195743,195743,195746,0,3,3
56080,1,3,195744,195746,195749,2,5,0
56081,1,2,195745,195749,195751,4,6,0
56082,2,1,195747,195751,195752,4,5,0
56083,5,3,195752,195752,195755,0,3,0
56084,1,3,195753,195755,195758,2,5,0
56085,1,3,195754,195758,195761,4,7,0
56086,3,1,195757,195761,195762,4,5,0
56087,4,2,195761,195762,195764,1,3,0
56088,2,1,195763,195764,195765,1,2,0
56089,5,1,195768,195768,195769,0,1,3
56090,6,2,195774,195774,195776,0,2,5
56091,1,2,195775,195776,195778,1,3,0
56092,5,2,195780,195780,195782,0,2,2
56093,6,1,195786,195786,195787,0,1,4
56094,6,1,195792,195792,195793,0,1,5
56095,2,3,195794,195794,195797,0,3,1
56096,1,1,195795,195797,195798,2,3,0
56097,2,3,195797,195798,195801,1,4,0
56098,6,2,195803,195803,195805,0,2,2
56099,4,1,195807,195807,195808,0,1,2
56100,6,1,195813,195813,195814,0,1,5
56101,4,1,195817,195817,195818,0,1,3
56102,1,2,195818,195818,195820,0,2,0
56103,6,1,195824,195824,195825,0,1,4
56104,2,1,195826,195826,195827,0,1,1
56105,5,2,195831,195831,195833,0,2,4
56106,1,1,195832,195833,195834,1,2,0
56107,4,1,195836,195836,195837,0,1,2
56108,3,3,195839,195839,195842,0,3,2
56109,3,1,195842,195842,195843,0,1,0
56110,4,2,195846,195846,195848,0,2,3
56111,3,3,195849,195849,195852,0,3,1
56112,2,1,195851,195852,195853,1,2,0
56113,5,3,195856,195856,195859,0,3,3
56114,4,2,195860,195860,195862,0,2,1
56115,3,3,195863,195863,195866,0,3,1
56116,3,3,195866,195866,195869,0,3,0
56117,4,3,195870,195870,195873,0,3,1
56118,3,1,195873,195873,195874,0,1,0
56119,2,1,195875,195875,195876,0,1,1
56120,1,3,195876,195876,195879,0,3,0
56121,5,3,195881,195881,195884,0,3,2
56122,1,2,195882,195884,195886,2,4,0
56123,5,1,195887,195887,195888,0,1,1
56124,6,3,195893,195893,195896,0,3,5
56125,1,3,195894,195896,195899,2,5,0
56126,2,1,195896,195899,195900,3,4,0
56127,6,2,195902,195902,195904,0,2,2
56128,2,1,195904,195904,195905,0,1,0
56129,2,3,195906,195906,195909,0,3,1
56130,5,3,195911,195911,195914,0,3,2
56131,2,3,195913,195914,195917,1,4,0
56132,1,1,195914,195917,195918,3,4,0
56133,5,3,195919,195919,195922,0,3,1
56134,3,1,195922,195922,195923,0,1,0
56135,2,3,195924,195924,195927,0,3,1
56136,1,2,195925,195927,195929,2,4,0
56137,2,3,195927,195929,195932,2,5,0
56138,3,2,195930,195932,195934,2,4,0
56139,1,1,195931,195934,195935,3,4,0
56140,4,3,195935,195935,195938,0,3,0
56141,5,1,195940,195940,195941,0,1,2
56142,1,3,195941,195941,195944,0,3,0
56143,6,2,195947,195947,195949,0,2,3
56144,1,1,195948,195949,195950,1,2,0
56145,6,2,195954,195954,195956,0,2,4
56146,6,2,195960,195960,195962,0,2,4
56147,6,1,195966,195966,195967,0,1,4
56148,6,1,195972,195972,195973,0,1,5
56149,4,1,195976,195976,195977,0,1,3
56150,4,1,195980,195980,195981,0,1,3
56151,3,3,195983,195983,195986,0,3,2
56152,6,2,195989,195989,195991,0,2,3
56153,2,3,195991,195991,195994,0,3,0
56154,1,3,195992,195994,195997,2,5,0
56155,3,2,195995,195997,195999,2,4,0
56156,2,2,195997,195999,196001,2,4,0
56157,6,1,196003,196003,196004,0,1,2
56158,5,1,196008,196008,196009,0,1,4
56159,4,2,196012,196012,196014,0,2,3
56160,5,2,196017,196017,196019,0,2,3
56161,1,1,196018,196019,196020,1,2,0
56162,4,3,196022,196022,196025,0,3,2
56163,3,3,196025,196025,196028,0,3,0
56164,4,1,196029,196029,196030,0,1,1
56165,5,1,196034,196034,196035,0,1,4
56166,6,2,196040,196040,196042,0,2,5
56167,1,3,196041,196042,196045,1,4,0
56168,5,1,196046,196046,196047,0,1,1
56169,4,1,196050,196050,196051,0,1,3
56170,1,1,196051,196051,196052,0,1,0
56171,6,3,196057,196057,196060,0,3,5
56172,5,2,196062,196062,196064,0,2,2
56173,2,1,196064,196064,196065,0,1,0
56174,5,3,196069,196069,196072,0,3,4
56175,5,2,196074,196074,196076,0,2,2
56176,3,3,196077,196077,196080,0,3,1
56177,3,3,196080,196080,196083,0,3,0
56178,6,2,196086,196086,196088,0,2,3
56179,4,1,196090,196090,196091,0,1,2
56180,4,3,196094,196094,196097,0,3,3
56181,2,2,196096,196097,196099,1,3,0
56182,1,2,196097,196099,196101,2,4,0
56183,3,3,196100,196101,196104,1,4,0
56184,6,1,196106,196106,196107,0,1,2
56185,4,3,196110,196110,196113,0,3,3
56186,2,3,196112,196113,196116,1,4,0
56187,4,2,196116,196116,196118,0,2,0
56188,3,1,196119,196119,196120,0,1,1
56189,3,2,196122,196122,196124,0,2,2
56190,1,3,196123,196124,196127,1,4,0
56191,2,1,196125,196127,196128,2,3,0
56192,1,3,196126,196128,196131,2,5,0
56193,4,2,196130,196131,196133,1,3,0
56194,1,2,196131,196133,196135,2,4,0
56195,2,2,196133,196135,196137,2,4,0
56196,1,3,196134,196137,196140,3,6,0
56197,3,3,196137,196140,196143,3,6,0
56198,5,1,196142,196143,196144,1,2,0
56199,6,2,196148,196148,196150,0,2,4
56200,6,1,196154,196154,196155,0,1,4
56201,5,2,196159,196159,196161,0,2,4
56202,4,2,196163,196163,196165,0,2,2
56203,2,3,196165,196165,196168,0,3,0
56204,1,1,196166,196168,196169,2,3,0
56205,1,1,196167,196169,196170,2,3,0
56206,2,1,196169,196170,196171,1,2,0
56207,1,2,196170,196171,196173,1,3,0
56208,4,3,196174,196174,196177,0,3,1
56209,2,1,196176,196177,196178,1,2,0
56210,3,3,196179,196179,196182,0,3,1
56211,1,1,196180,196182,196183,2,3,0
56212,6,2,196186,196186,196188,0,2,3
56213,1,2,196187,196188,196190,1,3,0
56214,4,3,196191,196191,196194,0,3,1
56215,3,1,196194,196194,196195,0,1,0
56216,5,2,196199,196199,196201,0,2,4
56217,3,3,196202,196202,196205,0,3,1
56218,6,2,196208,196208,196210,0,2,3
56219,1,3,196209,196210,196213,1,4,0
56220,5,1,196214,196214,196215,0,1,1
56221,3,2,196217,196217,196219,0,2,2
56222,2,2,196219,196219,196221,0,2,0
56223,2,1,196221,196221,196222,0,1,0
56224,2,3,196223,196223,196226,0,3,1
56225,2,1,196225,196226,196227,1,2,0
56226,3,3,196228,196228,196231,0,3,1
56227,4,2,196232,196232,196234,0,2,1
56228,4,2,196236,196236,196238,0,2,2
56229,2,1,196238,196238,196239,0,1,0
56230,5,3,196243,196243,196246,0,3,4
56231,1,2,196244,196246,196248,2,4,0
56232,2,1,196246,196248,196249,2,3,0
56233,4,3,196250,196250,196253,0,3,1
56234,6,3,196256,196256,196259,0,3,3
56235,4,1,196260,196260,196261,0,1,1
56236,2,1,196262,196262,196263,0,1,1
56237,4,1,196266,196266,196267,0,1,3
56238,3,1,196269,196269,196270,0,1,2
56239,1,1,196270,196270,196271,0,1,0
56240,1,1,196271,196271,196272,0,1,0
56241,6,2,196277,196277,196279,0,2,5
56242,5,2,196282,196282,196284,0,2,3
56243,1,3,196283,196284,196287,1,4,0
56244,1,2,196284,196287,196289,3,5,0
56245,6,2,196290,196290,196292,0,2,1
56246,4,3,196294,196294,196297,0,3,2
56247,6,1,196300,196300,196301,0,1,3
56248,2,1,196302,196302,196303,0,1,1
56249,1,3,196303,196303,196306,0,3,0
56250,4,1,196307,196307,196308,0,1,1
56251,5,1,196312,196312,196313,0,1,4
56252,2,3,196314,196314,196317,0,3,1
56253,6,1,196320,196320,196321,0,1,3
56254,6,2,196326,196326,196328,0,2,5
56255,4,3,196330,196330,196333,0,3,2
56256,4,1,196334,196334,196335,0,1,1
56257,5,3,196339,196339,196342,0,3,4
56258,2,3,196341,196342,196345,1,4,0
56259,2,1,196343,196345,196346,2,3,0
56260,6,2,196349,196349,196351,0,2,3
56261,2,1,196351,196351,196352,0,1,0
56262,2,3,196353,196353,196356,0,3,1
56263,4,1,196357,196357,196358,0,1,1
56264,1,3,196358,196358,196361,0,3,0
56265,1,2,196359,196361,196363,2,4,0
56266,2,1,196361,196363,196364,2,3,0
56267,1,1,196362,196364,196365,2,3,0
56268,2,2,196364,196365,196367,1,3,0
56269,2,2,196366,196367,196369,1,3,0
56270,2,1,196368,196369,196370,1,2,0
56271,6,1,196374,196374,196375,0,1,4
56272,3,3,196377,196377,196380,0,3,2
56273,4,3,196381,196381,196384,0,3,1
56274,4,1,196385,196385,196386,0,1,1
56275,2,1,196387,196387,196388,0,1,1
56276,4,2,196391,196391,196393,0,2,3
56277,2,2,196393,196393,196395,0,2,0
56278,4,1,196397,196397,196398,0,1,2
56279,3,1,196400,196400,196401,0,1,2
56280,1,2,196401,196401,196403,0,2,0
56281,3,2,196404,196404,196406,0,2,1
56282,4,1,196408,196408,196409,0,1,2
56283,2,2,196410,196410,196412,0,2,1
56284,3,3,196413,196413,196416,0,3,1
56285,5,1,196418,196418,196419,0,1,2
56286,5,2,196423,196423,196425,0,2,4
56287,2,3,196425,196425,196428,0,3,0
56288,1,1,196426,196428,196429,2,3,0
56289,3,2,196429,196429,196431,0,2,0
56290,5,2,196434,196434,196436,0,2,3
56291,1,1,196435,196436,196437,1,2,0
56292,4,3,196439,196439,196442,0,3,2
56293,5,2,196444,196444,196446,0,2,2
56294,1,1,196445,196446,196447,1,2,0
56295,5,1,196450,196450,196451,0,1,3
56296,6,2,196456,196456,196458,0,2,5
56297,2,2,196458,196458,196460,0,2,0
56298,1,3,196459,196460,196463,1,4,0
56299,1,2,196460,196463,196465,3,5,0
56300,1,2,196461,196465,196467,4,6,0
56301,4,3,196465,196467,196470,2,5,0
56302,5,2,196470,196470,196472,0,2,0
56303,6,1,196476,196476,196477,0,1,4
56304,2,2,196478,196478,196480,0,2,1
56305,5,3,196483,196483,196486,0,3,3
56306,1,2,196484,196486,196488,2,4,0
56307,5,2,196489,196489,196491,0,2,1
56308,3,1,196492,196492,196493,0,1,1
56309,6,1,196498,196498,196499,0,1,5
56310,6,3,196504,196504,196507,0,3,5
56311,5,3,196509,196509,196512,0,3,2
56312,1,2,196510,196512,196514,2,4,0
56313,5,3,196515,196515,196518,0,3,1
56314,3,3,196518,196518,196521,0,3,0
56315,6,3,196524,196524,196527,0,3,3
56316,2,2,196526,196527,196529,1,3,0
56317,3,2,196529,196529,196531,0,2,0
56318,3,1,196532,196532,196533,0,1,1
56319,2,1,196534,196534,196535,0,1,1
56320,2,1,196536,196536,196537,0,1,1
56321,6,2,196542,196542,196544,0,2,5
56322,6,2,196548,196548,196550,0,2,4
56323,1,3,196549,196550,196553,1,4,0
56324,3,3,196552,196553,196556,1,4,0
56325,5,1,196557,196557,196558,0,1,1
56326,6,2,196563,196563,196565,0,2,5
56327,5,2,196568,196568,196570,0,2,3
56328,1,3,196569,196570,196573,1,4,0
56329,3,1,196572,196573,196574,1,2,0
56330,4,3,196576,196576,196579,0,3,2
56331,1,2,196577,196579,196581,2,4,0
56332,4,1,196581,196581,196582,0,1,0
56333,5,3,196586,196586,196589,0,3,4
56334,1,2,196587,196589,196591,2,4,0
56335,4,3,196591,196591,196594,0,3,0
56336,3,2,196594,196594,196596,0,2,0
56337,6,1,196600,196600,196601,0,1,4
56338,1,1,196601,196601,196602,0,1,0
56339,1,3,196602,196602,196605,0,3,0
56340,6,3,196608,196608,196611,0,3,3
56341,5,2,196613,196613,196615,0,2,2
56342,1,2,196614,196615,196617,1,3,0
56343,2,2,196616,196617,196619,1,3,0
56344,3,2,196619,196619,196621,0,2,0
56345,6,2,196625,196625,196627,0,2,4
56346,6,2,196631,196631,196633,0,2,4
56347,3,3,196634,196634,196637,0,3,1
56348,6,2,196640,196640,196642,0,2,3
56349,2,1,196642,196642,196643,0,1,0
56350,2,2,196644,196644,196646,0,2,1
56351,3,3,196647,196647,196650,0,3,1
56352,6,2,196653,196653,196655,0,2,3
56353,5,2,196658,196658,196660,0,2,3
56354,3,3,196661,196661,196664,0,3,1
56355,1,2,196662,196664,196666,2,4,0
56356,1,1,196663,196666,196667,3,4,0
56357,2,2,196665,196667,196669,2,4,0
56358,3,2,196668,196669,196671,1,3,0
56359,6,1,196674,196674,196675,0,1,3
56360,5,3,196679,196679,196682,0,3,4
56361,3,2,196682,196682,196684,0,2,0
56362,2,3,196684,196684,196687,0,3,0
56363,5,1,196689,196689,196690,0,1,2
56364,4,1,196693,196693,196694,0,1,3
56365,1,1,196694,196694,196695,0,1,0
56366,5,1,196699,196699,196700,0,1,4
56367,2,3,196701,196701,196704,0,3,1
56368,2,3,196703,196704,196707,1,4,0
56369,2,2,196705,196707,196709,2,4,0
56370,2,2,196707,196709,196711,2,4,0
56371,1,2,196708,196711,196713,3,5,0
56372,3,1,196711,196713,196714,2,3,0
56373,1,3,196712,196714,196717,2,5,0
56374,5,3,196717,196717,196720,0,3,0
56375,5,1,196722,196722,196723,0,1,2
56376,6,1,196728,196728,196729,0,1,5
56377,2,3,196730,196730,196733,0,3,1
56378,1,2,196731,196733,196735,2,4,0
56379,5,2,196736,196736,196738,0,2,1
56380,1,1,196737,196738,196739,1,2,0
56381,6,2,196743,196743,196745,0,2,4
56382,4,1,196747,196747,196748,0,1,2
56383,1,3,196748,196748,196751,0,3,0
56384,1,2,196749,196751,196753,2,4,0
56385,6,2,196755,196755,196757,0,2,2
56386,2,1,196757,196757,196758,0,1,0
56387,2,1,196759,196759,196760,0,1,1
56388,4,2,196763,196763,196765,0,2,3
56389,1,2,196764,196765,196767,1,3,0
56390,5,2,196769,196769,196771,0,2,2
56391,4,2,196773,196773,196775,0,2,2
56392,5,1,196778,196778,196779,0,1,3
56393,1,1,196779,196779,196780,0,1,0
56394,3,1,196782,196782,196783,0,1,2
56395,5,2,196787,196787,196789,0,2,4
56396,6,3,196793,196793,196796,0,3,4
56397,6,2,196799,196799,196801,0,2,3
56398,4,2,196803,196803,196805,0,2,2
56399,3,2,196806,196806,196808,0,2,1
56400,2,3,196808,196808,196811,0,3,0
56401,2,1,196810,196811,196812,1,2,0
56402,5,2,196815,196815,196817,0,2,3
56403,6,1,196821,196821,196822,0,1,4
56404,1,2,196822,196822,196824,0,2,0
56405,5,2,196827,196827,196829,0,2,3
56406,2,3,196829,196829,196832,0,3,0
56407,1,2,196830,196832,196834,2,4,0
56408,4,2,196834,196834,196836,0,2,0
56409,1,3,196835,196836,196839,1,4,0
56410,3,3,196838,196839,196842,1,4,0
56411,2,3,196840,196842,196845,2,5,0
56412,5,1,196845,196845,196846,0,1,0
56413,2,1,196847,196847,196848,0,1,1
56414,3,2,196850,196850,196852,0,2,2
56415,2,3,196852,196852,196855,0,3,0
56416,6,1,196858,196858,196859,0,1,3
56417,6,1,196864,196864,196865,0,1,5
56418,3,2,196867,196867,196869,0,2,2
56419,6,1,196873,196873,196874,0,1,4
56420,4,3,196877,196877,196880,0,3,3
56421,5,3,196882,196882,196885,0,3,2
56422,3,1,196885,196885,196886,0,1,0
56423,3,2,196888,196888,196890,0,2,2
56424,5,1,196893,196893,196894,0,1,3
56425,5,1,196898,196898,196899,0,1,4
56426,3,3,196901,196901,196904,0,3,2
56427,1,3,196902,196904,196907,2,5,0
56428,6,3,196908,196908,196911,0,3,1
56429,4,2,196912,196912,196914,0,2,1
56430,3,1,196915,196915,196916,0,1,1
56431,1,3,196916,196916,196919,0,3,0
56432,6,2,196922,196922,196924,0,2,3
56433,6,2,196928,196928,196930,0,2,4
56434,1,3,196929,196930,196933,1,4,0
56435,1,3,196930,196933,196936,3,6,0
56436,5,1,196935,196936,196937,1,2,0
56437,3,3,196938,196938,196941,0,3,1
56438,3,2,196941,196941,196943,0,2,0
56439,5,3,196946,196946,196949,0,3,3
56440,3,3,196949,196949,196952,0,3,0
56441,2,3,196951,196952,196955,1,4,0
56442,6,1,196957,196957,196958,0,1,2
56443,1,1,196958,196958,196959,0,1,0
56444,1,3,196959,196959,196962,0,3,0
56445,3,1,196962,196962,196963,0,1,0
56446,1,1,196963,196963,196964,0,1,0
56447,3,3,196966,196966,196969,0,3,2
56448,2,1,196968,196969,196970,1,2,0
56449,1,1,196969,196970,196971,1,2,0
56450,5,2,196974,196974,196976,0,2,3
56451,2,2,196976,196976,196978,0,2,0
56452,2,1,196978,196978,196979,0,1,0
56453,4,3,196982,196982,196985,0,3,3
56454,6,1,196988,196988,196989,0,1,3
56455,2,1,196990,196990,196991,0,1,1
56456,2,3,196992,196992,196995,0,3,1
56457,2,1,196994,196995,196996,1,2,0
56458,6,2,197000,197000,197002,0,2,4
56459,2,2,197002,197002,197004,0,2,0
56460,2,3,197004,197004,197007,0,3,0
56461,2,1,197006,197007,197008,1,2,0
56462,4,1,197010,197010,197011,0,1,2
56463,5,1,197015,197015,197016,0,1,4
56464,4,2,197019,197019,197021,0,2,3
56465,2,2,197021,197021,197023,0,2,0
56466,5,3,197026,197026,197029,0,3,3
56467,4,1,197030,197030,197031,0,1,1
56468,5,1,197035,197035,197036,0,1,4
56469,5,3,197040,197040,197043,0,3,4
56470,1,3,197041,197043,197046,2,5,0
56471,4,3,197045,197046,197049,1,4,0
56472,6,3,197051,197051,197054,0,3,2
56473,6,2,197057,197057,197059,0,2,3
56474,6,3,197063,197063,197066,0,3,4
56475,2,2,197065,197066,197068,1,3,0
56476,3,2,197068,197068,197070,0,2,0
56477,2,3,197070,197070,197073,0,3,0
56478,6,3,197076,197076,197079,0,3,3
56479,1,2,197077,197079,197081,2,4,0
56480,5,3,197082,197082,197085,0,3,1
56481,3,2,197085,197085,197087,0,2,0
56482,3,2,197088,197088,197090,0,2,1
56483,2,1,197090,197090,197091,0,1,0
56484,6,2,197096,197096,197098,0,2,5
56485,2,1,197098,197098,197099,0,1,0
56486,5,3,197103,197103,197106,0,3,4
56487,4,1,197107,197107,197108,0,1,1
56488,6,1,197113,197113,197114,0,1,5
56489,1,2,197114,197114,197116,0,2,0
56490,1,2,197115,197116,197118,1,3,0
56491,6,2,197121,197121,197123,0,2,3
56492,5,2,197126,197126,197128,0,2,3
56493,5,1,197131,197131,197132,0,1,3
56494,1,3,197132,197132,197135,0,3,0
56495,1,3,197133,197135,197138,2,5,0
56496,2,2,197135,197138,197140,3,5,0
56497,1,1,197136,197140,197141,4,5,0
56498,1,1,197137,197141,197142,4,5,0
56499,3,2,197140,197142,197144,2,4,0
56500,2,3,197142,197144,197147,2,5,0
56501,5,2,197147,197147,197149,0,2,0
56502,1,2,197148,197149,197151,1,3,0
56503,6,2,197154,197154,197156,0,2,3
56504,6,2,197160,197160,197162,0,2,4
56505,6,1,197166,197166,197167,0,1,4
56506,1,3,197167,197167,197170,0,3,0
56507,2,2,197169,197170,197172,1,3,0
56508,4,3,197173,197173,197176,0,3,1
56509,3,1,197176,197176,197177,0,1,0
56510,3,2,197179,197179,197181,0,2,2
56511,1,1,197180,197181,197182,1,2,0
56512,6,3,197186,197186,197189,0,3,4
56513,5,3,197191,197191,197194,0,3,2
56514,5,2,197196,197196,197198,0,2,2
56515,1,2,197197,197198,197200,1,3,0
56516,3,1,197200,197200,197201,0,1,0
56517,2,2,197202,197202,197204,0,2,1
56518,4,1,197206,197206,197207,0,1,2
56519,4,1,197210,197210,197211,0,1,3
56520,2,2,197212,197212,197214,0,2,1
56521,4,3,197216,197216,197219,0,3,2
56522,1,2,197217,197219,197221,2,4,0
56523,6,1,197223,197223,197224,0,1,2
56524,5,3,197228,197228,197231,0,3,4
56525,6,2,197234,197234,197236,0,2,3
56526,3,1,197237,197237,197238,0,1,1
56527,2,1,197239,197239,197240,0,1,1
56528,5,3,197244,197244,197247,0,3,4
56529,2,2,197246,197247,197249,1,3,0
56530,5,3,197251,197251,197254,0,3,2
56531,4,2,197255,197255,197257,0,2,1
56532,5,3,197260,197260,197263,0,3,3
56533,6,1,197266,197266,197267,0,1,3
56534,4,2,197270,197270,197272,0,2,3
56535,5,1,197275,197275,197276,0,1,3
56536,6,1,197281,197281,197282,0,1,5
56537,5,1,197286,197286,197287,0,1,4
56538,1,3,197287,197287,197290,0,3,0
56539,3,3,197290,197290,197293,0,3,0
56540,4,3,197294,197294,197297,0,3,1
56541,2,1,197296,197297,197298,1,2,0
56542,1,2,197297,197298,197300,1,3,0
56543,6,2,197303,197303,197305,0,2,3
56544,1,1,197304,197305,197306,1,2,0
56545,3,2,197307,197307,197309,0,2,1
56546,3,1,197310,197310,197311,0,1,1
56547,4,3,197314,197314,197317,0,3,3
56548,3,1,197317,197317,197318,0,1,0
56549,1,1,197318,197318,197319,0,1,0
56550,5,3,197323,197323,197326,0,3,4
56551,5,2,197328,197328,197330,0,2,2
56552,2,2,197330,197330,197332,0,2,0
56553,4,3,197334,197334,197337,0,3,2
56554,2,2,197336,197337,197339,1,3,0
56555,1,2,197337,197339,197341,2,4,0
56556,1,1,197338,197341,197342,3,4,0
56557,6,1,197344,197344,197345,0,1,2
56558,5,1,197349,197349,197350,0,1,4
56559,4,3,197353,197353,197356,0,3,3
56560,2,2,197355,197356,197358,1,3,0
56561,3,3,197358,197358,197361,0,3,0
56562,1,1,197359,197361,197362,2,3,0
56563,3,3,197362,197362,197365,0,3,0
56564,6,3,197368,197368,197371,0,3,3
56565,4,2,197372,197372,197374,0,2,1
56566,6,1,197378,197378,197379,0,1,4
56567,4,2,197382,197382,197384,0,2,3
56568,2,3,197384,197384,197387,0,3,0
56569,5,1,197389,197389,197390,0,1,2
56570,5,3,197394,197394,197397,0,3,4
56571,4,3,197398,197398,197401,0,3,1
56572,1,2,197399,197401,197403,2,4,0
56573,5,3,197404,197404,197407,0,3,1
56574,2,2,197406,197407,197409,1,3,0
56575,5,3,197411,197411,197414,0,3,2
56576,4,1,197415,197415,197416,0,1,1
56577,3,1,197418,197418,197419,0,1,2
56578,2,2,197420,197420,197422,0,2,1
56579,6,1,197426,197426,197427,0,1,4
56580,5,1,197431,197431,197432,0,1,4
56581,4,2,197435,197435,197437,0,2,3
56582,1,2,197436,197437,197439,1,3,0
56583,2,2,197438,197439,197441,1,3,0
56584,6,1,197444,197444,197445,0,1,3
56585,4,2,197448,197448,197450,0,2,3
56586,5,2,197453,197453,197455,0,2,3
56587,2,2,197455,197455,197457,0,2,0
56588,2,2,197457,197457,197459,0,2,0
56589,2,3,197459,197459,197462,0,3,0
56590,4,2,197463,197463,197465,0,2,1
56591,2,3,197465,197465,197468,0,3,0
56592,3,1,197468,197468,197469,0,1,0
56593,2,1,197470,197470,197471,0,1,1
56594,2,2,197472,197472,197474,0,2,1
56595,3,2,197475,197475,197477,0,2,1
56596,1,3,197476,197477,197480,1,4,0
56597,5,3,197481,197481,197484,0,3,1
56598,4,2,197485,197485,197487,0,2,1
56599,4,1,197489,197489,197490,0,1,2
56600,6,3,197495,197495,197498,0,3,5
56601,2,1,197497,197498,197499,1,2,0
56602,5,1,197502,197502,197503,0,1,3
56603,6,3,197508,197508,197511,0,3,5
56604,4,3,197512,197512,197515,0,3,1
56605,4,1,197516,197516,197517,0,1,1
56606,4,3,197520,197520,197523,0,3,3
56607,6,1,197526,197526,197527,0,1,3
56608,5,3,197531,197531,197534,0,3,4
56609,6,1,197537,197537,197538,0,1,3
56610,6,3,197543,197543,197546,0,3,5
56611,1,3,197544,197546,197549,2,5,0
56612,2,2,197546,197549,197551,3,5,0
56613,4,1,197550,197551,197552,1,2,0
56614,3,3,197553,197553,197556,0,3,1
56615,5,1,197558,197558,197559,0,1,2
56616,1,2,197559,197559,197561,0,2,0
56617,6,2,197565,197565,197567,0,2,4
56618,1,1,197566,197567,197568,1,2,0
56619,3,3,197569,197569,197572,0,3,1
56620,3,2,197572,197572,197574,0,2,0
56621,3,2,197575,197575,197577,0,2,1
56622,4,1,197579,197579,197580,0,1,2
56623,2,1,197581,197581,197582,0,1,1
56624,4,1,197585,197585,197586,0,1,3
56625,6,1,197591,197591,197592,0,1,5
56626,3,2,197594,197594,197596,0,2,2
56627,2,1,197596,197596,197597,0,1,0
56628,1,1,197597,197597,197598,0,1,0
56629,1,3,197598,197598,197601,0,3,0
56630,5,1,197603,197603,197604,0,1,2
56631,6,1,197609,197609,197610,0,1,5
56632,3,2,197612,197612,197614,0,2,2
56633,6,2,197618,197618,197620,0,2,4
56634,1,3,197619,197620,197623,1,4,0
56635,4,2,197623,197623,197625,0,2,0
56636,6,3,197629,197629,197632,0,3,4
56637,6,1,197635,197635,197636,0,1,3
56638,5,1,197640,197640,197641,0,1,4
56639,3,1,197643,197643,197644,0,1,2
56640,2,3,197645,197645,197648,0,3,1
56641,2,3,197647,197648,197651,1,4,0
56642,6,3,197653,197653,197656,0,3,2
56643,6,1,197659,197659,197660,0,1,3
56644,4,3,197663,197663,197666,0,3,3
56645,6,3,197669,197669,197672,0,3,3
56646,6,1,197675,197675,197676,0,1,3
56647,1,1,197676,197676,197677,0,1,0
56648,2,3,197678,197678,197681,0,3,1
56649,3,2,197681,197681,197683,0,2,0
56650,6,3,197687,197687,197690,0,3,4
56651,6,3,197693,197693,197696,0,3,3
56652,3,2,197696,197696,197698,0,2,0
56653,1,1,197697,197698,197699,1,2,0
56654,2,2,197699,197699,197701,0,2,0
56655,2,1,197701,197701,197702,0,1,0
56656,1,2,197702,197702,197704,0,2,0
56657,2,1,197704,197704,197705,0,1,0
56658,2,1,197706,197706,197707,0,1,1
56659,6,3,197712,197712,197715,0,3,5
56660,1,2,197713,197715,197717,2,4,0
56661,4,1,197717,197717,197718,0,1,0
56662,6,2,197723,197723,197725,0,2,5
56663,6,3,197729,197729,197732,0,3,4
56664,5,1,197734,197734,197735,0,1,2
56665,4,2,197738,197738,197740,0,2,3
56666,5,1,197743,197743,197744,0,1,3
56667,6,3,197749,197749,197752,0,3,5
56668,6,3,197755,197755,197758,0,3,3
56669,1,1,197756,197758,197759,2,3,0
56670,2,2,197758,197759,197761,1,3,0
56671,6,1,197764,197764,197765,0,1,3
56672,5,1,197769,197769,197770,0,1,4
56673,2,2,197771,197771,197773,0,2,1
56674,3,1,197774,197774,197775,0,1,1
56675,3,2,197777,197777,197779,0,2,2
56676,5,3,197782,197782,197785,0,3,3
56677,1,3,197783,197785,197788,2,5,0
56678,4,2,197787,197788,197790,1,3,0
56679,5,1,197792,197792,197793,0,1,2
56680,4,3,197796,197796,197799,0,3,3
56681,4,2,197800,197800,197802,0,2,1
56682,1,2,197801,197802,197804,1,3,0
56683,5,3,197806,197806,197809,0,3,2
56684,5,2,197811,197811,197813,0,2,2
56685,6,2,197817,197817,197819,0,2,4
56686,5,3,197822,197822,197825,0,3,3
56687,1,3,197823,197825,197828,2,5,0
56688,6,1,197829,197829,197830,0,1,1
56689,3,1,197832,197832,197833,0,1,2
56690,3,2,197835,197835,197837,0,2,2
56691,2,2,197837,197837,197839,0,2,0
56692,1,1,197838,197839,197840,1,2,0
56693,4,3,197842,197842,197845,0,3,2
56694,4,2,197846,197846,197848,0,2,1
56695,1,3,197847,197848,197851,1,4,0
56696,5,1,197852,197852,197853,0,1,1
56697,5,3,197857,197857,197860,0,3,4
56698,5,2,197862,197862,197864,0,2,2
56699,4,1,197866,197866,197867,0,1,2
56700,1,3,197867,197867,197870,0,3,0
56701,6,2,197873,197873,197875,0,2,3
56702,1,1,197874,197875,197876,1,2,0
56703,5,1,197879,197879,197880,0,1,3
56704,1,3,197880,197880,197883,0,3,0
56705,2,2,197882,197883,197885,1,3,0
56706,2,3,197884,197885,197888,1,4,0
56707,2,1,197886,197888,197889,2,3,0
56708,6,3,197892,197892,197895,0,3,3
56709,2,3,197894,197895,197898,1,4,0
56710,3,2,197897,197898,197900,1,3,0
56711,2,2,197899,197900,197902,1,3,0
56712,3,3,197902,197902,197905,0,3,0
56713,2,1,197904,197905,197906,1,2,0
56714,4,2,197908,197908,197910,0,2,2
56715,3,1,197911,197911,197912,0,1,1
56716,1,1,197912,197912,197913,0,1,0
56717,5,1,197917,197917,197918,0,1,4
56718,5,3,197922,197922,197925,0,3,4
56719,3,1,197925,197925,197926,0,1,0
56720,3,2,197928,197928,197930,0,2,2
56721,6,1,197934,197934,197935,0,1,4
56722,2,1,197936,197936,197937,0,1,1
56723,2,1,197938,197938,197939,0,1,1
56724,2,1,197940,197940,197941,0,1,1
56725,6,2,197946,197946,197948,0,2,5
56726,3,1,197949,197949,197950,0,1,1
56727,3,1,197952,197952,197953,0,1,2
56728,3,2,197955,197955,197957,0,2,2
56729,2,3,197957,197957,197960,0,3,0
56730,2,3,197959,197960,197963,1,4,0
56731,5,2,197964,197964,197966,0,2,1
56732,2,1,197966,197966,197967,0,1,0
56733,3,1,197969,197969,197970,0,1,2
56734,6,1,197975,197975,197976,0,1,5
56735,6,3,197981,197981,197984,0,3,5
56736,4,1,197985,197985,197986,0,1,1
56737,4,1,197989,197989,197990,0,1,3
56738,4,3,197993,197993,197996,0,3,3
56739,2,3,197995,197996,197999,1,4,0
56740,3,3,197998,197999,198002,1,4,0
56741,6,2,198004,198004,198006,0,2,2
56742,3,3,198007,198007,198010,0,3,1
56743,5,1,198012,198012,198013,0,1,2
56744,4,2,198016,198016,198018,0,2,3
56745,5,3,198021,198021,198024,0,3,3
56746,1,2,198022,198024,198026,2,4,0
56747,5,2,198027,198027,198029,0,2,1
56748,4,3,198031,198031,198034,0,3,2
56749,6,1,198037,198037,198038,0,1,3
56750,4,1,198041,198041,198042,0,1,3
56751,1,1,198042,198042,198043,0,1,0
56752,4,1,198046,198046,198047,0,1,3
56753,4,1,198050,198050,198051,0,1,3
56754,2,1,198052,198052,198053,0,1,1
56755,4,3,198056,198056,198059,0,3,3
56756,1,3,198057,198059,198062,2,5,0
56757,3,2,198060,198062,198064,2,4,0
56758,6,1,198066,198066,198067,0,1,2
56759,2,3,198068,198068,198071,0,3,1
56760,2,1,198070,198071,198072,1,2,0
56761,3,2,198073,198073,198075,0,2,1
56762,1,3,198074,198075,198078,1,4,0
56763,6,1,198080,198080,198081,0,1,2
56764,1,3,198081,198081,198084,0,3,0
56765,2,1,198083,198084,198085,1,2,0
56766,2,2,198085,198085,198087,0,2,0
56767,1,2,198086,198087,198089,1,3,0
56768,3,3,198089,198089,198092,0,3,0
56769,6,3,198095,198095,198098,0,3,3
56770,6,1,198101,198101,198102,0,1,3
56771,3,1,198104,198104,198105,0,1,2
56772,6,2,198110,198110,198112,0,2,5
56773,5,1,198115,198115,198116,0,1,3
56774,4,1,198119,198119,198120,0,1,3
56775,1,3,198120,198120,198123,0,3,0
56776,5,3,198125,198125,198128,0,3,2
56777,5,2,198130,198130,198132,0,2,2
56778,6,2,198136,198136,198138,0,2,4
56779,2,2,198138,198138,198140,0,2,0
56780,4,2,198142,198142,198144,0,2,2
56781,3,1,198145,198145,198146,0,1,1
56782,6,3,198151,198151,198154,0,3,5
56783,6,2,198157,198157,198159,0,2,3
56784,4,2,198161,198161,198163,0,2,2
56785,6,1,198167,198167,198168,0,1,4
56786,5,1,198172,198172,198173,0,1,4
56787,2,3,198174,198174,198177,0,3,1
56788,2,1,198176,198177,198178,1,2,0
56789,2,2,198178,198178,198180,0,2,0
56790,4,1,198182,198182,198183,0,1,2
56791,2,1,198184,198184,198185,0,1,1
56792,6,2,198190,198190,198192,0,2,5
56793,1,2,198191,198192,198194,1,3,0
56794,3,2,198194,198194,198196,0,2,0
56795,4,2,198198,198198,198200,0,2,2
56796,4,1,198202,198202,198203,0,1,2
56797,2,3,198204,198204,198207,0,3,1
56798,1,3,198205,198207,198210,2,5,0
56799,4,3,198209,198210,198213,1,4,0
56800,1,1,198210,198213,198214,3,4,0
56801,5,3,198215,198215,198218,0,3,1
56802,5,1,198220,198220,198221,0,1,2
56803,1,3,198221,198221,198224,0,3,0
56804,4,1,198225,198225,198226,0,1,1
56805,5,1,198230,198230,198231,0,1,4
56806,2,2,198232,198232,198234,0,2,1
56807,6,3,198238,198238,198241,0,3,4
56808,4,2,198242,198242,198244,0,2,1
56809,6,2,198248,198248,198250,0,2,4
56810,2,3,198250,198250,198253,0,3,0
56811,1,3,198251,198253,198256,2,5,0
56812,3,1,198254,198256,198257,2,3,0
56813,2,3,198256,198257,198260,1,4,0
56814,2,3,198258,198260,198263,2,5,0
56815,6,2,198264,198264,198266,0,2,1
56816,6,3,198270,198270,198273,0,3,4
56817,5,1,198275,198275,198276,0,1,2
56818,2,3,198277,198277,198280,0,3,1
56819,5,1,198282,198282,198283,0,1,2
56820,2,3,198284,198284,198287,0,3,1
56821,6,2,198290,198290,198292,0,2,3
56822,2,1,198292,198292,198293,0,1,0
56823,1,2,198293,198293,198295,0,2,0
56824,1,2,198294,198295,198297,1,3,0
56825,5,2,198299,198299,198301,0,2,2
56826,2,2,198301,198301,198303,0,2,0
56827,4,2,198305,198305,198307,0,2,2
56828,5,1,198310,198310,198311,0,1,3
56829,2,2,198312,198312,198314,0,2,1
56830,4,1,198316,198316,198317,0,1,2
56831,6,1,198322,198322,198323,0,1,5
56832,4,1,198326,198326,198327,0,1,3
56833,2,2,198328,198328,198330,0,2,1
56834,2,1,198330,198330,198331,0,1,0
56835,6,1,198336,198336,198337,0,1,5
56836,6,3,198342,198342,198345,0,3,5
56837,5,1,198347,198347,198348,0,1,2
56838,5,3,198352,198352,198355,0,3,4
56839,3,3,198355,198355,198358,0,3,0
56840,3,3,198358,198358,198361,0,3,0
56841,5,2,198363,198363,198365,0,2,2
56842,6,3,198369,198369,198372,0,3,4
56843,5,1,198374,198374,198375,0,1,2
56844,5,1,198379,198379,198380,0,1,4
56845,2,2,198381,198381,198383,0,2,1
56846,5,2,198386,198386,198388,0,2,3
56847,3,2,198389,198389,198391,0,2,1
56848,1,1,198390,198391,198392,1,2,0
56849,1,1,198391,198392,198393,1,2,0
56850,1,2,198392,198393,198395,1,3,0
56851,1,3,198393,198395,198398,2,5,0
56852,1,1,198394,198398,198399,4,5,0
56853,4,1,198398,198399,198400,1,2,0
56854,4,1,198402,198402,198403,0,1,2
56855,5,1,198407,198407,198408,0,1,4
56856,4,1,198411,198411,198412,0,1,3
56857,1,3,198412,198412,198415,0,3,0
56858,6,1,198418,198418,198419,0,1,3
56859,1,3,198419,198419,198422,0,3,0
56860,1,1,198420,198422,198423,2,3,0
56861,1,2,198421,198423,198425,2,4,0
56862,3,3,198424,198425,198428,1,4,0
56863,6,1,198430,198430,198431,0,1,2
56864,3,1,198433,198433,198434,0,1,2
56865,2,3,198435,198435,198438,0,3,1
56866,4,2,198439,198439,198441,0,2,1
56867,6,1,198445,198445,198446,0,1,4
56868,5,3,198450,198450,198453,0,3,4
56869,3,2,198453,198453,198455,0,2,0
56870,5,2,198458,198458,198460,0,2,3
56871,2,3,198460,198460,198463,0,3,0
56872,3,3,198463,198463,198466,0,3,0
56873,5,2,198468,198468,198470,0,2,2
56874,5,3,198473,198473,198476,0,3,3
56875,6,3,198479,198479,198482,0,3,3
56876,1,2,198480,198482,198484,2,4,0
56877,1,1,198481,198484,198485,3,4,0
56878,5,2,198486,198486,198488,0,2,1
56879,3,3,198489,198489,198492,0,3,1
56880,5,3,198494,198494,198497,0,3,2
56881,5,1,198499,198499,198500,0,1,2
56882,6,2,198505,198505,198507,0,2,5
56883,1,2,198506,198507,198509,1,3,0
56884,6,2,198512,198512,198514,0,2,3
56885,5,2,198517,198517,198519,0,2,3
56886,5,1,198522,198522,198523,0,1,3
56887,6,1,198528,198528,198529,0,1,5
56888,6,3,198534,198534,198537,0,3,5
56889,3,3,198537,198537,198540,0,3,0
56890,3,3,198540,198540,198543,0,3,0
56891,6,1,198546,198546,198547,0,1,3
56892,1,1,198547,198547,198548,0,1,0
56893,4,3,198551,198551,198554,0,3,3
56894,5,1,198556,198556,198557,0,1,2
56895,4,2,198560,198560,198562,0,2,3
56896,5,1,198565,198565,198566,0,1,3
56897,6,3,198571,198571,198574,0,3,5
56898,4,3,198575,198575,198578,0,3,1
56899,2,1,198577,198578,198579,1,2,0
56900,1,1,198578,198579,198580,1,2,0
56901,4,3,198582,198582,198585,0,3,2
56902,6,3,198588,198588,198591,0,3,3
56903,1,2,198589,198591,198593,2,4,0
56904,2,1,198591,198593,198594,2,3,0
56905,4,1,198595,198595,198596,0,1,1
56906,6,2,198601,198601,198603,0,2,5
56907,5,1,198606,198606,198607,0,1,3
56908,3,2,198609,198609,198611,0,2,2
56909,2,1,198611,198611,198612,0,1,0
56910,6,2,198617,198617,198619,0,2,5
56911,2,2,198619,198619,198621,0,2,0
56912,1,1,198620,198621,198622,1,2,0
56913,1,1,198621,198622,198623,1,2,0
56914,4,2,198625,198625,198627,0,2,2
56915,2,3,198627,198627,198630,0,3,0
56916,6,1,198633,198633,198634,0,1,3
56917,5,3,198638,198638,198641,0,3,4
56918,5,1,198643,198643,198644,0,1,2
56919,3,2,198646,198646,198648,0,2,2
56920,2,2,198648,198648,198650,0,2,0
56921,2,3,198650,198650,198653,0,3,0
56922,6,3,198656,198656,198659,0,3,3
56923,2,1,198658,198659,198660,1,2,0
56924,5,2,198663,198663,198665,0,2,3
56925,1,2,198664,198665,198667,1,3,0
56926,3,1,198667,198667,198668,0,1,0
56927,6,1,198673,198673,198674,0,1,5
56928,2,2,198675,198675,198677,0,2,1
56929,4,2,198679,198679,198681,0,2,2
56930,4,1,198683,198683,198684,0,1,2
56931,4,2,198687,198687,198689,0,2,3
56932,1,2,198688,198689,198691,1,3,0
56933,4,2,198692,198692,198694,0,2,1
56934,6,2,198698,198698,198700,0,2,4
56935,4,2,198702,198702,198704,0,2,2
56936,6,2,198708,198708,198710,0,2,4
56937,4,3,198712,198712,198715,0,3,2
56938,2,3,198714,198715,198718,1,4,0
56939,4,2,198718,198718,198720,0,2,0
56940,3,3,198721,198721,198724,0,3,1
56941,5,2,198726,198726,198728,0,2,2
56942,1,3,198727,198728,198731,1,4,0
56943,1,2,198728,198731,198733,3,5,0
56944,4,2,198732,198733,198735,1,3,0
56945,1,3,198733,198735,198738,2,5,0
56946,6,1,198739,198739,198740,0,1,1
56947,4,2,198743,198743,198745,0,2,3
56948,3,3,198746,198746,198749,0,3,1
56949,6,1,198752,198752,198753,0,1,3
56950,3,3,198755,198755,198758,0,3,2
56951,3,1,198758,198758,198759,0,1,0
56952,1,1,198759,198759,198760,0,1,0
56953,5,2,198764,198764,198766,0,2,4
56954,1,2,198765,198766,198768,1,3,0
56955,1,1,198766,198768,198769,2,3,0
56956,2,1,198768,198769,198770,1,2,0
56957,5,1,198773,198773,198774,0,1,3
56958,4,3,198777,198777,198780,0,3,3
56959,1,1,198778,198780,198781,2,3,0
56960,6,1,198784,198784,198785,0,1,3
56961,4,3,198788,198788,198791,0,3,3
56962,2,2,198790,198791,198793,1,3,0
56963,2,3,198792,198793,198796,1,4,0
56964,5,3,198797,198797,198800,0,3,1
56965,5,3,198802,198802,198805,0,3,2
56966,4,2,198806,198806,198808,0,2,1
56967,3,3,198809,198809,198812,0,3,1
56968,3,2,198812,198812,198814,0,2,0
56969,3,3,198815,198815,198818,0,3,1
56970,5,3,198820,198820,198823,0,3,2
56971,2,3,198822,198823,198826,1,4,0
56972,4,1,198826,198826,198827,0,1,0
56973,3,1,198829,198829,198830,0,1,2
56974,3,3,198832,198832,198835,0,3,2
56975,2,2,198834,198835,198837,1,3,0
56976,5,3,198839,198839,198842,0,3,2
56977,2,2,198841,198842,198844,1,3,0
56978,3,2,198844,198844,198846,0,2,0
56979,3,2,198847,198847,198849,0,2,1
56980,2,3,198849,198849,198852,0,3,0
56981,2,2,198851,198852,198854,1,3,0
56982,4,1,198855,198855,198856,0,1,1
56983,1,2,198856,198856,198858,0,2,0
56984,4,1,198860,198860,198861,0,1,2
56985,1,1,198861,198861,198862,0,1,0
56986,2,3,198863,198863,198866,0,3,1
56987,3,3,198866,198866,198869,0,3,0
56988,6,3,198872,198872,198875,0,3,3
56989,6,2,198878,198878,198880,0,2,3
56990,2,3,198880,198880,198883,0,3,0
56991,3,3,198883,198883,198886,0,3,0
56992,5,3,198888,198888,198891,0,3,2
56993,3,3,198891,198891,198894,0,3,0
56994,2,2,198893,198894,198896,1,3,0
56995,3,2,198896,198896,198898,0,2,0
56996,4,3,198900,198900,198903,0,3,2
56997,3,1,198903,198903,198904,0,1,0
56998,6,1,198909,198909,198910,0,1,5
56999,6,3,198915,198915,198918,0,3,5
57000,2,1,198917,198918,198919,1,2,0
57001,6,1,198923,198923,198924,0,1,4
57002,4,2,198927,198927,198929,0,2,3
57003,1,3,198928,198929,198932,1,4,0
57004,1,2,198929,198932,198934,3,5,0
57005,5,2,198934,198934,198936,0,2,0
57006,3,2,198937,198937,198939,0,2,1
57007,3,2,198940,198940,198942,0,2,1
57008,4,1,198944,198944,198945,0,1,2
57009,1,2,198945,198945,198947,0,2,0
57010,4,1,198949,198949,198950,0,1,2
57011,4,2,198953,198953,198955,0,2,3
57012,2,1,198955,198955,198956,0,1,0
57013,1,1,198956,198956,198957,0,1,0
57014,6,1,198962,198962,198963,0,1,5
57015,4,1,198966,198966,198967,0,1,3
57016,6,2,198972,198972,198974,0,2,5
57017,6,3,198978,198978,198981,0,3,4
57018,4,1,198982,198982,198983,0,1,1
57019,6,3,198988,198988,198991,0,3,5
57020,5,1,198993,198993,198994,0,1,2
57021,5,1,198998,198998,198999,0,1,4
57022,1,3,198999,198999,199002,0,3,0
57023,3,1,199002,199002,199003,0,1,0
57024,5,1,199007,199007,199008,0,1,4
57025,1,3,199008,199008,199011,0,3,0
57026,5,2,199013,199013,199015,0,2,2
57027,2,3,199015,199015,199018,0,3,0
57028,4,3,199019,199019,199022,0,3,1
57029,4,3,199023,199023,199026,0,3,1
57030,2,2,199025,199026,199028,1,3,0
57031,6,1,199031,199031,199032,0,1,3
57032,1,3,199032,199032,199035,0,3,0
57033,6,3,199038,199038,199041,0,3,3
57034,1,3,199039,199041,199044,2,5,0
57035,2,3,199041,199044,199047,3,6,0
57036,4,1,199045,199047,199048,2,3,0
57037,2,2,199047,199048,199050,1,3,0
57038,6,3,199053,199053,199056,0,3,3
57039,6,1,199059,199059,199060,0,1,3
57040,3,3,199062,199062,199065,0,3,2
57041,5,2,199067,199067,199069,0,2,2
57042,6,3,199073,199073,199076,0,3,4
57043,6,1,199079,199079,199080,0,1,3
57044,2,2,199081,199081,199083,0,2,1
57045,2,2,199083,199083,199085,0,2,0
57046,4,2,199087,199087,199089,0,2,2
57047,2,1,199089,199089,199090,0,1,0
57048,6,3,199095,199095,199098,0,3,5
57049,6,3,199101,199101,199104,0,3,3
57050,2,2,199103,199104,199106,1,3,0
57051,5,2,199108,199108,199110,0,2,2
57052,5,1,199113,199113,199114,0,1,3
57053,2,1,199115,199115,199116,0,1,1
57054,5,2,199120,199120,199122,0,2,4
57055,1,3,199121,199122,199125,1,4,0
57056,2,2,199123,199125,199127,2,4,0
57057,3,1,199126,199127,199128,1,2,0
57058,1,2,199127,199128,199130,1,3,0
57059,2,2,199129,199130,199132,1,3,0
57060,6,2,199135,199135,199137,0,2,3
57061,6,2,199141,199141,199143,0,2,4
57062,5,2,199146,199146,199148,0,2,3
57063,2,1,199148,199148,199149,0,1,0
57064,1,3,199149,199149,199152,0,3,0
57065,5,2,199154,199154,199156,0,2,2
57066,1,1,199155,199156,199157,1,2,0
57067,3,2,199158,199158,199160,0,2,1
57068,4,1,199162,199162,199163,0,1,2
57069,6,2,199168,199168,199170,0,2,5
57070,5,1,199173,199173,199174,0,1,3
57071,1,3,199174,199174,199177,0,3,0
57072,3,2,199177,199177,199179,0,2,0
57073,3,1,199180,199180,199181,0,1,1
57074,4,3,199184,199184,199187,0,3,3
57075,2,1,199186,199187,199188,1,2,0
57076,6,3,199192,199192,199195,0,3,4
57077,5,2,199197,199197,199199,0,2,2
57078,2,3,199199,199199,199202,0,3,0
57079,4,3,199203,199203,199206,0,3,1
57080,6,2,199209,199209,199211,0,2,3
57081,1,2,199210,199211,199213,1,3,0
57082,1,1,199211,199213,199214,2,3,0
57083,3,3,199214,199214,199217,0,3,0
57084,3,3,199217,199217,199220,0,3,0
57085,2,1,199219,199220,199221,1,2,0
57086,4,2,199223,199223,199225,0,2,2
57087,3,2,199226,199226,199228,0,2,1
57088,5,3,199231,199231,199234,0,3,3
57089,2,2,199233,199234,199236,1,3,0
57090,4,3,199237,199237,199240,0,3,1
57091,5,2,199242,199242,199244,0,2,2
57092,2,3,199244,199244,199247,0,3,0
57093,5,2,199249,199249,199251,0,2,2
57094,6,2,199255,199255,199257,0,2,4
57095,2,1,199257,199257,199258,0,1,0
57096,6,3,199263,199263,199266,0,3,5
57097,1,1,199264,199266,199267,2,3,0
57098,2,2,199266,199267,199269,1,3,0
57099,3,1,199269,199269,199270,0,1,0
57100,5,2,199274,199274,199276,0,2,4
57101,6,1,199280,199280,199281,0,1,4
57102,2,2,199282,199282,199284,0,2,1
57103,3,2,199285,199285,199287,0,2,1
57104,2,3,199287,199287,199290,0,3,0
57105,6,3,199293,199293,199296,0,3,3
57106,3,3,199296,199296,199299,0,3,0
57107,4,1,199300,199300,199301,0,1,1
57108,1,3,199301,199301,199304,0,3,0
57109,6,3,199307,199307,199310,0,3,3
57110,4,1,199311,199311,199312,0,1,1
57111,5,2,199316,199316,199318,0,2,4
57112,2,3,199318,199318,199321,0,3,0
57113,2,3,199320,199321,199324,1,4,0
57114,1,2,199321,199324,199326,3,5,0
57115,4,3,199325,199326,199329,1,4,0
57116,1,2,199326,199329,199331,3,5,0
57117,6,2,199332,199332,199334,0,2,1
57118,2,3,199334,199334,199337,0,3,0
57119,6,1,199340,199340,199341,0,1,3
57120,4,3,199344,199344,199347,0,3,3
57121,6,2,199350,199350,199352,0,2,3
57122,6,1,199356,199356,199357,0,1,4
57123,1,2,199357,199357,199359,0,2,0
57124,1,1,199358,199359,199360,1,2,0
57125,6,2,199364,199364,199366,0,2,4
57126,4,3,199368,199368,199371,0,3,2
57127,1,3,199369,199371,199374,2,5,0
57128,5,1,199374,199374,199375,0,1,0
57129,4,3,199378,199378,199381,0,3,3
57130,6,3,199384,199384,199387,0,3,3
57131,6,3,199390,199390,199393,0,3,3
57132,3,2,199393,199393,199395,0,2,0
57133,5,2,199398,199398,199400,0,2,3
57134,2,2,199400,199400,199402,0,2,0
57135,6,3,199406,199406,199409,0,3,4
57136,4,3,199410,199410,199413,0,3,1
57137,5,3,199415,199415,199418,0,3,2
57138,5,2,199420,199420,199422,0,2,2
57139,6,1,199426,199426,199427,0,1,4
57140,2,2,199428,199428,199430,0,2,1
57141,2,1,199430,199430,199431,0,1,0
57142,4,1,199434,199434,199435,0,1,3
57143,2,1,199436,199436,199437,0,1,1
57144,1,1,199437,199437,199438,0,1,0
57145,3,1,199440,199440,199441,0,1,2
57146,1,1,199441,199441,199442,0,1,0
57147,5,1,199446,199446,199447,0,1,4
57148,2,1,199448,199448,199449,0,1,1
57149,5,1,199453,199453,199454,0,1,4
57150,3,2,199456,199456,199458,0,2,2
57151,3,2,199459,199459,199461,0,2,1
57152,6,3,199465,199465,199468,0,3,4
57153,1,3,199466,199468,199471,2,5,0
57154,5,3,199471,199471,199474,0,3,0
57155,2,2,199473,199474,199476,1,3,0
57156,4,2,199477,199477,199479,0,2,1
57157,1,1,199478,199479,199480,1,2,0
57158,4,1,199482,199482,199483,0,1,2
57159,4,3,199486,199486,199489,0,3,3
57160,2,2,199488,199489,199491,1,3,0
57161,1,3,199489,199491,199494,2,5,0
57162,3,1,199492,199494,199495,2,3,0
57163,4,1,199496,199496,199497,0,1,1
57164,3,2,199499,199499,199501,0,2,2
57165,2,2,199501,199501,199503,0,2,0
57166,1,2,199502,199503,199505,1,3,0
57167,1,1,199503,199505,199506,2,3,0
57168,6,2,199509,199509,199511,0,2,3
57169,1,3,199510,199511,199514,1,4,0
57170,1,1,199511,199514,199515,3,4,0
57171,5,2,199516,199516,199518,0,2,1
57172,6,2,199522,199522,199524,0,2,4
57173,4,1,199526,199526,199527,0,1,2
57174,5,2,199531,199531,199533,0,2,4
57175,3,2,199534,199534,199536,0,2,1
57176,1,1,199535,199536,199537,1,2,0
57177,4,1,199539,199539,199540,0,1,2
57178,2,3,199541,199541,199544,0,3,1
57179,5,2,199546,199546,199548,0,2,2
57180,4,3,199550,199550,199553,0,3,2
57181,4,3,199554,199554,199557,0,3,1
57182,5,3,199559,199559,199562,0,3,2
57183,5,1,199564,199564,199565,0,1,2
57184,3,1,199567,199567,199568,0,1,2
57185,3,2,199570,199570,199572,0,2,2
57186,1,2,199571,199572,199574,1,3,0
57187,6,2,199577,199577,199579,0,2,3
57188,6,2,199583,199583,199585,0,2,4
57189,5,3,199588,199588,199591,0,3,3
57190,4,2,199592,199592,199594,0,2,1
57191,3,2,199595,199595,199597,0,2,1
57192,4,1,199599,199599,199600,0,1,2
57193,6,2,199605,199605,199607,0,2,5
57194,5,3,199610,199610,199613,0,3,3
57195,5,1,199615,199615,199616,0,1,2
57196,3,2,199618,199618,199620,0,2,2
57197,3,1,199621,199621,199622,0,1,1
57198,5,1,199626,199626,199627,0,1,4
57199,4,1,199630,199630,199631,0,1,3
57200,1,3,199631,199631,199634,0,3,0
57201,5,1,199636,199636,199637,0,1,2
57202,3,3,199639,199639,199642,0,3,2
57203,5,3,199644,199644,199647,0,3,2
57204,5,1,199649,199649,199650,0,1,2
57205,3,2,199652,199652,199654,0,2,2
57206,2,2,199654,199654,199656,0,2,0
57207,2,1,199656,199656,199657,0,1,0
57208,5,3,199661,199661,199664,0,3,4
57209,5,3,199666,199666,199669,0,3,2
57210,5,2,199671,199671,199673,0,2,2
57211,2,1,199673,199673,199674,0,1,0
57212,5,3,199678,199678,199681,0,3,4
57213,4,3,199682,199682,199685,0,3,1
57214,4,2,199686,199686,199688,0,2,1
57215,4,1,199690,199690,199691,0,1,2
57216,1,3,199691,199691,199694,0,3,0
57217,1,3,199692,199694,199697,2,5,0
57218,6,1,199698,199698,199699,0,1,1
57219,6,3,199704,199704,199707,0,3,5
57220,4,3,199708,199708,199711,0,3,1
57221,2,1,199710,199711,199712,1,2,0
57222,5,3,199715,199715,199718,0,3,3
57223,6,1,199721,199721,199722,0,1,3
57224,1,2,199722,199722,199724,0,2,0
57225,2,3,199724,199724,199727,0,3,0
57226,6,3,199730,199730,199733,0,3,3
57227,4,3,199734,199734,199737,0,3,1
57228,6,3,199740,199740,199743,0,3,3
57229,2,2,199742,199743,199745,1,3,0
57230,1,2,199743,199745,199747,2,4,0
57231,1,1,199744,199747,199748,3,4,0
57232,1,3,199745,199748,199751,3,6,0
57233,3,3,199748,199751,199754,3,6,0
57234,6,3,199754,199754,199757,0,3,0
57235,3,1,199757,199757,199758,0,1,0
57236,2,3,199759,199759,199762,0,3,1
57237,2,3,199761,199762,199765,1,4,0
57238,3,1,199764,199765,199766,1,2,0
57239,2,3,199766,199766,199769,0,3,0
57240,5,2,199771,199771,199773,0,2,2
57241,1,1,199772,199773,199774,1,2,0
57242,4,2,199776,199776,199778,0,2,2
57243,2,3,199778,199778,199781,0,3,0
57244,4,3,199782,199782,199785,0,3,1
57245,6,2,199788,199788,199790,0,2,3
57246,1,2,199789,199790,199792,1,3,0
57247,3,3,199792,199792,199795,0,3,0
57248,1,2,199793,199795,199797,2,4,0
57249,4,2,199797,199797,199799,0,2,0
57250,6,2,199803,199803,199805,0,2,4
57251,5,1,199808,199808,199809,0,1,3
57252,6,2,199814,199814,199816,0,2,5
57253,3,3,199817,199817,199820,0,3,1
57254,2,2,199819,199820,199822,1,3,0
57255,5,3,199824,199824,199827,0,3,2
57256,3,1,199827,199827,199828,0,1,0
57257,5,3,199832,199832,199835,0,3,4
57258,2,2,199834,199835,199837,1,3,0
57259,5,2,199839,199839,199841,0,2,2
57260,6,1,199845,199845,199846,0,1,4
57261,6,1,199851,199851,199852,0,1,5
57262,4,2,199855,199855,199857,0,2,3
57263,1,3,199856,199857,199860,1,4,0
57264,4,1,199860,199860,199861,0,1,0
57265,3,2,199863,199863,199865,0,2,2
57266,4,1,199867,199867,199868,0,1,2
57267,6,2,199873,199873,199875,0,2,5
57268,3,1,199876,199876,199877,0,1,1
57269,4,2,199880,199880,199882,0,2,3
57270,1,2,199881,199882,199884,1,3,0
57271,3,3,199884,199884,199887,0,3,0
57272,6,1,199890,199890,199891,0,1,3
57273,4,3,199894,199894,199897,0,3,3
57274,3,2,199897,199897,199899,0,2,0
57275,5,3,199902,199902,199905,0,3,3
57276,3,1,199905,199905,199906,0,1,0
57277,1,3,199906,199906,199909,0,3,0
57278,4,3,199910,199910,199913,0,3,1
57279,4,2,199914,199914,199916,0,2,1
57280,5,2,199919,199919,199921,0,2,3
57281,5,1,199924,199924,199925,0,1,3
57282,4,3,199928,199928,199931,0,3,3
57283,4,2,199932,199932,199934,0,2,1
57284,4,1,199936,199936,199937,0,1,2
57285,6,1,199942,199942,199943,0,1,5
57286,1,2,199943,199943,199945,0,2,0
57287,4,3,199947,199947,199950,0,3,2
57288,6,1,199953,199953,199954,0,1,3
57289,5,3,199958,199958,199961,0,3,4
57290,1,2,199959,199961,199963,2,4,0
57291,2,3,199961,199963,199966,2,5,0
57292,5,2,199966,199966,199968,0,2,0
57293,3,3,199969,199969,199972,0,3,1
57294,4,1,199973,199973,199974,0,1,1
57295,3,2,199976,199976,199978,0,2,2
57296,5,1,199981,199981,199982,0,1,3
57297,2,1,199983,199983,199984,0,1,1
57298,6,3,199989,199989,199992,0,3,5
57299,5,1,199994,199994,199995,0,1,2
57300,2,3,199996,199996,199999,0,3,1
57301,2,3,199998,199999,200002,1,4,0
57302,5,3,200003,200003,200006,0,3,1
57303,5,2,200008,200008,200010,0,2,2
57304,3,2,200011,200011,200013,0,2,1
57305,1,2,200012,200013,200015,1,3,0
57306,1,1,200013,200015,200016,2,3,0
57307,2,2,200015,200016,200018,1,3,0
57308,1,1,200016,200018,200019,2,3,0
57309,4,1,200020,200020,200021,0,1,1
57310,5,1,200025,200025,200026,0,1,4
57311,4,1,200029,200029,200030,0,1,3
57312,3,2,200032,200032,200034,0,2,2
57313,3,2,200035,200035,200037,0,2,1
57314,5,3,200040,200040,200043,0,3,3
57315,2,2,200042,200043,200045,1,3,0
57316,4,3,200046,200046,200049,0,3,1
57317,4,3,200050,200050,200053,0,3,1
57318,2,1,200052,200053,200054,1,2,0
57319,1,3,200053,200054,200057,1,4,0
57320,2,1,200055,200057,200058,2,3,0
57321,3,1,200058,200058,200059,0,1,0
57322,6,3,200064,200064,200067,0,3,5
57323,2,1,200066,200067,200068,1,2,0
57324,2,3,200068,200068,200071,0,3,0
57325,2,3,200070,200071,200074,1,4,0
57326,5,1,200075,200075,200076,0,1,1
57327,6,1,200081,200081,200082,0,1,5
57328,4,1,200085,200085,200086,0,1,3
57329,1,1,200086,200086,200087,0,1,0
57330,5,1,200091,200091,200092,0,1,4
57331,5,3,200096,200096,200099,0,3,4
57332,5,1,200101,200101,200102,0,1,2
57333,4,2,200105,200105,200107,0,2,3
57334,4,3,200109,200109,200112,0,3,2
57335,4,3,200113,200113,200116,0,3,1
57336,4,2,200117,200117,200119,0,2,1
57337,5,2,200122,200122,200124,0,2,3
57338,2,2,200124,200124,200126,0,2,0
57339,3,2,200127,200127,200129,0,2,1
57340,2,2,200129,200129,200131,0,2,0
57341,5,3,200134,200134,200137,0,3,3
57342,3,2,200137,200137,200139,0,2,0
57343,4,3,200141,200141,200144,0,3,2
57344,1,2,200142,200144,200146,2,4,0
57345,1,1,200143,200146,200147,3,4,0
57346,1,1,200144,200147,200148,3,4,0
57347,3,3,200147,200148,200151,1,4,0
57348,5,3,200152,200152,200155,0,3,1
57349,4,3,200156,200156,200159,0,3,1
57350,4,2,200160,200160,200162,0,2,1
57351,4,3,200164,200164,200167,0,3,2
57352,5,1,200169,200169,200170,0,1,2
57353,3,3,200172,200172,200175,0,3,2
57354,5,2,200177,200177,200179,0,2,2
57355,3,1,200180,200180,200181,0,1,1
57356,3,3,200183,200183,200186,0,3,2
57357,6,2,200189,200189,200191,0,2,3
57358,2,3,200191,200191,200194,0,3,0
57359,1,2,200192,200194,200196,2,4,0
57360,2,3,200194,200196,200199,2,5,0
57361,2,2,200196,200199,200201,3,5,0
57362,5,3,200201,200201,200204,0,3,0
57363,6,2,200207,200207,200209,0,2,3
57364,5,3,200212,200212,200215,0,3,3
57365,5,2,200217,200217,200219,0,2,2
57366,6,1,200223,200223,200224,0,1,4
57367,5,1,200228,200228,200229,0,1,4
57368,3,1,200231,200231,200232,0,1,2
57369,3,2,200234,200234,200236,0,2,2
57370,4,2,200238,200238,200240,0,2,2
57371,6,3,200244,200244,200247,0,3,4
57372,5,1,200249,200249,200250,0,1,2
57373,2,1,200251,200251,200252,0,1,1
57374,2,2,200253,200253,200255,0,2,1
57375,6,1,200259,200259,200260,0,1,4
57376,2,1,200261,200261,200262,0,1,1
57377,1,2,200262,200262,200264,0,2,0
57378,2,1,200264,200264,200265,0,1,0
57379,5,3,200269,200269,200272,0,3,4
57380,5,3,200274,200274,200277,0,3,2
57381,5,2,200279,200279,200281,0,2,2
57382,2,2,200281,200281,200283,0,2,0
57383,6,1,200287,200287,200288,0,1,4
57384,1,1,200288,200288,200289,0,1,0
57385,1,2,200289,200289,200291,0,2,0
57386,3,2,200292,200292,200294,0,2,1
57387,3,3,200295,200295,200298,0,3,1
57388,5,3,200300,200300,200303,0,3,2
57389,5,1,200305,200305,200306,0,1,2
57390,2,3,200307,200307,200310,0,3,1
57391,6,3,200313,200313,200316,0,3,3
57392,3,1,200316,200316,200317,0,1,0
57393,6,2,200322,200322,200324,0,2,5
57394,2,3,200324,200324,200327,0,3,0
57395,5,1,200329,200329,200330,0,1,2
57396,3,1,200332,200332,200333,0,1,2
57397,3,3,200335,200335,200338,0,3,2
57398,5,2,200340,200340,200342,0,2,2
57399,3,3,200343,200343,200346,0,3,1
57400,5,3,200348,200348,200351,0,3,2
57401,5,3,200353,200353,200356,0,3,2
57402,3,1,200356,200356,200357,0,1,0
57403,5,1,200361,200361,200362,0,1,4
57404,5,3,200366,200366,200369,0,3,4
57405,5,2,200371,200371,200373,0,2,2
57406,2,1,200373,200373,200374,0,1,0
57407,4,2,200377,200377,200379,0,2,3
57408,6,1,200383,200383,200384,0,1,4
57409,5,2,200388,200388,200390,0,2,4
57410,3,3,200391,200391,200394,0,3,1
57411,3,1,200394,200394,200395,0,1,0
57412,6,1,200400,200400,200401,0,1,5
57413,4,2,200404,200404,200406,0,2,3
57414,3,1,200407,200407,200408,0,1,1
57415,6,2,200413,200413,200415,0,2,5
57416,6,2,200419,200419,200421,0,2,4
57417,5,1,200424,200424,200425,0,1,3
57418,3,2,200427,200427,200429,0,2,2
57419,1,1,200428,200429,200430,1,2,0
57420,1,3,200429,200430,200433,1,4,0
57421,1,3,200430,200433,200436,3,6,0
57422,3,3,200433,200436,200439,3,6,0
57423,4,1,200437,200439,200440,2,3,0
57424,5,2,200442,200442,200444,0,2,2
57425,5,3,200447,200447,200450,0,3,3
57426,1,2,200448,200450,200452,2,4,0
57427,5,2,200453,200453,200455,0,2,1
57428,3,1,200456,200456,200457,0,1,1
57429,5,2,200461,200461,200463,0,2,4
57430,6,1,200467,200467,200468,0,1,4
57431,5,2,200472,200472,200474,0,2,4
57432,3,3,200475,200475,200478,0,3,1
57433,4,1,200479,200479,200480,0,1,1
57434,5,1,200484,200484,200485,0,1,4
57435,3,3,200487,200487,200490,0,3,2
57436,4,3,200491,200491,200494,0,3,1
57437,4,3,200495,200495,200498,0,3,1
57438,2,3,200497,200498,200501,1,4,0
57439,5,2,200502,200502,200504,0,2,1
57440,4,2,200506,200506,200508,0,2,2
57441,4,2,200510,200510,200512,0,2,2
57442,1,1,200511,200512,200513,1,2,0
57443,6,3,200517,200517,200520,0,3,4
57444,4,1,200521,200521,200522,0,1,1
57445,4,2,200525,200525,200527,0,2,3
57446,6,2,200531,200531,200533,0,2,4
57447,2,2,200533,200533,200535,0,2,0
57448,6,2,200539,200539,200541,0,2,4
57449,4,3,200543,200543,200546,0,3,2
57450,3,3,200546,200546,200549,0,3,0
57451,1,1,200547,200549,200550,2,3,0
57452,5,1,200552,200552,200553,0,1,2
57453,2,2,200554,200554,200556,0,2,1
57454,3,2,200557,200557,200559,0,2,1
57455,1,1,200558,200559,200560,1,2,0
57456,2,1,200560,200560,200561,0,1,0
57457,5,1,200565,200565,200566,0,1,4
57458,6,3,200571,200571,200574,0,3,5
57459,6,3,200577,200577,200580,0,3,3
57460,3,2,200580,200580,200582,0,2,0
57461,3,2,200583,200583,200585,0,2,1
57462,4,1,200587,200587,200588,0,1,2
57463,1,1,200588,200588,200589,0,1,0
57464,6,1,200594,200594,200595,0,1,5
57465,5,3,200599,200599,200602,0,3,4
57466,3,1,200602,200602,200603,0,1,0
57467,4,1,200606,200606,200607,0,1,3
57468,6,1,200612,200612,200613,0,1,5
57469,5,2,200617,200617,200619,0,2,4
57470,3,3,200620,200620,200623,0,3,1
57471,5,1,200625,200625,200626,0,1,2
57472,5,1,200630,200630,200631,0,1,4
57473,6,3,200636,200636,200639,0,3,5
57474,4,1,200640,200640,200641,0,1,1
57475,2,3,200642,200642,200645,0,3,1
57476,4,1,200646,200646,200647,0,1,1
57477,6,3,200652,200652,200655,0,3,5
57478,5,3,200657,200657,200660,0,3,2
57479,4,1,200661,200661,200662,0,1,1
57480,1,1,200662,200662,200663,0,1,0
57481,5,2,200667,200667,200669,0,2,4
57482,3,1,200670,200670,200671,0,1,1
57483,6,3,200676,200676,200679,0,3,5
57484,2,1,200678,200679,200680,1,2,0
57485,5,1,200683,200683,200684,0,1,3
57486,5,1,200688,200688,200689,0,1,4
57487,6,3,200694,200694,200697,0,3,5
57488,4,2,200698,200698,200700,0,2,1
57489,6,2,200704,200704,200706,0,2,4
57490,6,3,200710,200710,200713,0,3,4
57491,1,3,200711,200713,200716,2,5,0
57492,2,3,200713,200716,200719,3,6,0
57493,3,3,200716,200719,200722,3,6,0
57494,1,3,200717,200722,200725,5,8,0
57495,1,2,200718,200725,200727,7,9,0
57496,3,2,200721,200727,200729,6,8,0
57497,1,1,200722,200729,200730,7,8,0
57498,2,2,200724,200730,200732,6,8,0
57499,1,3,200725,200732,200735,7,10,0
57500,4,3,200729,200735,200738,6,9,0
57501,3,1,200732,200738,200739,6,7,0
57502,5,2,200737,200739,200741,2,4,0
57503,4,3,200741,200741,200744,0,3,0
57504,4,2,200745,200745,200747,0,2,1
57505,5,1,200750,200750,200751,0,1,3
57506,5,2,200755,200755,200757,0,2,4
57507,6,3,200761,200761,200764,0,3,4
57508,5,1,200766,200766,200767,0,1,2
57509,2,3,200768,200768,200771,0,3,1
57510,2,3,200770,200771,200774,1,4,0
57511,6,1,200776,200776,200777,0,1,2
57512,6,3,200782,200782,200785,0,3,5
57513,1,1,200783,200785,200786,2,3,0
57514,3,3,200786,200786,200789,0,3,0
57515,6,2,200792,200792,200794,0,2,3
57516,4,2,200796,200796,200798,0,2,2
57517,3,2,200799,200799,200801,0,2,1
57518,6,3,200805,200805,200808,0,3,4
57519,4,1,200809,200809,200810,0,1,1
57520,4,1,200813,200813,200814,0,1,3
57521,3,1,200816,200816,200817,0,1,2
57522,4,1,200820,200820,200821,0,1,3
57523,6,3,200826,200826,200829,0,3,5
57524,3,3,200829,200829,200832,0,3,0
57525,4,3,200833,200833,200836,0,3,1
57526,4,3,200837,200837,200840,0,3,1
57527,1,3,200838,200840,200843,2,5,0
57528,2,1,200840,200843,200844,3,4,0
57529,5,3,200845,200845,200848,0,3,1
57530,6,2,200851,200851,200853,0,2,3
57531,4,2,200855,200855,200857,0,2,2
57532,2,1,200857,200857,200858,0,1,0
57533,6,1,200863,200863,200864,0,1,5
57534,1,1,200864,200864,200865,0,1,0
57535,4,1,200868,200868,200869,0,1,3
57536,3,1,200871,200871,200872,0,1,2
57537,5,1,200876,200876,200877,0,1,4
57538,4,3,200880,200880,200883,0,3,3
57539,6,3,200886,200886,200889,0,3,3
57540,2,2,200888,200889,200891,1,3,0
57541,3,3,200891,200891,200894,0,3,0
57542,6,2,200897,200897,200899,0,2,3
57543,5,2,200902,200902,200904,0,2,3
57544,6,3,200908,200908,200911,0,3,4
57545,3,3,200911,200911,200914,0,3,0
57546,2,1,200913,200914,200915,1,2,0
57547,2,2,200915,200915,200917,0,2,0
57548,3,1,200918,200918,200919,0,1,1
57549,2,1,200920,200920,200921,0,1,1
57550,2,3,200922,200922,200925,0,3,1
57551,6,3,200928,200928,200931,0,3,3
57552,2,1,200930,200931,200932,1,2,0
57553,3,2,200933,200933,200935,0,2,1
57554,6,1,200939,200939,200940,0,1,4
57555,5,3,200944,200944,200947,0,3,4
57556,5,3,200949,200949,200952,0,3,2
57557,5,3,200954,200954,200957,0,3,2
57558,3,1,200957,200957,200958,0,1,0
57559,5,1,200962,200962,200963,0,1,4
57560,4,1,200966,200966,200967,0,1,3
57561,5,2,200971,200971,200973,0,2,4
57562,2,1,200973,200973,200974,0,1,0
57563,6,1,200979,200979,200980,0,1,5
57564,6,3,200985,200985,200988,0,3,5
57565,4,2,200989,200989,200991,0,2,1
57566,4,1,200993,200993,200994,0,1,2
57567,6,2,200999,200999,201001,0,2,5
57568,1,2,201000,201001,201003,1,3,0
57569,6,3,201006,201006,201009,0,3,3
57570,4,1,201010,201010,201011,0,1,1
57571,2,2,201012,201012,201014,0,2,1
57572,3,1,201015,201015,201016,0,1,1
57573,2,2,201017,201017,201019,0,2,1
57574,5,2,201022,201022,201024,0,2,3
57575,1,3,201023,201024,201027,1,4,0
57576,6,3,201029,201029,201032,0,3,2
57577,4,1,201033,201033,201034,0,1,1
57578,1,1,201034,201034,201035,0,1,0
57579,4,3,201038,201038,201041,0,3,3
57580,1,3,201039,201041,201044,2,5,0
57581,2,1,201041,201044,201045,3,4,0
57582,4,1,201045,201045,201046,0,1,0
57583,5,1,201050,201050,201051,0,1,4
57584,4,1,201054,201054,201055,0,1,3
57585,1,2,201055,201055,201057,0,2,0
57586,5,3,201060,201060,201063,0,3,3
57587,2,1,201062,201063,201064,1,2,0
57588,5,2,201067,201067,201069,0,2,3
57589,1,1,201068,201069,201070,1,2,0
57590,2,2,201070,201070,201072,0,2,0
57591,2,1,201072,201072,201073,0,1,0
57592,6,1,201078,201078,201079,0,1,5
57593,6,3,201084,201084,201087,0,3,5
57594,5,2,201089,201089,201091,0,2,2
57595,6,2,201095,201095,201097,0,2,4
57596,2,3,201097,201097,201100,0,3,0
57597,2,1,201099,201100,201101,1,2,0
57598,3,1,201102,201102,201103,0,1,1
57599,2,3,201104,201104,201107,0,3,1
57600,2,1,201106,201107,201108,1,2,0
57601,4,3,201110,201110,201113,0,3,2
57602,6,2,201116,201116,201118,0,2,3
57603,3,1,201119,201119,201120,0,1,1
57604,4,3,201123,201123,201126,0,3,3
57605,3,2,201126,201126,201128,0,2,0
57606,5,1,201131,201131,201132,0,1,3
57607,5,3,201136,201136,201139,0,3,4
57608,5,3,201141,201141,201144,0,3,2
57609,6,1,201147,201147,201148,0,1,3
57610,5,2,201152,201152,201154,0,2,4
57611,4,1,201156,201156,201157,0,1,2
57612,4,1,201160,201160,201161,0,1,3
57613,1,3,201161,201161,201164,0,3,0
57614,6,2,201167,201167,201169,0,2,3
57615,4,3,201171,201171,201174,0,3,2
57616,1,1,201172,201174,201175,2,3,0
57617,3,1,201175,201175,201176,0,1,0
57618,2,2,201177,201177,201179,0,2,1
57619,1,2,201178,201179,201181,1,3,0
57620,6,3,201184,201184,201187,0,3,3
57621,2,1,201186,201187,201188,1,2,0
57622,4,3,201190,201190,201193,0,3,2
57623,1,2,201191,201193,201195,2,4,0
57624,6,3,201197,201197,201200,0,3,2
57625,3,3,201200,201200,201203,0,3,0
57626,3,1,201203,201203,201204,0,1,0
57627,3,3,201206,201206,201209,0,3,2
57628,2,2,201208,201209,201211,1,3,0
57629,4,3,201212,201212,201215,0,3,1
57630,6,2,201218,201218,201220,0,2,3
57631,6,1,201224,201224,201225,0,1,4
57632,2,2,201226,201226,201228,0,2,1
57633,5,1,201231,201231,201232,0,1,3
57634,5,3,201236,201236,201239,0,3,4
57635,4,3,201240,201240,201243,0,3,1
57636,6,3,201246,201246,201249,0,3,3
57637,1,1,201247,201249,201250,2,3,0
57638,5,3,201252,201252,201255,0,3,2
57639,5,2,201257,201257,201259,0,2,2
57640,2,1,201259,201259,201260,0,1,0
57641,6,3,201265,201265,201268,0,3,5
57642,6,2,201271,201271,201273,0,2,3
57643,3,3,201274,201274,201277,0,3,1
57644,4,3,201278,201278,201281,0,3,1
57645,3,3,201281,201281,201284,0,3,0
57646,5,2,201286,201286,201288,0,2,2
57647,6,3,201292,201292,201295,0,3,4
57648,2,3,201294,201295,201298,1,4,0
57649,3,3,201297,201298,201301,1,4,0
57650,4,3,201301,201301,201304,0,3,0
57651,2,1,201303,201304,201305,1,2,0
57652,2,2,201305,201305,201307,0,2,0
57653,5,3,201310,201310,201313,0,3,3
57654,4,2,201314,201314,201316,0,2,1
57655,4,2,201318,201318,201320,0,2,2
57656,6,1,201324,201324,201325,0,1,4
57657,4,3,201328,201328,201331,0,3,3
57658,3,1,201331,201331,201332,0,1,0
57659,4,3,201335,201335,201338,0,3,3
57660,2,3,201337,201338,201341,1,4,0
57661,1,2,201338,201341,201343,3,5,0
57662,3,3,201341,201343,201346,2,5,0
57663,3,1,201344,201346,201347,2,3,0
57664,6,1,201350,201350,201351,0,1,3
57665,2,1,201352,201352,201353,0,1,1
57666,2,3,201354,201354,201357,0,3,1
57667,6,3,201360,201360,201363,0,3,3
57668,5,2,201365,201365,201367,0,2,2
57669,2,1,201367,201367,201368,0,1,0
57670,6,3,201373,201373,201376,0,3,5
57671,4,3,201377,201377,201380,0,3,1
57672,4,2,201381,201381,201383,0,2,1
57673,3,3,201384,201384,201387,0,3,1
57674,2,2,201386,201387,201389,1,3,0
57675,4,3,201390,201390,201393,0,3,1
57676,5,1,201395,201395,201396,0,1,2
57677,1,2,201396,201396,201398,0,2,0
57678,3,1,201399,201399,201400,0,1,1
57679,6,2,201405,201405,201407,0,2,5
57680,4,3,201409,201409,201412,0,3,2
57681,2,3,201411,201412,201415,1,4,0
57682,5,3,201416,201416,201419,0,3,1
57683,1,3,201417,201419,201422,2,5,0
57684,5,2,201422,201422,201424,0,2,0
57685,2,1,201424,201424,201425,0,1,0
57686,6,2,201430,201430,201432,0,2,5
57687,5,1,201435,201435,201436,0,1,3
57688,6,3,201441,201441,201444,0,3,5
57689,3,2,201444,201444,201446,0,2,0
57690,1,2,201445,201446,201448,1,3,0
57691,5,1,201450,201450,201451,0,1,2
57692,2,2,201452,201452,201454,0,2,1
57693,4,1,201456,201456,201457,0,1,2
57694,6,2,201462,201462,201464,0,2,5
57695,1,2,201463,201464,201466,1,3,0
57696,5,1,201468,201468,201469,0,1,2
57697,3,3,201471,201471,201474,0,3,2
57698,6,3,201477,201477,201480,0,3,3
57699,6,1,201483,201483,201484,0,1,3
57700,1,3,201484,201484,201487,0,3,0
57701,5,2,201489,201489,201491,0,2,2
57702,5,3,201494,201494,201497,0,3,3
57703,2,3,201496,201497,201500,1,4,0
57704,5,1,201501,201501,201502,0,1,1
57705,3,2,201504,201504,201506,0,2,2
57706,2,3,201506,201506,201509,0,3,0
57707,2,3,201508,201509,201512,1,4,0
57708,4,2,201512,201512,201514,0,2,0
57709,6,2,201518,201518,201520,0,2,4
57710,3,2,201521,201521,201523,0,2,1
57711,2,1,201523,201523,201524,0,1,0
57712,4,3,201527,201527,201530,0,3,3
57713,6,3,201533,201533,201536,0,3,3
57714,6,3,201539,201539,201542,0,3,3
57715,2,3,201541,201542,201545,1,4,0
57716,5,1,201546,201546,201547,0,1,1
57717,5,1,201551,201551,201552,0,1,4
57718,6,2,201557,201557,201559,0,2,5
57719,6,3,201563,201563,201566,0,3,4
57720,3,2,201566,201566,201568,0,2,0
57721,1,2,201567,201568,201570,1,3,0
57722,2,3,201569,201570,201573,1,4,0
57723,4,2,201573,201573,201575,0,2,0
57724,1,2,201574,201575,201577,1,3,0
57725,3,1,201577,201577,201578,0,1,0
57726,2,1,201579,201579,201580,0,1,1
57727,4,3,201583,201583,201586,0,3,3
57728,5,3,201588,201588,201591,0,3,2
57729,2,1,201590,201591,201592,1,2,0
57730,4,1,201594,201594,201595,0,1,2
57731,2,3,201596,201596,201599,0,3,1
57732,6,3,201602,201602,201605,0,3,3
57733,4,2,201606,201606,201608,0,2,1
57734,3,1,201609,201609,201610,0,1,1
57735,2,1,201611,201611,201612,0,1,1
57736,5,1,201616,201616,201617,0,1,4
57737,3,2,201619,201619,201621,0,2,2
57738,5,3,201624,201624,201627,0,3,3
57739,1,3,201625,201627,201630,2,5,0
57740,5,1,201630,201630,201631,0,1,0
57741,2,2,201632,201632,201634,0,2,1
57742,4,3,201636,201636,201639,0,3,2
57743,3,1,201639,201639,201640,0,1,0
57744,3,3,201642,201642,201645,0,3,2
57745,1,2,201643,201645,201647,2,4,0
57746,2,2,201645,201647,201649,2,4,0
57747,2,1,201647,201649,201650,2,3,0
57748,1,3,201648,201650,201653,2,5,0
57749,3,1,201651,201653,201654,2,3,0
57750,4,3,201655,201655,201658,0,3,1
57751,1,2,201656,201658,201660,2,4,0
57752,1,1,201657,201660,201661,3,4,0
57753,1,3,201658,201661,201664,3,6,0
57754,3,1,201661,201664,201665,3,4,0
57755,1,1,201662,201665,201666,3,4,0
57756,4,1,201666,201666,201667,0,1,0
57757,4,2,201670,201670,201672,0,2,3
57758,5,3,201675,201675,201678,0,3,3
57759,4,2,201679,201679,201681,0,2,1
57760,5,1,201684,201684,201685,0,1,3
57761,2,3,201686,201686,201689,0,3,1
57762,2,2,201688,201689,201691,1,3,0
57763,5,1,201693,201693,201694,0,1,2
57764,4,2,201697,201697,201699,0,2,3
57765,1,1,201698,201699,201700,1,2,0
57766,1,2,201699,201700,201702,1,3,0
57767,6,2,201705,201705,201707,0,2,3
57768,6,2,201711,201711,201713,0,2,4
57769,6,1,201717,201717,201718,0,1,4
57770,5,2,201722,201722,201724,0,2,4
57771,4,3,201726,201726,201729,0,3,2
57772,2,2,201728,201729,201731,1,3,0
57773,6,2,201734,201734,201736,0,2,3
57774,5,1,201739,201739,201740,0,1,3
57775,5,2,201744,201744,201746,0,2,4
57776,1,3,201745,201746,201749,1,4,0
57777,1,1,201746,201749,201750,3,4,0
57778,6,2,201752,201752,201754,0,2,2
57779,3,1,201755,201755,201756,0,1,1
57780,2,1,201757,201757,201758,0,1,1
57781,2,2,201759,201759,201761,0,2,1
57782,4,3,201763,201763,201766,0,3,2
57783,6,1,201769,201769,201770,0,1,3
57784,3,2,201772,201772,201774,0,2,2
57785,5,1,201777,201777,201778,0,1,3
57786,4,2,201781,201781,201783,0,2,3
57787,4,2,201785,201785,201787,0,2,2
57788,5,1,201790,201790,201791,0,1,3
57789,2,2,201792,201792,201794,0,2,1
57790,4,2,201796,201796,201798,0,2,2
57791,3,3,201799,201799,201802,0,3,1
57792,2,2,201801,201802,201804,1,3,0
57793,5,2,201806,201806,201808,0,2,2
57794,1,3,201807,201808,201811,1,4,0
57795,6,1,201813,201813,201814,0,1,2
57796,1,2,201814,201814,201816,0,2,0
57797,3,1,201817,201817,201818,0,1,1
57798,4,2,201821,201821,201823,0,2,3
57799,5,2,201826,201826,201828,0,2,3
57800,1,1,201827,201828,201829,1,2,0
57801,5,2,201832,201832,201834,0,2,3
57802,4,1,201836,201836,201837,0,1,2
57803,2,2,201838,201838,201840,0,2,1
57804,3,2,201841,201841,201843,0,2,1
57805,5,1,201846,201846,201847,0,1,3
57806,2,3,201848,201848,201851,0,3,1
57807,1,2,201849,201851,201853,2,4,0
57808,6,3,201855,201855,201858,0,3,2
57809,1,2,201856,201858,201860,2,4,0
57810,1,2,201857,201860,201862,3,5,0
57811,1,2,201858,201862,201864,4,6,0
57812,6,2,201864,201864,201866,0,2,0
57813,4,3,201868,201868,201871,0,3,2
57814,6,3,201874,201874,201877,0,3,3
57815,5,1,201879,201879,201880,0,1,2
57816,6,2,201885,201885,201887,0,2,5
57817,1,2,201886,201887,201889,1,3,0
57818,6,3,201892,201892,201895,0,3,3
57819,5,1,201897,201897,201898,0,1,2
57820,4,3,201901,201901,201904,0,3,3
57821,3,3,201904,201904,201907,0,3,0
57822,5,2,201909,201909,201911,0,2,2
57823,2,3,201911,201911,201914,0,3,0
57824,3,1,201914,201914,201915,0,1,0
57825,4,3,201918,201918,201921,0,3,3
57826,3,3,201921,201921,201924,0,3,0
57827,2,1,201923,201924,201925,1,2,0
57828,4,3,201927,201927,201930,0,3,2
57829,2,2,201929,201930,201932,1,3,0
57830,2,2,201931,201932,201934,1,3,0
57831,2,2,201933,201934,201936,1,3,0
57832,2,1,201935,201936,201937,1,2,0
57833,6,2,201941,201941,201943,0,2,4
57834,4,1,201945,201945,201946,0,1,2
57835,6,1,201951,201951,201952,0,1,5
57836,3,1,201954,201954,201955,0,1,2
57837,5,3,201959,201959,201962,0,3,4
57838,2,2,201961,201962,201964,1,3,0
57839,1,1,201962,201964,201965,2,3,0
57840,2,3,201964,201965,201968,1,4,0
57841,5,3,201969,201969,201972,0,3,1
57842,1,3,201970,201972,201975,2,5,0
57843,1,3,201971,201975,201978,4,7,0
57844,2,3,201973,201978,201981,5,8,0
57845,4,1,201977,201981,201982,4,5,0
57846,2,3,201979,201982,201985,3,6,0
57847,2,1,201981,201985,201986,4,5,0
57848,6,1,201987,201987,201988,0,1,1
57849,3,1,201990,201990,201991,0,1,2
57850,1,2,201991,201991,201993,0,2,0
57851,5,1,201996,201996,201997,0,1,3
57852,5,2,202001,202001,202003,0,2,4
57853,3,1,202004,202004,202005,0,1,1
57854,2,3,202006,202006,202009,0,3,1
57855,6,2,202012,202012,202014,0,2,3
57856,5,2,202017,202017,202019,0,2,3
57857,4,1,202021,202021,202022,0,1,2
57858,6,2,202027,202027,202029,0,2,5
57859,6,2,202033,202033,202035,0,2,4
57860,1,3,202034,202035,202038,1,4,0
57861,6,1,202040,202040,202041,0,1,2
57862,3,3,202043,202043,202046,0,3,2
57863,5,1,202048,202048,202049,0,1,2
57864,1,2,202049,202049,202051,0,2,0
57865,5,2,202054,202054,202056,0,2,3
57866,1,1,202055,202056,202057,1,2,0
57867,5,2,202060,202060,202062,0,2,3
57868,5,3,202065,202065,202068,0,3,3
57869,2,1,202067,202068,202069,1,2,0
57870,5,1,202072,202072,202073,0,1,3
57871,3,2,202075,202075,202077,0,2,2
57872,1,3,202076,202077,202080,1,4,0
57873,5,1,202081,202081,202082,0,1,1
57874,4,1,202085,202085,202086,0,1,3
57875,4,1,202089,202089,202090,0,1,3
57876,4,3,202093,202093,202096,0,3,3
57877,1,1,202094,202096,202097,2,3,0
57878,4,3,202098,202098,202101,0,3,1
57879,1,2,202099,202101,202103,2,4,0
57880,4,2,202103,202103,202105,0,2,0
57881,6,2,202109,202109,202111,0,2,4
57882,3,1,202112,202112,202113,0,1,1
57883,4,1,202116,202116,202117,0,1,3
57884,3,1,202119,202119,202120,0,1,2
57885,6,1,202125,202125,202126,0,1,5
57886,1,1,202126,202126,202127,0,1,0
57887,6,3,202132,202132,202135,0,3,5
57888,1,3,202133,202135,202138,2,5,0
57889,1,3,202134,202138,202141,4,7,0
57890,1,3,202135,202141,202144,6,9,0
57891,6,3,202141,202144,202147,3,6,0
57892,5,2,202146,202147,202149,1,3,0
57893,2,2,202148,202149,202151,1,3,0
57894,6,2,202154,202154,202156,0,2,3
57895,5,1,202159,202159,202160,0,1,3
57896,5,2,202164,202164,202166,0,2,4
57897,1,1,202165,202166,202167,1,2,0
57898,6,3,202171,202171,202174,0,3,4
57899,6,1,202177,202177,202178,0,1,3
57900,4,1,202181,202181,202182,0,1,3
57901,3,3,202184,202184,202187,0,3,2
57902,5,3,202189,202189,202192,0,3,2
57903,3,1,202192,202192,202193,0,1,0
57904,5,3,202197,202197,202200,0,3,4
57905,5,2,202202,202202,202204,0,2,2
57906,2,1,202204,202204,202205,0,1,0
57907,5,3,202209,202209,202212,0,3,4
57908,2,2,202211,202212,202214,1,3,0
57909,6,1,202217,202217,202218,0,1,3
57910,4,3,202221,202221,202224,0,3,3
57911,6,1,202227,202227,202228,0,1,3
57912,3,3,202230,202230,202233,0,3,2
57913,4,2,202234,202234,202236,0,2,1
57914,5,3,202239,202239,202242,0,3,3
57915,3,2,202242,202242,202244,0,2,0
57916,3,2,202245,202245,202247,0,2,1
57917,4,1,202249,202249,202250,0,1,2
57918,6,1,202255,202255,202256,0,1,5
57919,6,2,202261,202261,202263,0,2,5
57920,4,1,202265,202265,202266,0,1,2
57921,5,2,202270,202270,202272,0,2,4
57922,3,3,202273,202273,202276,0,3,1
57923,4,1,202277,202277,202278,0,1,1
57924,2,1,202279,202279,202280,0,1,1
57925,1,1,202280,202280,202281,0,1,0
57926,3,3,202283,202283,202286,0,3,2
57927,6,3,202289,202289,202292,0,3,3
57928,2,3,202291,202292,202295,1,4,0
57929,1,3,202292,202295,202298,3,6,0
57930,1,3,202293,202298,202301,5,8,0
57931,5,1,202298,202301,202302,3,4,0
57932,1,3,202299,202302,202305,3,6,0
57933,4,1,202303,202305,202306,2,3,0
57934,2,3,202305,202306,202309,1,4,0
57935,6,1,202311,202311,202312,0,1,2
57936,2,2,202313,202313,202315,0,2,1
57937,1,1,202314,202315,202316,1,2,0
57938,1,1,202315,202316,202317,1,2,0
57939,1,2,202316,202317,202319,1,3,0
57940,1,2,202317,202319,202321,2,4,0
57941,4,1,202321,202321,202322,0,1,0
57942,5,1,202326,202326,202327,0,1,4
57943,6,3,202332,202332,202335,0,3,5
57944,1,2,202333,202335,202337,2,4,0
57945,5,1,202338,202338,202339,0,1,1
57946,1,1,202339,202339,202340,0,1,0
57947,6,2,202345,202345,202347,0,2,5
57948,5,2,202350,202350,202352,0,2,3
57949,1,1,202351,202352,202353,1,2,0
57950,3,2,202354,202354,202356,0,2,1
57951,6,2,202360,202360,202362,0,2,4
57952,3,2,202363,202363,202365,0,2,1
57953,3,3,202366,202366,202369,0,3,1
57954,5,2,202371,202371,202373,0,2,2
57955,6,1,202377,202377,202378,0,1,4
57956,5,2,202382,202382,202384,0,2,4
57957,5,3,202387,202387,202390,0,3,3
57958,1,2,202388,202390,202392,2,4,0
57959,2,1,202390,202392,202393,2,3,0
57960,1,2,202391,202393,202395,2,4,0
57961,2,3,202393,202395,202398,2,5,0
57962,3,1,202396,202398,202399,2,3,0
57963,3,2,202399,202399,202401,0,2,0
57964,4,2,202403,202403,202405,0,2,2
57965,6,1,202409,202409,202410,0,1,4
57966,6,3,202415,202415,202418,0,3,5
57967,5,2,202420,202420,202422,0,2,2
57968,2,2,202422,202422,202424,0,2,0
57969,3,3,202425,202425,202428,0,3,1
57970,2,3,202427,202428,202431,1,4,0
57971,4,1,202431,202431,202432,0,1,0
57972,5,3,202436,202436,202439,0,3,4
57973,6,2,202442,202442,202444,0,2,3
57974,3,2,202445,202445,202447,0,2,1
57975,6,1,202451,202451,202452,0,1,4
57976,2,3,202453,202453,202456,0,3,1
57977,5,3,202458,202458,202461,0,3,2
57978,1,1,202459,202461,202462,2,3,0
57979,2,3,202461,202462,202465,1,4,0
57980,1,3,202462,202465,202468,3,6,0
57981,4,3,202466,202468,202471,2,5,0
57982,5,3,202471,202471,202474,0,3,0
57983,1,1,202472,202474,202475,2,3,0
57984,3,2,202475,202475,202477,0,2,0
57985,4,1,202479,202479,202480,0,1,2
57986,2,2,202481,202481,202483,0,2,1
57987,6,2,202487,202487,202489,0,2,4
57988,4,2,202491,202491,202493,0,2,2
57989,2,1,202493,202493,202494,0,1,0
57990,4,2,202497,202497,202499,0,2,3
57991,4,3,202501,202501,202504,0,3,2
57992,2,1,202503,202504,202505,1,2,0
57993,4,3,202507,202507,202510,0,3,2
57994,6,3,202513,202513,202516,0,3,3
57995,1,1,202514,202516,202517,2,3,0
57996,6,3,202520,202520,202523,0,3,3
57997,4,1,202524,202524,202525,0,1,1
57998,4,3,202528,202528,202531,0,3,3
57999,1,2,202529,202531,202533,2,4,0
58000,3,1,202532,202533,202534,1,2,0
58001,2,3,202534,202534,202537,0,3,0
58002,5,1,202539,202539,202540,0,1,2
58003,4,1,202543,202543,202544,0,1,3
58004,2,1,202545,202545,202546,0,1,1
58005,2,1,202547,202547,202548,0,1,1
58006,6,2,202553,202553,202555,0,2,5
58007,5,1,202558,202558,202559,0,1,3
58008,6,3,202564,202564,202567,0,3,5
58009,6,2,202570,202570,202572,0,2,3
58010,1,1,202571,202572,202573,1,2,0
58011,4,2,202575,202575,202577,0,2,2
58012,4,1,202579,202579,202580,0,1,2
58013,2,3,202581,202581,202584,0,3,1
58014,4,2,202585,202585,202587,0,2,1
58015,2,3,202587,202587,202590,0,3,0
58016,4,2,202591,202591,202593,0,2,1
58017,5,3,202596,202596,202599,0,3,3
58018,2,3,202598,202599,202602,1,4,0
58019,2,1,202600,202602,202603,2,3,0
58020,5,2,202605,202605,202607,0,2,2
58021,4,2,202609,202609,202611,0,2,2
58022,6,2,202615,202615,202617,0,2,4
58023,5,3,202620,202620,202623,0,3,3
58024,1,1,202621,202623,202624,2,3,0
58025,2,2,202623,202624,202626,1,3,0
58026,5,1,202628,202628,202629,0,1,2
58027,5,1,202633,202633,202634,0,1,4
58028,3,1,202636,202636,202637,0,1,2
58029,1,2,202637,202637,202639,0,2,0
58030,3,3,202640,202640,202643,0,3,1
58031,6,1,202646,202646,202647,0,1,3
58032,2,1,202648,202648,202649,0,1,1
58033,4,1,202652,202652,202653,0,1,3
58034,4,3,202656,202656,202659,0,3,3
58035,2,2,202658,202659,202661,1,3,0
58036,4,1,202662,202662,202663,0,1,1
58037,6,3,202668,202668,202671,0,3,5
58038,4,1,202672,202672,202673,0,1,1
58039,3,1,202675,202675,202676,0,1,2
58040,3,1,202678,202678,202679,0,1,2
58041,4,3,202682,202682,202685,0,3,3
58042,6,2,202688,202688,202690,0,2,3
58043,1,1,202689,202690,202691,1,2,0
58044,4,2,202693,202693,202695,0,2,2
58045,4,2,202697,202697,202699,0,2,2
58046,2,3,202699,202699,202702,0,3,0
58047,4,2,202703,202703,202705,0,2,1
58048,1,3,202704,202705,202708,1,4,0
58049,1,2,202705,202708,202710,3,5,0
58050,6,1,202711,202711,202712,0,1,1
58051,1,3,202712,202712,202715,0,3,0
58052,3,1,202715,202715,202716,0,1,0
58053,2,3,202717,202717,202720,0,3,1
58054,1,1,202718,202720,202721,2,3,0
58055,6,1,202724,202724,202725,0,1,3
58056,5,3,202729,202729,202732,0,3,4
58057,1,2,202730,202732,202734,2,4,0
58058,3,3,202733,202734,202737,1,4,0
58059,1,3,202734,202737,202740,3,6,0
58060,5,1,202739,202740,202741,1,2,0
58061,4,2,202743,202743,202745,0,2,2
58062,6,2,202749,202749,202751,0,2,4
58063,6,1,202755,202755,202756,0,1,4
58064,3,1,202758,202758,202759,0,1,2
58065,1,3,202759,202759,202762,0,3,0
58066,1,1,202760,202762,202763,2,3,0
58067,3,2,202763,202763,202765,0,2,0
58068,6,1,202769,202769,202770,0,1,4
58069,6,1,202775,202775,202776,0,1,5
58070,3,3,202778,202778,202781,0,3,2
58071,3,3,202781,202781,202784,0,3,0
58072,2,1,202783,202784,202785,1,2,0
58073,2,3,202785,202785,202788,0,3,0
58074,3,2,202788,202788,202790,0,2,0
58075,2,1,202790,202790,202791,0,1,0
58076,4,1,202794,202794,202795,0,1,3
58077,4,2,202798,202798,202800,0,2,3
58078,3,3,202801,202801,202804,0,3,1
58079,2,3,202803,202804,202807,1,4,0
58080,3,1,202806,202807,202808,1,2,0
58081,5,3,202811,202811,202814,0,3,3
58082,4,2,202815,202815,202817,0,2,1
58083,4,3,202819,202819,202822,0,3,2
58084,2,3,202821,202822,202825,1,4,0
58085,5,2,202826,202826,202828,0,2,1
58086,6,1,202832,202832,202833,0,1,4
58087,6,2,202838,202838,202840,0,2,5
58088,5,2,202843,202843,202845,0,2,3
58089,2,2,202845,202845,202847,0,2,0
58090,6,2,202851,202851,202853,0,2,4
58091,5,2,202856,202856,202858,0,2,3
58092,3,1,202859,202859,202860,0,1,1
58093,3,2,202862,202862,202864,0,2,2
58094,4,3,202866,202866,202869,0,3,2
58095,1,1,202867,202869,202870,2,3,0
58096,6,3,202873,202873,202876,0,3,3
58097,3,1,202876,202876,202877,0,1,0
58098,2,3,202878,202878,202881,0,3,1
58099,6,2,202884,202884,202886,0,2,3
58100,3,2,202887,202887,202889,0,2,1
58101,2,2,202889,202889,202891,0,2,0
58102,3,3,202892,202892,202895,0,3,1
58103,5,3,202897,202897,202900,0,3,2
58104,3,2,202900,202900,202902,0,2,0
58105,3,2,202903,202903,202905,0,2,1
58106,4,3,202907,202907,202910,0,3,2
58107,4,3,202911,202911,202914,0,3,1
58108,2,2,202913,202914,202916,1,3,0
58109,5,2,202918,202918,202920,0,2,2
58110,2,3,202920,202920,202923,0,3,0
58111,1,1,202921,202923,202924,2,3,0
58112,3,1,202924,202924,202925,0,1,0
58113,3,2,202927,202927,202929,0,2,2
58114,2,2,202929,202929,202931,0,2,0
58115,4,3,202933,202933,202936,0,3,2
58116,2,2,202935,202936,202938,1,3,0
58117,6,1,202941,202941,202942,0,1,3
58118,6,2,202947,202947,202949,0,2,5
58119,2,2,202949,202949,202951,0,2,0
58120,2,2,202951,202951,202953,0,2,0
58121,3,1,202954,202954,202955,0,1,1
58122,5,1,202959,202959,202960,0,1,4
58123,5,3,202964,202964,202967,0,3,4
58124,4,2,202968,202968,202970,0,2,1
58125,6,1,202974,202974,202975,0,1,4
58126,4,3,202978,202978,202981,0,3,3
58127,6,2,202984,202984,202986,0,2,3
58128,5,1,202989,202989,202990,0,1,3
58129,6,2,202995,202995,202997,0,2,5
58130,4,2,202999,202999,203001,0,2,2
58131,5,2,203004,203004,203006,0,2,3
58132,5,1,203009,203009,203010,0,1,3
58133,3,3,203012,203012,203015,0,3,2
58134,4,2,203016,203016,203018,0,2,1
58135,4,1,203020,203020,203021,0,1,2
58136,4,3,203024,203024,203027,0,3,3
58137,4,3,203028,203028,203031,0,3,1
58138,3,1,203031,203031,203032,0,1,0
58139,3,2,203034,203034,203036,0,2,2
58140,6,1,203040,203040,203041,0,1,4
58141,5,2,203045,203045,203047,0,2,4
58142,2,3,203047,203047,203050,0,3,0
58143,3,3,203050,203050,203053,0,3,0
58144,4,3,203054,203054,203057,0,3,1
58145,2,2,203056,203057,203059,1,3,0
58146,4,3,203060,203060,203063,0,3,1
58147,1,2,203061,203063,203065,2,4,0
58148,2,1,203063,203065,203066,2,3,0
58149,6,3,203069,203069,203072,0,3,3
58150,5,1,203074,203074,203075,0,1,2
58151,5,1,203079,203079,203080,0,1,4
58152,2,3,203081,203081,203084,0,3,1
58153,6,2,203087,203087,203089,0,2,3
58154,1,2,203088,203089,203091,1,3,0
58155,2,1,203090,203091,203092,1,2,0
58156,1,2,203091,203092,203094,1,3,0
58157,6,1,203097,203097,203098,0,1,3
58158,5,1,203102,203102,203103,0,1,4
58159,6,3,203108,203108,203111,0,3,5
58160,2,3,203110,203111,203114,1,4,0
58161,2,2,203112,203114,203116,2,4,0
58162,4,1,203116,203116,203117,0,1,0
58163,3,3,203119,203119,203122,0,3,2
58164,4,1,203123,203123,203124,0,1,1
58165,5,3,203128,203128,203131,0,3,4
58166,6,3,203134,203134,203137,0,3,3
58167,5,2,203139,203139,203141,0,2,2
58168,4,3,203143,203143,203146,0,3,2
58169,1,1,203144,203146,203147,2,3,0
58170,5,1,203149,203149,203150,0,1,2
58171,2,2,203151,203151,203153,0,2,1
58172,2,3,203153,203153,203156,0,3,0
58173,5,1,203158,203158,203159,0,1,2
58174,6,1,203164,203164,203165,0,1,5
58175,6,3,203170,203170,203173,0,3,5
58176,5,2,203175,203175,203177,0,2,2
58177,1,1,203176,203177,203178,1,2,0
58178,4,2,203180,203180,203182,0,2,2
58179,3,2,203183,203183,203185,0,2,1
58180,1,2,203184,203185,203187,1,3,0
58181,1,3,203185,203187,203190,2,5,0
58182,5,2,203190,203190,203192,0,2,0
58183,3,1,203193,203193,203194,0,1,1
58184,1,2,203194,203194,203196,0,2,0
58185,3,2,203197,203197,203199,0,2,1
58186,3,2,203200,203200,203202,0,2,1
58187,6,3,203206,203206,203209,0,3,4
58188,3,1,203209,203209,203210,0,1,0
58189,3,2,203212,203212,203214,0,2,2
58190,5,3,203217,203217,203220,0,3,3
58191,6,2,203223,203223,203225,0,2,3
58192,5,2,203228,203228,203230,0,2,3
58193,4,2,203232,203232,203234,0,2,2
58194,4,2,203236,203236,203238,0,2,2
58195,2,1,203238,203238,203239,0,1,0
58196,6,1,203244,203244,203245,0,1,5
58197,6,3,203250,203250,203253,0,3,5
58198,6,3,203256,203256,203259,0,3,3
58199,3,2,203259,203259,203261,0,2,0
58200,4,3,203263,203263,203266,0,3,2
58201,6,1,203269,203269,203270,0,1,3
58202,2,1,203271,203271,203272,0,1,1
58203,6,2,203277,203277,203279,0,2,5
58204,2,3,203279,203279,203282,0,3,0
58205,6,3,203285,203285,203288,0,3,3
58206,3,2,203288,203288,203290,0,2,0
58207,4,1,203292,203292,203293,0,1,2
58208,5,1,203297,203297,203298,0,1,4
58209,2,2,203299,203299,203301,0,2,1
58210,4,2,203303,203303,203305,0,2,2
58211,5,2,203308,203308,203310,0,2,3
58212,1,1,203309,203310,203311,1,2,0
58213,6,2,203315,203315,203317,0,2,4
58214,4,2,203319,203319,203321,0,2,2
58215,1,1,203320,203321,203322,1,2,0
58216,4,2,203324,203324,203326,0,2,2
58217,5,1,203329,203329,203330,0,1,3
58218,6,3,203335,203335,203338,0,3,5
58219,2,3,203337,203338,203341,1,4,0
58220,5,1,203342,203342,203343,0,1,1
58221,6,2,203348,203348,203350,0,2,5
58222,5,1,203353,203353,203354,0,1,3
58223,1,3,203354,203354,203357,0,3,0
58224,5,3,203359,203359,203362,0,3,2
58225,1,1,203360,203362,203363,2,3,0
58226,3,1,203363,203363,203364,0,1,0
58227,1,2,203364,203364,203366,0,2,0
58228,4,3,203368,203368,203371,0,3,2
58229,6,3,203374,203374,203377,0,3,3
58230,4,3,203378,203378,203381,0,3,1
58231,4,3,203382,203382,203385,0,3,1
58232,1,1,203383,203385,203386,2,3,0
58233,6,1,203389,203389,203390,0,1,3
58234,1,1,203390,203390,203391,0,1,0
58235,1,3,203391,203391,203394,0,3,0
58236,1,3,203392,203394,203397,2,5,0
58237,3,1,203395,203397,203398,2,3,0
58238,3,1,203398,203398,203399,0,1,0
58239,5,1,203403,203403,203404,0,1,4
58240,2,3,203405,203405,203408,0,3,1
58241,5,1,203410,203410,203411,0,1,2
58242,1,3,203411,203411,203414,0,3,0
58243,1,3,203412,203414,203417,2,5,0
58244,2,2,203414,203417,203419,3,5,0
58245,3,2,203417,203419,203421,2,4,0
58246,2,2,203419,203421,203423,2,4,0
58247,2,3,203421,203423,203426,2,5,0
58248,1,2,203422,203426,203428,4,6,0
58249,6,3,203428,203428,203431,0,3,0
58250,3,1,203431,203431,203432,0,1,0
58251,1,2,203432,203432,203434,0,2,0
58252,2,1,203434,203434,203435,0,1,0
58253,6,3,203440,203440,203443,0,3,5
58254,5,1,203445,203445,203446,0,1,2
58255,5,2,203450,203450,203452,0,2,4
58256,4,1,203454,203454,203455,0,1,2
58257,2,3,203456,203456,203459,0,3,1
58258,2,2,203458,203459,203461,1,3,0
58259,5,2,203463,203463,203465,0,2,2
58260,1,1,203464,203465,203466,1,2,0
58261,1,3,203465,203466,203469,1,4,0
58262,6,2,203471,203471,203473,0,2,2
58263,1,2,203472,203473,203475,1,3,0
58264,3,3,203475,203475,203478,0,3,0
58265,4,3,203479,203479,203482,0,3,1
58266,6,3,203485,203485,203488,0,3,3
58267,1,1,203486,203488,203489,2,3,0
58268,3,3,203489,203489,203492,0,3,0
58269,1,3,203490,203492,203495,2,5,0
58270,1,2,203491,203495,203497,4,6,0
58271,1,2,203492,203497,203499,5,7,0
58272,1,1,203493,203499,203500,6,7,0
58273,2,1,203495,203500,203501,5,6,0
58274,1,1,203496,203501,203502,5,6,0
58275,4,1,203500,203502,203503,2,3,0
58276,2,3,203502,203503,203506,1,4,0
58277,1,3,203503,203506,203509,3,6,0
58278,4,3,203507,203509,203512,2,5,0
58279,5,3,203512,203512,203515,0,3,0
58280,3,2,203515,203515,203517,0,2,0
58281,4,3,203519,203519,203522,0,3,2
58282,2,1,203521,203522,203523,1,2,0
58283,1,1,203522,203523,203524,1,2,0
58284,4,2,203526,203526,203528,0,2,2
58285,6,3,203532,203532,203535,0,3,4
58286,1,3,203533,203535,203538,2,5,0
58287,1,2,203534,203538,203540,4,6,0
58288,2,2,203536,203540,203542,4,6,0
58289,5,1,203541,203542,203543,1,2,0
58290,3,1,203544,203544,203545,0,1,1
58291,3,3,203547,203547,203550,0,3,2
58292,5,3,203552,203552,203555,0,3,2
58293,4,2,203556,203556,203558,0,2,1
58294,1,2,203557,203558,203560,1,3,0
58295,2,2,203559,203560,203562,1,3,0
58296,4,3,203563,203563,203566,0,3,1
58297,4,1,203567,203567,203568,0,1,1
58298,3,3,203570,203570,203573,0,3,2
58299,6,1,203576,203576,203577,0,1,3
58300,2,1,203578,203578,203579,0,1,1
58301,6,2,203584,203584,203586,0,2,5
58302,6,1,203590,203590,203591,0,1,4
58303,4,2,203594,203594,203596,0,2,3
58304,5,1,203599,203599,203600,0,1,3
58305,5,3,203604,203604,203607,0,3,4
58306,3,2,203607,203607,203609,0,2,0
58307,2,3,203609,203609,203612,0,3,0
58308,2,1,203611,203612,203613,1,2,0
58309,5,1,203616,203616,203617,0,1,3
58310,6,2,203622,203622,203624,0,2,5
58311,1,3,203623,203624,203627,1,4,0
58312,1,3,203624,203627,203630,3,6,0
58313,5,1,203629,203630,203631,1,2,0
58314,4,3,203633,203633,203636,0,3,2
58315,3,1,203636,203636,203637,0,1,0
58316,1,3,203637,203637,203640,0,3,0
58317,4,1,203641,203641,203642,0,1,1
58318,4,2,203645,203645,203647,0,2,3
58319,4,2,203649,203649,203651,0,2,2
58320,4,1,203653,203653,203654,0,1,2
58321,5,2,203658,203658,203660,0,2,4
58322,3,2,203661,203661,203663,0,2,1
58323,1,3,203662,203663,203666,1,4,0
58324,6,2,203668,203668,203670,0,2,2
58325,1,1,203669,203670,203671,1,2,0
58326,1,1,203670,203671,203672,1,2,0
58327,1,1,203671,203672,203673,1,2,0
58328,5,3,203676,203676,203679,0,3,3
58329,2,1,203678,203679,203680,1,2,0
58330,2,3,203680,203680,203683,0,3,0
58331,6,2,203686,203686,203688,0,2,3
58332,3,3,203689,203689,203692,0,3,1
58333,1,1,203690,203692,203693,2,3,0
58334,1,2,203691,203693,203695,2,4,0
58335,4,3,203695,203695,203698,0,3,0
58336,4,3,203699,203699,203702,0,3,1
58337,3,3,203702,203702,203705,0,3,0
58338,5,1,203707,203707,203708,0,1,2
58339,1,2,203708,203708,203710,0,2,0
58340,4,3,203712,203712,203715,0,3,2
58341,5,1,203717,203717,203718,0,1,2
58342,4,2,203721,203721,203723,0,2,3
58343,6,2,203727,203727,203729,0,2,4
58344,2,3,203729,203729,203732,0,3,0
58345,2,1,203731,203732,203733,1,2,0
58346,5,1,203736,203736,203737,0,1,3
58347,3,3,203739,203739,203742,0,3,2
58348,6,2,203745,203745,203747,0,2,3
58349,6,1,203751,203751,203752,0,1,4
58350,3,2,203754,203754,203756,0,2,2
58351,1,2,203755,203756,203758,1,3,0
58352,6,2,203761,203761,203763,0,2,3
58353,6,3,203767,203767,203770,0,3,4
58354,6,1,203773,203773,203774,0,1,3
58355,4,1,203777,203777,203778,0,1,3
58356,4,1,203781,203781,203782,0,1,3
58357,4,2,203785,203785,203787,0,2,3
58358,3,1,203788,203788,203789,0,1,1
58359,4,1,203792,203792,203793,0,1,3
58360,4,2,203796,203796,203798,0,2,3
58361,4,1,203800,203800,203801,0,1,2
58362,2,1,203802,203802,203803,0,1,1
58363,4,3,203806,203806,203809,0,3,3
58364,1,1,203807,203809,203810,2,3,0
58365,6,2,203813,203813,203815,0,2,3
58366,3,2,203816,203816,203818,0,2,1
58367,5,1,203821,203821,203822,0,1,3
58368,2,2,203823,203823,203825,0,2,1
58369,4,1,203827,203827,203828,0,1,2
58370,6,3,203833,203833,203836,0,3,5
58371,2,3,203835,203836,203839,1,4,0
58372,2,1,203837,203839,203840,2,3,0
58373,4,1,203841,203841,203842,0,1,1
58374,6,2,203847,203847,203849,0,2,5
58375,1,3,203848,203849,203852,1,4,0
58376,1,2,203849,203852,203854,3,5,0
58377,5,2,203854,203854,203856,0,2,0
58378,1,2,203855,203856,203858,1,3,0
58379,1,1,203856,203858,203859,2,3,0
58380,5,3,203861,203861,203864,0,3,2
58381,5,2,203866,203866,203868,0,2,2
58382,3,1,203869,203869,203870,0,1,1
58383,5,3,203874,203874,203877,0,3,4
58384,1,2,203875,203877,203879,2,4,0
58385,5,1,203880,203880,203881,0,1,1
58386,5,2,203885,203885,203887,0,2,4
58387,6,1,203891,203891,203892,0,1,4
58388,4,1,203895,203895,203896,0,1,3
58389,3,2,203898,203898,203900,0,2,2
58390,1,1,203899,203900,203901,1,2,0
58391,2,1,203901,203901,203902,0,1,0
58392,5,1,203906,203906,203907,0,1,4
58393,5,2,203911,203911,203913,0,2,4
58394,3,1,203914,203914,203915,0,1,1
58395,6,1,203920,203920,203921,0,1,5
58396,4,3,203924,203924,203927,0,3,3
58397,6,1,203930,203930,203931,0,1,3
58398,4,3,203934,203934,203937,0,3,3
58399,1,1,203935,203937,203938,2,3,0
58400,6,3,203941,203941,203944,0,3,3
58401,1,2,203942,203944,203946,2,4,0
58402,6,2,203948,203948,203950,0,2,2
58403,6,2,203954,203954,203956,0,2,4
58404,4,3,203958,203958,203961,0,3,2
58405,4,1,203962,203962,203963,0,1,1
58406,2,3,203964,203964,203967,0,3,1
58407,4,2,203968,203968,203970,0,2,1
58408,2,1,203970,203970,203971,0,1,0
58409,5,1,203975,203975,203976,0,1,4
58410,3,1,203978,203978,203979,0,1,2
58411,2,3,203980,203980,203983,0,3,1
58412,2,1,203982,203983,203984,1,2,0
58413,5,3,203987,203987,203990,0,3,3
58414,2,1,203989,203990,203991,1,2,0
58415,2,2,203991,203991,203993,0,2,0
58416,2,2,203993,203993,203995,0,2,0
58417,5,3,203998,203998,204001,0,3,3
58418,3,3,204001,204001,204004,0,3,0
58419,2,3,204003,204004,204007,1,4,0
58420,2,2,204005,204007,204009,2,4,0
58421,5,2,204010,204010,204012,0,2,1
58422,2,2,204012,204012,204014,0,2,0
58423,4,2,204016,204016,204018,0,2,2
58424,2,3,204018,204018,204021,0,3,0
58425,5,1,204023,204023,204024,0,1,2
58426,4,1,204027,204027,204028,0,1,3
58427,6,2,204033,204033,204035,0,2,5
58428,5,3,204038,204038,204041,0,3,3
58429,3,1,204041,204041,204042,0,1,0
58430,2,3,204043,204043,204046,0,3,1
58431,2,1,204045,204046,204047,1,2,0
58432,4,3,204049,204049,204052,0,3,2
58433,6,3,204055,204055,204058,0,3,3
58434,4,1,204059,204059,204060,0,1,1
58435,6,2,204065,204065,204067,0,2,5
58436,3,2,204068,204068,204070,0,2,1
58437,4,3,204072,204072,204075,0,3,2
58438,3,2,204075,204075,204077,0,2,0
58439,2,2,204077,204077,204079,0,2,0
58440,3,2,204080,204080,204082,0,2,1
58441,6,1,204086,204086,204087,0,1,4
58442,2,2,204088,204088,204090,0,2,1
58443,2,2,204090,204090,204092,0,2,0
58444,3,2,204093,204093,204095,0,2,1
58445,6,3,204099,204099,204102,0,3,4
58446,5,3,204104,204104,204107,0,3,2
58447,5,3,204109,204109,204112,0,3,2
58448,5,3,204114,204114,204117,0,3,2
58449,5,1,204119,204119,204120,0,1,2
58450,3,2,204122,204122,204124,0,2,2
58451,2,2,204124,204124,204126,0,2,0
58452,6,2,204130,204130,204132,0,2,4
58453,5,2,204135,204135,204137,0,2,3
58454,1,2,204136,204137,204139,1,3,0
58455,3,1,204139,204139,204140,0,1,0
58456,3,1,204142,204142,204143,0,1,2
58457,3,2,204145,204145,204147,0,2,2
58458,5,2,204150,204150,204152,0,2,3
58459,3,1,204153,204153,204154,0,1,1
58460,1,2,204154,204154,204156,0,2,0
58461,4,1,204158,204158,204159,0,1,2
58462,2,2,204160,204160,204162,0,2,1
58463,6,1,204166,204166,204167,0,1,4
58464,5,3,204171,204171,204174,0,3,4
58465,6,3,204177,204177,204180,0,3,3
58466,1,3,204178,204180,204183,2,5,0
58467,5,3,204183,204183,204186,0,3,0
58468,1,1,204184,204186,204187,2,3,0
58469,4,3,204188,204188,204191,0,3,1
58470,2,3,204190,204191,204194,1,4,0
58471,5,1,204195,204195,204196,0,1,1
58472,2,2,204197,204197,204199,0,2,1
58473,6,1,204203,204203,204204,0,1,4
58474,5,2,204208,204208,204210,0,2,4
58475,4,2,204212,204212,204214,0,2,2
58476,1,2,204213,204214,204216,1,3,0
58477,3,3,204216,204216,204219,0,3,0
58478,2,2,204218,204219,204221,1,3,0
58479,3,3,204221,204221,204224,0,3,0
58480,5,2,204226,204226,204228,0,2,2
58481,5,3,204231,204231,204234,0,3,3
58482,4,2,204235,204235,204237,0,2,1
58483,3,3,204238,204238,204241,0,3,1
58484,6,2,204244,204244,204246,0,2,3
58485,4,1,204248,204248,204249,0,1,2
58486,6,1,204254,204254,204255,0,1,5
58487,1,3,204255,204255,204258,0,3,0
58488,2,1,204257,204258,204259,1,2,0
58489,5,1,204262,204262,204263,0,1,3
58490,6,1,204268,204268,204269,0,1,5
58491,2,2,204270,204270,204272,0,2,1
58492,6,3,204276,204276,204279,0,3,4
58493,2,1,204278,204279,204280,1,2,0
58494,4,3,204282,204282,204285,0,3,2
58495,2,3,204284,204285,204288,1,4,0
58496,1,3,204285,204288,204291,3,6,0
58497,1,1,204286,204291,204292,5,6,0
58498,2,3,204288,204292,204295,4,7,0
58499,5,3,204293,204295,204298,2,5,0
58500,5,1,204298,204298,204299,0,1,0
58501,2,1,204300,204300,204301,0,1,1
58502,1,3,204301,204301,204304,0,3,0
58503,6,1,204307,204307,204308,0,1,3
58504,2,2,204309,204309,204311,0,2,1
58505,5,3,204314,204314,204317,0,3,3
58506,2,1,204316,204317,204318,1,2,0
58507,1,1,204317,204318,204319,1,2,0
58508,5,1,204322,204322,204323,0,1,3
58509,4,1,204326,204326,204327,0,1,3
58510,3,3,204329,204329,204332,0,3,2
58511,1,2,204330,204332,204334,2,4,0
58512,6,1,204336,204336,204337,0,1,2
58513,3,2,204339,204339,204341,0,2,2
58514,6,1,204345,204345,204346,0,1,4
58515,3,2,204348,204348,204350,0,2,2
58516,4,2,204352,204352,204354,0,2,2
58517,3,2,204355,204355,204357,0,2,1
58518,4,3,204359,204359,204362,0,3,2
58519,1,2,204360,204362,204364,2,4,0
58520,3,2,204363,204364,204366,1,3,0
58521,3,2,204366,204366,204368,0,2,0
58522,6,2,204372,204372,204374,0,2,4
58523,4,1,204376,204376,204377,0,1,2
58524,3,3,204379,204379,204382,0,3,2
58525,2,2,204381,204382,204384,1,3,0
58526,2,2,204383,204384,204386,1,3,0
58527,2,3,204385,204386,204389,1,4,0
58528,5,3,204390,204390,204393,0,3,1
58529,4,1,204394,204394,204395,0,1,1
58530,5,1,204399,204399,204400,0,1,4
58531,6,1,204405,204405,204406,0,1,5
58532,4,1,204409,204409,204410,0,1,3
58533,3,2,204412,204412,204414,0,2,2
58534,4,3,204416,204416,204419,0,3,2
58535,1,2,204417,204419,204421,2,4,0
58536,6,2,204423,204423,204425,0,2,2
58537,1,3,204424,204425,204428,1,4,0
58538,2,1,204426,204428,204429,2,3,0
58539,1,1,204427,204429,204430,2,3,0
58540,1,2,204428,204430,204432,2,4,0
58541,3,1,204431,204432,204433,1,2,0
58542,6,1,204437,204437,204438,0,1,4
58543,4,2,204441,204441,204443,0,2,3
58544,5,1,204446,204446,204447,0,1,3
58545,5,1,204451,204451,204452,0,1,4
58546,5,2,204456,204456,204458,0,2,4
58547,5,2,204461,204461,204463,0,2,3
58548,1,3,204462,204463,204466,1,4,0
58549,3,1,204465,204466,204467,1,2,0
58550,2,2,204467,204467,204469,0,2,0
58551,5,2,204472,204472,204474,0,2,3
58552,2,1,204474,204474,204475,0,1,0
58553,3,3,204477,204477,204480,0,3,2
58554,2,2,204479,204480,204482,1,3,0
58555,4,2,204483,204483,204485,0,2,1
58556,3,1,204486,204486,204487,0,1,1
58557,5,3,204491,204491,204494,0,3,4
58558,6,3,204497,204497,204500,0,3,3
58559,1,3,204498,204500,204503,2,5,0
58560,1,1,204499,204503,204504,4,5,0
58561,2,2,204501,204504,204506,3,5,0
58562,4,1,204505,204506,204507,1,2,0
58563,2,2,204507,204507,204509,0,2,0
58564,5,2,204512,204512,204514,0,2,3
58565,3,3,204515,204515,204518,0,3,1
58566,5,1,204520,204520,204521,0,1,2
58567,5,1,204525,204525,204526,0,1,4
58568,1,3,204526,204526,204529,0,3,0
58569,5,1,204531,204531,204532,0,1,2
58570,2,2,204533,204533,204535,0,2,1
58571,4,3,204537,204537,204540,0,3,2
58572,4,1,204541,204541,204542,0,1,1
58573,1,3,204542,204542,204545,0,3,0
58574,6,2,204548,204548,204550,0,2,3
58575,6,3,204554,204554,204557,0,3,4
58576,4,3,204558,204558,204561,0,3,1
58577,2,1,204560,204561,204562,1,2,0
58578,6,3,204566,204566,204569,0,3,4
58579,2,1,204568,204569,204570,1,2,0
58580,3,1,204571,204571,204572,0,1,1
58581,4,1,204575,204575,204576,0,1,3
58582,4,3,204579,204579,204582,0,3,3
58583,6,1,204585,204585,204586,0,1,3
58584,1,1,204586,204586,204587,0,1,0
58585,6,2,204592,204592,204594,0,2,5
58586,2,1,204594,204594,204595,0,1,0
58587,2,1,204596,204596,204597,0,1,1
58588,5,2,204601,204601,204603,0,2,4
58589,2,1,204603,204603,204604,0,1,0
58590,4,2,204607,204607,204609,0,2,3
58591,1,1,204608,204609,204610,1,2,0
58592,1,2,204609,204610,204612,1,3,0
58593,6,2,204615,204615,204617,0,2,3
58594,5,2,204620,204620,204622,0,2,3
58595,6,2,204626,204626,204628,0,2,4
58596,2,1,204628,204628,204629,0,1,0
58597,6,3,204634,204634,204637,0,3,5
58598,5,1,204639,204639,204640,0,1,2
58599,1,1,204640,204640,204641,0,1,0
58600,3,1,204643,204643,204644,0,1,2
58601,1,3,204644,204644,204647,0,3,0
58602,3,1,204647,204647,204648,0,1,0
58603,6,2,204653,204653,204655,0,2,5
58604,6,3,204659,204659,204662,0,3,4
58605,2,1,204661,204662,204663,1,2,0
58606,4,3,204665,204665,204668,0,3,2
58607,1,1,204666,204668,204669,2,3,0
58608,1,2,204667,204669,204671,2,4,0
58609,4,2,204671,204671,204673,0,2,0
58610,4,2,204675,204675,204677,0,2,2
58611,6,2,204681,204681,204683,0,2,4
58612,6,3,204687,204687,204690,0,3,4
58613,1,3,204688,204690,204693,2,5,0
58614,2,2,204690,204693,204695,3,5,0
58615,6,2,204696,204696,204698,0,2,1
58616,1,3,204697,204698,204701,1,4,0
58617,2,3,204699,204701,204704,2,5,0
58618,1,3,204700,204704,204707,4,7,0
58619,3,3,204703,204707,204710,4,7,0
58620,4,3,204707,204710,204713,3,6,0
58621,3,1,204710,204713,204714,3,4,0
58622,1,3,204711,204714,204717,3,6,0
58623,4,2,204715,204717,204719,2,4,0
58624,1,1,204716,204719,204720,3,4,0
58625,4,3,204720,204720,204723,0,3,0
58626,4,1,204724,204724,204725,0,1,1
58627,2,3,204726,204726,204729,0,3,1
58628,3,1,204729,204729,204730,0,1,0
58629,6,3,204735,204735,204738,0,3,5
58630,2,3,204737,204738,204741,1,4,0
58631,4,1,204741,204741,204742,0,1,0
58632,1,1,204742,204742,204743,0,1,0
58633,3,3,204745,204745,204748,0,3,2
58634,6,1,204751,204751,204752,0,1,3
58635,6,2,204757,204757,204759,0,2,5
58636,6,3,204763,204763,204766,0,3,4
58637,2,1,204765,204766,204767,1,2,0
58638,4,3,204769,204769,204772,0,3,2
58639,6,3,204775,204775,204778,0,3,3
58640,1,1,204776,204778,204779,2,3,0
58641,4,3,204780,204780,204783,0,3,1
58642,1,2,204781,204783,204785,2,4,0
58643,3,1,204784,204785,204786,1,2,0
58644,2,3,204786,204786,204789,0,3,0
58645,2,2,204788,204789,204791,1,3,0
58646,5,3,204793,204793,204796,0,3,2
58647,4,1,204797,204797,204798,0,1,1
58648,3,3,204800,204800,204803,0,3,2
58649,5,2,204805,204805,204807,0,2,2
58650,6,2,204811,204811,204813,0,2,4
58651,3,1,204814,204814,204815,0,1,1
58652,4,1,204818,204818,204819,0,1,3
58653,4,1,204822,204822,204823,0,1,3
58654,2,3,204824,204824,204827,0,3,1
58655,1,3,204825,204827,204830,2,5,0
58656,2,2,204827,204830,204832,3,5,0
58657,1,3,204828,204832,204835,4,7,0
58658,1,2,204829,204835,204837,6,8,0
58659,2,3,204831,204837,204840,6,9,0
58660,5,3,204836,204840,204843,4,7,0
58661,6,3,204842,204843,204846,1,4,0
58662,5,2,204847,204847,204849,0,2,1
58663,5,3,204852,204852,204855,0,3,3
58664,2,1,204854,204855,204856,1,2,0
58665,5,1,204859,204859,204860,0,1,3
58666,4,1,204863,204863,204864,0,1,3
58667,6,2,204869,204869,204871,0,2,5
58668,4,2,204873,204873,204875,0,2,2
58669,1,3,204874,204875,204878,1,4,0
58670,3,1,204877,204878,204879,1,2,0
58671,4,3,204881,204881,204884,0,3,2
58672,1,1,204882,204884,204885,2,3,0
58673,5,3,204887,204887,204890,0,3,2
58674,1,2,204888,204890,204892,2,4,0
58675,4,2,204892,204892,204894,0,2,0
58676,4,1,204896,204896,204897,0,1,2
58677,5,2,204901,204901,204903,0,2,4
58678,3,2,204904,204904,204906,0,2,1
58679,6,2,204910,204910,204912,0,2,4
58680,1,3,204911,204912,204915,1,4,0
58681,2,3,204913,204915,204918,2,5,0
58682,3,2,204916,204918,204920,2,4,0
58683,5,2,204921,204921,204923,0,2,1
58684,5,2,204926,204926,204928,0,2,3
58685,2,3,204928,204928,204931,0,3,0
58686,1,3,204929,204931,204934,2,5,0
58687,5,2,204934,204934,204936,0,2,0
58688,2,3,204936,204936,204939,0,3,0
58689,1,3,204937,204939,204942,2,5,0
58690,1,1,204938,204942,204943,4,5,0
58691,6,1,204944,204944,204945,0,1,1
58692,6,3,204950,204950,204953,0,3,5
58693,1,2,204951,204953,204955,2,4,0
58694,1,2,204952,204955,204957,3,5,0
58695,2,2,204954,204957,204959,3,5,0
58696,6,2,204960,204960,204962,0,2,1
58697,3,2,204963,204963,204965,0,2,1
58698,3,1,204966,204966,204967,0,1,1
58699,4,3,204970,204970,204973,0,3,3
58700,4,3,204974,204974,204977,0,3,1
58701,2,3,204976,204977,204980,1,4,0
58702,1,3,204977,204980,204983,3,6,0
58703,1,2,204978,204983,204985,5,7,0
58704,6,3,204984,204985,204988,1,4,0
58705,1,1,204985,204988,204989,3,4,0
58706,2,1,204987,204989,204990,2,3,0
58707,5,1,204992,204992,204993,0,1,2
58708,4,2,204996,204996,204998,0,2,3
58709,6,3,205002,205002,205005,0,3,4
58710,1,1,205003,205005,205006,2,3,0
58711,3,3,205006,205006,205009,0,3,0
58712,6,2,205012,205012,205014,0,2,3
58713,2,2,205014,205014,205016,0,2,0
58714,2,1,205016,205016,205017,0,1,0
58715,2,1,205018,205018,205019,0,1,1
58716,5,1,205023,205023,205024,0,1,4
58717,2,2,205025,205025,205027,0,2,1
58718,6,1,205031,205031,205032,0,1,4
58719,1,3,205032,205032,205035,0,3,0
58720,5,2,205037,205037,205039,0,2,2
58721,2,1,205039,205039,205040,0,1,0
58722,6,3,205045,205045,205048,0,3,5
58723,2,1,205047,205048,205049,1,2,0
58724,4,3,205051,205051,205054,0,3,2
58725,3,1,205054,205054,205055,0,1,0
58726,2,1,205056,205056,205057,0,1,1
58727,2,1,205058,205058,205059,0,1,1
58728,3,3,205061,205061,205064,0,3,2
58729,4,1,205065,205065,205066,0,1,1
58730,6,3,205071,205071,205074,0,3,5
58731,5,1,205076,205076,205077,0,1,2
58732,1,3,205077,205077,205080,0,3,0
58733,4,2,205081,205081,205083,0,2,1
58734,3,2,205084,205084,205086,0,2,1
58735,5,1,205089,205089,205090,0,1,3
58736,2,3,205091,205091,205094,0,3,1
58737,3,3,205094,205094,205097,0,3,0
58738,6,1,205100,205100,205101,0,1,3
58739,2,1,205102,205102,205103,0,1,1
58740,1,3,205103,205103,205106,0,3,0
58741,4,1,205107,205107,205108,0,1,1
58742,1,2,205108,205108,205110,0,2,0
58743,2,2,205110,205110,205112,0,2,0
58744,2,2,205112,205112,205114,0,2,0
58745,3,1,205115,205115,205116,0,1,1
58746,4,3,205119,205119,205122,0,3,3
58747,2,3,205121,205122,205125,1,4,0
58748,2,2,205123,205125,205127,2,4,0
58749,2,3,205125,205127,205130,2,5,0
58750,1,1,205126,205130,205131,4,5,0
58751,1,3,205127,205131,205134,4,7,0
58752,6,2,205133,205134,205136,1,3,0
58753,4,3,205137,205137,205140,0,3,1
58754,5,1,205142,205142,205143,0,1,2
58755,2,2,205144,205144,205146,0,2,1
58756,3,1,205147,205147,205148,0,1,1
58757,5,1,205152,205152,205153,0,1,4
58758,3,1,205155,205155,205156,0,1,2
58759,1,1,205156,205156,205157,0,1,0
58760,4,1,205160,205160,205161,0,1,3
58761,6,2,205166,205166,205168,0,2,5
58762,6,3,205172,205172,205175,0,3,4
58763,4,1,205176,205176,205177,0,1,1
58764,1,2,205177,205177,205179,0,2,0
58765,6,1,205183,205183,205184,0,1,4
58766,3,2,205186,205186,205188,0,2,2
58767,2,3,205188,205188,205191,0,3,0
58768,3,1,205191,205191,205192,0,1,0
58769,3,2,205194,205194,205196,0,2,2
58770,2,3,205196,205196,205199,0,3,0
58771,5,2,205201,205201,205203,0,2,2
58772,4,2,205205,205205,205207,0,2,2
58773,2,1,205207,205207,205208,0,1,0
58774,1,2,205208,205208,205210,0,2,0
58775,4,2,205212,205212,205214,0,2,2
58776,3,1,205215,205215,205216,0,1,1
58777,6,2,205221,205221,205223,0,2,5
58778,2,2,205223,205223,205225,0,2,0
58779,4,3,205227,205227,205230,0,3,2
58780,5,1,205232,205232,205233,0,1,2
58781,2,1,205234,205234,205235,0,1,1
58782,5,2,205239,205239,205241,0,2,4
58783,3,3,205242,205242,205245,0,3,1
58784,4,1,205246,205246,205247,0,1,1
58785,3,1,205249,205249,205250,0,1,2
58786,4,1,205253,205253,205254,0,1,3
58787,5,2,205258,205258,205260,0,2,4
58788,5,3,205263,205263,205266,0,3,3
58789,1,2,205264,205266,205268,2,4,0
58790,3,1,205267,205268,205269,1,2,0
58791,2,2,205269,205269,205271,0,2,0
58792,5,3,205274,205274,205277,0,3,3
58793,1,3,205275,205277,205280,2,5,0
58794,3,1,205278,205280,205281,2,3,0
58795,4,2,205282,205282,205284,0,2,1
58796,3,2,205285,205285,205287,0,2,1
58797,3,2,205288,205288,205290,0,2,1
58798,4,3,205292,205292,205295,0,3,2
58799,4,1,205296,205296,205297,0,1,1
58800,6,1,205302,205302,205303,0,1,5
58801,6,2,205308,205308,205310,0,2,5
58802,4,1,205312,205312,205313,0,1,2
58803,1,2,205313,205313,205315,0,2,0
58804,6,2,205319,205319,205321,0,2,4
58805,3,1,205322,205322,205323,0,1,1
58806,1,2,205323,205323,205325,0,2,0
58807,6,3,205329,205329,205332,0,3,4
58808,1,1,205330,205332,205333,2,3,0
58809,5,3,205335,205335,205338,0,3,2
58810,2,3,205337,205338,205341,1,4,0
58811,1,3,205338,205341,205344,3,6,0
58812,5,2,205343,205344,205346,1,3,0
58813,5,2,205348,205348,205350,0,2,2
58814,5,3,205353,205353,205356,0,3,3
58815,6,2,205359,205359,205361,0,2,3
58816,4,2,205363,205363,205365,0,2,2
58817,3,3,205366,205366,205369,0,3,1
58818,6,1,205372,205372,205373,0,1,3
58819,2,3,205374,205374,205377,0,3,1
58820,5,1,205379,205379,205380,0,1,2
58821,5,2,205384,205384,205386,0,2,4
58822,1,1,205385,205386,205387,1,2,0
58823,1,1,205386,205387,205388,1,2,0
58824,2,3,205388,205388,205391,0,3,0
58825,5,3,205393,205393,205396,0,3,2
58826,2,1,205395,205396,205397,1,2,0
58827,2,3,205397,205397,205400,0,3,0
58828,1,1,205398,205400,205401,2,3,0
58829,2,3,205400,205401,205404,1,4,0
58830,2,3,205402,205404,205407,2,5,0
58831,4,2,205406,205407,205409,1,3,0
58832,3,3,205409,205409,205412,0,3,0
58833,3,3,205412,205412,205415,0,3,0
58834,3,2,205415,205415,205417,0,2,0
58835,2,3,205417,205417,205420,0,3,0
58836,6,2,205423,205423,205425,0,2,3
58837,1,1,205424,205425,205426,1,2,0
58838,6,3,205430,205430,205433,0,3,4
58839,2,1,205432,205433,205434,1,2,0
58840,3,3,205435,205435,205438,0,3,1
58841,5,2,205440,205440,205442,0,2,2
58842,3,2,205443,205443,205445,0,2,1
58843,1,1,205444,205445,205446,1,2,0
58844,1,1,205445,205446,205447,1,2,0
58845,4,3,205449,205449,205452,0,3,2
58846,1,2,205450,205452,205454,2,4,0
58847,6,3,205456,205456,205459,0,3,2
58848,5,3,205461,205461,205464,0,3,2
58849,1,1,205462,205464,205465,2,3,0
58850,1,3,205463,205465,205468,2,5,0
58851,1,3,205464,205468,205471,4,7,0
58852,4,1,205468,205471,205472,3,4,0
58853,5,3,205473,205473,205476,0,3,1
58854,5,1,205478,205478,205479,0,1,2
58855,4,2,205482,205482,205484,0,2,3
58856,5,1,205487,205487,205488,0,1,3
58857,1,2,205488,205488,205490,0,2,0
58858,4,2,205492,205492,205494,0,2,2
58859,3,1,205495,205495,205496,0,1,1
58860,4,3,205499,205499,205502,0,3,3
58861,4,3,205503,205503,205506,0,3,1
58862,2,2,205505,205506,205508,1,3,0
58863,1,3,205506,205508,205511,2,5,0
58864,5,2,205511,205511,205513,0,2,0
58865,5,2,205516,205516,205518,0,2,3
58866,3,1,205519,205519,205520,0,1,1
58867,2,2,205521,205521,205523,0,2,1
58868,5,3,205526,205526,205529,0,3,3
58869,2,3,205528,205529,205532,1,4,0
58870,5,3,205533,205533,205536,0,3,1
58871,6,3,205539,205539,205542,0,3,3
58872,4,2,205543,205543,205545,0,2,1
58873,4,3,205547,205547,205550,0,3,2
58874,4,2,205551,205551,205553,0,2,1
58875,4,3,205555,205555,205558,0,3,2
58876,5,2,205560,205560,205562,0,2,2
58877,1,1,205561,205562,205563,1,2,0
58878,3,3,205564,205564,205567,0,3,1
58879,3,2,205567,205567,205569,0,2,0
58880,3,2,205570,205570,205572,0,2,1
58881,1,1,205571,205572,205573,1,2,0
58882,2,1,205573,205573,205574,0,1,0
58883,4,2,205577,205577,205579,0,2,3
58884,3,3,205580,205580,205583,0,3,1
58885,6,3,205586,205586,205589,0,3,3
58886,2,2,205588,205589,205591,1,3,0
58887,6,2,205594,205594,205596,0,2,3
58888,6,1,205600,205600,205601,0,1,4
58889,5,1,205605,205605,205606,0,1,4
58890,1,1,205606,205606,205607,0,1,0
58891,2,3,205608,205608,205611,0,3,1
58892,2,3,205610,205611,205614,1,4,0
58893,6,3,205616,205616,205619,0,3,2
58894,3,3,205619,205619,205622,0,3,0
58895,3,3,205622,205622,205625,0,3,0
58896,2,3,205624,205625,205628,1,4,0
58897,1,2,205625,205628,205630,3,5,0
58898,4,3,205629,205630,205633,1,4,0
58899,4,3,205633,205633,205636,0,3,0
58900,6,1,205639,205639,205640,0,1,3
58901,5,3,205644,205644,205647,0,3,4
58902,4,1,205648,205648,205649,0,1,1
58903,1,3,205649,205649,205652,0,3,0
58904,1,1,205650,205652,205653,2,3,0
58905,1,1,205651,205653,205654,2,3,0
58906,3,3,205654,205654,205657,0,3,0
58907,1,2,205655,205657,205659,2,4,0
58908,1,1,205656,205659,205660,3,4,0
58909,2,1,205658,205660,205661,2,3,0
58910,1,3,205659,205661,205664,2,5,0
58911,6,3,205665,205665,205668,0,3,1
58912,4,2,205669,205669,205671,0,2,1
58913,1,3,205670,205671,205674,1,4,0
58914,5,1,205675,205675,205676,0,1,1
58915,2,3,205677,205677,205680,0,3,1
58916,2,2,205679,205680,205682,1,3,0
58917,2,3,205681,205682,205685,1,4,0
58918,3,2,205684,205685,205687,1,3,0
58919,4,1,205688,205688,205689,0,1,1
58920,6,3,205694,205694,205697,0,3,5
58921,4,3,205698,205698,205701,0,3,1
58922,6,1,205704,205704,205705,0,1,3
58923,3,2,205707,205707,205709,0,2,2
58924,5,3,205712,205712,205715,0,3,3
58925,6,2,205718,205718,205720,0,2,3
58926,4,1,205722,205722,205723,0,1,2
58927,2,1,205724,205724,205725,0,1,1
58928,1,1,205725,205725,205726,0,1,0
58929,3,2,205728,205728,205730,0,2,2
58930,5,2,205733,205733,205735,0,2,3
58931,3,2,205736,205736,205738,0,2,1
58932,6,1,205742,205742,205743,0,1,4
58933,2,1,205744,205744,205745,0,1,1
58934,6,3,205750,205750,205753,0,3,5
58935,3,3,205753,205753,205756,0,3,0
58936,4,3,205757,205757,205760,0,3,1
58937,2,3,205759,205760,205763,1,4,0
58938,1,1,205760,205763,205764,3,4,0
58939,3,3,205763,205764,205767,1,4,0
58940,6,3,205769,205769,205772,0,3,2
58941,6,3,205775,205775,205778,0,3,3
58942,1,3,205776,205778,205781,2,5,0
58943,5,3,205781,205781,205784,0,3,0
58944,2,3,205783,205784,205787,1,4,0
58945,5,3,205788,205788,205791,0,3,1
58946,6,3,205794,205794,205797,0,3,3
58947,6,2,205800,205800,205802,0,2,3
58948,3,3,205803,205803,205806,0,3,1
58949,1,1,205804,205806,205807,2,3,0
58950,2,3,205806,205807,205810,1,4,0
58951,5,1,205811,205811,205812,0,1,1
58952,1,3,205812,205812,205815,0,3,0
58953,4,1,205816,205816,205817,0,1,1
58954,6,1,205822,205822,205823,0,1,5
58955,4,3,205826,205826,205829,0,3,3
58956,1,2,205827,205829,205831,2,4,0
58957,6,3,205833,205833,205836,0,3,2
58958,4,2,205837,205837,205839,0,2,1
58959,5,3,205842,205842,205845,0,3,3
58960,3,1,205845,205845,205846,0,1,0
58961,2,3,205847,205847,205850,0,3,1
58962,5,1,205852,205852,205853,0,1,2
58963,5,2,205857,205857,205859,0,2,4
58964,2,1,205859,205859,205860,0,1,0
58965,6,3,205865,205865,205868,0,3,5
58966,5,2,205870,205870,205872,0,2,2
58967,1,2,205871,205872,205874,1,3,0
58968,4,2,205875,205875,205877,0,2,1
58969,1,1,205876,205877,205878,1,2,0
58970,6,2,205882,205882,205884,0,2,4
58971,5,3,205887,205887,205890,0,3,3
58972,2,3,205889,205890,205893,1,4,0
58973,6,3,205895,205895,205898,0,3,2
58974,2,1,205897,205898,205899,1,2,0
58975,3,1,205900,205900,205901,0,1,1
58976,1,2,205901,205901,205903,0,2,0
58977,5,3,205906,205906,205909,0,3,3
58978,3,3,205909,205909,205912,0,3,0
58979,4,1,205913,205913,205914,0,1,1
58980,3,2,205916,205916,205918,0,2,2
58981,3,3,205919,205919,205922,0,3,1
58982,3,2,205922,205922,205924,0,2,0
58983,4,3,205926,205926,205929,0,3,2
58984,3,1,205929,205929,205930,0,1,0
58985,4,3,205933,205933,205936,0,3,3
58986,4,1,205937,205937,205938,0,1,1
58987,6,3,205943,205943,205946,0,3,5
58988,2,2,205945,205946,205948,1,3,0
58989,3,1,205948,205948,205949,0,1,0
58990,1,2,205949,205949,205951,0,2,0
58991,1,2,205950,205951,205953,1,3,0
58992,4,1,205954,205954,205955,0,1,1
58993,3,2,205957,205957,205959,0,2,2
58994,4,3,205961,205961,205964,0,3,2
58995,6,3,205967,205967,205970,0,3,3
58996,1,1,205968,205970,205971,2,3,0
58997,5,2,205973,205973,205975,0,2,2
58998,2,3,205975,205975,205978,0,3,0
58999,1,1,205976,205978,205979,2,3,0
59000,2,1,205978,205979,205980,1,2,0
59001,4,3,205982,205982,205985,0,3,2
59002,1,3,205983,205985,205988,2,5,0
59003,5,2,205988,205988,205990,0,2,0
59004,5,1,205993,205993,205994,0,1,3
59005,1,2,205994,205994,205996,0,2,0
59006,6,1,206000,206000,206001,0,1,4
59007,2,1,206002,206002,206003,0,1,1
59008,4,1,206006,206006,206007,0,1,3
59009,4,1,206010,206010,206011,0,1,3
59010,3,3,206013,206013,206016,0,3,2
59011,4,3,206017,206017,206020,0,3,1
59012,4,3,206021,206021,206024,0,3,1
59013,1,1,206022,206024,206025,2,3,0
59014,3,1,206025,206025,206026,0,1,0
59015,5,2,206030,206030,206032,0,2,4
59016,5,2,206035,206035,206037,0,2,3
59017,4,2,206039,206039,206041,0,2,2
59018,5,1,206044,206044,206045,0,1,3
59019,1,2,206045,206045,206047,0,2,0
59020,1,1,206046,206047,206048,1,2,0
59021,4,3,206050,206050,206053,0,3,2
59022,5,1,206055,206055,206056,0,1,2
59023,1,2,206056,206056,206058,0,2,0
59024,5,3,206061,206061,206064,0,3,3
59025,1,1,206062,206064,206065,2,3,0
59026,5,2,206067,206067,206069,0,2,2
59027,4,1,206071,206071,206072,0,1,2
59028,4,1,206075,206075,206076,0,1,3
59029,5,1,206080,206080,206081,0,1,4
59030,4,3,206084,206084,206087,0,3,3
59031,2,3,206086,206087,206090,1,4,0
59032,5,3,206091,206091,206094,0,3,1
59033,4,3,206095,206095,206098,0,3,1
59034,3,3,206098,206098,206101,0,3,0
59035,1,1,206099,206101,206102,2,3,0
59036,4,2,206103,206103,206105,0,2,1
59037,2,1,206105,206105,206106,0,1,0
59038,1,2,206106,206106,206108,0,2,0
59039,4,2,206110,206110,206112,0,2,2
59040,2,2,206112,206112,206114,0,2,0
59041,1,2,206113,206114,206116,1,3,0
59042,1,2,206114,206116,206118,2,4,0
59043,6,2,206120,206120,206122,0,2,2
59044,3,3,206123,206123,206126,0,3,1
59045,4,3,206127,206127,206130,0,3,1
59046,5,2,206132,206132,206134,0,2,2
59047,3,1,206135,206135,206136,0,1,1
59048,4,3,206139,206139,206142,0,3,3
59049,2,1,206141,206142,206143,1,2,0
59050,4,1,206145,206145,206146,0,1,2
59051,3,2,206148,206148,206150,0,2,2
59052,6,1,206154,206154,206155,0,1,4
59053,5,2,206159,206159,206161,0,2,4
59054,2,3,206161,206161,206164,0,3,0
59055,1,2,206162,206164,206166,2,4,0
59056,6,3,206168,206168,206171,0,3,2
59057,6,2,206174,206174,206176,0,2,3
59058,1,1,206175,206176,206177,1,2,0
59059,3,2,206178,206178,206180,0,2,1
59060,3,3,206181,206181,206184,0,3,1
59061,5,2,206186,206186,206188,0,2,2
59062,3,2,206189,206189,206191,0,2,1
59063,4,1,206193,206193,206194,0,1,2
59064,2,3,206195,206195,206198,0,3,1
59065,3,1,206198,206198,206199,0,1,0
59066,6,1,206204,206204,206205,0,1,5
59067,2,1,206206,206206,206207,0,1,1
59068,1,3,206207,206207,206210,0,3,0
59069,6,3,206213,206213,206216,0,3,3
59070,2,2,206215,206216,206218,1,3,0
59071,5,3,206220,206220,206223,0,3,2
59072,1,3,206221,206223,206226,2,5,0
59073,6,1,206227,206227,206228,0,1,1
59074,3,3,206230,206230,206233,0,3,2
59075,4,2,206234,206234,206236,0,2,1
59076,2,1,206236,206236,206237,0,1,0
59077,6,1,206242,206242,206243,0,1,5
59078,1,3,206243,206243,206246,0,3,0
59079,1,2,206244,206246,206248,2,4,0
59080,1,1,206245,206248,206249,3,4,0
59081,5,3,206250,206250,206253,0,3,1
59082,5,2,206255,206255,206257,0,2,2
59083,2,3,206257,206257,206260,0,3,0
59084,5,3,206262,206262,206265,0,3,2
59085,3,1,206265,206265,206266,0,1,0
59086,1,2,206266,206266,206268,0,2,0
59087,1,1,206267,206268,206269,1,2,0
59088,3,3,206270,206270,206273,0,3,1
59089,3,2,206273,206273,206275,0,2,0
59090,6,2,206279,206279,206281,0,2,4
59091,4,2,206283,206283,206285,0,2,2
59092,6,1,206289,206289,206290,0,1,4
59093,1,1,206290,206290,206291,0,1,0
59094,4,2,206294,206294,206296,0,2,3
59095,4,3,206298,206298,206301,0,3,2
59096,1,1,206299,206301,206302,2,3,0
59097,6,2,206305,206305,206307,0,2,3
59098,5,2,206310,206310,206312,0,2,3
59099,5,1,206315,206315,206316,0,1,3
59100,4,2,206319,206319,206321,0,2,3
59101,6,1,206325,206325,206326,0,1,4
59102,2,1,206327,206327,206328,0,1,1
59103,1,3,206328,206328,206331,0,3,0
59104,6,1,206334,206334,206335,0,1,3
59105,1,2,206335,206335,206337,0,2,0
59106,6,1,206341,206341,206342,0,1,4
59107,4,1,206345,206345,206346,0,1,3
59108,2,1,206347,206347,206348,0,1,1
59109,2,3,206349,206349,206352,0,3,1
59110,1,3,206350,206352,206355,2,5,0
59111,2,1,206352,206355,206356,3,4,0
59112,4,2,206356,206356,206358,0,2,0
59113,5,1,206361,206361,206362,0,1,3
59114,1,1,206362,206362,206363,0,1,0
59115,3,3,206365,206365,206368,0,3,2
59116,6,3,206371,206371,206374,0,3,3
59117,2,1,206373,206374,206375,1,2,0
59118,4,1,206377,206377,206378,0,1,2
59119,2,1,206379,206379,206380,0,1,1
59120,1,1,206380,206380,206381,0,1,0
59121,2,2,206382,206382,206384,0,2,1
59122,5,1,206387,206387,206388,0,1,3
59123,4,2,206391,206391,206393,0,2,3
59124,3,1,206394,206394,206395,0,1,1
59125,6,2,206400,206400,206402,0,2,5
59126,2,2,206402,206402,206404,0,2,0
59127,1,2,206403,206404,206406,1,3,0
59128,3,1,206406,206406,206407,0,1,0
59129,6,3,206412,206412,206415,0,3,5
59130,5,3,206417,206417,206420,0,3,2
59131,2,1,206419,206420,206421,1,2,0
59132,6,2,206425,206425,206427,0,2,4
59133,4,1,206429,206429,206430,0,1,2
59134,1,3,206430,206430,206433,0,3,0
59135,5,3,206435,206435,206438,0,3,2
59136,3,3,206438,206438,206441,0,3,0
59137,1,3,206439,206441,206444,2,5,0
59138,3,3,206442,206444,206447,2,5,0
59139,4,3,206446,206447,206450,1,4,0
59140,3,1,206449,206450,206451,1,2,0
59141,5,3,206454,206454,206457,0,3,3
59142,6,2,206460,206460,206462,0,2,3
59143,4,3,206464,206464,206467,0,3,2
59144,5,2,206469,206469,206471,0,2,2
59145,3,3,206472,206472,206475,0,3,1
59146,2,2,206474,206475,206477,1,3,0
59147,4,2,206478,206478,206480,0,2,1
59148,6,2,206484,206484,206486,0,2,4
59149,3,2,206487,206487,206489,0,2,1
59150,1,2,206488,206489,206491,1,3,0
59151,1,3,206489,206491,206494,2,5,0
59152,1,1,206490,206494,206495,4,5,0
59153,6,3,206496,206496,206499,0,3,1
59154,2,2,206498,206499,206501,1,3,0
59155,1,3,206499,206501,206504,2,5,0
59156,1,3,206500,206504,206507,4,7,0
59157,6,2,206506,206507,206509,1,3,0
59158,4,2,206510,206510,206512,0,2,1
59159,5,2,206515,206515,206517,0,2,3
59160,3,2,206518,206518,206520,0,2,1
59161,3,1,206521,206521,206522,0,1,1
59162,2,3,206523,206523,206526,0,3,1
59163,1,2,206524,206526,206528,2,4,0
59164,3,1,206527,206528,206529,1,2,0
59165,2,3,206529,206529,206532,0,3,0
59166,6,2,206535,206535,206537,0,2,3
59167,6,2,206541,206541,206543,0,2,4
59168,1,3,206542,206543,206546,1,4,0
59169,6,2,206548,206548,206550,0,2,2
59170,5,2,206553,206553,206555,0,2,3
59171,5,2,206558,206558,206560,0,2,3
59172,2,1,206560,206560,206561,0,1,0
59173,3,3,206563,206563,206566,0,3,2
59174,6,3,206569,206569,206572,0,3,3
59175,6,1,206575,206575,206576,0,1,3
59176,4,1,206579,206579,206580,0,1,3
59177,2,2,206581,206581,206583,0,2,1
59178,4,3,206585,206585,206588,0,3,2
59179,5,1,206590,206590,206591,0,1,2
59180,6,2,206596,206596,206598,0,2,5
59181,3,1,206599,206599,206600,0,1,1
59182,2,3,206601,206601,206604,0,3,1
59183,5,1,206606,206606,206607,0,1,2
59184,5,2,206611,206611,206613,0,2,4
59185,1,1,206612,206613,206614,1,2,0
59186,5,1,206617,206617,206618,0,1,3
59187,6,3,206623,206623,206626,0,3,5
59188,4,3,206627,206627,206630,0,3,1
59189,4,3,206631,206631,206634,0,3,1
59190,3,1,206634,206634,206635,0,1,0
59191,6,2,206640,206640,206642,0,2,5
59192,3,2,206643,206643,206645,0,2,1
59193,4,1,206647,206647,206648,0,1,2
59194,6,2,206653,206653,206655,0,2,5
59195,6,2,206659,206659,206661,0,2,4
59196,1,2,206660,206661,206663,1,3,0
59197,3,1,206663,206663,206664,0,1,0
59198,3,1,206666,206666,206667,0,1,2
59199,2,3,206668,206668,206671,0,3,1
59200,6,2,206674,206674,206676,0,2,3
59201,5,2,206679,206679,206681,0,2,3
59202,1,2,206680,206681,206683,1,3,0
59203,2,3,206682,206683,206686,1,4,0
59204,2,2,206684,206686,206688,2,4,0
59205,2,3,206686,206688,206691,2,5,0
59206,6,3,206692,206692,206695,0,3,1
59207,5,3,206697,206697,206700,0,3,2
59208,2,3,206699,206700,206703,1,4,0
59209,2,1,206701,206703,206704,2,3,0
59210,6,3,206707,206707,206710,0,3,3
59211,6,3,206713,206713,206716,0,3,3
59212,5,1,206718,206718,206719,0,1,2
59213,2,3,206720,206720,206723,0,3,1
59214,2,1,206722,206723,206724,1,2,0
59215,3,3,206725,206725,206728,0,3,1
59216,3,3,206728,206728,206731,0,3,0
59217,5,3,206733,206733,206736,0,3,2
59218,3,3,206736,206736,206739,0,3,0
59219,2,3,206738,206739,206742,1,4,0
59220,4,1,206742,206742,206743,0,1,0
59221,3,1,206745,206745,206746,0,1,2
59222,4,1,206749,206749,206750,0,1,3
59223,5,2,206754,206754,206756,0,2,4
59224,4,3,206758,206758,206761,0,3,2
59225,5,2,206763,206763,206765,0,2,2
59226,6,2,206769,206769,206771,0,2,4
59227,6,1,206775,206775,206776,0,1,4
59228,4,1,206779,206779,206780,0,1,3
59229,3,2,206782,206782,206784,0,2,2
59230,2,3,206784,206784,206787,0,3,0
59231,5,1,206789,206789,206790,0,1,2
59232,6,1,206795,206795,206796,0,1,5
59233,6,2,206801,206801,206803,0,2,5
59234,6,3,206807,206807,206810,0,3,4
59235,4,2,206811,206811,206813,0,2,1
59236,2,3,206813,206813,206816,0,3,0
59237,2,1,206815,206816,206817,1,2,0
59238,4,2,206819,206819,206821,0,2,2
59239,3,2,206822,206822,206824,0,2,1
59240,2,3,206824,206824,206827,0,3,0
59241,2,3,206826,206827,206830,1,4,0
59242,5,1,206831,206831,206832,0,1,1
59243,2,3,206833,206833,206836,0,3,1
59244,6,2,206839,206839,206841,0,2,3
59245,5,2,206844,206844,206846,0,2,3
59246,2,3,206846,206846,206849,0,3,0
59247,3,1,206849,206849,206850,0,1,0
59248,3,2,206852,206852,206854,0,2,2
59249,2,1,206854,206854,206855,0,1,0
59250,5,2,206859,206859,206861,0,2,4
59251,2,2,206861,206861,206863,0,2,0
59252,3,2,206864,206864,206866,0,2,1
59253,5,3,206869,206869,206872,0,3,3
59254,6,2,206875,206875,206877,0,2,3
59255,3,1,206878,206878,206879,0,1,1
59256,2,2,206880,206880,206882,0,2,1
59257,6,3,206886,206886,206889,0,3,4
59258,2,1,206888,206889,206890,1,2,0
59259,5,3,206893,206893,206896,0,3,3
59260,5,3,206898,206898,206901,0,3,2
59261,1,1,206899,206901,206902,2,3,0
59262,3,3,206902,206902,206905,0,3,0
59263,5,1,206907,206907,206908,0,1,2
59264,6,1,206913,206913,206914,0,1,5
59265,6,2,206919,206919,206921,0,2,5
59266,1,2,206920,206921,206923,1,3,0
59267,3,3,206923,206923,206926,0,3,0
59268,3,2,206926,206926,206928,0,2,0
59269,1,2,206927,206928,206930,1,3,0
59270,2,3,206929,206930,206933,1,4,0
59271,6,2,206935,206935,206937,0,2,2
59272,5,1,206940,206940,206941,0,1,3
59273,4,1,206944,206944,206945,0,1,3
59274,3,2,206947,206947,206949,0,2,2
59275,4,1,206951,206951,206952,0,1,2
59276,5,3,206956,206956,206959,0,3,4
59277,1,2,206957,206959,206961,2,4,0
59278,1,2,206958,206961,206963,3,5,0
59279,2,2,206960,206963,206965,3,5,0
59280,2,2,206962,206965,206967,3,5,0
59281,5,1,206967,206967,206968,0,1,0
59282,4,2,206971,206971,206973,0,2,3
59283,1,3,206972,206973,206976,1,4,0
59284,6,3,206978,206978,206981,0,3,2
59285,3,1,206981,206981,206982,0,1,0
59286,5,3,206986,206986,206989,0,3,4
59287,2,2,206988,206989,206991,1,3,0
59288,4,1,206992,206992,206993,0,1,1
59289,3,1,206995,206995,206996,0,1,2
59290,2,1,206997,206997,206998,0,1,1
59291,4,1,207001,207001,207002,0,1,3
59292,4,1,207005,207005,207006,0,1,3
59293,2,3,207007,207007,207010,0,3,1
59294,2,1,207009,207010,207011,1,2,0
59295,5,3,207014,207014,207017,0,3,3
59296,5,3,207019,207019,207022,0,3,2
59297,3,1,207022,207022,207023,0,1,0
59298,1,3,207023,207023,207026,0,3,0
59299,2,3,207025,207026,207029,1,4,0
59300,3,2,207028,207029,207031,1,3,0
59301,4,1,207032,207032,207033,0,1,1
59302,5,2,207037,207037,207039,0,2,4
59303,3,1,207040,207040,207041,0,1,1
59304,6,3,207046,207046,207049,0,3,5
59305,1,2,207047,207049,207051,2,4,0
59306,4,3,207051,207051,207054,0,3,0
59307,4,3,207055,207055,207058,0,3,1
59308,4,3,207059,207059,207062,0,3,1
59309,6,2,207065,207065,207067,0,2,3
59310,5,2,207070,207070,207072,0,2,3
59311,5,3,207075,207075,207078,0,3,3
59312,5,2,207080,207080,207082,0,2,2
59313,5,2,207085,207085,207087,0,2,3
59314,3,3,207088,207088,207091,0,3,1
59315,3,1,207091,207091,207092,0,1,0
59316,5,2,207096,207096,207098,0,2,4
59317,6,3,207102,207102,207105,0,3,4
59318,2,3,207104,207105,207108,1,4,0
59319,5,1,207109,207109,207110,0,1,1
59320,6,2,207115,207115,207117,0,2,5
59321,5,1,207120,207120,207121,0,1,3
59322,2,3,207122,207122,207125,0,3,1
59323,3,3,207125,207125,207128,0,3,0
59324,3,1,207128,207128,207129,0,1,0
59325,2,3,207130,207130,207133,0,3,1
59326,5,3,207135,207135,207138,0,3,2
59327,6,3,207141,207141,207144,0,3,3
59328,5,3,207146,207146,207149,0,3,2
59329,2,2,207148,207149,207151,1,3,0
59330,5,2,207153,207153,207155,0,2,2
59331,3,3,207156,207156,207159,0,3,1
59332,4,2,207160,207160,207162,0,2,1
59333,4,3,207164,207164,207167,0,3,2
59334,5,1,207169,207169,207170,0,1,2
59335,4,1,207173,207173,207174,0,1,3
59336,5,3,207178,207178,207181,0,3,4
59337,5,1,207183,207183,207184,0,1,2
59338,6,1,207189,207189,207190,0,1,5
59339,6,1,207195,207195,207196,0,1,5
59340,5,2,207200,207200,207202,0,2,4
59341,5,3,207205,207205,207208,0,3,3
59342,1,3,207206,207208,207211,2,5,0
59343,4,2,207210,207211,207213,1,3,0
59344,1,1,207211,207213,207214,2,3,0
59345,1,3,207212,207214,207217,2,5,0
59346,5,3,207217,207217,207220,0,3,0
59347,4,1,207221,207221,207222,0,1,1
59348,5,2,207226,207226,207228,0,2,4
59349,6,2,207232,207232,207234,0,2,4
59350,2,1,207234,207234,207235,0,1,0
59351,4,3,207238,207238,207241,0,3,3
59352,5,1,207243,207243,207244,0,1,2
59353,1,2,207244,207244,207246,0,2,0
59354,3,3,207247,207247,207250,0,3,1
59355,1,3,207248,207250,207253,2,5,0
59356,6,3,207254,207254,207257,0,3,1
59357,1,1,207255,207257,207258,2,3,0
59358,1,3,207256,207258,207261,2,5,0
59359,4,1,207260,207261,207262,1,2,0
59360,3,3,207263,207263,207266,0,3,1
59361,4,2,207267,207267,207269,0,2,1
59362,4,1,207271,207271,207272,0,1,2
59363,1,2,207272,207272,207274,0,2,0
59364,6,3,207278,207278,207281,0,3,4
59365,6,3,207284,207284,207287,0,3,3
59366,4,2,207288,207288,207290,0,2,1
59367,3,3,207291,207291,207294,0,3,1
59368,6,2,207297,207297,207299,0,2,3
59369,6,1,207303,207303,207304,0,1,4
59370,4,1,207307,207307,207308,0,1,3
59371,4,3,207311,207311,207314,0,3,3
59372,5,1,207316,207316,207317,0,1,2
59373,1,1,207317,207317,207318,0,1,0
59374,2,2,207319,207319,207321,0,2,1
59375,5,3,207324,207324,207327,0,3,3
59376,1,3,207325,207327,207330,2,5,0
59377,5,1,207330,207330,207331,0,1,0
59378,5,3,207335,207335,207338,0,3,4
59379,1,3,207336,207338,207341,2,5,0
59380,4,1,207340,207341,207342,1,2,0
59381,3,3,207343,207343,207346,0,3,1
59382,1,2,207344,207346,207348,2,4,0
59383,1,2,207345,207348,207350,3,5,0
59384,6,1,207351,207351,207352,0,1,1
59385,6,3,207357,207357,207360,0,3,5
59386,6,3,207363,207363,207366,0,3,3
59387,4,2,207367,207367,207369,0,2,1
59388,1,3,207368,207369,207372,1,4,0
59389,5,2,207373,207373,207375,0,2,1
59390,3,2,207376,207376,207378,0,2,1
59391,1,1,207377,207378,207379,1,2,0
59392,5,2,207382,207382,207384,0,2,3
59393,1,3,207383,207384,207387,1,4,0
59394,5,1,207388,207388,207389,0,1,1
59395,2,2,207390,207390,207392,0,2,1
59396,5,1,207395,207395,207396,0,1,3
59397,3,3,207398,207398,207401,0,3,2
59398,4,3,207402,207402,207405,0,3,1
59399,3,3,207405,207405,207408,0,3,0
59400,4,2,207409,207409,207411,0,2,1
59401,1,1,207410,207411,207412,1,2,0
59402,4,2,207414,207414,207416,0,2,2
59403,4,1,207418,207418,207419,0,1,2
59404,4,3,207422,207422,207425,0,3,3
59405,3,3,207425,207425,207428,0,3,0
59406,5,2,207430,207430,207432,0,2,2
59407,3,3,207433,207433,207436,0,3,1
59408,3,3,207436,207436,207439,0,3,0
59409,5,1,207441,207441,207442,0,1,2
59410,1,3,207442,207442,207445,0,3,0
59411,5,3,207447,207447,207450,0,3,2
59412,4,1,207451,207451,207452,0,1,1
59413,3,2,207454,207454,207456,0,2,2
59414,2,2,207456,207456,207458,0,2,0
59415,1,1,207457,207458,207459,1,2,0
59416,5,3,207462,207462,207465,0,3,3
59417,5,2,207467,207467,207469,0,2,2
59418,6,2,207473,207473,207475,0,2,4
59419,5,3,207478,207478,207481,0,3,3
59420,4,3,207482,207482,207485,0,3,1
59421,6,3,207488,207488,207491,0,3,3
59422,6,3,207494,207494,207497,0,3,3
59423,2,3,207496,207497,207500,1,4,0
59424,2,3,207498,207500,207503,2,5,0
59425,1,2,207499,207503,207505,4,6,0
59426,1,1,207500,207505,207506,5,6,0
59427,2,1,207502,207506,207507,4,5,0
59428,1,1,207503,207507,207508,4,5,0
59429,6,2,207509,207509,207511,0,2,1
59430,3,3,207512,207512,207515,0,3,1
59431,5,2,207517,207517,207519,0,2,2
59432,5,3,207522,207522,207525,0,3,3
59433,4,3,207526,207526,207529,0,3,1
59434,3,2,207529,207529,207531,0,2,0
59435,1,3,207530,207531,207534,1,4,0
59436,5,2,207535,207535,207537,0,2,1
59437,3,2,207538,207538,207540,0,2,1
59438,5,3,207543,207543,207546,0,3,3
59439,2,1,207545,207546,207547,1,2,0
59440,5,1,207550,207550,207551,0,1,3
59441,3,3,207553,207553,207556,0,3,2
59442,3,1,207556,207556,207557,0,1,0
59443,2,1,207558,207558,207559,0,1,1
59444,3,2,207561,207561,207563,0,2,2
59445,4,3,207565,207565,207568,0,3,2
59446,6,3,207571,207571,207574,0,3,3
59447,6,3,207577,207577,207580,0,3,3
59448,6,1,207583,207583,207584,0,1,3
59449,3,1,207586,207586,207587,0,1,2
59450,4,2,207590,207590,207592,0,2,3
59451,3,1,207593,207593,207594,0,1,1
59452,6,1,207599,207599,207600,0,1,5
59453,4,2,207603,207603,207605,0,2,3
59454,1,2,207604,207605,207607,1,3,0
59455,6,2,207610,207610,207612,0,2,3
59456,2,3,207612,207612,207615,0,3,0
59457,1,3,207613,207615,207618,2,5,0
59458,3,1,207616,207618,207619,2,3,0
59459,2,2,207618,207619,207621,1,3,0
59460,3,2,207621,207621,207623,0,2,0
59461,5,3,207626,207626,207629,0,3,3
59462,4,3,207630,207630,207633,0,3,1
59463,5,1,207635,207635,207636,0,1,2
59464,4,3,207639,207639,207642,0,3,3
59465,1,3,207640,207642,207645,2,5,0
59466,1,3,207641,207645,207648,4,7,0
59467,1,2,207642,207648,207650,6,8,0
59468,1,2,207643,207650,207652,7,9,0
59469,4,2,207647,207652,207654,5,7,0
59470,2,3,207649,207654,207657,5,8,0
59471,3,2,207652,207657,207659,5,7,0
59472,6,1,207658,207659,207660,1,2,0
59473,4,2,207662,207662,207664,0,2,2
59474,4,2,207666,207666,207668,0,2,2
59475,6,2,207672,207672,207674,0,2,4
59476,1,3,207673,207674,207677,1,4,0
59477,2,3,207675,207677,207680,2,5,0
59478,3,3,207678,207680,207683,2,5,0
59479,4,1,207682,207683,207684,1,2,0
59480,3,3,207685,207685,207688,0,3,1
59481,3,3,207688,207688,207691,0,3,0
59482,5,3,207693,207693,207696,0,3,2
59483,6,1,207699,207699,207700,0,1,3
59484,5,2,207704,207704,207706,0,2,4
59485,2,1,207706,207706,207707,0,1,0
59486,5,2,207711,207711,207713,0,2,4
59487,3,3,207714,207714,207717,0,3,1
59488,4,2,207718,207718,207720,0,2,1
59489,5,1,207723,207723,207724,0,1,3
59490,5,1,207728,207728,207729,0,1,4
59491,5,2,207733,207733,207735,0,2,4
59492,6,1,207739,207739,207740,0,1,4
59493,4,3,207743,207743,207746,0,3,3
59494,3,1,207746,207746,207747,0,1,0
59495,3,2,207749,207749,207751,0,2,2
59496,3,3,207752,207752,207755,0,3,1
59497,1,2,207753,207755,207757,2,4,0
59498,3,1,207756,207757,207758,1,2,0
59499,6,3,207762,207762,207765,0,3,4
59500,2,3,207764,207765,207768,1,4,0
59501,5,2,207769,207769,207771,0,2,1
59502,4,1,207773,207773,207774,0,1,2
59503,2,2,207775,207775,207777,0,2,1
59504,2,3,207777,207777,207780,0,3,0
59505,3,3,207780,207780,207783,0,3,0
59506,2,2,207782,207783,207785,1,3,0
59507,1,3,207783,207785,207788,2,5,0
59508,5,3,207788,207788,207791,0,3,0
59509,3,3,207791,207791,207794,0,3,0
59510,5,3,207796,207796,207799,0,3,2
59511,6,1,207802,207802,207803,0,1,3
59512,6,3,207808,207808,207811,0,3,5
59513,1,2,207809,207811,207813,2,4,0
59514,6,1,207815,207815,207816,0,1,2
59515,5,3,207820,207820,207823,0,3,4
59516,6,2,207826,207826,207828,0,2,3
59517,1,3,207827,207828,207831,1,4,0
59518,3,2,207830,207831,207833,1,3,0
59519,2,1,207832,207833,207834,1,2,0
59520,3,1,207835,207835,207836,0,1,1
59521,3,1,207838,207838,207839,0,1,2
59522,5,1,207843,207843,207844,0,1,4
59523,4,3,207847,207847,207850,0,3,3
59524,1,3,207848,207850,207853,2,5,0
59525,4,2,207852,207853,207855,1,3,0
59526,5,2,207857,207857,207859,0,2,2
59527,3,3,207860,207860,207863,0,3,1
59528,2,3,207862,207863,207866,1,4,0
59529,5,1,207867,207867,207868,0,1,1
59530,5,2,207872,207872,207874,0,2,4
59531,4,1,207876,207876,207877,0,1,2
59532,6,2,207882,207882,207884,0,2,5
59533,2,3,207884,207884,207887,0,3,0
59534,1,2,207885,207887,207889,2,4,0
59535,4,3,207889,207889,207892,0,3,0
59536,1,3,207890,207892,207895,2,5,0
59537,5,3,207895,207895,207898,0,3,0
59538,4,3,207899,207899,207902,0,3,1
59539,4,3,207903,207903,207906,0,3,1
59540,4,2,207907,207907,207909,0,2,1
59541,4,2,207911,207911,207913,0,2,2
59542,4,3,207915,207915,207918,0,3,2
59543,5,2,207920,207920,207922,0,2,2
59544,1,1,207921,207922,207923,1,2,0
59545,6,2,207927,207927,207929,0,2,4
59546,1,1,207928,207929,207930,1,2,0
59547,5,1,207933,207933,207934,0,1,3
59548,5,2,207938,207938,207940,0,2,4
59549,1,2,207939,207940,207942,1,3,0
59550,4,3,207943,207943,207946,0,3,1
59551,5,3,207948,207948,207951,0,3,2
59552,1,2,207949,207951,207953,2,4,0
59553,1,2,207950,207953,207955,3,5,0
59554,6,3,207956,207956,207959,0,3,1
59555,2,1,207958,207959,207960,1,2,0
59556,4,3,207962,207962,207965,0,3,2
59557,4,1,207966,207966,207967,0,1,1
59558,3,2,207969,207969,207971,0,2,2
59559,1,3,207970,207971,207974,1,4,0
59560,6,3,207976,207976,207979,0,3,2
59561,2,1,207978,207979,207980,1,2,0
59562,4,3,207982,207982,207985,0,3,2
59563,1,3,207983,207985,207988,2,5,0
59564,5,1,207988,207988,207989,0,1,0
59565,2,2,207990,207990,207992,0,2,1
59566,2,1,207992,207992,207993,0,1,0
59567,5,3,207997,207997,208000,0,3,4
59568,1,1,207998,208000,208001,2,3,0
59569,4,3,208002,208002,208005,0,3,1
59570,1,2,208003,208005,208007,2,4,0
59571,1,1,208004,208007,208008,3,4,0
59572,2,3,208006,208008,208011,2,5,0
59573,6,1,208012,208012,208013,0,1,1
59574,2,2,208014,208014,208016,0,2,1
59575,2,1,208016,208016,208017,0,1,0
59576,2,2,208018,208018,208020,0,2,1
59577,3,2,208021,208021,208023,0,2,1
59578,6,2,208027,208027,208029,0,2,4
59579,3,3,208030,208030,208033,0,3,1
59580,4,3,208034,208034,208037,0,3,1
59581,2,2,208036,208037,208039,1,3,0
59582,4,3,208040,208040,208043,0,3,1
59583,1,1,208041,208043,208044,2,3,0
59584,5,3,208046,208046,208049,0,3,2
59585,6,3,208052,208052,208055,0,3,3
59586,4,2,208056,208056,208058,0,2,1
59587,4,2,208060,208060,208062,0,2,2
59588,3,1,208063,208063,208064,0,1,1
59589,5,3,208068,208068,208071,0,3,4
59590,3,1,208071,208071,208072,0,1,0
59591,2,2,208073,208073,208075,0,2,1
59592,4,1,208077,208077,208078,0,1,2
59593,4,2,208081,208081,208083,0,2,3
59594,1,3,208082,208083,208086,1,4,0
59595,2,2,208084,208086,208088,2,4,0
59596,3,1,208087,208088,208089,1,2,0
59597,2,2,208089,208089,208091,0,2,0
59598,5,1,208094,208094,208095,0,1,3
59599,5,1,208099,208099,208100,0,1,4
59600,2,3,208101,208101,208104,0,3,1
59601,4,2,208105,208105,208107,0,2,1
59602,1,1,208106,208107,208108,1,2,0
59603,5,1,208111,208111,208112,0,1,3
59604,4,2,208115,208115,208117,0,2,3
59605,6,1,208121,208121,208122,0,1,4
59606,3,3,208124,208124,208127,0,3,2
59607,5,3,208129,208129,208132,0,3,2
59608,3,1,208132,208132,208133,0,1,0
59609,5,1,208137,208137,208138,0,1,4
59610,6,1,208143,208143,208144,0,1,5
59611,5,2,208148,208148,208150,0,2,4
59612,4,1,208152,208152,208153,0,1,2
59613,6,2,208158,208158,208160,0,2,5
59614,2,1,208160,208160,208161,0,1,0
59615,2,1,208162,208162,208163,0,1,1
59616,2,3,208164,208164,208167,0,3,1
59617,4,1,208168,208168,208169,0,1,1
59618,4,1,208172,208172,208173,0,1,3
59619,6,1,208178,208178,208179,0,1,5
59620,2,1,208180,208180,208181,0,1,1
59621,1,2,208181,208181,208183,0,2,0
59622,3,3,208184,208184,208187,0,3,1
59623,4,1,208188,208188,208189,0,1,1
59624,6,3,208194,208194,208197,0,3,5
59625,6,2,208200,208200,208202,0,2,3
59626,6,2,208206,208206,208208,0,2,4
59627,2,2,208208,208208,208210,0,2,0
59628,3,3,208211,208211,208214,0,3,1
59629,6,3,208217,208217,208220,0,3,3
59630,3,1,208220,208220,208221,0,1,0
59631,3,3,208223,208223,208226,0,3,2
59632,4,1,208227,208227,208228,0,1,1
59633,3,1,208230,208230,208231,0,1,2
59634,3,2,208233,208233,208235,0,2,2
59635,2,1,208235,208235,208236,0,1,0
59636,4,2,208239,208239,208241,0,2,3
59637,5,2,208244,208244,208246,0,2,3
59638,3,3,208247,208247,208250,0,3,1
59639,6,3,208253,208253,208256,0,3,3
59640,4,2,208257,208257,208259,0,2,1
59641,1,1,208258,208259,208260,1,2,0
59642,3,1,208261,208261,208262,0,1,1
59643,5,3,208266,208266,208269,0,3,4
59644,2,3,208268,208269,208272,1,4,0
59645,1,2,208269,208272,208274,3,5,0
59646,2,1,208271,208274,208275,3,4,0
59647,2,3,208273,208275,208278,2,5,0
59648,2,1,208275,208278,208279,3,4,0
59649,3,1,208278,208279,208280,1,2,0
59650,3,2,208281,208281,208283,0,2,1
59651,6,1,208287,208287,208288,0,1,4
59652,2,3,208289,208289,208292,0,3,1
59653,2,2,208291,208292,208294,1,3,0
59654,1,2,208292,208294,208296,2,4,0
59655,3,1,208295,208296,208297,1,2,0
59656,2,3,208297,208297,208300,0,3,0
59657,5,1,208302,208302,208303,0,1,2
59658,3,3,208305,208305,208308,0,3,2
59659,4,3,208309,208309,208312,0,3,1
59660,3,3,208312,208312,208315,0,3,0
59661,2,2,208314,208315,208317,1,3,0
59662,6,3,208320,208320,208323,0,3,3
59663,5,3,208325,208325,208328,0,3,2
59664,1,3,208326,208328,208331,2,5,0
59665,6,1,208332,208332,208333,0,1,1
59666,1,3,208333,208333,208336,0,3,0
59667,2,3,208335,208336,208339,1,4,0
59668,3,1,208338,208339,208340,1,2,0
59669,4,1,208342,208342,208343,0,1,2
59670,2,2,208344,208344,208346,0,2,1
59671,6,3,208350,208350,208353,0,3,4
59672,6,2,208356,208356,208358,0,2,3
59673,4,2,208360,208360,208362,0,2,2
59674,2,1,208362,208362,208363,0,1,0
59675,2,2,208364,208364,208366,0,2,1
59676,6,1,208370,208370,208371,0,1,4
59677,4,1,208374,208374,208375,0,1,3
59678,4,3,208378,208378,208381,0,3,3
59679,4,1,208382,208382,208383,0,1,1
59680,5,1,208387,208387,208388,0,1,4
59681,4,3,208391,208391,208394,0,3,3
59682,2,1,208393,208394,208395,1,2,0
59683,3,1,208396,208396,208397,0,1,1
59684,6,1,208402,208402,208403,0,1,5
59685,3,3,208405,208405,208408,0,3,2
59686,2,2,208407,208408,208410,1,3,0
59687,5,3,208412,208412,208415,0,3,2
59688,1,1,208413,208415,208416,2,3,0
59689,5,1,208418,208418,208419,0,1,2
59690,1,3,208419,208419,208422,0,3,0
59691,6,2,208425,208425,208427,0,2,3
59692,4,1,208429,208429,208430,0,1,2
59693,6,1,208435,208435,208436,0,1,5
59694,5,3,208440,208440,208443,0,3,4
59695,5,2,208445,208445,208447,0,2,2
59696,3,1,208448,208448,208449,0,1,1
59697,5,1,208453,208453,208454,0,1,4
59698,4,3,208457,208457,208460,0,3,3
59699,5,1,208462,208462,208463,0,1,2
59700,4,3,208466,208466,208469,0,3,3
59701,5,3,208471,208471,208474,0,3,2
59702,5,3,208476,208476,208479,0,3,2
59703,6,1,208482,208482,208483,0,1,3
59704,5,3,208487,208487,208490,0,3,4
59705,3,3,208490,208490,208493,0,3,0
59706,3,2,208493,208493,208495,0,2,0
59707,4,1,208497,208497,208498,0,1,2
59708,4,3,208501,208501,208504,0,3,3
59709,2,1,208503,208504,208505,1,2,0
59710,1,1,208504,208505,208506,1,2,0
59711,4,3,208508,208508,208511,0,3,2
59712,6,2,208514,208514,208516,0,2,3
59713,4,2,208518,208518,208520,0,2,2
59714,6,2,208524,208524,208526,0,2,4
59715,6,3,208530,208530,208533,0,3,4
59716,3,1,208533,208533,208534,0,1,0
59717,5,1,208538,208538,208539,0,1,4
59718,3,3,208541,208541,208544,0,3,2
59719,3,1,208544,208544,208545,0,1,0
59720,3,1,208547,208547,208548,0,1,2
59721,1,1,208548,208548,208549,0,1,0
59722,2,3,208550,208550,208553,0,3,1
59723,2,3,208552,208553,208556,1,4,0
59724,3,1,208555,208556,208557,1,2,0
59725,1,3,208556,208557,208560,1,4,0
59726,1,1,208557,208560,208561,3,4,0
59727,1,2,208558,208561,208563,3,5,0
59728,5,1,208563,208563,208564,0,1,0
59729,6,3,208569,208569,208572,0,3,5
59730,3,3,208572,208572,208575,0,3,0
59731,3,3,208575,208575,208578,0,3,0
59732,4,1,208579,208579,208580,0,1,1
59733,2,3,208581,208581,208584,0,3,1
59734,6,2,208587,208587,208589,0,2,3
59735,3,1,208590,208590,208591,0,1,1
59736,3,1,208593,208593,208594,0,1,2
59737,4,2,208597,208597,208599,0,2,3
59738,1,1,208598,208599,208600,1,2,0
59739,6,2,208604,208604,208606,0,2,4
59740,3,2,208607,208607,208609,0,2,1
59741,5,2,208612,208612,208614,0,2,3
59742,3,2,208615,208615,208617,0,2,1
59743,2,2,208617,208617,208619,0,2,0
59744,3,2,208620,208620,208622,0,2,1
59745,6,1,208626,208626,208627,0,1,4
59746,5,3,208631,208631,208634,0,3,4
59747,2,1,208633,208634,208635,1,2,0
59748,4,2,208637,208637,208639,0,2,2
59749,3,1,208640,208640,208641,0,1,1
59750,2,2,208642,208642,208644,0,2,1
59751,1,3,208643,208644,208647,1,4,0
59752,5,3,208648,208648,208651,0,3,1
59753,4,1,208652,208652,208653,0,1,1
59754,6,3,208658,208658,208661,0,3,5
59755,2,3,208660,208661,208664,1,4,0
59756,4,3,208664,208664,208667,0,3,0
59757,6,2,208670,208670,208672,0,2,3
59758,1,1,208671,208672,208673,1,2,0
59759,6,3,208677,208677,208680,0,3,4
59760,4,1,208681,208681,208682,0,1,1
59761,3,2,208684,208684,208686,0,2,2
59762,2,3,208686,208686,208689,0,3,0
59763,1,1,208687,208689,208690,2,3,0
59764,2,2,208689,208690,208692,1,3,0
59765,2,1,208691,208692,208693,1,2,0
59766,2,2,208693,208693,208695,0,2,0
59767,5,3,208698,208698,208701,0,3,3
59768,3,1,208701,208701,208702,0,1,0
59769,5,1,208706,208706,208707,0,1,4
59770,3,3,208709,208709,208712,0,3,2
59771,2,1,208711,208712,208713,1,2,0
59772,3,2,208714,208714,208716,0,2,1
59773,1,3,208715,208716,208719,1,4,0
59774,6,1,208721,208721,208722,0,1,2
59775,5,2,208726,208726,208728,0,2,4
59776,2,3,208728,208728,208731,0,3,0
59777,4,3,208732,208732,208735,0,3,1
59778,2,3,208734,208735,208738,1,4,0
59779,1,3,208735,208738,208741,3,6,0
59780,4,2,208739,208741,208743,2,4,0
59781,5,1,208744,208744,208745,0,1,1
59782,4,2,208748,208748,208750,0,2,3
59783,3,2,208751,208751,208753,0,2,1
59784,3,2,208754,208754,208756,0,2,1
59785,2,2,208756,208756,208758,0,2,0
59786,1,1,208757,208758,208759,1,2,0
59787,6,2,208763,208763,208765,0,2,4
59788,5,1,208768,208768,208769,0,1,3
59789,2,3,208770,208770,208773,0,3,1
59790,2,3,208772,208773,208776,1,4,0
59791,2,3,208774,208776,208779,2,5,0
59792,6,3,208780,208780,208783,0,3,1
59793,4,3,208784,208784,208787,0,3,1
59794,2,2,208786,208787,208789,1,3,0
59795,1,3,208787,208789,208792,2,5,0
59796,5,2,208792,208792,208794,0,2,0
59797,4,1,208796,208796,208797,0,1,2
59798,5,2,208801,208801,208803,0,2,4
59799,3,1,208804,208804,208805,0,1,1
59800,4,2,208808,208808,208810,0,2,3
59801,6,2,208814,208814,208816,0,2,4
59802,2,3,208816,208816,208819,0,3,0
59803,1,2,208817,208819,208821,2,4,0
59804,3,1,208820,208821,208822,1,2,0
59805,4,2,208824,208824,208826,0,2,2
59806,5,1,208829,208829,208830,0,1,3
59807,6,1,208835,208835,208836,0,1,5
59808,3,3,208838,208838,208841,0,3,2
59809,1,2,208839,208841,208843,2,4,0
59810,3,1,208842,208843,208844,1,2,0
59811,3,1,208845,208845,208846,0,1,1
59812,1,2,208846,208846,208848,0,2,0
59813,1,1,208847,208848,208849,1,2,0
59814,2,1,208849,208849,208850,0,1,0
59815,5,1,208854,208854,208855,0,1,4
59816,1,3,208855,208855,208858,0,3,0
59817,5,1,208860,208860,208861,0,1,2
59818,6,3,208866,208866,208869,0,3,5
59819,4,1,208870,208870,208871,0,1,1
59820,4,2,208874,208874,208876,0,2,3
59821,5,1,208879,208879,208880,0,1,3
59822,2,3,208881,208881,208884,0,3,1
59823,2,3,208883,208884,208887,1,4,0
59824,3,2,208886,208887,208889,1,3,0
59825,3,1,208889,208889,208890,0,1,0
59826,6,3,208895,208895,208898,0,3,5
59827,2,1,208897,208898,208899,1,2,0
59828,5,1,208902,208902,208903,0,1,3
59829,3,2,208905,208905,208907,0,2,2
59830,3,1,208908,208908,208909,0,1,1
59831,1,2,208909,208909,208911,0,2,0
59832,5,3,208914,208914,208917,0,3,3
59833,6,2,208920,208920,208922,0,2,3
59834,1,2,208921,208922,208924,1,3,0
59835,2,1,208923,208924,208925,1,2,0
59836,6,1,208929,208929,208930,0,1,4
59837,2,3,208931,208931,208934,0,3,1
59838,1,1,208932,208934,208935,2,3,0
59839,3,3,208935,208935,208938,0,3,0
59840,5,2,208940,208940,208942,0,2,2
59841,3,3,208943,208943,208946,0,3,1
59842,4,1,208947,208947,208948,0,1,1
59843,4,3,208951,208951,208954,0,3,3
59844,6,3,208957,208957,208960,0,3,3
59845,2,1,208959,208960,208961,1,2,0
59846,5,2,208964,208964,208966,0,2,3
59847,6,2,208970,208970,208972,0,2,4
59848,3,2,208973,208973,208975,0,2,1
59849,4,2,208977,208977,208979,0,2,2
59850,2,3,208979,208979,208982,0,3,0
59851,1,1,208980,208982,208983,2,3,0
59852,2,3,208982,208983,208986,1,4,0
59853,2,2,208984,208986,208988,2,4,0
59854,3,1,208987,208988,208989,1,2,0
59855,2,2,208989,208989,208991,0,2,0
59856,1,2,208990,208991,208993,1,3,0
59857,5,2,208995,208995,208997,0,2,2
59858,1,2,208996,208997,208999,1,3,0
59859,6,3,209002,209002,209005,0,3,3
59860,6,3,209008,209008,209011,0,3,3
59861,3,3,209011,209011,209014,0,3,0
59862,2,1,209013,209014,209015,1,2,0
59863,5,3,209018,209018,209021,0,3,3
59864,5,2,209023,209023,209025,0,2,2
59865,4,3,209027,209027,209030,0,3,2
59866,1,1,209028,209030,209031,2,3,0
59867,5,2,209033,209033,209035,0,2,2
59868,6,1,209039,209039,209040,0,1,4
59869,4,3,209043,209043,209046,0,3,3
59870,2,3,209045,209046,209049,1,4,0
59871,2,2,209047,209049,209051,2,4,0
59872,3,2,209050,209051,209053,1,3,0
59873,3,1,209053,209053,209054,0,1,0
59874,1,3,209054,209054,209057,0,3,0
59875,1,2,209055,209057,209059,2,4,0
59876,1,3,209056,209059,209062,3,6,0
59877,2,3,209058,209062,209065,4,7,0
59878,5,2,209063,209065,209067,2,4,0
59879,1,2,209064,209067,209069,3,5,0
59880,2,1,209066,209069,209070,3,4,0
59881,1,2,209067,209070,209072,3,5,0
59882,3,1,209070,209072,209073,2,3,0
59883,4,1,209074,209074,209075,0,1,1
59884,5,1,209079,209079,209080,0,1,4
59885,1,1,209080,209080,209081,0,1,0
59886,5,2,209085,209085,209087,0,2,4
59887,2,2,209087,209087,209089,0,2,0
59888,1,1,209088,209089,209090,1,2,0
59889,4,1,209092,209092,209093,0,1,2
59890,5,1,209097,209097,209098,0,1,4
59891,4,1,209101,209101,209102,0,1,3
59892,4,1,209105,209105,209106,0,1,3
59893,1,1,209106,209106,209107,0,1,0
59894,3,3,209109,209109,209112,0,3,2
59895,2,1,209111,209112,209113,1,2,0
59896,3,2,209114,209114,209116,0,2,1
59897,3,3,209117,209117,209120,0,3,1
59898,5,3,209122,209122,209125,0,3,2
59899,2,3,209124,209125,209128,1,4,0
59900,2,3,209126,209128,209131,2,5,0
59901,4,1,209130,209131,209132,1,2,0
59902,1,2,209131,209132,209134,1,3,0
59903,6,2,209137,209137,209139,0,2,3
59904,5,1,209142,209142,209143,0,1,3
59905,5,3,209147,209147,209150,0,3,4
59906,6,2,209153,209153,209155,0,2,3
59907,4,1,209157,209157,209158,0,1,2
59908,1,1,209158,209158,209159,0,1,0
59909,3,3,209161,209161,209164,0,3,2
59910,4,3,209165,209165,209168,0,3,1
59911,4,2,209169,209169,209171,0,2,1
59912,1,3,209170,209171,209174,1,4,0
59913,1,1,209171,209174,209175,3,4,0
59914,3,1,209174,209175,209176,1,2,0
59915,3,2,209177,209177,209179,0,2,1
59916,1,3,209178,209179,209182,1,4,0
59917,4,2,209182,209182,209184,0,2,0
59918,2,3,209184,209184,209187,0,3,0
59919,2,2,209186,209187,209189,1,3,0
59920,2,2,209188,209189,209191,1,3,0
59921,1,2,209189,209191,209193,2,4,0
59922,3,2,209192,209193,209195,1,3,0
59923,1,2,209193,209195,209197,2,4,0
59924,6,1,209199,209199,209200,0,1,2
59925,2,2,209201,209201,209203,0,2,1
59926,4,3,209205,209205,209208,0,3,2
59927,1,3,209206,209208,209211,2,5,0
59928,6,1,209212,209212,209213,0,1,1
59929,5,1,209217,209217,209218,0,1,4
59930,2,3,209219,209219,209222,0,3,1
59931,4,2,209223,209223,209225,0,2,1
59932,4,1,209227,209227,209228,0,1,2
59933,6,1,209233,209233,209234,0,1,5
59934,5,1,209238,209238,209239,0,1,4
59935,2,2,209240,209240,209242,0,2,1
59936,2,3,209242,209242,209245,0,3,0
59937,6,1,209248,209248,209249,0,1,3
59938,2,2,209250,209250,209252,0,2,1
59939,6,2,209256,209256,209258,0,2,4
59940,5,2,209261,209261,209263,0,2,3
59941,3,3,209264,209264,209267,0,3,1
59942,3,1,209267,209267,209268,0,1,0
59943,1,2,209268,209268,209270,0,2,0
59944,3,3,209271,209271,209274,0,3,1
59945,5,2,209276,209276,209278,0,2,2
59946,2,3,209278,209278,209281,0,3,0
59947,3,3,209281,209281,209284,0,3,0
59948,3,3,209284,209284,209287,0,3,0
59949,5,2,209289,209289,209291,0,2,2
59950,6,1,209295,209295,209296,0,1,4
59951,6,3,209301,209301,209304,0,3,5
59952,4,2,209305,209305,209307,0,2,1
59953,3,1,209308,209308,209309,0,1,1
59954,3,3,209311,209311,209314,0,3,2
59955,4,1,209315,209315,209316,0,1,1
59956,3,2,209318,209318,209320,0,2,2
59957,4,2,209322,209322,209324,0,2,2
59958,6,3,209328,209328,209331,0,3,4
59959,4,2,209332,209332,209334,0,2,1
59960,1,3,209333,209334,209337,1,4,0
59961,4,2,209337,209337,209339,0,2,0
59962,6,3,209343,209343,209346,0,3,4
59963,2,1,209345,209346,209347,1,2,0
59964,1,2,209346,209347,209349,1,3,0
59965,4,1,209350,209350,209351,0,1,1
59966,5,3,209355,209355,209358,0,3,4
59967,5,2,209360,209360,209362,0,2,2
59968,4,2,209364,209364,209366,0,2,2
59969,4,3,209368,209368,209371,0,3,2
59970,2,1,209370,209371,209372,1,2,0
59971,1,2,209371,209372,209374,1,3,0
59972,1,3,209372,209374,209377,2,5,0
59973,3,1,209375,209377,209378,2,3,0
59974,6,1,209381,209381,209382,0,1,3
59975,4,2,209385,209385,209387,0,2,3
59976,1,3,209386,209387,209390,1,4,0
59977,6,3,209392,209392,209395,0,3,2
59978,3,3,209395,209395,209398,0,3,0
59979,2,1,209397,209398,209399,1,2,0
59980,2,1,209399,209399,209400,0,1,0
59981,1,1,209400,209400,209401,0,1,0
59982,6,1,209406,209406,209407,0,1,5
59983,5,2,209411,209411,209413,0,2,4
59984,2,1,209413,209413,209414,0,1,0
59985,4,1,209417,209417,209418,0,1,3
59986,3,1,209420,209420,209421,0,1,2
59987,2,2,209422,209422,209424,0,2,1
59988,5,2,209427,209427,209429,0,2,3
59989,1,1,209428,209429,209430,1,2,0
59990,6,3,209434,209434,209437,0,3,4
59991,5,2,209439,209439,209441,0,2,2
59992,5,3,209444,209444,209447,0,3,3
59993,5,1,209449,209449,209450,0,1,2
59994,3,3,209452,209452,209455,0,3,2
59995,1,2,209453,209455,209457,2,4,0
59996,2,3,209455,209457,209460,2,5,0
59997,5,3,209460,209460,209463,0,3,0
59998,5,3,209465,209465,209468,0,3,2
59999,2,2,209467,209468,209470,1,3,0
60000,5,3,209472,209472,209475,0,3,2
60001,5,3,209477,209477,209480,0,3,2
60002,1,1,209478,209480,209481,2,3,0
60003,2,1,209480,209481,209482,1,2,0
60004,6,2,209486,209486,209488,0,2,4
60005,2,2,209488,209488,209490,0,2,0
60006,2,1,209490,209490,209491,0,1,0
60007,6,1,209496,209496,209497,0,1,5
60008,3,2,209499,209499,209501,0,2,2
60009,1,1,209500,209501,209502,1,2,0
60010,3,3,209503,209503,209506,0,3,1
60011,5,2,209508,209508,209510,0,2,2
60012,6,1,209514,209514,209515,0,1,4
60013,3,3,209517,209517,209520,0,3,2
60014,5,3,209522,209522,209525,0,3,2
60015,4,2,209526,209526,209528,0,2,1
60016,4,1,209530,209530,209531,0,1,2
60017,2,1,209532,209532,209533,0,1,1
60018,1,3,209533,209533,209536,0,3,0
60019,3,1,209536,209536,209537,0,1,0
60020,6,3,209542,209542,209545,0,3,5
60021,2,1,209544,209545,209546,1,2,0
60022,6,1,209550,209550,209551,0,1,4
60023,4,2,209554,209554,209556,0,2,3
60024,3,1,209557,209557,209558,0,1,1
60025,6,1,209563,209563,209564,0,1,5
60026,6,1,209569,209569,209570,0,1,5
60027,5,2,209574,209574,209576,0,2,4
60028,3,3,209577,209577,209580,0,3,1
60029,5,1,209582,209582,209583,0,1,2
60030,5,2,209587,209587,209589,0,2,4
60031,2,3,209589,209589,209592,0,3,0
60032,5,2,209594,209594,209596,0,2,2
60033,4,1,209598,209598,209599,0,1,2
60034,3,1,209601,209601,209602,0,1,2
60035,4,1,209605,209605,209606,0,1,3
60036,1,2,209606,209606,209608,0,2,0
60037,2,1,209608,209608,209609,0,1,0
60038,6,2,209614,209614,209616,0,2,5
60039,3,1,209617,209617,209618,0,1,1
60040,6,1,209623,209623,209624,0,1,5
60041,5,2,209628,209628,209630,0,2,4
60042,1,3,209629,209630,209633,1,4,0
60043,4,3,209633,209633,209636,0,3,0
60044,3,3,209636,209636,209639,0,3,0
60045,2,3,209638,209639,209642,1,4,0
60046,2,2,209640,209642,209644,2,4,0
60047,4,2,209644,209644,209646,0,2,0
60048,2,3,209646,209646,209649,0,3,0
60049,4,2,209650,209650,209652,0,2,1
60050,3,1,209653,209653,209654,0,1,1
60051,5,2,209658,209658,209660,0,2,4
60052,5,3,209663,209663,209666,0,3,3
60053,2,2,209665,209666,209668,1,3,0
60054,2,1,209667,209668,209669,1,2,0
60055,5,1,209672,209672,209673,0,1,3
60056,5,2,209677,209677,209679,0,2,4
60057,1,1,209678,209679,209680,1,2,0
60058,5,1,209683,209683,209684,0,1,3
60059,6,1,209689,209689,209690,0,1,5
60060,6,3,209695,209695,209698,0,3,5
60061,4,1,209699,209699,209700,0,1,1
60062,2,3,209701,209701,209704,0,3,1
60063,6,3,209707,209707,209710,0,3,3
60064,4,2,209711,209711,209713,0,2,1
60065,5,3,209716,209716,209719,0,3,3
60066,5,1,209721,209721,209722,0,1,2
60067,2,3,209723,209723,209726,0,3,1
60068,1,1,209724,209726,209727,2,3,0
60069,5,3,209729,209729,209732,0,3,2
60070,1,2,209730,209732,209734,2,4,0
60071,1,3,209731,209734,209737,3,6,0
60072,6,1,209737,209737,209738,0,1,0
60073,6,3,209743,209743,209746,0,3,5
60074,1,1,209744,209746,209747,2,3,0
60075,3,2,209747,209747,209749,0,2,0
60076,3,3,209750,209750,209753,0,3,1
60077,2,1,209752,209753,209754,1,2,0
60078,5,3,209757,209757,209760,0,3,3
60079,2,2,209759,209760,209762,1,3,0
60080,1,2,209760,209762,209764,2,4,0
60081,3,3,209763,209764,209767,1,4,0
60082,1,1,209764,209767,209768,3,4,0
60083,1,3,209765,209768,209771,3,6,0
60084,2,1,209767,209771,209772,4,5,0
60085,3,3,209770,209772,209775,2,5,0
60086,3,3,209773,209775,209778,2,5,0
60087,2,2,209775,209778,209780,3,5,0
60088,2,3,209777,209780,209783,3,6,0
60089,5,2,209782,209783,209785,1,3,0
60090,2,1,209784,209785,209786,1,2,0
60091,1,2,209785,209786,209788,1,3,0
60092,6,1,209791,209791,209792,0,1,3
60093,3,2,209794,209794,209796,0,2,2
60094,3,2,209797,209797,209799,0,2,1
60095,5,2,209802,209802,209804,0,2,3
60096,1,2,209803,209804,209806,1,3,0
60097,4,2,209807,209807,209809,0,2,1
60098,5,3,209812,209812,209815,0,3,3
60099,2,2,209814,209815,209817,1,3,0
60100,6,2,209820,209820,209822,0,2,3
60101,3,3,209823,209823,209826,0,3,1
60102,6,1,209829,209829,209830,0,1,3
60103,3,2,209832,209832,209834,0,2,2
60104,6,1,209838,209838,209839,0,1,4
60105,2,3,209840,209840,209843,0,3,1
60106,5,1,209845,209845,209846,0,1,2
60107,3,3,209848,209848,209851,0,3,2
60108,6,1,209854,209854,209855,0,1,3
60109,6,2,209860,209860,209862,0,2,5
60110,5,3,209865,209865,209868,0,3,3
60111,6,3,209871,209871,209874,0,3,3
60112,3,2,209874,209874,209876,0,2,0
60113,1,3,209875,209876,209879,1,4,0
60114,5,3,209880,209880,209883,0,3,1
60115,3,2,209883,209883,209885,0,2,0
60116,3,1,209886,209886,209887,0,1,1
60117,5,1,209891,209891,209892,0,1,4
60118,3,3,209894,209894,209897,0,3,2
60119,2,3,209896,209897,209900,1,4,0
60120,5,3,209901,209901,209904,0,3,1
60121,4,3,209905,209905,209908,0,3,1
60122,2,1,209907,209908,209909,1,2,0
60123,3,2,209910,209910,209912,0,2,1
60124,6,1,209916,209916,209917,0,1,4
60125,3,1,209919,209919,209920,0,1,2
60126,4,1,209923,209923,209924,0,1,3
60127,5,3,209928,209928,209931,0,3,4
60128,2,3,209930,209931,209934,1,4,0
60129,4,3,209934,209934,209937,0,3,0
60130,1,3,209935,209937,209940,2,5,0
60131,1,1,209936,209940,209941,4,5,0
60132,6,1,209942,209942,209943,0,1,1
60133,4,1,209946,209946,209947,0,1,3
60134,3,3,209949,209949,209952,0,3,2
60135,4,1,209953,209953,209954,0,1,1
60136,6,3,209959,209959,209962,0,3,5
60137,3,2,209962,209962,209964,0,2,0
60138,3,2,209965,209965,209967,0,2,1
60139,2,2,209967,209967,209969,0,2,0
60140,1,2,209968,209969,209971,1,3,0
60141,4,3,209972,209972,209975,0,3,1
60142,2,2,209974,209975,209977,1,3,0
60143,2,1,209976,209977,209978,1,2,0
60144,1,2,209977,209978,209980,1,3,0
60145,4,2,209981,209981,209983,0,2,1
60146,2,3,209983,209983,209986,0,3,0
60147,1,3,209984,209986,209989,2,5,0
60148,6,1,209990,209990,209991,0,1,1
60149,6,2,209996,209996,209998,0,2,5
60150,6,2,210002,210002,210004,0,2,4
60151,3,2,210005,210005,210007,0,2,1
60152,1,1,210006,210007,210008,1,2,0
60153,4,1,210010,210010,210011,0,1,2
60154,6,1,210016,210016,210017,0,1,5
60155,6,3,210022,210022,210025,0,3,5
60156,5,1,210027,210027,210028,0,1,2
60157,3,3,210030,210030,210033,0,3,2
60158,4,1,210034,210034,210035,0,1,1
60159,1,3,210035,210035,210038,0,3,0
60160,3,1,210038,210038,210039,0,1,0
60161,4,1,210042,210042,210043,0,1,3
60162,1,3,210043,210043,210046,0,3,0
60163,6,1,210049,210049,210050,0,1,3
60164,5,2,210054,210054,210056,0,2,4
60165,5,1,210059,210059,210060,0,1,3
60166,1,3,210060,210060,210063,0,3,0
60167,3,3,210063,210063,210066,0,3,0
60168,5,3,210068,210068,210071,0,3,2
60169,6,1,210074,210074,210075,0,1,3
60170,5,1,210079,210079,210080,0,1,4
60171,1,1,210080,210080,210081,0,1,0
60172,5,3,210085,210085,210088,0,3,4
60173,5,1,210090,210090,210091,0,1,2
60174,5,2,210095,210095,210097,0,2,4
60175,6,1,210101,210101,210102,0,1,4
60176,5,3,210106,210106,210109,0,3,4
60177,4,3,210110,210110,210113,0,3,1
60178,5,2,210115,210115,210117,0,2,2
60179,3,3,210118,210118,210121,0,3,1
60180,1,2,210119,210121,210123,2,4,0
60181,1,3,210120,210123,210126,3,6,0
60182,1,1,210121,210126,210127,5,6,0
60183,4,1,210125,210127,210128,2,3,0
60184,5,2,210130,210130,210132,0,2,2
60185,1,2,210131,210132,210134,1,3,0
60186,1,3,210132,210134,210137,2,5,0
60187,4,1,210136,210137,210138,1,2,0
60188,5,1,210141,210141,210142,0,1,3
60189,4,1,210145,210145,210146,0,1,3
60190,3,1,210148,210148,210149,0,1,2
60191,3,1,210151,210151,210152,0,1,2
60192,3,1,210154,210154,210155,0,1,2
60193,5,2,210159,210159,210161,0,2,4
60194,6,1,210165,210165,210166,0,1,4
60195,4,2,210169,210169,210171,0,2,3
60196,6,1,210175,210175,210176,0,1,4
60197,3,3,210178,210178,210181,0,3,2
60198,3,3,210181,210181,210184,0,3,0
60199,2,3,210183,210184,210187,1,4,0
60200,2,2,210185,210187,210189,2,4,0
60201,6,2,210191,210191,210193,0,2,2
60202,1,3,210192,210193,210196,1,4,0
60203,6,2,210198,210198,210200,0,2,2
60204,1,1,210199,210200,210201,1,2,0
60205,3,3,210202,210202,210205,0,3,1
60206,3,3,210205,210205,210208,0,3,0
60207,1,2,210206,210208,210210,2,4,0
60208,5,2,210211,210211,210213,0,2,1
60209,4,1,210215,210215,210216,0,1,2
60210,3,1,210218,210218,210219,0,1,2
60211,5,3,210223,210223,210226,0,3,4
60212,3,2,210226,210226,210228,0,2,0
60213,6,3,210232,210232,210235,0,3,4
60214,4,2,210236,210236,210238,0,2,1
60215,4,3,210240,210240,210243,0,3,2
60216,1,1,210241,210243,210244,2,3,0
60217,5,1,210246,210246,210247,0,1,2
60218,2,1,210248,210248,210249,0,1,1
60219,4,1,210252,210252,210253,0,1,3
60220,3,3,210255,210255,210258,0,3,2
60221,5,1,210260,210260,210261,0,1,2
60222,5,3,210265,210265,210268,0,3,4
60223,2,1,210267,210268,210269,1,2,0
60224,4,2,210271,210271,210273,0,2,2
60225,1,1,210272,210273,210274,1,2,0
60226,2,1,210274,210274,210275,0,1,0
60227,4,2,210278,210278,210280,0,2,3
60228,3,1,210281,210281,210282,0,1,1
60229,4,1,210285,210285,210286,0,1,3
60230,4,1,210289,210289,210290,0,1,3
60231,5,3,210294,210294,210297,0,3,4
60232,6,1,210300,210300,210301,0,1,3
60233,5,2,210305,210305,210307,0,2,4
60234,2,3,210307,210307,210310,0,3,0
60235,2,3,210309,210310,210313,1,4,0
60236,2,2,210311,210313,210315,2,4,0
60237,4,1,210315,210315,210316,0,1,0
60238,3,3,210318,210318,210321,0,3,2
60239,5,3,210323,210323,210326,0,3,2
60240,2,1,210325,210326,210327,1,2,0
60241,5,3,210330,210330,210333,0,3,3
60242,4,2,210334,210334,210336,0,2,1
60243,1,2,210335,210336,210338,1,3,0
60244,4,1,210339,210339,210340,0,1,1
60245,5,3,210344,210344,210347,0,3,4
60246,3,2,210347,210347,210349,0,2,0
60247,1,2,210348,210349,210351,1,3,0
60248,6,3,210354,210354,210357,0,3,3
60249,4,3,210358,210358,210361,0,3,1
60250,1,2,210359,210361,210363,2,4,0
60251,6,2,210365,210365,210367,0,2,2
60252,6,1,210371,210371,210372,0,1,4
60253,4,1,210375,210375,210376,0,1,3
60254,1,1,210376,210376,210377,0,1,0
60255,1,2,210377,210377,210379,0,2,0
60256,3,2,210380,210380,210382,0,2,1
60257,1,2,210381,210382,210384,1,3,0
60258,3,1,210384,210384,210385,0,1,0
60259,2,3,210386,210386,210389,0,3,1
60260,5,1,210391,210391,210392,0,1,2
60261,2,1,210393,210393,210394,0,1,1
60262,2,2,210395,210395,210397,0,2,1
60263,3,1,210398,210398,210399,0,1,1
60264,1,1,210399,210399,210400,0,1,0
60265,1,2,210400,210400,210402,0,2,0
60266,2,3,210402,210402,210405,0,3,0
60267,3,1,210405,210405,210406,0,1,0
60268,5,2,210410,210410,210412,0,2,4
60269,1,3,210411,210412,210415,1,4,0
60270,3,2,210414,210415,210417,1,3,0
60271,3,3,210417,210417,210420,0,3,0
60272,6,2,210423,210423,210425,0,2,3
60273,6,3,210429,210429,210432,0,3,4
60274,5,3,210434,210434,210437,0,3,2
60275,1,1,210435,210437,210438,2,3,0
60276,5,1,210440,210440,210441,0,1,2
60277,2,1,210442,210442,210443,0,1,1
60278,5,3,210447,210447,210450,0,3,4
60279,1,3,210448,210450,210453,2,5,0
60280,6,1,210454,210454,210455,0,1,1
60281,1,2,210455,210455,210457,0,2,0
60282,6,1,210461,210461,210462,0,1,4
60283,5,2,210466,210466,210468,0,2,4
60284,3,1,210469,210469,210470,0,1,1
60285,1,1,210470,210470,210471,0,1,0
60286,6,3,210476,210476,210479,0,3,5
60287,3,1,210479,210479,210480,0,1,0
60288,5,3,210484,210484,210487,0,3,4
60289,5,3,210489,210489,210492,0,3,2
60290,4,3,210493,210493,210496,0,3,1
60291,6,3,210499,210499,210502,0,3,3
60292,6,2,210505,210505,210507,0,2,3
60293,4,3,210509,210509,210512,0,3,2
60294,1,3,210510,210512,210515,2,5,0
60295,5,2,210515,210515,210517,0,2,0
60296,1,2,210516,210517,210519,1,3,0
60297,5,3,210521,210521,210524,0,3,2
60298,5,3,210526,210526,210529,0,3,2
60299,5,2,210531,210531,210533,0,2,2
60300,6,1,210537,210537,210538,0,1,4
60301,2,2,210539,210539,210541,0,2,1
60302,3,2,210542,210542,210544,0,2,1
60303,3,2,210545,210545,210547,0,2,1
60304,3,2,210548,210548,210550,0,2,1
60305,4,3,210552,210552,210555,0,3,2
60306,2,2,210554,210555,210557,1,3,0
60307,5,3,210559,210559,210562,0,3,2
60308,6,1,210565,210565,210566,0,1,3
60309,1,3,210566,210566,210569,0,3,0
60310,4,2,210570,210570,210572,0,2,1
60311,6,3,210576,210576,210579,0,3,4
60312,2,1,210578,210579,210580,1,2,0
60313,2,2,210580,210580,210582,0,2,0
60314,3,2,210583,210583,210585,0,2,1
60315,5,3,210588,210588,210591,0,3,3
60316,3,1,210591,210591,210592,0,1,0
60317,1,2,210592,210592,210594,0,2,0
60318,6,2,210598,210598,210600,0,2,4
60319,3,1,210601,210601,210602,0,1,1
60320,5,2,210606,210606,210608,0,2,4
60321,6,1,210612,210612,210613,0,1,4
60322,5,2,210617,210617,210619,0,2,4
60323,5,3,210622,210622,210625,0,3,3
60324,6,2,210628,210628,210630,0,2,3
60325,3,1,210631,210631,210632,0,1,1
60326,2,1,210633,210633,210634,0,1,1
60327,4,2,210637,210637,210639,0,2,3
60328,4,1,210641,210641,210642,0,1,2
60329,2,1,210643,210643,210644,0,1,1
60330,4,1,210647,210647,210648,0,1,3
60331,3,2,210650,210650,210652,0,2,2
60332,2,1,210652,210652,210653,0,1,0
60333,1,2,210653,210653,210655,0,2,0
60334,1,2,210654,210655,210657,1,3,0
60335,1,2,210655,210657,210659,2,4,0
60336,6,2,210661,210661,210663,0,2,2
60337,1,1,210662,210663,210664,1,2,0
60338,5,3,210667,210667,210670,0,3,3
60339,3,1,210670,210670,210671,0,1,0
60340,6,1,210676,210676,210677,0,1,5
60341,3,3,210679,210679,210682,0,3,2
60342,4,3,210683,210683,210686,0,3,1
60343,5,2,210688,210688,210690,0,2,2
60344,4,2,210692,210692,210694,0,2,2
60345,3,2,210695,210695,210697,0,2,1
60346,4,1,210699,210699,210700,0,1,2
60347,3,2,210702,210702,210704,0,2,2
60348,6,3,210708,210708,210711,0,3,4
60349,2,1,210710,210711,210712,1,2,0
60350,3,3,210713,210713,210716,0,3,1
60351,5,2,210718,210718,210720,0,2,2
60352,2,3,210720,210720,210723,0,3,0
60353,3,1,210723,210723,210724,0,1,0
60354,2,3,210725,210725,210728,0,3,1
60355,1,2,210726,210728,210730,2,4,0
60356,2,2,210728,210730,210732,2,4,0
60357,6,1,210734,210734,210735,0,1,2
60358,6,3,210740,210740,210743,0,3,5
60359,5,3,210745,210745,210748,0,3,2
60360,2,1,210747,210748,210749,1,2,0
60361,5,2,210752,210752,210754,0,2,3
60362,2,1,210754,210754,210755,0,1,0
60363,3,1,210757,210757,210758,0,1,2
60364,6,1,210763,210763,210764,0,1,5
60365,3,1,210766,210766,210767,0,1,2
60366,2,1,210768,210768,210769,0,1,1
60367,4,3,210772,210772,210775,0,3,3
60368,2,3,210774,210775,210778,1,4,0
60369,5,1,210779,210779,210780,0,1,1
60370,2,3,210781,210781,210784,0,3,1
60371,5,3,210786,210786,210789,0,3,2
60372,5,3,210791,210791,210794,0,3,2
60373,2,1,210793,210794,210795,1,2,0
60374,3,3,210796,210796,210799,0,3,1
60375,3,1,210799,210799,210800,0,1,0
60376,4,3,210803,210803,210806,0,3,3
60377,5,3,210808,210808,210811,0,3,2
60378,4,1,210812,210812,210813,0,1,1
60379,3,1,210815,210815,210816,0,1,2
60380,2,1,210817,210817,210818,0,1,1
60381,4,2,210821,210821,210823,0,2,3
60382,4,1,210825,210825,210826,0,1,2
60383,5,1,210830,210830,210831,0,1,4
60384,6,1,210836,210836,210837,0,1,5
60385,4,3,210840,210840,210843,0,3,3
60386,1,1,210841,210843,210844,2,3,0
60387,5,1,210846,210846,210847,0,1,2
60388,6,3,210852,210852,210855,0,3,5
60389,4,3,210856,210856,210859,0,3,1
60390,6,2,210862,210862,210864,0,2,3
60391,2,1,210864,210864,210865,0,1,0
60392,4,1,210868,210868,210869,0,1,3
60393,5,2,210873,210873,210875,0,2,4
60394,4,3,210877,210877,210880,0,3,2
60395,4,1,210881,210881,210882,0,1,1
60396,6,3,210887,210887,210890,0,3,5
60397,2,3,210889,210890,210893,1,4,0
60398,3,2,210892,210893,210895,1,3,0
60399,1,3,210893,210895,210898,2,5,0
60400,1,3,210894,210898,210901,4,7,0
60401,6,1,210900,210901,210902,1,2,0
60402,5,2,210905,210905,210907,0,2,3
60403,2,2,210907,210907,210909,0,2,0
60404,3,3,210910,210910,210913,0,3,1
60405,4,1,210914,210914,210915,0,1,1
60406,3,2,210917,210917,210919,0,2,2
60407,3,2,210920,210920,210922,0,2,1
60408,1,3,210921,210922,210925,1,4,0
60409,5,1,210926,210926,210927,0,1,1
60410,6,3,210932,210932,210935,0,3,5
60411,3,1,210935,210935,210936,0,1,0
60412,5,2,210940,210940,210942,0,2,4
60413,3,3,210943,210943,210946,0,3,1
60414,3,2,210946,210946,210948,0,2,0
60415,1,1,210947,210948,210949,1,2,0
60416,4,3,210951,210951,210954,0,3,2
60417,1,2,210952,210954,210956,2,4,0
60418,4,1,210956,210956,210957,0,1,0
60419,5,2,210961,210961,210963,0,2,4
60420,3,3,210964,210964,210967,0,3,1
60421,6,2,210970,210970,210972,0,2,3
60422,2,3,210972,210972,210975,0,3,0
60423,2,3,210974,210975,210978,1,4,0
60424,5,1,210979,210979,210980,0,1,1
60425,2,2,210981,210981,210983,0,2,1
60426,5,3,210986,210986,210989,0,3,3
60427,1,1,210987,210989,210990,2,3,0
60428,4,2,210991,210991,210993,0,2,1
60429,5,3,210996,210996,210999,0,3,3
60430,2,2,210998,210999,211001,1,3,0
60431,5,2,211003,211003,211005,0,2,2
60432,4,1,211007,211007,211008,0,1,2
60433,6,2,211013,211013,211015,0,2,5
60434,4,1,211017,211017,211018,0,1,2
60435,3,1,211020,211020,211021,0,1,2
60436,4,2,211024,211024,211026,0,2,3
60437,3,1,211027,211027,211028,0,1,1
60438,6,1,211033,211033,211034,0,1,5
60439,3,3,211036,211036,211039,0,3,2
60440,3,1,211039,211039,211040,0,1,0
60441,1,2,211040,211040,211042,0,2,0
60442,1,2,211041,211042,211044,1,3,0
60443,5,2,211046,211046,211048,0,2,2
60444,2,1,211048,211048,211049,0,1,0
60445,2,1,211050,211050,211051,0,1,1
60446,3,2,211053,211053,211055,0,2,2
60447,5,2,211058,211058,211060,0,2,3
60448,6,3,211064,211064,211067,0,3,4
60449,5,2,211069,211069,211071,0,2,2
60450,2,1,211071,211071,211072,0,1,0
60451,2,2,211073,211073,211075,0,2,1
60452,2,3,211075,211075,211078,0,3,0
60453,2,3,211077,211078,211081,1,4,0
60454,6,2,211083,211083,211085,0,2,2
60455,4,3,211087,211087,211090,0,3,2
60456,5,1,211092,211092,211093,0,1,2
60457,2,2,211094,211094,211096,0,2,1
60458,6,3,211100,211100,211103,0,3,4
60459,4,3,211104,211104,211107,0,3,1
60460,1,2,211105,211107,211109,2,4,0
60461,4,3,211109,211109,211112,0,3,0
60462,6,3,211115,211115,211118,0,3,3
60463,4,2,211119,211119,211121,0,2,1
60464,2,1,211121,211121,211122,0,1,0
60465,1,1,211122,211122,211123,0,1,0
60466,4,1,211126,211126,211127,0,1,3
60467,6,1,211132,211132,211133,0,1,5
60468,2,2,211134,211134,211136,0,2,1
60469,5,1,211139,211139,211140,0,1,3
60470,6,1,211145,211145,211146,0,1,5
60471,3,3,211148,211148,211151,0,3,2
60472,6,2,211154,211154,211156,0,2,3
60473,3,3,211157,211157,211160,0,3,1
60474,5,2,211162,211162,211164,0,2,2
60475,5,1,211167,211167,211168,0,1,3
60476,6,1,211173,211173,211174,0,1,5
60477,4,2,211177,211177,211179,0,2,3
60478,1,3,211178,211179,211182,1,4,0
60479,2,2,211180,211182,211184,2,4,0
60480,5,1,211185,211185,211186,0,1,1
60481,4,3,211189,211189,211192,0,3,3
60482,4,2,211193,211193,211195,0,2,1
60483,1,2,211194,211195,211197,1,3,0
60484,5,3,211199,211199,211202,0,3,2
60485,2,1,211201,211202,211203,1,2,0
60486,6,2,211207,211207,211209,0,2,4
60487,1,2,211208,211209,211211,1,3,0
60488,1,2,211209,211211,211213,2,4,0
60489,4,3,211213,211213,211216,0,3,0
60490,5,3,211218,211218,211221,0,3,2
60491,5,3,211223,211223,211226,0,3,2
60492,6,1,211229,211229,211230,0,1,3
60493,1,2,211230,211230,211232,0,2,0
60494,4,3,211234,211234,211237,0,3,2
60495,5,1,211239,211239,211240,0,1,2
60496,3,3,211242,211242,211245,0,3,2
60497,4,1,211246,211246,211247,0,1,1
60498,6,3,211252,211252,211255,0,3,5
60499,2,2,211254,211255,211257,1,3,0
60500,6,1,211260,211260,211261,0,1,3
60501,3,3,211263,211263,211266,0,3,2
60502,5,3,211268,211268,211271,0,3,2
60503,3,3,211271,211271,211274,0,3,0
60504,2,3,211273,211274,211277,1,4,0
60505,4,2,211277,211277,211279,0,2,0
60506,3,2,211280,211280,211282,0,2,1
60507,2,2,211282,211282,211284,0,2,0
60508,1,1,211283,211284,211285,1,2,0
60509,5,1,211288,211288,211289,0,1,3
60510,6,2,211294,211294,211296,0,2,5
60511,6,2,211300,211300,211302,0,2,4
60512,4,2,211304,211304,211306,0,2,2
60513,3,2,211307,211307,211309,0,2,1
60514,2,3,211309,211309,211312,0,3,0
60515,3,3,211312,211312,211315,0,3,0
60516,2,3,211314,211315,211318,1,4,0
60517,4,1,211318,211318,211319,0,1,0
60518,6,3,211324,211324,211327,0,3,5
60519,6,1,211330,211330,211331,0,1,3
60520,6,1,211336,211336,211337,0,1,5
60521,3,2,211339,211339,211341,0,2,2
60522,4,2,211343,211343,211345,0,2,2
60523,4,2,211347,211347,211349,0,2,2
60524,6,2,211353,211353,211355,0,2,4
60525,3,1,211356,211356,211357,0,1,1
60526,2,1,211358,211358,211359,0,1,1
60527,2,3,211360,211360,211363,0,3,1
60528,3,1,211363,211363,211364,0,1,0
60529,4,2,211367,211367,211369,0,2,3
60530,2,1,211369,211369,211370,0,1,0
60531,3,1,211372,211372,211373,0,1,2
60532,3,3,211375,211375,211378,0,3,2
60533,6,1,211381,211381,211382,0,1,3
60534,1,1,211382,211382,211383,0,1,0
60535,5,3,211387,211387,211390,0,3,4
60536,3,1,211390,211390,211391,0,1,0
60537,4,3,211394,211394,211397,0,3,3
60538,2,2,211396,211397,211399,1,3,0
60539,1,2,211397,211399,211401,2,4,0
60540,3,1,211400,211401,211402,1,2,0
60541,1,1,211401,211402,211403,1,2,0
60542,5,3,211406,211406,211409,0,3,3
60543,1,1,211407,211409,211410,2,3,0
60544,4,3,211411,211411,211414,0,3,1
60545,3,1,211414,211414,211415,0,1,0
60546,4,2,211418,211418,211420,0,2,3
60547,2,1,211420,211420,211421,0,1,0
60548,2,3,211422,211422,211425,0,3,1
60549,6,1,211428,211428,211429,0,1,3
60550,5,2,211433,211433,211435,0,2,4
60551,5,3,211438,211438,211441,0,3,3
60552,1,3,211439,211441,211444,2,5,0
60553,4,3,211443,211444,211447,1,4,0
60554,2,3,211445,211447,211450,2,5,0
60555,6,2,211451,211451,211453,0,2,1
60556,2,1,211453,211453,211454,0,1,0
60557,3,1,211456,211456,211457,0,1,2
60558,3,2,211459,211459,211461,0,2,2
60559,2,2,211461,211461,211463,0,2,0
60560,1,3,211462,211463,211466,1,4,0
60561,5,3,211467,211467,211470,0,3,1
60562,6,2,211473,211473,211475,0,2,3
60563,5,2,211478,211478,211480,0,2,3
60564,5,2,211483,211483,211485,0,2,3
60565,3,2,211486,211486,211488,0,2,1
60566,6,2,211492,211492,211494,0,2,4
60567,2,1,211494,211494,211495,0,1,0
60568,1,2,211495,211495,211497,0,2,0
60569,5,1,211500,211500,211501,0,1,3
60570,5,3,211505,211505,211508,0,3,4
60571,6,1,211511,211511,211512,0,1,3
60572,1,1,211512,211512,211513,0,1,0
60573,2,1,211514,211514,211515,0,1,1
60574,6,3,211520,211520,211523,0,3,5
60575,3,2,211523,211523,211525,0,2,0
60576,2,2,211525,211525,211527,0,2,0
60577,4,2,211529,211529,211531,0,2,2
60578,1,2,211530,211531,211533,1,3,0
60579,5,2,211535,211535,211537,0,2,2
60580,2,3,211537,211537,211540,0,3,0
60581,1,2,211538,211540,211542,2,4,0
60582,4,1,211542,211542,211543,0,1,0
60583,6,2,211548,211548,211550,0,2,5
60584,5,2,211553,211553,211555,0,2,3
60585,1,1,211554,211555,211556,1,2,0
60586,2,2,211556,211556,211558,0,2,0
60587,4,3,211560,211560,211563,0,3,2
60588,5,2,211565,211565,211567,0,2,2
60589,1,2,211566,211567,211569,1,3,0
60590,3,1,211569,211569,211570,0,1,0
60591,6,1,211575,211575,211576,0,1,5
60592,2,2,211577,211577,211579,0,2,1
60593,2,1,211579,211579,211580,0,1,0
60594,2,3,211581,211581,211584,0,3,1
60595,5,2,211586,211586,211588,0,2,2
60596,4,1,211590,211590,211591,0,1,2
60597,1,2,211591,211591,211593,0,2,0
60598,2,3,211593,211593,211596,0,3,0
60599,2,1,211595,211596,211597,1,2,0
60600,4,3,211599,211599,211602,0,3,2
60601,2,3,211601,211602,211605,1,4,0
60602,2,3,211603,211605,211608,2,5,0
60603,6,3,211609,211609,211612,0,3,1
60604,5,3,211614,211614,211617,0,3,2
60605,4,2,211618,211618,211620,0,2,1
60606,3,1,211621,211621,211622,0,1,1
60607,5,1,211626,211626,211627,0,1,4
60608,6,2,211632,211632,211634,0,2,5
60609,2,2,211634,211634,211636,0,2,0
60610,1,1,211635,211636,211637,1,2,0
60611,4,2,211639,211639,211641,0,2,2
60612,1,2,211640,211641,211643,1,3,0
60613,3,3,211643,211643,211646,0,3,0
60614,4,2,211647,211647,211649,0,2,1
60615,6,2,211653,211653,211655,0,2,4
60616,3,1,211656,211656,211657,0,1,1
60617,4,3,211660,211660,211663,0,3,3
60618,1,2,211661,211663,211665,2,4,0
60619,4,1,211665,211665,211666,0,1,0
60620,5,1,211670,211670,211671,0,1,4
60621,6,2,211676,211676,211678,0,2,5
60622,4,3,211680,211680,211683,0,3,2
60623,1,2,211681,211683,211685,2,4,0
60624,1,2,211682,211685,211687,3,5,0
60625,3,3,211685,211687,211690,2,5,0
60626,4,1,211689,211690,211691,1,2,0
60627,1,1,211690,211691,211692,1,2,0
60628,2,2,211692,211692,211694,0,2,0
60629,1,3,211693,211694,211697,1,4,0
60630,6,3,211699,211699,211702,0,3,2
60631,5,3,211704,211704,211707,0,3,2
60632,6,3,211710,211710,211713,0,3,3
60633,4,2,211714,211714,211716,0,2,1
60634,1,3,211715,211716,211719,1,4,0
60635,3,2,211718,211719,211721,1,3,0
60636,1,1,211719,211721,211722,2,3,0
60637,1,2,211720,211722,211724,2,4,0
60638,3,3,211723,211724,211727,1,4,0
60639,3,3,211726,211727,211730,1,4,0
60640,6,3,211732,211732,211735,0,3,2
60641,3,1,211735,211735,211736,0,1,0
60642,2,3,211737,211737,211740,0,3,1
60643,5,2,211742,211742,211744,0,2,2
60644,6,3,211748,211748,211751,0,3,4
60645,1,1,211749,211751,211752,2,3,0
60646,5,2,211754,211754,211756,0,2,2
60647,2,3,211756,211756,211759,0,3,0
60648,2,2,211758,211759,211761,1,3,0
60649,5,1,211763,211763,211764,0,1,2
60650,4,1,211767,211767,211768,0,1,3
60651,5,3,211772,211772,211775,0,3,4
60652,2,3,211774,211775,211778,1,4,0
60653,1,1,211775,211778,211779,3,4,0
60654,4,3,211779,211779,211782,0,3,0
60655,3,2,211782,211782,211784,0,2,0
60656,4,3,211786,211786,211789,0,3,2
60657,5,2,211791,211791,211793,0,2,2
60658,2,2,211793,211793,211795,0,2,0
60659,6,2,211799,211799,211801,0,2,4
60660,5,3,211804,211804,211807,0,3,3
60661,1,3,211805,211807,211810,2,5,0
60662,5,1,211810,211810,211811,0,1,0
60663,4,2,211814,211814,211816,0,2,3
60664,6,1,211820,211820,211821,0,1,4
60665,1,3,211821,211821,211824,0,3,0
60666,1,3,211822,211824,211827,2,5,0
60667,2,1,211824,211827,211828,3,4,0
60668,4,3,211828,211828,211831,0,3,0
60669,2,3,211830,211831,211834,1,4,0
60670,2,1,211832,211834,211835,2,3,0
60671,4,1,211836,211836,211837,0,1,1
60672,1,2,211837,211837,211839,0,2,0
60673,1,1,211838,211839,211840,1,2,0
60674,5,3,211843,211843,211846,0,3,3
60675,4,2,211847,211847,211849,0,2,1
60676,6,1,211853,211853,211854,0,1,4
60677,5,3,211858,211858,211861,0,3,4
60678,3,3,211861,211861,211864,0,3,0
60679,5,2,211866,211866,211868,0,2,2
60680,2,2,211868,211868,211870,0,2,0
60681,6,2,211874,211874,211876,0,2,4
60682,3,1,211877,211877,211878,0,1,1
60683,6,2,211883,211883,211885,0,2,5
60684,5,1,211888,211888,211889,0,1,3
60685,5,2,211893,211893,211895,0,2,4
60686,6,1,211899,211899,211900,0,1,4
60687,3,3,211902,211902,211905,0,3,2
60688,3,1,211905,211905,211906,0,1,0
60689,5,1,211910,211910,211911,0,1,4
60690,6,1,211916,211916,211917,0,1,5
60691,2,1,211918,211918,211919,0,1,1
60692,4,1,211922,211922,211923,0,1,3
60693,3,3,211925,211925,211928,0,3,2
60694,2,3,211927,211928,211931,1,4,0
60695,2,3,211929,211931,211934,2,5,0
60696,4,2,211933,211934,211936,1,3,0
60697,3,1,211936,211936,211937,0,1,0
60698,3,3,211939,211939,211942,0,3,2
60699,4,3,211943,211943,211946,0,3,1
60700,2,1,211945,211946,211947,1,2,0
60701,4,1,211949,211949,211950,0,1,2
60702,6,1,211955,211955,211956,0,1,5
60703,5,2,211960,211960,211962,0,2,4
60704,3,2,211963,211963,211965,0,2,1
60705,4,3,211967,211967,211970,0,3,2
60706,4,2,211971,211971,211973,0,2,1
60707,5,3,211976,211976,211979,0,3,3
60708,6,1,211982,211982,211983,0,1,3
60709,6,2,211988,211988,211990,0,2,5
60710,2,2,211990,211990,211992,0,2,0
60711,4,3,211994,211994,211997,0,3,2
60712,3,2,211997,211997,211999,0,2,0
60713,3,3,212000,212000,212003,0,3,1
60714,3,1,212003,212003,212004,0,1,0
60715,6,2,212009,212009,212011,0,2,5
60716,4,1,212013,212013,212014,0,1,2
60717,6,2,212019,212019,212021,0,2,5
60718,1,1,212020,212021,212022,1,2,0
60719,1,3,212021,212022,212025,1,4,0
60720,3,2,212024,212025,212027,1,3,0
60721,1,2,212025,212027,212029,2,4,0
60722,2,2,212027,212029,212031,2,4,0
60723,1,2,212028,212031,212033,3,5,0
60724,4,1,212032,212033,212034,1,2,0
60725,6,1,212038,212038,212039,0,1,4
60726,2,1,212040,212040,212041,0,1,1
60727,3,2,212043,212043,212045,0,2,2
60728,4,3,212047,212047,212050,0,3,2
60729,4,1,212051,212051,212052,0,1,1
60730,3,2,212054,212054,212056,0,2,2
60731,3,3,212057,212057,212060,0,3,1
60732,2,2,212059,212060,212062,1,3,0
60733,2,1,212061,212062,212063,1,2,0
60734,4,1,212065,212065,212066,0,1,2
60735,4,3,212069,212069,212072,0,3,3
60736,6,3,212075,212075,212078,0,3,3
60737,2,1,212077,212078,212079,1,2,0
60738,2,2,212079,212079,212081,0,2,0
60739,6,3,212085,212085,212088,0,3,4
60740,3,2,212088,212088,212090,0,2,0
60741,5,3,212093,212093,212096,0,3,3
60742,3,2,212096,212096,212098,0,2,0
60743,6,3,212102,212102,212105,0,3,4
60744,1,1,212103,212105,212106,2,3,0
60745,4,1,212107,212107,212108,0,1,1
60746,6,2,212113,212113,212115,0,2,5
60747,2,3,212115,212115,212118,0,3,0
60748,2,2,212117,212118,212120,1,3,0
60749,6,1,212123,212123,212124,0,1,3
60750,1,1,212124,212124,212125,0,1,0
60751,3,1,212127,212127,212128,0,1,2
60752,5,2,212132,212132,212134,0,2,4
60753,2,3,212134,212134,212137,0,3,0
60754,4,1,212138,212138,212139,0,1,1
60755,1,3,212139,212139,212142,0,3,0
60756,5,2,212144,212144,212146,0,2,2
60757,4,1,212148,212148,212149,0,1,2
60758,5,3,212153,212153,212156,0,3,4
60759,1,2,212154,212156,212158,2,4,0
60760,2,3,212156,212158,212161,2,5,0
60761,5,1,212161,212161,212162,0,1,0
60762,3,3,212164,212164,212167,0,3,2
60763,6,2,212170,212170,212172,0,2,3
60764,3,2,212173,212173,212175,0,2,1
60765,6,3,212179,212179,212182,0,3,4
60766,2,3,212181,212182,212185,1,4,0
60767,6,2,212187,212187,212189,0,2,2
60768,3,1,212190,212190,212191,0,1,1
60769,6,3,212196,212196,212199,0,3,5
60770,1,2,212197,212199,212201,2,4,0
60771,4,3,212201,212201,212204,0,3,0
60772,1,1,212202,212204,212205,2,3,0
60773,1,2,212203,212205,212207,2,4,0
60774,6,2,212209,212209,212211,0,2,2
60775,6,2,212215,212215,212217,0,2,4
60776,3,2,212218,212218,212220,0,2,1
60777,5,2,212223,212223,212225,0,2,3
60778,1,3,212224,212225,212228,1,4,0
60779,1,3,212225,212228,212231,3,6,0
60780,4,2,212229,212231,212233,2,4,0
60781,2,3,212231,212233,212236,2,5,0
60782,5,1,212236,212236,212237,0,1,0
60783,3,1,212239,212239,212240,0,1,2
60784,6,3,212245,212245,212248,0,3,5
60785,1,2,212246,212248,212250,2,4,0
60786,6,2,212252,212252,212254,0,2,2
60787,4,3,212256,212256,212259,0,3,2
60788,5,3,212261,212261,212264,0,3,2
60789,2,2,212263,212264,212266,1,3,0
60790,3,2,212266,212266,212268,0,2,0
60791,2,3,212268,212268,212271,0,3,0
60792,6,3,212274,212274,212277,0,3,3
60793,3,1,212277,212277,212278,0,1,0
60794,5,1,212282,212282,212283,0,1,4
60795,3,3,212285,212285,212288,0,3,2
60796,3,3,212288,212288,212291,0,3,0
60797,1,1,212289,212291,212292,2,3,0
60798,3,1,212292,212292,212293,0,1,0
60799,2,2,212294,212294,212296,0,2,1
60800,6,3,212300,212300,212303,0,3,4
60801,6,3,212306,212306,212309,0,3,3
60802,3,3,212309,212309,212312,0,3,0
60803,3,2,212312,212312,212314,0,2,0
60804,6,1,212318,212318,212319,0,1,4
60805,3,3,212321,212321,212324,0,3,2
60806,6,1,212327,212327,212328,0,1,3
60807,1,2,212328,212328,212330,0,2,0
60808,1,2,212329,212330,212332,1,3,0
60809,4,2,212333,212333,212335,0,2,1
60810,6,1,212339,212339,212340,0,1,4
60811,3,2,212342,212342,212344,0,2,2
60812,5,3,212347,212347,212350,0,3,3
60813,6,3,212353,212353,212356,0,3,3
60814,5,2,212358,212358,212360,0,2,2
60815,1,3,212359,212360,212363,1,4,0
60816,3,3,212362,212363,212366,1,4,0
60817,3,1,212365,212366,212367,1,2,0
60818,2,3,212367,212367,212370,0,3,0
60819,6,2,212373,212373,212375,0,2,3
60820,6,2,212379,212379,212381,0,2,4
60821,6,3,212385,212385,212388,0,3,4
60822,6,3,212391,212391,212394,0,3,3
60823,4,1,212395,212395,212396,0,1,1
60824,3,2,212398,212398,212400,0,2,2
60825,5,2,212403,212403,212405,0,2,3
60826,5,3,212408,212408,212411,0,3,3
60827,1,1,212409,212411,212412,2,3,0
60828,2,3,212411,212412,212415,1,4,0
60829,5,1,212416,212416,212417,0,1,1
60830,5,3,212421,212421,212424,0,3,4
60831,5,2,212426,212426,212428,0,2,2
60832,6,3,212432,212432,212435,0,3,4
60833,3,3,212435,212435,212438,0,3,0
60834,2,2,212437,212438,212440,1,3,0
60835,1,1,212438,212440,212441,2,3,0
60836,5,2,212443,212443,212445,0,2,2
60837,2,3,212445,212445,212448,0,3,0
60838,4,2,212449,212449,212451,0,2,1
60839,6,2,212455,212455,212457,0,2,4
60840,1,3,212456,212457,212460,1,4,0
60841,4,3,212460,212460,212463,0,3,0
60842,6,2,212466,212466,212468,0,2,3
60843,2,3,212468,212468,212471,0,3,0
60844,5,3,212473,212473,212476,0,3,2
60845,6,1,212479,212479,212480,0,1,3
60846,1,1,212480,212480,212481,0,1,0
60847,1,1,212481,212481,212482,0,1,0
60848,1,1,212482,212482,212483,0,1,0
60849,5,2,212487,212487,212489,0,2,4
60850,6,3,212493,212493,212496,0,3,4
60851,1,2,212494,212496,212498,2,4,0
60852,6,1,212500,212500,212501,0,1,2
60853,3,2,212503,212503,212505,0,2,2
60854,5,3,212508,212508,212511,0,3,3
60855,3,3,212511,212511,212514,0,3,0
60856,6,2,212517,212517,212519,0,2,3
60857,5,1,212522,212522,212523,0,1,3
60858,5,3,212527,212527,212530,0,3,4
60859,5,2,212532,212532,212534,0,2,2
60860,1,1,212533,212534,212535,1,2,0
60861,6,2,212539,212539,212541,0,2,4
60862,5,1,212544,212544,212545,0,1,3
60863,5,1,212549,212549,212550,0,1,4
60864,4,3,212553,212553,212556,0,3,3
60865,6,1,212559,212559,212560,0,1,3
60866,3,2,212562,212562,212564,0,2,2
60867,2,3,212564,212564,212567,0,3,0
60868,4,3,212568,212568,212571,0,3,1
60869,1,3,212569,212571,212574,2,5,0
60870,4,2,212573,212574,212576,1,3,0
60871,1,3,212574,212576,212579,2,5,0
60872,1,3,212575,212579,212582,4,7,0
60873,3,3,212578,212582,212585,4,7,0
60874,6,2,212584,212585,212587,1,3,0
60875,4,2,212588,212588,212590,0,2,1
60876,1,2,212589,212590,212592,1,3,0
60877,5,2,212594,212594,212596,0,2,2
60878,6,3,212600,212600,212603,0,3,4
60879,5,3,212605,212605,212608,0,3,2
60880,6,2,212611,212611,212613,0,2,3
60881,2,2,212613,212613,212615,0,2,0
60882,3,3,212616,212616,212619,0,3,1
60883,4,2,212620,212620,212622,0,2,1
60884,4,3,212624,212624,212627,0,3,2
60885,2,3,212626,212627,212630,1,4,0
60886,6,2,212632,212632,212634,0,2,2
60887,3,3,212635,212635,212638,0,3,1
60888,6,3,212641,212641,212644,0,3,3
60889,1,1,212642,212644,212645,2,3,0
60890,5,2,212647,212647,212649,0,2,2
60891,3,1,212650,212650,212651,0,1,1
60892,6,2,212656,212656,212658,0,2,5
60893,4,2,212660,212660,212662,0,2,2
60894,2,3,212662,212662,212665,0,3,0
60895,1,2,212663,212665,212667,2,4,0
60896,1,1,212664,212667,212668,3,4,0
60897,2,1,212666,212668,212669,2,3,0
60898,6,3,212672,212672,212675,0,3,3
60899,4,1,212676,212676,212677,0,1,1
60900,5,3,212681,212681,212684,0,3,4
60901,2,1,212683,212684,212685,1,2,0
60902,6,3,212689,212689,212692,0,3,4
60903,5,2,212694,212694,212696,0,2,2
60904,6,3,212700,212700,212703,0,3,4
60905,2,3,212702,212703,212706,1,4,0
60906,1,2,212703,212706,212708,3,5,0
60907,5,1,212708,212708,212709,0,1,0
60908,4,3,212712,212712,212715,0,3,3
60909,2,1,212714,212715,212716,1,2,0
60910,5,2,212719,212719,212721,0,2,3
60911,6,3,212725,212725,212728,0,3,4
60912,6,3,212731,212731,212734,0,3,3
60913,6,2,212737,212737,212739,0,2,3
60914,5,1,212742,212742,212743,0,1,3
60915,5,2,212747,212747,212749,0,2,4
60916,2,2,212749,212749,212751,0,2,0
60917,3,2,212752,212752,212754,0,2,1
60918,6,2,212758,212758,212760,0,2,4
60919,6,1,212764,212764,212765,0,1,4
60920,5,1,212769,212769,212770,0,1,4
60921,1,3,212770,212770,212773,0,3,0
60922,1,2,212771,212773,212775,2,4,0
60923,5,2,212776,212776,212778,0,2,1
60924,6,2,212782,212782,212784,0,2,4
60925,6,3,212788,212788,212791,0,3,4
60926,4,1,212792,212792,212793,0,1,1
60927,6,3,212798,212798,212801,0,3,5
60928,6,2,212804,212804,212806,0,2,3
60929,1,1,212805,212806,212807,1,2,0
60930,4,3,212809,212809,212812,0,3,2
60931,5,1,212814,212814,212815,0,1,2
60932,5,2,212819,212819,212821,0,2,4
60933,5,3,212824,212824,212827,0,3,3
60934,2,3,212826,212827,212830,1,4,0
60935,1,2,212827,212830,212832,3,5,0
60936,6,1,212833,212833,212834,0,1,1
60937,6,3,212839,212839,212842,0,3,5
60938,6,3,212845,212845,212848,0,3,3
60939,1,2,212846,212848,212850,2,4,0
60940,3,1,212849,212850,212851,1,2,0
60941,1,2,212850,212851,212853,1,3,0
60942,5,3,212855,212855,212858,0,3,2
60943,3,2,212858,212858,212860,0,2,0
60944,1,2,212859,212860,212862,1,3,0
60945,4,2,212863,212863,212865,0,2,1
60946,2,1,212865,212865,212866,0,1,0
60947,6,2,212871,212871,212873,0,2,5
60948,4,1,212875,212875,212876,0,1,2
60949,2,1,212877,212877,212878,0,1,1
60950,4,3,212881,212881,212884,0,3,3
60951,6,1,212887,212887,212888,0,1,3
60952,3,2,212890,212890,212892,0,2,2
60953,4,1,212894,212894,212895,0,1,2
60954,1,2,212895,212895,212897,0,2,0
60955,2,2,212897,212897,212899,0,2,0
60956,3,3,212900,212900,212903,0,3,1
60957,1,2,212901,212903,212905,2,4,0
60958,3,3,212904,212905,212908,1,4,0
60959,4,2,212908,212908,212910,0,2,0
60960,1,3,212909,212910,212913,1,4,0
60961,6,1,212915,212915,212916,0,1,2
60962,3,3,212918,212918,212921,0,3,2
60963,5,3,212923,212923,212926,0,3,2
60964,2,1,212925,212926,212927,1,2,0
60965,6,1,212931,212931,212932,0,1,4
60966,4,1,212935,212935,212936,0,1,3
60967,5,2,212940,212940,212942,0,2,4
60968,2,1,212942,212942,212943,0,1,0
60969,2,1,212944,212944,212945,0,1,1
60970,4,1,212948,212948,212949,0,1,3
60971,1,3,212949,212949,212952,0,3,0
60972,4,1,212953,212953,212954,0,1,1
60973,4,2,212957,212957,212959,0,2,3
60974,3,2,212960,212960,212962,0,2,1
60975,3,3,212963,212963,212966,0,3,1
60976,1,1,212964,212966,212967,2,3,0
60977,2,3,212966,212967,212970,1,4,0
60978,3,3,212969,212970,212973,1,4,0
60979,2,1,212971,212973,212974,2,3,0
60980,1,2,212972,212974,212976,2,4,0
60981,1,3,212973,212976,212979,3,6,0
60982,2,1,212975,212979,212980,4,5,0
60983,6,1,212981,212981,212982,0,1,1
60984,1,2,212982,212982,212984,0,2,0
60985,5,2,212987,212987,212989,0,2,3
60986,3,3,212990,212990,212993,0,3,1
60987,2,1,212992,212993,212994,1,2,0
60988,6,3,212998,212998,213001,0,3,4
60989,6,2,213004,213004,213006,0,2,3
60990,6,1,213010,213010,213011,0,1,4
60991,4,1,213014,213014,213015,0,1,3
60992,1,3,213015,213015,213018,0,3,0
60993,4,2,213019,213019,213021,0,2,1
60994,6,3,213025,213025,213028,0,3,4
60995,1,3,213026,213028,213031,2,5,0
60996,1,1,213027,213031,213032,4,5,0
60997,5,1,213032,213032,213033,0,1,0
60998,1,3,213033,213033,213036,0,3,0
60999,5,1,213038,213038,213039,0,1,2
61000,1,1,213039,213039,213040,0,1,0
61001,4,2,213043,213043,213045,0,2,3
61002,2,3,213045,213045,213048,0,3,0
61003,1,1,213046,213048,213049,2,3,0
61004,2,2,213048,213049,213051,1,3,0
61005,6,2,213054,213054,213056,0,2,3
61006,3,3,213057,213057,213060,0,3,1
61007,3,1,213060,213060,213061,0,1,0
61008,2,2,213062,213062,213064,0,2,1
61009,3,3,213065,213065,213068,0,3,1
61010,1,2,213066,213068,213070,2,4,0
61011,1,1,213067,213070,213071,3,4,0
61012,5,1,213072,213072,213073,0,1,1
61013,3,3,213075,213075,213078,0,3,2
61014,3,1,213078,213078,213079,0,1,0
61015,5,1,213083,213083,213084,0,1,4
61016,6,1,213089,213089,213090,0,1,5
61017,2,2,213091,213091,213093,0,2,1
61018,2,1,213093,213093,213094,0,1,0
61019,5,1,213098,213098,213099,0,1,4
61020,1,2,213099,213099,213101,0,2,0
61021,2,3,213101,213101,213104,0,3,0
61022,5,1,213106,213106,213107,0,1,2
61023,6,1,213112,213112,213113,0,1,5
61024,2,1,213114,213114,213115,0,1,1
61025,5,2,213119,213119,213121,0,2,4
61026,6,1,213125,213125,213126,0,1,4
61027,6,3,213131,213131,213134,0,3,5
61028,5,2,213136,213136,213138,0,2,2
61029,5,3,213141,213141,213144,0,3,3
61030,1,1,213142,213144,213145,2,3,0
61031,6,2,213148,213148,213150,0,2,3
61032,5,2,213153,213153,213155,0,2,3
61033,2,3,213155,213155,213158,0,3,0
61034,5,3,213160,213160,213163,0,3,2
61035,3,2,213163,213163,213165,0,2,0
61036,1,1,213164,213165,213166,1,2,0
61037,3,2,213167,213167,213169,0,2,1
61038,3,2,213170,213170,213172,0,2,1
61039,1,1,213171,213172,213173,1,2,0
61040,3,1,213174,213174,213175,0,1,1
61041,3,2,213177,213177,213179,0,2,2
61042,3,1,213180,213180,213181,0,1,1
61043,5,3,213185,213185,213188,0,3,4
61044,3,2,213188,213188,213190,0,2,0
61045,6,1,213194,213194,213195,0,1,4
61046,6,2,213200,213200,213202,0,2,5
61047,2,3,213202,213202,213205,0,3,0
61048,5,1,213207,213207,213208,0,1,2
61049,6,2,213213,213213,213215,0,2,5
61050,1,2,213214,213215,213217,1,3,0
61051,3,3,213217,213217,213220,0,3,0
61052,6,1,213223,213223,213224,0,1,3
61053,3,2,213226,213226,213228,0,2,2
61054,6,1,213232,213232,213233,0,1,4
61055,3,2,213235,213235,213237,0,2,2
61056,3,2,213238,213238,213240,0,2,1
61057,6,3,213244,213244,213247,0,3,4
61058,2,3,213246,213247,213250,1,4,0
61059,4,3,213250,213250,213253,0,3,0
61060,1,2,213251,213253,213255,2,4,0
61061,6,1,213257,213257,213258,0,1,2
61062,4,1,213261,213261,213262,0,1,3
61063,6,1,213267,213267,213268,0,1,5
61064,2,1,213269,213269,213270,0,1,1
61065,5,3,213274,213274,213277,0,3,4
61066,1,1,213275,213277,213278,2,3,0
61067,4,2,213279,213279,213281,0,2,1
61068,3,1,213282,213282,213283,0,1,1
61069,2,1,213284,213284,213285,0,1,1
61070,3,3,213287,213287,213290,0,3,2
61071,1,3,213288,213290,213293,2,5,0
61072,3,3,213291,213293,213296,2,5,0
61073,4,3,213295,213296,213299,1,4,0
61074,2,3,213297,213299,213302,2,5,0
61075,4,2,213301,213302,213304,1,3,0
61076,6,2,213307,213307,213309,0,2,3
61077,3,3,213310,213310,213313,0,3,1
61078,2,1,213312,213313,213314,1,2,0
61079,3,3,213315,213315,213318,0,3,1
61080,4,1,213319,213319,213320,0,1,1
61081,5,1,213324,213324,213325,0,1,4
61082,6,2,213330,213330,213332,0,2,5
61083,4,1,213334,213334,213335,0,1,2
61084,1,2,213335,213335,213337,0,2,0
61085,2,2,213337,213337,213339,0,2,0
61086,1,1,213338,213339,213340,1,2,0
61087,6,1,213344,213344,213345,0,1,4
61088,5,3,213349,213349,213352,0,3,4
61089,2,2,213351,213352,213354,1,3,0
61090,1,1,213352,213354,213355,2,3,0
61091,6,2,213358,213358,213360,0,2,3
61092,4,2,213362,213362,213364,0,2,2
61093,6,2,213368,213368,213370,0,2,4
61094,3,3,213371,213371,213374,0,3,1
61095,5,2,213376,213376,213378,0,2,2
61096,3,3,213379,213379,213382,0,3,1
61097,3,1,213382,213382,213383,0,1,0
61098,5,3,213387,213387,213390,0,3,4
61099,1,3,213388,213390,213393,2,5,0
61100,3,1,213391,213393,213394,2,3,0
61101,1,2,213392,213394,213396,2,4,0
61102,4,1,213396,213396,213397,0,1,0
61103,4,2,213400,213400,213402,0,2,3
61104,6,3,213406,213406,213409,0,3,4
61105,5,3,213411,213411,213414,0,3,2
61106,5,3,213416,213416,213419,0,3,2
61107,2,1,213418,213419,213420,1,2,0
61108,2,1,213420,213420,213421,0,1,0
61109,1,1,213421,213421,213422,0,1,0
61110,4,2,213425,213425,213427,0,2,3
61111,2,2,213427,213427,213429,0,2,0
61112,3,1,213430,213430,213431,0,1,1
61113,6,2,213436,213436,213438,0,2,5
61114,4,1,213440,213440,213441,0,1,2
61115,5,2,213445,213445,213447,0,2,4
61116,3,2,213448,213448,213450,0,2,1
61117,5,2,213453,213453,213455,0,2,3
61118,4,1,213457,213457,213458,0,1,2
61119,6,1,213463,213463,213464,0,1,5
61120,3,3,213466,213466,213469,0,3,2
61121,6,3,213472,213472,213475,0,3,3
61122,2,3,213474,213475,213478,1,4,0
61123,4,3,213478,213478,213481,0,3,0
61124,4,3,213482,213482,213485,0,3,1
61125,4,1,213486,213486,213487,0,1,1
61126,5,2,213491,213491,213493,0,2,4
61127,1,2,213492,213493,213495,1,3,0
61128,5,1,213497,213497,213498,0,1,2
61129,3,2,213500,213500,213502,0,2,2
61130,6,2,213506,213506,213508,0,2,4
61131,3,2,213509,213509,213511,0,2,1
61132,5,2,213514,213514,213516,0,2,3
61133,4,1,213518,213518,213519,0,1,2
61134,2,1,213520,213520,213521,0,1,1
61135,3,1,213523,213523,213524,0,1,2
61136,4,1,213527,213527,213528,0,1,3
61137,2,2,213529,213529,213531,0,2,1
61138,1,1,213530,213531,213532,1,2,0
61139,1,3,213531,213532,213535,1,4,0
61140,1,2,213532,213535,213537,3,5,0
61141,5,2,213537,213537,213539,0,2,0
61142,6,3,213543,213543,213546,0,3,4
61143,5,1,213548,213548,213549,0,1,2
61144,5,1,213553,213553,213554,0,1,4
61145,5,3,213558,213558,213561,0,3,4
61146,4,2,213562,213562,213564,0,2,1
61147,3,3,213565,213565,213568,0,3,1
61148,5,3,213570,213570,213573,0,3,2
61149,3,2,213573,213573,213575,0,2,0
61150,1,1,213574,213575,213576,1,2,0
61151,6,3,213580,213580,213583,0,3,4
61152,2,3,213582,213583,213586,1,4,0
61153,1,1,213583,213586,213587,3,4,0
61154,4,3,213587,213587,213590,0,3,0
61155,2,2,213589,213590,213592,1,3,0
61156,5,2,213594,213594,213596,0,2,2
61157,4,2,213598,213598,213600,0,2,2
61158,5,3,213603,213603,213606,0,3,3
61159,2,2,213605,213606,213608,1,3,0
61160,3,3,213608,213608,213611,0,3,0
61161,4,2,213612,213612,213614,0,2,1
61162,4,1,213616,213616,213617,0,1,2
61163,5,2,213621,213621,213623,0,2,4
61164,1,1,213622,213623,213624,1,2,0
61165,3,2,213625,213625,213627,0,2,1
61166,6,3,213631,213631,213634,0,3,4
61167,6,3,213637,213637,213640,0,3,3
61168,6,2,213643,213643,213645,0,2,3
61169,2,2,213645,213645,213647,0,2,0
61170,2,2,213647,213647,213649,0,2,0
61171,1,2,213648,213649,213651,1,3,0
61172,6,3,213654,213654,213657,0,3,3
61173,3,3,213657,213657,213660,0,3,0
61174,5,1,213662,213662,213663,0,1,2
61175,2,2,213664,213664,213666,0,2,1
61176,3,3,213667,213667,213670,0,3,1
61177,6,2,213673,213673,213675,0,2,3
61178,4,1,213677,213677,213678,0,1,2
61179,2,3,213679,213679,213682,0,3,1
61180,6,1,213685,213685,213686,0,1,3
61181,2,1,213687,213687,213688,0,1,1
61182,5,3,213692,213692,213695,0,3,4
61183,6,1,213698,213698,213699,0,1,3
61184,5,3,213703,213703,213706,0,3,4
61185,2,3,213705,213706,213709,1,4,0
61186,3,1,213708,213709,213710,1,2,0
61187,4,1,213712,213712,213713,0,1,2
61188,3,3,213715,213715,213718,0,3,2
61189,4,1,213719,213719,213720,0,1,1
61190,1,1,213720,213720,213721,0,1,0
61191,5,1,213725,213725,213726,0,1,4
61192,3,2,213728,213728,213730,0,2,2
61193,4,3,213732,213732,213735,0,3,2
61194,3,1,213735,213735,213736,0,1,0
61195,6,2,213741,213741,213743,0,2,5
61196,4,1,213745,213745,213746,0,1,2
61197,5,1,213750,213750,213751,0,1,4
61198,2,3,213752,213752,213755,0,3,1
61199,6,1,213758,213758,213759,0,1,3
61200,4,3,213762,213762,213765,0,3,3
61201,2,1,213764,213765,213766,1,2,0
61202,3,3,213767,213767,213770,0,3,1
61203,4,3,213771,213771,213774,0,3,1
61204,3,2,213774,213774,213776,0,2,0
61205,5,2,213779,213779,213781,0,2,3
61206,6,1,213785,213785,213786,0,1,4
61207,3,1,213788,213788,213789,0,1,2
61208,2,1,213790,213790,213791,0,1,1
61209,2,3,213792,213792,213795,0,3,1
61210,3,1,213795,213795,213796,0,1,0
61211,2,1,213797,213797,213798,0,1,1
61212,1,2,213798,213798,213800,0,2,0
61213,5,2,213803,213803,213805,0,2,3
61214,2,3,213805,213805,213808,0,3,0
61215,6,1,213811,213811,213812,0,1,3
61216,6,2,213817,213817,213819,0,2,5
61217,5,1,213822,213822,213823,0,1,3
61218,3,1,213825,213825,213826,0,1,2
61219,4,2,213829,213829,213831,0,2,3
61220,1,2,213830,213831,213833,1,3,0
61221,2,2,213832,213833,213835,1,3,0
61222,3,2,213835,213835,213837,0,2,0
61223,5,1,213840,213840,213841,0,1,3
61224,3,3,213843,213843,213846,0,3,2
61225,2,2,213845,213846,213848,1,3,0
61226,4,1,213849,213849,213850,0,1,1
61227,5,1,213854,213854,213855,0,1,4
61228,4,1,213858,213858,213859,0,1,3
61229,4,3,213862,213862,213865,0,3,3
61230,6,3,213868,213868,213871,0,3,3
61231,2,1,213870,213871,213872,1,2,0
61232,4,2,213874,213874,213876,0,2,2
61233,6,1,213880,213880,213881,0,1,4
61234,2,2,213882,213882,213884,0,2,1
61235,1,3,213883,213884,213887,1,4,0
61236,4,1,213887,213887,213888,0,1,0
61237,6,3,213893,213893,213896,0,3,5
61238,3,3,213896,213896,213899,0,3,0
61239,1,3,213897,213899,213902,2,5,0
61240,5,1,213902,213902,213903,0,1,0
61241,1,3,213903,213903,213906,0,3,0
61242,5,3,213908,213908,213911,0,3,2
61243,3,2,213911,213911,213913,0,2,0
61244,5,2,213916,213916,213918,0,2,3
61245,4,3,213920,213920,213923,0,3,2
61246,4,3,213924,213924,213927,0,3,1
61247,1,1,213925,213927,213928,2,3,0
61248,3,3,213928,213928,213931,0,3,0
61249,3,1,213931,213931,213932,0,1,0
61250,3,3,213934,213934,213937,0,3,2
61251,4,1,213938,213938,213939,0,1,1
61252,6,3,213944,213944,213947,0,3,5
61253,5,3,213949,213949,213952,0,3,2
61254,1,2,213950,213952,213954,2,4,0
61255,3,3,213953,213954,213957,1,4,0
61256,5,2,213958,213958,213960,0,2,1
61257,4,1,213962,213962,213963,0,1,2
61258,4,2,213966,213966,213968,0,2,3
61259,6,2,213972,213972,213974,0,2,4
61260,6,1,213978,213978,213979,0,1,4
61261,1,3,213979,213979,213982,0,3,0
61262,2,3,213981,213982,213985,1,4,0
61263,6,3,213987,213987,213990,0,3,2
61264,5,3,213992,213992,213995,0,3,2
61265,1,3,213993,213995,213998,2,5,0
61266,2,2,213995,213998,214000,3,5,0
61267,6,1,214001,214001,214002,0,1,1
61268,5,3,214006,214006,214009,0,3,4
61269,1,2,214007,214009,214011,2,4,0
61270,6,2,214013,214013,214015,0,2,2
61271,2,3,214015,214015,214018,0,3,0
61272,5,3,214020,214020,214023,0,3,2
61273,5,1,214025,214025,214026,0,1,2
61274,5,3,214030,214030,214033,0,3,4
61275,2,3,214032,214033,214036,1,4,0
61276,5,2,214037,214037,214039,0,2,1
61277,4,3,214041,214041,214044,0,3,2
61278,1,3,214042,214044,214047,2,5,0
61279,6,3,214048,214048,214051,0,3,1
61280,2,2,214050,214051,214053,1,3,0
61281,1,1,214051,214053,214054,2,3,0
61282,4,1,214055,214055,214056,0,1,1
61283,6,2,214061,214061,214063,0,2,5
61284,2,2,214063,214063,214065,0,2,0
61285,2,3,214065,214065,214068,0,3,0
61286,2,3,214067,214068,214071,1,4,0
61287,1,3,214068,214071,214074,3,6,0
61288,2,2,214070,214074,214076,4,6,0
61289,1,2,214071,214076,214078,5,7,0
61290,1,3,214072,214078,214081,6,9,0
61291,5,1,214077,214081,214082,4,5,0
61292,2,1,214079,214082,214083,3,4,0
61293,6,3,214085,214085,214088,0,3,2
61294,3,3,214088,214088,214091,0,3,0
61295,2,1,214090,214091,214092,1,2,0
61296,1,1,214091,214092,214093,1,2,0
61297,4,3,214095,214095,214098,0,3,2
61298,1,3,214096,214098,214101,2,5,0
61299,6,1,214102,214102,214103,0,1,1
61300,6,3,214108,214108,214111,0,3,5
61301,3,3,214111,214111,214114,0,3,0
61302,6,2,214117,214117,214119,0,2,3
61303,4,2,214121,214121,214123,0,2,2
61304,3,2,214124,214124,214126,0,2,1
61305,1,1,214125,214126,214127,1,2,0
61306,5,3,214130,214130,214133,0,3,3
61307,2,1,214132,214133,214134,1,2,0
61308,5,2,214137,214137,214139,0,2,3
61309,2,1,214139,214139,214140,0,1,0
61310,1,2,214140,214140,214142,0,2,0
61311,4,2,214144,214144,214146,0,2,2
61312,2,1,214146,214146,214147,0,1,0
61313,1,3,214147,214147,214150,0,3,0
61314,6,1,214153,214153,214154,0,1,3
61315,1,3,214154,214154,214157,0,3,0
61316,5,2,214159,214159,214161,0,2,2
61317,1,2,214160,214161,214163,1,3,0
61318,6,3,214166,214166,214169,0,3,3
61319,2,2,214168,214169,214171,1,3,0
61320,2,3,214170,214171,214174,1,4,0
61321,1,1,214171,214174,214175,3,4,0
61322,1,1,214172,214175,214176,3,4,0
61323,4,1,214176,214176,214177,0,1,0
61324,5,3,214181,214181,214184,0,3,4
61325,6,3,214187,214187,214190,0,3,3
61326,1,2,214188,214190,214192,2,4,0
61327,6,1,214194,214194,214195,0,1,2
61328,1,3,214195,214195,214198,0,3,0
61329,1,1,214196,214198,214199,2,3,0
61330,6,2,214202,214202,214204,0,2,3
61331,6,1,214208,214208,214209,0,1,4
61332,2,1,214210,214210,214211,0,1,1
61333,3,2,214213,214213,214215,0,2,2
61334,2,2,214215,214215,214217,0,2,0
61335,6,3,214221,214221,214224,0,3,4
61336,6,1,214227,214227,214228,0,1,3
61337,6,2,214233,214233,214235,0,2,5
61338,5,2,214238,214238,214240,0,2,3
61339,1,3,214239,214240,214243,1,4,0
61340,1,3,214240,214243,214246,3,6,0
61341,2,2,214242,214246,214248,4,6,0
61342,2,3,214244,214248,214251,4,7,0
61343,2,1,214246,214251,214252,5,6,0
61344,3,1,214249,214252,214253,3,4,0
61345,4,1,214253,214253,214254,0,1,0
61346,2,3,214255,214255,214258,0,3,1
61347,3,1,214258,214258,214259,0,1,0
61348,6,1,214264,214264,214265,0,1,5
61349,4,3,214268,214268,214271,0,3,3
61350,1,2,214269,214271,214273,2,4,0
61351,4,1,214273,214273,214274,0,1,0
61352,5,3,214278,214278,214281,0,3,4
61353,1,1,214279,214281,214282,2,3,0
61354,2,2,214281,214282,214284,1,3,0
61355,4,3,214285,214285,214288,0,3,1
61356,4,3,214289,214289,214292,0,3,1
61357,1,3,214290,214292,214295,2,5,0
61358,1,3,214291,214295,214298,4,7,0
61359,6,2,214297,214298,214300,1,3,0
61360,6,3,214303,214303,214306,0,3,3
61361,2,3,214305,214306,214309,1,4,0
61362,4,3,214309,214309,214312,0,3,0
61363,5,2,214314,214314,214316,0,2,2
61364,2,2,214316,214316,214318,0,2,0
61365,2,3,214318,214318,214321,0,3,0
61366,4,3,214322,214322,214325,0,3,1
61367,5,1,214327,214327,214328,0,1,2
61368,6,1,214333,214333,214334,0,1,5
61369,1,1,214334,214334,214335,0,1,0
61370,4,1,214338,214338,214339,0,1,3
61371,6,3,214344,214344,214347,0,3,5
61372,1,2,214345,214347,214349,2,4,0
61373,3,2,214348,214349,214351,1,3,0
61374,1,2,214349,214351,214353,2,4,0
61375,6,2,214355,214355,214357,0,2,2
61376,3,1,214358,214358,214359,0,1,1
61377,1,3,214359,214359,214362,0,3,0
61378,3,2,214362,214362,214364,0,2,0
61379,1,2,214363,214364,214366,1,3,0
61380,4,2,214367,214367,214369,0,2,1
61381,6,1,214373,214373,214374,0,1,4
61382,4,1,214377,214377,214378,0,1,3
61383,2,1,214379,214379,214380,0,1,1
61384,2,1,214381,214381,214382,0,1,1
61385,3,3,214384,214384,214387,0,3,2
61386,3,1,214387,214387,214388,0,1,0
61387,2,2,214389,214389,214391,0,2,1
61388,2,2,214391,214391,214393,0,2,0
61389,1,1,214392,214393,214394,1,2,0
61390,2,1,214394,214394,214395,0,1,0
61391,4,2,214398,214398,214400,0,2,3
61392,3,2,214401,214401,214403,0,2,1
61393,6,1,214407,214407,214408,0,1,4
61394,1,1,214408,214408,214409,0,1,0
61395,5,1,214413,214413,214414,0,1,4
61396,4,1,214417,214417,214418,0,1,3
61397,4,1,214421,214421,214422,0,1,3
61398,6,3,214427,214427,214430,0,3,5
61399,4,2,214431,214431,214433,0,2,1
61400,1,2,214432,214433,214435,1,3,0
61401,2,3,214434,214435,214438,1,4,0
61402,5,2,214439,214439,214441,0,2,1
61403,1,3,214440,214441,214444,1,4,0
61404,2,2,214442,214444,214446,2,4,0
61405,4,2,214446,214446,214448,0,2,0
61406,6,3,214452,214452,214455,0,3,4
61407,5,1,214457,214457,214458,0,1,2
61408,4,2,214461,214461,214463,0,2,3
61409,1,3,214462,214463,214466,1,4,0
61410,5,2,214467,214467,214469,0,2,1
61411,4,2,214471,214471,214473,0,2,2
61412,6,1,214477,214477,214478,0,1,4
61413,1,1,214478,214478,214479,0,1,0
61414,2,2,214480,214480,214482,0,2,1
61415,3,1,214483,214483,214484,0,1,1
61416,1,3,214484,214484,214487,0,3,0
61417,2,1,214486,214487,214488,1,2,0
61418,3,1,214489,214489,214490,0,1,1
61419,5,2,214494,214494,214496,0,2,4
61420,4,2,214498,214498,214500,0,2,2
61421,2,3,214500,214500,214503,0,3,0
61422,3,2,214503,214503,214505,0,2,0
61423,4,3,214507,214507,214510,0,3,2
61424,5,2,214512,214512,214514,0,2,2
61425,6,3,214518,214518,214521,0,3,4
61426,1,3,214519,214521,214524,2,5,0
61427,1,2,214520,214524,214526,4,6,0
61428,6,1,214526,214526,214527,0,1,0
61429,5,1,214531,214531,214532,0,1,4
61430,4,2,214535,214535,214537,0,2,3
61431,5,2,214540,214540,214542,0,2,3
61432,1,1,214541,214542,214543,1,2,0
61433,1,2,214542,214543,214545,1,3,0
61434,2,3,214544,214545,214548,1,4,0
61435,1,3,214545,214548,214551,3,6,0
61436,6,3,214551,214551,214554,0,3,0
61437,1,3,214552,214554,214557,2,5,0
61438,6,2,214558,214558,214560,0,2,1
61439,6,1,214564,214564,214565,0,1,4
61440,5,1,214569,214569,214570,0,1,4
61441,6,1,214575,214575,214576,0,1,5
61442,6,3,214581,214581,214584,0,3,5
61443,1,2,214582,214584,214586,2,4,0
61444,3,1,214585,214586,214587,1,2,0
61445,4,3,214589,214589,214592,0,3,2
61446,3,1,214592,214592,214593,0,1,0
61447,4,1,214596,214596,214597,0,1,3
61448,3,2,214599,214599,214601,0,2,2
61449,6,1,214605,214605,214606,0,1,4
61450,6,2,214611,214611,214613,0,2,5
61451,2,2,214613,214613,214615,0,2,0
61452,3,1,214616,214616,214617,0,1,1
61453,2,2,214618,214618,214620,0,2,1
61454,4,3,214622,214622,214625,0,3,2
61455,1,3,214623,214625,214628,2,5,0
61456,6,2,214629,214629,214631,0,2,1
61457,1,3,214630,214631,214634,1,4,0
61458,1,3,214631,214634,214637,3,6,0
61459,4,1,214635,214637,214638,2,3,0
61460,5,2,214640,214640,214642,0,2,2
61461,1,2,214641,214642,214644,1,3,0
61462,1,2,214642,214644,214646,2,4,0
61463,1,2,214643,214646,214648,3,5,0
61464,4,3,214647,214648,214651,1,4,0
61465,5,1,214652,214652,214653,0,1,1
61466,6,2,214658,214658,214660,0,2,5
61467,3,1,214661,214661,214662,0,1,1
61468,5,1,214666,214666,214667,0,1,4
61469,1,1,214667,214667,214668,0,1,0
61470,4,3,214671,214671,214674,0,3,3
61471,5,3,214676,214676,214679,0,3,2
61472,4,3,214680,214680,214683,0,3,1
61473,6,3,214686,214686,214689,0,3,3
61474,6,3,214692,214692,214695,0,3,3
61475,3,1,214695,214695,214696,0,1,0
61476,2,1,214697,214697,214698,0,1,1
61477,1,1,214698,214698,214699,0,1,0
61478,2,1,214700,214700,214701,0,1,1
61479,2,3,214702,214702,214705,0,3,1
61480,2,3,214704,214705,214708,1,4,0
61481,6,2,214710,214710,214712,0,2,2
61482,3,1,214713,214713,214714,0,1,1
61483,4,2,214717,214717,214719,0,2,3
61484,3,1,214720,214720,214721,0,1,1
61485,4,2,214724,214724,214726,0,2,3
61486,5,2,214729,214729,214731,0,2,3
61487,4,3,214733,214733,214736,0,3,2
61488,6,3,214739,214739,214742,0,3,3
61489,6,3,214745,214745,214748,0,3,3
61490,1,3,214746,214748,214751,2,5,0
61491,5,1,214751,214751,214752,0,1,0
61492,5,1,214756,214756,214757,0,1,4
61493,5,3,214761,214761,214764,0,3,4
61494,2,2,214763,214764,214766,1,3,0
61495,1,1,214764,214766,214767,2,3,0
61496,4,3,214768,214768,214771,0,3,1
61497,2,2,214770,214771,214773,1,3,0
61498,1,1,214771,214773,214774,2,3,0
61499,6,1,214777,214777,214778,0,1,3
61500,4,2,214781,214781,214783,0,2,3
61501,1,1,214782,214783,214784,1,2,0
61502,6,3,214788,214788,214791,0,3,4
61503,5,1,214793,214793,214794,0,1,2
61504,3,1,214796,214796,214797,0,1,2
61505,2,1,214798,214798,214799,0,1,1
61506,3,3,214801,214801,214804,0,3,2
61507,3,3,214804,214804,214807,0,3,0
61508,4,2,214808,214808,214810,0,2,1
61509,4,3,214812,214812,214815,0,3,2
61510,5,1,214817,214817,214818,0,1,2
61511,6,2,214823,214823,214825,0,2,5
61512,6,2,214829,214829,214831,0,2,4
61513,3,2,214832,214832,214834,0,2,1
61514,4,3,214836,214836,214839,0,3,2
61515,5,2,214841,214841,214843,0,2,2
61516,2,2,214843,214843,214845,0,2,0
61517,1,3,214844,214845,214848,1,4,0
61518,4,1,214848,214848,214849,0,1,0
61519,2,2,214850,214850,214852,0,2,1
61520,3,3,214853,214853,214856,0,3,1
61521,3,1,214856,214856,214857,0,1,0
61522,1,3,214857,214857,214860,0,3,0
61523,1,3,214858,214860,214863,2,5,0
61524,6,3,214864,214864,214867,0,3,1
61525,3,3,214867,214867,214870,0,3,0
61526,5,3,214872,214872,214875,0,3,2
61527,1,3,214873,214875,214878,2,5,0
61528,1,1,214874,214878,214879,4,5,0
61529,6,1,214880,214880,214881,0,1,1
61530,4,1,214884,214884,214885,0,1,3
61531,5,3,214889,214889,214892,0,3,4
61532,3,3,214892,214892,214895,0,3,0
61533,4,2,214896,214896,214898,0,2,1
61534,2,2,214898,214898,214900,0,2,0
61535,2,2,214900,214900,214902,0,2,0
61536,5,1,214905,214905,214906,0,1,3
61537,1,3,214906,214906,214909,0,3,0
61538,5,1,214911,214911,214912,0,1,2
61539,3,1,214914,214914,214915,0,1,2
61540,4,2,214918,214918,214920,0,2,3
61541,2,1,214920,214920,214921,0,1,0
61542,4,1,214924,214924,214925,0,1,3
61543,3,2,214927,214927,214929,0,2,2
61544,3,3,214930,214930,214933,0,3,1
61545,5,3,214935,214935,214938,0,3,2
61546,2,1,214937,214938,214939,1,2,0
61547,6,1,214943,214943,214944,0,1,4
61548,3,1,214946,214946,214947,0,1,2
61549,5,2,214951,214951,214953,0,2,4
61550,1,2,214952,214953,214955,1,3,0
61551,5,3,214957,214957,214960,0,3,2
61552,1,3,214958,214960,214963,2,5,0
61553,6,3,214964,214964,214967,0,3,1
61554,6,1,214970,214970,214971,0,1,3
61555,4,3,214974,214974,214977,0,3,3
61556,2,3,214976,214977,214980,1,4,0
61557,3,3,214979,214980,214983,1,4,0
61558,5,1,214984,214984,214985,0,1,1
61559,4,3,214988,214988,214991,0,3,3
61560,3,3,214991,214991,214994,0,3,0
61561,1,3,214992,214994,214997,2,5,0
61562,5,1,214997,214997,214998,0,1,0
61563,2,2,214999,214999,215001,0,2,1
61564,1,2,215000,215001,215003,1,3,0
61565,3,3,215003,215003,215006,0,3,0
61566,4,1,215007,215007,215008,0,1,1
61567,2,3,215009,215009,215012,0,3,1
61568,6,3,215015,215015,215018,0,3,3
61569,3,2,215018,215018,215020,0,2,0
61570,5,1,215023,215023,215024,0,1,3
61571,2,1,215025,215025,215026,0,1,1
61572,5,2,215030,215030,215032,0,2,4
61573,3,2,215033,215033,215035,0,2,1
61574,4,2,215037,215037,215039,0,2,2
61575,5,3,215042,215042,215045,0,3,3
61576,6,1,215048,215048,215049,0,1,3
61577,4,2,215052,215052,215054,0,2,3
61578,6,1,215058,215058,215059,0,1,4
61579,5,1,215063,215063,215064,0,1,4
61580,2,2,215065,215065,215067,0,2,1
61581,4,3,215069,215069,215072,0,3,2
61582,3,3,215072,215072,215075,0,3,0
61583,2,2,215074,215075,215077,1,3,0
61584,3,3,215077,215077,215080,0,3,0
61585,2,1,215079,215080,215081,1,2,0
61586,4,1,215083,215083,215084,0,1,2
61587,2,3,215085,215085,215088,0,3,1
61588,4,2,215089,215089,215091,0,2,1
61589,6,2,215095,215095,215097,0,2,4
61590,5,3,215100,215100,215103,0,3,3
61591,2,1,215102,215103,215104,1,2,0
61592,5,1,215107,215107,215108,0,1,3
61593,4,3,215111,215111,215114,0,3,3
61594,3,1,215114,215114,215115,0,1,0
61595,6,3,215120,215120,215123,0,3,5
61596,6,1,215126,215126,215127,0,1,3
61597,5,3,215131,215131,215134,0,3,4
61598,2,3,215133,215134,215137,1,4,0
61599,3,2,215136,215137,215139,1,3,0
61600,4,3,215140,215140,215143,0,3,1
61601,4,2,215144,215144,215146,0,2,1
61602,2,2,215146,215146,215148,0,2,0
61603,6,3,215152,215152,215155,0,3,4
61604,1,3,215153,215155,215158,2,5,0
61605,4,2,215157,215158,215160,1,3,0
61606,3,3,215160,215160,215163,0,3,0
61607,4,1,215164,215164,215165,0,1,1
61608,5,3,215169,215169,215172,0,3,4
61609,4,3,215173,215173,215176,0,3,1
61610,5,1,215178,215178,215179,0,1,2
61611,3,3,215181,215181,215184,0,3,2
61612,2,2,215183,215184,215186,1,3,0
61613,5,1,215188,215188,215189,0,1,2
61614,6,1,215194,215194,215195,0,1,5
61615,4,2,215198,215198,215200,0,2,3
61616,1,2,215199,215200,215202,1,3,0
61617,1,2,215200,215202,215204,2,4,0
61618,6,3,215206,215206,215209,0,3,2
61619,2,1,215208,215209,215210,1,2,0
61620,2,2,215210,215210,215212,0,2,0
61621,1,1,215211,215212,215213,1,2,0
61622,5,3,215216,215216,215219,0,3,3
61623,5,3,215221,215221,215224,0,3,2
61624,6,1,215227,215227,215228,0,1,3
61625,6,3,215233,215233,215236,0,3,5
61626,2,2,215235,215236,215238,1,3,0
61627,3,3,215238,215238,215241,0,3,0
61628,6,2,215244,215244,215246,0,2,3
61629,6,2,215250,215250,215252,0,2,4
61630,6,1,215256,215256,215257,0,1,4
61631,3,2,215259,215259,215261,0,2,2
61632,1,1,215260,215261,215262,1,2,0
61633,6,2,215266,215266,215268,0,2,4
61634,3,3,215269,215269,215272,0,3,1
61635,5,1,215274,215274,215275,0,1,2
61636,6,2,215280,215280,215282,0,2,5
61637,1,3,215281,215282,215285,1,4,0
61638,1,3,215282,215285,215288,3,6,0
61639,4,1,215286,215288,215289,2,3,0
61640,5,2,215291,215291,215293,0,2,2
61641,1,2,215292,215293,215295,1,3,0
61642,3,2,215295,215295,215297,0,2,0
61643,2,2,215297,215297,215299,0,2,0
61644,6,3,215303,215303,215306,0,3,4
61645,4,2,215307,215307,215309,0,2,1
61646,2,3,215309,215309,215312,0,3,0
61647,3,3,215312,215312,215315,0,3,0
61648,6,2,215318,215318,215320,0,2,3
61649,1,1,215319,215320,215321,1,2,0
61650,2,1,215321,215321,215322,0,1,0
61651,5,3,215326,215326,215329,0,3,4
61652,1,3,215327,215329,215332,2,5,0
61653,2,1,215329,215332,215333,3,4,0
61654,1,3,215330,215333,215336,3,6,0
61655,1,1,215331,215336,215337,5,6,0
61656,3,3,215334,215337,215340,3,6,0
61657,1,1,215335,215340,215341,5,6,0
61658,3,3,215338,215341,215344,3,6,0
61659,4,3,215342,215344,215347,2,5,0
61660,2,3,215344,215347,215350,3,6,0
61661,1,1,215345,215350,215351,5,6,0
61662,5,1,215350,215351,215352,1,2,0
61663,3,1,215353,215353,215354,0,1,1
61664,2,1,215355,215355,215356,0,1,1
61665,5,2,215360,215360,215362,0,2,4
61666,4,3,215364,215364,215367,0,3,2
61667,6,2,215370,215370,215372,0,2,3
61668,5,2,215375,215375,215377,0,2,3
61669,6,3,215381,215381,215384,0,3,4
61670,2,3,215383,215384,215387,1,4,0
61671,5,2,215388,215388,215390,0,2,1
61672,5,2,215393,215393,215395,0,2,3
61673,5,2,215398,215398,215400,0,2,3
61674,2,2,215400,215400,215402,0,2,0
61675,3,2,215403,215403,215405,0,2,1
61676,3,2,215406,215406,215408,0,2,1
61677,2,1,215408,215408,215409,0,1,0
61678,1,1,215409,215409,215410,0,1,0
61679,4,3,215413,215413,215416,0,3,3
61680,1,2,215414,215416,215418,2,4,0
61681,1,3,215415,215418,215421,3,6,0
61682,6,2,215421,215421,215423,0,2,0
61683,5,2,215426,215426,215428,0,2,3
61684,4,1,215430,215430,215431,0,1,2
61685,5,3,215435,215435,215438,0,3,4
61686,1,1,215436,215438,215439,2,3,0
61687,5,2,215441,215441,215443,0,2,2
61688,1,2,215442,215443,215445,1,3,0
61689,5,1,215447,215447,215448,0,1,2
61690,3,3,215450,215450,215453,0,3,2
61691,2,2,215452,215453,215455,1,3,0
61692,2,2,215454,215455,215457,1,3,0
61693,1,2,215455,215457,215459,2,4,0
61694,2,3,215457,215459,215462,2,5,0
61695,3,1,215460,215462,215463,2,3,0
61696,6,2,215466,215466,215468,0,2,3
61697,2,1,215468,215468,215469,0,1,0
61698,2,3,215470,215470,215473,0,3,1
61699,1,1,215471,215473,215474,2,3,0
61700,5,2,215476,215476,215478,0,2,2
61701,3,3,215479,215479,215482,0,3,1
61702,1,2,215480,215482,215484,2,4,0
61703,6,2,215486,215486,215488,0,2,2
61704,1,2,215487,215488,215490,1,3,0
61705,6,3,215493,215493,215496,0,3,3
61706,5,2,215498,215498,215500,0,2,2
61707,6,1,215504,215504,215505,0,1,4
61708,6,3,215510,215510,215513,0,3,5
61709,6,3,215516,215516,215519,0,3,3
61710,4,2,215520,215520,215522,0,2,1
61711,3,3,215523,215523,215526,0,3,1
61712,6,2,215529,215529,215531,0,2,3
61713,4,2,215533,215533,215535,0,2,2
61714,6,3,215539,215539,215542,0,3,4
61715,6,1,215545,215545,215546,0,1,3
61716,5,3,215550,215550,215553,0,3,4
61717,1,1,215551,215553,215554,2,3,0
61718,2,3,215553,215554,215557,1,4,0
61719,6,1,215559,215559,215560,0,1,2
61720,5,1,215564,215564,215565,0,1,4
61721,2,3,215566,215566,215569,0,3,1
61722,5,3,215571,215571,215574,0,3,2
61723,1,3,215572,215574,215577,2,5,0
61724,5,1,215577,215577,215578,0,1,0
61725,3,3,215580,215580,215583,0,3,2
61726,2,2,215582,215583,215585,1,3,0
61727,5,2,215587,215587,215589,0,2,2
61728,1,2,215588,215589,215591,1,3,0
61729,3,3,215591,215591,215594,0,3,0
61730,1,3,215592,215594,215597,2,5,0
61731,3,3,215595,215597,215600,2,5,0
61732,4,2,215599,215600,215602,1,3,0
61733,6,2,215605,215605,215607,0,2,3
61734,1,2,215606,215607,215609,1,3,0
61735,3,1,215609,215609,215610,0,1,0
61736,1,2,215610,215610,215612,0,2,0
61737,6,2,215616,215616,215618,0,2,4
61738,5,2,215621,215621,215623,0,2,3
61739,2,3,215623,215623,215626,0,3,0
61740,1,1,215624,215626,215627,2,3,0
61741,1,2,215625,215627,215629,2,4,0
61742,2,3,215627,215629,215632,2,5,0
61743,1,2,215628,215632,215634,4,6,0
61744,2,2,215630,215634,215636,4,6,0
61745,1,2,215631,215636,215638,5,7,0
61746,6,3,215637,215638,215641,1,4,0
61747,1,1,215638,215641,215642,3,4,0
61748,5,1,215643,215643,215644,0,1,1
61749,3,2,215646,215646,215648,0,2,2
61750,2,2,215648,215648,215650,0,2,0
61751,6,3,215654,215654,215657,0,3,4
61752,6,1,215660,215660,215661,0,1,3
61753,2,1,215662,215662,215663,0,1,1
61754,4,3,215666,215666,215669,0,3,3
61755,6,2,215672,215672,215674,0,2,3
61756,3,3,215675,215675,215678,0,3,1
61757,3,1,215678,215678,215679,0,1,0
61758,3,2,215681,215681,215683,0,2,2
61759,2,3,215683,215683,215686,0,3,0
61760,5,2,215688,215688,215690,0,2,2
61761,1,2,215689,215690,215692,1,3,0
61762,1,1,215690,215692,215693,2,3,0
61763,1,3,215691,215693,215696,2,5,0
61764,1,3,215692,215696,215699,4,7,0
61765,4,2,215696,215699,215701,3,5,0
61766,6,3,215702,215702,215705,0,3,1
61767,5,3,215707,215707,215710,0,3,2
61768,2,1,215709,215710,215711,1,2,0
61769,1,1,215710,215711,215712,1,2,0
61770,5,3,215715,215715,215718,0,3,3
61771,1,1,215716,215718,215719,2,3,0
61772,4,3,215720,215720,215723,0,3,1
61773,3,2,215723,215723,215725,0,2,0
61774,3,1,215726,215726,215727,0,1,1
61775,5,2,215731,215731,215733,0,2,4
61776,2,1,215733,215733,215734,0,1,0
61777,5,3,215738,215738,215741,0,3,4
61778,2,1,215740,215741,215742,1,2,0
61779,4,2,215744,215744,215746,0,2,2
61780,1,3,215745,215746,215749,1,4,0
61781,3,1,215748,215749,215750,1,2,0
61782,2,2,215750,215750,215752,0,2,0
61783,3,1,215753,215753,215754,0,1,1
61784,5,3,215758,215758,215761,0,3,4
61785,5,3,215763,215763,215766,0,3,2
61786,6,1,215769,215769,215770,0,1,3
61787,1,3,215770,215770,215773,0,3,0
61788,3,1,215773,215773,215774,0,1,0
61789,1,3,215774,215774,215777,0,3,0
61790,6,1,215780,215780,215781,0,1,3
61791,4,1,215784,215784,215785,0,1,3
61792,1,2,215785,215785,215787,0,2,0
61793,2,1,215787,215787,215788,0,1,0
61794,3,1,215790,215790,215791,0,1,2
61795,1,3,215791,215791,215794,0,3,0
61796,4,2,215795,215795,215797,0,2,1
61797,5,1,215800,215800,215801,0,1,3
61798,4,2,215804,215804,215806,0,2,3
61799,6,3,215810,215810,215813,0,3,4
61800,5,2,215815,215815,215817,0,2,2
61801,4,2,215819,215819,215821,0,2,2
61802,6,1,215825,215825,215826,0,1,4
61803,1,1,215826,215826,215827,0,1,0
61804,3,3,215829,215829,215832,0,3,2
61805,1,2,215830,215832,215834,2,4,0
61806,4,2,215834,215834,215836,0,2,0
61807,3,2,215837,215837,215839,0,2,1
61808,4,2,215841,215841,215843,0,2,2
61809,3,3,215844,215844,215847,0,3,1
61810,3,1,215847,215847,215848,0,1,0
61811,5,1,215852,215852,215853,0,1,4
61812,1,2,215853,215853,215855,0,2,0
61813,6,3,215859,215859,215862,0,3,4
61814,2,3,215861,215862,215865,1,4,0
61815,3,2,215864,215865,215867,1,3,0
61816,1,2,215865,215867,215869,2,4,0
61817,6,1,215871,215871,215872,0,1,2
61818,6,3,215877,215877,215880,0,3,5
61819,1,3,215878,215880,215883,2,5,0
61820,3,3,215881,215883,215886,2,5,0
61821,5,2,215886,215886,215888,0,2,0
61822,3,1,215889,215889,215890,0,1,1
61823,4,2,215893,215893,215895,0,2,3
61824,3,2,215896,215896,215898,0,2,1
61825,5,2,215901,215901,215903,0,2,3
61826,6,1,215907,215907,215908,0,1,4
61827,1,3,215908,215908,215911,0,3,0
61828,4,3,215912,215912,215915,0,3,1
61829,5,3,215917,215917,215920,0,3,2
61830,4,3,215921,215921,215924,0,3,1
61831,5,1,215926,215926,215927,0,1,2
61832,1,2,215927,215927,215929,0,2,0
61833,5,1,215932,215932,215933,0,1,3
61834,6,3,215938,215938,215941,0,3,5
61835,4,1,215942,215942,215943,0,1,1
61836,3,2,215945,215945,215947,0,2,2
61837,3,1,215948,215948,215949,0,1,1
61838,6,1,215954,215954,215955,0,1,5
61839,2,3,215956,215956,215959,0,3,1
61840,2,1,215958,215959,215960,1,2,0
61841,3,2,215961,215961,215963,0,2,1
61842,6,3,215967,215967,215970,0,3,4
61843,3,2,215970,215970,215972,0,2,0
61844,3,3,215973,215973,215976,0,3,1
61845,3,1,215976,215976,215977,0,1,0
61846,1,3,215977,215977,215980,0,3,0
61847,3,3,215980,215980,215983,0,3,0
61848,6,1,215986,215986,215987,0,1,3
61849,6,3,215992,215992,215995,0,3,5
61850,1,2,215993,215995,215997,2,4,0
61851,4,1,215997,215997,215998,0,1,0
61852,5,3,216002,216002,216005,0,3,4
61853,4,1,216006,216006,216007,0,1,1
61854,2,3,216008,216008,216011,0,3,1
61855,6,3,216014,216014,216017,0,3,3
61856,4,3,216018,216018,216021,0,3,1
61857,2,1,216020,216021,216022,1,2,0
61858,6,3,216026,216026,216029,0,3,4
61859,1,1,216027,216029,216030,2,3,0
61860,6,1,216033,216033,216034,0,1,3
61861,6,2,216039,216039,216041,0,2,5
61862,5,1,216044,216044,216045,0,1,3
61863,5,1,216049,216049,216050,0,1,4
61864,6,2,216055,216055,216057,0,2,5
61865,2,2,216057,216057,216059,0,2,0
61866,3,3,216060,216060,216063,0,3,1
61867,3,3,216063,216063,216066,0,3,0
61868,5,2,216068,216068,216070,0,2,2
61869,3,2,216071,216071,216073,0,2,1
61870,4,2,216075,216075,216077,0,2,2
61871,4,1,216079,216079,216080,0,1,2
61872,3,2,216082,216082,216084,0,2,2
61873,5,3,216087,216087,216090,0,3,3
61874,4,2,216091,216091,216093,0,2,1
61875,1,1,216092,216093,216094,1,2,0
61876,1,1,216093,216094,216095,1,2,0
61877,1,1,216094,216095,216096,1,2,0
61878,5,3,216099,216099,216102,0,3,3
61879,4,3,216103,216103,216106,0,3,1
61880,1,2,216104,216106,216108,2,4,0
61881,3,2,216107,216108,216110,1,3,0
61882,6,2,216113,216113,216115,0,2,3
61883,2,3,216115,216115,216118,0,3,0
61884,2,3,216117,216118,216121,1,4,0
61885,2,1,216119,216121,216122,2,3,0
61886,3,1,216122,216122,216123,0,1,0
61887,3,2,216125,216125,216127,0,2,2
61888,2,1,216127,216127,216128,0,1,0
61889,6,1,216133,216133,216134,0,1,5
61890,3,1,216136,216136,216137,0,1,2
61891,2,3,216138,216138,216141,0,3,1
61892,4,2,216142,216142,216144,0,2,1
61893,4,3,216146,216146,216149,0,3,2
61894,5,2,216151,216151,216153,0,2,2
61895,6,2,216157,216157,216159,0,2,4
61896,2,1,216159,216159,216160,0,1,0
61897,5,2,216164,216164,216166,0,2,4
61898,3,2,216167,216167,216169,0,2,1
61899,5,3,216172,216172,216175,0,3,3
61900,2,1,216174,216175,216176,1,2,0
61901,4,3,216178,216178,216181,0,3,2
61902,3,2,216181,216181,216183,0,2,0
61903,5,3,216186,216186,216189,0,3,3
61904,1,2,216187,216189,216191,2,4,0
61905,3,3,216190,216191,216194,1,4,0
61906,2,3,216192,216194,216197,2,5,0
61907,1,1,216193,216197,216198,4,5,0
61908,1,2,216194,216198,216200,4,6,0
61909,2,3,216196,216200,216203,4,7,0
61910,6,1,216202,216203,216204,1,2,0
61911,6,3,216208,216208,216211,0,3,4
61912,1,1,216209,216211,216212,2,3,0
61913,2,1,216211,216212,216213,1,2,0
61914,5,2,216216,216216,216218,0,2,3
61915,2,2,216218,216218,216220,0,2,0
61916,4,3,216222,216222,216225,0,3,2
61917,5,3,216227,216227,216230,0,3,2
61918,2,2,216229,216230,216232,1,3,0
61919,2,1,216231,216232,216233,1,2,0
61920,5,1,216236,216236,216237,0,1,3
61921,4,2,216240,216240,216242,0,2,3
61922,4,1,216244,216244,216245,0,1,2
61923,6,2,216250,216250,216252,0,2,5
61924,2,1,216252,216252,216253,0,1,0
61925,3,1,216255,216255,216256,0,1,2
61926,3,1,216258,216258,216259,0,1,2
61927,3,2,216261,216261,216263,0,2,2
61928,2,3,216263,216263,216266,0,3,0
61929,6,2,216269,216269,216271,0,2,3
61930,4,2,216273,216273,216275,0,2,2
61931,5,1,216278,216278,216279,0,1,3
61932,3,1,216281,216281,216282,0,1,2
61933,2,1,216283,216283,216284,0,1,1
61934,4,2,216287,216287,216289,0,2,3
61935,3,1,216290,216290,216291,0,1,1
61936,4,2,216294,216294,216296,0,2,3
61937,6,1,216300,216300,216301,0,1,4
61938,1,1,216301,216301,216302,0,1,0
61939,5,3,216306,216306,216309,0,3,4
61940,1,2,216307,216309,216311,2,4,0
61941,5,1,216312,216312,216313,0,1,1
61942,1,1,216313,216313,216314,0,1,0
61943,2,1,216315,216315,216316,0,1,1
61944,3,1,216318,216318,216319,0,1,2
61945,5,1,216323,216323,216324,0,1,4
61946,1,2,216324,216324,216326,0,2,0
61947,4,1,216328,216328,216329,0,1,2
61948,4,2,216332,216332,216334,0,2,3
61949,5,1,216337,216337,216338,0,1,3
61950,5,2,216342,216342,216344,0,2,4
61951,2,3,216344,216344,216347,0,3,0
61952,6,2,216350,216350,216352,0,2,3
61953,1,1,216351,216352,216353,1,2,0
61954,6,3,216357,216357,216360,0,3,4
61955,3,3,216360,216360,216363,0,3,0
61956,5,2,216365,216365,216367,0,2,2
61957,4,3,216369,216369,216372,0,3,2
61958,4,1,216373,216373,216374,0,1,1
61959,2,2,216375,216375,216377,0,2,1
61960,1,3,216376,216377,216380,1,4,0
61961,5,1,216381,216381,216382,0,1,1
61962,4,1,216385,216385,216386,0,1,3
61963,5,3,216390,216390,216393,0,3,4
61964,5,1,216395,216395,216396,0,1,2
61965,6,2,216401,216401,216403,0,2,5
61966,1,1,216402,216403,216404,1,2,0
61967,6,2,216408,216408,216410,0,2,4
61968,6,3,216414,216414,216417,0,3,4
61969,2,3,216416,216417,216420,1,4,0
61970,1,1,216417,216420,216421,3,4,0
61971,5,2,216422,216422,216424,0,2,1
61972,1,1,216423,216424,216425,1,2,0
61973,2,1,216425,216425,216426,0,1,0
61974,5,3,216430,216430,216433,0,3,4
61975,5,1,216435,216435,216436,0,1,2
61976,2,2,216437,216437,216439,0,2,1
61977,4,2,216441,216441,216443,0,2,2
61978,2,3,216443,216443,216446,0,3,0
61979,4,2,216447,216447,216449,0,2,1
61980,4,2,216451,216451,216453,0,2,2
61981,1,1,216452,216453,216454,1,2,0
61982,2,2,216454,216454,216456,0,2,0
61983,6,2,216460,216460,216462,0,2,4
61984,5,3,216465,216465,216468,0,3,3
61985,4,1,216469,216469,216470,0,1,1
61986,2,3,216471,216471,216474,0,3,1
61987,6,1,216477,216477,216478,0,1,3
61988,5,2,216482,216482,216484,0,2,4
61989,5,3,216487,216487,216490,0,3,3
61990,5,3,216492,216492,216495,0,3,2
61991,5,2,216497,216497,216499,0,2,2
61992,1,2,216498,216499,216501,1,3,0
61993,1,1,216499,216501,216502,2,3,0
61994,4,2,216503,216503,216505,0,2,1
61995,6,1,216509,216509,216510,0,1,4
61996,4,1,216513,216513,216514,0,1,3
61997,4,3,216517,216517,216520,0,3,3
61998,1,2,216518,216520,216522,2,4,0
61999,4,2,216522,216522,216524,0,2,0
62000,2,2,216524,216524,216526,0,2,0
62001,5,3,216529,216529,216532,0,3,3
62002,1,2,216530,216532,216534,2,4,0
62003,1,3,216531,216534,216537,3,6,0
62004,6,2,216537,216537,216539,0,2,0
62005,3,3,216540,216540,216543,0,3,1
62006,4,1,216544,216544,216545,0,1,1
62007,1,1,216545,216545,216546,0,1,0
62008,6,3,216551,216551,216554,0,3,5
62009,3,2,216554,216554,216556,0,2,0
62010,3,1,216557,216557,216558,0,1,1
62011,6,1,216563,216563,216564,0,1,5
62012,1,1,216564,216564,216565,0,1,0
62013,6,3,216570,216570,216573,0,3,5
62014,4,3,216574,216574,216577,0,3,1
62015,5,1,216579,216579,216580,0,1,2
62016,2,1,216581,216581,216582,0,1,1
62017,5,1,216586,216586,216587,0,1,4
62018,5,1,216591,216591,216592,0,1,4
62019,4,3,216595,216595,216598,0,3,3
62020,3,1,216598,216598,216599,0,1,0
62021,1,2,216599,216599,216601,0,2,0
62022,4,1,216603,216603,216604,0,1,2
62023,2,1,216605,216605,216606,0,1,1
62024,4,1,216609,216609,216610,0,1,3
62025,5,1,216614,216614,216615,0,1,4
62026,3,1,216617,216617,216618,0,1,2
62027,5,1,216622,216622,216623,0,1,4
62028,4,1,216626,216626,216627,0,1,3
62029,1,3,216627,216627,216630,0,3,0
62030,4,2,216631,216631,216633,0,2,1
62031,2,2,216633,216633,216635,0,2,0
62032,1,2,216634,216635,216637,1,3,0
62033,1,3,216635,216637,216640,2,5,0
62034,3,1,216638,216640,216641,2,3,0
62035,2,2,216640,216641,216643,1,3,0
62036,1,3,216641,216643,216646,2,5,0
62037,3,1,216644,216646,216647,2,3,0
62038,4,1,216648,216648,216649,0,1,1
62039,4,2,216652,216652,216654,0,2,3
62040,3,1,216655,216655,216656,0,1,1
62041,4,1,216659,216659,216660,0,1,3
62042,1,3,216660,216660,216663,0,3,0
62043,5,2,216665,216665,216667,0,2,2
62044,6,3,216671,216671,216674,0,3,4
62045,4,2,216675,216675,216677,0,2,1
62046,4,1,216679,216679,216680,0,1,2
62047,5,1,216684,216684,216685,0,1,4
62048,1,3,216685,216685,216688,0,3,0
62049,2,2,216687,216688,216690,1,3,0
62050,3,2,216690,216690,216692,0,2,0
62051,5,3,216695,216695,216698,0,3,3
62052,5,3,216700,216700,216703,0,3,2
62053,3,1,216703,216703,216704,0,1,0
62054,2,2,216705,216705,216707,0,2,1
62055,3,2,216708,216708,216710,0,2,1
62056,6,3,216714,216714,216717,0,3,4
62057,4,1,216718,216718,216719,0,1,1
62058,1,1,216719,216719,216720,0,1,0
62059,4,2,216723,216723,216725,0,2,3
62060,1,2,216724,216725,216727,1,3,0
62061,3,3,216727,216727,216730,0,3,0
62062,3,3,216730,216730,216733,0,3,0
62063,2,3,216732,216733,216736,1,4,0
62064,2,1,216734,216736,216737,2,3,0
62065,2,2,216736,216737,216739,1,3,0
62066,3,1,216739,216739,216740,0,1,0
62067,2,2,216741,216741,216743,0,2,1
62068,1,1,216742,216743,216744,1,2,0
62069,4,3,216746,216746,216749,0,3,2
62070,3,2,216749,216749,216751,0,2,0
62071,2,3,216751,216751,216754,0,3,0
62072,1,3,216752,216754,216757,2,5,0
62073,2,2,216754,216757,216759,3,5,0
62074,3,3,216757,216759,216762,2,5,0
62075,2,3,216759,216762,216765,3,6,0
62076,3,1,216762,216765,216766,3,4,0
62077,3,3,216765,216766,216769,1,4,0
62078,5,3,216770,216770,216773,0,3,1
62079,1,1,216771,216773,216774,2,3,0
62080,6,2,216777,216777,216779,0,2,3
62081,6,2,216783,216783,216785,0,2,4
62082,6,3,216789,216789,216792,0,3,4
62083,1,3,216790,216792,216795,2,5,0
62084,2,2,216792,216795,216797,3,5,0
62085,4,2,216796,216797,216799,1,3,0
62086,5,2,216801,216801,216803,0,2,2
62087,2,1,216803,216803,216804,0,1,0
62088,2,2,216805,216805,216807,0,2,1
62089,4,2,216809,216809,216811,0,2,2
62090,1,1,216810,216811,216812,1,2,0
62091,3,2,216813,216813,216815,0,2,1
62092,4,3,216817,216817,216820,0,3,2
62093,5,2,216822,216822,216824,0,2,2
62094,3,2,216825,216825,216827,0,2,1
62095,6,2,216831,216831,216833,0,2,4
62096,4,1,216835,216835,216836,0,1,2
62097,6,1,216841,216841,216842,0,1,5
62098,5,3,216846,216846,216849,0,3,4
62099,2,2,216848,216849,216851,1,3,0
62100,1,3,216849,216851,216854,2,5,0
62101,4,2,216853,216854,216856,1,3,0
62102,5,3,216858,216858,216861,0,3,2
62103,1,3,216859,216861,216864,2,5,0
62104,2,2,216861,216864,216866,3,5,0
62105,2,1,216863,216866,216867,3,4,0
62106,4,1,216867,216867,216868,0,1,0
62107,1,2,216868,216868,216870,0,2,0
62108,1,2,216869,216870,216872,1,3,0
62109,1,3,216870,216872,216875,2,5,0
62110,6,3,216876,216876,216879,0,3,1
62111,6,3,216882,216882,216885,0,3,3
62112,6,3,216888,216888,216891,0,3,3
62113,3,3,216891,216891,216894,0,3,0
62114,3,3,216894,216894,216897,0,3,0
62115,4,1,216898,216898,216899,0,1,1
62116,5,2,216903,216903,216905,0,2,4
62117,5,1,216908,216908,216909,0,1,3
62118,2,2,216910,216910,216912,0,2,1
62119,2,2,216912,216912,216914,0,2,0
62120,3,3,216915,216915,216918,0,3,1
62121,5,2,216920,216920,216922,0,2,2
62122,3,1,216923,216923,216924,0,1,1
62123,6,1,216929,216929,216930,0,1,5
62124,3,3,216932,216932,216935,0,3,2
62125,4,1,216936,216936,216937,0,1,1
62126,3,3,216939,216939,216942,0,3,2
62127,4,2,216943,216943,216945,0,2,1
62128,3,2,216946,216946,216948,0,2,1
62129,1,2,216947,216948,216950,1,3,0
62130,2,2,216949,216950,216952,1,3,0
62131,3,2,216952,216952,216954,0,2,0
62132,4,3,216956,216956,216959,0,3,2
62133,5,1,216961,216961,216962,0,1,2
62134,3,3,216964,216964,216967,0,3,2
62135,3,3,216967,216967,216970,0,3,0
62136,5,1,216972,216972,216973,0,1,2
62137,3,1,216975,216975,216976,0,1,2
62138,6,2,216981,216981,216983,0,2,5
62139,5,3,216986,216986,216989,0,3,3
62140,3,1,216989,216989,216990,0,1,0
62141,5,3,216994,216994,216997,0,3,4
62142,5,3,216999,216999,217002,0,3,2
62143,1,2,217000,217002,217004,2,4,0
62144,1,3,217001,217004,217007,3,6,0
62145,1,2,217002,217007,217009,5,7,0
62146,5,3,217007,217009,217012,2,5,0
62147,4,2,217011,217012,217014,1,3,0
62148,6,2,217017,217017,217019,0,2,3
62149,3,3,217020,217020,217023,0,3,1
62150,5,2,217025,217025,217027,0,2,2
62151,1,1,217026,217027,217028,1,2,0
62152,2,3,217028,217028,217031,0,3,0
62153,5,3,217033,217033,217036,0,3,2
62154,2,1,217035,217036,217037,1,2,0
62155,2,1,217037,217037,217038,0,1,0
62156,3,1,217040,217040,217041,0,1,2
62157,1,1,217041,217041,217042,0,1,0
62158,4,1,217045,217045,217046,0,1,3
62159,1,2,217046,217046,217048,0,2,0
62160,2,3,217048,217048,217051,0,3,0
62161,5,3,217053,217053,217056,0,3,2
62162,5,3,217058,217058,217061,0,3,2
62163,3,3,217061,217061,217064,0,3,0
62164,1,1,217062,217064,217065,2,3,0
62165,4,2,217066,217066,217068,0,2,1
62166,6,1,217072,217072,217073,0,1,4
62167,3,2,217075,217075,217077,0,2,2
62168,3,1,217078,217078,217079,0,1,1
62169,5,3,217083,217083,217086,0,3,4
62170,5,2,217088,217088,217090,0,2,2
62171,4,1,217092,217092,217093,0,1,2
62172,2,1,217094,217094,217095,0,1,1
62173,4,3,217098,217098,217101,0,3,3
62174,1,3,217099,217101,217104,2,5,0
62175,6,1,217105,217105,217106,0,1,1
62176,2,1,217107,217107,217108,0,1,1
62177,3,3,217110,217110,217113,0,3,2
62178,2,2,217112,217113,217115,1,3,0
62179,6,2,217118,217118,217120,0,2,3
62180,3,2,217121,217121,217123,0,2,1
62181,3,3,217124,217124,217127,0,3,1
62182,1,1,217125,217127,217128,2,3,0
62183,5,3,217130,217130,217133,0,3,2
62184,2,2,217132,217133,217135,1,3,0
62185,3,2,217135,217135,217137,0,2,0
62186,1,1,217136,217137,217138,1,2,0
62187,1,1,217137,217138,217139,1,2,0
62188,3,2,217140,217140,217142,0,2,1
62189,5,3,217145,217145,217148,0,3,3
62190,2,2,217147,217148,217150,1,3,0
62191,5,1,217152,217152,217153,0,1,2
62192,4,1,217156,217156,217157,0,1,3
62193,2,2,217158,217158,217160,0,2,1
62194,3,2,217161,217161,217163,0,2,1
62195,4,1,217165,217165,217166,0,1,2
62196,1,2,217166,217166,217168,0,2,0
62197,2,2,217168,217168,217170,0,2,0
62198,5,1,217173,217173,217174,0,1,3
62199,6,1,217179,217179,217180,0,1,5
62200,1,3,217180,217180,217183,0,3,0
62201,6,2,217186,217186,217188,0,2,3
62202,3,2,217189,217189,217191,0,2,1
62203,1,3,217190,217191,217194,1,4,0
62204,3,1,217193,217194,217195,1,2,0
62205,6,3,217199,217199,217202,0,3,4
62206,5,3,217204,217204,217207,0,3,2
62207,6,3,217210,217210,217213,0,3,3
62208,1,3,217211,217213,217216,2,5,0
62209,1,3,217212,217216,217219,4,7,0
62210,4,1,217216,217219,217220,3,4,0
62211,4,2,217220,217220,217222,0,2,0
62212,6,3,217226,217226,217229,0,3,4
62213,3,3,217229,217229,217232,0,3,0
62214,5,3,217234,217234,217237,0,3,2
62215,4,2,217238,217238,217240,0,2,1
62216,1,1,217239,217240,217241,1,2,0
62217,1,2,217240,217241,217243,1,3,0
62218,5,1,217245,217245,217246,0,1,2
62219,5,2,217250,217250,217252,0,2,4
62220,3,2,217253,217253,217255,0,2,1
62221,5,3,217258,217258,217261,0,3,3
62222,3,2,217261,217261,217263,0,2,0
62223,4,2,217265,217265,217267,0,2,2
62224,6,1,217271,217271,217272,0,1,4
62225,6,2,217277,217277,217279,0,2,5
62226,6,3,217283,217283,217286,0,3,4
62227,6,2,217289,217289,217291,0,2,3
62228,6,3,217295,217295,217298,0,3,4
62229,4,3,217299,217299,217302,0,3,1
62230,5,3,217304,217304,217307,0,3,2
62231,6,3,217310,217310,217313,0,3,3
62232,6,3,217316,217316,217319,0,3,3
62233,3,3,217319,217319,217322,0,3,0
62234,5,3,217324,217324,217327,0,3,2
62235,1,2,217325,217327,217329,2,4,0
62236,5,1,217330,217330,217331,0,1,1
62237,3,2,217333,217333,217335,0,2,2
62238,4,1,217337,217337,217338,0,1,2
62239,5,2,217342,217342,217344,0,2,4
62240,5,3,217347,217347,217350,0,3,3
62241,2,2,217349,217350,217352,1,3,0
62242,6,1,217355,217355,217356,0,1,3
62243,6,2,217361,217361,217363,0,2,5
62244,5,1,217366,217366,217367,0,1,3
62245,2,2,217368,217368,217370,0,2,1
62246,2,1,217370,217370,217371,0,1,0
62247,4,2,217374,217374,217376,0,2,3
62248,3,3,217377,217377,217380,0,3,1
62249,1,2,217378,217380,217382,2,4,0
62250,2,2,217380,217382,217384,2,4,0
62251,5,2,217385,217385,217387,0,2,1
62252,2,1,217387,217387,217388,0,1,0
62253,6,1,217393,217393,217394,0,1,5
62254,5,2,217398,217398,217400,0,2,4
62255,1,1,217399,217400,217401,1,2,0
62256,2,1,217401,217401,217402,0,1,0
62257,1,1,217402,217402,217403,0,1,0
62258,2,1,217404,217404,217405,0,1,1
62259,5,1,217409,217409,217410,0,1,4
62260,1,3,217410,217410,217413,0,3,0
62261,3,3,217413,217413,217416,0,3,0
62262,1,3,217414,217416,217419,2,5,0
62263,5,2,217419,217419,217421,0,2,0
62264,4,2,217423,217423,217425,0,2,2
62265,6,1,217429,217429,217430,0,1,4
62266,4,3,217433,217433,217436,0,3,3
62267,2,3,217435,217436,217439,1,4,0
62268,4,2,217439,217439,217441,0,2,0
62269,3,3,217442,217442,217445,0,3,1
62270,4,2,217446,217446,217448,0,2,1
62271,3,1,217449,217449,217450,0,1,1
62272,2,1,217451,217451,217452,0,1,1
62273,6,3,217457,217457,217460,0,3,5
62274,4,2,217461,217461,217463,0,2,1
62275,4,1,217465,217465,217466,0,1,2
62276,6,3,217471,217471,217474,0,3,5
62277,5,2,217476,217476,217478,0,2,2
62278,1,3,217477,217478,217481,1,4,0
62279,4,1,217481,217481,217482,0,1,0
62280,5,1,217486,217486,217487,0,1,4
62281,3,1,217489,217489,217490,0,1,2
62282,6,3,217495,217495,217498,0,3,5
62283,2,2,217497,217498,217500,1,3,0
62284,6,2,217503,217503,217505,0,2,3
62285,4,3,217507,217507,217510,0,3,2
62286,6,3,217513,217513,217516,0,3,3
62287,4,2,217517,217517,217519,0,2,1
62288,4,3,217521,217521,217524,0,3,2
62289,6,3,217527,217527,217530,0,3,3
62290,4,2,217531,217531,217533,0,2,1
62291,4,2,217535,217535,217537,0,2,2
62292,4,2,217539,217539,217541,0,2,2
62293,3,1,217542,217542,217543,0,1,1
62294,6,2,217548,217548,217550,0,2,5
62295,1,2,217549,217550,217552,1,3,0
62296,1,2,217550,217552,217554,2,4,0
62297,1,3,217551,217554,217557,3,6,0
62298,2,2,217553,217557,217559,4,6,0
62299,1,3,217554,217559,217562,5,8,0
62300,4,3,217558,217562,217565,4,7,0
62301,3,2,217561,217565,217567,4,6,0
62302,1,2,217562,217567,217569,5,7,0
62303,1,3,217563,217569,217572,6,9,0
62304,4,2,217567,217572,217574,5,7,0
62305,2,3,217569,217574,217577,5,8,0
62306,1,3,217570,217577,217580,7,10,0
62307,1,3,217571,217580,217583,9,12,0
62308,4,2,217575,217583,217585,8,10,0
62309,5,3,217580,217585,217588,5,8,0
62310,1,1,217581,217588,217589,7,8,0
62311,6,2,217587,217589,217591,2,4,0
62312,3,2,217590,217591,217593,1,3,0
62313,5,1,217595,217595,217596,0,1,2
62314,6,1,217601,217601,217602,0,1,5
62315,3,1,217604,217604,217605,0,1,2
62316,3,2,217607,217607,217609,0,2,2
62317,2,3,217609,217609,217612,0,3,0
62318,2,1,217611,217612,217613,1,2,0
62319,6,3,217617,217617,217620,0,3,4
62320,5,1,217622,217622,217623,0,1,2
62321,5,3,217627,217627,217630,0,3,4
62322,5,1,217632,217632,217633,0,1,2
62323,2,1,217634,217634,217635,0,1,1
62324,1,3,217635,217635,217638,0,3,0
62325,6,1,217641,217641,217642,0,1,3
62326,4,3,217645,217645,217648,0,3,3
62327,1,1,217646,217648,217649,2,3,0
62328,6,2,217652,217652,217654,0,2,3
62329,5,3,217657,217657,217660,0,3,3
62330,4,1,217661,217661,217662,0,1,1
62331,4,1,217665,217665,217666,0,1,3
62332,3,2,217668,217668,217670,0,2,2
62333,4,2,217672,217672,217674,0,2,2
62334,1,1,217673,217674,217675,1,2,0
62335,3,1,217676,217676,217677,0,1,1
62336,1,3,217677,217677,217680,0,3,0
62337,1,1,217678,217680,217681,2,3,0
62338,2,2,217680,217681,217683,1,3,0
62339,4,3,217684,217684,217687,0,3,1
62340,1,3,217685,217687,217690,2,5,0
62341,2,1,217687,217690,217691,3,4,0
62342,1,3,217688,217691,217694,3,6,0
62343,2,2,217690,217694,217696,4,6,0
62344,1,2,217691,217696,217698,5,7,0
62345,3,3,217694,217698,217701,4,7,0
62346,5,1,217699,217701,217702,2,3,0
62347,5,3,217704,217704,217707,0,3,2
62348,2,2,217706,217707,217709,1,3,0
62349,3,3,217709,217709,217712,0,3,0
62350,5,1,217714,217714,217715,0,1,2
62351,1,3,217715,217715,217718,0,3,0
62352,3,2,217718,217718,217720,0,2,0
62353,2,2,217720,217720,217722,0,2,0
62354,5,1,217725,217725,217726,0,1,3
62355,2,3,217727,217727,217730,0,3,1
62356,3,2,217730,217730,217732,0,2,0
62357,2,2,217732,217732,217734,0,2,0
62358,4,1,217736,217736,217737,0,1,2
62359,5,3,217741,217741,217744,0,3,4
62360,3,1,217744,217744,217745,0,1,0
62361,1,3,217745,217745,217748,0,3,0
62362,3,2,217748,217748,217750,0,2,0
62363,2,2,217750,217750,217752,0,2,0
62364,5,2,217755,217755,217757,0,2,3
62365,4,2,217759,217759,217761,0,2,2
62366,4,3,217763,217763,217766,0,3,2
62367,1,3,217764,217766,217769,2,5,0
62368,1,2,217765,217769,217771,4,6,0
62369,6,1,217771,217771,217772,0,1,0
62370,4,2,217775,217775,217777,0,2,3
62371,2,3,217777,217777,217780,0,3,0
62372,3,1,217780,217780,217781,0,1,0
62373,5,1,217785,217785,217786,0,1,4
62374,5,2,217790,217790,217792,0,2,4
62375,1,1,217791,217792,217793,1,2,0
62376,4,3,217795,217795,217798,0,3,2
62377,5,3,217800,217800,217803,0,3,2
62378,6,3,217806,217806,217809,0,3,3
62379,3,1,217809,217809,217810,0,1,0
62380,4,3,217813,217813,217816,0,3,3
62381,6,1,217819,217819,217820,0,1,3
62382,4,3,217823,217823,217826,0,3,3
62383,2,3,217825,217826,217829,1,4,0
62384,1,3,217826,217829,217832,3,6,0
62385,6,3,217832,217832,217835,0,3,0
62386,3,1,217835,217835,217836,0,1,0
62387,1,3,217836,217836,217839,0,3,0
62388,3,3,217839,217839,217842,0,3,0
62389,3,2,217842,217842,217844,0,2,0
62390,2,1,217844,217844,217845,0,1,0
62391,3,3,217847,217847,217850,0,3,2
62392,2,3,217849,217850,217853,1,4,0
62393,4,3,217853,217853,217856,0,3,0
62394,5,3,217858,217858,217861,0,3,2
62395,3,3,217861,217861,217864,0,3,0
62396,6,1,217867,217867,217868,0,1,3
62397,1,3,217868,217868,217871,0,3,0
62398,5,3,217873,217873,217876,0,3,2
62399,6,1,217879,217879,217880,0,1,3
62400,1,2,217880,217880,217882,0,2,0
62401,1,2,217881,217882,217884,1,3,0
62402,2,1,217883,217884,217885,1,2,0
62403,1,1,217884,217885,217886,1,2,0
62404,2,1,217886,217886,217887,0,1,0
62405,5,2,217891,217891,217893,0,2,4
62406,3,3,217894,217894,217897,0,3,1
62407,5,1,217899,217899,217900,0,1,2
62408,5,3,217904,217904,217907,0,3,4
62409,5,2,217909,217909,217911,0,2,2
62410,2,3,217911,217911,217914,0,3,0
62411,2,1,217913,217914,217915,1,2,0
62412,2,1,217915,217915,217916,0,1,0
62413,4,2,217919,217919,217921,0,2,3
62414,1,3,217920,217921,217924,1,4,0
62415,1,2,217921,217924,217926,3,5,0
62416,5,2,217926,217926,217928,0,2,0
62417,6,1,217932,217932,217933,0,1,4
62418,4,2,217936,217936,217938,0,2,3
62419,4,1,217940,217940,217941,0,1,2
62420,6,3,217946,217946,217949,0,3,5
62421,3,3,217949,217949,217952,0,3,0
62422,4,3,217953,217953,217956,0,3,1
62423,1,1,217954,217956,217957,2,3,0
62424,5,1,217959,217959,217960,0,1,2
62425,1,2,217960,217960,217962,0,2,0
62426,2,1,217962,217962,217963,0,1,0
62427,2,1,217964,217964,217965,0,1,1
62428,4,1,217968,217968,217969,0,1,3
62429,2,2,217970,217970,217972,0,2,1
62430,3,3,217973,217973,217976,0,3,1
62431,1,1,217974,217976,217977,2,3,0
62432,2,2,217976,217977,217979,1,3,0
62433,3,3,217979,217979,217982,0,3,0
62434,2,2,217981,217982,217984,1,3,0
62435,1,1,217982,217984,217985,2,3,0
62436,1,2,217983,217985,217987,2,4,0
62437,1,1,217984,217987,217988,3,4,0
62438,2,3,217986,217988,217991,2,5,0
62439,6,1,217992,217992,217993,0,1,1
62440,3,2,217995,217995,217997,0,2,2
62441,3,3,217998,217998,218001,0,3,1
62442,4,2,218002,218002,218004,0,2,1
62443,5,2,218007,218007,218009,0,2,3
62444,2,1,218009,218009,218010,0,1,0
62445,4,2,218013,218013,218015,0,2,3
62446,2,3,218015,218015,218018,0,3,0
62447,6,3,218021,218021,218024,0,3,3
62448,1,1,218022,218024,218025,2,3,0
62449,3,2,218025,218025,218027,0,2,0
62450,6,2,218031,218031,218033,0,2,4
62451,4,3,218035,218035,218038,0,3,2
62452,2,1,218037,218038,218039,1,2,0
62453,4,2,218041,218041,218043,0,2,2
62454,1,1,218042,218043,218044,1,2,0
62455,6,3,218048,218048,218051,0,3,4
62456,1,1,218049,218051,218052,2,3,0
62457,6,1,218055,218055,218056,0,1,3
62458,4,3,218059,218059,218062,0,3,3
62459,1,2,218060,218062,218064,2,4,0
62460,6,2,218066,218066,218068,0,2,2
62461,4,2,218070,218070,218072,0,2,2
62462,6,3,218076,218076,218079,0,3,4
62463,5,2,218081,218081,218083,0,2,2
62464,6,2,218087,218087,218089,0,2,4
62465,3,3,218090,218090,218093,0,3,1
62466,2,3,218092,218093,218096,1,4,0
62467,1,1,218093,218096,218097,3,4,0
62468,3,1,218096,218097,218098,1,2,0
62469,2,3,218098,218098,218101,0,3,0
62470,5,2,218103,218103,218105,0,2,2
62471,1,1,218104,218105,218106,1,2,0
62472,6,2,218110,218110,218112,0,2,4
62473,1,1,218111,218112,218113,1,2,0
62474,5,1,218116,218116,218117,0,1,3
62475,4,3,218120,218120,218123,0,3,3
62476,5,2,218125,218125,218127,0,2,2
62477,1,2,218126,218127,218129,1,3,0
62478,6,3,218132,218132,218135,0,3,3
62479,6,1,218138,218138,218139,0,1,3
62480,5,1,218143,218143,218144,0,1,4
62481,6,3,218149,218149,218152,0,3,5
62482,1,1,218150,218152,218153,2,3,0
62483,4,1,218154,218154,218155,0,1,1
62484,2,2,218156,218156,218158,0,2,1
62485,2,1,218158,218158,218159,0,1,0
62486,6,3,218164,218164,218167,0,3,5
62487,6,1,218170,218170,218171,0,1,3
62488,2,3,218172,218172,218175,0,3,1
62489,1,1,218173,218175,218176,2,3,0
62490,6,1,218179,218179,218180,0,1,3
62491,3,1,218182,218182,218183,0,1,2
62492,6,3,218188,218188,218191,0,3,5
62493,4,2,218192,218192,218194,0,2,1
62494,3,3,218195,218195,218198,0,3,1
62495,1,1,218196,218198,218199,2,3,0
62496,1,2,218197,218199,218201,2,4,0
62497,1,1,218198,218201,218202,3,4,0
62498,4,2,218202,218202,218204,0,2,0
62499,4,1,218206,218206,218207,0,1,2
62500,6,2,218212,218212,218214,0,2,5
62501,1,1,218213,218214,218215,1,2,0
62502,2,3,218215,218215,218218,0,3,0
62503,3,3,218218,218218,218221,0,3,0
62504,1,2,218219,218221,218223,2,4,0
62505,6,3,218225,218225,218228,0,3,2
62506,2,1,218227,218228,218229,1,2,0
62507,1,2,218228,218229,218231,1,3,0
62508,5,1,218233,218233,218234,0,1,2
62509,5,2,218238,218238,218240,0,2,4
62510,5,2,218243,218243,218245,0,2,3
62511,5,2,218248,218248,218250,0,2,3
62512,2,3,218250,218250,218253,0,3,0
62513,3,2,218253,218253,218255,0,2,0
62514,5,3,218258,218258,218261,0,3,3
62515,4,3,218262,218262,218265,0,3,1
62516,2,2,218264,218265,218267,1,3,0
62517,2,1,218266,218267,218268,1,2,0
62518,2,3,218268,218268,218271,0,3,0
62519,4,3,218272,218272,218275,0,3,1
62520,1,3,218273,218275,218278,2,5,0
62521,3,2,218276,218278,218280,2,4,0
62522,5,2,218281,218281,218283,0,2,1
62523,1,1,218282,218283,218284,1,2,0
62524,6,3,218288,218288,218291,0,3,4
62525,4,2,218292,218292,218294,0,2,1
62526,2,2,218294,218294,218296,0,2,0
62527,3,1,218297,218297,218298,0,1,1
62528,2,3,218299,218299,218302,0,3,1
62529,6,3,218305,218305,218308,0,3,3
62530,2,2,218307,218308,218310,1,3,0
62531,2,1,218309,218310,218311,1,2,0
62532,3,2,218312,218312,218314,0,2,1
62533,4,3,218316,218316,218319,0,3,2
62534,2,2,218318,218319,218321,1,3,0
62535,4,3,218322,218322,218325,0,3,1
62536,5,3,218327,218327,218330,0,3,2
62537,5,1,218332,218332,218333,0,1,2
62538,5,3,218337,218337,218340,0,3,4
62539,3,3,218340,218340,218343,0,3,0
62540,2,1,218342,218343,218344,1,2,0
62541,4,2,218346,218346,218348,0,2,2
62542,3,2,218349,218349,218351,0,2,1
62543,6,1,218355,218355,218356,0,1,4
62544,2,1,218357,218357,218358,0,1,1
62545,1,2,218358,218358,218360,0,2,0
62546,4,2,218362,218362,218364,0,2,2
62547,6,3,218368,218368,218371,0,3,4
62548,2,3,218370,218371,218374,1,4,0
62549,5,1,218375,218375,218376,0,1,1
62550,5,2,218380,218380,218382,0,2,4
62551,6,2,218386,218386,218388,0,2,4
62552,1,1,218387,218388,218389,1,2,0
62553,1,2,218388,218389,218391,1,3,0
62554,6,3,218394,218394,218397,0,3,3
62555,3,3,218397,218397,218400,0,3,0
62556,3,2,218400,218400,218402,0,2,0
62557,2,1,218402,218402,218403,0,1,0
62558,2,3,218404,218404,218407,0,3,1
62559,3,2,218407,218407,218409,0,2,0
62560,3,2,218410,218410,218412,0,2,1
62561,6,3,218416,218416,218419,0,3,4
62562,2,3,218418,218419,218422,1,4,0
62563,6,3,218424,218424,218427,0,3,2
62564,6,3,218430,218430,218433,0,3,3
62565,4,3,218434,218434,218437,0,3,1
62566,6,2,218440,218440,218442,0,2,3
62567,6,2,218446,218446,218448,0,2,4
62568,5,3,218451,218451,218454,0,3,3
62569,1,1,218452,218454,218455,2,3,0
62570,3,1,218455,218455,218456,0,1,0
62571,4,2,218459,218459,218461,0,2,3
62572,3,2,218462,218462,218464,0,2,1
62573,4,2,218466,218466,218468,0,2,2
62574,2,2,218468,218468,218470,0,2,0
62575,5,1,218473,218473,218474,0,1,3
62576,3,3,218476,218476,218479,0,3,2
62577,4,1,218480,218480,218481,0,1,1
62578,5,1,218485,218485,218486,0,1,4
62579,6,1,218491,218491,218492,0,1,5
62580,4,1,218495,218495,218496,0,1,3
62581,4,3,218499,218499,218502,0,3,3
62582,4,3,218503,218503,218506,0,3,1
62583,2,2,218505,218506,218508,1,3,0
62584,4,2,218509,218509,218511,0,2,1
62585,6,3,218515,218515,218518,0,3,4
62586,1,2,218516,218518,218520,2,4,0
62587,6,2,218522,218522,218524,0,2,2
62588,3,2,218525,218525,218527,0,2,1
62589,5,3,218530,218530,218533,0,3,3
62590,3,3,218533,218533,218536,0,3,0
62591,3,3,218536,218536,218539,0,3,0
62592,3,2,218539,218539,218541,0,2,0
62593,3,3,218542,218542,218545,0,3,1
62594,1,2,218543,218545,218547,2,4,0
62595,6,3,218549,218549,218552,0,3,2
62596,5,1,218554,218554,218555,0,1,2
62597,5,2,218559,218559,218561,0,2,4
62598,1,2,218560,218561,218563,1,3,0
62599,6,2,218566,218566,218568,0,2,3
62600,4,1,218570,218570,218571,0,1,2
62601,5,1,218575,218575,218576,0,1,4
62602,6,1,218581,218581,218582,0,1,5
62603,6,1,218587,218587,218588,0,1,5
62604,5,2,218592,218592,218594,0,2,4
62605,6,3,218598,218598,218601,0,3,4
62606,4,3,218602,218602,218605,0,3,1
62607,4,3,218606,218606,218609,0,3,1
62608,5,1,218611,218611,218612,0,1,2
62609,2,2,218613,218613,218615,0,2,1
62610,6,2,218619,218619,218621,0,2,4
62611,1,3,218620,218621,218624,1,4,0
62612,2,2,218622,218624,218626,2,4,0
62613,2,3,218624,218626,218629,2,5,0
62614,1,3,218625,218629,218632,4,7,0
62615,5,3,218630,218632,218635,2,5,0
62616,4,1,218634,218635,218636,1,2,0
62617,6,2,218640,218640,218642,0,2,4
62618,6,2,218646,218646,218648,0,2,4
62619,3,3,218649,218649,218652,0,3,1
62620,6,3,218655,218655,218658,0,3,3
62621,5,3,218660,218660,218663,0,3,2
62622,5,1,218665,218665,218666,0,1,2
62623,5,2,218670,218670,218672,0,2,4
62624,2,1,218672,218672,218673,0,1,0
62625,1,3,218673,218673,218676,0,3,0
62626,6,3,218679,218679,218682,0,3,3
62627,1,3,218680,218682,218685,2,5,0
62628,5,2,218685,218685,218687,0,2,0
62629,5,1,218690,218690,218691,0,1,3
62630,3,3,218693,218693,218696,0,3,2
62631,5,1,218698,218698,218699,0,1,2
62632,4,3,218702,218702,218705,0,3,3
62633,4,3,218706,218706,218709,0,3,1
62634,3,3,218709,218709,218712,0,3,0
62635,5,1,218714,218714,218715,0,1,2
62636,6,2,218720,218720,218722,0,2,5
62637,5,1,218725,218725,218726,0,1,3
62638,4,2,218729,218729,218731,0,2,3
62639,1,1,218730,218731,218732,1,2,0
62640,3,3,218733,218733,218736,0,3,1
62641,4,1,218737,218737,218738,0,1,1
62642,6,1,218743,218743,218744,0,1,5
62643,1,1,218744,218744,218745,0,1,0
62644,5,1,218749,218749,218750,0,1,4
62645,4,2,218753,218753,218755,0,2,3
62646,2,1,218755,218755,218756,0,1,0
62647,5,1,218760,218760,218761,0,1,4
62648,2,3,218762,218762,218765,0,3,1
62649,1,2,218763,218765,218767,2,4,0
62650,1,1,218764,218767,218768,3,4,0
62651,6,1,218770,218770,218771,0,1,2
62652,3,3,218773,218773,218776,0,3,2
62653,1,3,218774,218776,218779,2,5,0
62654,1,2,218775,218779,218781,4,6,0
62655,6,1,218781,218781,218782,0,1,0
62656,1,3,218782,218782,218785,0,3,0
62657,3,1,218785,218785,218786,0,1,0
62658,2,3,218787,218787,218790,0,3,1
62659,5,1,218792,218792,218793,0,1,2
62660,2,3,218794,218794,218797,0,3,1
62661,2,3,218796,218797,218800,1,4,0
62662,2,1,218798,218800,218801,2,3,0
62663,4,3,218802,218802,218805,0,3,1
62664,2,1,218804,218805,218806,1,2,0
62665,5,3,218809,218809,218812,0,3,3
62666,5,1,218814,218814,218815,0,1,2
62667,1,2,218815,218815,218817,0,2,0
62668,5,2,218820,218820,218822,0,2,3
62669,4,2,218824,218824,218826,0,2,2
62670,2,2,218826,218826,218828,0,2,0
62671,1,1,218827,218828,218829,1,2,0
62672,3,3,218830,218830,218833,0,3,1
62673,6,2,218836,218836,218838,0,2,3
62674,2,1,218838,218838,218839,0,1,0
62675,1,1,218839,218839,218840,0,1,0
62676,2,1,218841,218841,218842,0,1,1
62677,1,1,218842,218842,218843,0,1,0
62678,5,1,218847,218847,218848,0,1,4
62679,1,3,218848,218848,218851,0,3,0
62680,3,1,218851,218851,218852,0,1,0
62681,1,3,218852,218852,218855,0,3,0
62682,2,3,218854,218855,218858,1,4,0
62683,4,2,218858,218858,218860,0,2,0
62684,3,1,218861,218861,218862,0,1,1
62685,1,3,218862,218862,218865,0,3,0
62686,1,3,218863,218865,218868,2,5,0
62687,3,3,218866,218868,218871,2,5,0
62688,3,1,218869,218871,218872,2,3,0
62689,2,2,218871,218872,218874,1,3,0
62690,1,2,218872,218874,218876,2,4,0
62691,5,2,218877,218877,218879,0,2,1
62692,1,1,218878,218879,218880,1,2,0
62693,2,1,218880,218880,218881,0,1,0
62694,5,1,218885,218885,218886,0,1,4
62695,1,1,218886,218886,218887,0,1,0
62696,6,2,218892,218892,218894,0,2,5
62697,1,1,218893,218894,218895,1,2,0
62698,6,1,218899,218899,218900,0,1,4
62699,3,3,218902,218902,218905,0,3,2
62700,5,2,218907,218907,218909,0,2,2
62701,5,1,218912,218912,218913,0,1,3
62702,4,1,218916,218916,218917,0,1,3
62703,6,3,218922,218922,218925,0,3,5
62704,4,2,218926,218926,218928,0,2,1
62705,6,1,218932,218932,218933,0,1,4
62706,1,3,218933,218933,218936,0,3,0
62707,2,3,218935,218936,218939,1,4,0
62708,4,1,218939,218939,218940,0,1,0
62709,3,3,218942,218942,218945,0,3,2
62710,6,1,218948,218948,218949,0,1,3
62711,6,1,218954,218954,218955,0,1,5
62712,5,2,218959,218959,218961,0,2,4
62713,5,1,218964,218964,218965,0,1,3
62714,6,1,218970,218970,218971,0,1,5
62715,1,3,218971,218971,218974,0,3,0
62716,6,3,218977,218977,218980,0,3,3
62717,4,1,218981,218981,218982,0,1,1
62718,3,1,218984,218984,218985,0,1,2
62719,5,2,218989,218989,218991,0,2,4
62720,3,3,218992,218992,218995,0,3,1
62721,4,2,218996,218996,218998,0,2,1
62722,6,1,219002,219002,219003,0,1,4
62723,5,2,219007,219007,219009,0,2,4
62724,3,3,219010,219010,219013,0,3,1
62725,4,1,219014,219014,219015,0,1,1
62726,4,2,219018,219018,219020,0,2,3
62727,2,2,219020,219020,219022,0,2,0
62728,4,2,219024,219024,219026,0,2,2
62729,4,1,219028,219028,219029,0,1,2
62730,4,2,219032,219032,219034,0,2,3
62731,1,1,219033,219034,219035,1,2,0
62732,6,2,219039,219039,219041,0,2,4
62733,2,3,219041,219041,219044,0,3,0
62734,2,2,219043,219044,219046,1,3,0
62735,1,1,219044,219046,219047,2,3,0
62736,4,2,219048,219048,219050,0,2,1
62737,5,2,219053,219053,219055,0,2,3
62738,4,3,219057,219057,219060,0,3,2
62739,4,2,219061,219061,219063,0,2,1
62740,3,2,219064,219064,219066,0,2,1
62741,6,1,219070,219070,219071,0,1,4
62742,5,2,219075,219075,219077,0,2,4
62743,5,2,219080,219080,219082,0,2,3
62744,4,2,219084,219084,219086,0,2,2
62745,4,2,219088,219088,219090,0,2,2
62746,1,3,219089,219090,219093,1,4,0
62747,6,1,219095,219095,219096,0,1,2
62748,5,1,219100,219100,219101,0,1,4
62749,3,2,219103,219103,219105,0,2,2
62750,1,1,219104,219105,219106,1,2,0
62751,5,2,219109,219109,219111,0,2,3
62752,2,3,219111,219111,219114,0,3,0
62753,2,2,219113,219114,219116,1,3,0
62754,3,3,219116,219116,219119,0,3,0
62755,6,3,219122,219122,219125,0,3,3
62756,5,3,219127,219127,219130,0,3,2
62757,2,3,219129,219130,219133,1,4,0
62758,6,1,219135,219135,219136,0,1,2
62759,1,2,219136,219136,219138,0,2,0
62760,1,3,219137,219138,219141,1,4,0
62761,2,3,219139,219141,219144,2,5,0
62762,5,1,219144,219144,219145,0,1,0
62763,2,3,219146,219146,219149,0,3,1
62764,2,3,219148,219149,219152,1,4,0
62765,3,2,219151,219152,219154,1,3,0
62766,3,1,219154,219154,219155,0,1,0
62767,3,1,219157,219157,219158,0,1,2
62768,3,1,219160,219160,219161,0,1,2
62769,5,3,219165,219165,219168,0,3,4
62770,6,3,219171,219171,219174,0,3,3
62771,2,2,219173,219174,219176,1,3,0
62772,2,1,219175,219176,219177,1,2,0
62773,1,2,219176,219177,219179,1,3,0
62774,5,2,219181,219181,219183,0,2,2
62775,3,2,219184,219184,219186,0,2,1
62776,3,1,219187,219187,219188,0,1,1
62777,2,1,219189,219189,219190,0,1,1
62778,4,1,219193,219193,219194,0,1,3
62779,1,1,219194,219194,219195,0,1,0
62780,1,3,219195,219195,219198,0,3,0
62781,5,1,219200,219200,219201,0,1,2
62782,4,2,219204,219204,219206,0,2,3
62783,2,2,219206,219206,219208,0,2,0
62784,4,1,219210,219210,219211,0,1,2
62785,1,1,219211,219211,219212,0,1,0
62786,5,1,219216,219216,219217,0,1,4
62787,6,1,219222,219222,219223,0,1,5
62788,5,2,219227,219227,219229,0,2,4
62789,5,1,219232,219232,219233,0,1,3
62790,4,1,219236,219236,219237,0,1,3
62791,1,1,219237,219237,219238,0,1,0
62792,4,1,219241,219241,219242,0,1,3
62793,3,2,219244,219244,219246,0,2,2
62794,1,2,219245,219246,219248,1,3,0
62795,6,2,219251,219251,219253,0,2,3
62796,2,1,219253,219253,219254,0,1,0
62797,4,2,219257,219257,219259,0,2,3
62798,2,1,219259,219259,219260,0,1,0
62799,3,3,219262,219262,219265,0,3,2
62800,1,1,219263,219265,219266,2,3,0
62801,1,1,219264,219266,219267,2,3,0
62802,6,2,219270,219270,219272,0,2,3
62803,5,2,219275,219275,219277,0,2,3
62804,4,2,219279,219279,219281,0,2,2
62805,6,2,219285,219285,219287,0,2,4
62806,3,3,219288,219288,219291,0,3,1
62807,4,2,219292,219292,219294,0,2,1
62808,4,3,219296,219296,219299,0,3,2
62809,6,2,219302,219302,219304,0,2,3
62810,3,1,219305,219305,219306,0,1,1
62811,6,2,219311,219311,219313,0,2,5
62812,2,3,219313,219313,219316,0,3,0
62813,3,2,219316,219316,219318,0,2,0
62814,1,1,219317,219318,219319,1,2,0
62815,2,1,219319,219319,219320,0,1,0
62816,2,1,219321,219321,219322,0,1,1
62817,4,2,219325,219325,219327,0,2,3
62818,5,3,219330,219330,219333,0,3,3
62819,3,2,219333,219333,219335,0,2,0
62820,1,3,219334,219335,219338,1,4,0
62821,4,2,219338,219338,219340,0,2,0
62822,3,3,219341,219341,219344,0,3,1
62823,6,2,219347,219347,219349,0,2,3
62824,6,1,219353,219353,219354,0,1,4
62825,1,3,219354,219354,219357,0,3,0
62826,2,3,219356,219357,219360,1,4,0
62827,5,3,219361,219361,219364,0,3,1
62828,2,3,219363,219364,219367,1,4,0
62829,2,3,219365,219367,219370,2,5,0
62830,2,1,219367,219370,219371,3,4,0
62831,1,3,219368,219371,219374,3,6,0
62832,4,1,219372,219374,219375,2,3,0
62833,1,3,219373,219375,219378,2,5,0
62834,4,1,219377,219378,219379,1,2,0
62835,3,2,219380,219380,219382,0,2,1
62836,4,1,219384,219384,219385,0,1,2
62837,6,1,219390,219390,219391,0,1,5
62838,3,1,219393,219393,219394,0,1,2
62839,4,3,219397,219397,219400,0,3,3
62840,1,2,219398,219400,219402,2,4,0
62841,1,1,219399,219402,219403,3,4,0
62842,6,2,219405,219405,219407,0,2,2
62843,1,2,219406,219407,219409,1,3,0
62844,4,3,219410,219410,219413,0,3,1
62845,2,2,219412,219413,219415,1,3,0
62846,4,1,219416,219416,219417,0,1,1
62847,2,2,219418,219418,219420,0,2,1
62848,3,1,219421,219421,219422,0,1,1
62849,6,3,219427,219427,219430,0,3,5
62850,3,3,219430,219430,219433,0,3,0
62851,6,2,219436,219436,219438,0,2,3
62852,3,3,219439,219439,219442,0,3,1
62853,4,1,219443,219443,219444,0,1,1
62854,4,2,219447,219447,219449,0,2,3
62855,3,3,219450,219450,219453,0,3,1
62856,1,3,219451,219453,219456,2,5,0
62857,5,2,219456,219456,219458,0,2,0
62858,5,2,219461,219461,219463,0,2,3
62859,2,2,219463,219463,219465,0,2,0
62860,1,1,219464,219465,219466,1,2,0
62861,5,2,219469,219469,219471,0,2,3
62862,6,3,219475,219475,219478,0,3,4
62863,5,1,219480,219480,219481,0,1,2
62864,6,1,219486,219486,219487,0,1,5
62865,1,1,219487,219487,219488,0,1,0
62866,3,1,219490,219490,219491,0,1,2
62867,1,3,219491,219491,219494,0,3,0
62868,6,3,219497,219497,219500,0,3,3
62869,6,3,219503,219503,219506,0,3,3
62870,4,3,219507,219507,219510,0,3,1
62871,6,2,219513,219513,219515,0,2,3
62872,1,2,219514,219515,219517,1,3,0
62873,3,3,219517,219517,219520,0,3,0
62874,2,2,219519,219520,219522,1,3,0
62875,3,1,219522,219522,219523,0,1,0
62876,3,3,219525,219525,219528,0,3,2
62877,5,3,219530,219530,219533,0,3,2
62878,5,3,219535,219535,219538,0,3,2
62879,2,2,219537,219538,219540,1,3,0
62880,1,3,219538,219540,219543,2,5,0
62881,2,2,219540,219543,219545,3,5,0
62882,2,1,219542,219545,219546,3,4,0
62883,6,2,219548,219548,219550,0,2,2
62884,5,3,219553,219553,219556,0,3,3
62885,5,3,219558,219558,219561,0,3,2
62886,2,2,219560,219561,219563,1,3,0
62887,3,3,219563,219563,219566,0,3,0
62888,1,3,219564,219566,219569,2,5,0
62889,1,3,219565,219569,219572,4,7,0
62890,2,3,219567,219572,219575,5,8,0
62891,4,1,219571,219575,219576,4,5,0
62892,1,1,219572,219576,219577,4,5,0
62893,5,1,219577,219577,219578,0,1,0
62894,2,2,219579,219579,219581,0,2,1
62895,3,3,219582,219582,219585,0,3,1
62896,4,3,219586,219586,219589,0,3,1
62897,5,3,219591,219591,219594,0,3,2
62898,1,2,219592,219594,219596,2,4,0
62899,2,1,219594,219596,219597,2,3,0
62900,2,2,219596,219597,219599,1,3,0
62901,2,1,219598,219599,219600,1,2,0
62902,4,3,219602,219602,219605,0,3,2
62903,1,1,219603,219605,219606,2,3,0
62904,3,2,219606,219606,219608,0,2,0
62905,6,2,219612,219612,219614,0,2,4
62906,2,2,219614,219614,219616,0,2,0
62907,5,1,219619,219619,219620,0,1,3
62908,6,1,219625,219625,219626,0,1,5
62909,1,2,219626,219626,219628,0,2,0
62910,2,3,219628,219628,219631,0,3,0
62911,3,2,219631,219631,219633,0,2,0
62912,4,2,219635,219635,219637,0,2,2
62913,6,2,219641,219641,219643,0,2,4
62914,2,1,219643,219643,219644,0,1,0
62915,6,1,219649,219649,219650,0,1,5
62916,5,3,219654,219654,219657,0,3,4
62917,3,3,219657,219657,219660,0,3,0
62918,4,3,219661,219661,219664,0,3,1
62919,3,2,219664,219664,219666,0,2,0
62920,5,3,219669,219669,219672,0,3,3
62921,3,1,219672,219672,219673,0,1,0
62922,4,3,219676,219676,219679,0,3,3
62923,5,2,219681,219681,219683,0,2,2
62924,6,2,219687,219687,219689,0,2,4
62925,5,3,219692,219692,219695,0,3,3
62926,6,3,219698,219698,219701,0,3,3
62927,3,1,219701,219701,219702,0,1,0
62928,6,1,219707,219707,219708,0,1,5
62929,6,1,219713,219713,219714,0,1,5
62930,5,1,219718,219718,219719,0,1,4
62931,1,1,219719,219719,219720,0,1,0
62932,6,2,219725,219725,219727,0,2,5
62933,4,3,219729,219729,219732,0,3,2
62934,6,3,219735,219735,219738,0,3,3
62935,1,1,219736,219738,219739,2,3,0
62936,4,2,219740,219740,219742,0,2,1
62937,4,1,219744,219744,219745,0,1,2
62938,4,1,219748,219748,219749,0,1,3
62939,5,1,219753,219753,219754,0,1,4
62940,1,3,219754,219754,219757,0,3,0
62941,1,3,219755,219757,219760,2,5,0
62942,5,3,219760,219760,219763,0,3,0
62943,5,3,219765,219765,219768,0,3,2
62944,1,3,219766,219768,219771,2,5,0
62945,6,2,219772,219772,219774,0,2,1
62946,1,3,219773,219774,219777,1,4,0
62947,6,2,219779,219779,219781,0,2,2
62948,1,2,219780,219781,219783,1,3,0
62949,2,3,219782,219783,219786,1,4,0
62950,1,2,219783,219786,219788,3,5,0
62951,5,2,219788,219788,219790,0,2,0
62952,2,2,219790,219790,219792,0,2,0
62953,1,1,219791,219792,219793,1,2,0
62954,4,2,219795,219795,219797,0,2,2
62955,6,1,219801,219801,219802,0,1,4
62956,3,2,219804,219804,219806,0,2,2
62957,5,1,219809,219809,219810,0,1,3
62958,3,1,219812,219812,219813,0,1,2
62959,1,3,219813,219813,219816,0,3,0
62960,5,3,219818,219818,219821,0,3,2
62961,6,1,219824,219824,219825,0,1,3
62962,2,3,219826,219826,219829,0,3,1
62963,6,1,219832,219832,219833,0,1,3
62964,3,2,219835,219835,219837,0,2,2
62965,4,1,219839,219839,219840,0,1,2
62966,4,3,219843,219843,219846,0,3,3
62967,1,2,219844,219846,219848,2,4,0
62968,4,3,219848,219848,219851,0,3,0
62969,1,3,219849,219851,219854,2,5,0
62970,1,3,219850,219854,219857,4,7,0
62971,4,2,219854,219857,219859,3,5,0
62972,4,2,219858,219859,219861,1,3,0
62973,5,3,219863,219863,219866,0,3,2
62974,3,2,219866,219866,219868,0,2,0
62975,4,3,219870,219870,219873,0,3,2
62976,1,3,219871,219873,219876,2,5,0
62977,5,2,219876,219876,219878,0,2,0
62978,2,3,219878,219878,219881,0,3,0
62979,5,3,219883,219883,219886,0,3,2
62980,2,3,219885,219886,219889,1,4,0
62981,5,3,219890,219890,219893,0,3,1
62982,2,2,219892,219893,219895,1,3,0
62983,3,3,219895,219895,219898,0,3,0
62984,6,3,219901,219901,219904,0,3,3
62985,3,3,219904,219904,219907,0,3,0
62986,5,2,219909,219909,219911,0,2,2
62987,6,1,219915,219915,219916,0,1,4
62988,1,2,219916,219916,219918,0,2,0
62989,4,1,219920,219920,219921,0,1,2
62990,1,3,219921,219921,219924,0,3,0
62991,5,2,219926,219926,219928,0,2,2
62992,3,2,219929,219929,219931,0,2,1
62993,6,2,219935,219935,219937,0,2,4
62994,3,3,219938,219938,219941,0,3,1
62995,5,2,219943,219943,219945,0,2,2
62996,1,3,219944,219945,219948,1,4,0
62997,1,1,219945,219948,219949,3,4,0
62998,1,3,219946,219949,219952,3,6,0
62999,3,2,219949,219952,219954,3,5,0
63000,6,1,219955,219955,219956,0,1,1
63001,5,2,219960,219960,219962,0,2,4
63002,4,3,219964,219964,219967,0,3,2
63003,5,1,219969,219969,219970,0,1,2
63004,4,2,219973,219973,219975,0,2,3
63005,5,3,219978,219978,219981,0,3,3
63006,1,1,219979,219981,219982,2,3,0
63007,2,3,219981,219982,219985,1,4,0
63008,2,2,219983,219985,219987,2,4,0
63009,4,3,219987,219987,219990,0,3,0
63010,4,2,219991,219991,219993,0,2,1
63011,5,3,219996,219996,219999,0,3,3
63012,3,1,219999,219999,220000,0,1,0
63013,5,2,220004,220004,220006,0,2,4
63014,4,1,220008,220008,220009,0,1,2
63015,1,2,220009,220009,220011,0,2,0
63016,3,2,220012,220012,220014,0,2,1
63017,1,1,220013,220014,220015,1,2,0
63018,2,2,220015,220015,220017,0,2,0
63019,1,3,220016,220017,220020,1,4,0
63020,1,2,220017,220020,220022,3,5,0
63021,1,1,220018,220022,220023,4,5,0
63022,6,2,220024,220024,220026,0,2,1
63023,3,1,220027,220027,220028,0,1,1
63024,1,3,220028,220028,220031,0,3,0
63025,5,3,220033,220033,220036,0,3,2
63026,5,2,220038,220038,220040,0,2,2
63027,3,2,220041,220041,220043,0,2,1
63028,1,3,220042,220043,220046,1,4,0
63029,1,3,220043,220046,220049,3,6,0
63030,4,1,220047,220049,220050,2,3,0
63031,6,3,220053,220053,220056,0,3,3
63032,1,3,220054,220056,220059,2,5,0
63033,4,2,220058,220059,220061,1,3,0
63034,3,2,220061,220061,220063,0,2,0
63035,5,2,220066,220066,220068,0,2,3
63036,4,1,220070,220070,220071,0,1,2
63037,6,1,220076,220076,220077,0,1,5
63038,2,3,220078,220078,220081,0,3,1
63039,4,3,220082,220082,220085,0,3,1
63040,3,1,220085,220085,220086,0,1,0
63041,6,1,220091,220091,220092,0,1,5
63042,5,2,220096,220096,220098,0,2,4
63043,1,1,220097,220098,220099,1,2,0
63044,4,3,220101,220101,220104,0,3,2
63045,5,1,220106,220106,220107,0,1,2
63046,2,1,220108,220108,220109,0,1,1
63047,2,2,220110,220110,220112,0,2,1
63048,2,2,220112,220112,220114,0,2,0
63049,3,3,220115,220115,220118,0,3,1
63050,2,3,220117,220118,220121,1,4,0
63051,6,3,220123,220123,220126,0,3,2
63052,4,2,220127,220127,220129,0,2,1
63053,3,3,220130,220130,220133,0,3,1
63054,5,3,220135,220135,220138,0,3,2
63055,2,3,220137,220138,220141,1,4,0
63056,2,2,220139,220141,220143,2,4,0
63057,3,1,220142,220143,220144,1,2,0
63058,1,1,220143,220144,220145,1,2,0
63059,1,3,220144,220145,220148,1,4,0
63060,3,1,220147,220148,220149,1,2,0
63061,4,1,220151,220151,220152,0,1,2
63062,4,2,220155,220155,220157,0,2,3
63063,1,1,220156,220157,220158,1,2,0
63064,5,1,220161,220161,220162,0,1,3
63065,4,1,220165,220165,220166,0,1,3
63066,6,3,220171,220171,220174,0,3,5
63067,6,2,220177,220177,220179,0,2,3
63068,1,3,220178,220179,220182,1,4,0
63069,5,2,220183,220183,220185,0,2,1
63070,3,2,220186,220186,220188,0,2,1
63071,3,2,220189,220189,220191,0,2,1
63072,4,3,220193,220193,220196,0,3,2
63073,4,1,220197,220197,220198,0,1,1
63074,6,1,220203,220203,220204,0,1,5
63075,1,3,220204,220204,220207,0,3,0
63076,5,1,220209,220209,220210,0,1,2
63077,1,3,220210,220210,220213,0,3,0
63078,4,3,220214,220214,220217,0,3,1
63079,4,1,220218,220218,220219,0,1,1
63080,3,2,220221,220221,220223,0,2,2
63081,1,1,220222,220223,220224,1,2,0
63082,6,1,220228,220228,220229,0,1,4
63083,1,1,220229,220229,220230,0,1,0
63084,5,1,220234,220234,220235,0,1,4
63085,5,1,220239,220239,220240,0,1,4
63086,3,2,220242,220242,220244,0,2,2
63087,5,1,220247,220247,220248,0,1,3
63088,5,2,220252,220252,220254,0,2,4
63089,3,2,220255,220255,220257,0,2,1
63090,4,1,220259,220259,220260,0,1,2
63091,6,1,220265,220265,220266,0,1,5
63092,1,1,220266,220266,220267,0,1,0
63093,1,1,220267,220267,220268,0,1,0
63094,5,2,220272,220272,220274,0,2,4
63095,4,2,220276,220276,220278,0,2,2
63096,4,1,220280,220280,220281,0,1,2
63097,2,1,220282,220282,220283,0,1,1
63098,2,1,220284,220284,220285,0,1,1
63099,4,3,220288,220288,220291,0,3,3
63100,1,1,220289,220291,220292,2,3,0
63101,3,2,220292,220292,220294,0,2,0
63102,4,1,220296,220296,220297,0,1,2
63103,1,1,220297,220297,220298,0,1,0
63104,5,1,220302,220302,220303,0,1,4
63105,2,3,220304,220304,220307,0,3,1
63106,4,3,220308,220308,220311,0,3,1
63107,3,3,220311,220311,220314,0,3,0
63108,1,2,220312,220314,220316,2,4,0
63109,6,2,220318,220318,220320,0,2,2
63110,3,3,220321,220321,220324,0,3,1
63111,5,2,220326,220326,220328,0,2,2
63112,4,1,220330,220330,220331,0,1,2
63113,1,2,220331,220331,220333,0,2,0
63114,3,3,220334,220334,220337,0,3,1
63115,4,1,220338,220338,220339,0,1,1
63116,2,3,220340,220340,220343,0,3,1
63117,4,2,220344,220344,220346,0,2,1
63118,6,3,220350,220350,220353,0,3,4
63119,4,1,220354,220354,220355,0,1,1
63120,1,1,220355,220355,220356,0,1,0
63121,6,2,220361,220361,220363,0,2,5
63122,3,1,220364,220364,220365,0,1,1
63123,2,1,220366,220366,220367,0,1,1
63124,6,2,220372,220372,220374,0,2,5
63125,5,1,220377,220377,220378,0,1,3
63126,4,3,220381,220381,220384,0,3,3
63127,4,3,220385,220385,220388,0,3,1
63128,2,1,220387,220388,220389,1,2,0
63129,3,1,220390,220390,220391,0,1,1
63130,2,3,220392,220392,220395,0,3,1
63131,6,3,220398,220398,220401,0,3,3
63132,2,2,220400,220401,220403,1,3,0
63133,4,3,220404,220404,220407,0,3,1
63134,3,1,220407,220407,220408,0,1,0
63135,1,2,220408,220408,220410,0,2,0
63136,6,1,220414,220414,220415,0,1,4
63137,3,3,220417,220417,220420,0,3,2
63138,2,1,220419,220420,220421,1,2,0
63139,6,2,220425,220425,220427,0,2,4
63140,1,2,220426,220427,220429,1,3,0
63141,3,3,220429,220429,220432,0,3,0
63142,3,3,220432,220432,220435,0,3,0
63143,5,3,220437,220437,220440,0,3,2
63144,2,3,220439,220440,220443,1,4,0
63145,5,2,220444,220444,220446,0,2,1
63146,6,3,220450,220450,220453,0,3,4
63147,1,2,220451,220453,220455,2,4,0
63148,6,2,220457,220457,220459,0,2,2
63149,6,1,220463,220463,220464,0,1,4
63150,2,2,220465,220465,220467,0,2,1
63151,1,1,220466,220467,220468,1,2,0
63152,3,2,220469,220469,220471,0,2,1
63153,3,2,220472,220472,220474,0,2,1
63154,3,3,220475,220475,220478,0,3,1
63155,5,3,220480,220480,220483,0,3,2
63156,2,1,220482,220483,220484,1,2,0
63157,1,1,220483,220484,220485,1,2,0
63158,2,2,220485,220485,220487,0,2,0
63159,3,2,220488,220488,220490,0,2,1
63160,6,2,220494,220494,220496,0,2,4
63161,3,2,220497,220497,220499,0,2,1
63162,2,1,220499,220499,220500,0,1,0
63163,2,3,220501,220501,220504,0,3,1
63164,3,1,220504,220504,220505,0,1,0
63165,3,3,220507,220507,220510,0,3,2
63166,3,3,220510,220510,220513,0,3,0
63167,3,3,220513,220513,220516,0,3,0
63168,3,1,220516,220516,220517,0,1,0
63169,5,1,220521,220521,220522,0,1,4
63170,4,3,220525,220525,220528,0,3,3
63171,6,2,220531,220531,220533,0,2,3
63172,5,1,220536,220536,220537,0,1,3
63173,3,2,220539,220539,220541,0,2,2
63174,1,2,220540,220541,220543,1,3,0
63175,2,3,220542,220543,220546,1,4,0
63176,4,2,220546,220546,220548,0,2,0
63177,2,2,220548,220548,220550,0,2,0
63178,3,1,220551,220551,220552,0,1,1
63179,1,3,220552,220552,220555,0,3,0
63180,6,2,220558,220558,220560,0,2,3
63181,4,3,220562,220562,220565,0,3,2
63182,5,2,220567,220567,220569,0,2,2
63183,5,2,220572,220572,220574,0,2,3
63184,3,1,220575,220575,220576,0,1,1
63185,4,3,220579,220579,220582,0,3,3
63186,6,2,220585,220585,220587,0,2,3
63187,2,3,220587,220587,220590,0,3,0
63188,2,1,220589,220590,220591,1,2,0
63189,2,3,220591,220591,220594,0,3,0
63190,5,3,220596,220596,220599,0,3,2
63191,6,3,220602,220602,220605,0,3,3
63192,3,2,220605,220605,220607,0,2,0
63193,3,2,220608,220608,220610,0,2,1
63194,4,3,220612,220612,220615,0,3,2
63195,3,2,220615,220615,220617,0,2,0
63196,6,1,220621,220621,220622,0,1,4
63197,6,1,220627,220627,220628,0,1,5
63198,2,1,220629,220629,220630,0,1,1
63199,2,3,220631,220631,220634,0,3,1
63200,5,1,220636,220636,220637,0,1,2
63201,2,1,220638,220638,220639,0,1,1
63202,2,1,220640,220640,220641,0,1,1
63203,2,1,220642,220642,220643,0,1,1
63204,2,1,220644,220644,220645,0,1,1
63205,4,1,220648,220648,220649,0,1,3
63206,1,1,220649,220649,220650,0,1,0
63207,5,1,220654,220654,220655,0,1,4
63208,6,1,220660,220660,220661,0,1,5
63209,4,3,220664,220664,220667,0,3,3
63210,5,1,220669,220669,220670,0,1,2
63211,5,2,220674,220674,220676,0,2,4
63212,6,3,220680,220680,220683,0,3,4
63213,3,1,220683,220683,220684,0,1,0
63214,2,3,220685,220685,220688,0,3,1
63215,3,3,220688,220688,220691,0,3,0
63216,1,1,220689,220691,220692,2,3,0
63217,5,1,220694,220694,220695,0,1,2
63218,6,2,220700,220700,220702,0,2,5
63219,5,2,220705,220705,220707,0,2,3
63220,4,2,220709,220709,220711,0,2,2
63221,4,1,220713,220713,220714,0,1,2
63222,6,2,220719,220719,220721,0,2,5
63223,4,1,220723,220723,220724,0,1,2
63224,2,2,220725,220725,220727,0,2,1
63225,1,2,220726,220727,220729,1,3,0
63226,6,2,220732,220732,220734,0,2,3
63227,1,3,220733,220734,220737,1,4,0
63228,1,2,220734,220737,220739,3,5,0
63229,2,1,220736,220739,220740,3,4,0
63230,3,2,220739,220740,220742,1,3,0
63231,4,1,220743,220743,220744,0,1,1
63232,3,2,220746,220746,220748,0,2,2
63233,4,1,220750,220750,220751,0,1,2
63234,3,1,220753,220753,220754,0,1,2
63235,2,1,220755,220755,220756,0,1,1
63236,1,3,220756,220756,220759,0,3,0
63237,1,3,220757,220759,220762,2,5,0
63238,6,2,220763,220763,220765,0,2,1
63239,6,2,220769,220769,220771,0,2,4
63240,2,3,220771,220771,220774,0,3,0
63241,1,3,220772,220774,220777,2,5,0
63242,3,1,220775,220777,220778,2,3,0
63243,6,3,220781,220781,220784,0,3,3
63244,1,3,220782,220784,220787,2,5,0
63245,1,3,220783,220787,220790,4,7,0
63246,2,2,220785,220790,220792,5,7,0
63247,1,3,220786,220792,220795,6,9,0
63248,4,2,220790,220795,220797,5,7,0
63249,3,2,220793,220797,220799,4,6,0
63250,6,3,220799,220799,220802,0,3,0
63251,6,1,220805,220805,220806,0,1,3
63252,6,2,220811,220811,220813,0,2,5
63253,1,1,220812,220813,220814,1,2,0
63254,3,1,220815,220815,220816,0,1,1
63255,1,3,220816,220816,220819,0,3,0
63256,1,3,220817,220819,220822,2,5,0
63257,2,3,220819,220822,220825,3,6,0
63258,2,1,220821,220825,220826,4,5,0
63259,6,1,220827,220827,220828,0,1,1
63260,4,2,220831,220831,220833,0,2,3
63261,1,2,220832,220833,220835,1,3,0
63262,6,1,220838,220838,220839,0,1,3
63263,6,2,220844,220844,220846,0,2,5
63264,6,3,220850,220850,220853,0,3,4
63265,5,3,220855,220855,220858,0,3,2
63266,1,2,220856,220858,220860,2,4,0
63267,4,2,220860,220860,220862,0,2,0
63268,5,2,220865,220865,220867,0,2,3
63269,2,1,220867,220867,220868,0,1,0
63270,1,2,220868,220868,220870,0,2,0
63271,5,3,220873,220873,220876,0,3,3
63272,1,1,220874,220876,220877,2,3,0
63273,5,3,220879,220879,220882,0,3,2
63274,5,1,220884,220884,220885,0,1,2
63275,6,3,220890,220890,220893,0,3,5
63276,6,1,220896,220896,220897,0,1,3
63277,3,2,220899,220899,220901,0,2,2
63278,3,3,220902,220902,220905,0,3,1
63279,5,1,220907,220907,220908,0,1,2
63280,4,1,220911,220911,220912,0,1,3
63281,3,3,220914,220914,220917,0,3,2
63282,4,1,220918,220918,220919,0,1,1
63283,3,1,220921,220921,220922,0,1,2
63284,3,2,220924,220924,220926,0,2,2
63285,3,2,220927,220927,220929,0,2,1
63286,5,3,220932,220932,220935,0,3,3
63287,6,1,220938,220938,220939,0,1,3
63288,6,3,220944,220944,220947,0,3,5
63289,6,2,220950,220950,220952,0,2,3
63290,1,2,220951,220952,220954,1,3,0
63291,5,3,220956,220956,220959,0,3,2
63292,6,2,220962,220962,220964,0,2,3
63293,5,1,220967,220967,220968,0,1,3
63294,2,1,220969,220969,220970,0,1,1
63295,2,1,220971,220971,220972,0,1,1
63296,3,3,220974,220974,220977,0,3,2
63297,4,3,220978,220978,220981,0,3,1
63298,6,2,220984,220984,220986,0,2,3
63299,2,2,220986,220986,220988,0,2,0
63300,3,1,220989,220989,220990,0,1,1
63301,2,3,220991,220991,220994,0,3,1
63302,1,1,220992,220994,220995,2,3,0
63303,2,3,220994,220995,220998,1,4,0
63304,1,2,220995,220998,221000,3,5,0
63305,3,1,220998,221000,221001,2,3,0
63306,4,1,221002,221002,221003,0,1,1
63307,4,1,221006,221006,221007,0,1,3
63308,2,3,221008,221008,221011,0,3,1
63309,5,2,221013,221013,221015,0,2,2
63310,3,3,221016,221016,221019,0,3,1
63311,6,3,221022,221022,221025,0,3,3
63312,3,3,221025,221025,221028,0,3,0
63313,1,2,221026,221028,221030,2,4,0
63314,1,1,221027,221030,221031,3,4,0
63315,5,3,221032,221032,221035,0,3,1
63316,1,2,221033,221035,221037,2,4,0
63317,2,3,221035,221037,221040,2,5,0
63318,2,3,221037,221040,221043,3,6,0
63319,2,3,221039,221043,221046,4,7,0
63320,6,3,221045,221046,221049,1,4,0
63321,1,1,221046,221049,221050,3,4,0
63322,3,2,221049,221050,221052,1,3,0
63323,6,3,221055,221055,221058,0,3,3
63324,5,2,221060,221060,221062,0,2,2
63325,3,1,221063,221063,221064,0,1,1
63326,2,1,221065,221065,221066,0,1,1
63327,1,1,221066,221066,221067,0,1,0
63328,4,1,221070,221070,221071,0,1,3
63329,4,3,221074,221074,221077,0,3,3
63330,3,1,221077,221077,221078,0,1,0
63331,2,2,221079,221079,221081,0,2,1
63332,6,2,221085,221085,221087,0,2,4
63333,1,1,221086,221087,221088,1,2,0
63334,3,2,221089,221089,221091,0,2,1
63335,6,1,221095,221095,221096,0,1,4
63336,1,1,221096,221096,221097,0,1,0
63337,6,1,221102,221102,221103,0,1,5
63338,6,1,221108,221108,221109,0,1,5
63339,2,1,221110,221110,221111,0,1,1
63340,4,3,221114,221114,221117,0,3,3
63341,4,2,221118,221118,221120,0,2,1
63342,1,2,221119,221120,221122,1,3,0
63343,4,1,221123,221123,221124,0,1,1
63344,4,3,221127,221127,221130,0,3,3
63345,2,1,221129,221130,221131,1,2,0
63346,2,1,221131,221131,221132,0,1,0
63347,6,1,221137,221137,221138,0,1,5
63348,3,2,221140,221140,221142,0,2,2
63349,4,3,221144,221144,221147,0,3,2
63350,2,3,221146,221147,221150,1,4,0
63351,3,2,221149,221150,221152,1,3,0
63352,1,2,221150,221152,221154,2,4,0
63353,3,2,221153,221154,221156,1,3,0
63354,1,3,221154,221156,221159,2,5,0
63355,5,1,221159,221159,221160,0,1,0
63356,1,2,221160,221160,221162,0,2,0
63357,3,1,221163,221163,221164,0,1,1
63358,1,3,221164,221164,221167,0,3,0
63359,1,1,221165,221167,221168,2,3,0
63360,5,3,221170,221170,221173,0,3,2
63361,2,1,221172,221173,221174,1,2,0
63362,5,3,221177,221177,221180,0,3,3
63363,5,1,221182,221182,221183,0,1,2
63364,4,3,221186,221186,221189,0,3,3
63365,6,1,221192,221192,221193,0,1,3
63366,6,3,221198,221198,221201,0,3,5
63367,6,3,221204,221204,221207,0,3,3
63368,4,3,221208,221208,221211,0,3,1
63369,4,1,221212,221212,221213,0,1,1
63370,1,3,221213,221213,221216,0,3,0
63371,4,1,221217,221217,221218,0,1,1
63372,2,3,221219,221219,221222,0,3,1
63373,1,3,221220,221222,221225,2,5,0
63374,2,1,221222,221225,221226,3,4,0
63375,2,2,221224,221226,221228,2,4,0
63376,5,3,221229,221229,221232,0,3,1
63377,6,2,221235,221235,221237,0,2,3
63378,4,3,221239,221239,221242,0,3,2
63379,1,2,221240,221242,221244,2,4,0
63380,2,3,221242,221244,221247,2,5,0
63381,3,2,221245,221247,221249,2,4,0
63382,1,2,221246,221249,221251,3,5,0
63383,2,3,221248,221251,221254,3,6,0
63384,1,3,221249,221254,221257,5,8,0
63385,1,2,221250,221257,221259,7,9,0
63386,1,3,221251,221259,221262,8,11,0
63387,1,1,221252,221262,221263,10,11,0
63388,6,3,221258,221263,221266,5,8,0
63389,3,1,221261,221266,221267,5,6,0
63390,3,2,221264,221267,221269,3,5,0
63391,5,1,221269,221269,221270,0,1,0
63392,5,2,221274,221274,221276,0,2,4
63393,6,1,221280,221280,221281,0,1,4
63394,6,1,221286,221286,221287,0,1,5
63395,3,3,221289,221289,221292,0,3,2
63396,5,1,221294,221294,221295,0,1,2
63397,6,3,221300,221300,221303,0,3,5
63398,2,2,221302,221303,221305,1,3,0
63399,2,3,221304,221305,221308,1,4,0
63400,3,3,221307,221308,221311,1,4,0
63401,2,3,221309,221311,221314,2,5,0
63402,4,1,221313,221314,221315,1,2,0
63403,1,3,221314,221315,221318,1,4,0
63404,5,1,221319,221319,221320,0,1,1
63405,2,1,221321,221321,221322,0,1,1
63406,1,2,221322,221322,221324,0,2,0
63407,4,2,221326,221326,221328,0,2,2
63408,5,3,221331,221331,221334,0,3,3
63409,4,1,221335,221335,221336,0,1,1
63410,6,3,221341,221341,221344,0,3,5
63411,6,1,221347,221347,221348,0,1,3
63412,6,3,221353,221353,221356,0,3,5
63413,5,3,221358,221358,221361,0,3,2
63414,2,1,221360,221361,221362,1,2,0
63415,6,3,221366,221366,221369,0,3,4
63416,6,1,221372,221372,221373,0,1,3
63417,2,3,221374,221374,221377,0,3,1
63418,1,2,221375,221377,221379,2,4,0
63419,6,1,221381,221381,221382,0,1,2
63420,3,3,221384,221384,221387,0,3,2
63421,5,3,221389,221389,221392,0,3,2
63422,2,2,221391,221392,221394,1,3,0
63423,4,3,221395,221395,221398,0,3,1
63424,3,3,221398,221398,221401,0,3,0
63425,2,1,221400,221401,221402,1,2,0
63426,2,3,221402,221402,221405,0,3,0
63427,2,1,221404,221405,221406,1,2,0
63428,4,3,221408,221408,221411,0,3,2
63429,6,1,221414,221414,221415,0,1,3
63430,5,3,221419,221419,221422,0,3,4
63431,1,2,221420,221422,221424,2,4,0
63432,1,2,221421,221424,221426,3,5,0
63433,3,3,221424,221426,221429,2,5,0
63434,2,1,221426,221429,221430,3,4,0
63435,1,2,221427,221430,221432,3,5,0
63436,6,2,221433,221433,221435,0,2,1
63437,5,2,221438,221438,221440,0,2,3
63438,4,2,221442,221442,221444,0,2,2
63439,2,2,221444,221444,221446,0,2,0
63440,6,2,221450,221450,221452,0,2,4
63441,6,2,221456,221456,221458,0,2,4
63442,2,1,221458,221458,221459,0,1,0
63443,3,1,221461,221461,221462,0,1,2
63444,4,1,221465,221465,221466,0,1,3
63445,5,3,221470,221470,221473,0,3,4
63446,3,2,221473,221473,221475,0,2,0
63447,1,2,221474,221475,221477,1,3,0
63448,6,1,221480,221480,221481,0,1,3
63449,1,1,221481,221481,221482,0,1,0
63450,2,2,221483,221483,221485,0,2,1
63451,6,2,221489,221489,221491,0,2,4
63452,1,2,221490,221491,221493,1,3,0
63453,6,3,221496,221496,221499,0,3,3
63454,3,2,221499,221499,221501,0,2,0
63455,3,1,221502,221502,221503,0,1,1
63456,3,1,221505,221505,221506,0,1,2
63457,5,1,221510,221510,221511,0,1,4
63458,5,1,221515,221515,221516,0,1,4
63459,3,1,221518,221518,221519,0,1,2
63460,6,1,221524,221524,221525,0,1,5
63461,4,2,221528,221528,221530,0,2,3
63462,3,3,221531,221531,221534,0,3,1
63463,2,3,221533,221534,221537,1,4,0
63464,4,3,221537,221537,221540,0,3,0
63465,6,3,221543,221543,221546,0,3,3
63466,6,3,221549,221549,221552,0,3,3
63467,3,1,221552,221552,221553,0,1,0
63468,2,3,221554,221554,221557,0,3,1
63469,2,1,221556,221557,221558,1,2,0
63470,4,2,221560,221560,221562,0,2,2
63471,4,1,221564,221564,221565,0,1,2
63472,3,2,221567,221567,221569,0,2,2
63473,1,1,221568,221569,221570,1,2,0
63474,5,2,221573,221573,221575,0,2,3
63475,3,3,221576,221576,221579,0,3,1
63476,4,1,221580,221580,221581,0,1,1
63477,5,2,221585,221585,221587,0,2,4
63478,3,1,221588,221588,221589,0,1,1
63479,1,3,221589,221589,221592,0,3,0
63480,1,1,221590,221592,221593,2,3,0
63481,5,2,221595,221595,221597,0,2,2
63482,4,2,221599,221599,221601,0,2,2
63483,6,2,221605,221605,221607,0,2,4
63484,3,3,221608,221608,221611,0,3,1
63485,4,2,221612,221612,221614,0,2,1
63486,5,1,221617,221617,221618,0,1,3
63487,6,3,221623,221623,221626,0,3,5
63488,3,3,221626,221626,221629,0,3,0
63489,4,2,221630,221630,221632,0,2,1
63490,5,3,221635,221635,221638,0,3,3
63491,5,3,221640,221640,221643,0,3,2
63492,5,1,221645,221645,221646,0,1,2
63493,4,2,221649,221649,221651,0,2,3
63494,2,2,221651,221651,221653,0,2,0
63495,6,1,221657,221657,221658,0,1,4
63496,5,1,221662,221662,221663,0,1,4
63497,3,2,221665,221665,221667,0,2,2
63498,4,3,221669,221669,221672,0,3,2
63499,3,1,221672,221672,221673,0,1,0
63500,5,2,221677,221677,221679,0,2,4
63501,3,3,221680,221680,221683,0,3,1
63502,5,3,221685,221685,221688,0,3,2
63503,4,1,221689,221689,221690,0,1,1
63504,6,2,221695,221695,221697,0,2,5
63505,5,1,221700,221700,221701,0,1,3
63506,5,1,221705,221705,221706,0,1,4
63507,3,1,221708,221708,221709,0,1,2
63508,2,3,221710,221710,221713,0,3,1
63509,3,3,221713,221713,221716,0,3,0
63510,5,3,221718,221718,221721,0,3,2
63511,1,1,221719,221721,221722,2,3,0
63512,2,3,221721,221722,221725,1,4,0
63513,2,2,221723,221725,221727,2,4,0
63514,2,1,221725,221727,221728,2,3,0
63515,6,2,221731,221731,221733,0,2,3
63516,3,2,221734,221734,221736,0,2,1
63517,4,2,221738,221738,221740,0,2,2
63518,5,1,221743,221743,221744,0,1,3
63519,2,3,221745,221745,221748,0,3,1
63520,6,1,221751,221751,221752,0,1,3
63521,3,2,221754,221754,221756,0,2,2
63522,6,3,221760,221760,221763,0,3,4
63523,2,1,221762,221763,221764,1,2,0
63524,6,3,221768,221768,221771,0,3,4
63525,3,1,221771,221771,221772,0,1,0
63526,5,3,221776,221776,221779,0,3,4
63527,3,1,221779,221779,221780,0,1,0
63528,4,1,221783,221783,221784,0,1,3
63529,1,2,221784,221784,221786,0,2,0
63530,2,2,221786,221786,221788,0,2,0
63531,2,3,221788,221788,221791,0,3,0
63532,3,2,221791,221791,221793,0,2,0
63533,5,3,221796,221796,221799,0,3,3
63534,6,3,221802,221802,221805,0,3,3
63535,4,3,221806,221806,221809,0,3,1
63536,1,3,221807,221809,221812,2,5,0
63537,1,3,221808,221812,221815,4,7,0
63538,4,3,221812,221815,221818,3,6,0
63539,5,2,221817,221818,221820,1,3,0
63540,6,3,221823,221823,221826,0,3,3
63541,4,2,221827,221827,221829,0,2,1
63542,1,3,221828,221829,221832,1,4,0
63543,3,2,221831,221832,221834,1,3,0
63544,6,1,221837,221837,221838,0,1,3
63545,2,3,221839,221839,221842,0,3,1
63546,2,1,221841,221842,221843,1,2,0
63547,6,3,221847,221847,221850,0,3,4
63548,6,1,221853,221853,221854,0,1,3
63549,6,3,221859,221859,221862,0,3,5
63550,1,1,221860,221862,221863,2,3,0
63551,2,2,221862,221863,221865,1,3,0
63552,3,1,221865,221865,221866,0,1,0
63553,6,2,221871,221871,221873,0,2,5
63554,2,1,221873,221873,221874,0,1,0
63555,4,1,221877,221877,221878,0,1,3
63556,6,3,221883,221883,221886,0,3,5
63557,6,1,221889,221889,221890,0,1,3
63558,4,1,221893,221893,221894,0,1,3
63559,5,3,221898,221898,221901,0,3,4
63560,2,1,221900,221901,221902,1,2,0
63561,5,2,221905,221905,221907,0,2,3
63562,6,2,221911,221911,221913,0,2,4
63563,1,2,221912,221913,221915,1,3,0
63564,1,3,221913,221915,221918,2,5,0
63565,4,3,221917,221918,221921,1,4,0
63566,4,1,221921,221921,221922,0,1,0
63567,1,2,221922,221922,221924,0,2,0
63568,2,2,221924,221924,221926,0,2,0
63569,4,1,221928,221928,221929,0,1,2
63570,2,3,221930,221930,221933,0,3,1
63571,4,1,221934,221934,221935,0,1,1
63572,5,3,221939,221939,221942,0,3,4
63573,1,2,221940,221942,221944,2,4,0
63574,4,3,221944,221944,221947,0,3,0
63575,6,3,221950,221950,221953,0,3,3
63576,5,1,221955,221955,221956,0,1,2
63577,4,1,221959,221959,221960,0,1,3
63578,2,1,221961,221961,221962,0,1,1
63579,3,2,221964,221964,221966,0,2,2
63580,1,2,221965,221966,221968,1,3,0
63581,1,2,221966,221968,221970,2,4,0
63582,1,3,221967,221970,221973,3,6,0
63583,1,3,221968,221973,221976,5,8,0
63584,6,3,221974,221976,221979,2,5,0
63585,3,1,221977,221979,221980,2,3,0
63586,1,3,221978,221980,221983,2,5,0
63587,3,1,221981,221983,221984,2,3,0
63588,1,3,221982,221984,221987,2,5,0
63589,3,3,221985,221987,221990,2,5,0
63590,6,3,221991,221991,221994,0,3,1
63591,1,2,221992,221994,221996,2,4,0
63592,6,2,221998,221998,222000,0,2,2
63593,5,2,222003,222003,222005,0,2,3
63594,2,2,222005,222005,222007,0,2,0
63595,3,2,222008,222008,222010,0,2,1
63596,6,2,222014,222014,222016,0,2,4
63597,4,2,222018,222018,222020,0,2,2
63598,5,3,222023,222023,222026,0,3,3
63599,5,2,222028,222028,222030,0,2,2
63600,2,1,222030,222030,222031,0,1,0
63601,1,3,222031,222031,222034,0,3,0
63602,4,1,222035,222035,222036,0,1,1
63603,3,3,222038,222038,222041,0,3,2
63604,4,1,222042,222042,222043,0,1,1
63605,5,3,222047,222047,222050,0,3,4
63606,1,3,222048,222050,222053,2,5,0
63607,3,2,222051,222053,222055,2,4,0
63608,2,1,222053,222055,222056,2,3,0
63609,5,3,222058,222058,222061,0,3,2
63610,5,1,222063,222063,222064,0,1,2
63611,1,1,222064,222064,222065,0,1,0
63612,6,3,222070,222070,222073,0,3,5
63613,3,3,222073,222073,222076,0,3,0
63614,6,1,222079,222079,222080,0,1,3
63615,4,1,222083,222083,222084,0,1,3
63616,6,3,222089,222089,222092,0,3,5
63617,3,1,222092,222092,222093,0,1,0
63618,4,1,222096,222096,222097,0,1,3
63619,5,2,222101,222101,222103,0,2,4
63620,1,1,222102,222103,222104,1,2,0
63621,5,1,222107,222107,222108,0,1,3
63622,1,3,222108,222108,222111,0,3,0
63623,5,3,222113,222113,222116,0,3,2
63624,3,2,222116,222116,222118,0,2,0
63625,4,1,222120,222120,222121,0,1,2
63626,6,1,222126,222126,222127,0,1,5
63627,1,1,222127,222127,222128,0,1,0
63628,5,1,222132,222132,222133,0,1,4
63629,2,3,222134,222134,222137,0,3,1
63630,2,2,222136,222137,222139,1,3,0
63631,4,2,222140,222140,222142,0,2,1
63632,2,2,222142,222142,222144,0,2,0
63633,5,1,222147,222147,222148,0,1,3
63634,4,1,222151,222151,222152,0,1,3
63635,2,3,222153,222153,222156,0,3,1
63636,1,1,222154,222156,222157,2,3,0
63637,4,2,222158,222158,222160,0,2,1
63638,3,1,222161,222161,222162,0,1,1
63639,3,3,222164,222164,222167,0,3,2
63640,4,1,222168,222168,222169,0,1,1
63641,6,2,222174,222174,222176,0,2,5
63642,6,2,222180,222180,222182,0,2,4
63643,4,1,222184,222184,222185,0,1,2
63644,6,3,222190,222190,222193,0,3,5
63645,2,2,222192,222193,222195,1,3,0
63646,4,2,222196,222196,222198,0,2,1
63647,6,2,222202,222202,222204,0,2,4
63648,3,2,222205,222205,222207,0,2,1
63649,2,3,222207,222207,222210,0,3,0
63650,3,1,222210,222210,222211,0,1,0
63651,5,2,222215,222215,222217,0,2,4
63652,5,3,222220,222220,222223,0,3,3
63653,2,2,222222,222223,222225,1,3,0
63654,6,1,222228,222228,222229,0,1,3
63655,5,3,222233,222233,222236,0,3,4
63656,6,3,222239,222239,222242,0,3,3
63657,2,1,222241,222242,222243,1,2,0
63658,2,3,222243,222243,222246,0,3,0
63659,1,3,222244,222246,222249,2,5,0
63660,3,3,222247,222249,222252,2,5,0
63661,1,1,222248,222252,222253,4,5,0
63662,1,2,222249,222253,222255,4,6,0
63663,6,1,222255,222255,222256,0,1,0
63664,6,2,222261,222261,222263,0,2,5
63665,3,3,222264,222264,222267,0,3,1
63666,3,3,222267,222267,222270,0,3,0
63667,6,3,222273,222273,222276,0,3,3
63668,2,2,222275,222276,222278,1,3,0
63669,2,3,222277,222278,222281,1,4,0
63670,2,3,222279,222281,222284,2,5,0
63671,1,3,222280,222284,222287,4,7,0
63672,6,2,222286,222287,222289,1,3,0
63673,3,1,222289,222289,222290,0,1,0
63674,5,2,222294,222294,222296,0,2,4
63675,5,1,222299,222299,222300,0,1,3
63676,2,1,222301,222301,222302,0,1,1
63677,5,3,222306,222306,222309,0,3,4
63678,3,3,222309,222309,222312,0,3,0
63679,3,3,222312,222312,222315,0,3,0
63680,6,3,222318,222318,222321,0,3,3
63681,5,1,222323,222323,222324,0,1,2
63682,3,2,222326,222326,222328,0,2,2
63683,4,2,222330,222330,222332,0,2,2
63684,4,3,222334,222334,222337,0,3,2
63685,6,2,222340,222340,222342,0,2,3
63686,3,2,222343,222343,222345,0,2,1
63687,5,3,222348,222348,222351,0,3,3
63688,6,2,222354,222354,222356,0,2,3
63689,3,3,222357,222357,222360,0,3,1
63690,1,3,222358,222360,222363,2,5,0
63691,5,2,222363,222363,222365,0,2,0
63692,4,2,222367,222367,222369,0,2,2
63693,3,2,222370,222370,222372,0,2,1
63694,3,1,222373,222373,222374,0,1,1
63695,4,3,222377,222377,222380,0,3,3
63696,2,3,222379,222380,222383,1,4,0
63697,2,1,222381,222383,222384,2,3,0
63698,1,1,222382,222384,222385,2,3,0
63699,3,3,222385,222385,222388,0,3,0
63700,6,2,222391,222391,222393,0,2,3
63701,6,2,222397,222397,222399,0,2,4
63702,1,3,222398,222399,222402,1,4,0
63703,1,2,222399,222402,222404,3,5,0
63704,3,2,222402,222404,222406,2,4,0
63705,3,3,222405,222406,222409,1,4,0
63706,4,3,222409,222409,222412,0,3,0
63707,3,2,222412,222412,222414,0,2,0
63708,4,3,222416,222416,222419,0,3,2
63709,1,1,222417,222419,222420,2,3,0
63710,6,2,222423,222423,222425,0,2,3
63711,4,1,222427,222427,222428,0,1,2
63712,2,3,222429,222429,222432,0,3,1
63713,4,2,222433,222433,222435,0,2,1
63714,3,1,222436,222436,222437,0,1,1
63715,1,2,222437,222437,222439,0,2,0
63716,3,1,222440,222440,222441,0,1,1
63717,3,1,222443,222443,222444,0,1,2
63718,6,2,222449,222449,222451,0,2,5
63719,5,3,222454,222454,222457,0,3,3
63720,6,1,222460,222460,222461,0,1,3
63721,3,1,222463,222463,222464,0,1,2
63722,3,1,222466,222466,222467,0,1,2
63723,3,2,222469,222469,222471,0,2,2
63724,2,1,222471,222471,222472,0,1,0
63725,1,1,222472,222472,222473,0,1,0
63726,5,2,222477,222477,222479,0,2,4
63727,5,1,222482,222482,222483,0,1,3
63728,1,2,222483,222483,222485,0,2,0
63729,5,3,222488,222488,222491,0,3,3
63730,6,2,222494,222494,222496,0,2,3
63731,1,1,222495,222496,222497,1,2,0
63732,4,1,222499,222499,222500,0,1,2
63733,2,2,222501,222501,222503,0,2,1
63734,5,1,222506,222506,222507,0,1,3
63735,2,1,222508,222508,222509,0,1,1
63736,5,1,222513,222513,222514,0,1,4
63737,6,3,222519,222519,222522,0,3,5
63738,4,2,222523,222523,222525,0,2,1
63739,3,1,222526,222526,222527,0,1,1
63740,4,2,222530,222530,222532,0,2,3
63741,6,3,222536,222536,222539,0,3,4
63742,1,3,222537,222539,222542,2,5,0
63743,3,3,222540,222542,222545,2,5,0
63744,1,2,222541,222545,222547,4,6,0
63745,4,3,222545,222547,222550,2,5,0
63746,5,1,222550,222550,222551,0,1,0
63747,3,3,222553,222553,222556,0,3,2
63748,2,2,222555,222556,222558,1,3,0
63749,2,2,222557,222558,222560,1,3,0
63750,2,1,222559,222560,222561,1,2,0
63751,1,1,222560,222561,222562,1,2,0
63752,4,3,222564,222564,222567,0,3,2
63753,6,3,222570,222570,222573,0,3,3
63754,3,1,222573,222573,222574,0,1,0
63755,6,3,222579,222579,222582,0,3,5
63756,3,3,222582,222582,222585,0,3,0
63757,5,1,222587,222587,222588,0,1,2
63758,6,3,222593,222593,222596,0,3,5
63759,4,3,222597,222597,222600,0,3,1
63760,4,1,222601,222601,222602,0,1,1
63761,1,3,222602,222602,222605,0,3,0
63762,1,2,222603,222605,222607,2,4,0
63763,1,3,222604,222607,222610,3,6,0
63764,4,3,222608,222610,222613,2,5,0
63765,4,2,222612,222613,222615,1,3,0
63766,1,3,222613,222615,222618,2,5,0
63767,3,3,222616,222618,222621,2,5,0
63768,2,1,222618,222621,222622,3,4,0
63769,4,1,222622,222622,222623,0,1,0
63770,6,2,222628,222628,222630,0,2,5
63771,4,2,222632,222632,222634,0,2,2
63772,1,3,222633,222634,222637,1,4,0
63773,5,1,222638,222638,222639,0,1,1
63774,2,1,222640,222640,222641,0,1,1
63775,5,2,222645,222645,222647,0,2,4
63776,5,2,222650,222650,222652,0,2,3
63777,2,2,222652,222652,222654,0,2,0
63778,5,3,222657,222657,222660,0,3,3
63779,1,2,222658,222660,222662,2,4,0
63780,1,1,222659,222662,222663,3,4,0
63781,4,2,222663,222663,222665,0,2,0
63782,2,2,222665,222665,222667,0,2,0
63783,6,3,222671,222671,222674,0,3,4
63784,3,1,222674,222674,222675,0,1,0
63785,5,3,222679,222679,222682,0,3,4
63786,2,3,222681,222682,222685,1,4,0
63787,3,1,222684,222685,222686,1,2,0
63788,2,2,222686,222686,222688,0,2,0
63789,3,1,222689,222689,222690,0,1,1
63790,5,2,222694,222694,222696,0,2,4
63791,1,2,222695,222696,222698,1,3,0
63792,5,3,222700,222700,222703,0,3,2
63793,1,2,222701,222703,222705,2,4,0
63794,2,1,222703,222705,222706,2,3,0
63795,3,2,222706,222706,222708,0,2,0
63796,5,1,222711,222711,222712,0,1,3
63797,4,2,222715,222715,222717,0,2,3
63798,6,3,222721,222721,222724,0,3,4
63799,3,2,222724,222724,222726,0,2,0
63800,2,2,222726,222726,222728,0,2,0
63801,6,3,222732,222732,222735,0,3,4
63802,4,3,222736,222736,222739,0,3,1
63803,1,3,222737,222739,222742,2,5,0
63804,3,2,222740,222742,222744,2,4,0
63805,5,1,222745,222745,222746,0,1,1
63806,5,3,222750,222750,222753,0,3,4
63807,5,2,222755,222755,222757,0,2,2
63808,4,3,222759,222759,222762,0,3,2
63809,4,1,222763,222763,222764,0,1,1
63810,5,2,222768,222768,222770,0,2,4
63811,2,1,222770,222770,222771,0,1,0
63812,6,2,222776,222776,222778,0,2,5
63813,1,3,222777,222778,222781,1,4,0
63814,3,2,222780,222781,222783,1,3,0
63815,5,3,222785,222785,222788,0,3,2
63816,2,3,222787,222788,222791,1,4,0
63817,6,1,222793,222793,222794,0,1,2
63818,3,2,222796,222796,222798,0,2,2
63819,4,3,222800,222800,222803,0,3,2
63820,5,2,222805,222805,222807,0,2,2
63821,1,1,222806,222807,222808,1,2,0
63822,6,1,222812,222812,222813,0,1,4
63823,5,3,222817,222817,222820,0,3,4
63824,6,1,222823,222823,222824,0,1,3
63825,4,3,222827,222827,222830,0,3,3
63826,5,3,222832,222832,222835,0,3,2
63827,5,1,222837,222837,222838,0,1,2
63828,5,2,222842,222842,222844,0,2,4
63829,1,3,222843,222844,222847,1,4,0
63830,3,2,222846,222847,222849,1,3,0
63831,6,2,222852,222852,222854,0,2,3
63832,1,3,222853,222854,222857,1,4,0
63833,4,3,222857,222857,222860,0,3,0
63834,6,3,222863,222863,222866,0,3,3
63835,4,2,222867,222867,222869,0,2,1
63836,5,1,222872,222872,222873,0,1,3
63837,3,3,222875,222875,222878,0,3,2
63838,4,1,222879,222879,222880,0,1,1
63839,2,3,222881,222881,222884,0,3,1
63840,2,3,222883,222884,222887,1,4,0
63841,2,2,222885,222887,222889,2,4,0
63842,4,3,222889,222889,222892,0,3,0
63843,4,3,222893,222893,222896,0,3,1
63844,2,3,222895,222896,222899,1,4,0
63845,4,1,222899,222899,222900,0,1,0
63846,1,1,222900,222900,222901,0,1,0
63847,1,3,222901,222901,222904,0,3,0
63848,5,3,222906,222906,222909,0,3,2
63849,5,2,222911,222911,222913,0,2,2
63850,6,3,222917,222917,222920,0,3,4
63851,3,1,222920,222920,222921,0,1,0
63852,1,3,222921,222921,222924,0,3,0
63853,2,1,222923,222924,222925,1,2,0
63854,2,1,222925,222925,222926,0,1,0
63855,1,3,222926,222926,222929,0,3,0
63856,4,1,222930,222930,222931,0,1,1
63857,5,1,222935,222935,222936,0,1,4
63858,6,1,222941,222941,222942,0,1,5
63859,1,2,222942,222942,222944,0,2,0
63860,3,2,222945,222945,222947,0,2,1
63861,6,2,222951,222951,222953,0,2,4
63862,6,3,222957,222957,222960,0,3,4
63863,2,1,222959,222960,222961,1,2,0
63864,6,2,222965,222965,222967,0,2,4
63865,1,2,222966,222967,222969,1,3,0
63866,4,3,222970,222970,222973,0,3,1
63867,5,3,222975,222975,222978,0,3,2
63868,6,2,222981,222981,222983,0,2,3
63869,6,2,222987,222987,222989,0,2,4
63870,6,3,222993,222993,222996,0,3,4
63871,3,3,222996,222996,222999,0,3,0
63872,2,2,222998,222999,223001,1,3,0
63873,1,2,222999,223001,223003,2,4,0
63874,2,2,223001,223003,223005,2,4,0
63875,3,3,223004,223005,223008,1,4,0
63876,1,1,223005,223008,223009,3,4,0
63877,4,1,223009,223009,223010,0,1,0
63878,3,2,223012,223012,223014,0,2,2
63879,5,1,223017,223017,223018,0,1,3
63880,1,3,223018,223018,223021,0,3,0
63881,4,2,223022,223022,223024,0,2,1
63882,1,2,223023,223024,223026,1,3,0
63883,3,3,223026,223026,223029,0,3,0
63884,1,2,223027,223029,223031,2,4,0
63885,2,2,223029,223031,223033,2,4,0
63886,1,2,223030,223033,223035,3,5,0
63887,4,2,223034,223035,223037,1,3,0
63888,5,2,223039,223039,223041,0,2,2
63889,1,3,223040,223041,223044,1,4,0
63890,3,3,223043,223044,223047,1,4,0
63891,4,1,223047,223047,223048,0,1,0
63892,2,2,223049,223049,223051,0,2,1
63893,4,2,223053,223053,223055,0,2,2
63894,3,2,223056,223056,223058,0,2,1
63895,4,2,223060,223060,223062,0,2,2
63896,2,1,223062,223062,223063,0,1,0
63897,1,3,223063,223063,223066,0,3,0
63898,1,1,223064,223066,223067,2,3,0
63899,2,1,223066,223067,223068,1,2,0
63900,6,3,223072,223072,223075,0,3,4
63901,4,2,223076,223076,223078,0,2,1
63902,6,3,223082,223082,223085,0,3,4
63903,1,1,223083,223085,223086,2,3,0
63904,3,1,223086,223086,223087,0,1,0
63905,2,3,223088,223088,223091,0,3,1
63906,1,1,223089,223091,223092,2,3,0
63907,5,1,223094,223094,223095,0,1,2
63908,5,1,223099,223099,223100,0,1,4
63909,2,1,223101,223101,223102,0,1,1
63910,1,3,223102,223102,223105,0,3,0
63911,3,3,223105,223105,223108,0,3,0
63912,4,2,223109,223109,223111,0,2,1
63913,4,3,223113,223113,223116,0,3,2
63914,3,3,223116,223116,223119,0,3,0
63915,6,2,223122,223122,223124,0,2,3
63916,1,3,223123,223124,223127,1,4,0
63917,3,1,223126,223127,223128,1,2,0
63918,4,1,223130,223130,223131,0,1,2
63919,2,1,223132,223132,223133,0,1,1
63920,6,1,223138,223138,223139,0,1,5
63921,3,3,223141,223141,223144,0,3,2
63922,3,3,223144,223144,223147,0,3,0
63923,5,2,223149,223149,223151,0,2,2
63924,5,2,223154,223154,223156,0,2,3
63925,3,2,223157,223157,223159,0,2,1
63926,2,3,223159,223159,223162,0,3,0
63927,2,1,223161,223162,223163,1,2,0
63928,2,1,223163,223163,223164,0,1,0
63929,2,1,223165,223165,223166,0,1,1
63930,3,3,223168,223168,223171,0,3,2
63931,2,2,223170,223171,223173,1,3,0
63932,5,1,223175,223175,223176,0,1,2
63933,1,1,223176,223176,223177,0,1,0
63934,6,1,223182,223182,223183,0,1,5
63935,6,1,223188,223188,223189,0,1,5
63936,6,3,223194,223194,223197,0,3,5
63937,4,1,223198,223198,223199,0,1,1
63938,1,1,223199,223199,223200,0,1,0
63939,5,2,223204,223204,223206,0,2,4
63940,6,1,223210,223210,223211,0,1,4
63941,6,1,223216,223216,223217,0,1,5
63942,5,1,223221,223221,223222,0,1,4
63943,3,2,223224,223224,223226,0,2,2
63944,2,3,223226,223226,223229,0,3,0
63945,3,2,223229,223229,223231,0,2,0
63946,2,1,223231,223231,223232,0,1,0
63947,5,3,223236,223236,223239,0,3,4
63948,3,2,223239,223239,223241,0,2,0
63949,5,1,223244,223244,223245,0,1,3
63950,2,3,223246,223246,223249,0,3,1
63951,5,1,223251,223251,223252,0,1,2
63952,3,2,223254,223254,223256,0,2,2
63953,5,1,223259,223259,223260,0,1,3
63954,6,2,223265,223265,223267,0,2,5
63955,1,1,223266,223267,223268,1,2,0
63956,5,2,223271,223271,223273,0,2,3
63957,6,3,223277,223277,223280,0,3,4
63958,4,1,223281,223281,223282,0,1,1
63959,1,2,223282,223282,223284,0,2,0
63960,4,2,223286,223286,223288,0,2,2
63961,6,1,223292,223292,223293,0,1,4
63962,5,3,223297,223297,223300,0,3,4
63963,5,1,223302,223302,223303,0,1,2
63964,3,3,223305,223305,223308,0,3,2
63965,2,1,223307,223308,223309,1,2,0
63966,2,2,223309,223309,223311,0,2,0
63967,2,2,223311,223311,223313,0,2,0
63968,1,2,223312,223313,223315,1,3,0
63969,6,1,223318,223318,223319,0,1,3
63970,3,1,223321,223321,223322,0,1,2
63971,6,2,223327,223327,223329,0,2,5
63972,5,2,223332,223332,223334,0,2,3
63973,5,3,223337,223337,223340,0,3,3
63974,4,2,223341,223341,223343,0,2,1
63975,5,2,223346,223346,223348,0,2,3
63976,2,1,223348,223348,223349,0,1,0
63977,4,2,223352,223352,223354,0,2,3
63978,2,3,223354,223354,223357,0,3,0
63979,6,2,223360,223360,223362,0,2,3
63980,3,2,223363,223363,223365,0,2,1
63981,4,1,223367,223367,223368,0,1,2
63982,4,3,223371,223371,223374,0,3,3
63983,4,1,223375,223375,223376,0,1,1
63984,4,3,223379,223379,223382,0,3,3
63985,6,2,223385,223385,223387,0,2,3
63986,5,1,223390,223390,223391,0,1,3
63987,1,3,223391,223391,223394,0,3,0
63988,3,1,223394,223394,223395,0,1,0
63989,4,1,223398,223398,223399,0,1,3
63990,4,3,223402,223402,223405,0,3,3
63991,2,3,223404,223405,223408,1,4,0
63992,3,2,223407,223408,223410,1,3,0
63993,3,3,223410,223410,223413,0,3,0
63994,5,2,223415,223415,223417,0,2,2
63995,1,1,223416,223417,223418,1,2,0
63996,1,1,223417,223418,223419,1,2,0
63997,4,1,223421,223421,223422,0,1,2
63998,6,1,223427,223427,223428,0,1,5
63999,1,2,223428,223428,223430,0,2,0
64000,5,3,223433,223433,223436,0,3,3
64001,1,1,223434,223436,223437,2,3,0
64002,2,1,223436,223437,223438,1,2,0
64003,5,3,223441,223441,223444,0,3,3
64004,4,3,223445,223445,223448,0,3,1
64005,2,1,223447,223448,223449,1,2,0
64006,1,1,223448,223449,223450,1,2,0
64007,5,1,223453,223453,223454,0,1,3
64008,1,3,223454,223454,223457,0,3,0
64009,4,1,223458,223458,223459,0,1,1
64010,2,1,223460,223460,223461,0,1,1
64011,1,2,223461,223461,223463,0,2,0
64012,3,2,223464,223464,223466,0,2,1
64013,3,2,223467,223467,223469,0,2,1
64014,2,3,223469,223469,223472,0,3,0
64015,4,2,223473,223473,223475,0,2,1
64016,4,1,223477,223477,223478,0,1,2
64017,2,3,223479,223479,223482,0,3,1
64018,2,3,223481,223482,223485,1,4,0
64019,3,1,223484,223485,223486,1,2,0
64020,3,2,223487,223487,223489,0,2,1
64021,6,2,223493,223493,223495,0,2,4
64022,3,2,223496,223496,223498,0,2,1
64023,3,3,223499,223499,223502,0,3,1
64024,5,2,223504,223504,223506,0,2,2
64025,1,2,223505,223506,223508,1,3,0
64026,1,3,223506,223508,223511,2,5,0
64027,3,1,223509,223511,223512,2,3,0
64028,2,3,223511,223512,223515,1,4,0
64029,4,2,223515,223515,223517,0,2,0
64030,6,2,223521,223521,223523,0,2,4
64031,6,3,223527,223527,223530,0,3,4
64032,4,3,223531,223531,223534,0,3,1
64033,1,2,223532,223534,223536,2,4,0
64034,1,2,223533,223536,223538,3,5,0
64035,6,1,223539,223539,223540,0,1,1
64036,5,3,223544,223544,223547,0,3,4
64037,4,2,223548,223548,223550,0,2,1
64038,4,3,223552,223552,223555,0,3,2
64039,1,2,223553,223555,223557,2,4,0
64040,1,3,223554,223557,223560,3,6,0
64041,2,1,223556,223560,223561,4,5,0
64042,5,3,223561,223561,223564,0,3,0
64043,5,2,223566,223566,223568,0,2,2
64044,2,3,223568,223568,223571,0,3,0
64045,1,2,223569,223571,223573,2,4,0
64046,5,2,223574,223574,223576,0,2,1
64047,5,3,223579,223579,223582,0,3,3
64048,1,1,223580,223582,223583,2,3,0
64049,3,1,223583,223583,223584,0,1,0
64050,4,1,223587,223587,223588,0,1,3
64051,1,1,223588,223588,223589,0,1,0
64052,2,2,223590,223590,223592,0,2,1
64053,3,3,223593,223593,223596,0,3,1
64054,2,2,223595,223596,223598,1,3,0
64055,3,1,223598,223598,223599,0,1,0
64056,3,1,223601,223601,223602,0,1,2
64057,2,3,223603,223603,223606,0,3,1
64058,2,2,223605,223606,223608,1,3,0
64059,4,1,223609,223609,223610,0,1,1
64060,1,2,223610,223610,223612,0,2,0
64061,2,2,223612,223612,223614,0,2,0
64062,6,3,223618,223618,223621,0,3,4
64063,6,1,223624,223624,223625,0,1,3
64064,4,1,223628,223628,223629,0,1,3
64065,1,3,223629,223629,223632,0,3,0
64066,1,1,223630,223632,223633,2,3,0
64067,4,1,223634,223634,223635,0,1,1
64068,3,1,223637,223637,223638,0,1,2
64069,3,1,223640,223640,223641,0,1,2
64070,2,2,223642,223642,223644,0,2,1
64071,4,2,223646,223646,223648,0,2,2
64072,5,1,223651,223651,223652,0,1,3
64073,1,2,223652,223652,223654,0,2,0
64074,5,1,223657,223657,223658,0,1,3
64075,3,1,223660,223660,223661,0,1,2
64076,6,1,223666,223666,223667,0,1,5
64077,1,2,223667,223667,223669,0,2,0
64078,2,2,223669,223669,223671,0,2,0
64079,2,1,223671,223671,223672,0,1,0
64080,4,2,223675,223675,223677,0,2,3
64081,3,2,223678,223678,223680,0,2,1
64082,3,3,223681,223681,223684,0,3,1
64083,1,2,223682,223684,223686,2,4,0
64084,1,2,223683,223686,223688,3,5,0
64085,2,1,223685,223688,223689,3,4,0
64086,3,2,223688,223689,223691,1,3,0
64087,5,3,223693,223693,223696,0,3,2
64088,5,3,223698,223698,223701,0,3,2
64089,3,3,223701,223701,223704,0,3,0
64090,1,1,223702,223704,223705,2,3,0
64091,6,2,223708,223708,223710,0,2,3
64092,3,1,223711,223711,223712,0,1,1
64093,4,2,223715,223715,223717,0,2,3
64094,5,2,223720,223720,223722,0,2,3
64095,4,2,223724,223724,223726,0,2,2
64096,3,2,223727,223727,223729,0,2,1
64097,3,2,223730,223730,223732,0,2,1
64098,4,1,223734,223734,223735,0,1,2
64099,5,3,223739,223739,223742,0,3,4
64100,6,2,223745,223745,223747,0,2,3
64101,1,3,223746,223747,223750,1,4,0
64102,2,3,223748,223750,223753,2,5,0
64103,1,3,223749,223753,223756,4,7,0
64104,2,1,223751,223756,223757,5,6,0
64105,6,1,223757,223757,223758,0,1,0
64106,1,1,223758,223758,223759,0,1,0
64107,6,1,223764,223764,223765,0,1,5
64108,1,2,223765,223765,223767,0,2,0
64109,1,3,223766,223767,223770,1,4,0
64110,1,3,223767,223770,223773,3,6,0
64111,6,1,223773,223773,223774,0,1,0
64112,6,3,223779,223779,223782,0,3,5
64113,4,3,223783,223783,223786,0,3,1
64114,4,1,223787,223787,223788,0,1,1
64115,3,3,223790,223790,223793,0,3,2
64116,4,1,223794,223794,223795,0,1,1
64117,4,3,223798,223798,223801,0,3,3
64118,4,1,223802,223802,223803,0,1,1
64119,2,3,223804,223804,223807,0,3,1
64120,5,2,223809,223809,223811,0,2,2
64121,4,3,223813,223813,223816,0,3,2
64122,1,1,223814,223816,223817,2,3,0
64123,1,3,223815,223817,223820,2,5,0
64124,2,1,223817,223820,223821,3,4,0
64125,6,1,223823,223823,223824,0,1,2
64126,5,1,223828,223828,223829,0,1,4
64127,1,1,223829,223829,223830,0,1,0
64128,4,3,223833,223833,223836,0,3,3
64129,1,3,223834,223836,223839,2,5,0
64130,1,1,223835,223839,223840,4,5,0
64131,4,3,223839,223840,223843,1,4,0
64132,3,1,223842,223843,223844,1,2,0
64133,5,1,223847,223847,223848,0,1,3
64134,1,2,223848,223848,223850,0,2,0
64135,6,1,223854,223854,223855,0,1,4
64136,2,1,223856,223856,223857,0,1,1
64137,5,1,223861,223861,223862,0,1,4
64138,4,3,223865,223865,223868,0,3,3
64139,1,2,223866,223868,223870,2,4,0
64140,6,1,223872,223872,223873,0,1,2
64141,3,2,223875,223875,223877,0,2,2
64142,3,1,223878,223878,223879,0,1,1
64143,3,1,223881,223881,223882,0,1,2
64144,5,3,223886,223886,223889,0,3,4
64145,1,2,223887,223889,223891,2,4,0
64146,2,3,223889,223891,223894,2,5,0
64147,1,2,223890,223894,223896,4,6,0
64148,1,3,223891,223896,223899,5,8,0
64149,4,3,223895,223899,223902,4,7,0
64150,5,2,223900,223902,223904,2,4,0
64151,5,3,223905,223905,223908,0,3,1
64152,6,3,223911,223911,223914,0,3,3
64153,1,3,223912,223914,223917,2,5,0
64154,2,1,223914,223917,223918,3,4,0
64155,6,2,223920,223920,223922,0,2,2
64156,5,1,223925,223925,223926,0,1,3
64157,2,2,223927,223927,223929,0,2,1
64158,6,2,223933,223933,223935,0,2,4
64159,1,3,223934,223935,223938,1,4,0
64160,4,1,223938,223938,223939,0,1,0
64161,4,1,223942,223942,223943,0,1,3
64162,4,2,223946,223946,223948,0,2,3
64163,2,2,223948,223948,223950,0,2,0
64164,1,3,223949,223950,223953,1,4,0
64165,2,2,223951,223953,223955,2,4,0
64166,1,2,223952,223955,223957,3,5,0
64167,3,3,223955,223957,223960,2,5,0
64168,1,3,223956,223960,223963,4,7,0
64169,2,1,223958,223963,223964,5,6,0
64170,4,2,223962,223964,223966,2,4,0
64171,1,3,223963,223966,223969,3,6,0
64172,2,3,223965,223969,223972,4,7,0
64173,4,3,223969,223972,223975,3,6,0
64174,3,2,223972,223975,223977,3,5,0
64175,5,2,223977,223977,223979,0,2,0
64176,1,1,223978,223979,223980,1,2,0
64177,4,3,223982,223982,223985,0,3,2
64178,6,3,223988,223988,223991,0,3,3
64179,4,3,223992,223992,223995,0,3,1
64180,6,1,223998,223998,223999,0,1,3
64181,1,2,223999,223999,224001,0,2,0
64182,4,2,224003,224003,224005,0,2,2
64183,6,3,224009,224009,224012,0,3,4
64184,2,3,224011,224012,224015,1,4,0
64185,3,3,224014,224015,224018,1,4,0
64186,3,3,224017,224018,224021,1,4,0
64187,2,1,224019,224021,224022,2,3,0
64188,4,3,224023,224023,224026,0,3,1
64189,1,2,224024,224026,224028,2,4,0
64190,1,2,224025,224028,224030,3,5,0
64191,1,1,224026,224030,224031,4,5,0
64192,2,3,224028,224031,224034,3,6,0
64193,1,1,224029,224034,224035,5,6,0
64194,1,1,224030,224035,224036,5,6,0
64195,1,1,224031,224036,224037,5,6,0
64196,2,3,224033,224037,224040,4,7,0
64197,2,1,224035,224040,224041,5,6,0
64198,1,1,224036,224041,224042,5,6,0
64199,5,1,224041,224042,224043,1,2,0
64200,4,1,224045,224045,224046,0,1,2
64201,2,2,224047,224047,224049,0,2,1
64202,2,3,224049,224049,224052,0,3,0
64203,2,3,224051,224052,224055,1,4,0
64204,2,1,224053,224055,224056,2,3,0
64205,1,1,224054,224056,224057,2,3,0
64206,1,1,224055,224057,224058,2,3,0
64207,1,2,224056,224058,224060,2,4,0
64208,2,2,224058,224060,224062,2,4,0
64209,4,3,224062,224062,224065,0,3,0
64210,4,1,224066,224066,224067,0,1,1
64211,6,3,224072,224072,224075,0,3,5
64212,5,3,224077,224077,224080,0,3,2
64213,3,3,224080,224080,224083,0,3,0
64214,1,2,224081,224083,224085,2,4,0
64215,5,3,224086,224086,224089,0,3,1
64216,3,2,224089,224089,224091,0,2,0
64217,5,1,224094,224094,224095,0,1,3
64218,2,1,224096,224096,224097,0,1,1
64219,3,2,224099,224099,224101,0,2,2
64220,5,2,224104,224104,224106,0,2,3
64221,1,1,224105,224106,224107,1,2,0
64222,5,3,224110,224110,224113,0,3,3
64223,2,3,224112,224113,224116,1,4,0
64224,6,2,224118,224118,224120,0,2,2
64225,3,2,224121,224121,224123,0,2,1
64226,5,3,224126,224126,224129,0,3,3
64227,1,3,224127,224129,224132,2,5,0
64228,2,2,224129,224132,224134,3,5,0
64229,4,3,224133,224134,224137,1,4,0
64230,3,2,224136,224137,224139,1,3,0
64231,1,1,224137,224139,224140,2,3,0
64232,3,1,224140,224140,224141,0,1,0
64233,3,1,224143,224143,224144,0,1,2
64234,4,2,224147,224147,224149,0,2,3
64235,1,2,224148,224149,224151,1,3,0
64236,4,2,224152,224152,224154,0,2,1
64237,3,3,224155,224155,224158,0,3,1
64238,1,3,224156,224158,224161,2,5,0
64239,6,1,224162,224162,224163,0,1,1
64240,1,1,224163,224163,224164,0,1,0
64241,6,3,224169,224169,224172,0,3,5
64242,6,1,224175,224175,224176,0,1,3
64243,1,2,224176,224176,224178,0,2,0
64244,4,3,224180,224180,224183,0,3,2
64245,4,3,224184,224184,224187,0,3,1
64246,4,1,224188,224188,224189,0,1,1
64247,3,1,224191,224191,224192,0,1,2
64248,3,2,224194,224194,224196,0,2,2
64249,2,1,224196,224196,224197,0,1,0
64250,1,3,224197,224197,224200,0,3,0
64251,2,1,224199,224200,224201,1,2,0
64252,3,3,224202,224202,224205,0,3,1
64253,6,1,224208,224208,224209,0,1,3
64254,4,2,224212,224212,224214,0,2,3
64255,3,2,224215,224215,224217,0,2,1
64256,2,3,224217,224217,224220,0,3,0
64257,6,3,224223,224223,224226,0,3,3
64258,3,3,224226,224226,224229,0,3,0
64259,2,3,224228,224229,224232,1,4,0
64260,5,3,224233,224233,224236,0,3,1
64261,3,1,224236,224236,224237,0,1,0
64262,1,3,224237,224237,224240,0,3,0
64263,3,1,224240,224240,224241,0,1,0
64264,1,1,224241,224241,224242,0,1,0
64265,6,1,224247,224247,224248,0,1,5
64266,3,1,224250,224250,224251,0,1,2
64267,2,3,224252,224252,224255,0,3,1
64268,2,3,224254,224255,224258,1,4,0
64269,4,2,224258,224258,224260,0,2,0
64270,6,3,224264,224264,224267,0,3,4
64271,6,1,224270,224270,224271,0,1,3
64272,1,2,224271,224271,224273,0,2,0
64273,3,2,224274,224274,224276,0,2,1
64274,2,3,224276,224276,224279,0,3,0
64275,5,2,224281,224281,224283,0,2,2
64276,6,2,224287,224287,224289,0,2,4
64277,2,1,224289,224289,224290,0,1,0
64278,6,3,224295,224295,224298,0,3,5
64279,4,2,224299,224299,224301,0,2,1
64280,5,3,224304,224304,224307,0,3,3
64281,3,1,224307,224307,224308,0,1,0
64282,5,3,224312,224312,224315,0,3,4
64283,5,2,224317,224317,224319,0,2,2
64284,6,1,224323,224323,224324,0,1,4
64285,3,2,224326,224326,224328,0,2,2
64286,1,3,224327,224328,224331,1,4,0
64287,3,1,224330,224331,224332,1,2,0
64288,1,2,224331,224332,224334,1,3,0
64289,4,1,224335,224335,224336,0,1,1
64290,6,1,224341,224341,224342,0,1,5
64291,3,2,224344,224344,224346,0,2,2
64292,2,2,224346,224346,224348,0,2,0
64293,1,1,224347,224348,224349,1,2,0
64294,4,3,224351,224351,224354,0,3,2
64295,5,2,224356,224356,224358,0,2,2
64296,5,3,224361,224361,224364,0,3,3
64297,6,1,224367,224367,224368,0,1,3
64298,2,3,224369,224369,224372,0,3,1
64299,2,1,224371,224372,224373,1,2,0
64300,3,3,224374,224374,224377,0,3,1
64301,5,3,224379,224379,224382,0,3,2
64302,5,2,224384,224384,224386,0,2,2
64303,1,1,224385,224386,224387,1,2,0
64304,4,1,224389,224389,224390,0,1,2
64305,6,2,224395,224395,224397,0,2,5
64306,5,2,224400,224400,224402,0,2,3
64307,4,1,224404,224404,224405,0,1,2
64308,5,3,224409,224409,224412,0,3,4
64309,2,3,224411,224412,224415,1,4,0
64310,5,1,224416,224416,224417,0,1,1
64311,2,2,224418,224418,224420,0,2,1
64312,4,3,224422,224422,224425,0,3,2
64313,4,2,224426,224426,224428,0,2,1
64314,1,2,224427,224428,224430,1,3,0
64315,4,3,224431,224431,224434,0,3,1
64316,6,3,224437,224437,224440,0,3,3
64317,6,2,224443,224443,224445,0,2,3
64318,1,3,224444,224445,224448,1,4,0
64319,3,1,224447,224448,224449,1,2,0
64320,3,1,224450,224450,224451,0,1,1
64321,5,3,224455,224455,224458,0,3,4
64322,4,3,224459,224459,224462,0,3,1
64323,2,3,224461,224462,224465,1,4,0
64324,5,3,224466,224466,224469,0,3,1
64325,2,1,224468,224469,224470,1,2,0
64326,1,1,224469,224470,224471,1,2,0
64327,5,1,224474,224474,224475,0,1,3
64328,6,3,224480,224480,224483,0,3,5
64329,1,3,224481,224483,224486,2,5,0
64330,6,2,224487,224487,224489,0,2,1
64331,1,3,224488,224489,224492,1,4,0
64332,3,1,224491,224492,224493,1,2,0
64333,5,3,224496,224496,224499,0,3,3
64334,3,2,224499,224499,224501,0,2,0
64335,6,2,224505,224505,224507,0,2,4
64336,5,3,224510,224510,224513,0,3,3
64337,4,2,224514,224514,224516,0,2,1
64338,1,2,224515,224516,224518,1,3,0
64339,5,2,224520,224520,224522,0,2,2
64340,6,3,224526,224526,224529,0,3,4
64341,6,1,224532,224532,224533,0,1,3
64342,4,2,224536,224536,224538,0,2,3
64343,6,1,224542,224542,224543,0,1,4
64344,3,2,224545,224545,224547,0,2,2
64345,3,2,224548,224548,224550,0,2,1
64346,1,1,224549,224550,224551,1,2,0
64347,5,3,224554,224554,224557,0,3,3
64348,3,2,224557,224557,224559,0,2,0
64349,4,3,224561,224561,224564,0,3,2
64350,3,2,224564,224564,224566,0,2,0
64351,6,3,224570,224570,224573,0,3,4
64352,3,3,224573,224573,224576,0,3,0
64353,4,2,224577,224577,224579,0,2,1
64354,2,1,224579,224579,224580,0,1,0
64355,1,3,224580,224580,224583,0,3,0
64356,3,1,224583,224583,224584,0,1,0
64357,6,2,224589,224589,224591,0,2,5
64358,1,1,224590,224591,224592,1,2,0
64359,4,1,224594,224594,224595,0,1,2
64360,4,3,224598,224598,224601,0,3,3
64361,2,3,224600,224601,224604,1,4,0
64362,6,3,224606,224606,224609,0,3,2
64363,1,2,224607,224609,224611,2,4,0
64364,2,1,224609,224611,224612,2,3,0
64365,5,1,224614,224614,224615,0,1,2
64366,1,3,224615,224615,224618,0,3,0
64367,2,2,224617,224618,224620,1,3,0
64368,2,3,224619,224620,224623,1,4,0
64369,5,3,224624,224624,224627,0,3,1
64370,4,1,224628,224628,224629,0,1,1
64371,5,2,224633,224633,224635,0,2,4
64372,2,3,224635,224635,224638,0,3,0
64373,1,2,224636,224638,224640,2,4,0
64374,5,3,224641,224641,224644,0,3,1
64375,2,1,224643,224644,224645,1,2,0
64376,1,1,224644,224645,224646,1,2,0
64377,1,2,224645,224646,224648,1,3,0
64378,6,1,224651,224651,224652,0,1,3
64379,6,2,224657,224657,224659,0,2,5
64380,5,3,224662,224662,224665,0,3,3
64381,4,1,224666,224666,224667,0,1,1
64382,3,2,224669,224669,224671,0,2,2
64383,6,3,224675,224675,224678,0,3,4
64384,4,2,224679,224679,224681,0,2,1
64385,5,3,224684,224684,224687,0,3,3
64386,3,2,224687,224687,224689,0,2,0
64387,4,2,224691,224691,224693,0,2,2
64388,6,1,224697,224697,224698,0,1,4
64389,5,2,224702,224702,224704,0,2,4
64390,1,2,224703,224704,224706,1,3,0
64391,2,3,224705,224706,224709,1,4,0
64392,5,1,224710,224710,224711,0,1,1
64393,2,2,224712,224712,224714,0,2,1
64394,1,3,224713,224714,224717,1,4,0
64395,6,2,224719,224719,224721,0,2,2
64396,6,2,224725,224725,224727,0,2,4
64397,6,1,224731,224731,224732,0,1,4
64398,3,2,224734,224734,224736,0,2,2
64399,3,3,224737,224737,224740,0,3,1
64400,3,1,224740,224740,224741,0,1,0
64401,6,2,224746,224746,224748,0,2,5
64402,2,2,224748,224748,224750,0,2,0
64403,3,2,224751,224751,224753,0,2,1
64404,6,3,224757,224757,224760,0,3,4
64405,5,3,224762,224762,224765,0,3,2
64406,3,2,224765,224765,224767,0,2,0
64407,3,3,224768,224768,224771,0,3,1
64408,2,3,224770,224771,224774,1,4,0
64409,2,1,224772,224774,224775,2,3,0
64410,3,2,224775,224775,224777,0,2,0
64411,2,1,224777,224777,224778,0,1,0
64412,3,3,224780,224780,224783,0,3,2
64413,4,2,224784,224784,224786,0,2,1
64414,6,1,224790,224790,224791,0,1,4
64415,6,2,224796,224796,224798,0,2,5
64416,1,3,224797,224798,224801,1,4,0
64417,2,1,224799,224801,224802,2,3,0
64418,6,1,224805,224805,224806,0,1,3
64419,1,2,224806,224806,224808,0,2,0
64420,1,2,224807,224808,224810,1,3,0
64421,2,1,224809,224810,224811,1,2,0
64422,6,1,224815,224815,224816,0,1,4
64423,1,3,224816,224816,224819,0,3,0
64424,3,1,224819,224819,224820,0,1,0
64425,4,3,224823,224823,224826,0,3,3
64426,3,1,224826,224826,224827,0,1,0
64427,3,2,224829,224829,224831,0,2,2
64428,5,3,224834,224834,224837,0,3,3
64429,2,2,224836,224837,224839,1,3,0
64430,4,2,224840,224840,224842,0,2,1
64431,5,2,224845,224845,224847,0,2,3
64432,2,1,224847,224847,224848,0,1,0
64433,2,2,224849,224849,224851,0,2,1
64434,2,2,224851,224851,224853,0,2,0
64435,1,1,224852,224853,224854,1,2,0
64436,3,2,224855,224855,224857,0,2,1
64437,1,3,224856,224857,224860,1,4,0
64438,5,1,224861,224861,224862,0,1,1
64439,2,2,224863,224863,224865,0,2,1
64440,6,3,224869,224869,224872,0,3,4
64441,5,2,224874,224874,224876,0,2,2
64442,2,3,224876,224876,224879,0,3,0
64443,6,1,224882,224882,224883,0,1,3
64444,3,2,224885,224885,224887,0,2,2
64445,1,1,224886,224887,224888,1,2,0
64446,1,1,224887,224888,224889,1,2,0
64447,6,1,224893,224893,224894,0,1,4
64448,3,2,224896,224896,224898,0,2,2
64449,6,2,224902,224902,224904,0,2,4
64450,2,1,224904,224904,224905,0,1,0
64451,3,1,224907,224907,224908,0,1,2
64452,5,3,224912,224912,224915,0,3,4
64453,5,2,224917,224917,224919,0,2,2
64454,3,1,224920,224920,224921,0,1,1
64455,2,2,224922,224922,224924,0,2,1
64456,1,1,224923,224924,224925,1,2,0
64457,3,1,224926,224926,224927,0,1,1
64458,1,3,224927,224927,224930,0,3,0
64459,6,3,224933,224933,224936,0,3,3
64460,4,2,224937,224937,224939,0,2,1
64461,6,3,224943,224943,224946,0,3,4
64462,5,2,224948,224948,224950,0,2,2
64463,2,1,224950,224950,224951,0,1,0
64464,4,2,224954,224954,224956,0,2,3
64465,5,1,224959,224959,224960,0,1,3
64466,5,3,224964,224964,224967,0,3,4
64467,6,1,224970,224970,224971,0,1,3
64468,3,2,224973,224973,224975,0,2,2
64469,4,2,224977,224977,224979,0,2,2
64470,4,2,224981,224981,224983,0,2,2
64471,4,3,224985,224985,224988,0,3,2
64472,1,2,224986,224988,224990,2,4,0
64473,1,2,224987,224990,224992,3,5,0
64474,2,3,224989,224992,224995,3,6,0
64475,5,2,224994,224995,224997,1,3,0
64476,6,3,225000,225000,225003,0,3,3
64477,1,1,225001,225003,225004,2,3,0
64478,1,1,225002,225004,225005,2,3,0
64479,1,3,225003,225005,225008,2,5,0
64480,2,3,225005,225008,225011,3,6,0
64481,2,1,225007,225011,225012,4,5,0
64482,6,2,225013,225013,225015,0,2,1
64483,5,1,225018,225018,225019,0,1,3
64484,1,2,225019,225019,225021,0,2,0
64485,2,1,225021,225021,225022,0,1,0
64486,1,1,225022,225022,225023,0,1,0
64487,2,2,225024,225024,225026,0,2,1
64488,3,1,225027,225027,225028,0,1,1
64489,4,2,225031,225031,225033,0,2,3
64490,1,2,225032,225033,225035,1,3,0
64491,2,1,225034,225035,225036,1,2,0
64492,4,3,225038,225038,225041,0,3,2
64493,1,1,225039,225041,225042,2,3,0
64494,6,2,225045,225045,225047,0,2,3
64495,2,1,225047,225047,225048,0,1,0
64496,1,3,225048,225048,225051,0,3,0
64497,6,3,225054,225054,225057,0,3,3
64498,2,2,225056,225057,225059,1,3,0
64499,6,3,225062,225062,225065,0,3,3
64500,4,1,225066,225066,225067,0,1,1
64501,6,2,225072,225072,225074,0,2,5
64502,6,3,225078,225078,225081,0,3,4
64503,6,1,225084,225084,225085,0,1,3
64504,6,3,225090,225090,225093,0,3,5
64505,5,2,225095,225095,225097,0,2,2
64506,4,3,225099,225099,225102,0,3,2
64507,1,3,225100,225102,225105,2,5,0
64508,1,1,225101,225105,225106,4,5,0
64509,2,3,225103,225106,225109,3,6,0
64510,6,3,225109,225109,225112,0,3,0
64511,1,2,225110,225112,225114,2,4,0
64512,4,2,225114,225114,225116,0,2,0
64513,6,3,225120,225120,225123,0,3,4
64514,3,1,225123,225123,225124,0,1,0
64515,4,1,225127,225127,225128,0,1,3
64516,1,3,225128,225128,225131,0,3,0
64517,3,1,225131,225131,225132,0,1,0
64518,4,1,225135,225135,225136,0,1,3
64519,1,3,225136,225136,225139,0,3,0
64520,5,2,225141,225141,225143,0,2,2
64521,1,3,225142,225143,225146,1,4,0
64522,5,3,225147,225147,225150,0,3,1
64523,5,3,225152,225152,225155,0,3,2
64524,3,1,225155,225155,225156,0,1,0
64525,3,2,225158,225158,225160,0,2,2
64526,5,2,225163,225163,225165,0,2,3
64527,6,1,225169,225169,225170,0,1,4
64528,2,1,225171,225171,225172,0,1,1
64529,1,1,225172,225172,225173,0,1,0
64530,1,2,225173,225173,225175,0,2,0
64531,5,1,225178,225178,225179,0,1,3
64532,4,3,225182,225182,225185,0,3,3
64533,6,3,225188,225188,225191,0,3,3
64534,3,3,225191,225191,225194,0,3,0
64535,6,1,225197,225197,225198,0,1,3
64536,1,2,225198,225198,225200,0,2,0
64537,6,3,225204,225204,225207,0,3,4
64538,5,2,225209,225209,225211,0,2,2
64539,6,2,225215,225215,225217,0,2,4
64540,5,2,225220,225220,225222,0,2,3
64541,4,3,225224,225224,225227,0,3,2
64542,4,1,225228,225228,225229,0,1,1
64543,2,1,225230,225230,225231,0,1,1
64544,2,3,225232,225232,225235,0,3,1
64545,4,2,225236,225236,225238,0,2,1
64546,6,2,225242,225242,225244,0,2,4
64547,6,1,225248,225248,225249,0,1,4
64548,4,3,225252,225252,225255,0,3,3
64549,1,2,225253,225255,225257,2,4,0
64550,5,3,225258,225258,225261,0,3,1
64551,6,1,225264,225264,225265,0,1,3
64552,6,1,225270,225270,225271,0,1,5
64553,5,3,225275,225275,225278,0,3,4
64554,3,1,225278,225278,225279,0,1,0
64555,5,2,225283,225283,225285,0,2,4
64556,2,1,225285,225285,225286,0,1,0
64557,5,3,225290,225290,225293,0,3,4
64558,2,2,225292,225293,225295,1,3,0
64559,3,1,225295,225295,225296,0,1,0
64560,1,3,225296,225296,225299,0,3,0
64561,5,1,225301,225301,225302,0,1,2
64562,4,2,225305,225305,225307,0,2,3
64563,4,1,225309,225309,225310,0,1,2
64564,3,1,225312,225312,225313,0,1,2
64565,4,1,225316,225316,225317,0,1,3
64566,1,3,225317,225317,225320,0,3,0
64567,1,3,225318,225320,225323,2,5,0
64568,5,2,225323,225323,225325,0,2,0
64569,5,1,225328,225328,225329,0,1,3
64570,5,1,225333,225333,225334,0,1,4
64571,3,2,225336,225336,225338,0,2,2
64572,2,1,225338,225338,225339,0,1,0
64573,1,2,225339,225339,225341,0,2,0
64574,6,3,225345,225345,225348,0,3,4
64575,3,3,225348,225348,225351,0,3,0
64576,3,1,225351,225351,225352,0,1,0
64577,4,3,225355,225355,225358,0,3,3
64578,4,1,225359,225359,225360,0,1,1
64579,2,3,225361,225361,225364,0,3,1
64580,1,3,225362,225364,225367,2,5,0
64581,4,2,225366,225367,225369,1,3,0
64582,1,2,225367,225369,225371,2,4,0
64583,1,1,225368,225371,225372,3,4,0
64584,1,1,225369,225372,225373,3,4,0
64585,4,1,225373,225373,225374,0,1,0
64586,1,2,225374,225374,225376,0,2,0
64587,2,2,225376,225376,225378,0,2,0
64588,5,3,225381,225381,225384,0,3,3
64589,3,3,225384,225384,225387,0,3,0
64590,4,3,225388,225388,225391,0,3,1
64591,3,1,225391,225391,225392,0,1,0
64592,4,2,225395,225395,225397,0,2,3
64593,6,1,225401,225401,225402,0,1,4
64594,6,3,225407,225407,225410,0,3,5
64595,3,2,225410,225410,225412,0,2,0
64596,2,1,225412,225412,225413,0,1,0
64597,4,1,225416,225416,225417,0,1,3
64598,4,3,225420,225420,225423,0,3,3
64599,4,2,225424,225424,225426,0,2,1
64600,3,3,225427,225427,225430,0,3,1
64601,4,1,225431,225431,225432,0,1,1
64602,6,2,225437,225437,225439,0,2,5
64603,6,1,225443,225443,225444,0,1,4
64604,2,1,225445,225445,225446,0,1,1
64605,5,3,225450,225450,225453,0,3,4
64606,1,3,225451,225453,225456,2,5,0
64607,3,2,225454,225456,225458,2,4,0
64608,6,1,225460,225460,225461,0,1,2
64609,6,2,225466,225466,225468,0,2,5
64610,3,1,225469,225469,225470,0,1,1
64611,2,3,225471,225471,225474,0,3,1
64612,6,1,225477,225477,225478,0,1,3
64613,1,1,225478,225478,225479,0,1,0
64614,3,1,225481,225481,225482,0,1,2
64615,6,3,225487,225487,225490,0,3,5
64616,4,3,225491,225491,225494,0,3,1
64617,3,3,225494,225494,225497,0,3,0
64618,6,3,225500,225500,225503,0,3,3
64619,3,1,225503,225503,225504,0,1,0
64620,1,1,225504,225504,225505,0,1,0
64621,1,2,225505,225505,225507,0,2,0
64622,1,1,225506,225507,225508,1,2,0
64623,2,3,225508,225508,225511,0,3,0
64624,4,1,225512,225512,225513,0,1,1
64625,2,2,225514,225514,225516,0,2,1
64626,5,3,225519,225519,225522,0,3,3
64627,5,2,225524,225524,225526,0,2,2
64628,3,2,225527,225527,225529,0,2,1
64629,3,3,225530,225530,225533,0,3,1
64630,4,3,225534,225534,225537,0,3,1
64631,4,2,225538,225538,225540,0,2,1
64632,5,3,225543,225543,225546,0,3,3
64633,5,1,225548,225548,225549,0,1,2
64634,1,1,225549,225549,225550,0,1,0
64635,2,3,225551,225551,225554,0,3,1
64636,2,1,225553,225554,225555,1,2,0
64637,4,2,225557,225557,225559,0,2,2
64638,3,1,225560,225560,225561,0,1,1
64639,3,3,225563,225563,225566,0,3,2
64640,4,1,225567,225567,225568,0,1,1
64641,6,2,225573,225573,225575,0,2,5
64642,5,1,225578,225578,225579,0,1,3
64643,3,1,225581,225581,225582,0,1,2
64644,6,1,225587,225587,225588,0,1,5
64645,5,3,225592,225592,225595,0,3,4
64646,1,3,225593,225595,225598,2,5,0
64647,1,3,225594,225598,225601,4,7,0
64648,3,2,225597,225601,225603,4,6,0
64649,3,3,225600,225603,225606,3,6,0
64650,5,1,225605,225606,225607,1,2,0
64651,4,1,225609,225609,225610,0,1,2
64652,4,1,225613,225613,225614,0,1,3
64653,5,3,225618,225618,225621,0,3,4
64654,2,2,225620,225621,225623,1,3,0
64655,2,3,225622,225623,225626,1,4,0
64656,1,3,225623,225626,225629,3,6,0
64657,4,3,225627,225629,225632,2,5,0
64658,6,3,225633,225633,225636,0,3,1
64659,3,1,225636,225636,225637,0,1,0
64660,3,1,225639,225639,225640,0,1,2
64661,1,2,225640,225640,225642,0,2,0
64662,3,3,225643,225643,225646,0,3,1
64663,2,3,225645,225646,225649,1,4,0
64664,1,3,225646,225649,225652,3,6,0
64665,3,3,225649,225652,225655,3,6,0
64666,4,1,225653,225655,225656,2,3,0
64667,5,1,225658,225658,225659,0,1,2
64668,4,3,225662,225662,225665,0,3,3
64669,5,1,225667,225667,225668,0,1,2
64670,4,1,225671,225671,225672,0,1,3
64671,2,1,225673,225673,225674,0,1,1
64672,1,1,225674,225674,225675,0,1,0
64673,1,2,225675,225675,225677,0,2,0
64674,6,2,225681,225681,225683,0,2,4
64675,1,3,225682,225683,225686,1,4,0
64676,2,3,225684,225686,225689,2,5,0
64677,5,1,225689,225689,225690,0,1,0
64678,4,3,225693,225693,225696,0,3,3
64679,4,1,225697,225697,225698,0,1,1
64680,6,2,225703,225703,225705,0,2,5
64681,4,3,225707,225707,225710,0,3,2
64682,6,3,225713,225713,225716,0,3,3
64683,2,1,225715,225716,225717,1,2,0
64684,6,1,225721,225721,225722,0,1,4
64685,3,1,225724,225724,225725,0,1,2
64686,4,3,225728,225728,225731,0,3,3
64687,1,2,225729,225731,225733,2,4,0
64688,6,3,225735,225735,225738,0,3,2
64689,5,3,225740,225740,225743,0,3,2
64690,4,1,225744,225744,225745,0,1,1
64691,4,1,225748,225748,225749,0,1,3
64692,4,3,225752,225752,225755,0,3,3
64693,6,1,225758,225758,225759,0,1,3
64694,2,2,225760,225760,225762,0,2,1
64695,2,1,225762,225762,225763,0,1,0
64696,3,2,225765,225765,225767,0,2,2
64697,2,1,225767,225767,225768,0,1,0
64698,6,2,225773,225773,225775,0,2,5
64699,2,1,225775,225775,225776,0,1,0
64700,2,1,225777,225777,225778,0,1,1
64701,5,2,225782,225782,225784,0,2,4
64702,1,1,225783,225784,225785,1,2,0
64703,6,2,225789,225789,225791,0,2,4
64704,2,3,225791,225791,225794,0,3,0
64705,3,3,225794,225794,225797,0,3,0
64706,4,1,225798,225798,225799,0,1,1
64707,5,2,225803,225803,225805,0,2,4
64708,3,1,225806,225806,225807,0,1,1
64709,2,1,225808,225808,225809,0,1,1
64710,2,1,225810,225810,225811,0,1,1
64711,6,1,225816,225816,225817,0,1,5
64712,4,2,225820,225820,225822,0,2,3
64713,2,1,225822,225822,225823,0,1,0
64714,3,1,225825,225825,225826,0,1,2
64715,6,1,225831,225831,225832,0,1,5
64716,4,3,225835,225835,225838,0,3,3
64717,6,2,225841,225841,225843,0,2,3
64718,2,1,225843,225843,225844,0,1,0
64719,4,2,225847,225847,225849,0,2,3
64720,2,1,225849,225849,225850,0,1,0
64721,3,2,225852,225852,225854,0,2,2
64722,3,1,225855,225855,225856,0,1,1
64723,4,2,225859,225859,225861,0,2,3
64724,5,1,225864,225864,225865,0,1,3
64725,1,1,225865,225865,225866,0,1,0
64726,2,3,225867,225867,225870,0,3,1
64727,5,1,225872,225872,225873,0,1,2
64728,3,3,225875,225875,225878,0,3,2
64729,3,3,225878,225878,225881,0,3,0
64730,6,3,225884,225884,225887,0,3,3
64731,4,1,225888,225888,225889,0,1,1
64732,2,2,225890,225890,225892,0,2,1
64733,3,3,225893,225893,225896,0,3,1
64734,1,1,225894,225896,225897,2,3,0
64735,2,1,225896,225897,225898,1,2,0
64736,3,2,225899,225899,225901,0,2,1
64737,5,1,225904,225904,225905,0,1,3
64738,4,3,225908,225908,225911,0,3,3
64739,4,3,225912,225912,225915,0,3,1
64740,4,3,225916,225916,225919,0,3,1
64741,2,2,225918,225919,225921,1,3,0
64742,1,2,225919,225921,225923,2,4,0
64743,4,1,225923,225923,225924,0,1,0
64744,4,3,225927,225927,225930,0,3,3
64745,1,1,225928,225930,225931,2,3,0
64746,6,2,225934,225934,225936,0,2,3
64747,6,3,225940,225940,225943,0,3,4
64748,6,1,225946,225946,225947,0,1,3
64749,6,3,225952,225952,225955,0,3,5
64750,6,1,225958,225958,225959,0,1,3
64751,4,2,225962,225962,225964,0,2,3
64752,3,1,225965,225965,225966,0,1,1
64753,1,3,225966,225966,225969,0,3,0
64754,2,2,225968,225969,225971,1,3,0
64755,3,3,225971,225971,225974,0,3,0
64756,4,1,225975,225975,225976,0,1,1
64757,6,1,225981,225981,225982,0,1,5
64758,2,1,225983,225983,225984,0,1,1
64759,1,2,225984,225984,225986,0,2,0
64760,2,1,225986,225986,225987,0,1,0
64761,1,2,225987,225987,225989,0,2,0
64762,4,1,225991,225991,225992,0,1,2
64763,6,1,225997,225997,225998,0,1,5
64764,3,2,226000,226000,226002,0,2,2
64765,4,2,226004,226004,226006,0,2,2
64766,4,3,226008,226008,226011,0,3,2
64767,1,1,226009,226011,226012,2,3,0
64768,3,2,226012,226012,226014,0,2,0
64769,1,1,226013,226014,226015,1,2,0
64770,2,2,226015,226015,226017,0,2,0
64771,4,1,226019,226019,226020,0,1,2
64772,6,2,226025,226025,226027,0,2,5
64773,6,1,226031,226031,226032,0,1,4
64774,1,3,226032,226032,226035,0,3,0
64775,5,1,226037,226037,226038,0,1,2
64776,1,3,226038,226038,226041,0,3,0
64777,6,2,226044,226044,226046,0,2,3
64778,6,2,226050,226050,226052,0,2,4
64779,1,1,226051,226052,226053,1,2,0
64780,5,2,226056,226056,226058,0,2,3
64781,5,2,226061,226061,226063,0,2,3
64782,6,3,226067,226067,226070,0,3,4
64783,5,2,226072,226072,226074,0,2,2
64784,2,1,226074,226074,226075,0,1,0
64785,1,3,226075,226075,226078,0,3,0
64786,5,1,226080,226080,226081,0,1,2
64787,6,3,226086,226086,226089,0,3,5
64788,3,1,226089,226089,226090,0,1,0
64789,4,1,226093,226093,226094,0,1,3
64790,6,2,226099,226099,226101,0,2,5
64791,1,3,226100,226101,226104,1,4,0
64792,3,2,226103,226104,226106,1,3,0
64793,2,3,226105,226106,226109,1,4,0
64794,4,3,226109,226109,226112,0,3,0
64795,2,3,226111,226112,226115,1,4,0
64796,2,3,226113,226115,226118,2,5,0
64797,1,1,226114,226118,226119,4,5,0
64798,4,2,226118,226119,226121,1,3,0
64799,2,1,226120,226121,226122,1,2,0
64800,6,3,226126,226126,226129,0,3,4
64801,5,2,226131,226131,226133,0,2,2
64802,3,2,226134,226134,226136,0,2,1
64803,4,3,226138,226138,226141,0,3,2
64804,1,1,226139,226141,226142,2,3,0
64805,3,1,226142,226142,226143,0,1,0
64806,5,2,226147,226147,226149,0,2,4
64807,2,1,226149,226149,226150,0,1,0
64808,5,3,226154,226154,226157,0,3,4
64809,1,2,226155,226157,226159,2,4,0
64810,4,2,226159,226159,226161,0,2,0
64811,5,3,226164,226164,226167,0,3,3
64812,5,2,226169,226169,226171,0,2,2
64813,6,1,226175,226175,226176,0,1,4
64814,3,3,226178,226178,226181,0,3,2
64815,5,2,226183,226183,226185,0,2,2
64816,5,1,226188,226188,226189,0,1,3
64817,2,1,226190,226190,226191,0,1,1
64818,1,1,226191,226191,226192,0,1,0
64819,6,3,226197,226197,226200,0,3,5
64820,1,3,226198,226200,226203,2,5,0
64821,1,3,226199,226203,226206,4,7,0
64822,5,1,226204,226206,226207,2,3,0
64823,6,3,226210,226210,226213,0,3,3
64824,4,1,226214,226214,226215,0,1,1
64825,3,2,226217,226217,226219,0,2,2
64826,5,3,226222,226222,226225,0,3,3
64827,2,1,226224,226225,226226,1,2,0
64828,2,2,226226,226226,226228,0,2,0
64829,6,1,226232,226232,226233,0,1,4
64830,3,2,226235,226235,226237,0,2,2
64831,3,3,226238,226238,226241,0,3,1
64832,5,3,226243,226243,226246,0,3,2
64833,2,2,226245,226246,226248,1,3,0
64834,3,3,226248,226248,226251,0,3,0
64835,2,3,226250,226251,226254,1,4,0
64836,1,3,226251,226254,226257,3,6,0
64837,2,3,226253,226257,226260,4,7,0
64838,5,1,226258,226260,226261,2,3,0
64839,3,3,226261,226261,226264,0,3,0
64840,5,1,226266,226266,226267,0,1,2
64841,1,3,226267,226267,226270,0,3,0
64842,5,3,226272,226272,226275,0,3,2
64843,5,3,226277,226277,226280,0,3,2
64844,6,3,226283,226283,226286,0,3,3
64845,1,2,226284,226286,226288,2,4,0
64846,4,2,226288,226288,226290,0,2,0
64847,3,2,226291,226291,226293,0,2,1
64848,3,1,226294,226294,226295,0,1,1
64849,4,3,226298,226298,226301,0,3,3
64850,5,2,226303,226303,226305,0,2,2
64851,2,2,226305,226305,226307,0,2,0
64852,3,1,226308,226308,226309,0,1,1
64853,6,1,226314,226314,226315,0,1,5
64854,4,1,226318,226318,226319,0,1,3
64855,3,3,226321,226321,226324,0,3,2
64856,3,1,226324,226324,226325,0,1,0
64857,2,3,226326,226326,226329,0,3,1
64858,3,3,226329,226329,226332,0,3,0
64859,4,3,226333,226333,226336,0,3,1
64860,5,2,226338,226338,226340,0,2,2
64861,3,3,226341,226341,226344,0,3,1
64862,1,2,226342,226344,226346,2,4,0
64863,5,3,226347,226347,226350,0,3,1
64864,5,2,226352,226352,226354,0,2,2
64865,3,3,226355,226355,226358,0,3,1
64866,2,1,226357,226358,226359,1,2,0
64867,2,3,226359,226359,226362,0,3,0
64868,1,1,226360,226362,226363,2,3,0
64869,5,3,226365,226365,226368,0,3,2
64870,1,2,226366,226368,226370,2,4,0
64871,4,2,226370,226370,226372,0,2,0
64872,2,2,226372,226372,226374,0,2,0
64873,1,2,226373,226374,226376,1,3,0
64874,4,3,226377,226377,226380,0,3,1
64875,6,1,226383,226383,226384,0,1,3
64876,6,1,226389,226389,226390,0,1,5
64877,3,2,226392,226392,226394,0,2,2
64878,1,3,226393,226394,226397,1,4,0
64879,6,3,226399,226399,226402,0,3,2
64880,2,3,226401,226402,226405,1,4,0
64881,1,1,226402,226405,226406,3,4,0
64882,5,3,226407,226407,226410,0,3,1
64883,6,1,226413,226413,226414,0,1,3
64884,6,2,226419,226419,226421,0,2,5
64885,2,1,226421,226421,226422,0,1,0
64886,4,1,226425,226425,226426,0,1,3
64887,1,2,226426,226426,226428,0,2,0
64888,5,2,226431,226431,226433,0,2,3
64889,5,3,226436,226436,226439,0,3,3
64890,1,1,226437,226439,226440,2,3,0
64891,5,1,226442,226442,226443,0,1,2
64892,6,1,226448,226448,226449,0,1,5
64893,6,3,226454,226454,226457,0,3,5
64894,6,1,226460,226460,226461,0,1,3
64895,5,2,226465,226465,226467,0,2,4
64896,3,3,226468,226468,226471,0,3,1
64897,4,1,226472,226472,226473,0,1,1
64898,2,2,226474,226474,226476,0,2,1
64899,5,3,226479,226479,226482,0,3,3
64900,1,2,226480,226482,226484,2,4,0
64901,5,3,226485,226485,226488,0,3,1
64902,1,3,226486,226488,226491,2,5,0
64903,4,3,226490,226491,226494,1,4,0
64904,4,1,226494,226494,226495,0,1,0
64905,5,2,226499,226499,226501,0,2,4
64906,3,3,226502,226502,226505,0,3,1
64907,6,1,226508,226508,226509,0,1,3
64908,5,1,226513,226513,226514,0,1,4
64909,5,3,226518,226518,226521,0,3,4
64910,2,2,226520,226521,226523,1,3,0
64911,1,1,226521,226523,226524,2,3,0
64912,3,2,226524,226524,226526,0,2,0
64913,5,2,226529,226529,226531,0,2,3
64914,1,1,226530,226531,226532,1,2,0
64915,4,2,226534,226534,226536,0,2,2
64916,3,3,226537,226537,226540,0,3,1
64917,3,2,226540,226540,226542,0,2,0
64918,5,2,226545,226545,226547,0,2,3
64919,1,2,226546,226547,226549,1,3,0
64920,5,3,226551,226551,226554,0,3,2
64921,6,3,226557,226557,226560,0,3,3
64922,1,2,226558,226560,226562,2,4,0
64923,1,2,226559,226562,226564,3,5,0
64924,1,1,226560,226564,226565,4,5,0
64925,6,2,226566,226566,226568,0,2,1
64926,3,2,226569,226569,226571,0,2,1
64927,4,3,226573,226573,226576,0,3,2
64928,2,3,226575,226576,226579,1,4,0
64929,5,1,226580,226580,226581,0,1,1
64930,3,2,226583,226583,226585,0,2,2
64931,4,1,226587,226587,226588,0,1,2
64932,6,3,226593,226593,226596,0,3,5
64933,5,2,226598,226598,226600,0,2,2
64934,5,1,226603,226603,226604,0,1,3
64935,3,1,226606,226606,226607,0,1,2
64936,3,3,226609,226609,226612,0,3,2
64937,3,1,226612,226612,226613,0,1,0
64938,2,3,226614,226614,226617,0,3,1
64939,4,1,226618,226618,226619,0,1,1
64940,3,1,226621,226621,226622,0,1,2
64941,4,2,226625,226625,226627,0,2,3
64942,4,1,226629,226629,226630,0,1,2
64943,5,1,226634,226634,226635,0,1,4
64944,2,1,226636,226636,226637,0,1,1
64945,4,1,226640,226640,226641,0,1,3
64946,5,3,226645,226645,226648,0,3,4
64947,5,3,226650,226650,226653,0,3,2
64948,2,2,226652,226653,226655,1,3,0
64949,6,1,226658,226658,226659,0,1,3
64950,5,3,226663,226663,226666,0,3,4
64951,5,1,226668,226668,226669,0,1,2
64952,3,1,226671,226671,226672,0,1,2
64953,2,2,226673,226673,226675,0,2,1
64954,6,1,226679,226679,226680,0,1,4
64955,6,3,226685,226685,226688,0,3,5
64956,4,1,226689,226689,226690,0,1,1
64957,1,3,226690,226690,226693,0,3,0
64958,6,1,226696,226696,226697,0,1,3
64959,5,3,226701,226701,226704,0,3,4
64960,5,3,226706,226706,226709,0,3,2
64961,5,1,226711,226711,226712,0,1,2
64962,5,1,226716,226716,226717,0,1,4
64963,1,1,226717,226717,226718,0,1,0
64964,5,2,226722,226722,226724,0,2,4
64965,4,3,226726,226726,226729,0,3,2
64966,6,2,226732,226732,226734,0,2,3
64967,1,1,226733,226734,226735,1,2,0
64968,1,3,226734,226735,226738,1,4,0
64969,2,1,226736,226738,226739,2,3,0
64970,4,3,226740,226740,226743,0,3,1
64971,5,2,226745,226745,226747,0,2,2
64972,5,2,226750,226750,226752,0,2,3
64973,3,1,226753,226753,226754,0,1,1
64974,5,3,226758,226758,226761,0,3,4
64975,1,2,226759,226761,226763,2,4,0
64976,5,3,226764,226764,226767,0,3,1
64977,5,2,226769,226769,226771,0,2,2
64978,2,2,226771,226771,226773,0,2,0
64979,1,1,226772,226773,226774,1,2,0
64980,4,1,226776,226776,226777,0,1,2
64981,5,1,226781,226781,226782,0,1,4
64982,3,1,226784,226784,226785,0,1,2
64983,4,1,226788,226788,226789,0,1,3
64984,1,2,226789,226789,226791,0,2,0
64985,5,2,226794,226794,226796,0,2,3
64986,1,3,226795,226796,226799,1,4,0
64987,4,2,226799,226799,226801,0,2,0
64988,4,2,226803,226803,226805,0,2,2
64989,3,2,226806,226806,226808,0,2,1
64990,4,1,226810,226810,226811,0,1,2
64991,6,1,226816,226816,226817,0,1,5
64992,2,1,226818,226818,226819,0,1,1
64993,3,1,226821,226821,226822,0,1,2
64994,4,3,226825,226825,226828,0,3,3
64995,1,1,226826,226828,226829,2,3,0
64996,4,3,226830,226830,226833,0,3,1
64997,2,2,226832,226833,226835,1,3,0
64998,2,3,226834,226835,226838,1,4,0
64999,1,3,226835,226838,226841,3,6,0
65000,1,1,226836,226841,226842,5,6,0
65001,3,1,226839,226842,226843,3,4,0
65002,3,3,226842,226843,226846,1,4,0
65003,6,1,226848,226848,226849,0,1,2
65004,1,3,226849,226849,226852,0,3,0
65005,1,3,226850,226852,226855,2,5,0
65006,4,2,226854,226855,226857,1,3,0
65007,1,3,226855,226857,226860,2,5,0
65008,3,2,226858,226860,226862,2,4,0
65009,4,2,226862,226862,226864,0,2,0
65010,3,3,226865,226865,226868,0,3,1
65011,1,2,226866,226868,226870,2,4,0
65012,3,2,226869,226870,226872,1,3,0
65013,1,1,226870,226872,226873,2,3,0
65014,5,3,226875,226875,226878,0,3,2
65015,2,2,226877,226878,226880,1,3,0
65016,6,1,226883,226883,226884,0,1,3
65017,5,3,226888,226888,226891,0,3,4
65018,1,3,226889,226891,226894,2,5,0
65019,2,2,226891,226894,226896,3,5,0
65020,3,3,226894,226896,226899,2,5,0
65021,2,2,226896,226899,226901,3,5,0
65022,1,2,226897,226901,226903,4,6,0
65023,1,3,226898,226903,226906,5,8,0
65024,3,1,226901,226906,226907,5,6,0
65025,4,1,226905,226907,226908,2,3,0
65026,6,2,226911,226911,226913,0,2,3
65027,6,1,226917,226917,226918,0,1,4
65028,4,2,226921,226921,226923,0,2,3
65029,5,1,226926,226926,226927,0,1,3
65030,1,2,226927,226927,226929,0,2,0
65031,3,3,226930,226930,226933,0,3,1
65032,2,2,226932,226933,226935,1,3,0
65033,6,3,226938,226938,226941,0,3,3
65034,4,1,226942,226942,226943,0,1,1
65035,3,1,226945,226945,226946,0,1,2
65036,3,2,226948,226948,226950,0,2,2
65037,2,1,226950,226950,226951,0,1,0
65038,5,1,226955,226955,226956,0,1,4
65039,5,2,226960,226960,226962,0,2,4
65040,1,3,226961,226962,226965,1,4,0
65041,3,1,226964,226965,226966,1,2,0
65042,1,3,226965,226966,226969,1,4,0
65043,3,3,226968,226969,226972,1,4,0
65044,2,3,226970,226972,226975,2,5,0
65045,1,3,226971,226975,226978,4,7,0
65046,5,1,226976,226978,226979,2,3,0
65047,6,2,226982,226982,226984,0,2,3
65048,2,3,226984,226984,226987,0,3,0
65049,1,1,226985,226987,226988,2,3,0
65050,3,1,226988,226988,226989,0,1,0
65051,4,2,226992,226992,226994,0,2,3
65052,5,1,226997,226997,226998,0,1,3
65053,1,2,226998,226998,227000,0,2,0
65054,4,1,227002,227002,227003,0,1,2
65055,1,1,227003,227003,227004,0,1,0
65056,4,1,227007,227007,227008,0,1,3
65057,2,2,227009,227009,227011,0,2,1
65058,1,3,227010,227011,227014,1,4,0
65059,4,1,227014,227014,227015,0,1,0
65060,3,1,227017,227017,227018,0,1,2
65061,1,2,227018,227018,227020,0,2,0
65062,6,1,227024,227024,227025,0,1,4
65063,5,2,227029,227029,227031,0,2,4
65064,1,1,227030,227031,227032,1,2,0
65065,1,2,227031,227032,227034,1,3,0
65066,6,3,227037,227037,227040,0,3,3
65067,3,1,227040,227040,227041,0,1,0
65068,3,1,227043,227043,227044,0,1,2
65069,1,1,227044,227044,227045,0,1,0
65070,1,3,227045,227045,227048,0,3,0
65071,3,1,227048,227048,227049,0,1,0
65072,3,3,227051,227051,227054,0,3,2
65073,4,2,227055,227055,227057,0,2,1
65074,6,3,227061,227061,227064,0,3,4
65075,4,1,227065,227065,227066,0,1,1
65076,3,1,227068,227068,227069,0,1,2
65077,2,3,227070,227070,227073,0,3,1
65078,3,2,227073,227073,227075,0,2,0
65079,3,2,227076,227076,227078,0,2,1
65080,2,1,227078,227078,227079,0,1,0
65081,4,1,227082,227082,227083,0,1,3
65082,3,2,227085,227085,227087,0,2,2
65083,5,3,227090,227090,227093,0,3,3
65084,4,2,227094,227094,227096,0,2,1
65085,3,1,227097,227097,227098,0,1,1
65086,5,3,227102,227102,227105,0,3,4
65087,3,3,227105,227105,227108,0,3,0
65088,2,2,227107,227108,227110,1,3,0
65089,2,3,227109,227110,227113,1,4,0
65090,3,2,227112,227113,227115,1,3,0
65091,6,3,227118,227118,227121,0,3,3
65092,4,1,227122,227122,227123,0,1,1
65093,4,1,227126,227126,227127,0,1,3
65094,5,2,227131,227131,227133,0,2,4
65095,5,1,227136,227136,227137,0,1,3
65096,1,3,227137,227137,227140,0,3,0
65097,4,2,227141,227141,227143,0,2,1
65098,4,1,227145,227145,227146,0,1,2
65099,3,2,227148,227148,227150,0,2,2
65100,4,3,227152,227152,227155,0,3,2
65101,6,1,227158,227158,227159,0,1,3
65102,2,3,227160,227160,227163,0,3,1
65103,2,3,227162,227163,227166,1,4,0
65104,1,1,227163,227166,227167,3,4,0
65105,2,2,227165,227167,227169,2,4,0
65106,3,3,227168,227169,227172,1,4,0
65107,6,1,227174,227174,227175,0,1,2
65108,2,1,227176,227176,227177,0,1,1
65109,6,2,227182,227182,227184,0,2,5
65110,5,3,227187,227187,227190,0,3,3
65111,6,2,227193,227193,227195,0,2,3
65112,6,1,227199,227199,227200,0,1,4
65113,6,1,227205,227205,227206,0,1,5
65114,3,2,227208,227208,227210,0,2,2
65115,4,1,227212,227212,227213,0,1,2
65116,1,1,227213,227213,227214,0,1,0
65117,2,2,227215,227215,227217,0,2,1
65118,1,2,227216,227217,227219,1,3,0
65119,6,1,227222,227222,227223,0,1,3
65120,5,1,227227,227227,227228,0,1,4
65121,4,2,227231,227231,227233,0,2,3
65122,1,2,227232,227233,227235,1,3,0
65123,4,2,227236,227236,227238,0,2,1
65124,1,2,227237,227238,227240,1,3,0
65125,3,1,227240,227240,227241,0,1,0
65126,1,3,227241,227241,227244,0,3,0
65127,5,3,227246,227246,227249,0,3,2
65128,3,2,227249,227249,227251,0,2,0
65129,5,3,227254,227254,227257,0,3,3
65130,4,1,227258,227258,227259,0,1,1
65131,5,2,227263,227263,227265,0,2,4
65132,3,3,227266,227266,227269,0,3,1
65133,5,2,227271,227271,227273,0,2,2
65134,1,2,227272,227273,227275,1,3,0
65135,4,2,227276,227276,227278,0,2,1
65136,4,2,227280,227280,227282,0,2,2
65137,4,2,227284,227284,227286,0,2,2
65138,5,3,227289,227289,227292,0,3,3
65139,3,2,227292,227292,227294,0,2,0
65140,4,1,227296,227296,227297,0,1,2
65141,3,2,227299,227299,227301,0,2,2
65142,3,3,227302,227302,227305,0,3,1
65143,2,2,227304,227305,227307,1,3,0
65144,5,1,227309,227309,227310,0,1,2
65145,6,1,227315,227315,227316,0,1,5
65146,6,1,227321,227321,227322,0,1,5
65147,1,3,227322,227322,227325,0,3,0
65148,2,1,227324,227325,227326,1,2,0
65149,4,3,227328,227328,227331,0,3,2
65150,6,2,227334,227334,227336,0,2,3
65151,4,3,227338,227338,227341,0,3,2
65152,6,1,227344,227344,227345,0,1,3
65153,4,2,227348,227348,227350,0,2,3
65154,1,2,227349,227350,227352,1,3,0
65155,4,1,227353,227353,227354,0,1,1
65156,2,3,227355,227355,227358,0,3,1
65157,6,3,227361,227361,227364,0,3,3
65158,2,3,227363,227364,227367,1,4,0
65159,4,3,227367,227367,227370,0,3,0
65160,6,3,227373,227373,227376,0,3,3
65161,3,3,227376,227376,227379,0,3,0
65162,3,1,227379,227379,227380,0,1,0
65163,1,2,227380,227380,227382,0,2,0
65164,1,1,227381,227382,227383,1,2,0
65165,2,2,227383,227383,227385,0,2,0
65166,5,2,227388,227388,227390,0,2,3
65167,3,1,227391,227391,227392,0,1,1
65168,1,2,227392,227392,227394,0,2,0
65169,1,1,227393,227394,227395,1,2,0
65170,1,2,227394,227395,227397,1,3,0
65171,6,1,227400,227400,227401,0,1,3
65172,6,2,227406,227406,227408,0,2,5
65173,1,2,227407,227408,227410,1,3,0
65174,2,1,227409,227410,227411,1,2,0
65175,2,2,227411,227411,227413,0,2,0
65176,3,3,227414,227414,227417,0,3,1
65177,6,2,227420,227420,227422,0,2,3
65178,2,3,227422,227422,227425,0,3,0
65179,6,2,227428,227428,227430,0,2,3
65180,4,1,227432,227432,227433,0,1,2
65181,2,3,227434,227434,227437,0,3,1
65182,2,1,227436,227437,227438,1,2,0
65183,1,3,227437,227438,227441,1,4,0
65184,2,3,227439,227441,227444,2,5,0
65185,5,2,227444,227444,227446,0,2,0
65186,2,2,227446,227446,227448,0,2,0
65187,1,2,227447,227448,227450,1,3,0
65188,3,1,227450,227450,227451,0,1,0
65189,3,2,227453,227453,227455,0,2,2
65190,3,2,227456,227456,227458,0,2,1
65191,3,2,227459,227459,227461,0,2,1
65192,4,1,227463,227463,227464,0,1,2
65193,6,1,227469,227469,227470,0,1,5
65194,5,1,227474,227474,227475,0,1,4
65195,2,1,227476,227476,227477,0,1,1
65196,3,1,227479,227479,227480,0,1,2
65197,6,2,227485,227485,227487,0,2,5
65198,3,2,227488,227488,227490,0,2,1
65199,5,1,227493,227493,227494,0,1,3
65200,2,1,227495,227495,227496,0,1,1
65201,5,3,227500,227500,227503,0,3,4
65202,5,2,227505,227505,227507,0,2,2
65203,6,1,227511,227511,227512,0,1,4
65204,2,3,227513,227513,227516,0,3,1
65205,3,1,227516,227516,227517,0,1,0
65206,2,2,227518,227518,227520,0,2,1
65207,5,1,227523,227523,227524,0,1,3
65208,5,1,227528,227528,227529,0,1,4
65209,3,3,227531,227531,227534,0,3,2
65210,2,2,227533,227534,227536,1,3,0
65211,3,1,227536,227536,227537,0,1,0
65212,5,3,227541,227541,227544,0,3,4
65213,3,2,227544,227544,227546,0,2,0
65214,2,1,227546,227546,227547,0,1,0
65215,2,1,227548,227548,227549,0,1,1
65216,5,2,227553,227553,227555,0,2,4
65217,2,1,227555,227555,227556,0,1,0
65218,1,3,227556,227556,227559,0,3,0
65219,2,3,227558,227559,227562,1,4,0
65220,4,1,227562,227562,227563,0,1,0
65221,2,1,227564,227564,227565,0,1,1
65222,4,2,227568,227568,227570,0,2,3
65223,2,3,227570,227570,227573,0,3,0
65224,1,2,227571,227573,227575,2,4,0
65225,5,1,227576,227576,227577,0,1,1
65226,1,2,227577,227577,227579,0,2,0
65227,3,1,227580,227580,227581,0,1,1
65228,2,2,227582,227582,227584,0,2,1
65229,1,2,227583,227584,227586,1,3,0
65230,1,3,227584,227586,227589,2,5,0
65231,4,1,227588,227589,227590,1,2,0
65232,5,3,227593,227593,227596,0,3,3
65233,2,3,227595,227596,227599,1,4,0
65234,1,3,227596,227599,227602,3,6,0
65235,3,1,227599,227602,227603,3,4,0
65236,6,1,227605,227605,227606,0,1,2
65237,6,2,227611,227611,227613,0,2,5
65238,3,2,227614,227614,227616,0,2,1
65239,2,1,227616,227616,227617,0,1,0
65240,2,3,227618,227618,227621,0,3,1
65241,4,3,227622,227622,227625,0,3,1
65242,4,1,227626,227626,227627,0,1,1
65243,3,1,227629,227629,227630,0,1,2
65244,5,1,227634,227634,227635,0,1,4
65245,1,3,227635,227635,227638,0,3,0
65246,4,3,227639,227639,227642,0,3,1
65247,6,2,227645,227645,227647,0,2,3
65248,6,2,227651,227651,227653,0,2,4
65249,4,1,227655,227655,227656,0,1,2
65250,2,1,227657,227657,227658,0,1,1
65251,2,2,227659,227659,227661,0,2,1
65252,4,2,227663,227663,227665,0,2,2
65253,3,1,227666,227666,227667,0,1,1
65254,3,2,227669,227669,227671,0,2,2
65255,4,3,227673,227673,227676,0,3,2
65256,4,3,227677,227677,227680,0,3,1
65257,2,3,227679,227680,227683,1,4,0
65258,6,2,227685,227685,227687,0,2,2
65259,6,1,227691,227691,227692,0,1,4
65260,2,3,227693,227693,227696,0,3,1
65261,1,2,227694,227696,227698,2,4,0
65262,3,2,227697,227698,227700,1,3,0
65263,3,1,227700,227700,227701,0,1,0
65264,6,3,227706,227706,227709,0,3,5
65265,3,1,227709,227709,227710,0,1,0
65266,3,1,227712,227712,227713,0,1,2
65267,2,3,227714,227714,227717,0,3,1
65268,6,1,227720,227720,227721,0,1,3
65269,5,1,227725,227725,227726,0,1,4
65270,4,2,227729,227729,227731,0,2,3
65271,1,2,227730,227731,227733,1,3,0
65272,4,2,227734,227734,227736,0,2,1
65273,5,3,227739,227739,227742,0,3,3
65274,5,2,227744,227744,227746,0,2,2
65275,1,2,227745,227746,227748,1,3,0
65276,4,3,227749,227749,227752,0,3,1
65277,1,3,227750,227752,227755,2,5,0
65278,4,1,227754,227755,227756,1,2,0
65279,1,1,227755,227756,227757,1,2,0
65280,4,1,227759,227759,227760,0,1,2
65281,2,2,227761,227761,227763,0,2,1
65282,5,2,227766,227766,227768,0,2,3
65283,1,3,227767,227768,227771,1,4,0
65284,6,2,227773,227773,227775,0,2,2
65285,5,3,227778,227778,227781,0,3,3
65286,1,3,227779,227781,227784,2,5,0
65287,2,1,227781,227784,227785,3,4,0
65288,6,3,227787,227787,227790,0,3,2
65289,3,2,227790,227790,227792,0,2,0
65290,4,2,227794,227794,227796,0,2,2
65291,4,2,227798,227798,227800,0,2,2
65292,6,1,227804,227804,227805,0,1,4
65293,2,3,227806,227806,227809,0,3,1
65294,2,2,227808,227809,227811,1,3,0
65295,3,2,227811,227811,227813,0,2,0
65296,6,1,227817,227817,227818,0,1,4
65297,5,2,227822,227822,227824,0,2,4
65298,4,3,227826,227826,227829,0,3,2
65299,1,1,227827,227829,227830,2,3,0
65300,5,3,227832,227832,227835,0,3,2
65301,2,1,227834,227835,227836,1,2,0
65302,1,1,227835,227836,227837,1,2,0
65303,5,2,227840,227840,227842,0,2,3
65304,4,1,227844,227844,227845,0,1,2
65305,2,3,227846,227846,227849,0,3,1
65306,3,3,227849,227849,227852,0,3,0
65307,5,3,227854,227854,227857,0,3,2
65308,2,3,227856,227857,227860,1,4,0
65309,3,3,227859,227860,227863,1,4,0
65310,6,2,227865,227865,227867,0,2,2
65311,1,2,227866,227867,227869,1,3,0
65312,6,3,227872,227872,227875,0,3,3
65313,1,2,227873,227875,227877,2,4,0
65314,6,3,227879,227879,227882,0,3,2
65315,4,3,227883,227883,227886,0,3,1
65316,3,1,227886,227886,227887,0,1,0
65317,4,2,227890,227890,227892,0,2,3
65318,2,3,227892,227892,227895,0,3,0
65319,4,2,227896,227896,227898,0,2,1
65320,1,2,227897,227898,227900,1,3,0
65321,6,1,227903,227903,227904,0,1,3
65322,4,1,227907,227907,227908,0,1,3
65323,4,1,227911,227911,227912,0,1,3
65324,5,3,227916,227916,227919,0,3,4
65325,1,3,227917,227919,227922,2,5,0
65326,3,2,227920,227922,227924,2,4,0
65327,2,3,227922,227924,227927,2,5,0
65328,4,2,227926,227927,227929,1,3,0
65329,6,2,227932,227932,227934,0,2,3
65330,6,1,227938,227938,227939,0,1,4
65331,3,3,227941,227941,227944,0,3,2
65332,4,3,227945,227945,227948,0,3,1
65333,5,2,227950,227950,227952,0,2,2
65334,6,2,227956,227956,227958,0,2,4
65335,4,1,227960,227960,227961,0,1,2
65336,5,1,227965,227965,227966,0,1,4
65337,4,3,227969,227969,227972,0,3,3
65338,2,3,227971,227972,227975,1,4,0
65339,6,3,227977,227977,227980,0,3,2
65340,4,3,227981,227981,227984,0,3,1
65341,2,1,227983,227984,227985,1,2,0
65342,5,3,227988,227988,227991,0,3,3
65343,3,3,227991,227991,227994,0,3,0
65344,3,2,227994,227994,227996,0,2,0
65345,3,3,227997,227997,228000,0,3,1
65346,3,2,228000,228000,228002,0,2,0
65347,2,3,228002,228002,228005,0,3,0
65348,5,1,228007,228007,228008,0,1,2
65349,4,3,228011,228011,228014,0,3,3
65350,6,3,228017,228017,228020,0,3,3
65351,3,1,228020,228020,228021,0,1,0
65352,3,2,228023,228023,228025,0,2,2
65353,3,1,228026,228026,228027,0,1,1
65354,2,3,228028,228028,228031,0,3,1
65355,1,1,228029,228031,228032,2,3,0
65356,4,1,228033,228033,228034,0,1,1
65357,3,3,228036,228036,228039,0,3,2
65358,3,2,228039,228039,228041,0,2,0
65359,3,1,228042,228042,228043,0,1,1
65360,1,3,228043,228043,228046,0,3,0
65361,3,2,228046,228046,228048,0,2,0
65362,2,2,228048,228048,228050,0,2,0
65363,5,3,228053,228053,228056,0,3,3
65364,3,1,228056,228056,228057,0,1,0
65365,2,1,228058,228058,228059,0,1,1
65366,1,1,228059,228059,228060,0,1,0
65367,3,2,228062,228062,228064,0,2,2
65368,5,2,228067,228067,228069,0,2,3
65369,4,3,228071,228071,228074,0,3,2
65370,5,3,228076,228076,228079,0,3,2
65371,5,2,228081,228081,228083,0,2,2
65372,4,2,228085,228085,228087,0,2,2
65373,3,2,228088,228088,228090,0,2,1
65374,6,1,228094,228094,228095,0,1,4
65375,1,2,228095,228095,228097,0,2,0
65376,4,3,228099,228099,228102,0,3,2
65377,4,1,228103,228103,228104,0,1,1
65378,3,1,228106,228106,228107,0,1,2
65379,6,1,228112,228112,228113,0,1,5
65380,3,2,228115,228115,228117,0,2,2
65381,4,3,228119,228119,228122,0,3,2
65382,4,2,228123,228123,228125,0,2,1
65383,5,2,228128,228128,228130,0,2,3
65384,3,3,228131,228131,228134,0,3,1
65385,2,2,228133,228134,228136,1,3,0
65386,3,2,228136,228136,228138,0,2,0
65387,6,2,228142,228142,228144,0,2,4
65388,3,3,228145,228145,228148,0,3,1
65389,4,1,228149,228149,228150,0,1,1
65390,2,2,228151,228151,228153,0,2,1
65391,5,3,228156,228156,228159,0,3,3
65392,4,1,228160,228160,228161,0,1,1
65393,6,3,228166,228166,228169,0,3,5
65394,1,2,228167,228169,228171,2,4,0
65395,6,2,228173,228173,228175,0,2,2
65396,2,1,228175,228175,228176,0,1,0
65397,6,1,228181,228181,228182,0,1,5
65398,5,3,228186,228186,228189,0,3,4
65399,4,3,228190,228190,228193,0,3,1
65400,1,2,228191,228193,228195,2,4,0
65401,1,3,228192,228195,228198,3,6,0
65402,2,2,228194,228198,228200,4,6,0
65403,4,3,228198,228200,228203,2,5,0
65404,2,3,228200,228203,228206,3,6,0
65405,5,1,228205,228206,228207,1,2,0
65406,6,1,228211,228211,228212,0,1,4
65407,5,2,228216,228216,228218,0,2,4
65408,2,3,228218,228218,228221,0,3,0
65409,5,3,228223,228223,228226,0,3,2
65410,1,2,228224,228226,228228,2,4,0
65411,3,1,228227,228228,228229,1,2,0
65412,6,1,228233,228233,228234,0,1,4
65413,4,3,228237,228237,228240,0,3,3
65414,4,1,228241,228241,228242,0,1,1
65415,1,1,228242,228242,228243,0,1,0
65416,6,3,228248,228248,228251,0,3,5
65417,2,1,228250,228251,228252,1,2,0
65418,4,2,228254,228254,228256,0,2,2
65419,5,3,228259,228259,228262,0,3,3
65420,1,2,228260,228262,228264,2,4,0
65421,1,1,228261,228264,228265,3,4,0
65422,4,1,228265,228265,228266,0,1,0
65423,6,1,228271,228271,228272,0,1,5
65424,6,3,228277,228277,228280,0,3,5
65425,4,3,228281,228281,228284,0,3,1
65426,3,1,228284,228284,228285,0,1,0
65427,4,3,228288,228288,228291,0,3,3
65428,3,1,228291,228291,228292,0,1,0
65429,6,2,228297,228297,228299,0,2,5
65430,1,1,228298,228299,228300,1,2,0
65431,3,3,228301,228301,228304,0,3,1
65432,5,2,228306,228306,228308,0,2,2
65433,3,3,228309,228309,228312,0,3,1
65434,5,3,228314,228314,228317,0,3,2
65435,3,2,228317,228317,228319,0,2,0
65436,5,2,228322,228322,228324,0,2,3
65437,6,2,228328,228328,228330,0,2,4
65438,2,3,228330,228330,228333,0,3,0
65439,6,2,228336,228336,228338,0,2,3
65440,6,2,228342,228342,228344,0,2,4
65441,2,1,228344,228344,228345,0,1,0
65442,3,1,228347,228347,228348,0,1,2
65443,1,1,228348,228348,228349,0,1,0
65444,1,3,228349,228349,228352,0,3,0
65445,4,2,228353,228353,228355,0,2,1
65446,6,3,228359,228359,228362,0,3,4
65447,3,2,228362,228362,228364,0,2,0
65448,2,1,228364,228364,228365,0,1,0
65449,1,3,228365,228365,228368,0,3,0
65450,6,1,228371,228371,228372,0,1,3
65451,3,2,228374,228374,228376,0,2,2
65452,6,3,228380,228380,228383,0,3,4
65453,2,3,228382,228383,228386,1,4,0
65454,1,3,228383,228386,228389,3,6,0
65455,3,3,228386,228389,228392,3,6,0
65456,6,3,228392,228392,228395,0,3,0
65457,5,3,228397,228397,228400,0,3,2
65458,3,3,228400,228400,228403,0,3,0
65459,2,2,228402,228403,228405,1,3,0
65460,4,3,228406,228406,228409,0,3,1
65461,6,3,228412,228412,228415,0,3,3
65462,6,3,228418,228418,228421,0,3,3
65463,6,1,228424,228424,228425,0,1,3
65464,5,2,228429,228429,228431,0,2,4
65465,4,2,228433,228433,228435,0,2,2
65466,4,1,228437,228437,228438,0,1,2
65467,1,2,228438,228438,228440,0,2,0
65468,3,2,228441,228441,228443,0,2,1
65469,2,3,228443,228443,228446,0,3,0
65470,4,1,228447,228447,228448,0,1,1
65471,6,2,228453,228453,228455,0,2,5
65472,2,2,228455,228455,228457,0,2,0
65473,2,2,228457,228457,228459,0,2,0
65474,5,2,228462,228462,228464,0,2,3
65475,2,1,228464,228464,228465,0,1,0
65476,4,1,228468,228468,228469,0,1,3
65477,2,3,228470,228470,228473,0,3,1
65478,5,2,228475,228475,228477,0,2,2
65479,2,3,228477,228477,228480,0,3,0
65480,1,3,228478,228480,228483,2,5,0
65481,6,2,228484,228484,228486,0,2,1
65482,3,1,228487,228487,228488,0,1,1
65483,5,1,228492,228492,228493,0,1,4
65484,1,1,228493,228493,228494,0,1,0
65485,4,3,228497,228497,228500,0,3,3
65486,6,2,228503,228503,228505,0,2,3
65487,1,1,228504,228505,228506,1,2,0
65488,5,1,228509,228509,228510,0,1,3
65489,5,2,228514,228514,228516,0,2,4
65490,4,1,228518,228518,228519,0,1,2
65491,6,1,228524,228524,228525,0,1,5
65492,5,2,228529,228529,228531,0,2,4
65493,3,1,228532,228532,228533,0,1,1
65494,5,1,228537,228537,228538,0,1,4
65495,5,1,228542,228542,228543,0,1,4
65496,1,2,228543,228543,228545,0,2,0
65497,2,2,228545,228545,228547,0,2,0
65498,1,2,228546,228547,228549,1,3,0
65499,2,2,228548,228549,228551,1,3,0
65500,5,3,228553,228553,228556,0,3,2
65501,2,3,228555,228556,228559,1,4,0
65502,1,1,228556,228559,228560,3,4,0
65503,1,2,228557,228560,228562,3,5,0
65504,4,1,228561,228562,228563,1,2,0
65505,3,2,228564,228564,228566,0,2,1
65506,2,3,228566,228566,228569,0,3,0
65507,5,3,228571,228571,228574,0,3,2
65508,4,3,228575,228575,228578,0,3,1
65509,6,2,228581,228581,228583,0,2,3
65510,2,1,228583,228583,228584,0,1,0
65511,4,3,228587,228587,228590,0,3,3
65512,5,2,228592,228592,228594,0,2,2
65513,4,3,228596,228596,228599,0,3,2
65514,1,2,228597,228599,228601,2,4,0
65515,2,2,228599,228601,228603,2,4,0
65516,2,1,228601,228603,228604,2,3,0
65517,4,2,228605,228605,228607,0,2,1
65518,3,3,228608,228608,228611,0,3,1
65519,1,3,228609,228611,228614,2,5,0
65520,3,3,228612,228614,228617,2,5,0
65521,4,1,228616,228617,228618,1,2,0
65522,6,2,228622,228622,228624,0,2,4
65523,4,1,228626,228626,228627,0,1,2
65524,6,3,228632,228632,228635,0,3,5
65525,4,1,228636,228636,228637,0,1,1
65526,2,3,228638,228638,228641,0,3,1
65527,1,2,228639,228641,228643,2,4,0
65528,1,3,228640,228643,228646,3,6,0
65529,6,3,228646,228646,228649,0,3,0
65530,1,3,228647,228649,228652,2,5,0
65531,5,2,228652,228652,228654,0,2,0
65532,6,1,228658,228658,228659,0,1,4
65533,3,1,228661,228661,228662,0,1,2
65534,5,3,228666,228666,228669,0,3,4
65535,2,1,228668,228669,228670,1,2,0
65536,5,2,228673,228673,228675,0,2,3
65537,6,3,228679,228679,228682,0,3,4
65538,4,2,228683,228683,228685,0,2,1
65539,3,1,228686,228686,228687,0,1,1
65540,5,2,228691,228691,228693,0,2,4
65541,5,1,228696,228696,228697,0,1,3
65542,5,1,228701,228701,228702,0,1,4
65543,4,2,228705,228705,228707,0,2,3
65544,5,1,228710,228710,228711,0,1,3
65545,3,3,228713,228713,228716,0,3,2
65546,4,2,228717,228717,228719,0,2,1
65547,4,3,228721,228721,228724,0,3,2
65548,1,2,228722,228724,228726,2,4,0
65549,1,3,228723,228726,228729,3,6,0
65550,4,2,228727,228729,228731,2,4,0
65551,5,1,228732,228732,228733,0,1,1
65552,5,1,228737,228737,228738,0,1,4
65553,6,3,228743,228743,228746,0,3,5
65554,1,3,228744,228746,228749,2,5,0
65555,3,2,228747,228749,228751,2,4,0
65556,3,2,228750,228751,228753,1,3,0
65557,4,3,228754,228754,228757,0,3,1
65558,4,2,228758,228758,228760,0,2,1
65559,6,1,228764,228764,228765,0,1,4
65560,5,2,228769,228769,228771,0,2,4
65561,6,2,228775,228775,228777,0,2,4
65562,6,1,228781,228781,228782,0,1,4
65563,5,1,228786,228786,228787,0,1,4
65564,6,1,228792,228792,228793,0,1,5
65565,2,3,228794,228794,228797,0,3,1
65566,3,2,228797,228797,228799,0,2,0
65567,6,2,228803,228803,228805,0,2,4
65568,6,2,228809,228809,228811,0,2,4
65569,4,2,228813,228813,228815,0,2,2
65570,3,1,228816,228816,228817,0,1,1
65571,1,1,228817,228817,228818,0,1,0
65572,5,1,228822,228822,228823,0,1,4
65573,2,1,228824,228824,228825,0,1,1
65574,6,3,228830,228830,228833,0,3,5
65575,2,1,228832,228833,228834,1,2,0
65576,2,2,228834,228834,228836,0,2,0
65577,6,3,228840,228840,228843,0,3,4
65578,5,1,228845,228845,228846,0,1,2
65579,3,1,228848,228848,228849,0,1,2
65580,1,1,228849,228849,228850,0,1,0
65581,3,1,228852,228852,228853,0,1,2
65582,2,1,228854,228854,228855,0,1,1
65583,6,2,228860,228860,228862,0,2,5
65584,1,2,228861,228862,228864,1,3,0
65585,4,1,228865,228865,228866,0,1,1
65586,3,3,228868,228868,228871,0,3,2
65587,1,3,228869,228871,228874,2,5,0
65588,6,2,228875,228875,228877,0,2,1
65589,2,2,228877,228877,228879,0,2,0
65590,3,3,228880,228880,228883,0,3,1
65591,5,1,228885,228885,228886,0,1,2
65592,2,1,228887,228887,228888,0,1,1
65593,6,2,228893,228893,228895,0,2,5
65594,5,2,228898,228898,228900,0,2,3
65595,4,3,228902,228902,228905,0,3,2
65596,6,3,228908,228908,228911,0,3,3
65597,2,1,228910,228911,228912,1,2,0
65598,2,3,228912,228912,228915,0,3,0
65599,1,3,228913,228915,228918,2,5,0
65600,5,2,228918,228918,228920,0,2,0
65601,2,1,228920,228920,228921,0,1,0
65602,2,2,228922,228922,228924,0,2,1
65603,4,1,228926,228926,228927,0,1,2
65604,2,2,228928,228928,228930,0,2,1
65605,1,3,228929,228930,228933,1,4,0
65606,5,1,228934,228934,228935,0,1,1
65607,4,2,228938,228938,228940,0,2,3
65608,3,2,228941,228941,228943,0,2,1
65609,1,1,228942,228943,228944,1,2,0
65610,5,2,228947,228947,228949,0,2,3
65611,4,3,228951,228951,228954,0,3,2
65612,5,2,228956,228956,228958,0,2,2
65613,4,1,228960,228960,228961,0,1,2
65614,5,1,228965,228965,228966,0,1,4
65615,5,3,228970,228970,228973,0,3,4
65616,6,3,228976,228976,228979,0,3,3
65617,2,1,228978,228979,228980,1,2,0
65618,1,2,228979,228980,228982,1,3,0
65619,1,3,228980,228982,228985,2,5,0
65620,1,2,228981,228985,228987,4,6,0
65621,2,2,228983,228987,228989,4,6,0
65622,5,2,228988,228989,228991,1,3,0
65623,4,1,228992,228992,228993,0,1,1
65624,2,2,228994,228994,228996,0,2,1
65625,4,2,228998,228998,229000,0,2,2
65626,3,2,229001,229001,229003,0,2,1
65627,2,2,229003,229003,229005,0,2,0
65628,5,1,229008,229008,229009,0,1,3
65629,3,2,229011,229011,229013,0,2,2
65630,4,2,229015,229015,229017,0,2,2
65631,1,2,229016,229017,229019,1,3,0
65632,5,1,229021,229021,229022,0,1,2
65633,2,1,229023,229023,229024,0,1,1
65634,1,3,229024,229024,229027,0,3,0
65635,1,2,229025,229027,229029,2,4,0
65636,5,3,229030,229030,229033,0,3,1
65637,3,1,229033,229033,229034,0,1,0
65638,3,2,229036,229036,229038,0,2,2
65639,3,2,229039,229039,229041,0,2,1
65640,5,2,229044,229044,229046,0,2,3
65641,1,3,229045,229046,229049,1,4,0
65642,6,1,229051,229051,229052,0,1,2
65643,1,2,229052,229052,229054,0,2,0
65644,5,2,229057,229057,229059,0,2,3
65645,4,2,229061,229061,229063,0,2,2
65646,3,3,229064,229064,229067,0,3,1
65647,6,2,229070,229070,229072,0,2,3
65648,3,2,229073,229073,229075,0,2,1
65649,3,1,229076,229076,229077,0,1,1
65650,4,1,229080,229080,229081,0,1,3
65651,2,1,229082,229082,229083,0,1,1
65652,3,1,229085,229085,229086,0,1,2
65653,2,1,229087,229087,229088,0,1,1
65654,5,1,229092,229092,229093,0,1,4
65655,1,3,229093,229093,229096,0,3,0
65656,2,2,229095,229096,229098,1,3,0
65657,1,2,229096,229098,229100,2,4,0
65658,5,2,229101,229101,229103,0,2,1
65659,3,1,229104,229104,229105,0,1,1
65660,3,1,229107,229107,229108,0,1,2
65661,6,3,229113,229113,229116,0,3,5
65662,1,3,229114,229116,229119,2,5,0
65663,1,3,229115,229119,229122,4,7,0
65664,4,3,229119,229122,229125,3,6,0
65665,1,3,229120,229125,229128,5,8,0
65666,5,2,229125,229128,229130,3,5,0
65667,2,1,229127,229130,229131,3,4,0
65668,3,3,229130,229131,229134,1,4,0
65669,2,2,229132,229134,229136,2,4,0
65670,1,3,229133,229136,229139,3,6,0
65671,4,3,229137,229139,229142,2,5,0
65672,3,3,229140,229142,229145,2,5,0
65673,6,3,229146,229146,229149,0,3,1
65674,3,3,229149,229149,229152,0,3,0
65675,4,3,229153,229153,229156,0,3,1
65676,6,3,229159,229159,229162,0,3,3
65677,5,1,229164,229164,229165,0,1,2
65678,1,2,229165,229165,229167,0,2,0
65679,5,2,229170,229170,229172,0,2,3
65680,2,1,229172,229172,229173,0,1,0
65681,1,2,229173,229173,229175,0,2,0
65682,2,1,229175,229175,229176,0,1,0
65683,5,1,229180,229180,229181,0,1,4
65684,2,2,229182,229182,229184,0,2,1
65685,5,2,229187,229187,229189,0,2,3
65686,5,2,229192,229192,229194,0,2,3
65687,5,3,229197,229197,229200,0,3,3
65688,3,3,229200,229200,229203,0,3,0
65689,2,2,229202,229203,229205,1,3,0
65690,1,2,229203,229205,229207,2,4,0
65691,4,2,229207,229207,229209,0,2,0
65692,6,3,229213,229213,229216,0,3,4
65693,4,3,229217,229217,229220,0,3,1
65694,6,1,229223,229223,229224,0,1,3
65695,1,1,229224,229224,229225,0,1,0
65696,6,2,229230,229230,229232,0,2,5
65697,3,1,229233,229233,229234,0,1,1
65698,1,3,229234,229234,229237,0,3,0
65699,5,1,229239,229239,229240,0,1,2
65700,1,2,229240,229240,229242,0,2,0
65701,5,2,229245,229245,229247,0,2,3
65702,3,2,229248,229248,229250,0,2,1
65703,5,3,229253,229253,229256,0,3,3
65704,2,3,229255,229256,229259,1,4,0
65705,2,2,229257,229259,229261,2,4,0
65706,6,3,229263,229263,229266,0,3,2
65707,5,2,229268,229268,229270,0,2,2
65708,4,1,229272,229272,229273,0,1,2
65709,6,1,229278,229278,229279,0,1,5
65710,1,2,229279,229279,229281,0,2,0
65711,3,1,229282,229282,229283,0,1,1
65712,2,3,229284,229284,229287,0,3,1
65713,5,2,229289,229289,229291,0,2,2
65714,3,3,229292,229292,229295,0,3,1
65715,5,1,229297,229297,229298,0,1,2
65716,6,2,229303,229303,229305,0,2,5
65717,1,3,229304,229305,229308,1,4,0
65718,2,2,229306,229308,229310,2,4,0
65719,4,3,229310,229310,229313,0,3,0
65720,3,3,229313,229313,229316,0,3,0
65721,4,1,229317,229317,229318,0,1,1
65722,3,3,229320,229320,229323,0,3,2
65723,5,1,229325,229325,229326,0,1,2
65724,5,3,229330,229330,229333,0,3,4
65725,2,1,229332,229333,229334,1,2,0
65726,6,3,229338,229338,229341,0,3,4
65727,1,3,229339,229341,229344,2,5,0
65728,5,3,229344,229344,229347,0,3,0
65729,3,1,229347,229347,229348,0,1,0
65730,1,1,229348,229348,229349,0,1,0
65731,3,2,229351,229351,229353,0,2,2
65732,2,2,229353,229353,229355,0,2,0
65733,6,1,229359,229359,229360,0,1,4
65734,2,3,229361,229361,229364,0,3,1
65735,1,2,229362,229364,229366,2,4,0
65736,2,2,229364,229366,229368,2,4,0
65737,1,1,229365,229368,229369,3,4,0
65738,2,1,229367,229369,229370,2,3,0
65739,1,2,229368,229370,229372,2,4,0
65740,6,1,229374,229374,229375,0,1,2
65741,5,3,229379,229379,229382,0,3,4
65742,4,1,229383,229383,229384,0,1,1
65743,1,3,229384,229384,229387,0,3,0
65744,1,3,229385,229387,229390,2,5,0
65745,2,1,229387,229390,229391,3,4,0
65746,5,1,229392,229392,229393,0,1,1
65747,4,3,229396,229396,229399,0,3,3
65748,6,3,229402,229402,229405,0,3,3
65749,2,1,229404,229405,229406,1,2,0
65750,4,2,229408,229408,229410,0,2,2
65751,6,1,229414,229414,229415,0,1,4
65752,3,3,229417,229417,229420,0,3,2
65753,1,2,229418,229420,229422,2,4,0
65754,6,1,229424,229424,229425,0,1,2
65755,1,2,229425,229425,229427,0,2,0
65756,3,2,229428,229428,229430,0,2,1
65757,2,3,229430,229430,229433,0,3,0
65758,4,1,229434,229434,229435,0,1,1
65759,5,2,229439,229439,229441,0,2,4
65760,4,3,229443,229443,229446,0,3,2
65761,6,2,229449,229449,229451,0,2,3
65762,1,2,229450,229451,229453,1,3,0
65763,2,2,229452,229453,229455,1,3,0
65764,4,2,229456,229456,229458,0,2,1
65765,1,3,229457,229458,229461,1,4,0
65766,3,2,229460,229461,229463,1,3,0
65767,1,3,229461,229463,229466,2,5,0
65768,3,1,229464,229466,229467,2,3,0
65769,6,3,229470,229470,229473,0,3,3
65770,4,3,229474,229474,229477,0,3,1
65771,1,3,229475,229477,229480,2,5,0
65772,6,1,229481,229481,229482,0,1,1
65773,6,2,229487,229487,229489,0,2,5
65774,2,1,229489,229489,229490,0,1,0
65775,3,1,229492,229492,229493,0,1,2
65776,5,3,229497,229497,229500,0,3,4
65777,6,2,229503,229503,229505,0,2,3
65778,5,3,229508,229508,229511,0,3,3
65779,1,2,229509,229511,229513,2,4,0
65780,4,2,229513,229513,229515,0,2,0
65781,6,2,229519,229519,229521,0,2,4
65782,6,2,229525,229525,229527,0,2,4
65783,2,1,229527,229527,229528,0,1,0
65784,6,3,229533,229533,229536,0,3,5
65785,6,1,229539,229539,229540,0,1,3
65786,1,1,229540,229540,229541,0,1,0
65787,6,2,229546,229546,229548,0,2,5
65788,6,1,229552,229552,229553,0,1,4
65789,2,2,229554,229554,229556,0,2,1
65790,5,1,229559,229559,229560,0,1,3
65791,4,3,229563,229563,229566,0,3,3
65792,2,3,229565,229566,229569,1,4,0
65793,3,1,229568,229569,229570,1,2,0
65794,1,2,229569,229570,229572,1,3,0
65795,1,2,229570,229572,229574,2,4,0
65796,3,1,229573,229574,229575,1,2,0
65797,6,3,229579,229579,229582,0,3,4
65798,6,2,229585,229585,229587,0,2,3
65799,2,2,229587,229587,229589,0,2,0
65800,2,1,229589,229589,229590,0,1,0
65801,4,1,229593,229593,229594,0,1,3
65802,6,1,229599,229599,229600,0,1,5
65803,6,3,229605,229605,229608,0,3,5
65804,3,1,229608,229608,229609,0,1,0
65805,5,1,229613,229613,229614,0,1,4
65806,3,2,229616,229616,229618,0,2,2
65807,3,1,229619,229619,229620,0,1,1
65808,2,3,229621,229621,229624,0,3,1
65809,5,2,229626,229626,229628,0,2,2
65810,2,2,229628,229628,229630,0,2,0
65811,5,2,229633,229633,229635,0,2,3
65812,6,1,229639,229639,229640,0,1,4
65813,2,3,229641,229641,229644,0,3,1
65814,4,2,229645,229645,229647,0,2,1
65815,5,1,229650,229650,229651,0,1,3
65816,2,1,229652,229652,229653,0,1,1
65817,6,2,229658,229658,229660,0,2,5
65818,6,3,229664,229664,229667,0,3,4
65819,1,3,229665,229667,229670,2,5,0
65820,3,3,229668,229670,229673,2,5,0
65821,4,2,229672,229673,229675,1,3,0
65822,2,3,229674,229675,229678,1,4,0
65823,3,2,229677,229678,229680,1,3,0
65824,1,1,229678,229680,229681,2,3,0
65825,1,3,229679,229681,229684,2,5,0
65826,4,1,229683,229684,229685,1,2,0
65827,3,3,229686,229686,229689,0,3,1
65828,6,1,229692,229692,229693,0,1,3
65829,3,3,229695,229695,229698,0,3,2
65830,4,2,229699,229699,229701,0,2,1
65831,3,1,229702,229702,229703,0,1,1
65832,2,2,229704,229704,229706,0,2,1
65833,4,3,229708,229708,229711,0,3,2
65834,2,1,229710,229711,229712,1,2,0
65835,4,3,229714,229714,229717,0,3,2
65836,6,1,229720,229720,229721,0,1,3
65837,1,1,229721,229721,229722,0,1,0
65838,6,3,229727,229727,229730,0,3,5
65839,3,2,229730,229730,229732,0,2,0
65840,3,1,229733,229733,229734,0,1,1
65841,5,2,229738,229738,229740,0,2,4
65842,4,2,229742,229742,229744,0,2,2
65843,2,1,229744,229744,229745,0,1,0
65844,6,2,229750,229750,229752,0,2,5
65845,5,2,229755,229755,229757,0,2,3
65846,5,3,229760,229760,229763,0,3,3
65847,2,2,229762,229763,229765,1,3,0
65848,2,3,229764,229765,229768,1,4,0
65849,3,1,229767,229768,229769,1,2,0
65850,6,2,229773,229773,229775,0,2,4
65851,5,1,229778,229778,229779,0,1,3
65852,4,2,229782,229782,229784,0,2,3
65853,1,2,229783,229784,229786,1,3,0
65854,3,3,229786,229786,229789,0,3,0
65855,6,3,229792,229792,229795,0,3,3
65856,1,3,229793,229795,229798,2,5,0
65857,2,1,229795,229798,229799,3,4,0
65858,2,2,229797,229799,229801,2,4,0
65859,5,2,229802,229802,229804,0,2,1
65860,6,2,229808,229808,229810,0,2,4
65861,4,2,229812,229812,229814,0,2,2
65862,1,3,229813,229814,229817,1,4,0
65863,4,1,229817,229817,229818,0,1,0
65864,5,2,229822,229822,229824,0,2,4
65865,5,2,229827,229827,229829,0,2,3
65866,6,1,229833,229833,229834,0,1,4
65867,1,1,229834,229834,229835,0,1,0
65868,6,1,229840,229840,229841,0,1,5
65869,1,2,229841,229841,229843,0,2,0
65870,4,3,229845,229845,229848,0,3,2
65871,3,1,229848,229848,229849,0,1,0
65872,4,3,229852,229852,229855,0,3,3
65873,1,2,229853,229855,229857,2,4,0
65874,4,1,229857,229857,229858,0,1,0
65875,5,2,229862,229862,229864,0,2,4
65876,3,1,229865,229865,229866,0,1,1
65877,5,2,229870,229870,229872,0,2,4
65878,6,3,229876,229876,229879,0,3,4
65879,3,3,229879,229879,229882,0,3,0
65880,5,2,229884,229884,229886,0,2,2
65881,4,1,229888,229888,229889,0,1,2
65882,6,2,229894,229894,229896,0,2,5
65883,3,3,229897,229897,229900,0,3,1
65884,3,3,229900,229900,229903,0,3,0
65885,3,2,229903,229903,229905,0,2,0
65886,3,1,229906,229906,229907,0,1,1
65887,2,2,229908,229908,229910,0,2,1
65888,6,3,229914,229914,229917,0,3,4
65889,6,3,229920,229920,229923,0,3,3
65890,4,3,229924,229924,229927,0,3,1
65891,6,2,229930,229930,229932,0,2,3
65892,3,3,229933,229933,229936,0,3,1
65893,6,2,229939,229939,229941,0,2,3
65894,1,3,229940,229941,229944,1,4,0
65895,5,1,229945,229945,229946,0,1,1
65896,2,1,229947,229947,229948,0,1,1
65897,2,2,229949,229949,229951,0,2,1
65898,5,3,229954,229954,229957,0,3,3
65899,5,1,229959,229959,229960,0,1,2
65900,3,3,229962,229962,229965,0,3,2
65901,5,3,229967,229967,229970,0,3,2
65902,2,3,229969,229970,229973,1,4,0
65903,2,3,229971,229973,229976,2,5,0
65904,4,1,229975,229976,229977,1,2,0
65905,4,1,229979,229979,229980,0,1,2
65906,6,3,229985,229985,229988,0,3,5
65907,6,3,229991,229991,229994,0,3,3
65908,2,3,229993,229994,229997,1,4,0
65909,5,1,229998,229998,229999,0,1,1
65910,1,1,229999,229999,230000,0,1,0
65911,2,3,230001,230001,230004,0,3,1
65912,2,2,230003,230004,230006,1,3,0
65913,5,2,230008,230008,230010,0,2,2
65914,3,1,230011,230011,230012,0,1,1
65915,3,3,230014,230014,230017,0,3,2
65916,5,1,230019,230019,230020,0,1,2
65917,3,2,230022,230022,230024,0,2,2
65918,2,2,230024,230024,230026,0,2,0
65919,2,2,230026,230026,230028,0,2,0
65920,5,2,230031,230031,230033,0,2,3
65921,6,1,230037,230037,230038,0,1,4
65922,6,3,230043,230043,230046,0,3,5
65923,2,1,230045,230046,230047,1,2,0
65924,1,3,230046,230047,230050,1,4,0
65925,2,2,230048,230050,230052,2,4,0
65926,6,1,230054,230054,230055,0,1,2
65927,4,1,230058,230058,230059,0,1,3
65928,6,2,230064,230064,230066,0,2,5
65929,1,3,230065,230066,230069,1,4,0
65930,6,1,230071,230071,230072,0,1,2
65931,5,2,230076,230076,230078,0,2,4
65932,1,1,230077,230078,230079,1,2,0
65933,2,1,230079,230079,230080,0,1,0
65934,5,3,230084,230084,230087,0,3,4
65935,4,1,230088,230088,230089,0,1,1
65936,3,1,230091,230091,230092,0,1,2
65937,2,3,230093,230093,230096,0,3,1
65938,4,1,230097,230097,230098,0,1,1
65939,1,3,230098,230098,230101,0,3,0
65940,2,2,230100,230101,230103,1,3,0
65941,6,2,230106,230106,230108,0,2,3
65942,3,2,230109,230109,230111,0,2,1
65943,2,2,230111,230111,230113,0,2,0
65944,1,1,230112,230113,230114,1,2,0
65945,2,2,230114,230114,230116,0,2,0
65946,4,2,230118,230118,230120,0,2,2
65947,4,1,230122,230122,230123,0,1,2
65948,3,3,230125,230125,230128,0,3,2
65949,6,1,230131,230131,230132,0,1,3
65950,4,1,230135,230135,230136,0,1,3
65951,1,3,230136,230136,230139,0,3,0
65952,2,3,230138,230139,230142,1,4,0
65953,6,3,230144,230144,230147,0,3,2
65954,2,1,230146,230147,230148,1,2,0
65955,3,2,230149,230149,230151,0,2,1
65956,4,1,230153,230153,230154,0,1,2
65957,5,3,230158,230158,230161,0,3,4
65958,4,1,230162,230162,230163,0,1,1
65959,6,3,230168,230168,230171,0,3,5
65960,4,2,230172,230172,230174,0,2,1
65961,4,2,230176,230176,230178,0,2,2
65962,5,2,230181,230181,230183,0,2,3
65963,2,2,230183,230183,230185,0,2,0
65964,4,3,230187,230187,230190,0,3,2
65965,3,3,230190,230190,230193,0,3,0
65966,5,1,230195,230195,230196,0,1,2
65967,4,1,230199,230199,230200,0,1,3
65968,3,1,230202,230202,230203,0,1,2
65969,5,2,230207,230207,230209,0,2,4
65970,3,2,230210,230210,230212,0,2,1
65971,4,3,230214,230214,230217,0,3,2
65972,1,1,230215,230217,230218,2,3,0
65973,1,1,230216,230218,230219,2,3,0
65974,4,1,230220,230220,230221,0,1,1
65975,1,1,230221,230221,230222,0,1,0
65976,3,3,230224,230224,230227,0,3,2
65977,2,1,230226,230227,230228,1,2,0
65978,4,3,230230,230230,230233,0,3,2
65979,4,2,230234,230234,230236,0,2,1
65980,1,2,230235,230236,230238,1,3,0
65981,5,3,230240,230240,230243,0,3,2
65982,2,2,230242,230243,230245,1,3,0
65983,4,2,230246,230246,230248,0,2,1
65984,5,3,230251,230251,230254,0,3,3
65985,5,3,230256,230256,230259,0,3,2
65986,5,2,230261,230261,230263,0,2,2
65987,5,1,230266,230266,230267,0,1,3
65988,2,1,230268,230268,230269,0,1,1
65989,5,3,230273,230273,230276,0,3,4
65990,1,1,230274,230276,230277,2,3,0
65991,4,2,230278,230278,230280,0,2,1
65992,4,3,230282,230282,230285,0,3,2
65993,5,2,230287,230287,230289,0,2,2
65994,3,3,230290,230290,230293,0,3,1
65995,4,3,230294,230294,230297,0,3,1
65996,3,3,230297,230297,230300,0,3,0
65997,6,3,230303,230303,230306,0,3,3
65998,4,2,230307,230307,230309,0,2,1
65999,5,1,230312,230312,230313,0,1,3
66000,5,1,230317,230317,230318,0,1,4
66001,4,2,230321,230321,230323,0,2,3
66002,4,1,230325,230325,230326,0,1,2
66003,1,3,230326,230326,230329,0,3,0
66004,4,1,230330,230330,230331,0,1,1
66005,6,3,230336,230336,230339,0,3,5
66006,3,3,230339,230339,230342,0,3,0
66007,3,1,230342,230342,230343,0,1,0
66008,6,1,230348,230348,230349,0,1,5
66009,3,1,230351,230351,230352,0,1,2
66010,2,2,230353,230353,230355,0,2,1
66011,1,1,230354,230355,230356,1,2,0
66012,4,2,230358,230358,230360,0,2,2
66013,2,1,230360,230360,230361,0,1,0
66014,5,2,230365,230365,230367,0,2,4
66015,2,3,230367,230367,230370,0,3,0
66016,5,2,230372,230372,230374,0,2,2
66017,2,3,230374,230374,230377,0,3,0
66018,1,3,230375,230377,230380,2,5,0
66019,3,2,230378,230380,230382,2,4,0
66020,3,3,230381,230382,230385,1,4,0
66021,5,1,230386,230386,230387,0,1,1
66022,4,3,230390,230390,230393,0,3,3
66023,5,3,230395,230395,230398,0,3,2
66024,1,3,230396,230398,230401,2,5,0
66025,3,2,230399,230401,230403,2,4,0
66026,4,2,230403,230403,230405,0,2,0
66027,4,2,230407,230407,230409,0,2,2
66028,3,3,230410,230410,230413,0,3,1
66029,4,1,230414,230414,230415,0,1,1
66030,6,3,230420,230420,230423,0,3,5
66031,2,2,230422,230423,230425,1,3,0
66032,1,3,230423,230425,230428,2,5,0
66033,4,2,230427,230428,230430,1,3,0
66034,4,1,230431,230431,230432,0,1,1
66035,6,3,230437,230437,230440,0,3,5
66036,2,1,230439,230440,230441,1,2,0
66037,1,2,230440,230441,230443,1,3,0
66038,6,2,230446,230446,230448,0,2,3
66039,5,1,230451,230451,230452,0,1,3
66040,6,1,230457,230457,230458,0,1,5
66041,3,2,230460,230460,230462,0,2,2
66042,3,2,230463,230463,230465,0,2,1
66043,4,2,230467,230467,230469,0,2,2
66044,2,1,230469,230469,230470,0,1,0
66045,4,1,230473,230473,230474,0,1,3
66046,4,1,230477,230477,230478,0,1,3
66047,2,1,230479,230479,230480,0,1,1
66048,3,1,230482,230482,230483,0,1,2
66049,3,3,230485,230485,230488,0,3,2
66050,2,3,230487,230488,230491,1,4,0
66051,3,1,230490,230491,230492,1,2,0
66052,3,3,230493,230493,230496,0,3,1
66053,5,3,230498,230498,230501,0,3,2
66054,3,2,230501,230501,230503,0,2,0
66055,6,3,230507,230507,230510,0,3,4
66056,1,1,230508,230510,230511,2,3,0
66057,3,2,230511,230511,230513,0,2,0
66058,5,1,230516,230516,230517,0,1,3
66059,4,3,230520,230520,230523,0,3,3
66060,1,3,230521,230523,230526,2,5,0
66061,1,2,230522,230526,230528,4,6,0
66062,5,3,230527,230528,230531,1,4,0
66063,5,3,230532,230532,230535,0,3,1
66064,2,3,230534,230535,230538,1,4,0
66065,3,1,230537,230538,230539,1,2,0
66066,6,2,230543,230543,230545,0,2,4
66067,4,1,230547,230547,230548,0,1,2
66068,3,2,230550,230550,230552,0,2,2
66069,5,2,230555,230555,230557,0,2,3
66070,3,1,230558,230558,230559,0,1,1
66071,3,2,230561,230561,230563,0,2,2
66072,6,2,230567,230567,230569,0,2,4
66073,2,2,230569,230569,230571,0,2,0
66074,6,2,230575,230575,230577,0,2,4
66075,5,1,230580,230580,230581,0,1,3
66076,2,2,230582,230582,230584,0,2,1
66077,1,1,230583,230584,230585,1,2,0
66078,1,2,230584,230585,230587,1,3,0
66079,5,3,230589,230589,230592,0,3,2
66080,1,2,230590,230592,230594,2,4,0
66081,3,1,230593,230594,230595,1,2,0
66082,4,1,230597,230597,230598,0,1,2
66083,1,3,230598,230598,230601,0,3,0
66084,2,2,230600,230601,230603,1,3,0
66085,2,2,230602,230603,230605,1,3,0
66086,1,2,230603,230605,230607,2,4,0
66087,6,1,230609,230609,230610,0,1,2
66088,6,1,230615,230615,230616,0,1,5
66089,3,2,230618,230618,230620,0,2,2
66090,1,1,230619,230620,230621,1,2,0
66091,4,1,230623,230623,230624,0,1,2
66092,1,2,230624,230624,230626,0,2,0
66093,3,3,230627,230627,230630,0,3,1
66094,6,2,230633,230633,230635,0,2,3
66095,1,1,230634,230635,230636,1,2,0
66096,1,3,230635,230636,230639,1,4,0
66097,2,2,230637,230639,230641,2,4,0
66098,1,3,230638,230641,230644,3,6,0
66099,1,2,230639,230644,230646,5,7,0
66100,3,1,230642,230646,230647,4,5,0
66101,2,3,230644,230647,230650,3,6,0
66102,6,2,230650,230650,230652,0,2,0
66103,4,2,230654,230654,230656,0,2,2
66104,6,1,230660,230660,230661,0,1,4
66105,3,3,230663,230663,230666,0,3,2
66106,1,1,230664,230666,230667,2,3,0
66107,2,2,230666,230667,230669,1,3,0
66108,6,1,230672,230672,230673,0,1,3
66109,6,3,230678,230678,230681,0,3,5
66110,1,3,230679,230681,230684,2,5,0
66111,1,2,230680,230684,230686,4,6,0
66112,4,3,230684,230686,230689,2,5,0
66113,5,2,230689,230689,230691,0,2,0
66114,4,1,230693,230693,230694,0,1,2
66115,3,3,230696,230696,230699,0,3,2
66116,6,1,230702,230702,230703,0,1,3
66117,6,3,230708,230708,230711,0,3,5
66118,3,1,230711,230711,230712,0,1,0
66119,4,1,230715,230715,230716,0,1,3
66120,6,1,230721,230721,230722,0,1,5
66121,3,2,230724,230724,230726,0,2,2
66122,2,3,230726,230726,230729,0,3,0
66123,5,3,230731,230731,230734,0,3,2
66124,2,3,230733,230734,230737,1,4,0
66125,3,3,230736,230737,230740,1,4,0
66126,1,1,230737,230740,230741,3,4,0
66127,1,1,230738,230741,230742,3,4,0
66128,4,2,230742,230742,230744,0,2,0
66129,2,1,230744,230744,230745,0,1,0
66130,6,1,230750,230750,230751,0,1,5
66131,2,1,230752,230752,230753,0,1,1
66132,6,1,230758,230758,230759,0,1,5
66133,6,3,230764,230764,230767,0,3,5
66134,5,1,230769,230769,230770,0,1,2
66135,1,2,230770,230770,230772,0,2,0
66136,3,2,230773,230773,230775,0,2,1
66137,4,1,230777,230777,230778,0,1,2
66138,1,1,230778,230778,230779,0,1,0
66139,4,1,230782,230782,230783,0,1,3
66140,6,2,230788,230788,230790,0,2,5
66141,6,1,230794,230794,230795,0,1,4
66142,4,2,230798,230798,230800,0,2,3
66143,4,1,230802,230802,230803,0,1,2
66144,6,3,230808,230808,230811,0,3,5
66145,5,1,230813,230813,230814,0,1,2
66146,5,1,230818,230818,230819,0,1,4
66147,2,1,230820,230820,230821,0,1,1
66148,5,1,230825,230825,230826,0,1,4
66149,2,2,230827,230827,230829,0,2,1
66150,4,1,230831,230831,230832,0,1,2
66151,2,2,230833,230833,230835,0,2,1
66152,1,2,230834,230835,230837,1,3,0
66153,1,2,230835,230837,230839,2,4,0
66154,4,1,230839,230839,230840,0,1,0
66155,5,1,230844,230844,230845,0,1,4
66156,2,3,230846,230846,230849,0,3,1
66157,6,1,230852,230852,230853,0,1,3
66158,3,1,230855,230855,230856,0,1,2
66159,2,1,230857,230857,230858,0,1,1
66160,3,1,230860,230860,230861,0,1,2
66161,3,3,230863,230863,230866,0,3,2
66162,1,1,230864,230866,230867,2,3,0
66163,2,2,230866,230867,230869,1,3,0
66164,5,1,230871,230871,230872,0,1,2
66165,4,3,230875,230875,230878,0,3,3
66166,4,2,230879,230879,230881,0,2,1
66167,3,1,230882,230882,230883,0,1,1
66168,1,2,230883,230883,230885,0,2,0
66169,2,3,230885,230885,230888,0,3,0
66170,6,1,230891,230891,230892,0,1,3
66171,2,2,230893,230893,230895,0,2,1
66172,1,1,230894,230895,230896,1,2,0
66173,3,3,230897,230897,230900,0,3,1
66174,4,1,230901,230901,230902,0,1,1
66175,1,2,230902,230902,230904,0,2,0
66176,3,3,230905,230905,230908,0,3,1
66177,3,1,230908,230908,230909,0,1,0
66178,3,2,230911,230911,230913,0,2,2
66179,3,1,230914,230914,230915,0,1,1
66180,2,2,230916,230916,230918,0,2,1
66181,5,2,230921,230921,230923,0,2,3
66182,6,2,230927,230927,230929,0,2,4
66183,1,3,230928,230929,230932,1,4,0
66184,5,1,230933,230933,230934,0,1,1
66185,1,2,230934,230934,230936,0,2,0
66186,4,3,230938,230938,230941,0,3,2
66187,6,2,230944,230944,230946,0,2,3
66188,5,1,230949,230949,230950,0,1,3
66189,5,2,230954,230954,230956,0,2,4
66190,2,1,230956,230956,230957,0,1,0
66191,6,1,230962,230962,230963,0,1,5
66192,6,3,230968,230968,230971,0,3,5
66193,3,1,230971,230971,230972,0,1,0
66194,1,1,230972,230972,230973,0,1,0
66195,3,2,230975,230975,230977,0,2,2
66196,3,1,230978,230978,230979,0,1,1
66197,6,2,230984,230984,230986,0,2,5
66198,1,2,230985,230986,230988,1,3,0
66199,2,2,230987,230988,230990,1,3,0
66200,2,2,230989,230990,230992,1,3,0
66201,6,3,230995,230995,230998,0,3,3
66202,5,1,231000,231000,231001,0,1,2
66203,6,3,231006,231006,231009,0,3,5
66204,4,3,231010,231010,231013,0,3,1
66205,4,1,231014,231014,231015,0,1,1
66206,5,3,231019,231019,231022,0,3,4
66207,4,3,231023,231023,231026,0,3,1
66208,4,2,231027,231027,231029,0,2,1
66209,2,3,231029,231029,231032,0,3,0
66210,3,2,231032,231032,231034,0,2,0
66211,3,2,231035,231035,231037,0,2,1
66212,6,1,231041,231041,231042,0,1,4
66213,2,1,231043,231043,231044,0,1,1
66214,3,3,231046,231046,231049,0,3,2
66215,6,1,231052,231052,231053,0,1,3
66216,3,2,231055,231055,231057,0,2,2
66217,6,2,231061,231061,231063,0,2,4
66218,4,1,231065,231065,231066,0,1,2
66219,6,3,231071,231071,231074,0,3,5
66220,3,3,231074,231074,231077,0,3,0
66221,6,3,231080,231080,231083,0,3,3
66222,1,2,231081,231083,231085,2,4,0
66223,6,2,231087,231087,231089,0,2,2
66224,3,2,231090,231090,231092,0,2,1
66225,2,2,231092,231092,231094,0,2,0
66226,6,3,231098,231098,231101,0,3,4
66227,1,2,231099,231101,231103,2,4,0
66228,1,2,231100,231103,231105,3,5,0
66229,6,2,231106,231106,231108,0,2,1
66230,3,3,231109,231109,231112,0,3,1
66231,5,1,231114,231114,231115,0,1,2
66232,6,3,231120,231120,231123,0,3,5
66233,5,3,231125,231125,231128,0,3,2
66234,2,3,231127,231128,231131,1,4,0
66235,1,1,231128,231131,231132,3,4,0
66236,4,1,231132,231132,231133,0,1,0
66237,1,1,231133,231133,231134,0,1,0
66238,5,1,231138,231138,231139,0,1,4
66239,3,1,231141,231141,231142,0,1,2
66240,3,2,231144,231144,231146,0,2,2
66241,5,2,231149,231149,231151,0,2,3
66242,4,2,231153,231153,231155,0,2,2
66243,6,1,231159,231159,231160,0,1,4
66244,4,2,231163,231163,231165,0,2,3
66245,5,2,231168,231168,231170,0,2,3
66246,4,2,231172,231172,231174,0,2,2
66247,1,3,231173,231174,231177,1,4,0
66248,6,1,231179,231179,231180,0,1,2
66249,3,1,231182,231182,231183,0,1,2
66250,3,3,231185,231185,231188,0,3,2
66251,5,1,231190,231190,231191,0,1,2
66252,6,1,231196,231196,231197,0,1,5
66253,6,2,231202,231202,231204,0,2,5
66254,5,3,231207,231207,231210,0,3,3
66255,6,3,231213,231213,231216,0,3,3
66256,1,2,231214,231216,231218,2,4,0
66257,1,1,231215,231218,231219,3,4,0
66258,4,1,231219,231219,231220,0,1,0
66259,6,1,231225,231225,231226,0,1,5
66260,2,1,231227,231227,231228,0,1,1
66261,1,2,231228,231228,231230,0,2,0
66262,3,1,231231,231231,231232,0,1,1
66263,2,3,231233,231233,231236,0,3,1
66264,3,3,231236,231236,231239,0,3,0
66265,5,3,231241,231241,231244,0,3,2
66266,3,1,231244,231244,231245,0,1,0
66267,2,3,231246,231246,231249,0,3,1
66268,5,1,231251,231251,231252,0,1,2
66269,6,1,231257,231257,231258,0,1,5
66270,2,1,231259,231259,231260,0,1,1
66271,3,2,231262,231262,231264,0,2,2
66272,1,1,231263,231264,231265,1,2,0
66273,6,2,231269,231269,231271,0,2,4
66274,1,2,231270,231271,231273,1,3,0
66275,1,3,231271,231273,231276,2,5,0
66276,6,2,231277,231277,231279,0,2,1
66277,4,1,231281,231281,231282,0,1,2
66278,6,2,231287,231287,231289,0,2,5
66279,5,2,231292,231292,231294,0,2,3
66280,1,2,231293,231294,231296,1,3,0
66281,4,2,231297,231297,231299,0,2,1
66282,6,2,231303,231303,231305,0,2,4
66283,1,3,231304,231305,231308,1,4,0
66284,3,3,231307,231308,231311,1,4,0
66285,3,1,231310,231311,231312,1,2,0
66286,4,2,231314,231314,231316,0,2,2
66287,3,2,231317,231317,231319,0,2,1
66288,3,2,231320,231320,231322,0,2,1
66289,6,2,231326,231326,231328,0,2,4
66290,4,1,231330,231330,231331,0,1,2
66291,4,2,231334,231334,231336,0,2,3
66292,3,1,231337,231337,231338,0,1,1
66293,6,3,231343,231343,231346,0,3,5
66294,5,2,231348,231348,231350,0,2,2
66295,2,1,231350,231350,231351,0,1,0
66296,2,1,231352,231352,231353,0,1,1
66297,6,3,231358,231358,231361,0,3,5
66298,5,2,231363,231363,231365,0,2,2
66299,5,2,231368,231368,231370,0,2,3
66300,2,1,231370,231370,231371,0,1,0
66301,2,2,231372,231372,231374,0,2,1
66302,6,2,231378,231378,231380,0,2,4
66303,5,3,231383,231383,231386,0,3,3
66304,2,2,231385,231386,231388,1,3,0
66305,4,2,231389,231389,231391,0,2,1
66306,6,3,231395,231395,231398,0,3,4
66307,3,3,231398,231398,231401,0,3,0
66308,5,2,231403,231403,231405,0,2,2
66309,6,3,231409,231409,231412,0,3,4
66310,4,1,231413,231413,231414,0,1,1
66311,3,3,231416,231416,231419,0,3,2
66312,1,1,231417,231419,231420,2,3,0
66313,5,1,231422,231422,231423,0,1,2
66314,4,2,231426,231426,231428,0,2,3
66315,6,1,231432,231432,231433,0,1,4
66316,3,2,231435,231435,231437,0,2,2
66317,4,3,231439,231439,231442,0,3,2
66318,5,3,231444,231444,231447,0,3,2
66319,4,3,231448,231448,231451,0,3,1
66320,2,1,231450,231451,231452,1,2,0
66321,1,2,231451,231452,231454,1,3,0
66322,6,1,231457,231457,231458,0,1,3
66323,6,1,231463,231463,231464,0,1,5
66324,2,3,231465,231465,231468,0,3,1
66325,4,2,231469,231469,231471,0,2,1
66326,6,1,231475,231475,231476,0,1,4
66327,3,1,231478,231478,231479,0,1,2
66328,2,3,231480,231480,231483,0,3,1
66329,6,2,231486,231486,231488,0,2,3
66330,3,1,231489,231489,231490,0,1,1
66331,6,1,231495,231495,231496,0,1,5
66332,2,2,231497,231497,231499,0,2,1
66333,6,2,231503,231503,231505,0,2,4
66334,4,3,231507,231507,231510,0,3,2
66335,2,2,231509,231510,231512,1,3,0
66336,1,2,231510,231512,231514,2,4,0
66337,4,1,231514,231514,231515,0,1,0
66338,4,1,231518,231518,231519,0,1,3
66339,1,2,231519,231519,231521,0,2,0
66340,5,1,231524,231524,231525,0,1,3
66341,4,2,231528,231528,231530,0,2,3
66342,1,1,231529,231530,231531,1,2,0
66343,2,1,231531,231531,231532,0,1,0
66344,3,1,231534,231534,231535,0,1,2
66345,4,2,231538,231538,231540,0,2,3
66346,1,3,231539,231540,231543,1,4,0
66347,1,3,231540,231543,231546,3,6,0
66348,5,3,231545,231546,231549,1,4,0
66349,6,3,231551,231551,231554,0,3,2
66350,3,1,231554,231554,231555,0,1,0
66351,1,1,231555,231555,231556,0,1,0
66352,3,2,231558,231558,231560,0,2,2
66353,4,2,231562,231562,231564,0,2,2
66354,5,1,231567,231567,231568,0,1,3
66355,6,2,231573,231573,231575,0,2,5
66356,6,2,231579,231579,231581,0,2,4
66357,1,3,231580,231581,231584,1,4,0
66358,2,2,231582,231584,231586,2,4,0
66359,4,3,231586,231586,231589,0,3,0
66360,4,3,231590,231590,231593,0,3,1
66361,5,1,231595,231595,231596,0,1,2
66362,6,3,231601,231601,231604,0,3,5
66363,3,3,231604,231604,231607,0,3,0
66364,2,2,231606,231607,231609,1,3,0
66365,4,3,231610,231610,231613,0,3,1
66366,5,3,231615,231615,231618,0,3,2
66367,1,2,231616,231618,231620,2,4,0
66368,5,1,231621,231621,231622,0,1,1
66369,3,1,231624,231624,231625,0,1,2
66370,4,1,231628,231628,231629,0,1,3
66371,1,2,231629,231629,231631,0,2,0
66372,4,3,231633,231633,231636,0,3,2
66373,3,2,231636,231636,231638,0,2,0
66374,6,2,231642,231642,231644,0,2,4
66375,3,1,231645,231645,231646,0,1,1
66376,5,1,231650,231650,231651,0,1,4
66377,5,3,231655,231655,231658,0,3,4
66378,1,2,231656,231658,231660,2,4,0
66379,4,1,231660,231660,231661,0,1,0
66380,4,1,231664,231664,231665,0,1,3
66381,5,2,231669,231669,231671,0,2,4
66382,4,3,231673,231673,231676,0,3,2
66383,2,1,231675,231676,231677,1,2,0
66384,6,3,231681,231681,231684,0,3,4
66385,2,2,231683,231684,231686,1,3,0
66386,4,1,231687,231687,231688,0,1,1
66387,2,2,231689,231689,231691,0,2,1
66388,2,3,231691,231691,231694,0,3,0
66389,3,2,231694,231694,231696,0,2,0
66390,1,2,231695,231696,231698,1,3,0
66391,5,1,231700,231700,231701,0,1,2
66392,6,2,231706,231706,231708,0,2,5
66393,2,2,231708,231708,231710,0,2,0
66394,6,1,231714,231714,231715,0,1,4
66395,4,2,231718,231718,231720,0,2,3
66396,5,2,231723,231723,231725,0,2,3
66397,4,3,231727,231727,231730,0,3,2
66398,3,2,231730,231730,231732,0,2,0
66399,5,1,231735,231735,231736,0,1,3
66400,3,1,231738,231738,231739,0,1,2
66401,2,1,231740,231740,231741,0,1,1
66402,4,3,231744,231744,231747,0,3,3
66403,6,2,231750,231750,231752,0,2,3
66404,2,2,231752,231752,231754,0,2,0
66405,1,3,231753,231754,231757,1,4,0
66406,6,3,231759,231759,231762,0,3,2
66407,5,1,231764,231764,231765,0,1,2
66408,2,2,231766,231766,231768,0,2,1
66409,5,3,231771,231771,231774,0,3,3
66410,4,1,231775,231775,231776,0,1,1
66411,6,3,231781,231781,231784,0,3,5
66412,1,2,231782,231784,231786,2,4,0
66413,3,1,231785,231786,231787,1,2,0
66414,3,2,231788,231788,231790,0,2,1
66415,5,1,231793,231793,231794,0,1,3
66416,6,3,231799,231799,231802,0,3,5
66417,2,3,231801,231802,231805,1,4,0
66418,2,1,231803,231805,231806,2,3,0
66419,6,3,231809,231809,231812,0,3,3
66420,2,3,231811,231812,231815,1,4,0
66421,3,3,231814,231815,231818,1,4,0
66422,5,3,231819,231819,231822,0,3,1
66423,5,1,231824,231824,231825,0,1,2
66424,1,3,231825,231825,231828,0,3,0
66425,5,3,231830,231830,231833,0,3,2
66426,3,1,231833,231833,231834,0,1,0
66427,1,3,231834,231834,231837,0,3,0
66428,4,3,231838,231838,231841,0,3,1
66429,5,1,231843,231843,231844,0,1,2
66430,5,2,231848,231848,231850,0,2,4
66431,5,3,231853,231853,231856,0,3,3
66432,2,2,231855,231856,231858,1,3,0
66433,1,1,231856,231858,231859,2,3,0
66434,4,1,231860,231860,231861,0,1,1
66435,2,2,231862,231862,231864,0,2,1
66436,1,2,231863,231864,231866,1,3,0
66437,1,1,231864,231866,231867,2,3,0
66438,3,3,231867,231867,231870,0,3,0
66439,5,1,231872,231872,231873,0,1,2
66440,1,1,231873,231873,231874,0,1,0
66441,3,2,231876,231876,231878,0,2,2
66442,1,2,231877,231878,231880,1,3,0
66443,5,1,231882,231882,231883,0,1,2
66444,5,3,231887,231887,231890,0,3,4
66445,2,1,231889,231890,231891,1,2,0
66446,2,2,231891,231891,231893,0,2,0
66447,5,3,231896,231896,231899,0,3,3
66448,6,2,231902,231902,231904,0,2,3
66449,1,3,231903,231904,231907,1,4,0
66450,2,3,231905,231907,231910,2,5,0
66451,3,3,231908,231910,231913,2,5,0
66452,3,3,231911,231913,231916,2,5,0
66453,3,1,231914,231916,231917,2,3,0
66454,4,2,231918,231918,231920,0,2,1
66455,4,1,231922,231922,231923,0,1,2
66456,4,2,231926,231926,231928,0,2,3
66457,4,2,231930,231930,231932,0,2,2
66458,3,2,231933,231933,231935,0,2,1
66459,2,3,231935,231935,231938,0,3,0
66460,1,1,231936,231938,231939,2,3,0
66461,4,2,231940,231940,231942,0,2,1
66462,6,2,231946,231946,231948,0,2,4
66463,2,1,231948,231948,231949,0,1,0
66464,6,2,231954,231954,231956,0,2,5
66465,4,2,231958,231958,231960,0,2,2
66466,1,3,231959,231960,231963,1,4,0
66467,1,2,231960,231963,231965,3,5,0
66468,6,3,231966,231966,231969,0,3,1
66469,4,1,231970,231970,231971,0,1,1
66470,5,1,231975,231975,231976,0,1,4
66471,3,2,231978,231978,231980,0,2,2
66472,1,1,231979,231980,231981,1,2,0
66473,4,1,231983,231983,231984,0,1,2
66474,3,2,231986,231986,231988,0,2,2
66475,3,2,231989,231989,231991,0,2,1
66476,4,1,231993,231993,231994,0,1,2
66477,6,3,231999,231999,232002,0,3,5
66478,2,1,232001,232002,232003,1,2,0
66479,6,2,232007,232007,232009,0,2,4
66480,2,1,232009,232009,232010,0,1,0
66481,6,3,232015,232015,232018,0,3,5
66482,5,3,232020,232020,232023,0,3,2
66483,1,2,232021,232023,232025,2,4,0
66484,5,2,232026,232026,232028,0,2,1
66485,1,2,232027,232028,232030,1,3,0
66486,5,2,232032,232032,232034,0,2,2
66487,3,1,232035,232035,232036,0,1,1
66488,2,1,232037,232037,232038,0,1,1
66489,5,1,232042,232042,232043,0,1,4
66490,2,1,232044,232044,232045,0,1,1
66491,5,2,232049,232049,232051,0,2,4
66492,1,3,232050,232051,232054,1,4,0
66493,2,1,232052,232054,232055,2,3,0
66494,2,2,232054,232055,232057,1,3,0
66495,4,1,232058,232058,232059,0,1,1
66496,6,3,232064,232064,232067,0,3,5
66497,1,1,232065,232067,232068,2,3,0
66498,1,3,232066,232068,232071,2,5,0
66499,6,2,232072,232072,232074,0,2,1
66500,5,2,232077,232077,232079,0,2,3
66501,2,2,232079,232079,232081,0,2,0
66502,4,3,232083,232083,232086,0,3,2
66503,4,1,232087,232087,232088,0,1,1
66504,2,3,232089,232089,232092,0,3,1
66505,6,1,232095,232095,232096,0,1,3
66506,6,2,232101,232101,232103,0,2,5
66507,5,2,232106,232106,232108,0,2,3
66508,6,2,232112,232112,232114,0,2,4
66509,2,3,232114,232114,232117,0,3,0
66510,6,3,232120,232120,232123,0,3,3
66511,4,2,232124,232124,232126,0,2,1
66512,5,2,232129,232129,232131,0,2,3
66513,6,1,232135,232135,232136,0,1,4
66514,2,2,232137,232137,232139,0,2,1
66515,6,3,232143,232143,232146,0,3,4
66516,3,2,232146,232146,232148,0,2,0
66517,2,2,232148,232148,232150,0,2,0
66518,3,2,232151,232151,232153,0,2,1
66519,2,2,232153,232153,232155,0,2,0
66520,4,2,232157,232157,232159,0,2,2
66521,3,2,232160,232160,232162,0,2,1
66522,3,2,232163,232163,232165,0,2,1
66523,5,1,232168,232168,232169,0,1,3
66524,3,2,232171,232171,232173,0,2,2
66525,6,3,232177,232177,232180,0,3,4
66526,6,2,232183,232183,232185,0,2,3
66527,4,1,232187,232187,232188,0,1,2
66528,5,2,232192,232192,232194,0,2,4
66529,1,2,232193,232194,232196,1,3,0
66530,2,3,232195,232196,232199,1,4,0
66531,4,2,232199,232199,232201,0,2,0
66532,5,2,232204,232204,232206,0,2,3
66533,3,2,232207,232207,232209,0,2,1
66534,5,1,232212,232212,232213,0,1,3
66535,4,2,232216,232216,232218,0,2,3
66536,2,1,232218,232218,232219,0,1,0
66537,1,3,232219,232219,232222,0,3,0
66538,2,3,232221,232222,232225,1,4,0
66539,5,3,232226,232226,232229,0,3,1
66540,6,1,232232,232232,232233,0,1,3
66541,2,2,232234,232234,232236,0,2,1
66542,5,3,232239,232239,232242,0,3,3
66543,5,3,232244,232244,232247,0,3,2
66544,4,2,232248,232248,232250,0,2,1
66545,1,2,232249,232250,232252,1,3,0
66546,6,3,232255,232255,232258,0,3,3
66547,3,1,232258,232258,232259,0,1,0
66548,1,2,232259,232259,232261,0,2,0
66549,6,3,232265,232265,232268,0,3,4
66550,1,3,232266,232268,232271,2,5,0
66551,1,3,232267,232271,232274,4,7,0
66552,6,3,232273,232274,232277,1,4,0
66553,3,2,232276,232277,232279,1,3,0
66554,6,3,232282,232282,232285,0,3,3
66555,5,1,232287,232287,232288,0,1,2
66556,4,3,232291,232291,232294,0,3,3
66557,2,3,232293,232294,232297,1,4,0
66558,4,3,232297,232297,232300,0,3,0
66559,6,3,232303,232303,232306,0,3,3
66560,2,1,232305,232306,232307,1,2,0
66561,6,3,232311,232311,232314,0,3,4
66562,3,1,232314,232314,232315,0,1,0
66563,6,2,232320,232320,232322,0,2,5
66564,2,2,232322,232322,232324,0,2,0
66565,6,1,232328,232328,232329,0,1,4
66566,4,2,232332,232332,232334,0,2,3
66567,2,1,232334,232334,232335,0,1,0
66568,2,1,232336,232336,232337,0,1,1
66569,4,3,232340,232340,232343,0,3,3
66570,1,1,232341,232343,232344,2,3,0
66571,4,2,232345,232345,232347,0,2,1
66572,1,1,232346,232347,232348,1,2,0
66573,1,2,232347,232348,232350,1,3,0
66574,2,1,232349,232350,232351,1,2,0
66575,6,1,232355,232355,232356,0,1,4
66576,3,3,232358,232358,232361,0,3,2
66577,1,3,232359,232361,232364,2,5,0
66578,2,1,232361,232364,232365,3,4,0
66579,3,2,232364,232365,232367,1,3,0
66580,1,3,232365,232367,232370,2,5,0
66581,1,3,232366,232370,232373,4,7,0
66582,1,1,232367,232373,232374,6,7,0
66583,3,2,232370,232374,232376,4,6,0
66584,1,1,232371,232376,232377,5,6,0
66585,2,2,232373,232377,232379,4,6,0
66586,4,3,232377,232379,232382,2,5,0
66587,4,3,232381,232382,232385,1,4,0
66588,3,1,232384,232385,232386,1,2,0
66589,1,3,232385,232386,232389,1,4,0
66590,3,2,232388,232389,232391,1,3,0
66591,2,3,232390,232391,232394,1,4,0
66592,4,1,232394,232394,232395,0,1,0
66593,6,1,232400,232400,232401,0,1,5
66594,3,3,232403,232403,232406,0,3,2
66595,3,2,232406,232406,232408,0,2,0
66596,2,1,232408,232408,232409,0,1,0
66597,2,1,232410,232410,232411,0,1,1
66598,5,2,232415,232415,232417,0,2,4
66599,6,1,232421,232421,232422,0,1,4
66600,3,1,232424,232424,232425,0,1,2
66601,1,2,232425,232425,232427,0,2,0
66602,6,1,232431,232431,232432,0,1,4
66603,2,1,232433,232433,232434,0,1,1
66604,2,2,232435,232435,232437,0,2,1
66605,1,3,232436,232437,232440,1,4,0
66606,4,2,232440,232440,232442,0,2,0
66607,1,3,232441,232442,232445,1,4,0
66608,2,2,232443,232445,232447,2,4,0
66609,6,1,232449,232449,232450,0,1,2
66610,4,1,232453,232453,232454,0,1,3
66611,5,3,232458,232458,232461,0,3,4
66612,5,2,232463,232463,232465,0,2,2
66613,5,3,232468,232468,232471,0,3,3
66614,1,2,232469,232471,232473,2,4,0
66615,2,1,232471,232473,232474,2,3,0
66616,1,3,232472,232474,232477,2,5,0
66617,2,2,232474,232477,232479,3,5,0
66618,3,3,232477,232479,232482,2,5,0
66619,1,2,232478,232482,232484,4,6,0
66620,3,2,232481,232484,232486,3,5,0
66621,3,3,232484,232486,232489,2,5,0
66622,1,3,232485,232489,232492,4,7,0
66623,3,1,232488,232492,232493,4,5,0
66624,1,1,232489,232493,232494,4,5,0
66625,2,3,232491,232494,232497,3,6,0
66626,5,2,232496,232497,232499,1,3,0
66627,6,3,232502,232502,232505,0,3,3
66628,2,3,232504,232505,232508,1,4,0
66629,5,3,232509,232509,232512,0,3,1
66630,6,3,232515,232515,232518,0,3,3
66631,3,3,232518,232518,232521,0,3,0
66632,4,1,232522,232522,232523,0,1,1
66633,5,3,232527,232527,232530,0,3,4
66634,5,1,232532,232532,232533,0,1,2
66635,5,2,232537,232537,232539,0,2,4
66636,4,3,232541,232541,232544,0,3,2
66637,2,1,232543,232544,232545,1,2,0
66638,2,1,232545,232545,232546,0,1,0
66639,4,2,232549,232549,232551,0,2,3
66640,4,1,232553,232553,232554,0,1,2
66641,4,1,232557,232557,232558,0,1,3
66642,5,3,232562,232562,232565,0,3,4
66643,1,3,232563,232565,232568,2,5,0
66644,6,1,232569,232569,232570,0,1,1
66645,3,2,232572,232572,232574,0,2,2
66646,4,3,232576,232576,232579,0,3,2
66647,1,1,232577,232579,232580,2,3,0
66648,5,1,232582,232582,232583,0,1,2
66649,4,3,232586,232586,232589,0,3,3
66650,6,1,232592,232592,232593,0,1,3
66651,3,2,232595,232595,232597,0,2,2
66652,5,2,232600,232600,232602,0,2,3
66653,3,3,232603,232603,232606,0,3,1
66654,4,3,232607,232607,232610,0,3,1
66655,1,3,232608,232610,232613,2,5,0
66656,1,3,232609,232613,232616,4,7,0
66657,1,1,232610,232616,232617,6,7,0
66658,4,2,232614,232617,232619,3,5,0
66659,5,2,232619,232619,232621,0,2,0
66660,4,3,232623,232623,232626,0,3,2
66661,2,2,232625,232626,232628,1,3,0
66662,5,3,232630,232630,232633,0,3,2
66663,6,1,232636,232636,232637,0,1,3
66664,6,2,232642,232642,232644,0,2,5
66665,2,2,232644,232644,232646,0,2,0
66666,3,1,232647,232647,232648,0,1,1
66667,5,3,232652,232652,232655,0,3,4
66668,2,2,232654,232655,232657,1,3,0
66669,2,1,232656,232657,232658,1,2,0
66670,3,2,232659,232659,232661,0,2,1
66671,4,1,232663,232663,232664,0,1,2
66672,3,2,232666,232666,232668,0,2,2
66673,5,3,232671,232671,232674,0,3,3
66674,6,1,232677,232677,232678,0,1,3
66675,2,3,232679,232679,232682,0,3,1
66676,1,3,232680,232682,232685,2,5,0
66677,6,3,232686,232686,232689,0,3,1
66678,4,2,232690,232690,232692,0,2,1
66679,1,1,232691,232692,232693,1,2,0
66680,1,2,232692,232693,232695,1,3,0
66681,6,3,232698,232698,232701,0,3,3
66682,3,1,232701,232701,232702,0,1,0
66683,3,1,232704,232704,232705,0,1,2
66684,6,1,232710,232710,232711,0,1,5
66685,1,3,232711,232711,232714,0,3,0
66686,5,3,232716,232716,232719,0,3,2
66687,6,1,232722,232722,232723,0,1,3
66688,5,1,232727,232727,232728,0,1,4
66689,6,3,232733,232733,232736,0,3,5
66690,1,2,232734,232736,232738,2,4,0
66691,6,3,232740,232740,232743,0,3,2
66692,1,3,232741,232743,232746,2,5,0
66693,2,2,232743,232746,232748,3,5,0
66694,3,2,232746,232748,232750,2,4,0
66695,4,2,232750,232750,232752,0,2,0
66696,3,1,232753,232753,232754,0,1,1
66697,1,1,232754,232754,232755,0,1,0
66698,5,3,232759,232759,232762,0,3,4
66699,3,1,232762,232762,232763,0,1,0
66700,3,3,232765,232765,232768,0,3,2
66701,1,1,232766,232768,232769,2,3,0
66702,1,2,232767,232769,232771,2,4,0
66703,4,3,232771,232771,232774,0,3,0
66704,2,2,232773,232774,232776,1,3,0
66705,1,1,232774,232776,232777,2,3,0
66706,6,1,232780,232780,232781,0,1,3
66707,2,2,232782,232782,232784,0,2,1
66708,5,3,232787,232787,232790,0,3,3
66709,6,2,232793,232793,232795,0,2,3
66710,2,2,232795,232795,232797,0,2,0
66711,6,3,232801,232801,232804,0,3,4
66712,3,1,232804,232804,232805,0,1,0
66713,1,3,232805,232805,232808,0,3,0
66714,1,1,232806,232808,232809,2,3,0
66715,6,3,232812,232812,232815,0,3,3
66716,5,1,232817,232817,232818,0,1,2
66717,3,3,232820,232820,232823,0,3,2
66718,3,2,232823,232823,232825,0,2,0
66719,5,3,232828,232828,232831,0,3,3
66720,1,1,232829,232831,232832,2,3,0
66721,3,1,232832,232832,232833,0,1,0
66722,6,1,232838,232838,232839,0,1,5
66723,2,2,232840,232840,232842,0,2,1
66724,2,3,232842,232842,232845,0,3,0
66725,1,3,232843,232845,232848,2,5,0
66726,2,3,232845,232848,232851,3,6,0
66727,1,3,232846,232851,232854,5,8,0
66728,6,3,232852,232854,232857,2,5,0
66729,2,2,232854,232857,232859,3,5,0
66730,1,2,232855,232859,232861,4,6,0
66731,2,2,232857,232861,232863,4,6,0
66732,5,3,232862,232863,232866,1,4,0
66733,5,3,232867,232867,232870,0,3,1
66734,6,3,232873,232873,232876,0,3,3
66735,3,1,232876,232876,232877,0,1,0
66736,4,2,232880,232880,232882,0,2,3
66737,2,2,232882,232882,232884,0,2,0
66738,1,3,232883,232884,232887,1,4,0
66739,6,1,232889,232889,232890,0,1,2
66740,3,1,232892,232892,232893,0,1,2
66741,3,2,232895,232895,232897,0,2,2
66742,3,2,232898,232898,232900,0,2,1
66743,6,3,232904,232904,232907,0,3,4
66744,6,3,232910,232910,232913,0,3,3
66745,3,3,232913,232913,232916,0,3,0
66746,6,3,232919,232919,232922,0,3,3
66747,4,1,232923,232923,232924,0,1,1
66748,4,2,232927,232927,232929,0,2,3
66749,6,2,232933,232933,232935,0,2,4
66750,1,2,232934,232935,232937,1,3,0
66751,6,3,232940,232940,232943,0,3,3
66752,3,1,232943,232943,232944,0,1,0
66753,5,1,232948,232948,232949,0,1,4
66754,5,3,232953,232953,232956,0,3,4
66755,6,2,232959,232959,232961,0,2,3
66756,5,1,232964,232964,232965,0,1,3
66757,4,3,232968,232968,232971,0,3,3
66758,2,3,232970,232971,232974,1,4,0
66759,1,1,232971,232974,232975,3,4,0
66760,6,1,232977,232977,232978,0,1,2
66761,1,2,232978,232978,232980,0,2,0
66762,4,3,232982,232982,232985,0,3,2
66763,3,2,232985,232985,232987,0,2,0
66764,4,2,232989,232989,232991,0,2,2
66765,2,1,232991,232991,232992,0,1,0
66766,4,3,232995,232995,232998,0,3,3
66767,5,2,233000,233000,233002,0,2,2
66768,2,3,233002,233002,233005,0,3,0
66769,1,1,233003,233005,233006,2,3,0
66770,3,3,233006,233006,233009,0,3,0
66771,6,3,233012,233012,233015,0,3,3
66772,4,1,233016,233016,233017,0,1,1
66773,1,2,233017,233017,233019,0,2,0
66774,5,2,233022,233022,233024,0,2,3
66775,4,3,233026,233026,233029,0,3,2
66776,3,3,233029,233029,233032,0,3,0
66777,4,3,233033,233033,233036,0,3,1
66778,5,1,233038,233038,233039,0,1,2
66779,6,1,233044,233044,233045,0,1,5
66780,1,3,233045,233045,233048,0,3,0
66781,4,3,233049,233049,233052,0,3,1
66782,3,1,233052,233052,233053,0,1,0
66783,5,3,233057,233057,233060,0,3,4
66784,5,3,233062,233062,233065,0,3,2
66785,1,3,233063,233065,233068,2,5,0
66786,2,2,233065,233068,233070,3,5,0
66787,2,3,233067,233070,233073,3,6,0
66788,4,3,233071,233073,233076,2,5,0
66789,1,1,233072,233076,233077,4,5,0
66790,1,2,233073,233077,233079,4,6,0
66791,4,1,233077,233079,233080,2,3,0
66792,1,3,233078,233080,233083,2,5,0
66793,4,2,233082,233083,233085,1,3,0
66794,5,3,233087,233087,233090,0,3,2
66795,1,2,233088,233090,233092,2,4,0
66796,6,1,233094,233094,233095,0,1,2
66797,3,2,233097,233097,233099,0,2,2
66798,3,2,233100,233100,233102,0,2,1
66799,1,1,233101,233102,233103,1,2,0
66800,6,2,233107,233107,233109,0,2,4
66801,1,2,233108,233109,233111,1,3,0
66802,6,3,233114,233114,233117,0,3,3
66803,5,3,233119,233119,233122,0,3,2
66804,4,3,233123,233123,233126,0,3,1
66805,4,3,233127,233127,233130,0,3,1
66806,5,2,233132,233132,233134,0,2,2
66807,3,1,233135,233135,233136,0,1,1
66808,2,1,233137,233137,233138,0,1,1
66809,4,1,233141,233141,233142,0,1,3
66810,5,1,233146,233146,233147,0,1,4
66811,6,3,233152,233152,233155,0,3,5
66812,5,1,233157,233157,233158,0,1,2
66813,6,1,233163,233163,233164,0,1,5
66814,1,2,233164,233164,233166,0,2,0
66815,3,3,233167,233167,233170,0,3,1
66816,3,3,233170,233170,233173,0,3,0
66817,1,3,233171,233173,233176,2,5,0
66818,5,1,233176,233176,233177,0,1,0
66819,3,1,233179,233179,233180,0,1,2
66820,4,2,233183,233183,233185,0,2,3
66821,2,1,233185,233185,233186,0,1,0
66822,2,1,233187,233187,233188,0,1,1
66823,2,1,233189,233189,233190,0,1,1
66824,3,2,233192,233192,233194,0,2,2
66825,5,1,233197,233197,233198,0,1,3
66826,3,1,233200,233200,233201,0,1,2
66827,2,2,233202,233202,233204,0,2,1
66828,1,3,233203,233204,233207,1,4,0
66829,1,2,233204,233207,233209,3,5,0
66830,6,1,233210,233210,233211,0,1,1
66831,3,1,233213,233213,233214,0,1,2
66832,5,1,233218,233218,233219,0,1,4
66833,6,1,233224,233224,233225,0,1,5
66834,1,2,233225,233225,233227,0,2,0
66835,6,1,233231,233231,233232,0,1,4
66836,4,2,233235,233235,233237,0,2,3
66837,6,3,233241,233241,233244,0,3,4
66838,4,3,233245,233245,233248,0,3,1
66839,4,3,233249,233249,233252,0,3,1
66840,3,2,233252,233252,233254,0,2,0
66841,1,3,233253,233254,233257,1,4,0
66842,1,2,233254,233257,233259,3,5,0
66843,3,3,233257,233259,233262,2,5,0
66844,1,1,233258,233262,233263,4,5,0
66845,2,3,233260,233263,233266,3,6,0
66846,4,1,233264,233266,233267,2,3,0
66847,1,3,233265,233267,233270,2,5,0
66848,5,1,233270,233270,233271,0,1,0
66849,4,2,233274,233274,233276,0,2,3
66850,4,3,233278,233278,233281,0,3,2
66851,2,2,233280,233281,233283,1,3,0
66852,3,3,233283,233283,233286,0,3,0
66853,5,3,233288,233288,233291,0,3,2
66854,5,2,233293,233293,233295,0,2,2
66855,1,2,233294,233295,233297,1,3,0
66856,6,1,233300,233300,233301,0,1,3
66857,3,3,233303,233303,233306,0,3,2
66858,2,2,233305,233306,233308,1,3,0
66859,2,1,233307,233308,233309,1,2,0
66860,1,3,233308,233309,233312,1,4,0
66861,4,1,233312,233312,233313,0,1,0
66862,5,3,233317,233317,233320,0,3,4
66863,1,2,233318,233320,233322,2,4,0
66864,3,2,233321,233322,233324,1,3,0
66865,2,1,233323,233324,233325,1,2,0
66866,4,1,233327,233327,233328,0,1,2
66867,2,2,233329,233329,233331,0,2,1
66868,5,1,233334,233334,233335,0,1,3
66869,4,2,233338,233338,233340,0,2,3
66870,1,3,233339,233340,233343,1,4,0
66871,6,2,233345,233345,233347,0,2,2
66872,3,3,233348,233348,233351,0,3,1
66873,5,2,233353,233353,233355,0,2,2
66874,1,3,233354,233355,233358,1,4,0
66875,4,2,233358,233358,233360,0,2,0
66876,3,1,233361,233361,233362,0,1,1
66877,5,1,233366,233366,233367,0,1,4
66878,4,2,233370,233370,233372,0,2,3
66879,5,1,233375,233375,233376,0,1,3
66880,4,3,233379,233379,233382,0,3,3
66881,5,1,233384,233384,233385,0,1,2
66882,5,3,233389,233389,233392,0,3,4
66883,4,3,233393,233393,233396,0,3,1
66884,1,2,233394,233396,233398,2,4,0
66885,3,3,233397,233398,233401,1,4,0
66886,1,3,233398,233401,233404,3,6,0
66887,1,2,233399,233404,233406,5,7,0
66888,4,2,233403,233406,233408,3,5,0
66889,6,3,233409,233409,233412,0,3,1
66890,1,2,233410,233412,233414,2,4,0
66891,3,3,233413,233414,233417,1,4,0
66892,3,2,233416,233417,233419,1,3,0
66893,3,2,233419,233419,233421,0,2,0
66894,2,1,233421,233421,233422,0,1,0
66895,4,3,233425,233425,233428,0,3,3
66896,2,3,233427,233428,233431,1,4,0
66897,2,3,233429,233431,233434,2,5,0
66898,3,2,233432,233434,233436,2,4,0
66899,6,1,233438,233438,233439,0,1,2
66900,3,2,233441,233441,233443,0,2,2
66901,6,1,233447,233447,233448,0,1,4
66902,1,3,233448,233448,233451,0,3,0
66903,5,1,233453,233453,233454,0,1,2
66904,3,2,233456,233456,233458,0,2,2
66905,4,1,233460,233460,233461,0,1,2
66906,2,3,233462,233462,233465,0,3,1
66907,3,3,233465,233465,233468,0,3,0
66908,6,1,233471,233471,233472,0,1,3
66909,3,2,233474,233474,233476,0,2,2
66910,6,1,233480,233480,233481,0,1,4
66911,4,3,233484,233484,233487,0,3,3
66912,3,1,233487,233487,233488,0,1,0
66913,4,2,233491,233491,233493,0,2,3
66914,2,2,233493,233493,233495,0,2,0
66915,3,3,233496,233496,233499,0,3,1
66916,1,2,233497,233499,233501,2,4,0
66917,3,3,233500,233501,233504,1,4,0
66918,5,1,233505,233505,233506,0,1,1
66919,3,3,233508,233508,233511,0,3,2
66920,1,3,233509,233511,233514,2,5,0
66921,1,2,233510,233514,233516,4,6,0
66922,5,3,233515,233516,233519,1,4,0
66923,6,2,233521,233521,233523,0,2,2
66924,1,1,233522,233523,233524,1,2,0
66925,3,3,233525,233525,233528,0,3,1
66926,3,1,233528,233528,233529,0,1,0
66927,5,2,233533,233533,233535,0,2,4
66928,5,2,233538,233538,233540,0,2,3
66929,4,3,233542,233542,233545,0,3,2
66930,1,3,233543,233545,233548,2,5,0
66931,3,2,233546,233548,233550,2,4,0
66932,3,1,233549,233550,233551,1,2,0
66933,6,2,233555,233555,233557,0,2,4
66934,2,2,233557,233557,233559,0,2,0
66935,6,3,233563,233563,233566,0,3,4
66936,4,1,233567,233567,233568,0,1,1
66937,3,2,233570,233570,233572,0,2,2
66938,1,3,233571,233572,233575,1,4,0
66939,4,3,233575,233575,233578,0,3,0
66940,6,1,233581,233581,233582,0,1,3
66941,3,3,233584,233584,233587,0,3,2
66942,5,2,233589,233589,233591,0,2,2
66943,5,1,233594,233594,233595,0,1,3
66944,1,3,233595,233595,233598,0,3,0
66945,4,2,233599,233599,233601,0,2,1
66946,3,2,233602,233602,233604,0,2,1
66947,6,1,233608,233608,233609,0,1,4
66948,2,2,233610,233610,233612,0,2,1
66949,6,2,233616,233616,233618,0,2,4
66950,1,3,233617,233618,233621,1,4,0
66951,4,3,233621,233621,233624,0,3,0
66952,1,3,233622,233624,233627,2,5,0
66953,6,1,233628,233628,233629,0,1,1
66954,3,1,233631,233631,233632,0,1,2
66955,1,1,233632,233632,233633,0,1,0
66956,4,2,233636,233636,233638,0,2,3
66957,5,1,233641,233641,233642,0,1,3
66958,1,3,233642,233642,233645,0,3,0
66959,3,1,233645,233645,233646,0,1,0
66960,1,3,233646,233646,233649,0,3,0
66961,3,1,233649,233649,233650,0,1,0
66962,1,3,233650,233650,233653,0,3,0
66963,2,2,233652,233653,233655,1,3,0
66964,3,2,233655,233655,233657,0,2,0
66965,3,3,233658,233658,233661,0,3,1
66966,4,3,233662,233662,233665,0,3,1
66967,5,1,233667,233667,233668,0,1,2
66968,6,3,233673,233673,233676,0,3,5
66969,4,2,233677,233677,233679,0,2,1
66970,5,1,233682,233682,233683,0,1,3
66971,2,2,233684,233684,233686,0,2,1
66972,2,3,233686,233686,233689,0,3,0
66973,1,2,233687,233689,233691,2,4,0
66974,1,1,233688,233691,233692,3,4,0
66975,2,1,233690,233692,233693,2,3,0
66976,5,1,233695,233695,233696,0,1,2
66977,3,2,233698,233698,233700,0,2,2
66978,5,1,233703,233703,233704,0,1,3
66979,2,3,233705,233705,233708,0,3,1
66980,4,2,233709,233709,233711,0,2,1
66981,6,1,233715,233715,233716,0,1,4
66982,4,2,233719,233719,233721,0,2,3
66983,6,1,233725,233725,233726,0,1,4
66984,1,1,233726,233726,233727,0,1,0
66985,2,2,233728,233728,233730,0,2,1
66986,1,3,233729,233730,233733,1,4,0
66987,2,3,233731,233733,233736,2,5,0
66988,5,1,233736,233736,233737,0,1,0
66989,1,3,233737,233737,233740,0,3,0
66990,4,3,233741,233741,233744,0,3,1
66991,5,2,233746,233746,233748,0,2,2
66992,2,3,233748,233748,233751,0,3,0
66993,5,1,233753,233753,233754,0,1,2
66994,1,1,233754,233754,233755,0,1,0
66995,1,2,233755,233755,233757,0,2,0
66996,3,2,233758,233758,233760,0,2,1
66997,4,2,233762,233762,233764,0,2,2
66998,4,3,233766,233766,233769,0,3,2
66999,5,1,233771,233771,233772,0,1,2
67000,2,3,233773,233773,233776,0,3,1
67001,6,2,233779,233779,233781,0,2,3
67002,5,1,233784,233784,233785,0,1,3
67003,5,3,233789,233789,233792,0,3,4
67004,1,2,233790,233792,233794,2,4,0
67005,2,2,233792,233794,233796,2,4,0
67006,4,3,233796,233796,233799,0,3,0
67007,1,2,233797,233799,233801,2,4,0
67008,4,1,233801,233801,233802,0,1,0
67009,6,1,233807,233807,233808,0,1,5
67010,3,2,233810,233810,233812,0,2,2
67011,3,2,233813,233813,233815,0,2,1
67012,3,2,233816,233816,233818,0,2,1
67013,2,1,233818,233818,233819,0,1,0
67014,4,1,233822,233822,233823,0,1,3
67015,2,1,233824,233824,233825,0,1,1
67016,3,2,233827,233827,233829,0,2,2
67017,4,2,233831,233831,233833,0,2,2
67018,5,2,233836,233836,233838,0,2,3
67019,2,1,233838,233838,233839,0,1,0
67020,6,3,233844,233844,233847,0,3,5
67021,5,3,233849,233849,233852,0,3,2
67022,4,1,233853,233853,233854,0,1,1
67023,4,1,233857,233857,233858,0,1,3
67024,4,3,233861,233861,233864,0,3,3
67025,6,3,233867,233867,233870,0,3,3
67026,5,1,233872,233872,233873,0,1,2
67027,1,1,233873,233873,233874,0,1,0
67028,4,2,233877,233877,233879,0,2,3
67029,5,3,233882,233882,233885,0,3,3
67030,1,2,233883,233885,233887,2,4,0
67031,2,2,233885,233887,233889,2,4,0
67032,3,1,233888,233889,233890,1,2,0
67033,2,1,233890,233890,233891,0,1,0
67034,1,1,233891,233891,233892,0,1,0
67035,3,1,233894,233894,233895,0,1,2
67036,4,3,233898,233898,233901,0,3,3
67037,5,1,233903,233903,233904,0,1,2
67038,2,2,233905,233905,233907,0,2,1
67039,4,1,233909,233909,233910,0,1,2
67040,6,3,233915,233915,233918,0,3,5
67041,4,2,233919,233919,233921,0,2,1
67042,4,1,233923,233923,233924,0,1,2
67043,6,1,233929,233929,233930,0,1,5
67044,5,1,233934,233934,233935,0,1,4
67045,6,1,233940,233940,233941,0,1,5
67046,4,1,233944,233944,233945,0,1,3
67047,2,1,233946,233946,233947,0,1,1
67048,1,1,233947,233947,233948,0,1,0
67049,5,2,233952,233952,233954,0,2,4
67050,1,1,233953,233954,233955,1,2,0
67051,5,2,233958,233958,233960,0,2,3
67052,2,1,233960,233960,233961,0,1,0
67053,5,2,233965,233965,233967,0,2,4
67054,4,1,233969,233969,233970,0,1,2
67055,2,2,233971,233971,233973,0,2,1
67056,2,3,233973,233973,233976,0,3,0
67057,4,1,233977,233977,233978,0,1,1
67058,2,2,233979,233979,233981,0,2,1
67059,6,3,233985,233985,233988,0,3,4
67060,5,3,233990,233990,233993,0,3,2
67061,1,1,233991,233993,233994,2,3,0
67062,3,1,233994,233994,233995,0,1,0
67063,5,1,233999,233999,234000,0,1,4
67064,6,1,234005,234005,234006,0,1,5
67065,4,3,234009,234009,234012,0,3,3
67066,5,1,234014,234014,234015,0,1,2
67067,1,3,234015,234015,234018,0,3,0
67068,3,3,234018,234018,234021,0,3,0
67069,1,1,234019,234021,234022,2,3,0
67070,2,2,234021,234022,234024,1,3,0
67071,6,3,234027,234027,234030,0,3,3
67072,6,2,234033,234033,234035,0,2,3
67073,6,3,234039,234039,234042,0,3,4
67074,4,1,234043,234043,234044,0,1,1
67075,1,3,234044,234044,234047,0,3,0
67076,5,2,234049,234049,234051,0,2,2
67077,1,3,234050,234051,234054,1,4,0
67078,4,1,234054,234054,234055,0,1,0
67079,4,2,234058,234058,234060,0,2,3
67080,3,2,234061,234061,234063,0,2,1
67081,3,1,234064,234064,234065,0,1,1
67082,3,2,234067,234067,234069,0,2,2
67083,2,2,234069,234069,234071,0,2,0
67084,3,3,234072,234072,234075,0,3,1
67085,5,1,234077,234077,234078,0,1,2
67086,5,3,234082,234082,234085,0,3,4
67087,3,3,234085,234085,234088,0,3,0
67088,1,3,234086,234088,234091,2,5,0
67089,2,2,234088,234091,234093,3,5,0
67090,2,1,234090,234093,234094,3,4,0
67091,6,3,234096,234096,234099,0,3,2
67092,6,3,234102,234102,234105,0,3,3
67093,5,3,234107,234107,234110,0,3,2
67094,6,1,234113,234113,234114,0,1,3
67095,6,3,234119,234119,234122,0,3,5
67096,1,1,234120,234122,234123,2,3,0
67097,3,2,234123,234123,234125,0,2,0
67098,3,2,234126,234126,234128,0,2,1
67099,6,3,234132,234132,234135,0,3,4
67100,6,2,234138,234138,234140,0,2,3
67101,2,2,234140,234140,234142,0,2,0
67102,1,3,234141,234142,234145,1,4,0
67103,4,1,234145,234145,234146,0,1,0
67104,4,3,234149,234149,234152,0,3,3
67105,6,2,234155,234155,234157,0,2,3
67106,6,3,234161,234161,234164,0,3,4
67107,1,2,234162,234164,234166,2,4,0
67108,6,3,234168,234168,234171,0,3,2
67109,5,1,234173,234173,234174,0,1,2
67110,5,2,234178,234178,234180,0,2,4
67111,5,3,234183,234183,234186,0,3,3
67112,1,1,234184,234186,234187,2,3,0
67113,2,3,234186,234187,234190,1,4,0
67114,1,2,234187,234190,234192,3,5,0
67115,4,1,234191,234192,234193,1,2,0
67116,6,2,234197,234197,234199,0,2,4
67117,1,3,234198,234199,234202,1,4,0
67118,4,2,234202,234202,234204,0,2,0
67119,3,3,234205,234205,234208,0,3,1
67120,2,1,234207,234208,234209,1,2,0
67121,6,3,234213,234213,234216,0,3,4
67122,4,2,234217,234217,234219,0,2,1
67123,5,2,234222,234222,234224,0,2,3
67124,2,2,234224,234224,234226,0,2,0
67125,5,2,234229,234229,234231,0,2,3
67126,5,2,234234,234234,234236,0,2,3
67127,2,3,234236,234236,234239,0,3,0
67128,3,1,234239,234239,234240,0,1,0
67129,6,3,234245,234245,234248,0,3,5
67130,6,3,234251,234251,234254,0,3,3
67131,6,2,234257,234257,234259,0,2,3
67132,5,3,234262,234262,234265,0,3,3
67133,5,2,234267,234267,234269,0,2,2
67134,3,2,234270,234270,234272,0,2,1
67135,4,3,234274,234274,234277,0,3,2
67136,4,3,234278,234278,234281,0,3,1
67137,6,3,234284,234284,234287,0,3,3
67138,6,1,234290,234290,234291,0,1,3
67139,5,2,234295,234295,234297,0,2,4
67140,6,3,234301,234301,234304,0,3,4
67141,6,2,234307,234307,234309,0,2,3
67142,2,1,234309,234309,234310,0,1,0
67143,4,3,234313,234313,234316,0,3,3
67144,4,3,234317,234317,234320,0,3,1
67145,6,1,234323,234323,234324,0,1,3
67146,2,1,234325,234325,234326,0,1,1
67147,6,1,234331,234331,234332,0,1,5
67148,6,3,234337,234337,234340,0,3,5
67149,5,3,234342,234342,234345,0,3,2
67150,6,1,234348,234348,234349,0,1,3
67151,5,3,234353,234353,234356,0,3,4
67152,2,3,234355,234356,234359,1,4,0
67153,6,1,234361,234361,234362,0,1,2
67154,4,3,234365,234365,234368,0,3,3
67155,2,3,234367,234368,234371,1,4,0
67156,2,2,234369,234371,234373,2,4,0
67157,4,1,234373,234373,234374,0,1,0
67158,4,3,234377,234377,234380,0,3,3
67159,6,3,234383,234383,234386,0,3,3
67160,6,1,234389,234389,234390,0,1,3
67161,1,2,234390,234390,234392,0,2,0
67162,6,2,234396,234396,234398,0,2,4
67163,1,2,234397,234398,234400,1,3,0
67164,5,1,234402,234402,234403,0,1,2
67165,5,3,234407,234407,234410,0,3,4
67166,3,3,234410,234410,234413,0,3,0
67167,3,1,234413,234413,234414,0,1,0
67168,2,3,234415,234415,234418,0,3,1
67169,3,2,234418,234418,234420,0,2,0
67170,5,3,234423,234423,234426,0,3,3
67171,4,2,234427,234427,234429,0,2,1
67172,5,1,234432,234432,234433,0,1,3
67173,2,1,234434,234434,234435,0,1,1
67174,2,3,234436,234436,234439,0,3,1
67175,2,2,234438,234439,234441,1,3,0
67176,3,3,234441,234441,234444,0,3,0
67177,5,2,234446,234446,234448,0,2,2
67178,1,1,234447,234448,234449,1,2,0
67179,1,2,234448,234449,234451,1,3,0
67180,4,2,234452,234452,234454,0,2,1
67181,5,3,234457,234457,234460,0,3,3
67182,5,2,234462,234462,234464,0,2,2
67183,2,1,234464,234464,234465,0,1,0
67184,1,1,234465,234465,234466,0,1,0
67185,5,2,234470,234470,234472,0,2,4
67186,2,2,234472,234472,234474,0,2,0
67187,6,1,234478,234478,234479,0,1,4
67188,1,1,234479,234479,234480,0,1,0
67189,1,3,234480,234480,234483,0,3,0
67190,1,1,234481,234483,234484,2,3,0
67191,5,3,234486,234486,234489,0,3,2
67192,1,3,234487,234489,234492,2,5,0
67193,4,1,234491,234492,234493,1,2,0
67194,5,3,234496,234496,234499,0,3,3
67195,4,2,234500,234500,234502,0,2,1
67196,4,1,234504,234504,234505,0,1,2
67197,5,2,234509,234509,234511,0,2,4
67198,6,3,234515,234515,234518,0,3,4
67199,2,1,234517,234518,234519,1,2,0
67200,5,1,234522,234522,234523,0,1,3
67201,2,3,234524,234524,234527,0,3,1
67202,2,2,234526,234527,234529,1,3,0
67203,5,2,234531,234531,234533,0,2,2
67204,6,2,234537,234537,234539,0,2,4
67205,3,3,234540,234540,234543,0,3,1
67206,4,1,234544,234544,234545,0,1,1
67207,2,1,234546,234546,234547,0,1,1
67208,5,2,234551,234551,234553,0,2,4
67209,4,2,234555,234555,234557,0,2,2
67210,2,3,234557,234557,234560,0,3,0
67211,6,3,234563,234563,234566,0,3,3
67212,4,2,234567,234567,234569,0,2,1
67213,6,1,234573,234573,234574,0,1,4
67214,2,2,234575,234575,234577,0,2,1
67215,5,1,234580,234580,234581,0,1,3
67216,4,2,234584,234584,234586,0,2,3
67217,6,1,234590,234590,234591,0,1,4
67218,4,2,234594,234594,234596,0,2,3
67219,5,2,234599,234599,234601,0,2,3
67220,2,3,234601,234601,234604,0,3,0
67221,4,2,234605,234605,234607,0,2,1
67222,3,2,234608,234608,234610,0,2,1
67223,3,1,234611,234611,234612,0,1,1
67224,2,3,234613,234613,234616,0,3,1
67225,6,3,234619,234619,234622,0,3,3
67226,2,1,234621,234622,234623,1,2,0
67227,6,2,234627,234627,234629,0,2,4
67228,4,1,234631,234631,234632,0,1,2
67229,3,2,234634,234634,234636,0,2,2
67230,3,1,234637,234637,234638,0,1,1
67231,3,3,234640,234640,234643,0,3,2
67232,4,2,234644,234644,234646,0,2,1
67233,6,2,234650,234650,234652,0,2,4
67234,4,2,234654,234654,234656,0,2,2
67235,1,2,234655,234656,234658,1,3,0
67236,5,2,234660,234660,234662,0,2,2
67237,3,2,234663,234663,234665,0,2,1
67238,5,3,234668,234668,234671,0,3,3
67239,6,3,234674,234674,234677,0,3,3
67240,6,3,234680,234680,234683,0,3,3
67241,6,3,234686,234686,234689,0,3,3
67242,5,3,234691,234691,234694,0,3,2
67243,3,2,234694,234694,234696,0,2,0
67244,6,3,234700,234700,234703,0,3,4
67245,3,2,234703,234703,234705,0,2,0
67246,5,3,234708,234708,234711,0,3,3
67247,1,3,234709,234711,234714,2,5,0
67248,3,1,234712,234714,234715,2,3,0
67249,5,3,234717,234717,234720,0,3,2
67250,5,3,234722,234722,234725,0,3,2
67251,6,2,234728,234728,234730,0,2,3
67252,6,3,234734,234734,234737,0,3,4
67253,1,2,234735,234737,234739,2,4,0
67254,2,2,234737,234739,234741,2,4,0
67255,1,3,234738,234741,234744,3,6,0
67256,1,2,234739,234744,234746,5,7,0
67257,6,1,234745,234746,234747,1,2,0
67258,1,1,234746,234747,234748,1,2,0
67259,3,2,234749,234749,234751,0,2,1
67260,5,1,234754,234754,234755,0,1,3
67261,3,3,234757,234757,234760,0,3,2
67262,5,3,234762,234762,234765,0,3,2
67263,5,1,234767,234767,234768,0,1,2
67264,4,1,234771,234771,234772,0,1,3
67265,3,3,234774,234774,234777,0,3,2
67266,3,3,234777,234777,234780,0,3,0
67267,4,2,234781,234781,234783,0,2,1
67268,6,3,234787,234787,234790,0,3,4
67269,2,1,234789,234790,234791,1,2,0
67270,3,3,234792,234792,234795,0,3,1
67271,4,3,234796,234796,234799,0,3,1
67272,3,1,234799,234799,234800,0,1,0
67273,3,1,234802,234802,234803,0,1,2
67274,2,3,234804,234804,234807,0,3,1
67275,4,3,234808,234808,234811,0,3,1
67276,4,1,234812,234812,234813,0,1,1
67277,4,3,234816,234816,234819,0,3,3
67278,2,2,234818,234819,234821,1,3,0
67279,4,1,234822,234822,234823,0,1,1
67280,3,1,234825,234825,234826,0,1,2
67281,4,3,234829,234829,234832,0,3,3
67282,4,2,234833,234833,234835,0,2,1
67283,2,1,234835,234835,234836,0,1,0
67284,6,2,234841,234841,234843,0,2,5
67285,3,3,234844,234844,234847,0,3,1
67286,6,1,234850,234850,234851,0,1,3
67287,4,2,234854,234854,234856,0,2,3
67288,5,1,234859,234859,234860,0,1,3
67289,4,3,234863,234863,234866,0,3,3
67290,5,1,234868,234868,234869,0,1,2
67291,2,3,234870,234870,234873,0,3,1
67292,1,1,234871,234873,234874,2,3,0
67293,4,2,234875,234875,234877,0,2,1
67294,1,3,234876,234877,234880,1,4,0
67295,6,1,234882,234882,234883,0,1,2
67296,2,2,234884,234884,234886,0,2,1
67297,1,2,234885,234886,234888,1,3,0
67298,1,1,234886,234888,234889,2,3,0
67299,2,1,234888,234889,234890,1,2,0
67300,1,1,234889,234890,234891,1,2,0
67301,6,3,234895,234895,234898,0,3,4
67302,4,2,234899,234899,234901,0,2,1
67303,2,2,234901,234901,234903,0,2,0
67304,3,3,234904,234904,234907,0,3,1
67305,2,3,234906,234907,234910,1,4,0
67306,5,3,234911,234911,234914,0,3,1
67307,5,3,234916,234916,234919,0,3,2
67308,1,3,234917,234919,234922,2,5,0
67309,3,2,234920,234922,234924,2,4,0
67310,4,2,234924,234924,234926,0,2,0
67311,3,2,234927,234927,234929,0,2,1
67312,1,3,234928,234929,234932,1,4,0
67313,4,2,234932,234932,234934,0,2,0
67314,3,2,234935,234935,234937,0,2,1
67315,5,2,234940,234940,234942,0,2,3
67316,2,2,234942,234942,234944,0,2,0
67317,2,3,234944,234944,234947,0,3,0
67318,4,1,234948,234948,234949,0,1,1
67319,5,3,234953,234953,234956,0,3,4
67320,6,3,234959,234959,234962,0,3,3
67321,5,2,234964,234964,234966,0,2,2
67322,2,2,234966,234966,234968,0,2,0
67323,3,3,234969,234969,234972,0,3,1
67324,6,3,234975,234975,234978,0,3,3
67325,3,3,234978,234978,234981,0,3,0
67326,5,1,234983,234983,234984,0,1,2
67327,5,2,234988,234988,234990,0,2,4
67328,5,1,234993,234993,234994,0,1,3
67329,3,3,234996,234996,234999,0,3,2
67330,4,1,235000,235000,235001,0,1,1
67331,3,1,235003,235003,235004,0,1,2
67332,4,2,235007,235007,235009,0,2,3
67333,5,2,235012,235012,235014,0,2,3
67334,3,3,235015,235015,235018,0,3,1
67335,5,3,235020,235020,235023,0,3,2
67336,6,1,235026,235026,235027,0,1,3
67337,3,1,235029,235029,235030,0,1,2
67338,2,1,235031,235031,235032,0,1,1
67339,2,3,235033,235033,235036,0,3,1
67340,3,3,235036,235036,235039,0,3,0
67341,1,3,235037,235039,235042,2,5,0
67342,2,3,235039,235042,235045,3,6,0
67343,1,1,235040,235045,235046,5,6,0
67344,4,3,235044,235046,235049,2,5,0
67345,6,2,235050,235050,235052,0,2,1
67346,1,1,235051,235052,235053,1,2,0
67347,4,3,235055,235055,235058,0,3,2
67348,1,1,235056,235058,235059,2,3,0
67349,1,3,235057,235059,235062,2,5,0
67350,6,2,235063,235063,235065,0,2,1
67351,3,2,235066,235066,235068,0,2,1
67352,5,2,235071,235071,235073,0,2,3
67353,1,1,235072,235073,235074,1,2,0
67354,5,3,235077,235077,235080,0,3,3
67355,6,1,235083,235083,235084,0,1,3
67356,1,2,235084,235084,235086,0,2,0
67357,2,2,235086,235086,235088,0,2,0
67358,3,2,235089,235089,235091,0,2,1
67359,2,1,235091,235091,235092,0,1,0
67360,5,2,235096,235096,235098,0,2,4
67361,3,1,235099,235099,235100,0,1,1
67362,4,2,235103,235103,235105,0,2,3
67363,2,3,235105,235105,235108,0,3,0
67364,5,3,235110,235110,235113,0,3,2
67365,4,1,235114,235114,235115,0,1,1
67366,6,1,235120,235120,235121,0,1,5
67367,1,1,235121,235121,235122,0,1,0
67368,6,2,235127,235127,235129,0,2,5
67369,4,3,235131,235131,235134,0,3,2
67370,4,1,235135,235135,235136,0,1,1
67371,6,1,235141,235141,235142,0,1,5
67372,3,3,235144,235144,235147,0,3,2
67373,3,1,235147,235147,235148,0,1,0
67374,4,1,235151,235151,235152,0,1,3
67375,6,1,235157,235157,235158,0,1,5
67376,6,1,235163,235163,235164,0,1,5
67377,6,3,235169,235169,235172,0,3,5
67378,3,1,235172,235172,235173,0,1,0
67379,2,3,235174,235174,235177,0,3,1
67380,1,3,235175,235177,235180,2,5,0
67381,6,2,235181,235181,235183,0,2,1
67382,4,3,235185,235185,235188,0,3,2
67383,3,3,235188,235188,235191,0,3,0
67384,3,3,235191,235191,235194,0,3,0
67385,2,3,235193,235194,235197,1,4,0
67386,2,2,235195,235197,235199,2,4,0
67387,2,1,235197,235199,235200,2,3,0
67388,4,1,235201,235201,235202,0,1,1
67389,4,2,235205,235205,235207,0,2,3
67390,6,2,235211,235211,235213,0,2,4
67391,3,2,235214,235214,235216,0,2,1
67392,3,3,235217,235217,235220,0,3,1
67393,1,1,235218,235220,235221,2,3,0
67394,5,1,235223,235223,235224,0,1,2
67395,4,2,235227,235227,235229,0,2,3
67396,5,2,235232,235232,235234,0,2,3
67397,1,2,235233,235234,235236,1,3,0
67398,6,2,235239,235239,235241,0,2,3
67399,4,1,235243,235243,235244,0,1,2
67400,5,2,235248,235248,235250,0,2,4
67401,3,3,235251,235251,235254,0,3,1
67402,2,1,235253,235254,235255,1,2,0
67403,2,2,235255,235255,235257,0,2,0
67404,1,1,235256,235257,235258,1,2,0
67405,5,2,235261,235261,235263,0,2,3
67406,4,2,235265,235265,235267,0,2,2
67407,3,3,235268,235268,235271,0,3,1
67408,6,3,235274,235274,235277,0,3,3
67409,1,3,235275,235277,235280,2,5,0
67410,2,3,235277,235280,235283,3,6,0
67411,1,2,235278,235283,235285,5,7,0
67412,1,3,235279,235285,235288,6,9,0
67413,6,2,235285,235288,235290,3,5,0
67414,5,1,235290,235290,235291,0,1,0
67415,4,2,235294,235294,235296,0,2,3
67416,2,3,235296,235296,235299,0,3,0
67417,1,2,235297,235299,235301,2,4,0
67418,6,2,235303,235303,235305,0,2,2
67419,6,1,235309,235309,235310,0,1,4
67420,3,2,235312,235312,235314,0,2,2
67421,3,2,235315,235315,235317,0,2,1
67422,3,1,235318,235318,235319,0,1,1
67423,6,1,235324,235324,235325,0,1,5
67424,2,2,235326,235326,235328,0,2,1
67425,1,1,235327,235328,235329,1,2,0
67426,5,3,235332,235332,235335,0,3,3
67427,2,1,235334,235335,235336,1,2,0
67428,5,2,235339,235339,235341,0,2,3
67429,1,3,235340,235341,235344,1,4,0
67430,3,2,235343,235344,235346,1,3,0
67431,6,1,235349,235349,235350,0,1,3
67432,2,3,235351,235351,235354,0,3,1
67433,5,3,235356,235356,235359,0,3,2
67434,2,1,235358,235359,235360,1,2,0
67435,2,2,235360,235360,235362,0,2,0
67436,1,1,235361,235362,235363,1,2,0
67437,5,2,235366,235366,235368,0,2,3
67438,3,2,235369,235369,235371,0,2,1
67439,2,2,235371,235371,235373,0,2,0
67440,1,3,235372,235373,235376,1,4,0
67441,2,3,235374,235376,235379,2,5,0
67442,6,3,235380,235380,235383,0,3,1
67443,5,3,235385,235385,235388,0,3,2
67444,5,1,235390,235390,235391,0,1,2
67445,4,2,235394,235394,235396,0,2,3
67446,5,3,235399,235399,235402,0,3,3
67447,1,1,235400,235402,235403,2,3,0
67448,3,2,235403,235403,235405,0,2,0
67449,6,3,235409,235409,235412,0,3,4
67450,3,3,235412,235412,235415,0,3,0
67451,4,1,235416,235416,235417,0,1,1
67452,3,3,235419,235419,235422,0,3,2
67453,2,2,235421,235422,235424,1,3,0
67454,2,2,235423,235424,235426,1,3,0
67455,5,1,235428,235428,235429,0,1,2
67456,3,2,235431,235431,235433,0,2,2
67457,5,1,235436,235436,235437,0,1,3
67458,6,2,235442,235442,235444,0,2,5
67459,6,2,235448,235448,235450,0,2,4
67460,6,3,235454,235454,235457,0,3,4
67461,4,2,235458,235458,235460,0,2,1
67462,1,1,235459,235460,235461,1,2,0
67463,1,3,235460,235461,235464,1,4,0
67464,5,3,235465,235465,235468,0,3,1
67465,2,3,235467,235468,235471,1,4,0
67466,2,3,235469,235471,235474,2,5,0
67467,5,3,235474,235474,235477,0,3,0
67468,1,1,235475,235477,235478,2,3,0
67469,5,1,235480,235480,235481,0,1,2
67470,1,1,235481,235481,235482,0,1,0
67471,3,3,235484,235484,235487,0,3,2
67472,5,2,235489,235489,235491,0,2,2
67473,2,2,235491,235491,235493,0,2,0
67474,2,1,235493,235493,235494,0,1,0
67475,2,1,235495,235495,235496,0,1,1
67476,4,1,235499,235499,235500,0,1,3
67477,6,1,235505,235505,235506,0,1,5
67478,5,1,235510,235510,235511,0,1,4
67479,5,3,235515,235515,235518,0,3,4
67480,3,1,235518,235518,235519,0,1,0
67481,2,2,235520,235520,235522,0,2,1
67482,2,1,235522,235522,235523,0,1,0
67483,4,1,235526,235526,235527,0,1,3
67484,3,2,235529,235529,235531,0,2,2
67485,4,3,235533,235533,235536,0,3,2
67486,4,2,235537,235537,235539,0,2,1
67487,5,3,235542,235542,235545,0,3,3
67488,3,2,235545,235545,235547,0,2,0
67489,3,1,235548,235548,235549,0,1,1
67490,1,3,235549,235549,235552,0,3,0
67491,1,3,235550,235552,235555,2,5,0
67492,5,1,235555,235555,235556,0,1,0
67493,6,2,235561,235561,235563,0,2,5
67494,4,3,235565,235565,235568,0,3,2
67495,5,3,235570,235570,235573,0,3,2
67496,3,1,235573,235573,235574,0,1,0
67497,3,2,235576,235576,235578,0,2,2
67498,1,3,235577,235578,235581,1,4,0
67499,6,1,235583,235583,235584,0,1,2
67500,2,2,235585,235585,235587,0,2,1
67501,1,1,235586,235587,235588,1,2,0
67502,2,2,235588,235588,235590,0,2,0
67503,5,2,235593,235593,235595,0,2,3
67504,5,3,235598,235598,235601,0,3,3
67505,2,3,235600,235601,235604,1,4,0
67506,3,1,235603,235604,235605,1,2,0
67507,2,3,235605,235605,235608,0,3,0
67508,6,2,235611,235611,235613,0,2,3
67509,6,3,235617,235617,235620,0,3,4
67510,2,1,235619,235620,235621,1,2,0
67511,5,3,235624,235624,235627,0,3,3
67512,2,1,235626,235627,235628,1,2,0
67513,1,1,235627,235628,235629,1,2,0
67514,3,2,235630,235630,235632,0,2,1
67515,5,1,235635,235635,235636,0,1,3
67516,3,3,235638,235638,235641,0,3,2
67517,4,2,235642,235642,235644,0,2,1
67518,3,2,235645,235645,235647,0,2,1
67519,3,2,235648,235648,235650,0,2,1
67520,6,2,235654,235654,235656,0,2,4
67521,2,2,235656,235656,235658,0,2,0
67522,2,2,235658,235658,235660,0,2,0
67523,6,1,235664,235664,235665,0,1,4
67524,4,3,235668,235668,235671,0,3,3
67525,1,3,235669,235671,235674,2,5,0
67526,3,3,235672,235674,235677,2,5,0
67527,3,2,235675,235677,235679,2,4,0
67528,6,1,235681,235681,235682,0,1,2
67529,5,2,235686,235686,235688,0,2,4
67530,5,2,235691,235691,235693,0,2,3
67531,6,1,235697,235697,235698,0,1,4
67532,2,1,235699,235699,235700,0,1,1
67533,4,2,235703,235703,235705,0,2,3
67534,5,3,235708,235708,235711,0,3,3
67535,5,3,235713,235713,235716,0,3,2
67536,3,2,235716,235716,235718,0,2,0
67537,3,3,235719,235719,235722,0,3,1
67538,6,3,235725,235725,235728,0,3,3
67539,3,3,235728,235728,235731,0,3,0
67540,4,2,235732,235732,235734,0,2,1
67541,3,2,235735,235735,235737,0,2,1
67542,5,1,235740,235740,235741,0,1,3
67543,3,3,235743,235743,235746,0,3,2
67544,4,1,235747,235747,235748,0,1,1
67545,1,1,235748,235748,235749,0,1,0
67546,2,1,235750,235750,235751,0,1,1
67547,2,2,235752,235752,235754,0,2,1
67548,4,2,235756,235756,235758,0,2,2
67549,2,2,235758,235758,235760,0,2,0
67550,3,3,235761,235761,235764,0,3,1
67551,6,1,235767,235767,235768,0,1,3
67552,2,1,235769,235769,235770,0,1,1
67553,3,3,235772,235772,235775,0,3,2
67554,1,1,235773,235775,235776,2,3,0
67555,2,1,235775,235776,235777,1,2,0
67556,6,2,235781,235781,235783,0,2,4
67557,2,1,235783,235783,235784,0,1,0
67558,5,2,235788,235788,235790,0,2,4
67559,5,3,235793,235793,235796,0,3,3
67560,1,3,235794,235796,235799,2,5,0
67561,4,3,235798,235799,235802,1,4,0
67562,6,3,235804,235804,235807,0,3,2
67563,4,3,235808,235808,235811,0,3,1
67564,1,2,235809,235811,235813,2,4,0
67565,4,3,235813,235813,235816,0,3,0
67566,2,2,235815,235816,235818,1,3,0
67567,1,1,235816,235818,235819,2,3,0
67568,5,1,235821,235821,235822,0,1,2
67569,1,1,235822,235822,235823,0,1,0
67570,1,2,235823,235823,235825,0,2,0
67571,6,2,235829,235829,235831,0,2,4
67572,5,1,235834,235834,235835,0,1,3
67573,4,2,235838,235838,235840,0,2,3
67574,5,1,235843,235843,235844,0,1,3
67575,3,2,235846,235846,235848,0,2,2
67576,2,2,235848,235848,235850,0,2,0
67577,4,1,235852,235852,235853,0,1,2
67578,1,1,235853,235853,235854,0,1,0
67579,2,3,235855,235855,235858,0,3,1
67580,3,3,235858,235858,235861,0,3,0
67581,6,3,235864,235864,235867,0,3,3
67582,6,1,235870,235870,235871,0,1,3
67583,1,2,235871,235871,235873,0,2,0
67584,4,2,235875,235875,235877,0,2,2
67585,6,3,235881,235881,235884,0,3,4
67586,3,3,235884,235884,235887,0,3,0
67587,6,1,235890,235890,235891,0,1,3
67588,2,2,235892,235892,235894,0,2,1
67589,4,1,235896,235896,235897,0,1,2
67590,6,3,235902,235902,235905,0,3,5
67591,2,3,235904,235905,235908,1,4,0
67592,5,3,235909,235909,235912,0,3,1
67593,1,1,235910,235912,235913,2,3,0
67594,3,3,235913,235913,235916,0,3,0
67595,4,1,235917,235917,235918,0,1,1
67596,1,2,235918,235918,235920,0,2,0
67597,6,3,235924,235924,235927,0,3,4
67598,4,1,235928,235928,235929,0,1,1
67599,5,2,235933,235933,235935,0,2,4
67600,1,2,235934,235935,235937,1,3,0
67601,1,1,235935,235937,235938,2,3,0
67602,1,3,235936,235938,235941,2,5,0
67603,6,3,235942,235942,235945,0,3,1
67604,3,3,235945,235945,235948,0,3,0
67605,6,2,235951,235951,235953,0,2,3
67606,4,2,235955,235955,235957,0,2,2
67607,3,3,235958,235958,235961,0,3,1
67608,4,3,235962,235962,235965,0,3,1
67609,2,2,235964,235965,235967,1,3,0
67610,2,2,235966,235967,235969,1,3,0
67611,4,1,235970,235970,235971,0,1,1
67612,3,1,235973,235973,235974,0,1,2
67613,6,1,235979,235979,235980,0,1,5
67614,6,1,235985,235985,235986,0,1,5
67615,4,3,235989,235989,235992,0,3,3
67616,6,2,235995,235995,235997,0,2,3
67617,2,3,235997,235997,236000,0,3,0
67618,1,1,235998,236000,236001,2,3,0
67619,1,2,235999,236001,236003,2,4,0
67620,6,3,236005,236005,236008,0,3,2
67621,1,2,236006,236008,236010,2,4,0
67622,1,1,236007,236010,236011,3,4,0
67623,5,3,236012,236012,236015,0,3,1
67624,3,2,236015,236015,236017,0,2,0
67625,1,2,236016,236017,236019,1,3,0
67626,3,2,236019,236019,236021,0,2,0
67627,4,3,236023,236023,236026,0,3,2
67628,2,3,236025,236026,236029,1,4,0
67629,3,3,236028,236029,236032,1,4,0
67630,5,3,236033,236033,236036,0,3,1
67631,2,2,236035,236036,236038,1,3,0
67632,1,1,236036,236038,236039,2,3,0
67633,2,3,236038,236039,236042,1,4,0
67634,2,1,236040,236042,236043,2,3,0
67635,3,1,236043,236043,236044,0,1,0
67636,5,1,236048,236048,236049,0,1,4
67637,4,1,236052,236052,236053,0,1,3
67638,1,1,236053,236053,236054,0,1,0
67639,4,3,236057,236057,236060,0,3,3
67640,5,2,236062,236062,236064,0,2,2
67641,1,2,236063,236064,236066,1,3,0
67642,3,2,236066,236066,236068,0,2,0
67643,3,3,236069,236069,236072,0,3,1
67644,4,3,236073,236073,236076,0,3,1
67645,4,2,236077,236077,236079,0,2,1
67646,5,3,236082,236082,236085,0,3,3
67647,3,3,236085,236085,236088,0,3,0
67648,1,3,236086,236088,236091,2,5,0
67649,5,3,236091,236091,236094,0,3,0
67650,1,1,236092,236094,236095,2,3,0
67651,1,3,236093,236095,236098,2,5,0
67652,6,3,236099,236099,236102,0,3,1
67653,6,2,236105,236105,236107,0,2,3
67654,5,1,236110,236110,236111,0,1,3
67655,5,3,236115,236115,236118,0,3,4
67656,1,3,236116,236118,236121,2,5,0
67657,4,1,236120,236121,236122,1,2,0
67658,6,3,236126,236126,236129,0,3,4
67659,4,2,236130,236130,236132,0,2,1
67660,3,1,236133,236133,236134,0,1,1
67661,3,2,236136,236136,236138,0,2,2
67662,6,3,236142,236142,236145,0,3,4
67663,6,3,236148,236148,236151,0,3,3
67664,5,1,236153,236153,236154,0,1,2
67665,6,3,236159,236159,236162,0,3,5
67666,1,1,236160,236162,236163,2,3,0
67667,3,3,236163,236163,236166,0,3,0
67668,3,2,236166,236166,236168,0,2,0
67669,2,2,236168,236168,236170,0,2,0
67670,1,1,236169,236170,236171,1,2,0
67671,3,3,236172,236172,236175,0,3,1
67672,1,2,236173,236175,236177,2,4,0
67673,5,1,236178,236178,236179,0,1,1
67674,1,3,236179,236179,236182,0,3,0
67675,5,3,236184,236184,236187,0,3,2
67676,1,3,236185,236187,236190,2,5,0
67677,1,1,236186,236190,236191,4,5,0
67678,1,3,236187,236191,236194,4,7,0
67679,5,3,236192,236194,236197,2,5,0
67680,4,3,236196,236197,236200,1,4,0
67681,1,2,236197,236200,236202,3,5,0
67682,1,1,236198,236202,236203,4,5,0
67683,4,3,236202,236203,236206,1,4,0
67684,3,3,236205,236206,236209,1,4,0
67685,3,3,236208,236209,236212,1,4,0
67686,2,1,236210,236212,236213,2,3,0
67687,1,2,236211,236213,236215,2,4,0
67688,1,3,236212,236215,236218,3,6,0
67689,5,2,236217,236218,236220,1,3,0
67690,5,2,236222,236222,236224,0,2,2
67691,2,1,236224,236224,236225,0,1,0
67692,5,2,236229,236229,236231,0,2,4
67693,4,2,236233,236233,236235,0,2,2
67694,1,2,236234,236235,236237,1,3,0
67695,3,3,236237,236237,236240,0,3,0
67696,1,3,236238,236240,236243,2,5,0
67697,3,3,236241,236243,236246,2,5,0
67698,1,1,236242,236246,236247,4,5,0
67699,5,1,236247,236247,236248,0,1,0
67700,3,1,236250,236250,236251,0,1,2
67701,5,2,236255,236255,236257,0,2,4
67702,1,1,236256,236257,236258,1,2,0
67703,4,2,236260,236260,236262,0,2,2
67704,4,2,236264,236264,236266,0,2,2
67705,6,1,236270,236270,236271,0,1,4
67706,1,3,236271,236271,236274,0,3,0
67707,4,3,236275,236275,236278,0,3,1
67708,3,2,236278,236278,236280,0,2,0
67709,2,1,236280,236280,236281,0,1,0
67710,3,1,236283,236283,236284,0,1,2
67711,5,2,236288,236288,236290,0,2,4
67712,5,3,236293,236293,236296,0,3,3
67713,3,3,236296,236296,236299,0,3,0
67714,6,3,236302,236302,236305,0,3,3
67715,6,3,236308,236308,236311,0,3,3
67716,3,2,236311,236311,236313,0,2,0
67717,4,1,236315,236315,236316,0,1,2
67718,6,2,236321,236321,236323,0,2,5
67719,4,1,236325,236325,236326,0,1,2
67720,3,3,236328,236328,236331,0,3,2
67721,4,2,236332,236332,236334,0,2,1
67722,1,3,236333,236334,236337,1,4,0
67723,3,2,236336,236337,236339,1,3,0
67724,3,2,236339,236339,236341,0,2,0
67725,2,3,236341,236341,236344,0,3,0
67726,1,1,236342,236344,236345,2,3,0
67727,5,3,236347,236347,236350,0,3,2
67728,2,3,236349,236350,236353,1,4,0
67729,3,3,236352,236353,236356,1,4,0
67730,4,3,236356,236356,236359,0,3,0
67731,5,2,236361,236361,236363,0,2,2
67732,1,3,236362,236363,236366,1,4,0
67733,6,3,236368,236368,236371,0,3,2
67734,4,3,236372,236372,236375,0,3,1
67735,6,1,236378,236378,236379,0,1,3
67736,6,1,236384,236384,236385,0,1,5
67737,6,2,236390,236390,236392,0,2,5
67738,1,1,236391,236392,236393,1,2,0
67739,1,3,236392,236393,236396,1,4,0
67740,6,2,236398,236398,236400,0,2,2
67741,2,1,236400,236400,236401,0,1,0
67742,6,1,236406,236406,236407,0,1,5
67743,6,1,236412,236412,236413,0,1,5
67744,4,1,236416,236416,236417,0,1,3
67745,6,3,236422,236422,236425,0,3,5
67746,5,1,236427,236427,236428,0,1,2
67747,2,1,236429,236429,236430,0,1,1
67748,4,3,236433,236433,236436,0,3,3
67749,3,2,236436,236436,236438,0,2,0
67750,4,3,236440,236440,236443,0,3,2
67751,6,2,236446,236446,236448,0,2,3
67752,1,3,236447,236448,236451,1,4,0
67753,2,2,236449,236451,236453,2,4,0
67754,6,1,236455,236455,236456,0,1,2
67755,5,2,236460,236460,236462,0,2,4
67756,2,1,236462,236462,236463,0,1,0
67757,4,2,236466,236466,236468,0,2,3
67758,3,2,236469,236469,236471,0,2,1
67759,6,1,236475,236475,236476,0,1,4
67760,3,3,236478,236478,236481,0,3,2
67761,6,3,236484,236484,236487,0,3,3
67762,5,1,236489,236489,236490,0,1,2
67763,6,2,236495,236495,236497,0,2,5
67764,6,3,236501,236501,236504,0,3,4
67765,4,1,236505,236505,236506,0,1,1
67766,4,3,236509,236509,236512,0,3,3
67767,6,1,236515,236515,236516,0,1,3
67768,3,3,236518,236518,236521,0,3,2
67769,1,2,236519,236521,236523,2,4,0
67770,1,3,236520,236523,236526,3,6,0
67771,6,3,236526,236526,236529,0,3,0
67772,4,1,236530,236530,236531,0,1,1
67773,1,3,236531,236531,236534,0,3,0
67774,4,1,236535,236535,236536,0,1,1
67775,3,2,236538,236538,236540,0,2,2
67776,1,3,236539,236540,236543,1,4,0
67777,5,2,236544,236544,236546,0,2,1
67778,4,3,236548,236548,236551,0,3,2
67779,5,2,236553,236553,236555,0,2,2
67780,4,2,236557,236557,236559,0,2,2
67781,5,3,236562,236562,236565,0,3,3
67782,6,2,236568,236568,236570,0,2,3
67783,6,2,236574,236574,236576,0,2,4
67784,5,2,236579,236579,236581,0,2,3
67785,2,3,236581,236581,236584,0,3,0
67786,4,1,236585,236585,236586,0,1,1
67787,6,3,236591,236591,236594,0,3,5
67788,2,3,236593,236594,236597,1,4,0
67789,4,2,236597,236597,236599,0,2,0
67790,3,2,236600,236600,236602,0,2,1
67791,6,2,236606,236606,236608,0,2,4
67792,1,2,236607,236608,236610,1,3,0
67793,6,1,236613,236613,236614,0,1,3
67794,4,3,236617,236617,236620,0,3,3
67795,1,2,236618,236620,236622,2,4,0
67796,5,1,236623,236623,236624,0,1,1
67797,6,1,236629,236629,236630,0,1,5
67798,2,1,236631,236631,236632,0,1,1
67799,3,3,236634,236634,236637,0,3,2
67800,2,2,236636,236637,236639,1,3,0
67801,2,1,236638,236639,236640,1,2,0
67802,1,2,236639,236640,236642,1,3,0
67803,3,1,236642,236642,236643,0,1,0
67804,5,2,236647,236647,236649,0,2,4
67805,6,2,236653,236653,236655,0,2,4
67806,3,3,236656,236656,236659,0,3,1
67807,1,2,236657,236659,236661,2,4,0
67808,2,3,236659,236661,236664,2,5,0
67809,1,3,236660,236664,236667,4,7,0
67810,3,3,236663,236667,236670,4,7,0
67811,5,3,236668,236670,236673,2,5,0
67812,2,1,236670,236673,236674,3,4,0
67813,4,1,236674,236674,236675,0,1,0
67814,6,3,236680,236680,236683,0,3,5
67815,5,1,236685,236685,236686,0,1,2
67816,3,2,236688,236688,236690,0,2,2
67817,1,1,236689,236690,236691,1,2,0
67818,1,2,236690,236691,236693,1,3,0
67819,3,2,236693,236693,236695,0,2,0
67820,5,1,236698,236698,236699,0,1,3
67821,6,1,236704,236704,236705,0,1,5
67822,2,3,236706,236706,236709,0,3,1
67823,3,1,236709,236709,236710,0,1,0
67824,1,2,236710,236710,236712,0,2,0
67825,5,2,236715,236715,236717,0,2,3
67826,3,3,236718,236718,236721,0,3,1
67827,6,1,236724,236724,236725,0,1,3
67828,3,2,236727,236727,236729,0,2,2
67829,4,1,236731,236731,236732,0,1,2
67830,4,3,236735,236735,236738,0,3,3
67831,4,1,236739,236739,236740,0,1,1
67832,5,3,236744,236744,236747,0,3,4
67833,3,2,236747,236747,236749,0,2,0
67834,2,1,236749,236749,236750,0,1,0
67835,3,3,236752,236752,236755,0,3,2
67836,2,1,236754,236755,236756,1,2,0
67837,2,1,236756,236756,236757,0,1,0
67838,4,3,236760,236760,236763,0,3,3
67839,4,3,236764,236764,236767,0,3,1
67840,1,3,236765,236767,236770,2,5,0
67841,3,2,236768,236770,236772,2,4,0
67842,4,2,236772,236772,236774,0,2,0
67843,1,3,236773,236774,236777,1,4,0
67844,6,1,236779,236779,236780,0,1,2
67845,3,3,236782,236782,236785,0,3,2
67846,4,3,236786,236786,236789,0,3,1
67847,5,1,236791,236791,236792,0,1,2
67848,6,3,236797,236797,236800,0,3,5
67849,1,1,236798,236800,236801,2,3,0
67850,1,2,236799,236801,236803,2,4,0
67851,2,2,236801,236803,236805,2,4,0
67852,1,1,236802,236805,236806,3,4,0
67853,2,3,236804,236806,236809,2,5,0
67854,5,1,236809,236809,236810,0,1,0
67855,4,1,236813,236813,236814,0,1,3
67856,5,3,236818,236818,236821,0,3,4
67857,2,2,236820,236821,236823,1,3,0
67858,3,1,236823,236823,236824,0,1,0
67859,1,3,236824,236824,236827,0,3,0
67860,4,2,236828,236828,236830,0,2,1
67861,1,2,236829,236830,236832,1,3,0
67862,2,1,236831,236832,236833,1,2,0
67863,2,1,236833,236833,236834,0,1,0
67864,5,2,236838,236838,236840,0,2,4
67865,3,2,236841,236841,236843,0,2,1
67866,6,2,236847,236847,236849,0,2,4
67867,6,2,236853,236853,236855,0,2,4
67868,4,3,236857,236857,236860,0,3,2
67869,3,2,236860,236860,236862,0,2,0
67870,3,3,236863,236863,236866,0,3,1
67871,4,2,236867,236867,236869,0,2,1
67872,1,3,236868,236869,236872,1,4,0
67873,4,2,236872,236872,236874,0,2,0
67874,3,3,236875,236875,236878,0,3,1
67875,6,2,236881,236881,236883,0,2,3
67876,6,1,236887,236887,236888,0,1,4
67877,4,1,236891,236891,236892,0,1,3
67878,2,2,236893,236893,236895,0,2,1
67879,5,2,236898,236898,236900,0,2,3
67880,3,3,236901,236901,236904,0,3,1
67881,1,2,236902,236904,236906,2,4,0
67882,6,2,236908,236908,236910,0,2,2
67883,5,2,236913,236913,236915,0,2,3
67884,5,2,236918,236918,236920,0,2,3
67885,1,1,236919,236920,236921,1,2,0
67886,1,2,236920,236921,236923,1,3,0
67887,3,1,236923,236923,236924,0,1,0
67888,3,2,236926,236926,236928,0,2,2
67889,5,2,236931,236931,236933,0,2,3
67890,6,2,236937,236937,236939,0,2,4
67891,2,1,236939,236939,236940,0,1,0
67892,6,1,236945,236945,236946,0,1,5
67893,5,1,236950,236950,236951,0,1,4
67894,1,2,236951,236951,236953,0,2,0
67895,2,3,236953,236953,236956,0,3,0
67896,2,3,236955,236956,236959,1,4,0
67897,3,1,236958,236959,236960,1,2,0
67898,5,2,236963,236963,236965,0,2,3
67899,1,2,236964,236965,236967,1,3,0
67900,4,3,236968,236968,236971,0,3,1
67901,5,3,236973,236973,236976,0,3,2
67902,3,1,236976,236976,236977,0,1,0
67903,4,2,236980,236980,236982,0,2,3
67904,6,2,236986,236986,236988,0,2,4
67905,5,3,236991,236991,236994,0,3,3
67906,6,1,236997,236997,236998,0,1,3
67907,4,1,237001,237001,237002,0,1,3
67908,6,1,237007,237007,237008,0,1,5
67909,1,3,237008,237008,237011,0,3,0
67910,4,1,237012,237012,237013,0,1,1
67911,5,1,237017,237017,237018,0,1,4
67912,2,1,237019,237019,237020,0,1,1
67913,5,2,237024,237024,237026,0,2,4
67914,1,1,237025,237026,237027,1,2,0
67915,2,3,237027,237027,237030,0,3,0
67916,5,2,237032,237032,237034,0,2,2
67917,2,3,237034,237034,237037,0,3,0
67918,4,2,237038,237038,237040,0,2,1
67919,5,1,237043,237043,237044,0,1,3
67920,1,3,237044,237044,237047,0,3,0
67921,2,1,237046,237047,237048,1,2,0
67922,3,1,237049,237049,237050,0,1,1
67923,1,3,237050,237050,237053,0,3,0
67924,2,2,237052,237053,237055,1,3,0
67925,5,3,237057,237057,237060,0,3,2
67926,6,2,237063,237063,237065,0,2,3
67927,1,1,237064,237065,237066,1,2,0
67928,6,2,237070,237070,237072,0,2,4
67929,4,2,237074,237074,237076,0,2,2
67930,1,3,237075,237076,237079,1,4,0
67931,1,3,237076,237079,237082,3,6,0
67932,1,3,237077,237082,237085,5,8,0
67933,1,3,237078,237085,237088,7,10,0
67934,5,2,237083,237088,237090,5,7,0
67935,1,2,237084,237090,237092,6,8,0
67936,2,1,237086,237092,237093,6,7,0
67937,3,1,237089,237093,237094,4,5,0
67938,5,3,237094,237094,237097,0,3,0
67939,4,1,237098,237098,237099,0,1,1
67940,5,3,237103,237103,237106,0,3,4
67941,1,3,237104,237106,237109,2,5,0
67942,3,2,237107,237109,237111,2,4,0
67943,3,3,237110,237111,237114,1,4,0
67944,1,2,237111,237114,237116,3,5,0
67945,6,2,237117,237117,237119,0,2,1
67946,5,3,237122,237122,237125,0,3,3
67947,4,3,237126,237126,237129,0,3,1
67948,2,1,237128,237129,237130,1,2,0
67949,3,2,237131,237131,237133,0,2,1
67950,6,1,237137,237137,237138,0,1,4
67951,6,3,237143,237143,237146,0,3,5
67952,1,2,237144,237146,237148,2,4,0
67953,3,3,237147,237148,237151,1,4,0
67954,2,2,237149,237151,237153,2,4,0
67955,1,1,237150,237153,237154,3,4,0
67956,6,2,237156,237156,237158,0,2,2
67957,3,3,237159,237159,237162,0,3,1
67958,5,3,237164,237164,237167,0,3,2
67959,2,1,237166,237167,237168,1,2,0
67960,3,3,237169,237169,237172,0,3,1
67961,5,3,237174,237174,237177,0,3,2
67962,3,1,237177,237177,237178,0,1,0
67963,3,1,237180,237180,237181,0,1,2
67964,2,1,237182,237182,237183,0,1,1
67965,1,1,237183,237183,237184,0,1,0
67966,1,1,237184,237184,237185,0,1,0
67967,1,1,237185,237185,237186,0,1,0
67968,5,1,237190,237190,237191,0,1,4
67969,1,2,237191,237191,237193,0,2,0
67970,3,1,237194,237194,237195,0,1,1
67971,2,3,237196,237196,237199,0,3,1
67972,1,3,237197,237199,237202,2,5,0
67973,2,1,237199,237202,237203,3,4,0
67974,2,2,237201,237203,237205,2,4,0
67975,2,1,237203,237205,237206,2,3,0
67976,1,1,237204,237206,237207,2,3,0
67977,1,1,237205,237207,237208,2,3,0
67978,5,3,237210,237210,237213,0,3,2
67979,1,3,237211,237213,237216,2,5,0
67980,3,2,237214,237216,237218,2,4,0
67981,1,1,237215,237218,237219,3,4,0
67982,2,1,237217,237219,237220,2,3,0
67983,6,1,237223,237223,237224,0,1,3
67984,6,1,237229,237229,237230,0,1,5
67985,2,2,237231,237231,237233,0,2,1
67986,1,2,237232,237233,237235,1,3,0
67987,6,2,237238,237238,237240,0,2,3
67988,4,1,237242,237242,237243,0,1,2
67989,3,3,237245,237245,237248,0,3,2
67990,2,1,237247,237248,237249,1,2,0
67991,5,2,237252,237252,237254,0,2,3
67992,6,1,237258,237258,237259,0,1,4
67993,5,3,237263,237263,237266,0,3,4
67994,5,2,237268,237268,237270,0,2,2
67995,5,1,237273,237273,237274,0,1,3
67996,5,1,237278,237278,237279,0,1,4
67997,5,3,237283,237283,237286,0,3,4
67998,1,2,237284,237286,237288,2,4,0
67999,6,1,237290,237290,237291,0,1,2
68000,1,2,237291,237291,237293,0,2,0
68001,5,2,237296,237296,237298,0,2,3
68002,5,3,237301,237301,237304,0,3,3
68003,2,3,237303,237304,237307,1,4,0
68004,1,3,237304,237307,237310,3,6,0
68005,4,1,237308,237310,237311,2,3,0
68006,6,3,237314,237314,237317,0,3,3
68007,1,1,237315,237317,237318,2,3,0
68008,5,1,237320,237320,237321,0,1,2
68009,1,2,237321,237321,237323,0,2,0
68010,3,1,237324,237324,237325,0,1,1
68011,3,2,237327,237327,237329,0,2,2
68012,4,2,237331,237331,237333,0,2,2
68013,3,3,237334,237334,237337,0,3,1
68014,3,2,237337,237337,237339,0,2,0
68015,1,1,237338,237339,237340,1,2,0
68016,6,1,237344,237344,237345,0,1,4
68017,6,3,237350,237350,237353,0,3,5
68018,2,1,237352,237353,237354,1,2,0
68019,2,1,237354,237354,237355,0,1,0
68020,6,3,237360,237360,237363,0,3,5
68021,6,2,237366,237366,237368,0,2,3
68022,2,3,237368,237368,237371,0,3,0
68023,4,2,237372,237372,237374,0,2,1
68024,6,3,237378,237378,237381,0,3,4
68025,6,1,237384,237384,237385,0,1,3
68026,2,3,237386,237386,237389,0,3,1
68027,3,1,237389,237389,237390,0,1,0
68028,6,3,237395,237395,237398,0,3,5
68029,5,1,237400,237400,237401,0,1,2
68030,5,1,237405,237405,237406,0,1,4
68031,5,3,237410,237410,237413,0,3,4
68032,5,2,237415,237415,237417,0,2,2
68033,5,2,237420,237420,237422,0,2,3
68034,6,3,237426,237426,237429,0,3,4
68035,1,1,237427,237429,237430,2,3,0
68036,1,2,237428,237430,237432,2,4,0
68037,4,3,237432,237432,237435,0,3,0
68038,5,1,237437,237437,237438,0,1,2
68039,6,2,237443,237443,237445,0,2,5
68040,4,3,237447,237447,237450,0,3,2
68041,2,1,237449,237450,237451,1,2,0
68042,2,2,237451,237451,237453,0,2,0
68043,4,3,237455,237455,237458,0,3,2
68044,4,3,237459,237459,237462,0,3,1
68045,5,1,237464,237464,237465,0,1,2
68046,3,1,237467,237467,237468,0,1,2
68047,1,2,237468,237468,237470,0,2,0
68048,6,1,237474,237474,237475,0,1,4
68049,6,3,237480,237480,237483,0,3,5
68050,5,3,237485,237485,237488,0,3,2
68051,1,2,237486,237488,237490,2,4,0
68052,1,3,237487,237490,237493,3,6,0
68053,6,3,237493,237493,237496,0,3,0
68054,1,2,237494,237496,237498,2,4,0
68055,4,1,237498,237498,237499,0,1,0
68056,3,3,237501,237501,237504,0,3,2
68057,5,3,237506,237506,237509,0,3,2
68058,1,3,237507,237509,237512,2,5,0
68059,2,3,237509,237512,237515,3,6,0
68060,1,1,237510,237515,237516,5,6,0
68061,5,3,237515,237516,237519,1,4,0
68062,3,1,237518,237519,237520,1,2,0
68063,4,2,237522,237522,237524,0,2,2
68064,4,1,237526,237526,237527,0,1,2
68065,4,1,237530,237530,237531,0,1,3
68066,1,1,237531,237531,237532,0,1,0
68067,5,1,237536,237536,237537,0,1,4
68068,4,1,237540,237540,237541,0,1,3
68069,1,2,237541,237541,237543,0,2,0
68070,4,2,237545,237545,237547,0,2,2
68071,3,3,237548,237548,237551,0,3,1
68072,3,3,237551,237551,237554,0,3,0
68073,1,2,237552,237554,237556,2,4,0
68074,3,3,237555,237556,237559,1,4,0
68075,2,2,237557,237559,237561,2,4,0
68076,5,1,237562,237562,237563,0,1,1
68077,6,2,237568,237568,237570,0,2,5
68078,1,3,237569,237570,237573,1,4,0
68079,5,2,237574,237574,237576,0,2,1
68080,4,1,237578,237578,237579,0,1,2
68081,4,3,237582,237582,237585,0,3,3
68082,5,2,237587,237587,237589,0,2,2
68083,6,3,237593,237593,237596,0,3,4
68084,1,3,237594,237596,237599,2,5,0
68085,2,2,237596,237599,237601,3,5,0
68086,4,1,237600,237601,237602,1,2,0
68087,6,1,237606,237606,237607,0,1,4
68088,4,2,237610,237610,237612,0,2,3
68089,1,1,237611,237612,237613,1,2,0
68090,5,3,237616,237616,237619,0,3,3
68091,2,3,237618,237619,237622,1,4,0
68092,3,2,237621,237622,237624,1,3,0
68093,5,2,237626,237626,237628,0,2,2
68094,2,3,237628,237628,237631,0,3,0
68095,2,3,237630,237631,237634,1,4,0
68096,2,3,237632,237634,237637,2,5,0
68097,6,1,237638,237638,237639,0,1,1
68098,1,3,237639,237639,237642,0,3,0
68099,5,1,237644,237644,237645,0,1,2
68100,4,1,237648,237648,237649,0,1,3
68101,2,2,237650,237650,237652,0,2,1
68102,3,3,237653,237653,237656,0,3,1
68103,3,1,237656,237656,237657,0,1,0
68104,5,3,237661,237661,237664,0,3,4
68105,3,1,237664,237664,237665,0,1,0
68106,6,3,237670,237670,237673,0,3,5
68107,6,2,237676,237676,237678,0,2,3
68108,2,3,237678,237678,237681,0,3,0
68109,6,2,237684,237684,237686,0,2,3
68110,5,1,237689,237689,237690,0,1,3
68111,4,2,237693,237693,237695,0,2,3
68112,1,1,237694,237695,237696,1,2,0
68113,2,2,237696,237696,237698,0,2,0
68114,1,2,237697,237698,237700,1,3,0
68115,4,2,237701,237701,237703,0,2,1
68116,5,3,237706,237706,237709,0,3,3
68117,5,3,237711,237711,237714,0,3,2
68118,6,2,237717,237717,237719,0,2,3
68119,5,2,237722,237722,237724,0,2,3
68120,3,1,237725,237725,237726,0,1,1
68121,6,1,237731,237731,237732,0,1,5
68122,3,1,237734,237734,237735,0,1,2
68123,2,2,237736,237736,237738,0,2,1
68124,4,1,237740,237740,237741,0,1,2
68125,1,2,237741,237741,237743,0,2,0
68126,4,3,237745,237745,237748,0,3,2
68127,4,3,237749,237749,237752,0,3,1
68128,5,1,237754,237754,237755,0,1,2
68129,4,1,237758,237758,237759,0,1,3
68130,6,2,237764,237764,237766,0,2,5
68131,5,2,237769,237769,237771,0,2,3
68132,5,3,237774,237774,237777,0,3,3
68133,6,3,237780,237780,237783,0,3,3
68134,6,3,237786,237786,237789,0,3,3
68135,4,3,237790,237790,237793,0,3,1
68136,2,1,237792,237793,237794,1,2,0
68137,4,3,237796,237796,237799,0,3,2
68138,3,1,237799,237799,237800,0,1,0
68139,3,1,237802,237802,237803,0,1,2
68140,5,2,237807,237807,237809,0,2,4
68141,4,2,237811,237811,237813,0,2,2
68142,1,2,237812,237813,237815,1,3,0
68143,2,1,237814,237815,237816,1,2,0
68144,1,2,237815,237816,237818,1,3,0
68145,6,1,237821,237821,237822,0,1,3
68146,1,3,237822,237822,237825,0,3,0
68147,4,1,237826,237826,237827,0,1,1
68148,3,3,237829,237829,237832,0,3,2
68149,1,2,237830,237832,237834,2,4,0
68150,6,1,237836,237836,237837,0,1,2
68151,5,1,237841,237841,237842,0,1,4
68152,6,3,237847,237847,237850,0,3,5
68153,2,2,237849,237850,237852,1,3,0
68154,1,3,237850,237852,237855,2,5,0
68155,5,2,237855,237855,237857,0,2,0
68156,4,2,237859,237859,237861,0,2,2
68157,5,2,237864,237864,237866,0,2,3
68158,1,1,237865,237866,237867,1,2,0
68159,4,3,237869,237869,237872,0,3,2
68160,2,3,237871,237872,237875,1,4,0
68161,6,2,237877,237877,237879,0,2,2
68162,3,1,237880,237880,237881,0,1,1
68163,4,3,237884,237884,237887,0,3,3
68164,6,3,237890,237890,237893,0,3,3
68165,2,2,237892,237893,237895,1,3,0
68166,6,2,237898,237898,237900,0,2,3
68167,5,2,237903,237903,237905,0,2,3
68168,2,1,237905,237905,237906,0,1,0
68169,2,3,237907,237907,237910,0,3,1
68170,6,3,237913,237913,237916,0,3,3
68171,4,2,237917,237917,237919,0,2,1
68172,2,2,237919,237919,237921,0,2,0
68173,2,3,237921,237921,237924,0,3,0
68174,4,2,237925,237925,237927,0,2,1
68175,1,1,237926,237927,237928,1,2,0
68176,1,2,237927,237928,237930,1,3,0
68177,2,3,237929,237930,237933,1,4,0
68178,2,2,237931,237933,237935,2,4,0
68179,4,3,237935,237935,237938,0,3,0
68180,6,2,237941,237941,237943,0,2,3
68181,2,2,237943,237943,237945,0,2,0
68182,3,2,237946,237946,237948,0,2,1
68183,3,3,237949,237949,237952,0,3,1
68184,1,2,237950,237952,237954,2,4,0
68185,5,3,237955,237955,237958,0,3,1
68186,1,1,237956,237958,237959,2,3,0
68187,3,1,237959,237959,237960,0,1,0
68188,1,1,237960,237960,237961,0,1,0
68189,6,3,237966,237966,237969,0,3,5
68190,2,3,237968,237969,237972,1,4,0
68191,2,2,237970,237972,237974,2,4,0
68192,2,1,237972,237974,237975,2,3,0
68193,1,3,237973,237975,237978,2,5,0
68194,2,1,237975,237978,237979,3,4,0
68195,6,3,237981,237981,237984,0,3,2
68196,2,1,237983,237984,237985,1,2,0
68197,2,2,237985,237985,237987,0,2,0
68198,4,3,237989,237989,237992,0,3,2
68199,6,1,237995,237995,237996,0,1,3
68200,6,1,238001,238001,238002,0,1,5
68201,2,3,238003,238003,238006,0,3,1
68202,3,2,238006,238006,238008,0,2,0
68203,6,2,238012,238012,238014,0,2,4
68204,1,1,238013,238014,238015,1,2,0
68205,6,3,238019,238019,238022,0,3,4
68206,4,2,238023,238023,238025,0,2,1
68207,5,1,238028,238028,238029,0,1,3
68208,6,1,238034,238034,238035,0,1,5
68209,4,1,238038,238038,238039,0,1,3
68210,4,2,238042,238042,238044,0,2,3
68211,6,2,238048,238048,238050,0,2,4
68212,4,2,238052,238052,238054,0,2,2
68213,5,1,238057,238057,238058,0,1,3
68214,2,3,238059,238059,238062,0,3,1
68215,5,2,238064,238064,238066,0,2,2
68216,2,1,238066,238066,238067,0,1,0
68217,2,2,238068,238068,238070,0,2,1
68218,2,3,238070,238070,238073,0,3,0
68219,2,3,238072,238073,238076,1,4,0
68220,3,1,238075,238076,238077,1,2,0
68221,2,1,238077,238077,238078,0,1,0
68222,2,1,238079,238079,238080,0,1,1
68223,4,2,238083,238083,238085,0,2,3
68224,1,2,238084,238085,238087,1,3,0
68225,2,1,238086,238087,238088,1,2,0
68226,4,1,238090,238090,238091,0,1,2
68227,4,3,238094,238094,238097,0,3,3
68228,5,3,238099,238099,238102,0,3,2
68229,1,2,238100,238102,238104,2,4,0
68230,4,2,238104,238104,238106,0,2,0
68231,4,3,238108,238108,238111,0,3,2
68232,2,1,238110,238111,238112,1,2,0
68233,6,2,238116,238116,238118,0,2,4
68234,1,2,238117,238118,238120,1,3,0
68235,5,1,238122,238122,238123,0,1,2
68236,4,3,238126,238126,238129,0,3,3
68237,3,3,238129,238129,238132,0,3,0
68238,5,1,238134,238134,238135,0,1,2
68239,5,2,238139,238139,238141,0,2,4
68240,1,3,238140,238141,238144,1,4,0
68241,2,1,238142,238144,238145,2,3,0
68242,2,1,238144,238145,238146,1,2,0
68243,1,1,238145,238146,238147,1,2,0
68244,6,1,238151,238151,238152,0,1,4
68245,4,1,238155,238155,238156,0,1,3
68246,2,2,238157,238157,238159,0,2,1
68247,5,1,238162,238162,238163,0,1,3
68248,4,3,238166,238166,238169,0,3,3
68249,3,2,238169,238169,238171,0,2,0
68250,3,3,238172,238172,238175,0,3,1
68251,1,3,238173,238175,238178,2,5,0
68252,4,2,238177,238178,238180,1,3,0
68253,5,1,238182,238182,238183,0,1,2
68254,4,3,238186,238186,238189,0,3,3
68255,6,2,238192,238192,238194,0,2,3
68256,1,3,238193,238194,238197,1,4,0
68257,5,2,238198,238198,238200,0,2,1
68258,2,3,238200,238200,238203,0,3,0
68259,2,2,238202,238203,238205,1,3,0
68260,3,2,238205,238205,238207,0,2,0
68261,4,2,238209,238209,238211,0,2,2
68262,5,1,238214,238214,238215,0,1,3
68263,5,2,238219,238219,238221,0,2,4
68264,4,2,238223,238223,238225,0,2,2
68265,2,3,238225,238225,238228,0,3,0
68266,1,1,238226,238228,238229,2,3,0
68267,4,1,238230,238230,238231,0,1,1
68268,1,1,238231,238231,238232,0,1,0
68269,1,1,238232,238232,238233,0,1,0
68270,3,2,238235,238235,238237,0,2,2
68271,3,1,238238,238238,238239,0,1,1
68272,6,3,238244,238244,238247,0,3,5
68273,3,1,238247,238247,238248,0,1,0
68274,2,2,238249,238249,238251,0,2,1
68275,1,2,238250,238251,238253,1,3,0
68276,1,1,238251,238253,238254,2,3,0
68277,1,1,238252,238254,238255,2,3,0
68278,3,3,238255,238255,238258,0,3,0
68279,3,2,238258,238258,238260,0,2,0
68280,4,3,238262,238262,238265,0,3,2
68281,1,3,238263,238265,238268,2,5,0
68282,2,2,238265,238268,238270,3,5,0
68283,6,2,238271,238271,238273,0,2,1
68284,1,2,238272,238273,238275,1,3,0
68285,4,2,238276,238276,238278,0,2,1
68286,4,2,238280,238280,238282,0,2,2
68287,2,2,238282,238282,238284,0,2,0
68288,5,3,238287,238287,238290,0,3,3
68289,3,3,238290,238290,238293,0,3,0
68290,6,2,238296,238296,238298,0,2,3
68291,2,3,238298,238298,238301,0,3,0
68292,6,1,238304,238304,238305,0,1,3
68293,4,3,238308,238308,238311,0,3,3
68294,3,3,238311,238311,238314,0,3,0
68295,2,3,238313,238314,238317,1,4,0
68296,6,2,238319,238319,238321,0,2,2
68297,3,1,238322,238322,238323,0,1,1
68298,1,2,238323,238323,238325,0,2,0
68299,2,3,238325,238325,238328,0,3,0
68300,4,3,238329,238329,238332,0,3,1
68301,1,3,238330,238332,238335,2,5,0
68302,2,2,238332,238335,238337,3,5,0
68303,2,2,238334,238337,238339,3,5,0
68304,3,1,238337,238339,238340,2,3,0
68305,3,3,238340,238340,238343,0,3,0
68306,3,2,238343,238343,238345,0,2,0
68307,4,3,238347,238347,238350,0,3,2
68308,2,3,238349,238350,238353,1,4,0
68309,4,2,238353,238353,238355,0,2,0
68310,2,2,238355,238355,238357,0,2,0
68311,5,1,238360,238360,238361,0,1,3
68312,4,2,238364,238364,238366,0,2,3
68313,3,1,238367,238367,238368,0,1,1
68314,1,2,238368,238368,238370,0,2,0
68315,4,3,238372,238372,238375,0,3,2
68316,2,2,238374,238375,238377,1,3,0
68317,2,2,238376,238377,238379,1,3,0
68318,5,1,238381,238381,238382,0,1,2
68319,3,2,238384,238384,238386,0,2,2
68320,5,1,238389,238389,238390,0,1,3
68321,1,1,238390,238390,238391,0,1,0
68322,3,2,238393,238393,238395,0,2,2
68323,1,2,238394,238395,238397,1,3,0
68324,3,2,238397,238397,238399,0,2,0
68325,5,2,238402,238402,238404,0,2,3
68326,6,1,238408,238408,238409,0,1,4
68327,6,3,238414,238414,238417,0,3,5
68328,6,1,238420,238420,238421,0,1,3
68329,3,1,238423,238423,238424,0,1,2
68330,5,2,238428,238428,238430,0,2,4
68331,4,3,238432,238432,238435,0,3,2
68332,2,2,238434,238435,238437,1,3,0
68333,3,1,238437,238437,238438,0,1,0
68334,5,2,238442,238442,238444,0,2,4
68335,4,2,238446,238446,238448,0,2,2
68336,1,2,238447,238448,238450,1,3,0
68337,2,2,238449,238450,238452,1,3,0
68338,1,1,238450,238452,238453,2,3,0
68339,1,3,238451,238453,238456,2,5,0
68340,4,3,238455,238456,238459,1,4,0
68341,2,2,238457,238459,238461,2,4,0
68342,2,2,238459,238461,238463,2,4,0
68343,5,1,238464,238464,238465,0,1,1
68344,1,1,238465,238465,238466,0,1,0
68345,3,3,238468,238468,238471,0,3,2
68346,1,3,238469,238471,238474,2,5,0
68347,5,1,238474,238474,238475,0,1,0
68348,1,1,238475,238475,238476,0,1,0
68349,4,2,238479,238479,238481,0,2,3
68350,1,1,238480,238481,238482,1,2,0
68351,4,2,238484,238484,238486,0,2,2
68352,1,1,238485,238486,238487,1,2,0
68353,6,3,238491,238491,238494,0,3,4
68354,6,1,238497,238497,238498,0,1,3
68355,2,2,238499,238499,238501,0,2,1
68356,1,1,238500,238501,238502,1,2,0
68357,6,3,238506,238506,238509,0,3,4
68358,3,3,238509,238509,238512,0,3,0
68359,5,3,238514,238514,238517,0,3,2
68360,3,1,238517,238517,238518,0,1,0
68361,6,2,238523,238523,238525,0,2,5
68362,3,2,238526,238526,238528,0,2,1
68363,6,1,238532,238532,238533,0,1,4
68364,1,2,238533,238533,238535,0,2,0
68365,2,2,238535,238535,238537,0,2,0
68366,1,2,238536,238537,238539,1,3,0
68367,2,1,238538,238539,238540,1,2,0
68368,4,2,238542,238542,238544,0,2,2
68369,5,3,238547,238547,238550,0,3,3
68370,4,2,238551,238551,238553,0,2,1
68371,3,1,238554,238554,238555,0,1,1
68372,5,1,238559,238559,238560,0,1,4
68373,3,2,238562,238562,238564,0,2,2
68374,4,2,238566,238566,238568,0,2,2
68375,6,3,238572,238572,238575,0,3,4
68376,6,3,238578,238578,238581,0,3,3
68377,2,3,238580,238581,238584,1,4,0
68378,4,3,238584,238584,238587,0,3,0
68379,5,1,238589,238589,238590,0,1,2
68380,2,2,238591,238591,238593,0,2,1
68381,5,3,238596,238596,238599,0,3,3
68382,6,1,238602,238602,238603,0,1,3
68383,1,1,238603,238603,238604,0,1,0
68384,3,1,238606,238606,238607,0,1,2
68385,2,1,238608,238608,238609,0,1,1
68386,3,1,238611,238611,238612,0,1,2
68387,4,3,238615,238615,238618,0,3,3
68388,5,2,238620,238620,238622,0,2,2
68389,2,2,238622,238622,238624,0,2,0
68390,3,3,238625,238625,238628,0,3,1
68391,5,2,238630,238630,238632,0,2,2
68392,6,1,238636,238636,238637,0,1,4
68393,4,3,238640,238640,238643,0,3,3
68394,6,1,238646,238646,238647,0,1,3
68395,1,3,238647,238647,238650,0,3,0
68396,1,3,238648,238650,238653,2,5,0
68397,5,1,238653,238653,238654,0,1,0
68398,3,3,238656,238656,238659,0,3,2
68399,5,1,238661,238661,238662,0,1,2
68400,1,1,238662,238662,238663,0,1,0
68401,3,3,238665,238665,238668,0,3,2
68402,5,2,238670,238670,238672,0,2,2
68403,3,2,238673,238673,238675,0,2,1
68404,6,2,238679,238679,238681,0,2,4
68405,5,1,238684,238684,238685,0,1,3
68406,4,3,238688,238688,238691,0,3,3
68407,6,3,238694,238694,238697,0,3,3
68408,6,2,238700,238700,238702,0,2,3
68409,4,2,238704,238704,238706,0,2,2
68410,6,1,238710,238710,238711,0,1,4
68411,4,3,238714,238714,238717,0,3,3
68412,3,3,238717,238717,238720,0,3,0
68413,3,3,238720,238720,238723,0,3,0
68414,3,2,238723,238723,238725,0,2,0
68415,4,1,238727,238727,238728,0,1,2
68416,3,1,238730,238730,238731,0,1,2
68417,4,1,238734,238734,238735,0,1,3
68418,4,1,238738,238738,238739,0,1,3
68419,3,1,238741,238741,238742,0,1,2
68420,1,2,238742,238742,238744,0,2,0
68421,6,2,238748,238748,238750,0,2,4
68422,6,1,238754,238754,238755,0,1,4
68423,1,2,238755,238755,238757,0,2,0
68424,5,1,238760,238760,238761,0,1,3
68425,5,2,238765,238765,238767,0,2,4
68426,3,2,238768,238768,238770,0,2,1
68427,6,1,238774,238774,238775,0,1,4
68428,3,2,238777,238777,238779,0,2,2
68429,5,3,238782,238782,238785,0,3,3
68430,1,1,238783,238785,238786,2,3,0
68431,1,3,238784,238786,238789,2,5,0
68432,6,2,238790,238790,238792,0,2,1
68433,5,1,238795,238795,238796,0,1,3
68434,3,3,238798,238798,238801,0,3,2
68435,1,2,238799,238801,238803,2,4,0
68436,4,2,238803,238803,238805,0,2,0
68437,6,1,238809,238809,238810,0,1,4
68438,6,1,238815,238815,238816,0,1,5
68439,1,2,238816,238816,238818,0,2,0
68440,6,3,238822,238822,238825,0,3,4
68441,3,2,238825,238825,238827,0,2,0
68442,1,3,238826,238827,238830,1,4,0
68443,4,3,238830,238830,238833,0,3,0
68444,4,1,238834,238834,238835,0,1,1
68445,6,3,238840,238840,238843,0,3,5
68446,2,1,238842,238843,238844,1,2,0
68447,1,3,238843,238844,238847,1,4,0
68448,3,2,238846,238847,238849,1,3,0
68449,1,1,238847,238849,238850,2,3,0
68450,1,2,238848,238850,238852,2,4,0
68451,2,3,238850,238852,238855,2,5,0
68452,3,1,238853,238855,238856,2,3,0
68453,3,3,238856,238856,238859,0,3,0
68454,2,3,238858,238859,238862,1,4,0
68455,3,1,238861,238862,238863,1,2,0
68456,4,1,238865,238865,238866,0,1,2
68457,5,2,238870,238870,238872,0,2,4
68458,2,1,238872,238872,238873,0,1,0
68459,3,2,238875,238875,238877,0,2,2
68460,3,1,238878,238878,238879,0,1,1
68461,2,3,238880,238880,238883,0,3,1
68462,6,3,238886,238886,238889,0,3,3
68463,4,1,238890,238890,238891,0,1,1
68464,2,2,238892,238892,238894,0,2,1
68465,6,3,238898,238898,238901,0,3,4
68466,1,3,238899,238901,238904,2,5,0
68467,3,3,238902,238904,238907,2,5,0
68468,1,2,238903,238907,238909,4,6,0
68469,6,1,238909,238909,238910,0,1,0
68470,1,2,238910,238910,238912,0,2,0
68471,6,1,238916,238916,238917,0,1,4
68472,2,1,238918,238918,238919,0,1,1
68473,1,3,238919,238919,238922,0,3,0
68474,2,3,238921,238922,238925,1,4,0
68475,1,2,238922,238925,238927,3,5,0
68476,2,3,238924,238927,238930,3,6,0
68477,5,2,238929,238930,238932,1,3,0
68478,6,3,238935,238935,238938,0,3,3
68479,6,3,238941,238941,238944,0,3,3
68480,6,1,238947,238947,238948,0,1,3
68481,2,1,238949,238949,238950,0,1,1
68482,2,1,238951,238951,238952,0,1,1
68483,4,2,238955,238955,238957,0,2,3
68484,4,3,238959,238959,238962,0,3,2
68485,4,3,238963,238963,238966,0,3,1
68486,1,2,238964,238966,238968,2,4,0
68487,2,1,238966,238968,238969,2,3,0
68488,3,1,238969,238969,238970,0,1,0
68489,1,3,238970,238970,238973,0,3,0
68490,6,3,238976,238976,238979,0,3,3
68491,6,1,238982,238982,238983,0,1,3
68492,3,3,238985,238985,238988,0,3,2
68493,6,2,238991,238991,238993,0,2,3
68494,2,1,238993,238993,238994,0,1,0
68495,3,1,238996,238996,238997,0,1,2
68496,3,2,238999,238999,239001,0,2,2
68497,4,2,239003,239003,239005,0,2,2
68498,1,2,239004,239005,239007,1,3,0
68499,1,1,239005,239007,239008,2,3,0
68500,2,3,239007,239008,239011,1,4,0
68501,5,3,239012,239012,239015,0,3,1
68502,5,2,239017,239017,239019,0,2,2
68503,1,2,239018,239019,239021,1,3,0
68504,3,1,239021,239021,239022,0,1,0
68505,2,3,239023,239023,239026,0,3,1
68506,3,1,239026,239026,239027,0,1,0
68507,6,1,239032,239032,239033,0,1,5
68508,1,1,239033,239033,239034,0,1,0
68509,6,2,239039,239039,239041,0,2,5
68510,5,1,239044,239044,239045,0,1,3
68511,4,1,239048,239048,239049,0,1,3
68512,1,1,239049,239049,239050,0,1,0
68513,6,3,239055,239055,239058,0,3,5
68514,4,3,239059,239059,239062,0,3,1
68515,1,3,239060,239062,239065,2,5,0
68516,3,3,239063,239065,239068,2,5,0
68517,6,3,239069,239069,239072,0,3,1
68518,4,1,239073,239073,239074,0,1,1
68519,5,2,239078,239078,239080,0,2,4
68520,2,3,239080,239080,239083,0,3,0
68521,4,3,239084,239084,239087,0,3,1
68522,4,1,239088,239088,239089,0,1,1
68523,5,3,239093,239093,239096,0,3,4
68524,6,1,239099,239099,239100,0,1,3
68525,3,2,239102,239102,239104,0,2,2
68526,5,1,239107,239107,239108,0,1,3
68527,6,3,239113,239113,239116,0,3,5
68528,5,1,239118,239118,239119,0,1,2
68529,6,1,239124,239124,239125,0,1,5
68530,4,1,239128,239128,239129,0,1,3
68531,5,3,239133,239133,239136,0,3,4
68532,2,3,239135,239136,239139,1,4,0
68533,6,2,239141,239141,239143,0,2,2
68534,2,3,239143,239143,239146,0,3,0
68535,2,1,239145,239146,239147,1,2,0
68536,1,1,239146,239147,239148,1,2,0
68537,2,3,239148,239148,239151,0,3,0
68538,5,2,239153,239153,239155,0,2,2
68539,3,1,239156,239156,239157,0,1,1
68540,3,2,239159,239159,239161,0,2,2
68541,3,2,239162,239162,239164,0,2,1
68542,4,2,239166,239166,239168,0,2,2
68543,1,2,239167,239168,239170,1,3,0
68544,2,1,239169,239170,239171,1,2,0
68545,5,1,239174,239174,239175,0,1,3
68546,2,2,239176,239176,239178,0,2,1
68547,6,2,239182,239182,239184,0,2,4
68548,1,3,239183,239184,239187,1,4,0
68549,3,1,239186,239187,239188,1,2,0
68550,6,3,239192,239192,239195,0,3,4
68551,4,1,239196,239196,239197,0,1,1
68552,3,2,239199,239199,239201,0,2,2
68553,5,1,239204,239204,239205,0,1,3
68554,5,2,239209,239209,239211,0,2,4
68555,4,1,239213,239213,239214,0,1,2
68556,3,1,239216,239216,239217,0,1,2
68557,6,2,239222,239222,239224,0,2,5
68558,3,3,239225,239225,239228,0,3,1
68559,2,2,239227,239228,239230,1,3,0
68560,4,2,239231,239231,239233,0,2,1
68561,2,1,239233,239233,239234,0,1,0
68562,6,2,239239,239239,239241,0,2,5
68563,3,1,239242,239242,239243,0,1,1
68564,3,2,239245,239245,239247,0,2,2
68565,6,1,239251,239251,239252,0,1,4
68566,4,3,239255,239255,239258,0,3,3
68567,5,2,239260,239260,239262,0,2,2
68568,3,1,239263,239263,239264,0,1,1
68569,6,2,239269,239269,239271,0,2,5
68570,3,3,239272,239272,239275,0,3,1
68571,1,1,239273,239275,239276,2,3,0
68572,5,2,239278,239278,239280,0,2,2
68573,4,2,239282,239282,239284,0,2,2
68574,4,1,239286,239286,239287,0,1,2
68575,3,1,239289,239289,239290,0,1,2
68576,3,1,239292,239292,239293,0,1,2
68577,1,3,239293,239293,239296,0,3,0
68578,3,1,239296,239296,239297,0,1,0
68579,5,1,239301,239301,239302,0,1,4
68580,4,3,239305,239305,239308,0,3,3
68581,1,3,239306,239308,239311,2,5,0
68582,3,3,239309,239311,239314,2,5,0
68583,3,3,239312,239314,239317,2,5,0
68584,6,2,239318,239318,239320,0,2,1
68585,5,1,239323,239323,239324,0,1,3
68586,1,3,239324,239324,239327,0,3,0
68587,3,1,239327,239327,239328,0,1,0
68588,2,1,239329,239329,239330,0,1,1
68589,3,1,239332,239332,239333,0,1,2
68590,4,1,239336,239336,239337,0,1,3
68591,5,2,239341,239341,239343,0,2,4
68592,4,2,239345,239345,239347,0,2,2
68593,3,2,239348,239348,239350,0,2,1
68594,2,3,239350,239350,239353,0,3,0
68595,3,1,239353,239353,239354,0,1,0
68596,5,3,239358,239358,239361,0,3,4
68597,3,2,239361,239361,239363,0,2,0
68598,5,3,239366,239366,239369,0,3,3
68599,3,3,239369,239369,239372,0,3,0
68600,1,2,239370,239372,239374,2,4,0
68601,5,3,239375,239375,239378,0,3,1
68602,5,3,239380,239380,239383,0,3,2
68603,1,1,239381,239383,239384,2,3,0
68604,2,2,239383,239384,239386,1,3,0
68605,3,1,239386,239386,239387,0,1,0
68606,1,2,239387,239387,239389,0,2,0
68607,1,2,239388,239389,239391,1,3,0
68608,4,1,239392,239392,239393,0,1,1
68609,1,1,239393,239393,239394,0,1,0
68610,4,3,239397,239397,239400,0,3,3
68611,4,2,239401,239401,239403,0,2,1
68612,3,2,239404,239404,239406,0,2,1
68613,4,1,239408,239408,239409,0,1,2
68614,5,3,239413,239413,239416,0,3,4
68615,4,2,239417,239417,239419,0,2,1
68616,3,3,239420,239420,239423,0,3,1
68617,4,1,239424,239424,239425,0,1,1
68618,3,2,239427,239427,239429,0,2,2
68619,3,1,239430,239430,239431,0,1,1
68620,4,3,239434,239434,239437,0,3,3
68621,2,1,239436,239437,239438,1,2,0
68622,4,3,239440,239440,239443,0,3,2
68623,5,2,239445,239445,239447,0,2,2
68624,5,3,239450,239450,239453,0,3,3
68625,5,2,239455,239455,239457,0,2,2
68626,6,1,239461,239461,239462,0,1,4
68627,4,1,239465,239465,239466,0,1,3
68628,6,3,239471,239471,239474,0,3,5
68629,2,2,239473,239474,239476,1,3,0
68630,5,3,239478,239478,239481,0,3,2
68631,4,2,239482,239482,239484,0,2,1
68632,5,3,239487,239487,239490,0,3,3
68633,5,3,239492,239492,239495,0,3,2
68634,5,2,239497,239497,239499,0,2,2
68635,4,3,239501,239501,239504,0,3,2
68636,4,3,239505,239505,239508,0,3,1
68637,1,2,239506,239508,239510,2,4,0
68638,1,3,239507,239510,239513,3,6,0
68639,6,2,239513,239513,239515,0,2,0
68640,4,2,239517,239517,239519,0,2,2
68641,1,2,239518,239519,239521,1,3,0
68642,2,3,239520,239521,239524,1,4,0
68643,5,3,239525,239525,239528,0,3,1
68644,1,1,239526,239528,239529,2,3,0
68645,6,3,239532,239532,239535,0,3,3
68646,5,3,239537,239537,239540,0,3,2
68647,1,2,239538,239540,239542,2,4,0
68648,3,2,239541,239542,239544,1,3,0
68649,6,2,239547,239547,239549,0,2,3
68650,4,3,239551,239551,239554,0,3,2
68651,4,1,239555,239555,239556,0,1,1
68652,2,3,239557,239557,239560,0,3,1
68653,5,1,239562,239562,239563,0,1,2
68654,1,2,239563,239563,239565,0,2,0
68655,4,1,239567,239567,239568,0,1,2
68656,6,1,239573,239573,239574,0,1,5
68657,1,3,239574,239574,239577,0,3,0
68658,6,2,239580,239580,239582,0,2,3
68659,1,2,239581,239582,239584,1,3,0
68660,6,3,239587,239587,239590,0,3,3
68661,5,1,239592,239592,239593,0,1,2
68662,3,2,239595,239595,239597,0,2,2
68663,5,2,239600,239600,239602,0,2,3
68664,4,1,239604,239604,239605,0,1,2
68665,5,2,239609,239609,239611,0,2,4
68666,5,1,239614,239614,239615,0,1,3
68667,3,2,239617,239617,239619,0,2,2
68668,6,1,239623,239623,239624,0,1,4
68669,5,2,239628,239628,239630,0,2,4
68670,2,1,239630,239630,239631,0,1,0
68671,2,2,239632,239632,239634,0,2,1
68672,6,3,239638,239638,239641,0,3,4
68673,3,2,239641,239641,239643,0,2,0
68674,4,2,239645,239645,239647,0,2,2
68675,2,3,239647,239647,239650,0,3,0
68676,3,3,239650,239650,239653,0,3,0
68677,6,2,239656,239656,239658,0,2,3
68678,6,1,239662,239662,239663,0,1,4
68679,4,3,239666,239666,239669,0,3,3
68680,3,3,239669,239669,239672,0,3,0
68681,1,1,239670,239672,239673,2,3,0
68682,2,1,239672,239673,239674,1,2,0
68683,5,2,239677,239677,239679,0,2,3
68684,3,3,239680,239680,239683,0,3,1
68685,1,1,239681,239683,239684,2,3,0
68686,5,1,239686,239686,239687,0,1,2
68687,1,2,239687,239687,239689,0,2,0
68688,2,3,239689,239689,239692,0,3,0
68689,3,3,239692,239692,239695,0,3,0
68690,5,1,239697,239697,239698,0,1,2
68691,4,1,239701,239701,239702,0,1,3
68692,4,3,239705,239705,239708,0,3,3
68693,6,2,239711,239711,239713,0,2,3
68694,3,3,239714,239714,239717,0,3,1
68695,6,2,239720,239720,239722,0,2,3
68696,6,2,239726,239726,239728,0,2,4
68697,4,1,239730,239730,239731,0,1,2
68698,6,3,239736,239736,239739,0,3,5
68699,3,3,239739,239739,239742,0,3,0
68700,6,1,239745,239745,239746,0,1,3
68701,4,3,239749,239749,239752,0,3,3
68702,3,2,239752,239752,239754,0,2,0
68703,4,1,239756,239756,239757,0,1,2
68704,2,1,239758,239758,239759,0,1,1
68705,4,2,239762,239762,239764,0,2,3
68706,3,3,239765,239765,239768,0,3,1
68707,3,2,239768,239768,239770,0,2,0
68708,6,2,239774,239774,239776,0,2,4
68709,4,2,239778,239778,239780,0,2,2
68710,4,2,239782,239782,239784,0,2,2
68711,1,3,239783,239784,239787,1,4,0
68712,1,3,239784,239787,239790,3,6,0
68713,2,3,239786,239790,239793,4,7,0
68714,4,2,239790,239793,239795,3,5,0
68715,4,3,239794,239795,239798,1,4,0
68716,5,1,239799,239799,239800,0,1,1
68717,5,1,239804,239804,239805,0,1,4
68718,4,2,239808,239808,239810,0,2,3
68719,6,1,239814,239814,239815,0,1,4
68720,1,3,239815,239815,239818,0,3,0
68721,1,1,239816,239818,239819,2,3,0
68722,4,1,239820,239820,239821,0,1,1
68723,3,3,239823,239823,239826,0,3,2
68724,1,2,239824,239826,239828,2,4,0
68725,1,1,239825,239828,239829,3,4,0
68726,2,2,239827,239829,239831,2,4,0
68727,2,3,239829,239831,239834,2,5,0
68728,5,3,239834,239834,239837,0,3,0
68729,2,1,239836,239837,239838,1,2,0
68730,4,2,239840,239840,239842,0,2,2
68731,6,3,239846,239846,239849,0,3,4
68732,3,2,239849,239849,239851,0,2,0
68733,1,2,239850,239851,239853,1,3,0
68734,3,2,239853,239853,239855,0,2,0
68735,6,1,239859,239859,239860,0,1,4
68736,1,1,239860,239860,239861,0,1,0
68737,5,1,239865,239865,239866,0,1,4
68738,4,1,239869,239869,239870,0,1,3
68739,6,3,239875,239875,239878,0,3,5
68740,6,1,239881,239881,239882,0,1,3
68741,1,1,239882,239882,239883,0,1,0
68742,1,3,239883,239883,239886,0,3,0
68743,3,2,239886,239886,239888,0,2,0
68744,6,3,239892,239892,239895,0,3,4
68745,4,2,239896,239896,239898,0,2,1
68746,6,1,239902,239902,239903,0,1,4
68747,3,2,239905,239905,239907,0,2,2
68748,4,3,239909,239909,239912,0,3,2
68749,3,1,239912,239912,239913,0,1,0
68750,2,2,239914,239914,239916,0,2,1
68751,1,1,239915,239916,239917,1,2,0
68752,2,3,239917,239917,239920,0,3,0
68753,4,2,239921,239921,239923,0,2,1
68754,5,2,239926,239926,239928,0,2,3
68755,6,2,239932,239932,239934,0,2,4
68756,1,2,239933,239934,239936,1,3,0
68757,5,2,239938,239938,239940,0,2,2
68758,1,1,239939,239940,239941,1,2,0
68759,1,2,239940,239941,239943,1,3,0
68760,2,1,239942,239943,239944,1,2,0
68761,2,1,239944,239944,239945,0,1,0
68762,1,2,239945,239945,239947,0,2,0
68763,4,3,239949,239949,239952,0,3,2
68764,3,3,239952,239952,239955,0,3,0
68765,6,1,239958,239958,239959,0,1,3
68766,4,1,239962,239962,239963,0,1,3
68767,4,3,239966,239966,239969,0,3,3
68768,4,2,239970,239970,239972,0,2,1
68769,5,2,239975,239975,239977,0,2,3
68770,4,1,239979,239979,239980,0,1,2
68771,4,2,239983,239983,239985,0,2,3
68772,2,2,239985,239985,239987,0,2,0
68773,1,1,239986,239987,239988,1,2,0
68774,2,1,239988,239988,239989,0,1,0
68775,2,1,239990,239990,239991,0,1,1
68776,2,1,239992,239992,239993,0,1,1
68777,4,2,239996,239996,239998,0,2,3
68778,3,1,239999,239999,240000,0,1,1
68779,3,1,240002,240002,240003,0,1,2
68780,2,1,240004,240004,240005,0,1,1
68781,2,2,240006,240006,240008,0,2,1
68782,5,2,240011,240011,240013,0,2,3
68783,2,2,240013,240013,240015,0,2,0
68784,4,2,240017,240017,240019,0,2,2
68785,2,3,240019,240019,240022,0,3,0
68786,5,3,240024,240024,240027,0,3,2
68787,2,3,240026,240027,240030,1,4,0
68788,1,2,240027,240030,240032,3,5,0
68789,3,3,240030,240032,240035,2,5,0
68790,6,1,240036,240036,240037,0,1,1
68791,1,3,240037,240037,240040,0,3,0
68792,3,3,240040,240040,240043,0,3,0
68793,1,1,240041,240043,240044,2,3,0
68794,5,2,240046,240046,240048,0,2,2
68795,2,3,240048,240048,240051,0,3,0
68796,4,2,240052,240052,240054,0,2,1
68797,4,3,240056,240056,240059,0,3,2
68798,1,1,240057,240059,240060,2,3,0
68799,2,2,240059,240060,240062,1,3,0
68800,4,3,240063,240063,240066,0,3,1
68801,1,1,240064,240066,240067,2,3,0
68802,2,2,240066,240067,240069,1,3,0
68803,2,3,240068,240069,240072,1,4,0
68804,2,2,240070,240072,240074,2,4,0
68805,1,3,240071,240074,240077,3,6,0
68806,6,2,240077,240077,240079,0,2,0
68807,1,1,240078,240079,240080,1,2,0
68808,6,1,240084,240084,240085,0,1,4
68809,6,3,240090,240090,240093,0,3,5
68810,2,1,240092,240093,240094,1,2,0
68811,1,1,240093,240094,240095,1,2,0
68812,3,2,240096,240096,240098,0,2,1
68813,5,1,240101,240101,240102,0,1,3
68814,3,2,240104,240104,240106,0,2,2
68815,6,3,240110,240110,240113,0,3,4
68816,1,1,240111,240113,240114,2,3,0
68817,3,2,240114,240114,240116,0,2,0
68818,2,2,240116,240116,240118,0,2,0
68819,2,2,240118,240118,240120,0,2,0
68820,5,3,240123,240123,240126,0,3,3
68821,4,2,240127,240127,240129,0,2,1
68822,3,1,240130,240130,240131,0,1,1
68823,3,2,240133,240133,240135,0,2,2
68824,1,2,240134,240135,240137,1,3,0
68825,2,2,240136,240137,240139,1,3,0
68826,3,1,240139,240139,240140,0,1,0
68827,2,3,240141,240141,240144,0,3,1
68828,6,1,240147,240147,240148,0,1,3
68829,3,2,240150,240150,240152,0,2,2
68830,6,1,240156,240156,240157,0,1,4
68831,1,3,240157,240157,240160,0,3,0
68832,1,3,240158,240160,240163,2,5,0
68833,3,3,240161,240163,240166,2,5,0
68834,2,1,240163,240166,240167,3,4,0
68835,6,1,240169,240169,240170,0,1,2
68836,3,3,240172,240172,240175,0,3,2
68837,4,1,240176,240176,240177,0,1,1
68838,6,1,240182,240182,240183,0,1,5
68839,5,2,240187,240187,240189,0,2,4
68840,2,2,240189,240189,240191,0,2,0
68841,2,1,240191,240191,240192,0,1,0
68842,6,3,240197,240197,240200,0,3,5
68843,6,2,240203,240203,240205,0,2,3
68844,1,2,240204,240205,240207,1,3,0
68845,5,3,240209,240209,240212,0,3,2
68846,2,2,240211,240212,240214,1,3,0
68847,5,3,240216,240216,240219,0,3,2
68848,6,3,240222,240222,240225,0,3,3
68849,1,2,240223,240225,240227,2,4,0
68850,1,3,240224,240227,240230,3,6,0
68851,4,1,240228,240230,240231,2,3,0
68852,4,2,240232,240232,240234,0,2,1
68853,1,3,240233,240234,240237,1,4,0
68854,3,1,240236,240237,240238,1,2,0
68855,1,1,240237,240238,240239,1,2,0
68856,6,2,240243,240243,240245,0,2,4
68857,4,1,240247,240247,240248,0,1,2
68858,5,2,240252,240252,240254,0,2,4
68859,3,2,240255,240255,240257,0,2,1
68860,1,1,240256,240257,240258,1,2,0
68861,6,1,240262,240262,240263,0,1,4
68862,6,1,240268,240268,240269,0,1,5
68863,2,3,240270,240270,240273,0,3,1
68864,3,3,240273,240273,240276,0,3,0
68865,2,1,240275,240276,240277,1,2,0
68866,1,3,240276,240277,240280,1,4,0
68867,6,2,240282,240282,240284,0,2,2
68868,2,3,240284,240284,240287,0,3,0
68869,6,2,240290,240290,240292,0,2,3
68870,3,3,240293,240293,240296,0,3,1
68871,5,1,240298,240298,240299,0,1,2
68872,4,3,240302,240302,240305,0,3,3
68873,3,2,240305,240305,240307,0,2,0
68874,4,2,240309,240309,240311,0,2,2
68875,1,3,240310,240311,240314,1,4,0
68876,3,2,240313,240314,240316,1,3,0
68877,3,2,240316,240316,240318,0,2,0
68878,5,2,240321,240321,240323,0,2,3
68879,6,1,240327,240327,240328,0,1,4
68880,1,1,240328,240328,240329,0,1,0
68881,6,3,240334,240334,240337,0,3,5
68882,6,2,240340,240340,240342,0,2,3
68883,5,1,240345,240345,240346,0,1,3
68884,4,2,240349,240349,240351,0,2,3
68885,2,2,240351,240351,240353,0,2,0
68886,1,1,240352,240353,240354,1,2,0
68887,1,3,240353,240354,240357,1,4,0
68888,4,2,240357,240357,240359,0,2,0
68889,5,3,240362,240362,240365,0,3,3
68890,4,1,240366,240366,240367,0,1,1
68891,4,1,240370,240370,240371,0,1,3
68892,4,1,240374,240374,240375,0,1,3
68893,4,2,240378,240378,240380,0,2,3
68894,3,2,240381,240381,240383,0,2,1
68895,4,1,240385,240385,240386,0,1,2
68896,3,1,240388,240388,240389,0,1,2
68897,2,3,240390,240390,240393,0,3,1
68898,1,3,240391,240393,240396,2,5,0
68899,1,1,240392,240396,240397,4,5,0
68900,1,1,240393,240397,240398,4,5,0
68901,5,3,240398,240398,240401,0,3,0
68902,5,2,240403,240403,240405,0,2,2
68903,2,3,240405,240405,240408,0,3,0
68904,4,3,240409,240409,240412,0,3,1
68905,2,3,240411,240412,240415,1,4,0
68906,4,3,240415,240415,240418,0,3,0
68907,4,3,240419,240419,240422,0,3,1
68908,2,1,240421,240422,240423,1,2,0
68909,2,1,240423,240423,240424,0,1,0
68910,1,1,240424,240424,240425,0,1,0
68911,6,2,240430,240430,240432,0,2,5
68912,3,2,240433,240433,240435,0,2,1
68913,5,3,240438,240438,240441,0,3,3
68914,3,3,240441,240441,240444,0,3,0
68915,4,3,240445,240445,240448,0,3,1
68916,3,2,240448,240448,240450,0,2,0
68917,4,2,240452,240452,240454,0,2,2
68918,2,1,240454,240454,240455,0,1,0
68919,4,2,240458,240458,240460,0,2,3
68920,1,3,240459,240460,240463,1,4,0
68921,6,2,240465,240465,240467,0,2,2
68922,3,1,240468,240468,240469,0,1,1
68923,2,3,240470,240470,240473,0,3,1
68924,3,2,240473,240473,240475,0,2,0
68925,3,1,240476,240476,240477,0,1,1
68926,6,2,240482,240482,240484,0,2,5
68927,3,1,240485,240485,240486,0,1,1
68928,6,3,240491,240491,240494,0,3,5
68929,4,3,240495,240495,240498,0,3,1
68930,5,3,240500,240500,240503,0,3,2
68931,5,1,240505,240505,240506,0,1,2
68932,3,1,240508,240508,240509,0,1,2
68933,6,2,240514,240514,240516,0,2,5
68934,2,1,240516,240516,240517,0,1,0
68935,5,1,240521,240521,240522,0,1,4
68936,1,1,240522,240522,240523,0,1,0
68937,2,1,240524,240524,240525,0,1,1
68938,2,1,240526,240526,240527,0,1,1
68939,5,3,240531,240531,240534,0,3,4
68940,5,1,240536,240536,240537,0,1,2
68941,6,1,240542,240542,240543,0,1,5
68942,6,2,240548,240548,240550,0,2,5
68943,4,3,240552,240552,240555,0,3,2
68944,2,1,240554,240555,240556,1,2,0
68945,6,2,240560,240560,240562,0,2,4
68946,1,2,240561,240562,240564,1,3,0
68947,6,1,240567,240567,240568,0,1,3
68948,5,2,240572,240572,240574,0,2,4
68949,2,1,240574,240574,240575,0,1,0
68950,2,3,240576,240576,240579,0,3,1
68951,1,3,240577,240579,240582,2,5,0
68952,6,2,240583,240583,240585,0,2,1
68953,3,3,240586,240586,240589,0,3,1
68954,2,2,240588,240589,240591,1,3,0
68955,2,2,240590,240591,240593,1,3,0
68956,6,1,240596,240596,240597,0,1,3
68957,1,2,240597,240597,240599,0,2,0
68958,6,2,240603,240603,240605,0,2,4
68959,6,3,240609,240609,240612,0,3,4
68960,6,3,240615,240615,240618,0,3,3
68961,5,3,240620,240620,240623,0,3,2
68962,4,3,240624,240624,240627,0,3,1
68963,4,1,240628,240628,240629,0,1,1
68964,1,2,240629,240629,240631,0,2,0
68965,5,3,240634,240634,240637,0,3,3
68966,5,2,240639,240639,240641,0,2,2
68967,1,3,240640,240641,240644,1,4,0
68968,5,2,240645,240645,240647,0,2,1
68969,1,1,240646,240647,240648,1,2,0
68970,3,2,240649,240649,240651,0,2,1
68971,5,2,240654,240654,240656,0,2,3
68972,2,2,240656,240656,240658,0,2,0
68973,4,3,240660,240660,240663,0,3,2
68974,1,2,240661,240663,240665,2,4,0
68975,5,2,240666,240666,240668,0,2,1
68976,2,3,240668,240668,240671,0,3,0
68977,2,3,240670,240671,240674,1,4,0
68978,4,1,240674,240674,240675,0,1,0
68979,6,1,240680,240680,240681,0,1,5
68980,3,3,240683,240683,240686,0,3,2
68981,1,2,240684,240686,240688,2,4,0
68982,5,1,240689,240689,240690,0,1,1
68983,6,1,240695,240695,240696,0,1,5
68984,3,2,240698,240698,240700,0,2,2
68985,6,2,240704,240704,240706,0,2,4
68986,6,3,240710,240710,240713,0,3,4
68987,5,2,240715,240715,240717,0,2,2
68988,6,2,240721,240721,240723,0,2,4
68989,3,1,240724,240724,240725,0,1,1
68990,2,2,240726,240726,240728,0,2,1
68991,1,1,240727,240728,240729,1,2,0
68992,3,2,240730,240730,240732,0,2,1
68993,5,3,240735,240735,240738,0,3,3
68994,2,1,240737,240738,240739,1,2,0
68995,4,3,240741,240741,240744,0,3,2
68996,5,3,240746,240746,240749,0,3,2
68997,5,1,240751,240751,240752,0,1,2
68998,2,3,240753,240753,240756,0,3,1
68999,4,1,240757,240757,240758,0,1,1
69000,6,2,240763,240763,240765,0,2,5
69001,1,3,240764,240765,240768,1,4,0
69002,2,3,240766,240768,240771,2,5,0
69003,6,1,240772,240772,240773,0,1,1
69004,1,1,240773,240773,240774,0,1,0
69005,3,3,240776,240776,240779,0,3,2
69006,6,1,240782,240782,240783,0,1,3
69007,6,2,240788,240788,240790,0,2,5
69008,3,1,240791,240791,240792,0,1,1
69009,6,3,240797,240797,240800,0,3,5
69010,5,3,240802,240802,240805,0,3,2
69011,1,1,240803,240805,240806,2,3,0
69012,3,1,240806,240806,240807,0,1,0
69013,2,2,240808,240808,240810,0,2,1
69014,2,2,240810,240810,240812,0,2,0
69015,3,3,240813,240813,240816,0,3,1
69016,3,3,240816,240816,240819,0,3,0
69017,6,1,240822,240822,240823,0,1,3
69018,3,3,240825,240825,240828,0,3,2
69019,2,3,240827,240828,240831,1,4,0
69020,5,2,240832,240832,240834,0,2,1
69021,5,1,240837,240837,240838,0,1,3
69022,4,1,240841,240841,240842,0,1,3
69023,3,3,240844,240844,240847,0,3,2
69024,2,2,240846,240847,240849,1,3,0
69025,6,3,240852,240852,240855,0,3,3
69026,4,2,240856,240856,240858,0,2,1
69027,6,3,240862,240862,240865,0,3,4
69028,3,1,240865,240865,240866,0,1,0
69029,6,1,240871,240871,240872,0,1,5
69030,1,1,240872,240872,240873,0,1,0
69031,6,2,240878,240878,240880,0,2,5
69032,5,1,240883,240883,240884,0,1,3
69033,6,3,240889,240889,240892,0,3,5
69034,6,3,240895,240895,240898,0,3,3
69035,5,1,240900,240900,240901,0,1,2
69036,5,2,240905,240905,240907,0,2,4
69037,6,2,240911,240911,240913,0,2,4
69038,6,2,240917,240917,240919,0,2,4
69039,6,3,240923,240923,240926,0,3,4
69040,1,1,240924,240926,240927,2,3,0
69041,5,2,240929,240929,240931,0,2,2
69042,1,1,240930,240931,240932,1,2,0
69043,6,1,240936,240936,240937,0,1,4
69044,1,3,240937,240937,240940,0,3,0
69045,2,3,240939,240940,240943,1,4,0
69046,1,3,240940,240943,240946,3,6,0
69047,6,2,240946,240946,240948,0,2,0
69048,2,2,240948,240948,240950,0,2,0
69049,6,2,240954,240954,240956,0,2,4
69050,1,1,240955,240956,240957,1,2,0
69051,5,2,240960,240960,240962,0,2,3
69052,5,2,240965,240965,240967,0,2,3
69053,5,1,240970,240970,240971,0,1,3
69054,6,3,240976,240976,240979,0,3,5
69055,3,1,240979,240979,240980,0,1,0
69056,4,2,240983,240983,240985,0,2,3
69057,3,1,240986,240986,240987,0,1,1
69058,3,3,240989,240989,240992,0,3,2
69059,3,3,240992,240992,240995,0,3,0
69060,6,3,240998,240998,241001,0,3,3
69061,1,2,240999,241001,241003,2,4,0
69062,5,3,241004,241004,241007,0,3,1
69063,3,2,241007,241007,241009,0,2,0
69064,2,3,241009,241009,241012,0,3,0
69065,4,1,241013,241013,241014,0,1,1
69066,1,1,241014,241014,241015,0,1,0
69067,6,3,241020,241020,241023,0,3,5
69068,1,2,241021,241023,241025,2,4,0
69069,4,2,241025,241025,241027,0,2,0
69070,2,2,241027,241027,241029,0,2,0
69071,2,3,241029,241029,241032,0,3,0
69072,4,3,241033,241033,241036,0,3,1
69073,4,1,241037,241037,241038,0,1,1
69074,4,1,241041,241041,241042,0,1,3
69075,6,2,241047,241047,241049,0,2,5
69076,3,2,241050,241050,241052,0,2,1
69077,6,2,241056,241056,241058,0,2,4
69078,3,1,241059,241059,241060,0,1,1
69079,1,2,241060,241060,241062,0,2,0
69080,1,2,241061,241062,241064,1,3,0
69081,2,3,241063,241064,241067,1,4,0
69082,2,3,241065,241067,241070,2,5,0
69083,1,1,241066,241070,241071,4,5,0
69084,6,2,241072,241072,241074,0,2,1
69085,5,2,241077,241077,241079,0,2,3
69086,6,3,241083,241083,241086,0,3,4
69087,5,3,241088,241088,241091,0,3,2
69088,5,1,241093,241093,241094,0,1,2
69089,2,2,241095,241095,241097,0,2,1
69090,2,2,241097,241097,241099,0,2,0
69091,2,2,241099,241099,241101,0,2,0
69092,2,2,241101,241101,241103,0,2,0
69093,5,2,241106,241106,241108,0,2,3
69094,2,2,241108,241108,241110,0,2,0
69095,6,2,241114,241114,241116,0,2,4
69096,4,2,241118,241118,241120,0,2,2
69097,3,3,241121,241121,241124,0,3,1
69098,4,3,241125,241125,241128,0,3,1
69099,2,1,241127,241128,241129,1,2,0
69100,5,1,241132,241132,241133,0,1,3
69101,3,3,241135,241135,241138,0,3,2
69102,5,1,241140,241140,241141,0,1,2
69103,4,3,241144,241144,241147,0,3,3
69104,4,3,241148,241148,241151,0,3,1
69105,2,2,241150,241151,241153,1,3,0
69106,3,3,241153,241153,241156,0,3,0
69107,5,3,241158,241158,241161,0,3,2
69108,4,1,241162,241162,241163,0,1,1
69109,2,3,241164,241164,241167,0,3,1
69110,3,1,241167,241167,241168,0,1,0
69111,2,3,241169,241169,241172,0,3,1
69112,4,2,241173,241173,241175,0,2,1
69113,3,1,241176,241176,241177,0,1,1
69114,6,2,241182,241182,241184,0,2,5
69115,2,1,241184,241184,241185,0,1,0
69116,5,3,241189,241189,241192,0,3,4
69117,3,1,241192,241192,241193,0,1,0
69118,2,2,241194,241194,241196,0,2,1
69119,3,3,241197,241197,241200,0,3,1
69120,6,3,241203,241203,241206,0,3,3
69121,4,3,241207,241207,241210,0,3,1
69122,5,1,241212,241212,241213,0,1,2
69123,5,2,241217,241217,241219,0,2,4
69124,6,3,241223,241223,241226,0,3,4
69125,3,2,241226,241226,241228,0,2,0
69126,6,3,241232,241232,241235,0,3,4
69127,3,2,241235,241235,241237,0,2,0
69128,2,1,241237,241237,241238,0,1,0
69129,6,2,241243,241243,241245,0,2,5
69130,5,1,241248,241248,241249,0,1,3
69131,6,2,241254,241254,241256,0,2,5
69132,3,1,241257,241257,241258,0,1,1
69133,2,3,241259,241259,241262,0,3,1
69134,4,1,241263,241263,241264,0,1,1
69135,2,2,241265,241265,241267,0,2,1
69136,1,2,241266,241267,241269,1,3,0
69137,3,2,241269,241269,241271,0,2,0
69138,1,3,241270,241271,241274,1,4,0
69139,2,3,241272,241274,241277,2,5,0
69140,2,2,241274,241277,241279,3,5,0
69141,4,2,241278,241279,241281,1,3,0
69142,1,2,241279,241281,241283,2,4,0
69143,1,2,241280,241283,241285,3,5,0
69144,6,3,241286,241286,241289,0,3,1
69145,6,2,241292,241292,241294,0,2,3
69146,5,3,241297,241297,241300,0,3,3
69147,3,3,241300,241300,241303,0,3,0
69148,3,2,241303,241303,241305,0,2,0
69149,2,1,241305,241305,241306,0,1,0
69150,5,3,241310,241310,241313,0,3,4
69151,4,1,241314,241314,241315,0,1,1
69152,3,3,241317,241317,241320,0,3,2
69153,6,1,241323,241323,241324,0,1,3
69154,3,2,241326,241326,241328,0,2,2
69155,5,1,241331,241331,241332,0,1,3
69156,2,1,241333,241333,241334,0,1,1
69157,5,3,241338,241338,241341,0,3,4
69158,3,1,241341,241341,241342,0,1,0
69159,4,2,241345,241345,241347,0,2,3
69160,5,3,241350,241350,241353,0,3,3
69161,6,3,241356,241356,241359,0,3,3
69162,4,3,241360,241360,241363,0,3,1
69163,5,2,241365,241365,241367,0,2,2
69164,1,2,241366,241367,241369,1,3,0
69165,6,1,241372,241372,241373,0,1,3
69166,1,2,241373,241373,241375,0,2,0
69167,1,1,241374,241375,241376,1,2,0
69168,4,2,241378,241378,241380,0,2,2
69169,4,3,241382,241382,241385,0,3,2
69170,4,3,241386,241386,241389,0,3,1
69171,6,2,241392,241392,241394,0,2,3
69172,4,3,241396,241396,241399,0,3,2
69173,5,2,241401,241401,241403,0,2,2
69174,6,3,241407,241407,241410,0,3,4
69175,5,3,241412,241412,241415,0,3,2
69176,6,2,241418,241418,241420,0,2,3
69177,4,1,241422,241422,241423,0,1,2
69178,5,1,241427,241427,241428,0,1,4
69179,2,1,241429,241429,241430,0,1,1
69180,5,3,241434,241434,241437,0,3,4
69181,2,1,241436,241437,241438,1,2,0
69182,6,1,241442,241442,241443,0,1,4
69183,2,2,241444,241444,241446,0,2,1
69184,5,3,241449,241449,241452,0,3,3
69185,3,2,241452,241452,241454,0,2,0
69186,1,2,241453,241454,241456,1,3,0
69187,1,3,241454,241456,241459,2,5,0
69188,5,3,241459,241459,241462,0,3,0
69189,1,3,241460,241462,241465,2,5,0
69190,4,3,241464,241465,241468,1,4,0
69191,3,1,241467,241468,241469,1,2,0
69192,4,3,241471,241471,241474,0,3,2
69193,1,2,241472,241474,241476,2,4,0
69194,2,3,241474,241476,241479,2,5,0
69195,6,3,241480,241480,241483,0,3,1
69196,3,1,241483,241483,241484,0,1,0
69197,1,1,241484,241484,241485,0,1,0
69198,5,3,241489,241489,241492,0,3,4
69199,5,3,241494,241494,241497,0,3,2
69200,5,3,241499,241499,241502,0,3,2
69201,3,2,241502,241502,241504,0,2,0
69202,5,2,241507,241507,241509,0,2,3
69203,3,1,241510,241510,241511,0,1,1
69204,6,2,241516,241516,241518,0,2,5
69205,2,2,241518,241518,241520,0,2,0
69206,6,3,241524,241524,241527,0,3,4
69207,1,1,241525,241527,241528,2,3,0
69208,6,2,241531,241531,241533,0,2,3
69209,5,2,241536,241536,241538,0,2,3
69210,1,3,241537,241538,241541,1,4,0
69211,2,2,241539,241541,241543,2,4,0
69212,4,2,241543,241543,241545,0,2,0
69213,5,1,241548,241548,241549,0,1,3
69214,5,2,241553,241553,241555,0,2,4
69215,1,2,241554,241555,241557,1,3,0
69216,4,1,241558,241558,241559,0,1,1
69217,6,2,241564,241564,241566,0,2,5
69218,1,3,241565,241566,241569,1,4,0
69219,1,1,241566,241569,241570,3,4,0
69220,2,1,241568,241570,241571,2,3,0
69221,3,3,241571,241571,241574,0,3,0
69222,1,3,241572,241574,241577,2,5,0
69223,6,3,241578,241578,241581,0,3,1
69224,5,3,241583,241583,241586,0,3,2
69225,5,3,241588,241588,241591,0,3,2
69226,1,1,241589,241591,241592,2,3,0
69227,1,3,241590,241592,241595,2,5,0
69228,1,2,241591,241595,241597,4,6,0
69229,3,1,241594,241597,241598,3,4,0
69230,2,2,241596,241598,241600,2,4,0
69231,6,3,241602,241602,241605,0,3,2
69232,5,1,241607,241607,241608,0,1,2
69233,5,3,241612,241612,241615,0,3,4
69234,6,1,241618,241618,241619,0,1,3
69235,5,2,241623,241623,241625,0,2,4
69236,5,2,241628,241628,241630,0,2,3
69237,6,3,241634,241634,241637,0,3,4
69238,4,2,241638,241638,241640,0,2,1
69239,2,2,241640,241640,241642,0,2,0
69240,3,2,241643,241643,241645,0,2,1
69241,4,1,241647,241647,241648,0,1,2
69242,5,2,241652,241652,241654,0,2,4
69243,1,3,241653,241654,241657,1,4,0
69244,2,1,241655,241657,241658,2,3,0
69245,3,1,241658,241658,241659,0,1,0
69246,6,2,241664,241664,241666,0,2,5
69247,5,1,241669,241669,241670,0,1,3
69248,1,1,241670,241670,241671,0,1,0
69249,2,1,241672,241672,241673,0,1,1
69250,5,3,241677,241677,241680,0,3,4
69251,4,1,241681,241681,241682,0,1,1
69252,6,2,241687,241687,241689,0,2,5
69253,5,2,241692,241692,241694,0,2,3
69254,6,3,241698,241698,241701,0,3,4
69255,6,1,241704,241704,241705,0,1,3
69256,2,1,241706,241706,241707,0,1,1
69257,1,1,241707,241707,241708,0,1,0
69258,5,2,241712,241712,241714,0,2,4
69259,1,3,241713,241714,241717,1,4,0
69260,2,1,241715,241717,241718,2,3,0
69261,4,1,241719,241719,241720,0,1,1
69262,3,2,241722,241722,241724,0,2,2
69263,1,3,241723,241724,241727,1,4,0
69264,2,3,241725,241727,241730,2,5,0
69265,1,3,241726,241730,241733,4,7,0
69266,3,1,241729,241733,241734,4,5,0
69267,6,2,241735,241735,241737,0,2,1
69268,6,3,241741,241741,241744,0,3,4
69269,5,3,241746,241746,241749,0,3,2
69270,1,3,241747,241749,241752,2,5,0
69271,6,2,241753,241753,241755,0,2,1
69272,5,3,241758,241758,241761,0,3,3
69273,5,2,241763,241763,241765,0,2,2
69274,2,1,241765,241765,241766,0,1,0
69275,6,1,241771,241771,241772,0,1,5
69276,1,1,241772,241772,241773,0,1,0
69277,3,1,241775,241775,241776,0,1,2
69278,2,2,241777,241777,241779,0,2,1
69279,6,1,241783,241783,241784,0,1,4
69280,3,1,241786,241786,241787,0,1,2
69281,5,1,241791,241791,241792,0,1,4
69282,2,3,241793,241793,241796,0,3,1
69283,2,1,241795,241796,241797,1,2,0
69284,3,1,241798,241798,241799,0,1,1
69285,6,3,241804,241804,241807,0,3,5
69286,4,1,241808,241808,241809,0,1,1
69287,6,2,241814,241814,241816,0,2,5
69288,5,3,241819,241819,241822,0,3,3
69289,6,2,241825,241825,241827,0,2,3
69290,1,2,241826,241827,241829,1,3,0
69291,3,1,241829,241829,241830,0,1,0
69292,2,3,241831,241831,241834,0,3,1
69293,3,3,241834,241834,241837,0,3,0
69294,2,2,241836,241837,241839,1,3,0
69295,3,1,241839,241839,241840,0,1,0
69296,6,3,241845,241845,241848,0,3,5
69297,6,2,241851,241851,241853,0,2,3
69298,3,3,241854,241854,241857,0,3,1
69299,3,2,241857,241857,241859,0,2,0
69300,2,2,241859,241859,241861,0,2,0
69301,5,3,241864,241864,241867,0,3,3
69302,6,1,241870,241870,241871,0,1,3
69303,2,3,241872,241872,241875,0,3,1
69304,5,1,241877,241877,241878,0,1,2
69305,6,3,241883,241883,241886,0,3,5
69306,3,1,241886,241886,241887,0,1,0
69307,6,1,241892,241892,241893,0,1,5
69308,2,1,241894,241894,241895,0,1,1
69309,3,2,241897,241897,241899,0,2,2
69310,4,2,241901,241901,241903,0,2,2
69311,5,1,241906,241906,241907,0,1,3
69312,3,2,241909,241909,241911,0,2,2
69313,5,2,241914,241914,241916,0,2,3
69314,1,1,241915,241916,241917,1,2,0
69315,3,3,241918,241918,241921,0,3,1
69316,3,2,241921,241921,241923,0,2,0
69317,4,1,241925,241925,241926,0,1,2
69318,5,2,241930,241930,241932,0,2,4
69319,3,1,241933,241933,241934,0,1,1
69320,1,2,241934,241934,241936,0,2,0
69321,1,2,241935,241936,241938,1,3,0
69322,1,3,241936,241938,241941,2,5,0
69323,6,3,241942,241942,241945,0,3,1
69324,2,2,241944,241945,241947,1,3,0
69325,2,2,241946,241947,241949,1,3,0
69326,5,1,241951,241951,241952,0,1,2
69327,2,2,241953,241953,241955,0,2,1
69328,5,3,241958,241958,241961,0,3,3
69329,5,1,241963,241963,241964,0,1,2
69330,5,1,241968,241968,241969,0,1,4
69331,3,3,241971,241971,241974,0,3,2
69332,1,2,241972,241974,241976,2,4,0
69333,4,2,241976,241976,241978,0,2,0
69334,6,2,241982,241982,241984,0,2,4
69335,5,1,241987,241987,241988,0,1,3
69336,5,2,241992,241992,241994,0,2,4
69337,5,1,241997,241997,241998,0,1,3
69338,1,3,241998,241998,242001,0,3,0
69339,1,2,241999,242001,242003,2,4,0
69340,2,2,242001,242003,242005,2,4,0
69341,6,3,242007,242007,242010,0,3,2
69342,6,3,242013,242013,242016,0,3,3
69343,1,1,242014,242016,242017,2,3,0
69344,4,3,242018,242018,242021,0,3,1
69345,4,3,242022,242022,242025,0,3,1
69346,1,1,242023,242025,242026,2,3,0
69347,4,2,242027,242027,242029,0,2,1
69348,6,2,242033,242033,242035,0,2,4
69349,3,3,242036,242036,242039,0,3,1
69350,1,1,242037,242039,242040,2,3,0
69351,1,3,242038,242040,242043,2,5,0
69352,2,2,242040,242043,242045,3,5,0
69353,4,2,242044,242045,242047,1,3,0
69354,3,2,242047,242047,242049,0,2,0
69355,2,1,242049,242049,242050,0,1,0
69356,5,3,242054,242054,242057,0,3,4
69357,4,1,242058,242058,242059,0,1,1
69358,3,1,242061,242061,242062,0,1,2
69359,5,2,242066,242066,242068,0,2,4
69360,4,1,242070,242070,242071,0,1,2
69361,5,1,242075,242075,242076,0,1,4
69362,6,1,242081,242081,242082,0,1,5
69363,3,1,242084,242084,242085,0,1,2
69364,3,2,242087,242087,242089,0,2,2
69365,5,3,242092,242092,242095,0,3,3
69366,4,1,242096,242096,242097,0,1,1
69367,4,1,242100,242100,242101,0,1,3
69368,4,1,242104,242104,242105,0,1,3
69369,4,2,242108,242108,242110,0,2,3
69370,5,2,242113,242113,242115,0,2,3
69371,2,1,242115,242115,242116,0,1,0
69372,5,1,242120,242120,242121,0,1,4
69373,6,1,242126,242126,242127,0,1,5
69374,4,3,242130,242130,242133,0,3,3
69375,6,2,242136,242136,242138,0,2,3
69376,5,2,242141,242141,242143,0,2,3
69377,6,3,242147,242147,242150,0,3,4
69378,5,2,242152,242152,242154,0,2,2
69379,6,3,242158,242158,242161,0,3,4
69380,2,3,242160,242161,242164,1,4,0
69381,1,3,242161,242164,242167,3,6,0
69382,3,2,242164,242167,242169,3,5,0
69383,4,2,242168,242169,242171,1,3,0
69384,3,3,242171,242171,242174,0,3,0
69385,1,3,242172,242174,242177,2,5,0
69386,1,2,242173,242177,242179,4,6,0
69387,4,3,242177,242179,242182,2,5,0
69388,5,3,242182,242182,242185,0,3,0
69389,1,3,242183,242185,242188,2,5,0
69390,1,3,242184,242188,242191,4,7,0
69391,3,3,242187,242191,242194,4,7,0
69392,4,2,242191,242194,242196,3,5,0
69393,4,3,242195,242196,242199,1,4,0
69394,6,3,242201,242201,242204,0,3,2
69395,3,3,242204,242204,242207,0,3,0
69396,4,3,242208,242208,242211,0,3,1
69397,1,2,242209,242211,242213,2,4,0
69398,2,3,242211,242213,242216,2,5,0
69399,3,1,242214,242216,242217,2,3,0
69400,4,2,242218,242218,242220,0,2,1
69401,2,2,242220,242220,242222,0,2,0
69402,3,3,242223,242223,242226,0,3,1
69403,3,1,242226,242226,242227,0,1,0
69404,4,2,242230,242230,242232,0,2,3
69405,3,1,242233,242233,242234,0,1,1
69406,1,1,242234,242234,242235,0,1,0
69407,5,3,242239,242239,242242,0,3,4
69408,3,3,242242,242242,242245,0,3,0
69409,6,3,242248,242248,242251,0,3,3
69410,2,3,242250,242251,242254,1,4,0
69411,4,1,242254,242254,242255,0,1,0
69412,5,2,242259,242259,242261,0,2,4
69413,6,1,242265,242265,242266,0,1,4
69414,1,2,242266,242266,242268,0,2,0
69415,3,1,242269,242269,242270,0,1,1
69416,1,2,242270,242270,242272,0,2,0
69417,2,3,242272,242272,242275,0,3,0
69418,1,3,242273,242275,242278,2,5,0
69419,3,1,242276,242278,242279,2,3,0
69420,6,3,242282,242282,242285,0,3,3
69421,1,1,242283,242285,242286,2,3,0
69422,1,3,242284,242286,242289,2,5,0
69423,5,1,242289,242289,242290,0,1,0
69424,5,1,242294,242294,242295,0,1,4
69425,2,3,242296,242296,242299,0,3,1
69426,5,2,242301,242301,242303,0,2,2
69427,2,3,242303,242303,242306,0,3,0
69428,3,3,242306,242306,242309,0,3,0
69429,4,1,242310,242310,242311,0,1,1
69430,1,1,242311,242311,242312,0,1,0
69431,6,1,242317,242317,242318,0,1,5
69432,6,3,242323,242323,242326,0,3,5
69433,2,3,242325,242326,242329,1,4,0
69434,6,3,242331,242331,242334,0,3,2
69435,2,2,242333,242334,242336,1,3,0
69436,3,1,242336,242336,242337,0,1,0
69437,6,1,242342,242342,242343,0,1,5
69438,6,3,242348,242348,242351,0,3,5
69439,5,1,242353,242353,242354,0,1,2
69440,3,1,242356,242356,242357,0,1,2
69441,2,3,242358,242358,242361,0,3,1
69442,3,1,242361,242361,242362,0,1,0
69443,5,1,242366,242366,242367,0,1,4
69444,1,3,242367,242367,242370,0,3,0
69445,1,1,242368,242370,242371,2,3,0
69446,2,2,242370,242371,242373,1,3,0
69447,4,2,242374,242374,242376,0,2,1
69448,4,3,242378,242378,242381,0,3,2
69449,4,3,242382,242382,242385,0,3,1
69450,6,2,242388,242388,242390,0,2,3
69451,6,2,242394,242394,242396,0,2,4
69452,6,3,242400,242400,242403,0,3,4
69453,3,1,242403,242403,242404,0,1,0
69454,3,1,242406,242406,242407,0,1,2
69455,5,3,242411,242411,242414,0,3,4
69456,2,2,242413,242414,242416,1,3,0
69457,6,1,242419,242419,242420,0,1,3
69458,2,2,242421,242421,242423,0,2,1
69459,2,2,242423,242423,242425,0,2,0
69460,2,2,242425,242425,242427,0,2,0
69461,6,1,242431,242431,242432,0,1,4
69462,1,1,242432,242432,242433,0,1,0
69463,3,1,242435,242435,242436,0,1,2
69464,4,2,242439,242439,242441,0,2,3
69465,2,3,242441,242441,242444,0,3,0
69466,3,1,242444,242444,242445,0,1,0
69467,1,1,242445,242445,242446,0,1,0
69468,6,1,242451,242451,242452,0,1,5
69469,2,3,242453,242453,242456,0,3,1
69470,1,1,242454,242456,242457,2,3,0
69471,2,3,242456,242457,242460,1,4,0
69472,6,2,242462,242462,242464,0,2,2
69473,6,3,242468,242468,242471,0,3,4
69474,2,3,242470,242471,242474,1,4,0
69475,6,2,242476,242476,242478,0,2,2
69476,4,2,242480,242480,242482,0,2,2
69477,3,2,242483,242483,242485,0,2,1
69478,1,1,242484,242485,242486,1,2,0
69479,3,1,242487,242487,242488,0,1,1
69480,5,1,242492,242492,242493,0,1,4
69481,2,3,242494,242494,242497,0,3,1
69482,6,1,242500,242500,242501,0,1,3
69483,4,2,242504,242504,242506,0,2,3
69484,3,3,242507,242507,242510,0,3,1
69485,4,3,242511,242511,242514,0,3,1
69486,3,3,242514,242514,242517,0,3,0
69487,5,3,242519,242519,242522,0,3,2
69488,1,3,242520,242522,242525,2,5,0
69489,1,3,242521,242525,242528,4,7,0
69490,4,3,242525,242528,242531,3,6,0
69491,5,2,242530,242531,242533,1,3,0
69492,2,3,242532,242533,242536,1,4,0
69493,3,2,242535,242536,242538,1,3,0
69494,2,1,242537,242538,242539,1,2,0
69495,6,2,242543,242543,242545,0,2,4
69496,6,1,242549,242549,242550,0,1,4
69497,6,3,242555,242555,242558,0,3,5
69498,1,3,242556,242558,242561,2,5,0
69499,6,1,242562,242562,242563,0,1,1
69500,6,1,242568,242568,242569,0,1,5
69501,3,2,242571,242571,242573,0,2,2
69502,5,2,242576,242576,242578,0,2,3
69503,2,1,242578,242578,242579,0,1,0
69504,2,2,242580,242580,242582,0,2,1
69505,3,2,242583,242583,242585,0,2,1
69506,5,2,242588,242588,242590,0,2,3
69507,1,1,242589,242590,242591,1,2,0
69508,6,2,242595,242595,242597,0,2,4
69509,6,2,242601,242601,242603,0,2,4
69510,2,2,242603,242603,242605,0,2,0
69511,3,2,242606,242606,242608,0,2,1
69512,6,2,242612,242612,242614,0,2,4
69513,5,3,242617,242617,242620,0,3,3
69514,2,1,242619,242620,242621,1,2,0
69515,2,1,242621,242621,242622,0,1,0
69516,1,3,242622,242622,242625,0,3,0
69517,5,3,242627,242627,242630,0,3,2
69518,2,2,242629,242630,242632,1,3,0
69519,6,2,242635,242635,242637,0,2,3
69520,4,3,242639,242639,242642,0,3,2
69521,4,3,242643,242643,242646,0,3,1
69522,4,2,242647,242647,242649,0,2,1
69523,1,3,242648,242649,242652,1,4,0
69524,5,1,242653,242653,242654,0,1,1
69525,2,1,242655,242655,242656,0,1,1
69526,6,1,242661,242661,242662,0,1,5
69527,5,3,242666,242666,242669,0,3,4
69528,5,2,242671,242671,242673,0,2,2
69529,2,3,242673,242673,242676,0,3,0
69530,1,1,242674,242676,242677,2,3,0
69531,2,2,242676,242677,242679,1,3,0
69532,6,2,242682,242682,242684,0,2,3
69533,2,1,242684,242684,242685,0,1,0
69534,6,3,242690,242690,242693,0,3,5
69535,2,1,242692,242693,242694,1,2,0
69536,2,2,242694,242694,242696,0,2,0
69537,2,3,242696,242696,242699,0,3,0
69538,4,1,242700,242700,242701,0,1,1
69539,2,1,242702,242702,242703,0,1,1
69540,2,2,242704,242704,242706,0,2,1
69541,5,2,242709,242709,242711,0,2,3
69542,3,3,242712,242712,242715,0,3,1
69543,5,1,242717,242717,242718,0,1,2
69544,3,2,242720,242720,242722,0,2,2
69545,2,2,242722,242722,242724,0,2,0
69546,5,1,242727,242727,242728,0,1,3
69547,5,2,242732,242732,242734,0,2,4
69548,6,1,242738,242738,242739,0,1,4
69549,4,2,242742,242742,242744,0,2,3
69550,4,2,242746,242746,242748,0,2,2
69551,5,1,242751,242751,242752,0,1,3
69552,4,3,242755,242755,242758,0,3,3
69553,1,2,242756,242758,242760,2,4,0
69554,1,2,242757,242760,242762,3,5,0
69555,1,1,242758,242762,242763,4,5,0
69556,1,2,242759,242763,242765,4,6,0
69557,2,1,242761,242765,242766,4,5,0
69558,6,3,242767,242767,242770,0,3,1
69559,5,3,242772,242772,242775,0,3,2
69560,4,3,242776,242776,242779,0,3,1
69561,6,3,242782,242782,242785,0,3,3
69562,3,1,242785,242785,242786,0,1,0
69563,4,1,242789,242789,242790,0,1,3
69564,1,2,242790,242790,242792,0,2,0
69565,1,1,242791,242792,242793,1,2,0
69566,3,3,242794,242794,242797,0,3,1
69567,2,1,242796,242797,242798,1,2,0
69568,5,1,242801,242801,242802,0,1,3
69569,3,2,242804,242804,242806,0,2,2
69570,1,3,242805,242806,242809,1,4,0
69571,2,2,242807,242809,242811,2,4,0
69572,3,1,242810,242811,242812,1,2,0
69573,6,2,242816,242816,242818,0,2,4
69574,4,2,242820,242820,242822,0,2,2
69575,3,2,242823,242823,242825,0,2,1
69576,4,3,242827,242827,242830,0,3,2
69577,2,2,242829,242830,242832,1,3,0
69578,5,1,242834,242834,242835,0,1,2
69579,5,3,242839,242839,242842,0,3,4
69580,3,1,242842,242842,242843,0,1,0
69581,3,1,242845,242845,242846,0,1,2
69582,3,3,242848,242848,242851,0,3,2
69583,4,1,242852,242852,242853,0,1,1
69584,2,1,242854,242854,242855,0,1,1
69585,2,1,242856,242856,242857,0,1,1
69586,5,1,242861,242861,242862,0,1,4
69587,5,3,242866,242866,242869,0,3,4
69588,4,1,242870,242870,242871,0,1,1
69589,4,1,242874,242874,242875,0,1,3
69590,4,2,242878,242878,242880,0,2,3
69591,3,3,242881,242881,242884,0,3,1
69592,1,2,242882,242884,242886,2,4,0
69593,3,1,242885,242886,242887,1,2,0
69594,5,3,242890,242890,242893,0,3,3
69595,5,1,242895,242895,242896,0,1,2
69596,1,1,242896,242896,242897,0,1,0
69597,1,1,242897,242897,242898,0,1,0
69598,3,2,242900,242900,242902,0,2,2
69599,3,1,242903,242903,242904,0,1,1
69600,4,3,242907,242907,242910,0,3,3
69601,4,3,242911,242911,242914,0,3,1
69602,1,3,242912,242914,242917,2,5,0
69603,5,3,242917,242917,242920,0,3,0
69604,6,1,242923,242923,242924,0,1,3
69605,5,2,242928,242928,242930,0,2,4
69606,1,3,242929,242930,242933,1,4,0
69607,6,3,242935,242935,242938,0,3,2
69608,4,1,242939,242939,242940,0,1,1
69609,2,3,242941,242941,242944,0,3,1
69610,2,2,242943,242944,242946,1,3,0
69611,5,1,242948,242948,242949,0,1,2
69612,1,1,242949,242949,242950,0,1,0
69613,4,3,242953,242953,242956,0,3,3
69614,6,3,242959,242959,242962,0,3,3
69615,2,1,242961,242962,242963,1,2,0
69616,4,2,242965,242965,242967,0,2,2
69617,1,3,242966,242967,242970,1,4,0
69618,3,3,242969,242970,242973,1,4,0
69619,2,3,242971,242973,242976,2,5,0
69620,5,1,242976,242976,242977,0,1,0
69621,5,1,242981,242981,242982,0,1,4
69622,2,1,242983,242983,242984,0,1,1
69623,3,1,242986,242986,242987,0,1,2
69624,3,1,242989,242989,242990,0,1,2
69625,2,1,242991,242991,242992,0,1,1
69626,4,2,242995,242995,242997,0,2,3
69627,5,2,243000,243000,243002,0,2,3
69628,1,1,243001,243002,243003,1,2,0
69629,6,2,243007,243007,243009,0,2,4
69630,5,3,243012,243012,243015,0,3,3
69631,6,2,243018,243018,243020,0,2,3
69632,1,3,243019,243020,243023,1,4,0
69633,6,3,243025,243025,243028,0,3,2
69634,2,3,243027,243028,243031,1,4,0
69635,2,1,243029,243031,243032,2,3,0
69636,5,3,243034,243034,243037,0,3,2
69637,3,1,243037,243037,243038,0,1,0
69638,1,3,243038,243038,243041,0,3,0
69639,1,3,243039,243041,243044,2,5,0
69640,4,1,243043,243044,243045,1,2,0
69641,5,3,243048,243048,243051,0,3,3
69642,6,3,243054,243054,243057,0,3,3
69643,6,1,243060,243060,243061,0,1,3
69644,3,3,243063,243063,243066,0,3,2
69645,1,2,243064,243066,243068,2,4,0
69646,3,2,243067,243068,243070,1,3,0
69647,3,3,243070,243070,243073,0,3,0
69648,2,1,243072,243073,243074,1,2,0
69649,2,1,243074,243074,243075,0,1,0
69650,6,1,243080,243080,243081,0,1,5
69651,6,3,243086,243086,243089,0,3,5
69652,6,2,243092,243092,243094,0,2,3
69653,4,2,243096,243096,243098,0,2,2
69654,5,3,243101,243101,243104,0,3,3
69655,5,3,243106,243106,243109,0,3,2
69656,1,1,243107,243109,243110,2,3,0
69657,1,1,243108,243110,243111,2,3,0
69658,4,3,243112,243112,243115,0,3,1
69659,5,2,243117,243117,243119,0,2,2
69660,5,3,243122,243122,243125,0,3,3
69661,3,2,243125,243125,243127,0,2,0
69662,6,1,243131,243131,243132,0,1,4
69663,6,3,243137,243137,243140,0,3,5
69664,5,2,243142,243142,243144,0,2,2
69665,3,2,243145,243145,243147,0,2,1
69666,2,3,243147,243147,243150,0,3,0
69667,6,2,243153,243153,243155,0,2,3
69668,1,2,243154,243155,243157,1,3,0
69669,4,2,243158,243158,243160,0,2,1
69670,2,3,243160,243160,243163,0,3,0
69671,4,3,243164,243164,243167,0,3,1
69672,6,3,243170,243170,243173,0,3,3
69673,3,1,243173,243173,243174,0,1,0
69674,1,3,243174,243174,243177,0,3,0
69675,3,2,243177,243177,243179,0,2,0
69676,6,3,243183,243183,243186,0,3,4
69677,4,1,243187,243187,243188,0,1,1
69678,6,1,243193,243193,243194,0,1,5
69679,6,2,243199,243199,243201,0,2,5
69680,5,3,243204,243204,243207,0,3,3
69681,4,2,243208,243208,243210,0,2,1
69682,3,3,243211,243211,243214,0,3,1
69683,3,1,243214,243214,243215,0,1,0
69684,1,1,243215,243215,243216,0,1,0
69685,4,2,243219,243219,243221,0,2,3
69686,5,2,243224,243224,243226,0,2,3
69687,5,3,243229,243229,243232,0,3,3
69688,5,3,243234,243234,243237,0,3,2
69689,1,2,243235,243237,243239,2,4,0
69690,5,1,243240,243240,243241,0,1,1
69691,3,2,243243,243243,243245,0,2,2
69692,2,1,243245,243245,243246,0,1,0
69693,3,3,243248,243248,243251,0,3,2
69694,5,1,243253,243253,243254,0,1,2
69695,4,1,243257,243257,243258,0,1,3
69696,4,2,243261,243261,243263,0,2,3
69697,4,3,243265,243265,243268,0,3,2
69698,5,3,243270,243270,243273,0,3,2
69699,6,1,243276,243276,243277,0,1,3
69700,3,2,243279,243279,243281,0,2,2
69701,6,3,243285,243285,243288,0,3,4
69702,5,3,243290,243290,243293,0,3,2
69703,4,2,243294,243294,243296,0,2,1
69704,2,2,243296,243296,243298,0,2,0
69705,4,3,243300,243300,243303,0,3,2
69706,4,3,243304,243304,243307,0,3,1
69707,3,2,243307,243307,243309,0,2,0
69708,3,3,243310,243310,243313,0,3,1
69709,4,3,243314,243314,243317,0,3,1
69710,6,3,243320,243320,243323,0,3,3
69711,3,2,243323,243323,243325,0,2,0
69712,5,3,243328,243328,243331,0,3,3
69713,2,1,243330,243331,243332,1,2,0
69714,6,3,243336,243336,243339,0,3,4
69715,1,3,243337,243339,243342,2,5,0
69716,3,2,243340,243342,243344,2,4,0
69717,2,2,243342,243344,243346,2,4,0
69718,2,1,243344,243346,243347,2,3,0
69719,6,2,243350,243350,243352,0,2,3
69720,6,1,243356,243356,243357,0,1,4
69721,3,1,243359,243359,243360,0,1,2
69722,1,1,243360,243360,243361,0,1,0
69723,3,1,243363,243363,243364,0,1,2
69724,1,3,243364,243364,243367,0,3,0
69725,4,3,243368,243368,243371,0,3,1
69726,5,3,243373,243373,243376,0,3,2
69727,2,2,243375,243376,243378,1,3,0
69728,5,3,243380,243380,243383,0,3,2
69729,4,3,243384,243384,243387,0,3,1
69730,6,3,243390,243390,243393,0,3,3
69731,2,3,243392,243393,243396,1,4,0
69732,6,2,243398,243398,243400,0,2,2
69733,5,3,243403,243403,243406,0,3,3
69734,5,3,243408,243408,243411,0,3,2
69735,1,1,243409,243411,243412,2,3,0
69736,5,3,243414,243414,243417,0,3,2
69737,5,1,243419,243419,243420,0,1,2
69738,4,1,243423,243423,243424,0,1,3
69739,4,1,243427,243427,243428,0,1,3
69740,2,1,243429,243429,243430,0,1,1
69741,6,2,243435,243435,243437,0,2,5
69742,3,3,243438,243438,243441,0,3,1
69743,1,2,243439,243441,243443,2,4,0
69744,1,2,243440,243443,243445,3,5,0
69745,5,2,243445,243445,243447,0,2,0
69746,4,2,243449,243449,243451,0,2,2
69747,1,3,243450,243451,243454,1,4,0
69748,1,1,243451,243454,243455,3,4,0
69749,4,2,243455,243455,243457,0,2,0
69750,6,2,243461,243461,243463,0,2,4
69751,1,2,243462,243463,243465,1,3,0
69752,5,3,243467,243467,243470,0,3,2
69753,6,2,243473,243473,243475,0,2,3
69754,4,2,243477,243477,243479,0,2,2
69755,4,2,243481,243481,243483,0,2,2
69756,5,2,243486,243486,243488,0,2,3
69757,5,3,243491,243491,243494,0,3,3
69758,6,1,243497,243497,243498,0,1,3
69759,3,3,243500,243500,243503,0,3,2
69760,3,2,243503,243503,243505,0,2,0
69761,2,3,243505,243505,243508,0,3,0
69762,2,2,243507,243508,243510,1,3,0
69763,1,1,243508,243510,243511,2,3,0
69764,5,2,243513,243513,243515,0,2,2
69765,6,1,243519,243519,243520,0,1,4
69766,1,3,243520,243520,243523,0,3,0
69767,6,1,243526,243526,243527,0,1,3
69768,3,2,243529,243529,243531,0,2,2
69769,6,3,243535,243535,243538,0,3,4
69770,2,1,243537,243538,243539,1,2,0
69771,2,2,243539,243539,243541,0,2,0
69772,6,2,243545,243545,243547,0,2,4
69773,3,1,243548,243548,243549,0,1,1
69774,2,3,243550,243550,243553,0,3,1
69775,1,2,243551,243553,243555,2,4,0
69776,1,2,243552,243555,243557,3,5,0
69777,6,1,243558,243558,243559,0,1,1
69778,1,1,243559,243559,243560,0,1,0
69779,1,1,243560,243560,243561,0,1,0
69780,2,3,243562,243562,243565,0,3,1
69781,1,2,243563,243565,243567,2,4,0
69782,6,1,243569,243569,243570,0,1,2
69783,4,2,243573,243573,243575,0,2,3
69784,4,1,243577,243577,243578,0,1,2
69785,6,1,243583,243583,243584,0,1,5
69786,2,1,243585,243585,243586,0,1,1
69787,4,2,243589,243589,243591,0,2,3
69788,6,3,243595,243595,243598,0,3,4
69789,1,1,243596,243598,243599,2,3,0
69790,2,2,243598,243599,243601,1,3,0
69791,5,3,243603,243603,243606,0,3,2
69792,4,2,243607,243607,243609,0,2,1
69793,6,3,243613,243613,243616,0,3,4
69794,3,3,243616,243616,243619,0,3,0
69795,5,1,243621,243621,243622,0,1,2
69796,3,1,243624,243624,243625,0,1,2
69797,5,2,243629,243629,243631,0,2,4
69798,4,3,243633,243633,243636,0,3,2
69799,2,1,243635,243636,243637,1,2,0
69800,3,3,243638,243638,243641,0,3,1
69801,4,1,243642,243642,243643,0,1,1
69802,4,1,243646,243646,243647,0,1,3
69803,4,1,243650,243650,243651,0,1,3
69804,3,1,243653,243653,243654,0,1,2
69805,2,3,243655,243655,243658,0,3,1
69806,1,2,243656,243658,243660,2,4,0
69807,3,3,243659,243660,243663,1,4,0
69808,1,2,243660,243663,243665,3,5,0
69809,2,3,243662,243665,243668,3,6,0
69810,4,1,243666,243668,243669,2,3,0
69811,5,3,243671,243671,243674,0,3,2
69812,1,2,243672,243674,243676,2,4,0
69813,6,1,243678,243678,243679,0,1,2
69814,2,2,243680,243680,243682,0,2,1
69815,6,1,243686,243686,243687,0,1,4
69816,1,3,243687,243687,243690,0,3,0
69817,6,2,243693,243693,243695,0,2,3
69818,4,3,243697,243697,243700,0,3,2
69819,1,1,243698,243700,243701,2,3,0
69820,1,3,243699,243701,243704,2,5,0
69821,4,3,243703,243704,243707,1,4,0
69822,5,3,243708,243708,243711,0,3,1
69823,1,1,243709,243711,243712,2,3,0
69824,4,2,243713,243713,243715,0,2,1
69825,3,3,243716,243716,243719,0,3,1
69826,3,2,243719,243719,243721,0,2,0
69827,6,2,243725,243725,243727,0,2,4
69828,1,2,243726,243727,243729,1,3,0
69829,6,3,243732,243732,243735,0,3,3
69830,1,3,243733,243735,243738,2,5,0
69831,3,3,243736,243738,243741,2,5,0
69832,4,1,243740,243741,243742,1,2,0
69833,6,2,243746,243746,243748,0,2,4
69834,5,2,243751,243751,243753,0,2,3
69835,4,3,243755,243755,243758,0,3,2
69836,2,1,243757,243758,243759,1,2,0
69837,3,1,243760,243760,243761,0,1,1
69838,4,3,243764,243764,243767,0,3,3
69839,6,1,243770,243770,243771,0,1,3
69840,6,3,243776,243776,243779,0,3,5
69841,3,2,243779,243779,243781,0,2,0
69842,3,2,243782,243782,243784,0,2,1
69843,4,3,243786,243786,243789,0,3,2
69844,4,2,243790,243790,243792,0,2,1
69845,5,3,243795,243795,243798,0,3,3
69846,1,3,243796,243798,243801,2,5,0
69847,2,1,243798,243801,243802,3,4,0
69848,5,1,243803,243803,243804,0,1,1
69849,1,1,243804,243804,243805,0,1,0
69850,4,3,243808,243808,243811,0,3,3
69851,1,2,243809,243811,243813,2,4,0
69852,6,2,243815,243815,243817,0,2,2
69853,3,2,243818,243818,243820,0,2,1
69854,6,2,243824,243824,243826,0,2,4
69855,4,2,243828,243828,243830,0,2,2
69856,1,2,243829,243830,243832,1,3,0
69857,4,1,243833,243833,243834,0,1,1
69858,3,2,243836,243836,243838,0,2,2
69859,1,2,243837,243838,243840,1,3,0
69860,4,2,243841,243841,243843,0,2,1
69861,6,3,243847,243847,243850,0,3,4
69862,2,3,243849,243850,243853,1,4,0
69863,3,1,243852,243853,243854,1,2,0
69864,1,1,243853,243854,243855,1,2,0
69865,3,1,243856,243856,243857,0,1,1
69866,1,3,243857,243857,243860,0,3,0
69867,3,1,243860,243860,243861,0,1,0
69868,2,1,243862,243862,243863,0,1,1
69869,6,1,243868,243868,243869,0,1,5
69870,4,2,243872,243872,243874,0,2,3
69871,3,3,243875,243875,243878,0,3,1
69872,2,1,243877,243878,243879,1,2,0
69873,3,1,243880,243880,243881,0,1,1
69874,2,3,243882,243882,243885,0,3,1
69875,6,3,243888,243888,243891,0,3,3
69876,2,1,243890,243891,243892,1,2,0
69877,1,1,243891,243892,243893,1,2,0
69878,3,1,243894,243894,243895,0,1,1
69879,5,3,243899,243899,243902,0,3,4
69880,3,2,243902,243902,243904,0,2,0
69881,3,2,243905,243905,243907,0,2,1
69882,6,2,243911,243911,243913,0,2,4
69883,5,3,243916,243916,243919,0,3,3
69884,2,1,243918,243919,243920,1,2,0
69885,6,2,243924,243924,243926,0,2,4
69886,3,2,243927,243927,243929,0,2,1
69887,4,1,243931,243931,243932,0,1,2
69888,1,2,243932,243932,243934,0,2,0
69889,2,3,243934,243934,243937,0,3,0
69890,3,2,243937,243937,243939,0,2,0
69891,3,1,243940,243940,243941,0,1,1
69892,4,1,243944,243944,243945,0,1,3
69893,4,2,243948,243948,243950,0,2,3
69894,3,3,243951,243951,243954,0,3,1
69895,2,3,243953,243954,243957,1,4,0
69896,2,1,243955,243957,243958,2,3,0
69897,2,3,243957,243958,243961,1,4,0
69898,5,1,243962,243962,243963,0,1,1
69899,5,2,243967,243967,243969,0,2,4
69900,4,3,243971,243971,243974,0,3,2
69901,1,1,243972,243974,243975,2,3,0
69902,2,1,243974,243975,243976,1,2,0
69903,6,1,243980,243980,243981,0,1,4
69904,6,3,243986,243986,243989,0,3,5
69905,1,1,243987,243989,243990,2,3,0
69906,3,1,243990,243990,243991,0,1,0
69907,4,3,243994,243994,243997,0,3,3
69908,6,3,244000,244000,244003,0,3,3
69909,6,1,244006,244006,244007,0,1,3
69910,5,3,244011,244011,244014,0,3,4
69911,2,3,244013,244014,244017,1,4,0
69912,1,1,244014,244017,244018,3,4,0
69913,1,1,244015,244018,244019,3,4,0
69914,1,3,244016,244019,244022,3,6,0
69915,5,3,244021,244022,244025,1,4,0
69916,3,1,244024,244025,244026,1,2,0
69917,1,1,244025,244026,244027,1,2,0
69918,5,1,244030,244030,244031,0,1,3
69919,3,3,244033,244033,244036,0,3,2
69920,1,3,244034,244036,244039,2,5,0
69921,4,2,244038,244039,244041,1,3,0
69922,3,2,244041,244041,244043,0,2,0
69923,5,1,244046,244046,244047,0,1,3
69924,1,1,244047,244047,244048,0,1,0
69925,4,3,244051,244051,244054,0,3,3
69926,3,3,244054,244054,244057,0,3,0
69927,5,2,244059,244059,244061,0,2,2
69928,2,3,244061,244061,244064,0,3,0
69929,4,1,244065,244065,244066,0,1,1
69930,2,3,244067,244067,244070,0,3,1
69931,3,3,244070,244070,244073,0,3,0
69932,1,1,244071,244073,244074,2,3,0
69933,5,3,244076,244076,244079,0,3,2
69934,1,1,244077,244079,244080,2,3,0
69935,6,1,244083,244083,244084,0,1,3
69936,1,1,244084,244084,244085,0,1,0
69937,1,1,244085,244085,244086,0,1,0
69938,6,2,244091,244091,244093,0,2,5
69939,5,3,244096,244096,244099,0,3,3
69940,2,1,244098,244099,244100,1,2,0
69941,1,1,244099,244100,244101,1,2,0
69942,1,2,244100,244101,244103,1,3,0
69943,3,3,244103,244103,244106,0,3,0
69944,4,2,244107,244107,244109,0,2,1
69945,1,2,244108,244109,244111,1,3,0
69946,6,3,244114,244114,244117,0,3,3
69947,5,2,244119,244119,244121,0,2,2
69948,2,1,244121,244121,244122,0,1,0
69949,4,3,244125,244125,244128,0,3,3
69950,6,1,244131,244131,244132,0,1,3
69951,5,2,244136,244136,244138,0,2,4
69952,3,3,244139,244139,244142,0,3,1
69953,6,1,244145,244145,244146,0,1,3
69954,6,3,244151,244151,244154,0,3,5
69955,2,2,244153,244154,244156,1,3,0
69956,4,3,244157,244157,244160,0,3,1
69957,6,2,244163,244163,244165,0,2,3
69958,2,1,244165,244165,244166,0,1,0
69959,2,2,244167,244167,244169,0,2,1
69960,2,3,244169,244169,244172,0,3,0
69961,3,1,244172,244172,244173,0,1,0
69962,6,3,244178,244178,244181,0,3,5
69963,2,1,244180,244181,244182,1,2,0
69964,5,1,244185,244185,244186,0,1,3
69965,4,1,244189,244189,244190,0,1,3
69966,2,2,244191,244191,244193,0,2,1
69967,1,1,244192,244193,244194,1,2,0
69968,1,2,244193,244194,244196,1,3,0
69969,6,1,244199,244199,244200,0,1,3
69970,6,3,244205,244205,244208,0,3,5
69971,4,3,244209,244209,244212,0,3,1
69972,3,3,244212,244212,244215,0,3,0
69973,3,2,244215,244215,244217,0,2,0
69974,2,3,244217,244217,244220,0,3,0
69975,2,1,244219,244220,244221,1,2,0
69976,2,3,244221,244221,244224,0,3,0
69977,1,3,244222,244224,244227,2,5,0
69978,4,2,244226,244227,244229,1,3,0
69979,3,2,244229,244229,244231,0,2,0
69980,4,1,244233,244233,244234,0,1,2
69981,5,2,244238,244238,244240,0,2,4
69982,5,1,244243,244243,244244,0,1,3
69983,2,3,244245,244245,244248,0,3,1
69984,5,2,244250,244250,244252,0,2,2
69985,6,1,244256,244256,244257,0,1,4
69986,3,2,244259,244259,244261,0,2,2
69987,5,3,244264,244264,244267,0,3,3
69988,5,1,244269,244269,244270,0,1,2
69989,5,3,244274,244274,244277,0,3,4
69990,2,3,244276,244277,244280,1,4,0
69991,2,3,244278,244280,244283,2,5,0
69992,4,3,244282,244283,244286,1,4,0
69993,4,3,244286,244286,244289,0,3,0
69994,3,3,244289,244289,244292,0,3,0
69995,2,2,244291,244292,244294,1,3,0
69996,3,2,244294,244294,244296,0,2,0
69997,6,2,244300,244300,244302,0,2,4
69998,6,1,244306,244306,244307,0,1,4
69999,6,1,244312,244312,244313,0,1,5
70000,3,2,244315,244315,244317,0,2,2
70001,3,3,244318,244318,244321,0,3,1
70002,3,1,244321,244321,244322,0,1,0
70003,2,2,244323,244323,244325,0,2,1
70004,2,1,244325,244325,244326,0,1,0
70005,1,1,244326,244326,244327,0,1,0
70006,3,1,244329,244329,244330,0,1,2
70007,2,2,244331,244331,244333,0,2,1
70008,2,2,244333,244333,244335,0,2,0
70009,2,1,244335,244335,244336,0,1,0
70010,6,1,244341,244341,244342,0,1,5
70011,5,2,244346,244346,244348,0,2,4
70012,4,2,244350,244350,244352,0,2,2
70013,6,3,244356,244356,244359,0,3,4
70014,2,1,244358,244359,244360,1,2,0
70015,4,2,244362,244362,244364,0,2,2
70016,1,3,244363,244364,244367,1,4,0
70017,2,2,244365,244367,244369,2,4,0
70018,2,1,244367,244369,244370,2,3,0
70019,3,2,244370,244370,244372,0,2,0
70020,3,3,244373,244373,244376,0,3,1
70021,1,2,244374,244376,244378,2,4,0
70022,3,2,244377,244378,244380,1,3,0
70023,3,2,244380,244380,244382,0,2,0
70024,5,3,244385,244385,244388,0,3,3
70025,5,3,244390,244390,244393,0,3,2
70026,4,2,244394,244394,244396,0,2,1
70027,3,3,244397,244397,244400,0,3,1
70028,1,3,244398,244400,244403,2,5,0
70029,2,3,244400,244403,244406,3,6,0
70030,1,3,244401,244406,244409,5,8,0
70031,3,3,244404,244409,244412,5,8,0
70032,5,1,244409,244412,244413,3,4,0
70033,2,2,244411,244413,244415,2,4,0
70034,3,3,244414,244415,244418,1,4,0
70035,6,3,244420,244420,244423,0,3,2
70036,3,1,244423,244423,244424,0,1,0
70037,4,2,244427,244427,244429,0,2,3
70038,6,3,244433,244433,244436,0,3,4
70039,6,3,244439,244439,244442,0,3,3
70040,6,1,244445,244445,244446,0,1,3
70041,4,1,244449,244449,244450,0,1,3
70042,5,2,244454,244454,244456,0,2,4
70043,4,3,244458,244458,244461,0,3,2
70044,6,1,244464,244464,244465,0,1,3
70045,5,1,244469,244469,244470,0,1,4
70046,1,2,244470,244470,244472,0,2,0
70047,5,2,244475,244475,244477,0,2,3
70048,1,1,244476,244477,244478,1,2,0
70049,2,1,244478,244478,244479,0,1,0
70050,1,3,244479,244479,244482,0,3,0
70051,1,2,244480,244482,244484,2,4,0
70052,1,1,244481,244484,244485,3,4,0
70053,2,2,244483,244485,244487,2,4,0
70054,6,3,244489,244489,244492,0,3,2
70055,4,2,244493,244493,244495,0,2,1
70056,4,3,244497,244497,244500,0,3,2
70057,6,1,244503,244503,244504,0,1,3
70058,3,3,244506,244506,244509,0,3,2
70059,1,2,244507,244509,244511,2,4,0
70060,4,3,244511,244511,244514,0,3,0
70061,2,1,244513,244514,244515,1,2,0
70062,2,2,244515,244515,244517,0,2,0
70063,1,3,244516,244517,244520,1,4,0
70064,2,2,244518,244520,244522,2,4,0
70065,1,1,244519,244522,244523,3,4,0
70066,3,3,244522,244523,244526,1,4,0
70067,3,1,244525,244526,244527,1,2,0
70068,2,2,244527,244527,244529,0,2,0
70069,1,3,244528,244529,244532,1,4,0
70070,3,1,244531,244532,244533,1,2,0
70071,2,3,244533,244533,244536,0,3,0
70072,1,3,244534,244536,244539,2,5,0
70073,1,1,244535,244539,244540,4,5,0
70074,1,2,244536,244540,244542,4,6,0
70075,3,3,244539,244542,244545,3,6,0
70076,2,1,244541,244545,244546,4,5,0
70077,5,2,244546,244546,244548,0,2,0
70078,2,1,244548,244548,244549,0,1,0
70079,6,3,244554,244554,244557,0,3,5
70080,3,2,244557,244557,244559,0,2,0
70081,1,2,244558,244559,244561,1,3,0
70082,5,1,244563,244563,244564,0,1,2
70083,5,3,244568,244568,244571,0,3,4
70084,6,3,244574,244574,244577,0,3,3
70085,1,1,244575,244577,244578,2,3,0
70086,2,3,244577,244578,244581,1,4,0
70087,3,2,244580,244581,244583,1,3,0
70088,1,1,244581,244583,244584,2,3,0
70089,2,1,244583,244584,244585,1,2,0
70090,6,2,244589,244589,244591,0,2,4
70091,5,2,244594,244594,244596,0,2,3
70092,5,2,244599,244599,244601,0,2,3
70093,1,2,244600,244601,244603,1,3,0
70094,2,1,244602,244603,244604,1,2,0
70095,2,1,244604,244604,244605,0,1,0
70096,5,1,244609,244609,244610,0,1,4
70097,5,2,244614,244614,244616,0,2,4
70098,1,1,244615,244616,244617,1,2,0
70099,1,3,244616,244617,244620,1,4,0
70100,6,3,244622,244622,244625,0,3,2
70101,3,3,244625,244625,244628,0,3,0
70102,3,3,244628,244628,244631,0,3,0
70103,2,1,244630,244631,244632,1,2,0
70104,6,2,244636,244636,244638,0,2,4
70105,3,1,244639,244639,244640,0,1,1
70106,2,1,244641,244641,244642,0,1,1
70107,2,1,244643,244643,244644,0,1,1
70108,5,1,244648,244648,244649,0,1,4
70109,6,1,244654,244654,244655,0,1,5
70110,1,2,244655,244655,244657,0,2,0
70111,4,1,244659,244659,244660,0,1,2
70112,5,1,244664,244664,244665,0,1,4
70113,3,1,244667,244667,244668,0,1,2
70114,2,1,244669,244669,244670,0,1,1
70115,1,1,244670,244670,244671,0,1,0
70116,3,3,244673,244673,244676,0,3,2
70117,2,2,244675,244676,244678,1,3,0
70118,1,3,244676,244678,244681,2,5,0
70119,3,3,244679,244681,244684,2,5,0
70120,4,3,244683,244684,244687,1,4,0
70121,5,1,244688,244688,244689,0,1,1
70122,3,1,244691,244691,244692,0,1,2
70123,4,3,244695,244695,244698,0,3,3
70124,2,1,244697,244698,244699,1,2,0
70125,5,1,244702,244702,244703,0,1,3
70126,2,1,244704,244704,244705,0,1,1
70127,6,1,244710,244710,244711,0,1,5
70128,1,3,244711,244711,244714,0,3,0
70129,4,1,244715,244715,244716,0,1,1
70130,1,2,244716,244716,244718,0,2,0
70131,6,1,244722,244722,244723,0,1,4
70132,4,2,244726,244726,244728,0,2,3
70133,2,2,244728,244728,244730,0,2,0
70134,6,2,244734,244734,244736,0,2,4
70135,5,3,244739,244739,244742,0,3,3
70136,6,1,244745,244745,244746,0,1,3
70137,3,2,244748,244748,244750,0,2,2
70138,4,3,244752,244752,244755,0,3,2
70139,5,1,244757,244757,244758,0,1,2
70140,1,3,244758,244758,244761,0,3,0
70141,3,1,244761,244761,244762,0,1,0
70142,1,1,244762,244762,244763,0,1,0
70143,4,1,244766,244766,244767,0,1,3
70144,5,1,244771,244771,244772,0,1,4
70145,1,2,244772,244772,244774,0,2,0
70146,1,3,244773,244774,244777,1,4,0
70147,1,2,244774,244777,244779,3,5,0
70148,1,3,244775,244779,244782,4,7,0
70149,6,3,244781,244782,244785,1,4,0
70150,3,2,244784,244785,244787,1,3,0
70151,1,1,244785,244787,244788,2,3,0
70152,6,1,244791,244791,244792,0,1,3
70153,5,1,244796,244796,244797,0,1,4
70154,3,3,244799,244799,244802,0,3,2
70155,3,1,244802,244802,244803,0,1,0
70156,1,1,244803,244803,244804,0,1,0
70157,5,3,244808,244808,244811,0,3,4
70158,1,3,244809,244811,244814,2,5,0
70159,1,1,244810,244814,244815,4,5,0
70160,2,3,244812,244815,244818,3,6,0
70161,1,3,244813,244818,244821,5,8,0
70162,5,1,244818,244821,244822,3,4,0
70163,5,3,244823,244823,244826,0,3,1
70164,5,1,244828,244828,244829,0,1,2
70165,1,3,244829,244829,244832,0,3,0
70166,2,1,244831,244832,244833,1,2,0
70167,3,2,244834,244834,244836,0,2,1
70168,6,2,244840,244840,244842,0,2,4
70169,2,1,244842,244842,244843,0,1,0
70170,5,2,244847,244847,244849,0,2,4
70171,3,3,244850,244850,244853,0,3,1
70172,2,3,244852,244853,244856,1,4,0
70173,3,1,244855,244856,244857,1,2,0
70174,2,1,244857,244857,244858,0,1,0
70175,4,2,244861,244861,244863,0,2,3
70176,1,1,244862,244863,244864,1,2,0
70177,4,3,244866,244866,244869,0,3,2
70178,2,1,244868,244869,244870,1,2,0
70179,5,3,244873,244873,244876,0,3,3
70180,6,1,244879,244879,244880,0,1,3
70181,3,3,244882,244882,244885,0,3,2
70182,4,1,244886,244886,244887,0,1,1
70183,6,2,244892,244892,244894,0,2,5
70184,4,3,244896,244896,244899,0,3,2
70185,6,3,244902,244902,244905,0,3,3
70186,6,2,244908,244908,244910,0,2,3
70187,5,3,244913,244913,244916,0,3,3
70188,6,3,244919,244919,244922,0,3,3
70189,2,2,244921,244922,244924,1,3,0
70190,1,3,244922,244924,244927,2,5,0
70191,5,1,244927,244927,244928,0,1,0
70192,6,1,244933,244933,244934,0,1,5
70193,4,3,244937,244937,244940,0,3,3
70194,4,2,244941,244941,244943,0,2,1
70195,5,1,244946,244946,244947,0,1,3
70196,3,2,244949,244949,244951,0,2,2
70197,2,3,244951,244951,244954,0,3,0
70198,3,3,244954,244954,244957,0,3,0
70199,1,2,244955,244957,244959,2,4,0
70200,1,3,244956,244959,244962,3,6,0
70201,1,3,244957,244962,244965,5,8,0
70202,2,3,244959,244965,244968,6,9,0
70203,3,3,244962,244968,244971,6,9,0
70204,5,3,244967,244971,244974,4,7,0
70205,4,2,244971,244974,244976,3,5,0
70206,4,3,244975,244976,244979,1,4,0
70207,2,3,244977,244979,244982,2,5,0
70208,6,2,244983,244983,244985,0,2,1
70209,2,3,244985,244985,244988,0,3,0
70210,3,3,244988,244988,244991,0,3,0
70211,6,3,244994,244994,244997,0,3,3
70212,2,2,244996,244997,244999,1,3,0
70213,6,3,245002,245002,245005,0,3,3
70214,3,2,245005,245005,245007,0,2,0
70215,5,1,245010,245010,245011,0,1,3
70216,1,2,245011,245011,245013,0,2,0
70217,5,2,245016,245016,245018,0,2,3
70218,5,2,245021,245021,245023,0,2,3
70219,1,1,245022,245023,245024,1,2,0
70220,5,1,245027,245027,245028,0,1,3
70221,3,1,245030,245030,245031,0,1,2
70222,6,2,245036,245036,245038,0,2,5
70223,2,3,245038,245038,245041,0,3,0
70224,5,3,245043,245043,245046,0,3,2
70225,5,1,245048,245048,245049,0,1,2
70226,4,2,245052,245052,245054,0,2,3
70227,1,2,245053,245054,245056,1,3,0
70228,2,2,245055,245056,245058,1,3,0
70229,5,2,245060,245060,245062,0,2,2
70230,4,3,245064,245064,245067,0,3,2
70231,1,2,245065,245067,245069,2,4,0
70232,6,3,245071,245071,245074,0,3,2
70233,2,2,245073,245074,245076,1,3,0
70234,1,2,245074,245076,245078,2,4,0
70235,3,3,245077,245078,245081,1,4,0
70236,4,1,245081,245081,245082,0,1,0
70237,4,3,245085,245085,245088,0,3,3
70238,3,3,245088,245088,245091,0,3,0
70239,3,1,245091,245091,245092,0,1,0
70240,5,1,245096,245096,245097,0,1,4
70241,4,2,245100,245100,245102,0,2,3
70242,6,1,245106,245106,245107,0,1,4
70243,3,3,245109,245109,245112,0,3,2
70244,5,2,245114,245114,245116,0,2,2
70245,4,2,245118,245118,245120,0,2,2
70246,5,1,245123,245123,245124,0,1,3
70247,2,3,245125,245125,245128,0,3,1
70248,4,2,245129,245129,245131,0,2,1
70249,2,1,245131,245131,245132,0,1,0
70250,4,1,245135,245135,245136,0,1,3
70251,2,3,245137,245137,245140,0,3,1
70252,1,2,245138,245140,245142,2,4,0
70253,4,3,245142,245142,245145,0,3,0
70254,6,3,245148,245148,245151,0,3,3
70255,5,2,245153,245153,245155,0,2,2
70256,2,3,245155,245155,245158,0,3,0
70257,2,2,245157,245158,245160,1,3,0
70258,6,1,245163,245163,245164,0,1,3
70259,4,3,245167,245167,245170,0,3,3
70260,5,1,245172,245172,245173,0,1,2
70261,1,1,245173,245173,245174,0,1,0
70262,3,1,245176,245176,245177,0,1,2
70263,4,1,245180,245180,245181,0,1,3
70264,2,1,245182,245182,245183,0,1,1
70265,3,2,245185,245185,245187,0,2,2
70266,2,3,245187,245187,245190,0,3,0
70267,3,1,245190,245190,245191,0,1,0
70268,1,1,245191,245191,245192,0,1,0
70269,2,3,245193,245193,245196,0,3,1
70270,4,1,245197,245197,245198,0,1,1
70271,2,1,245199,245199,245200,0,1,1
70272,1,2,245200,245200,245202,0,2,0
70273,4,1,245204,245204,245205,0,1,2
70274,6,3,245210,245210,245213,0,3,5
70275,1,2,245211,245213,245215,2,4,0
70276,4,1,245215,245215,245216,0,1,0
70277,5,3,245220,245220,245223,0,3,4
70278,3,3,245223,245223,245226,0,3,0
70279,6,3,245229,245229,245232,0,3,3
70280,2,2,245231,245232,245234,1,3,0
70281,1,2,245232,245234,245236,2,4,0
70282,4,2,245236,245236,245238,0,2,0
70283,2,3,245238,245238,245241,0,3,0
70284,5,1,245243,245243,245244,0,1,2
70285,5,2,245248,245248,245250,0,2,4
70286,4,3,245252,245252,245255,0,3,2
70287,5,3,245257,245257,245260,0,3,2
70288,2,3,245259,245260,245263,1,4,0
70289,2,3,245261,245263,245266,2,5,0
70290,5,2,245266,245266,245268,0,2,0
70291,6,2,245272,245272,245274,0,2,4
70292,1,1,245273,245274,245275,1,2,0
70293,6,1,245279,245279,245280,0,1,4
70294,4,3,245283,245283,245286,0,3,3
70295,4,1,245287,245287,245288,0,1,1
70296,4,3,245291,245291,245294,0,3,3
70297,2,3,245293,245294,245297,1,4,0
70298,4,2,245297,245297,245299,0,2,0
70299,6,2,245303,245303,245305,0,2,4
70300,3,1,245306,245306,245307,0,1,1
70301,5,3,245311,245311,245314,0,3,4
70302,3,2,245314,245314,245316,0,2,0
70303,6,1,245320,245320,245321,0,1,4
70304,1,2,245321,245321,245323,0,2,0
70305,1,2,245322,245323,245325,1,3,0
70306,3,3,245325,245325,245328,0,3,0
70307,1,3,245326,245328,245331,2,5,0
70308,4,3,245330,245331,245334,1,4,0
70309,6,3,245336,245336,245339,0,3,2
70310,5,2,245341,245341,245343,0,2,2
70311,5,3,245346,245346,245349,0,3,3
70312,6,2,245352,245352,245354,0,2,3
70313,4,3,245356,245356,245359,0,3,2
70314,6,1,245362,245362,245363,0,1,3
70315,3,3,245365,245365,245368,0,3,2
70316,4,3,245369,245369,245372,0,3,1
70317,3,3,245372,245372,245375,0,3,0
70318,3,3,245375,245375,245378,0,3,0
70319,5,3,245380,245380,245383,0,3,2
70320,3,3,245383,245383,245386,0,3,0
70321,5,1,245388,245388,245389,0,1,2
70322,1,2,245389,245389,245391,0,2,0
70323,6,2,245395,245395,245397,0,2,4
70324,1,3,245396,245397,245400,1,4,0
70325,3,1,245399,245400,245401,1,2,0
70326,3,2,245402,245402,245404,0,2,1
70327,6,2,245408,245408,245410,0,2,4
70328,1,1,245409,245410,245411,1,2,0
70329,2,2,245411,245411,245413,0,2,0
70330,6,1,245417,245417,245418,0,1,4
70331,4,2,245421,245421,245423,0,2,3
70332,2,2,245423,245423,245425,0,2,0
70333,4,3,245427,245427,245430,0,3,2
70334,1,2,245428,245430,245432,2,4,0
70335,3,3,245431,245432,245435,1,4,0
70336,2,2,245433,245435,245437,2,4,0
70337,3,3,245436,245437,245440,1,4,0
70338,3,1,245439,245440,245441,1,2,0
70339,2,1,245441,245441,245442,0,1,0
70340,3,1,245444,245444,245445,0,1,2
70341,3,2,245447,245447,245449,0,2,2
70342,1,3,245448,245449,245452,1,4,0
70343,2,3,245450,245452,245455,2,5,0
70344,2,1,245452,245455,245456,3,4,0
70345,3,2,245455,245456,245458,1,3,0
70346,5,2,245460,245460,245462,0,2,2
70347,6,2,245466,245466,245468,0,2,4
70348,5,2,245471,245471,245473,0,2,3
70349,5,3,245476,245476,245479,0,3,3
70350,1,3,245477,245479,245482,2,5,0
70351,1,3,245478,245482,245485,4,7,0
70352,2,3,245480,245485,245488,5,8,0
70353,4,3,245484,245488,245491,4,7,0
70354,6,3,245490,245491,245494,1,4,0
70355,6,3,245496,245496,245499,0,3,2
70356,4,1,245500,245500,245501,0,1,1
70357,2,3,245502,245502,245505,0,3,1
70358,4,2,245506,245506,245508,0,2,1
70359,2,2,245508,245508,245510,0,2,0
70360,1,1,245509,245510,245511,1,2,0
70361,2,3,245511,245511,245514,0,3,0
70362,6,1,245517,245517,245518,0,1,3
70363,4,3,245521,245521,245524,0,3,3
70364,2,2,245523,245524,245526,1,3,0
70365,6,3,245529,245529,245532,0,3,3
70366,1,1,245530,245532,245533,2,3,0
70367,2,3,245532,245533,245536,1,4,0
70368,5,2,245537,245537,245539,0,2,1
70369,5,2,245542,245542,245544,0,2,3
70370,1,2,245543,245544,245546,1,3,0
70371,2,2,245545,245546,245548,1,3,0
70372,2,1,245547,245548,245549,1,2,0
70373,4,1,245551,245551,245552,0,1,2
70374,3,2,245554,245554,245556,0,2,2
70375,4,3,245558,245558,245561,0,3,2
70376,4,3,245562,245562,245565,0,3,1
70377,4,2,245566,245566,245568,0,2,1
70378,6,3,245572,245572,245575,0,3,4
70379,5,3,245577,245577,245580,0,3,2
70380,2,1,245579,245580,245581,1,2,0
70381,5,3,245584,245584,245587,0,3,3
70382,3,3,245587,245587,245590,0,3,0
70383,3,1,245590,245590,245591,0,1,0
70384,3,2,245593,245593,245595,0,2,2
70385,3,2,245596,245596,245598,0,2,1
70386,2,3,245598,245598,245601,0,3,0
70387,1,1,245599,245601,245602,2,3,0
70388,2,3,245601,245602,245605,1,4,0
70389,2,1,245603,245605,245606,2,3,0
70390,1,1,245604,245606,245607,2,3,0
70391,2,3,245606,245607,245610,1,4,0
70392,5,3,245611,245611,245614,0,3,1
70393,1,3,245612,245614,245617,2,5,0
70394,2,3,245614,245617,245620,3,6,0
70395,4,2,245618,245620,245622,2,4,0
70396,1,2,245619,245622,245624,3,5,0
70397,5,2,245624,245624,245626,0,2,0
70398,1,1,245625,245626,245627,1,2,0
70399,1,3,245626,245627,245630,1,4,0
70400,5,3,245631,245631,245634,0,3,1
70401,2,1,245633,245634,245635,1,2,0
70402,5,2,245638,245638,245640,0,2,3
70403,1,2,245639,245640,245642,1,3,0
70404,1,3,245640,245642,245645,2,5,0
70405,5,2,245645,245645,245647,0,2,0
70406,4,1,245649,245649,245650,0,1,2
70407,1,2,245650,245650,245652,0,2,0
70408,1,2,245651,245652,245654,1,3,0
70409,2,1,245653,245654,245655,1,2,0
70410,3,2,245656,245656,245658,0,2,1
70411,1,1,245657,245658,245659,1,2,0
70412,6,1,245663,245663,245664,0,1,4
70413,1,2,245664,245664,245666,0,2,0
70414,2,3,245666,245666,245669,0,3,0
70415,1,1,245667,245669,245670,2,3,0
70416,1,2,245668,245670,245672,2,4,0
70417,2,3,245670,245672,245675,2,5,0
70418,2,2,245672,245675,245677,3,5,0
70419,3,3,245675,245677,245680,2,5,0
70420,5,1,245680,245680,245681,0,1,0
70421,5,1,245685,245685,245686,0,1,4
70422,1,1,245686,245686,245687,0,1,0
70423,3,1,245689,245689,245690,0,1,2
70424,1,2,245690,245690,245692,0,2,0
70425,2,2,245692,245692,245694,0,2,0
70426,3,2,245695,245695,245697,0,2,1
70427,6,2,245701,245701,245703,0,2,4
70428,3,3,245704,245704,245707,0,3,1
70429,4,3,245708,245708,245711,0,3,1
70430,1,1,245709,245711,245712,2,3,0
70431,4,1,245713,245713,245714,0,1,1
70432,1,3,245714,245714,245717,0,3,0
70433,2,3,245716,245717,245720,1,4,0
70434,5,3,245721,245721,245724,0,3,1
70435,2,1,245723,245724,245725,1,2,0
70436,3,3,245726,245726,245729,0,3,1
70437,5,2,245731,245731,245733,0,2,2
70438,6,1,245737,245737,245738,0,1,4
70439,1,3,245738,245738,245741,0,3,0
70440,5,2,245743,245743,245745,0,2,2
70441,5,2,245748,245748,245750,0,2,3
70442,2,1,245750,245750,245751,0,1,0
70443,2,1,245752,245752,245753,0,1,1
70444,1,2,245753,245753,245755,0,2,0
70445,1,2,245754,245755,245757,1,3,0
70446,1,1,245755,245757,245758,2,3,0
70447,6,2,245761,245761,245763,0,2,3
70448,2,3,245763,245763,245766,0,3,0
70449,6,3,245769,245769,245772,0,3,3
70450,1,3,245770,245772,245775,2,5,0
70451,3,2,245773,245775,245777,2,4,0
70452,5,3,245778,245778,245781,0,3,1
70453,3,2,245781,245781,245783,0,2,0
70454,2,2,245783,245783,245785,0,2,0
70455,6,1,245789,245789,245790,0,1,4
70456,5,1,245794,245794,245795,0,1,4
70457,1,2,245795,245795,245797,0,2,0
70458,6,1,245801,245801,245802,0,1,4
70459,3,2,245804,245804,245806,0,2,2
70460,5,2,245809,245809,245811,0,2,3
70461,2,2,245811,245811,245813,0,2,0
70462,1,3,245812,245813,245816,1,4,0
70463,6,3,245818,245818,245821,0,3,2
70464,4,3,245822,245822,245825,0,3,1
70465,4,3,245826,245826,245829,0,3,1
70466,2,1,245828,245829,245830,1,2,0
70467,6,1,245834,245834,245835,0,1,4
70468,5,2,245839,245839,245841,0,2,4
70469,2,3,245841,245841,245844,0,3,0
70470,1,2,245842,245844,245846,2,4,0
70471,5,1,245847,245847,245848,0,1,1
70472,4,3,245851,245851,245854,0,3,3
70473,4,1,245855,245855,245856,0,1,1
70474,4,3,245859,245859,245862,0,3,3
70475,3,1,245862,245862,245863,0,1,0
70476,2,1,245864,245864,245865,0,1,1
70477,3,3,245867,245867,245870,0,3,2
70478,3,3,245870,245870,245873,0,3,0
70479,2,1,245872,245873,245874,1,2,0
70480,3,2,245875,245875,245877,0,2,1
70481,4,1,245879,245879,245880,0,1,2
70482,3,2,245882,245882,245884,0,2,2
70483,6,2,245888,245888,245890,0,2,4
70484,2,2,245890,245890,245892,0,2,0
70485,4,1,245894,245894,245895,0,1,2
70486,1,1,245895,245895,245896,0,1,0
70487,3,3,245898,245898,245901,0,3,2
70488,3,1,245901,245901,245902,0,1,0
70489,1,3,245902,245902,245905,0,3,0
70490,4,3,245906,245906,245909,0,3,1
70491,1,2,245907,245909,245911,2,4,0
70492,5,2,245912,245912,245914,0,2,1
70493,3,1,245915,245915,245916,0,1,1
70494,4,2,245919,245919,245921,0,2,3
70495,2,3,245921,245921,245924,0,3,0
70496,6,2,245927,245927,245929,0,2,3
70497,2,1,245929,245929,245930,0,1,0
70498,5,1,245934,245934,245935,0,1,4
70499,5,1,245939,245939,245940,0,1,4
70500,5,1,245944,245944,245945,0,1,4
70501,4,3,245948,245948,245951,0,3,3
70502,2,3,245950,245951,245954,1,4,0
70503,6,3,245956,245956,245959,0,3,2
70504,6,2,245962,245962,245964,0,2,3
70505,2,1,245964,245964,245965,0,1,0
70506,1,3,245965,245965,245968,0,3,0
70507,2,2,245967,245968,245970,1,3,0
70508,4,1,245971,245971,245972,0,1,1
70509,4,2,245975,245975,245977,0,2,3
70510,5,2,245980,245980,245982,0,2,3
70511,2,2,245982,245982,245984,0,2,0
70512,1,3,245983,245984,245987,1,4,0
70513,6,2,245989,245989,245991,0,2,2
70514,4,2,245993,245993,245995,0,2,2
70515,4,2,245997,245997,245999,0,2,2
70516,1,1,245998,245999,246000,1,2,0
70517,4,3,246002,246002,246005,0,3,2
70518,4,1,246006,246006,246007,0,1,1
70519,6,3,246012,246012,246015,0,3,5
70520,6,3,246018,246018,246021,0,3,3
70521,3,3,246021,246021,246024,0,3,0
70522,2,1,246023,246024,246025,1,2,0
70523,2,2,246025,246025,246027,0,2,0
70524,4,2,246029,246029,246031,0,2,2
70525,6,3,246035,246035,246038,0,3,4
70526,6,2,246041,246041,246043,0,2,3
70527,5,2,246046,246046,246048,0,2,3
70528,5,3,246051,246051,246054,0,3,3
70529,5,3,246056,246056,246059,0,3,2
70530,1,1,246057,246059,246060,2,3,0
70531,5,3,246062,246062,246065,0,3,2
70532,3,2,246065,246065,246067,0,2,0
70533,1,3,246066,246067,246070,1,4,0
70534,6,2,246072,246072,246074,0,2,2
70535,4,1,246076,246076,246077,0,1,2
70536,3,3,246079,246079,246082,0,3,2
70537,6,3,246085,246085,246088,0,3,3
70538,5,1,246090,246090,246091,0,1,2
70539,5,2,246095,246095,246097,0,2,4
70540,1,1,246096,246097,246098,1,2,0
70541,3,3,246099,246099,246102,0,3,1
70542,2,1,246101,246102,246103,1,2,0
70543,1,2,246102,246103,246105,1,3,0
70544,2,1,246104,246105,246106,1,2,0
70545,2,2,246106,246106,246108,0,2,0
70546,3,1,246109,246109,246110,0,1,1
70547,4,2,246113,246113,246115,0,2,3
70548,5,2,246118,246118,246120,0,2,3
70549,5,2,246123,246123,246125,0,2,3
70550,6,2,246129,246129,246131,0,2,4
70551,4,1,246133,246133,246134,0,1,2
70552,1,1,246134,246134,246135,0,1,0
70553,3,3,246137,246137,246140,0,3,2
70554,4,1,246141,246141,246142,0,1,1
70555,6,2,246147,246147,246149,0,2,5
70556,1,2,246148,246149,246151,1,3,0
70557,1,1,246149,246151,246152,2,3,0
70558,1,2,246150,246152,246154,2,4,0
70559,2,1,246152,246154,246155,2,3,0
70560,6,3,246158,246158,246161,0,3,3
70561,1,1,246159,246161,246162,2,3,0
70562,3,1,246162,246162,246163,0,1,0
70563,3,2,246165,246165,246167,0,2,2
70564,3,1,246168,246168,246169,0,1,1
70565,6,1,246174,246174,246175,0,1,5
70566,6,2,246180,246180,246182,0,2,5
70567,5,1,246185,246185,246186,0,1,3
70568,4,1,246189,246189,246190,0,1,3
70569,4,1,246193,246193,246194,0,1,3
70570,6,3,246199,246199,246202,0,3,5
70571,1,1,246200,246202,246203,2,3,0
70572,5,3,246205,246205,246208,0,3,2
70573,1,1,246206,246208,246209,2,3,0
70574,4,2,246210,246210,246212,0,2,1
70575,4,3,246214,246214,246217,0,3,2
70576,2,3,246216,246217,246220,1,4,0
70577,2,3,246218,246220,246223,2,5,0
70578,3,3,246221,246223,246226,2,5,0
70579,4,2,246225,246226,246228,1,3,0
70580,3,2,246228,246228,246230,0,2,0
70581,6,2,246234,246234,246236,0,2,4
70582,5,3,246239,246239,246242,0,3,3
70583,4,3,246243,246243,246246,0,3,1
70584,3,2,246246,246246,246248,0,2,0
70585,4,3,246250,246250,246253,0,3,2
70586,2,3,246252,246253,246256,1,4,0
70587,6,2,246258,246258,246260,0,2,2
70588,6,2,246264,246264,246266,0,2,4
70589,5,2,246269,246269,246271,0,2,3
70590,5,2,246274,246274,246276,0,2,3
70591,1,3,246275,246276,246279,1,4,0
70592,5,2,246280,246280,246282,0,2,1
70593,3,2,246283,246283,246285,0,2,1
70594,6,2,246289,246289,246291,0,2,4
70595,6,2,246295,246295,246297,0,2,4
70596,4,1,246299,246299,246300,0,1,2
70597,6,3,246305,246305,246308,0,3,5
70598,6,2,246311,246311,246313,0,2,3
70599,5,1,246316,246316,246317,0,1,3
70600,6,1,246322,246322,246323,0,1,5
70601,1,1,246323,246323,246324,0,1,0
70602,3,1,246326,246326,246327,0,1,2
70603,6,2,246332,246332,246334,0,2,5
70604,2,2,246334,246334,246336,0,2,0
70605,6,2,246340,246340,246342,0,2,4
70606,5,3,246345,246345,246348,0,3,3
70607,2,3,246347,246348,246351,1,4,0
70608,2,3,246349,246351,246354,2,5,0
70609,6,3,246355,246355,246358,0,3,1
70610,4,1,246359,246359,246360,0,1,1
70611,3,1,246362,246362,246363,0,1,2
70612,6,1,246368,246368,246369,0,1,5
70613,6,3,246374,246374,246377,0,3,5
70614,2,2,246376,246377,246379,1,3,0
70615,1,3,246377,246379,246382,2,5,0
70616,2,2,246379,246382,246384,3,5,0
70617,3,1,246382,246384,246385,2,3,0
70618,1,3,246383,246385,246388,2,5,0
70619,1,2,246384,246388,246390,4,6,0
70620,2,1,246386,246390,246391,4,5,0
70621,3,2,246389,246391,246393,2,4,0
70622,1,3,246390,246393,246396,3,6,0
70623,1,2,246391,246396,246398,5,7,0
70624,6,3,246397,246398,246401,1,4,0
70625,5,2,246402,246402,246404,0,2,1
70626,5,3,246407,246407,246410,0,3,3
70627,3,1,246410,246410,246411,0,1,0
70628,4,2,246414,246414,246416,0,2,3
70629,1,1,246415,246416,246417,1,2,0
70630,2,1,246417,246417,246418,0,1,0
70631,2,2,246419,246419,246421,0,2,1
70632,1,3,246420,246421,246424,1,4,0
70633,4,3,246424,246424,246427,0,3,0
70634,6,1,246430,246430,246431,0,1,3
70635,5,1,246435,246435,246436,0,1,4
70636,6,3,246441,246441,246444,0,3,5
70637,1,1,246442,246444,246445,2,3,0
70638,5,3,246447,246447,246450,0,3,2
70639,3,1,246450,246450,246451,0,1,0
70640,1,3,246451,246451,246454,0,3,0
70641,5,2,246456,246456,246458,0,2,2
70642,5,1,246461,246461,246462,0,1,3
70643,2,1,246463,246463,246464,0,1,1
70644,6,1,246469,246469,246470,0,1,5
70645,3,3,246472,246472,246475,0,3,2
70646,5,2,246477,246477,246479,0,2,2
70647,3,1,246480,246480,246481,0,1,1
70648,3,3,246483,246483,246486,0,3,2
70649,5,1,246488,246488,246489,0,1,2
70650,3,1,246491,246491,246492,0,1,2
70651,1,3,246492,246492,246495,0,3,0
70652,3,1,246495,246495,246496,0,1,0
70653,2,2,246497,246497,246499,0,2,1
70654,4,1,246501,246501,246502,0,1,2
70655,3,3,246504,246504,246507,0,3,2
70656,4,2,246508,246508,246510,0,2,1
70657,5,1,246513,246513,246514,0,1,3
70658,2,1,246515,246515,246516,0,1,1
70659,3,2,246518,246518,246520,0,2,2
70660,1,1,246519,246520,246521,1,2,0
70661,5,3,246524,246524,246527,0,3,3
70662,2,3,246526,246527,246530,1,4,0
70663,6,3,246532,246532,246535,0,3,2
70664,1,3,246533,246535,246538,2,5,0
70665,6,1,246539,246539,246540,0,1,1
70666,1,3,246540,246540,246543,0,3,0
70667,4,3,246544,246544,246547,0,3,1
70668,5,2,246549,246549,246551,0,2,2
70669,6,2,246555,246555,246557,0,2,4
70670,2,1,246557,246557,246558,0,1,0
70671,6,1,246563,246563,246564,0,1,5
70672,6,3,246569,246569,246572,0,3,5
70673,4,1,246573,246573,246574,0,1,1
70674,4,1,246577,246577,246578,0,1,3
70675,3,3,246580,246580,246583,0,3,2
70676,4,3,246584,246584,246587,0,3,1
70677,6,3,246590,246590,246593,0,3,3
70678,5,1,246595,246595,246596,0,1,2
70679,4,2,246599,246599,246601,0,2,3
70680,5,3,246604,246604,246607,0,3,3
70681,1,3,246605,246607,246610,2,5,0
70682,4,1,246609,246610,246611,1,2,0
70683,6,3,246615,246615,246618,0,3,4
70684,4,3,246619,246619,246622,0,3,1
70685,5,3,246624,246624,246627,0,3,2
70686,6,3,246630,246630,246633,0,3,3
70687,5,1,246635,246635,246636,0,1,2
70688,1,3,246636,246636,246639,0,3,0
70689,5,2,246641,246641,246643,0,2,2
70690,4,3,246645,246645,246648,0,3,2
70691,3,1,246648,246648,246649,0,1,0
70692,3,3,246651,246651,246654,0,3,2
70693,6,3,246657,246657,246660,0,3,3
70694,5,3,246662,246662,246665,0,3,2
70695,2,2,246664,246665,246667,1,3,0
70696,2,2,246666,246667,246669,1,3,0
70697,1,3,246667,246669,246672,2,5,0
70698,6,2,246673,246673,246675,0,2,1
70699,2,3,246675,246675,246678,0,3,0
70700,2,2,246677,246678,246680,1,3,0
70701,6,2,246683,246683,246685,0,2,3
70702,2,2,246685,246685,246687,0,2,0
70703,4,2,246689,246689,246691,0,2,2
70704,5,2,246694,246694,246696,0,2,3
70705,4,2,246698,246698,246700,0,2,2
70706,5,2,246703,246703,246705,0,2,3
70707,2,1,246705,246705,246706,0,1,0
70708,3,2,246708,246708,246710,0,2,2
70709,4,1,246712,246712,246713,0,1,2
70710,4,3,246716,246716,246719,0,3,3
70711,2,1,246718,246719,246720,1,2,0
70712,2,2,246720,246720,246722,0,2,0
70713,2,3,246722,246722,246725,0,3,0
70714,5,1,246727,246727,246728,0,1,2
70715,5,1,246732,246732,246733,0,1,4
70716,5,1,246737,246737,246738,0,1,4
70717,6,2,246743,246743,246745,0,2,5
70718,1,3,246744,246745,246748,1,4,0
70719,4,3,246748,246748,246751,0,3,0
70720,4,3,246752,246752,246755,0,3,1
70721,3,1,246755,246755,246756,0,1,0
70722,4,2,246759,246759,246761,0,2,3
70723,6,1,246765,246765,246766,0,1,4
70724,4,3,246769,246769,246772,0,3,3
70725,6,3,246775,246775,246778,0,3,3
70726,6,1,246781,246781,246782,0,1,3
70727,6,1,246787,246787,246788,0,1,5
70728,1,2,246788,246788,246790,0,2,0
70729,2,3,246790,246790,246793,0,3,0
70730,3,1,246793,246793,246794,0,1,0
70731,2,3,246795,246795,246798,0,3,1
70732,5,1,246800,246800,246801,0,1,2
70733,6,1,246806,246806,246807,0,1,5
70734,5,1,246811,246811,246812,0,1,4
70735,5,2,246816,246816,246818,0,2,4
70736,2,1,246818,246818,246819,0,1,0
70737,4,1,246822,246822,246823,0,1,3
70738,5,2,246827,246827,246829,0,2,4
70739,1,2,246828,246829,246831,1,3,0
70740,2,1,246830,246831,246832,1,2,0
70741,6,2,246836,246836,246838,0,2,4
70742,2,2,246838,246838,246840,0,2,0
70743,5,2,246843,246843,246845,0,2,3
70744,1,3,246844,246845,246848,1,4,0
70745,3,2,246847,246848,246850,1,3,0
70746,6,3,246853,246853,246856,0,3,3
70747,3,1,246856,246856,246857,0,1,0
70748,6,2,246862,246862,246864,0,2,5
70749,5,2,246867,246867,246869,0,2,3
70750,4,3,246871,246871,246874,0,3,2
70751,5,3,246876,246876,246879,0,3,2
70752,2,3,246878,246879,246882,1,4,0
70753,5,2,246883,246883,246885,0,2,1
70754,1,2,246884,246885,246887,1,3,0
70755,3,3,246887,246887,246890,0,3,0
70756,6,2,246893,246893,246895,0,2,3
70757,2,1,246895,246895,246896,0,1,0
70758,3,2,246898,246898,246900,0,2,2
70759,4,1,246902,246902,246903,0,1,2
70760,2,1,246904,246904,246905,0,1,1
70761,5,2,246909,246909,246911,0,2,4
70762,6,3,246915,246915,246918,0,3,4
70763,2,1,246917,246918,246919,1,2,0
70764,6,2,246923,246923,246925,0,2,4
70765,5,1,246928,246928,246929,0,1,3
70766,1,2,246929,246929,246931,0,2,0
70767,2,2,246931,246931,246933,0,2,0
70768,6,2,246937,246937,246939,0,2,4
70769,3,1,246940,246940,246941,0,1,1
70770,5,2,246945,246945,246947,0,2,4
70771,6,1,246951,246951,246952,0,1,4
70772,6,2,246957,246957,246959,0,2,5
70773,3,1,246960,246960,246961,0,1,1
70774,6,3,246966,246966,246969,0,3,5
70775,2,3,246968,246969,246972,1,4,0
70776,2,3,246970,246972,246975,2,5,0
70777,2,3,246972,246975,246978,3,6,0
70778,6,1,246978,246978,246979,0,1,0
70779,5,1,246983,246983,246984,0,1,4
70780,3,3,246986,246986,246989,0,3,2
70781,6,2,246992,246992,246994,0,2,3
70782,4,2,246996,246996,246998,0,2,2
70783,1,3,246997,246998,247001,1,4,0
70784,4,1,247001,247001,247002,0,1,0
70785,1,2,247002,247002,247004,0,2,0
70786,3,2,247005,247005,247007,0,2,1
70787,3,1,247008,247008,247009,0,1,1
70788,4,2,247012,247012,247014,0,2,3
70789,2,2,247014,247014,247016,0,2,0
70790,6,1,247020,247020,247021,0,1,4
70791,3,1,247023,247023,247024,0,1,2
70792,4,3,247027,247027,247030,0,3,3
70793,2,1,247029,247030,247031,1,2,0
70794,1,2,247030,247031,247033,1,3,0
70795,2,1,247032,247033,247034,1,2,0
70796,5,2,247037,247037,247039,0,2,3
70797,2,1,247039,247039,247040,0,1,0
70798,3,3,247042,247042,247045,0,3,2
70799,4,3,247046,247046,247049,0,3,1
70800,6,1,247052,247052,247053,0,1,3
70801,6,3,247058,247058,247061,0,3,5
70802,3,3,247061,247061,247064,0,3,0
70803,4,3,247065,247065,247068,0,3,1
70804,1,3,247066,247068,247071,2,5,0
70805,6,2,247072,247072,247074,0,2,1
70806,3,3,247075,247075,247078,0,3,1
70807,2,1,247077,247078,247079,1,2,0
70808,4,3,247081,247081,247084,0,3,2
70809,3,3,247084,247084,247087,0,3,0
70810,1,3,247085,247087,247090,2,5,0
70811,3,2,247088,247090,247092,2,4,0
70812,1,3,247089,247092,247095,3,6,0
70813,1,3,247090,247095,247098,5,8,0
70814,1,2,247091,247098,247100,7,9,0
70815,2,2,247093,247100,247102,7,9,0
70816,5,2,247098,247102,247104,4,6,0
70817,4,2,247102,247104,247106,2,4,0
70818,6,2,247108,247108,247110,0,2,2
70819,1,2,247109,247110,247112,1,3,0
70820,1,2,247110,247112,247114,2,4,0
70821,6,2,247116,247116,247118,0,2,2
70822,4,3,247120,247120,247123,0,3,2
70823,2,3,247122,247123,247126,1,4,0
70824,1,1,247123,247126,247127,3,4,0
70825,2,3,247125,247127,247130,2,5,0
70826,1,3,247126,247130,247133,4,7,0
70827,3,3,247129,247133,247136,4,7,0
70828,4,2,247133,247136,247138,3,5,0
70829,2,1,247135,247138,247139,3,4,0
70830,3,1,247138,247139,247140,1,2,0
70831,2,3,247140,247140,247143,0,3,0
70832,2,2,247142,247143,247145,1,3,0
70833,2,1,247144,247145,247146,1,2,0
70834,5,1,247149,247149,247150,0,1,3
70835,3,2,247152,247152,247154,0,2,2
70836,5,1,247157,247157,247158,0,1,3
70837,3,2,247160,247160,247162,0,2,2
70838,6,3,247166,247166,247169,0,3,4
70839,1,1,247167,247169,247170,2,3,0
70840,5,1,247172,247172,247173,0,1,2
70841,6,2,247178,247178,247180,0,2,5
70842,2,1,247180,247180,247181,0,1,0
70843,6,1,247186,247186,247187,0,1,5
70844,3,3,247189,247189,247192,0,3,2
70845,5,3,247194,247194,247197,0,3,2
70846,6,3,247200,247200,247203,0,3,3
70847,3,1,247203,247203,247204,0,1,0
70848,4,1,247207,247207,247208,0,1,3
70849,4,2,247211,247211,247213,0,2,3
70850,4,3,247215,247215,247218,0,3,2
70851,6,1,247221,247221,247222,0,1,3
70852,1,1,247222,247222,247223,0,1,0
70853,1,1,247223,247223,247224,0,1,0
70854,5,3,247228,247228,247231,0,3,4
70855,1,2,247229,247231,247233,2,4,0
70856,1,1,247230,247233,247234,3,4,0
70857,2,2,247232,247234,247236,2,4,0
70858,4,3,247236,247236,247239,0,3,0
70859,6,2,247242,247242,247244,0,2,3
70860,3,2,247245,247245,247247,0,2,1
70861,3,3,247248,247248,247251,0,3,1
70862,1,3,247249,247251,247254,2,5,0
70863,4,2,247253,247254,247256,1,3,0
70864,3,1,247256,247256,247257,0,1,0
70865,4,2,247260,247260,247262,0,2,3
70866,5,2,247265,247265,247267,0,2,3
70867,3,2,247268,247268,247270,0,2,1
70868,6,2,247274,247274,247276,0,2,4
70869,2,1,247276,247276,247277,0,1,0
70870,5,2,247281,247281,247283,0,2,4
70871,2,2,247283,247283,247285,0,2,0
70872,3,1,247286,247286,247287,0,1,1
70873,2,3,247288,247288,247291,0,3,1
70874,5,1,247293,247293,247294,0,1,2
70875,3,3,247296,247296,247299,0,3,2
70876,6,2,247302,247302,247304,0,2,3
70877,1,1,247303,247304,247305,1,2,0
70878,3,2,247306,247306,247308,0,2,1
70879,6,2,247312,247312,247314,0,2,4
70880,3,2,247315,247315,247317,0,2,1
70881,3,3,247318,247318,247321,0,3,1
70882,2,2,247320,247321,247323,1,3,0
70883,3,3,247323,247323,247326,0,3,0
70884,2,3,247325,247326,247329,1,4,0
70885,2,1,247327,247329,247330,2,3,0
70886,1,1,247328,247330,247331,2,3,0
70887,5,2,247333,247333,247335,0,2,2
70888,5,2,247338,247338,247340,0,2,3
70889,5,3,247343,247343,247346,0,3,3
70890,1,3,247344,247346,247349,2,5,0
70891,5,1,247349,247349,247350,0,1,0
70892,5,3,247354,247354,247357,0,3,4
70893,6,1,247360,247360,247361,0,1,3
70894,5,2,247365,247365,247367,0,2,4
70895,2,2,247367,247367,247369,0,2,0
70896,4,3,247371,247371,247374,0,3,2
70897,3,1,247374,247374,247375,0,1,0
70898,3,1,247377,247377,247378,0,1,2
70899,2,1,247379,247379,247380,0,1,1
70900,2,3,247381,247381,247384,0,3,1
70901,3,1,247384,247384,247385,0,1,0
70902,4,1,247388,247388,247389,0,1,3
70903,1,1,247389,247389,247390,0,1,0
70904,6,1,247395,247395,247396,0,1,5
70905,6,1,247401,247401,247402,0,1,5
70906,1,2,247402,247402,247404,0,2,0
70907,4,2,247406,247406,247408,0,2,2
70908,1,2,247407,247408,247410,1,3,0
70909,4,3,247411,247411,247414,0,3,1
70910,6,3,247417,247417,247420,0,3,3
70911,2,3,247419,247420,247423,1,4,0
70912,6,2,247425,247425,247427,0,2,2
70913,6,2,247431,247431,247433,0,2,4
70914,6,2,247437,247437,247439,0,2,4
70915,5,3,247442,247442,247445,0,3,3
70916,1,3,247443,247445,247448,2,5,0
70917,1,1,247444,247448,247449,4,5,0
70918,5,3,247449,247449,247452,0,3,0
70919,4,3,247453,247453,247456,0,3,1
70920,4,2,247457,247457,247459,0,2,1
70921,2,2,247459,247459,247461,0,2,0
70922,4,2,247463,247463,247465,0,2,2
70923,6,2,247469,247469,247471,0,2,4
70924,5,2,247474,247474,247476,0,2,3
70925,1,3,247475,247476,247479,1,4,0
70926,1,3,247476,247479,247482,3,6,0
70927,3,3,247479,247482,247485,3,6,0
70928,4,3,247483,247485,247488,2,5,0
70929,1,3,247484,247488,247491,4,7,0
70930,4,2,247488,247491,247493,3,5,0
70931,2,1,247490,247493,247494,3,4,0
70932,4,2,247494,247494,247496,0,2,0
70933,2,1,247496,247496,247497,0,1,0
70934,1,3,247497,247497,247500,0,3,0
70935,2,2,247499,247500,247502,1,3,0
70936,1,2,247500,247502,247504,2,4,0
70937,6,1,247506,247506,247507,0,1,2
70938,2,1,247508,247508,247509,0,1,1
70939,1,2,247509,247509,247511,0,2,0
70940,3,1,247512,247512,247513,0,1,1
70941,1,1,247513,247513,247514,0,1,0
70942,4,1,247517,247517,247518,0,1,3
70943,4,1,247521,247521,247522,0,1,3
70944,1,3,247522,247522,247525,0,3,0
70945,3,3,247525,247525,247528,0,3,0
70946,6,2,247531,247531,247533,0,2,3
70947,5,3,247536,247536,247539,0,3,3
70948,6,1,247542,247542,247543,0,1,3
70949,4,2,247546,247546,247548,0,2,3
70950,2,2,247548,247548,247550,0,2,0
70951,4,3,247552,247552,247555,0,3,2
70952,2,1,247554,247555,247556,1,2,0
70953,5,3,247559,247559,247562,0,3,3
70954,3,1,247562,247562,247563,0,1,0
70955,1,3,247563,247563,247566,0,3,0
70956,6,3,247569,247569,247572,0,3,3
70957,5,1,247574,247574,247575,0,1,2
70958,5,2,247579,247579,247581,0,2,4
70959,3,1,247582,247582,247583,0,1,1
70960,6,1,247588,247588,247589,0,1,5
70961,2,3,247590,247590,247593,0,3,1
70962,6,2,247596,247596,247598,0,2,3
70963,3,3,247599,247599,247602,0,3,1
70964,6,1,247605,247605,247606,0,1,3
70965,4,3,247609,247609,247612,0,3,3
70966,1,2,247610,247612,247614,2,4,0
70967,4,3,247614,247614,247617,0,3,0
70968,4,1,247618,247618,247619,0,1,1
70969,3,1,247621,247621,247622,0,1,2
70970,6,2,247627,247627,247629,0,2,5
70971,1,1,247628,247629,247630,1,2,0
70972,4,1,247632,247632,247633,0,1,2
70973,4,2,247636,247636,247638,0,2,3
70974,4,1,247640,247640,247641,0,1,2
70975,2,2,247642,247642,247644,0,2,1
70976,1,2,247643,247644,247646,1,3,0
70977,3,2,247646,247646,247648,0,2,0
70978,2,1,247648,247648,247649,0,1,0
70979,1,2,247649,247649,247651,0,2,0
70980,3,2,247652,247652,247654,0,2,1
70981,2,1,247654,247654,247655,0,1,0
70982,4,1,247658,247658,247659,0,1,3
70983,1,2,247659,247659,247661,0,2,0
70984,3,3,247662,247662,247665,0,3,1
70985,1,3,247663,247665,247668,2,5,0
70986,1,2,247664,247668,247670,4,6,0
70987,6,3,247670,247670,247673,0,3,0
70988,2,2,247672,247673,247675,1,3,0
70989,5,1,247677,247677,247678,0,1,2
70990,6,2,247683,247683,247685,0,2,5
70991,3,3,247686,247686,247689,0,3,1
70992,3,3,247689,247689,247692,0,3,0
70993,3,1,247692,247692,247693,0,1,0
70994,4,1,247696,247696,247697,0,1,3
70995,3,1,247699,247699,247700,0,1,2
70996,3,1,247702,247702,247703,0,1,2
70997,2,1,247704,247704,247705,0,1,1
70998,4,2,247708,247708,247710,0,2,3
70999,1,2,247709,247710,247712,1,3,0
71000,2,3,247711,247712,247715,1,4,0
71001,1,1,247712,247715,247716,3,4,0
71002,4,1,247716,247716,247717,0,1,0
71003,5,3,247721,247721,247724,0,3,4
71004,3,3,247724,247724,247727,0,3,0
71005,2,1,247726,247727,247728,1,2,0
71006,6,3,247732,247732,247735,0,3,4
71007,3,2,247735,247735,247737,0,2,0
71008,2,3,247737,247737,247740,0,3,0
71009,6,1,247743,247743,247744,0,1,3
71010,4,2,247747,247747,247749,0,2,3
71011,6,3,247753,247753,247756,0,3,4
71012,1,2,247754,247756,247758,2,4,0
71013,5,1,247759,247759,247760,0,1,1
71014,3,1,247762,247762,247763,0,1,2
71015,6,1,247768,247768,247769,0,1,5
71016,3,1,247771,247771,247772,0,1,2
71017,5,3,247776,247776,247779,0,3,4
71018,6,1,247782,247782,247783,0,1,3
71019,5,3,247787,247787,247790,0,3,4
71020,2,1,247789,247790,247791,1,2,0
71021,5,2,247794,247794,247796,0,2,3
71022,2,1,247796,247796,247797,0,1,0
71023,5,3,247801,247801,247804,0,3,4
71024,3,2,247804,247804,247806,0,2,0
71025,5,3,247809,247809,247812,0,3,3
71026,4,3,247813,247813,247816,0,3,1
71027,3,3,247816,247816,247819,0,3,0
71028,4,1,247820,247820,247821,0,1,1
71029,4,1,247824,247824,247825,0,1,3
71030,1,3,247825,247825,247828,0,3,0
71031,5,1,247830,247830,247831,0,1,2
71032,2,2,247832,247832,247834,0,2,1
71033,2,2,247834,247834,247836,0,2,0
71034,2,3,247836,247836,247839,0,3,0
71035,2,1,247838,247839,247840,1,2,0
71036,3,1,247841,247841,247842,0,1,1
71037,2,2,247843,247843,247845,0,2,1
71038,1,2,247844,247845,247847,1,3,0
71039,3,3,247847,247847,247850,0,3,0
71040,6,2,247853,247853,247855,0,2,3
71041,6,3,247859,247859,247862,0,3,4
71042,6,2,247865,247865,247867,0,2,3
71043,1,2,247866,247867,247869,1,3,0
71044,4,1,247870,247870,247871,0,1,1
71045,5,3,247875,247875,247878,0,3,4
71046,1,2,247876,247878,247880,2,4,0
71047,4,2,247880,247880,247882,0,2,0
71048,2,3,247882,247882,247885,0,3,0
71049,6,1,247888,247888,247889,0,1,3
71050,6,1,247894,247894,247895,0,1,5
71051,3,1,247897,247897,247898,0,1,2
71052,6,3,247903,247903,247906,0,3,5
71053,3,3,247906,247906,247909,0,3,0
71054,2,3,247908,247909,247912,1,4,0
71055,2,1,247910,247912,247913,2,3,0
71056,3,3,247913,247913,247916,0,3,0
71057,1,1,247914,247916,247917,2,3,0
71058,3,3,247917,247917,247920,0,3,0
71059,2,3,247919,247920,247923,1,4,0
71060,2,2,247921,247923,247925,2,4,0
71061,6,1,247927,247927,247928,0,1,2
71062,5,1,247932,247932,247933,0,1,4
71063,1,1,247933,247933,247934,0,1,0
71064,4,2,247937,247937,247939,0,2,3
71065,6,1,247943,247943,247944,0,1,4
71066,5,1,247948,247948,247949,0,1,4
71067,2,3,247950,247950,247953,0,3,1
71068,1,2,247951,247953,247955,2,4,0
71069,6,1,247957,247957,247958,0,1,2
71070,5,3,247962,247962,247965,0,3,4
71071,6,1,247968,247968,247969,0,1,3
71072,2,2,247970,247970,247972,0,2,1
71073,1,3,247971,247972,247975,1,4,0
71074,4,2,247975,247975,247977,0,2,0
71075,4,1,247979,247979,247980,0,1,2
71076,3,1,247982,247982,247983,0,1,2
71077,1,2,247983,247983,247985,0,2,0
71078,2,2,247985,247985,247987,0,2,0
71079,4,2,247989,247989,247991,0,2,2
71080,1,3,247990,247991,247994,1,4,0
71081,1,1,247991,247994,247995,3,4,0
71082,5,3,247996,247996,247999,0,3,1
71083,5,2,248001,248001,248003,0,2,2
71084,4,3,248005,248005,248008,0,3,2
71085,2,3,248007,248008,248011,1,4,0
71086,2,2,248009,248011,248013,2,4,0
71087,5,3,248014,248014,248017,0,3,1
71088,4,2,248018,248018,248020,0,2,1
71089,3,1,248021,248021,248022,0,1,1
71090,3,3,248024,248024,248027,0,3,2
71091,2,1,248026,248027,248028,1,2,0
71092,6,1,248032,248032,248033,0,1,4
71093,4,3,248036,248036,248039,0,3,3
71094,5,2,248041,248041,248043,0,2,2
71095,2,1,248043,248043,248044,0,1,0
71096,5,3,248048,248048,248051,0,3,4
71097,3,3,248051,248051,248054,0,3,0
71098,4,1,248055,248055,248056,0,1,1
71099,4,2,248059,248059,248061,0,2,3
71100,4,3,248063,248063,248066,0,3,2
71101,2,2,248065,248066,248068,1,3,0
71102,2,1,248067,248068,248069,1,2,0
71103,6,2,248073,248073,248075,0,2,4
71104,2,3,248075,248075,248078,0,3,0
71105,4,1,248079,248079,248080,0,1,1
71106,3,2,248082,248082,248084,0,2,2
71107,2,1,248084,248084,248085,0,1,0
71108,3,3,248087,248087,248090,0,3,2
71109,2,1,248089,248090,248091,1,2,0
71110,5,1,248094,248094,248095,0,1,3
71111,4,2,248098,248098,248100,0,2,3
71112,5,3,248103,248103,248106,0,3,3
71113,2,2,248105,248106,248108,1,3,0
71114,5,3,248110,248110,248113,0,3,2
71115,2,2,248112,248113,248115,1,3,0
71116,3,3,248115,248115,248118,0,3,0
71117,4,2,248119,248119,248121,0,2,1
71118,5,3,248124,248124,248127,0,3,3
71119,4,2,248128,248128,248130,0,2,1
71120,2,2,248130,248130,248132,0,2,0
71121,6,1,248136,248136,248137,0,1,4
71122,6,3,248142,248142,248145,0,3,5
71123,3,2,248145,248145,248147,0,2,0
71124,2,1,248147,248147,248148,0,1,0
71125,5,2,248152,248152,248154,0,2,4
71126,4,1,248156,248156,248157,0,1,2
71127,6,3,248162,248162,248165,0,3,5
71128,1,1,248163,248165,248166,2,3,0
71129,1,3,248164,248166,248169,2,5,0
71130,4,2,248168,248169,248171,1,3,0
71131,5,2,248173,248173,248175,0,2,2
71132,3,2,248176,248176,248178,0,2,1
71133,6,2,248182,248182,248184,0,2,4
71134,6,3,248188,248188,248191,0,3,4
71135,6,3,248194,248194,248197,0,3,3
71136,1,2,248195,248197,248199,2,4,0
71137,5,1,248200,248200,248201,0,1,1
71138,4,1,248204,248204,248205,0,1,3
71139,1,1,248205,248205,248206,0,1,0
71140,3,3,248208,248208,248211,0,3,2
71141,1,1,248209,248211,248212,2,3,0
71142,2,3,248211,248212,248215,1,4,0
71143,4,1,248215,248215,248216,0,1,0
71144,5,1,248220,248220,248221,0,1,4
71145,6,1,248226,248226,248227,0,1,5
71146,6,3,248232,248232,248235,0,3,5
71147,1,3,248233,248235,248238,2,5,0
71148,6,2,248239,248239,248241,0,2,1
71149,4,2,248243,248243,248245,0,2,2
71150,6,1,248249,248249,248250,0,1,4
71151,4,2,248253,248253,248255,0,2,3
71152,6,3,248259,248259,248262,0,3,4
71153,3,3,248262,248262,248265,0,3,0
71154,5,1,248267,248267,248268,0,1,2
71155,4,2,248271,248271,248273,0,2,3
71156,4,2,248275,248275,248277,0,2,2
71157,1,2,248276,248277,248279,1,3,0
71158,6,2,248282,248282,248284,0,2,3
71159,4,2,248286,248286,248288,0,2,2
71160,5,1,248291,248291,248292,0,1,3
71161,5,2,248296,248296,248298,0,2,4
71162,2,3,248298,248298,248301,0,3,0
71163,6,1,248304,248304,248305,0,1,3
71164,5,1,248309,248309,248310,0,1,4
71165,4,3,248313,248313,248316,0,3,3
71166,1,3,248314,248316,248319,2,5,0
71167,6,3,248320,248320,248323,0,3,1
71168,5,2,248325,248325,248327,0,2,2
71169,4,1,248329,248329,248330,0,1,2
71170,4,1,248333,248333,248334,0,1,3
71171,2,2,248335,248335,248337,0,2,1
71172,4,2,248339,248339,248341,0,2,2
71173,2,1,248341,248341,248342,0,1,0
71174,5,1,248346,248346,248347,0,1,4
71175,3,3,248349,248349,248352,0,3,2
71176,2,1,248351,248352,248353,1,2,0
71177,2,2,248353,248353,248355,0,2,0
71178,1,1,248354,248355,248356,1,2,0
71179,3,3,248357,248357,248360,0,3,1
71180,5,3,248362,248362,248365,0,3,2
71181,6,1,248368,248368,248369,0,1,3
71182,3,3,248371,248371,248374,0,3,2
71183,2,1,248373,248374,248375,1,2,0
71184,6,1,248379,248379,248380,0,1,4
71185,6,3,248385,248385,248388,0,3,5
71186,3,2,248388,248388,248390,0,2,0
71187,2,3,248390,248390,248393,0,3,0
71188,4,3,248394,248394,248397,0,3,1
71189,5,2,248399,248399,248401,0,2,2
71190,1,2,248400,248401,248403,1,3,0
71191,3,1,248403,248403,248404,0,1,0
71192,1,2,248404,248404,248406,0,2,0
71193,2,2,248406,248406,248408,0,2,0
71194,3,2,248409,248409,248411,0,2,1
71195,2,2,248411,248411,248413,0,2,0
71196,6,3,248417,248417,248420,0,3,4
71197,3,2,248420,248420,248422,0,2,0
71198,6,2,248426,248426,248428,0,2,4
71199,6,1,248432,248432,248433,0,1,4
71200,2,1,248434,248434,248435,0,1,1
71201,2,2,248436,248436,248438,0,2,1
71202,3,1,248439,248439,248440,0,1,1
71203,6,1,248445,248445,248446,0,1,5
71204,3,2,248448,248448,248450,0,2,2
71205,5,1,248453,248453,248454,0,1,3
71206,4,3,248457,248457,248460,0,3,3
71207,3,1,248460,248460,248461,0,1,0
71208,2,3,248462,248462,248465,0,3,1
71209,1,2,248463,248465,248467,2,4,0
71210,1,1,248464,248467,248468,3,4,0
71211,1,3,248465,248468,248471,3,6,0
71212,6,2,248471,248471,248473,0,2,0
71213,6,3,248477,248477,248480,0,3,4
71214,5,2,248482,248482,248484,0,2,2
71215,2,2,248484,248484,248486,0,2,0
71216,3,1,248487,248487,248488,0,1,1
71217,3,3,248490,248490,248493,0,3,2
71218,4,2,248494,248494,248496,0,2,1
71219,6,1,248500,248500,248501,0,1,4
71220,6,3,248506,248506,248509,0,3,5
71221,3,3,248509,248509,248512,0,3,0
71222,6,1,248515,248515,248516,0,1,3
71223,4,3,248519,248519,248522,0,3,3
71224,6,3,248525,248525,248528,0,3,3
71225,5,1,248530,248530,248531,0,1,2
71226,6,1,248536,248536,248537,0,1,5
71227,2,2,248538,248538,248540,0,2,1
71228,2,2,248540,248540,248542,0,2,0
71229,3,2,248543,248543,248545,0,2,1
71230,6,2,248549,248549,248551,0,2,4
71231,5,3,248554,248554,248557,0,3,3
71232,5,1,248559,248559,248560,0,1,2
71233,6,1,248565,248565,248566,0,1,5
71234,4,2,248569,248569,248571,0,2,3
71235,4,2,248573,248573,248575,0,2,2
71236,5,3,248578,248578,248581,0,3,3
71237,1,3,248579,248581,248584,2,5,0
71238,1,2,248580,248584,248586,4,6,0
71239,5,3,248585,248586,248589,1,4,0
71240,2,3,248587,248589,248592,2,5,0
71241,2,2,248589,248592,248594,3,5,0
71242,1,2,248590,248594,248596,4,6,0
71243,6,2,248596,248596,248598,0,2,0
71244,4,3,248600,248600,248603,0,3,2
71245,3,2,248603,248603,248605,0,2,0
71246,3,1,248606,248606,248607,0,1,1
71247,2,1,248608,248608,248609,0,1,1
71248,6,1,248614,248614,248615,0,1,5
71249,2,1,248616,248616,248617,0,1,1
71250,3,1,248619,248619,248620,0,1,2
71251,4,1,248623,248623,248624,0,1,3
71252,1,3,248624,248624,248627,0,3,0
71253,6,1,248630,248630,248631,0,1,3
71254,4,1,248634,248634,248635,0,1,3
71255,3,3,248637,248637,248640,0,3,2
71256,5,3,248642,248642,248645,0,3,2
71257,1,2,248643,248645,248647,2,4,0
71258,5,2,248648,248648,248650,0,2,1
71259,5,2,248653,248653,248655,0,2,3
71260,6,3,248659,248659,248662,0,3,4
71261,2,2,248661,248662,248664,1,3,0
71262,6,1,248667,248667,248668,0,1,3
71263,6,2,248673,248673,248675,0,2,5
71264,4,3,248677,248677,248680,0,3,2
71265,6,2,248683,248683,248685,0,2,3
71266,2,2,248685,248685,248687,0,2,0
71267,6,3,248691,248691,248694,0,3,4
71268,6,1,248697,248697,248698,0,1,3
71269,4,3,248701,248701,248704,0,3,3
71270,1,2,248702,248704,248706,2,4,0
71271,3,1,248705,248706,248707,1,2,0
71272,6,1,248711,248711,248712,0,1,4
71273,3,2,248714,248714,248716,0,2,2
71274,2,1,248716,248716,248717,0,1,0
71275,4,2,248720,248720,248722,0,2,3
71276,6,2,248726,248726,248728,0,2,4
71277,6,2,248732,248732,248734,0,2,4
71278,5,1,248737,248737,248738,0,1,3
71279,3,3,248740,248740,248743,0,3,2
71280,3,1,248743,248743,248744,0,1,0
71281,3,3,248746,248746,248749,0,3,2
71282,4,1,248750,248750,248751,0,1,1
71283,4,3,248754,248754,248757,0,3,3
71284,5,1,248759,248759,248760,0,1,2
71285,3,1,248762,248762,248763,0,1,2
71286,4,1,248766,248766,248767,0,1,3
71287,2,1,248768,248768,248769,0,1,1
71288,6,1,248774,248774,248775,0,1,5
71289,6,3,248780,248780,248783,0,3,5
71290,2,1,248782,248783,248784,1,2,0
71291,5,1,248787,248787,248788,0,1,3
71292,5,2,248792,248792,248794,0,2,4
71293,2,1,248794,248794,248795,0,1,0
71294,5,1,248799,248799,248800,0,1,4
71295,6,1,248805,248805,248806,0,1,5
71296,4,1,248809,248809,248810,0,1,3
71297,6,1,248815,248815,248816,0,1,5
71298,5,1,248820,248820,248821,0,1,4
71299,3,2,248823,248823,248825,0,2,2
71300,5,2,248828,248828,248830,0,2,3
71301,4,2,248832,248832,248834,0,2,2
71302,3,2,248835,248835,248837,0,2,1
71303,6,1,248841,248841,248842,0,1,4
71304,6,3,248847,248847,248850,0,3,5
71305,5,3,248852,248852,248855,0,3,2
71306,3,2,248855,248855,248857,0,2,0
71307,4,2,248859,248859,248861,0,2,2
71308,3,2,248862,248862,248864,0,2,1
71309,4,3,248866,248866,248869,0,3,2
71310,6,3,248872,248872,248875,0,3,3
71311,1,1,248873,248875,248876,2,3,0
71312,5,3,248878,248878,248881,0,3,2
71313,3,3,248881,248881,248884,0,3,0
71314,3,1,248884,248884,248885,0,1,0
71315,2,2,248886,248886,248888,0,2,1
71316,1,1,248887,248888,248889,1,2,0
71317,5,3,248892,248892,248895,0,3,3
71318,3,1,248895,248895,248896,0,1,0
71319,6,3,248901,248901,248904,0,3,5
71320,2,1,248903,248904,248905,1,2,0
71321,1,1,248904,248905,248906,1,2,0
71322,6,2,248910,248910,248912,0,2,4
71323,5,3,248915,248915,248918,0,3,3
71324,3,2,248918,248918,248920,0,2,0
71325,6,3,248924,248924,248927,0,3,4
71326,3,1,248927,248927,248928,0,1,0
71327,5,1,248932,248932,248933,0,1,4
71328,2,2,248934,248934,248936,0,2,1
71329,3,2,248937,248937,248939,0,2,1
71330,5,3,248942,248942,248945,0,3,3
71331,3,2,248945,248945,248947,0,2,0
71332,2,3,248947,248947,248950,0,3,0
71333,5,3,248952,248952,248955,0,3,2
71334,6,3,248958,248958,248961,0,3,3
71335,6,1,248964,248964,248965,0,1,3
71336,2,1,248966,248966,248967,0,1,1
71337,1,1,248967,248967,248968,0,1,0
71338,5,2,248972,248972,248974,0,2,4
71339,6,3,248978,248978,248981,0,3,4
71340,5,3,248983,248983,248986,0,3,2
71341,1,1,248984,248986,248987,2,3,0
71342,4,3,248988,248988,248991,0,3,1
71343,4,2,248992,248992,248994,0,2,1
71344,4,3,248996,248996,248999,0,3,2
71345,2,2,248998,248999,249001,1,3,0
71346,3,2,249001,249001,249003,0,2,0
71347,2,3,249003,249003,249006,0,3,0
71348,3,1,249006,249006,249007,0,1,0
71349,5,3,249011,249011,249014,0,3,4
71350,4,2,249015,249015,249017,0,2,1
71351,2,3,249017,249017,249020,0,3,0
71352,4,2,249021,249021,249023,0,2,1
71353,3,3,249024,249024,249027,0,3,1
71354,6,1,249030,249030,249031,0,1,3
71355,1,3,249031,249031,249034,0,3,0
71356,1,2,249032,249034,249036,2,4,0
71357,6,2,249038,249038,249040,0,2,2
71358,5,3,249043,249043,249046,0,3,3
71359,5,2,249048,249048,249050,0,2,2
71360,1,1,249049,249050,249051,1,2,0
71361,3,2,249052,249052,249054,0,2,1
71362,6,1,249058,249058,249059,0,1,4
71363,5,1,249063,249063,249064,0,1,4
71364,3,3,249066,249066,249069,0,3,2
71365,3,1,249069,249069,249070,0,1,0
71366,3,3,249072,249072,249075,0,3,2
71367,4,2,249076,249076,249078,0,2,1
71368,1,2,249077,249078,249080,1,3,0
71369,1,3,249078,249080,249083,2,5,0
71370,3,1,249081,249083,249084,2,3,0
71371,3,1,249084,249084,249085,0,1,0
71372,3,1,249087,249087,249088,0,1,2
71373,5,2,249092,249092,249094,0,2,4
71374,6,2,249098,249098,249100,0,2,4
71375,3,2,249101,249101,249103,0,2,1
71376,1,1,249102,249103,249104,1,2,0
71377,6,3,249108,249108,249111,0,3,4
71378,1,2,249109,249111,249113,2,4,0
71379,1,3,249110,249113,249116,3,6,0
71380,4,2,249114,249116,249118,2,4,0
71381,4,2,249118,249118,249120,0,2,0
71382,6,3,249124,249124,249127,0,3,4
71383,6,2,249130,249130,249132,0,2,3
71384,5,3,249135,249135,249138,0,3,3
71385,4,1,249139,249139,249140,0,1,1
71386,2,3,249141,249141,249144,0,3,1
71387,3,2,249144,249144,249146,0,2,0
71388,2,1,249146,249146,249147,0,1,0
71389,2,2,249148,249148,249150,0,2,1
71390,4,1,249152,249152,249153,0,1,2
71391,5,3,249157,249157,249160,0,3,4
71392,1,2,249158,249160,249162,2,4,0
71393,4,1,249162,249162,249163,0,1,0
71394,1,3,249163,249163,249166,0,3,0
71395,1,3,249164,249166,249169,2,5,0
71396,4,1,249168,249169,249170,1,2,0
71397,2,1,249170,249170,249171,0,1,0
71398,2,2,249172,249172,249174,0,2,1
71399,4,2,249176,249176,249178,0,2,2
71400,2,2,249178,249178,249180,0,2,0
71401,4,1,249182,249182,249183,0,1,2
71402,4,1,249186,249186,249187,0,1,3
71403,2,1,249188,249188,249189,0,1,1
71404,5,2,249193,249193,249195,0,2,4
71405,5,3,249198,249198,249201,0,3,3
71406,3,2,249201,249201,249203,0,2,0
71407,3,2,249204,249204,249206,0,2,1
71408,4,3,249208,249208,249211,0,3,2
71409,6,2,249214,249214,249216,0,2,3
71410,2,1,249216,249216,249217,0,1,0
71411,3,3,249219,249219,249222,0,3,2
71412,3,3,249222,249222,249225,0,3,0
71413,5,3,249227,249227,249230,0,3,2
71414,1,3,249228,249230,249233,2,5,0
71415,4,3,249232,249233,249236,1,4,0
71416,5,3,249237,249237,249240,0,3,1
71417,1,1,249238,249240,249241,2,3,0
71418,2,1,249240,249241,249242,1,2,0
71419,3,3,249243,249243,249246,0,3,1
71420,1,1,249244,249246,249247,2,3,0
71421,5,1,249249,249249,249250,0,1,2
71422,2,3,249251,249251,249254,0,3,1
71423,3,1,249254,249254,249255,0,1,0
71424,5,1,249259,249259,249260,0,1,4
71425,4,2,249263,249263,249265,0,2,3
71426,3,2,249266,249266,249268,0,2,1
71427,1,1,249267,249268,249269,1,2,0
71428,4,2,249271,249271,249273,0,2,2
71429,4,1,249275,249275,249276,0,1,2
71430,3,2,249278,249278,249280,0,2,2
71431,5,2,249283,249283,249285,0,2,3
71432,2,3,249285,249285,249288,0,3,0
71433,4,2,249289,249289,249291,0,2,1
71434,5,1,249294,249294,249295,0,1,3
71435,2,2,249296,249296,249298,0,2,1
71436,4,2,249300,249300,249302,0,2,2
71437,3,3,249303,249303,249306,0,3,1
71438,2,1,249305,249306,249307,1,2,0
71439,6,3,249311,249311,249314,0,3,4
71440,6,2,249317,249317,249319,0,2,3
71441,3,2,249320,249320,249322,0,2,1
71442,3,1,249323,249323,249324,0,1,1
71443,1,2,249324,249324,249326,0,2,0
71444,1,2,249325,249326,249328,1,3,0
71445,1,3,249326,249328,249331,2,5,0
71446,4,3,249330,249331,249334,1,4,0
71447,2,1,249332,249334,249335,2,3,0
71448,4,2,249336,249336,249338,0,2,1
71449,4,1,249340,249340,249341,0,1,2
71450,5,3,249345,249345,249348,0,3,4
71451,1,1,249346,249348,249349,2,3,0
71452,6,1,249352,249352,249353,0,1,3
71453,2,3,249354,249354,249357,0,3,1
71454,2,3,249356,249357,249360,1,4,0
71455,6,1,249362,249362,249363,0,1,2
71456,2,3,249364,249364,249367,0,3,1
71457,4,2,249368,249368,249370,0,2,1
71458,1,1,249369,249370,249371,1,2,0
71459,4,2,249373,249373,249375,0,2,2
71460,2,1,249375,249375,249376,0,1,0
71461,6,2,249381,249381,249383,0,2,5
71462,3,2,249384,249384,249386,0,2,1
71463,6,1,249390,249390,249391,0,1,4
71464,3,3,249393,249393,249396,0,3,2
71465,2,3,249395,249396,249399,1,4,0
71466,2,3,249397,249399,249402,2,5,0
71467,6,1,249403,249403,249404,0,1,1
71468,6,2,249409,249409,249411,0,2,5
71469,4,1,249413,249413,249414,0,1,2
71470,3,2,249416,249416,249418,0,2,2
71471,5,3,249421,249421,249424,0,3,3
71472,1,3,249422,249424,249427,2,5,0
71473,6,3,249428,249428,249431,0,3,1
71474,5,3,249433,249433,249436,0,3,2
71475,3,1,249436,249436,249437,0,1,0
71476,6,2,249442,249442,249444,0,2,5
71477,1,2,249443,249444,249446,1,3,0
71478,5,3,249448,249448,249451,0,3,2
71479,1,1,249449,249451,249452,2,3,0
71480,5,3,249454,249454,249457,0,3,2
71481,4,1,249458,249458,249459,0,1,1
71482,2,2,249460,249460,249462,0,2,1
71483,1,1,249461,249462,249463,1,2,0
71484,6,1,249467,249467,249468,0,1,4
71485,6,3,249473,249473,249476,0,3,5
71486,1,3,249474,249476,249479,2,5,0
71487,2,1,249476,249479,249480,3,4,0
71488,5,1,249481,249481,249482,0,1,1
71489,5,1,249486,249486,249487,0,1,4
71490,2,2,249488,249488,249490,0,2,1
71491,2,1,249490,249490,249491,0,1,0
71492,6,1,249496,249496,249497,0,1,5
71493,1,1,249497,249497,249498,0,1,0
71494,2,1,249499,249499,249500,0,1,1
71495,4,1,249503,249503,249504,0,1,3
71496,3,1,249506,249506,249507,0,1,2
71497,3,1,249509,249509,249510,0,1,2
71498,4,2,249513,249513,249515,0,2,3
71499,1,3,249514,249515,249518,1,4,0
71500,1,2,249515,249518,249520,3,5,0
71501,3,3,249518,249520,249523,2,5,0
71502,5,3,249523,249523,249526,0,3,0
71503,6,2,249529,249529,249531,0,2,3
71504,3,1,249532,249532,249533,0,1,1
71505,6,3,249538,249538,249541,0,3,5
71506,5,2,249543,249543,249545,0,2,2
71507,6,1,249549,249549,249550,0,1,4
71508,1,3,249550,249550,249553,0,3,0
71509,1,1,249551,249553,249554,2,3,0
71510,6,3,249557,249557,249560,0,3,3
71511,2,3,249559,249560,249563,1,4,0
71512,4,1,249563,249563,249564,0,1,0
71513,4,3,249567,249567,249570,0,3,3
71514,6,1,249573,249573,249574,0,1,3
71515,1,3,249574,249574,249577,0,3,0
71516,1,2,249575,249577,249579,2,4,0
71517,3,2,249578,249579,249581,1,3,0
71518,5,2,249583,249583,249585,0,2,2
71519,4,2,249587,249587,249589,0,2,2
71520,5,2,249592,249592,249594,0,2,3
71521,2,3,249594,249594,249597,0,3,0
71522,3,2,249597,249597,249599,0,2,0
71523,1,3,249598,249599,249602,1,4,0
71524,4,1,249602,249602,249603,0,1,0
71525,5,1,249607,249607,249608,0,1,4
71526,6,1,249613,249613,249614,0,1,5
71527,5,1,249618,249618,249619,0,1,4
71528,3,1,249621,249621,249622,0,1,2
71529,6,3,249627,249627,249630,0,3,5
71530,4,3,249631,249631,249634,0,3,1
71531,2,2,249633,249634,249636,1,3,0
71532,6,1,249639,249639,249640,0,1,3
71533,6,2,249645,249645,249647,0,2,5
71534,4,3,249649,249649,249652,0,3,2
71535,2,3,249651,249652,249655,1,4,0
71536,6,2,249657,249657,249659,0,2,2
71537,1,3,249658,249659,249662,1,4,0
71538,3,3,249661,249662,249665,1,4,0
71539,6,1,249667,249667,249668,0,1,2
71540,6,3,249673,249673,249676,0,3,5
71541,2,2,249675,249676,249678,1,3,0
71542,1,2,249676,249678,249680,2,4,0
71543,4,1,249680,249680,249681,0,1,0
71544,6,3,249686,249686,249689,0,3,5
71545,2,3,249688,249689,249692,1,4,0
71546,2,3,249690,249692,249695,2,5,0
71547,5,2,249695,249695,249697,0,2,0
71548,5,2,249700,249700,249702,0,2,3
71549,3,1,249703,249703,249704,0,1,1
71550,6,2,249709,249709,249711,0,2,5
71551,5,1,249714,249714,249715,0,1,3
71552,3,2,249717,249717,249719,0,2,2
71553,1,3,249718,249719,249722,1,4,0
71554,2,2,249720,249722,249724,2,4,0
71555,1,3,249721,249724,249727,3,6,0
71556,5,3,249726,249727,249730,1,4,0
71557,4,1,249730,249730,249731,0,1,0
71558,2,2,249732,249732,249734,0,2,1
71559,5,1,249737,249737,249738,0,1,3
71560,4,2,249741,249741,249743,0,2,3
71561,6,1,249747,249747,249748,0,1,4
71562,2,1,249749,249749,249750,0,1,1
71563,5,1,249754,249754,249755,0,1,4
71564,5,1,249759,249759,249760,0,1,4
71565,5,1,249764,249764,249765,0,1,4
71566,5,2,249769,249769,249771,0,2,4
71567,6,2,249775,249775,249777,0,2,4
71568,5,1,249780,249780,249781,0,1,3
71569,5,2,249785,249785,249787,0,2,4
71570,5,1,249790,249790,249791,0,1,3
71571,2,1,249792,249792,249793,0,1,1
71572,5,1,249797,249797,249798,0,1,4
71573,6,2,249803,249803,249805,0,2,5
71574,6,3,249809,249809,249812,0,3,4
71575,4,3,249813,249813,249816,0,3,1
71576,2,2,249815,249816,249818,1,3,0
71577,4,3,249819,249819,249822,0,3,1
71578,2,2,249821,249822,249824,1,3,0
71579,1,2,249822,249824,249826,2,4,0
71580,1,1,249823,249826,249827,3,4,0
71581,3,1,249826,249827,249828,1,2,0
71582,3,3,249829,249829,249832,0,3,1
71583,2,3,249831,249832,249835,1,4,0
71584,5,3,249836,249836,249839,0,3,1
71585,1,2,249837,249839,249841,2,4,0
71586,2,3,249839,249841,249844,2,5,0
71587,4,3,249843,249844,249847,1,4,0
71588,6,2,249849,249849,249851,0,2,2
71589,5,3,249854,249854,249857,0,3,3
71590,5,3,249859,249859,249862,0,3,2
71591,2,1,249861,249862,249863,1,2,0
71592,1,2,249862,249863,249865,1,3,0
71593,4,1,249866,249866,249867,0,1,1
71594,5,3,249871,249871,249874,0,3,4
71595,1,2,249872,249874,249876,2,4,0
71596,2,2,249874,249876,249878,2,4,0
71597,3,1,249877,249878,249879,1,2,0
71598,6,1,249883,249883,249884,0,1,4
71599,1,1,249884,249884,249885,0,1,0
71600,1,3,249885,249885,249888,0,3,0
71601,1,2,249886,249888,249890,2,4,0
71602,6,3,249892,249892,249895,0,3,2
71603,6,1,249898,249898,249899,0,1,3
71604,3,3,249901,249901,249904,0,3,2
71605,6,1,249907,249907,249908,0,1,3
71606,1,3,249908,249908,249911,0,3,0
71607,4,1,249912,249912,249913,0,1,1
71608,6,3,249918,249918,249921,0,3,5
71609,2,3,249920,249921,249924,1,4,0
71610,2,1,249922,249924,249925,2,3,0
71611,5,2,249927,249927,249929,0,2,2
71612,1,3,249928,249929,249932,1,4,0
71613,5,2,249933,249933,249935,0,2,1
71614,2,2,249935,249935,249937,0,2,0
71615,3,2,249938,249938,249940,0,2,1
71616,5,1,249943,249943,249944,0,1,3
71617,5,2,249948,249948,249950,0,2,4
71618,2,3,249950,249950,249953,0,3,0
71619,5,1,249955,249955,249956,0,1,2
71620,4,3,249959,249959,249962,0,3,3
71621,1,1,249960,249962,249963,2,3,0
71622,5,2,249965,249965,249967,0,2,2
71623,6,1,249971,249971,249972,0,1,4
71624,5,3,249976,249976,249979,0,3,4
71625,4,2,249980,249980,249982,0,2,1
71626,3,2,249983,249983,249985,0,2,1
71627,3,2,249986,249986,249988,0,2,1
71628,2,1,249988,249988,249989,0,1,0
71629,6,2,249994,249994,249996,0,2,5
71630,2,3,249996,249996,249999,0,3,0
71631,6,2,250002,250002,250004,0,2,3
71632,5,3,250007,250007,250010,0,3,3
71633,2,1,250009,250010,250011,1,2,0
71634,2,3,250011,250011,250014,0,3,0
71635,1,2,250012,250014,250016,2,4,0
71636,1,2,250013,250016,250018,3,5,0
71637,1,2,250014,250018,250020,4,6,0
71638,6,3,250020,250020,250023,0,3,0
71639,1,3,250021,250023,250026,2,5,0
71640,6,3,250027,250027,250030,0,3,1
71641,4,2,250031,250031,250033,0,2,1
71642,2,2,250033,250033,250035,0,2,0
71643,4,1,250037,250037,250038,0,1,2
71644,5,3,250042,250042,250045,0,3,4
71645,4,1,250046,250046,250047,0,1,1
71646,5,3,250051,250051,250054,0,3,4
71647,2,2,250053,250054,250056,1,3,0
71648,6,1,250059,250059,250060,0,1,3
71649,5,1,250064,250064,250065,0,1,4
71650,6,3,250070,250070,250073,0,3,5
71651,3,3,250073,250073,250076,0,3,0
71652,5,1,250078,250078,250079,0,1,2
71653,4,2,250082,250082,250084,0,2,3
71654,5,1,250087,250087,250088,0,1,3
71655,6,1,250093,250093,250094,0,1,5
71656,5,2,250098,250098,250100,0,2,4
71657,4,1,250102,250102,250103,0,1,2
71658,2,1,250104,250104,250105,0,1,1
71659,1,1,250105,250105,250106,0,1,0
71660,3,1,250108,250108,250109,0,1,2
71661,6,2,250114,250114,250116,0,2,5
71662,3,2,250117,250117,250119,0,2,1
71663,5,2,250122,250122,250124,0,2,3
71664,4,1,250126,250126,250127,0,1,2
71665,3,2,250129,250129,250131,0,2,2
71666,2,3,250131,250131,250134,0,3,0
71667,5,1,250136,250136,250137,0,1,2
71668,5,2,250141,250141,250143,0,2,4
71669,1,1,250142,250143,250144,1,2,0
71670,6,1,250148,250148,250149,0,1,4
71671,3,2,250151,250151,250153,0,2,2
71672,1,2,250152,250153,250155,1,3,0
71673,6,3,250158,250158,250161,0,3,3
71674,4,1,250162,250162,250163,0,1,1
71675,2,3,250164,250164,250167,0,3,1
71676,3,3,250167,250167,250170,0,3,0
71677,1,1,250168,250170,250171,2,3,0
71678,6,3,250174,250174,250177,0,3,3
71679,3,3,250177,250177,250180,0,3,0
71680,4,3,250181,250181,250184,0,3,1
71681,5,3,250186,250186,250189,0,3,2
71682,6,3,250192,250192,250195,0,3,3
71683,6,1,250198,250198,250199,0,1,3
71684,4,2,250202,250202,250204,0,2,3
71685,3,2,250205,250205,250207,0,2,1
71686,6,3,250211,250211,250214,0,3,4
71687,3,3,250214,250214,250217,0,3,0
71688,4,2,250218,250218,250220,0,2,1
71689,2,2,250220,250220,250222,0,2,0
71690,1,1,250221,250222,250223,1,2,0
71691,5,3,250226,250226,250229,0,3,3
71692,6,1,250232,250232,250233,0,1,3
71693,5,2,250237,250237,250239,0,2,4
71694,6,1,250243,250243,250244,0,1,4
71695,3,2,250246,250246,250248,0,2,2
71696,6,3,250252,250252,250255,0,3,4
71697,1,3,250253,250255,250258,2,5,0
71698,1,2,250254,250258,250260,4,6,0
71699,2,3,250256,250260,250263,4,7,0
71700,6,3,250262,250263,250266,1,4,0
71701,1,3,250263,250266,250269,3,6,0
71702,1,1,250264,250269,250270,5,6,0
71703,2,3,250266,250270,250273,4,7,0
71704,3,1,250269,250273,250274,4,5,0
71705,2,3,250271,250274,250277,3,6,0
71706,6,2,250277,250277,250279,0,2,0
71707,2,3,250279,250279,250282,0,3,0
71708,4,2,250283,250283,250285,0,2,1
71709,3,2,250286,250286,250288,0,2,1
71710,2,1,250288,250288,250289,0,1,0
71711,2,1,250290,250290,250291,0,1,1
71712,4,3,250294,250294,250297,0,3,3
71713,4,3,250298,250298,250301,0,3,1
71714,5,3,250303,250303,250306,0,3,2
71715,4,3,250307,250307,250310,0,3,1
71716,4,1,250311,250311,250312,0,1,1
71717,1,1,250312,250312,250313,0,1,0
71718,4,1,250316,250316,250317,0,1,3
71719,2,1,250318,250318,250319,0,1,1
71720,2,2,250320,250320,250322,0,2,1
71721,4,1,250324,250324,250325,0,1,2
71722,6,3,250330,250330,250333,0,3,5
71723,4,3,250334,250334,250337,0,3,1
71724,2,3,250336,250337,250340,1,4,0
71725,1,2,250337,250340,250342,3,5,0
71726,2,1,250339,250342,250343,3,4,0
71727,6,1,250345,250345,250346,0,1,2
71728,2,2,250347,250347,250349,0,2,1
71729,6,3,250353,250353,250356,0,3,4
71730,6,3,250359,250359,250362,0,3,3
71731,2,2,250361,250362,250364,1,3,0
71732,5,2,250366,250366,250368,0,2,2
71733,5,1,250371,250371,250372,0,1,3
71734,1,2,250372,250372,250374,0,2,0
71735,2,3,250374,250374,250377,0,3,0
71736,5,3,250379,250379,250382,0,3,2
71737,4,3,250383,250383,250386,0,3,1
71738,5,2,250388,250388,250390,0,2,2
71739,5,3,250393,250393,250396,0,3,3
71740,1,2,250394,250396,250398,2,4,0
71741,4,1,250398,250398,250399,0,1,0
71742,5,1,250403,250403,250404,0,1,4
71743,4,1,250407,250407,250408,0,1,3
71744,4,3,250411,250411,250414,0,3,3
71745,4,2,250415,250415,250417,0,2,1
71746,4,2,250419,250419,250421,0,2,2
71747,1,1,250420,250421,250422,1,2,0
71748,6,2,250426,250426,250428,0,2,4
71749,1,2,250427,250428,250430,1,3,0
71750,4,3,250431,250431,250434,0,3,1
71751,5,2,250436,250436,250438,0,2,2
71752,6,1,250442,250442,250443,0,1,4
71753,1,2,250443,250443,250445,0,2,0
71754,6,3,250449,250449,250452,0,3,4
71755,4,2,250453,250453,250455,0,2,1
71756,6,2,250459,250459,250461,0,2,4
71757,3,3,250462,250462,250465,0,3,1
71758,3,2,250465,250465,250467,0,2,0
71759,4,1,250469,250469,250470,0,1,2
71760,3,1,250472,250472,250473,0,1,2
71761,6,1,250478,250478,250479,0,1,5
71762,1,2,250479,250479,250481,0,2,0
71763,2,1,250481,250481,250482,0,1,0
71764,3,1,250484,250484,250485,0,1,2
71765,2,1,250486,250486,250487,0,1,1
71766,5,2,250491,250491,250493,0,2,4
71767,5,1,250496,250496,250497,0,1,3
71768,2,1,250498,250498,250499,0,1,1
71769,6,1,250504,250504,250505,0,1,5
71770,5,3,250509,250509,250512,0,3,4
71771,4,1,250513,250513,250514,0,1,1
71772,4,2,250517,250517,250519,0,2,3
71773,1,1,250518,250519,250520,1,2,0
71774,1,2,250519,250520,250522,1,3,0
71775,5,3,250524,250524,250527,0,3,2
71776,2,2,250526,250527,250529,1,3,0
71777,3,1,250529,250529,250530,0,1,0
71778,3,2,250532,250532,250534,0,2,2
71779,1,3,250533,250534,250537,1,4,0
71780,2,3,250535,250537,250540,2,5,0
71781,2,1,250537,250540,250541,3,4,0
71782,5,2,250542,250542,250544,0,2,1
71783,6,3,250548,250548,250551,0,3,4
71784,4,1,250552,250552,250553,0,1,1
71785,6,1,250558,250558,250559,0,1,5
71786,2,2,250560,250560,250562,0,2,1
71787,2,1,250562,250562,250563,0,1,0
71788,3,1,250565,250565,250566,0,1,2
71789,2,1,250567,250567,250568,0,1,1
71790,1,2,250568,250568,250570,0,2,0
71791,3,2,250571,250571,250573,0,2,1
71792,5,1,250576,250576,250577,0,1,3
71793,4,1,250580,250580,250581,0,1,3
71794,5,3,250585,250585,250588,0,3,4
71795,1,3,250586,250588,250591,2,5,0
71796,1,1,250587,250591,250592,4,5,0
71797,3,2,250590,250592,250594,2,4,0
71798,5,2,250595,250595,250597,0,2,1
71799,2,2,250597,250597,250599,0,2,0
71800,6,2,250603,250603,250605,0,2,4
71801,4,1,250607,250607,250608,0,1,2
71802,1,2,250608,250608,250610,0,2,0
71803,3,1,250611,250611,250612,0,1,1
71804,5,1,250616,250616,250617,0,1,4
71805,1,2,250617,250617,250619,0,2,0
71806,2,2,250619,250619,250621,0,2,0
71807,5,1,250624,250624,250625,0,1,3
71808,2,2,250626,250626,250628,0,2,1
71809,1,2,250627,250628,250630,1,3,0
71810,5,1,250632,250632,250633,0,1,2
71811,5,3,250637,250637,250640,0,3,4
71812,2,3,250639,250640,250643,1,4,0
71813,5,1,250644,250644,250645,0,1,1
71814,5,1,250649,250649,250650,0,1,4
71815,6,1,250655,250655,250656,0,1,5
71816,2,2,250657,250657,250659,0,2,1
71817,6,2,250663,250663,250665,0,2,4
71818,2,2,250665,250665,250667,0,2,0
71819,4,3,250669,250669,250672,0,3,2
71820,1,1,250670,250672,250673,2,3,0
71821,1,1,250671,250673,250674,2,3,0
71822,3,1,250674,250674,250675,0,1,0
71823,1,2,250675,250675,250677,0,2,0
71824,5,3,250680,250680,250683,0,3,3
71825,3,1,250683,250683,250684,0,1,0
71826,6,1,250689,250689,250690,0,1,5
71827,4,2,250693,250693,250695,0,2,3
71828,2,1,250695,250695,250696,0,1,0
71829,6,3,250701,250701,250704,0,3,5
71830,5,3,250706,250706,250709,0,3,2
71831,3,2,250709,250709,250711,0,2,0
71832,6,3,250715,250715,250718,0,3,4
71833,2,1,250717,250718,250719,1,2,0
71834,1,1,250718,250719,250720,1,2,0
71835,6,3,250724,250724,250727,0,3,4
71836,3,2,250727,250727,250729,0,2,0
71837,3,2,250730,250730,250732,0,2,1
71838,1,3,250731,250732,250735,1,4,0
71839,5,1,250736,250736,250737,0,1,1
71840,3,1,250739,250739,250740,0,1,2
71841,3,3,250742,250742,250745,0,3,2
71842,5,2,250747,250747,250749,0,2,2
71843,5,1,250752,250752,250753,0,1,3
71844,2,1,250754,250754,250755,0,1,1
71845,3,2,250757,250757,250759,0,2,2
71846,3,1,250760,250760,250761,0,1,1
71847,6,3,250766,250766,250769,0,3,5
71848,3,1,250769,250769,250770,0,1,0
71849,1,3,250770,250770,250773,0,3,0
71850,1,3,250771,250773,250776,2,5,0
71851,5,3,250776,250776,250779,0,3,0
71852,4,2,250780,250780,250782,0,2,1
71853,4,3,250784,250784,250787,0,3,2
71854,1,3,250785,250787,250790,2,5,0
71855,2,2,250787,250790,250792,3,5,0
71856,2,1,250789,250792,250793,3,4,0
71857,2,2,250791,250793,250795,2,4,0
71858,2,1,250793,250795,250796,2,3,0
71859,4,3,250797,250797,250800,0,3,1
71860,4,1,250801,250801,250802,0,1,1
71861,5,3,250806,250806,250809,0,3,4
71862,1,2,250807,250809,250811,2,4,0
71863,1,3,250808,250811,250814,3,6,0
71864,3,3,250811,250814,250817,3,6,0
71865,4,2,250815,250817,250819,2,4,0
71866,4,2,250819,250819,250821,0,2,0
71867,4,2,250823,250823,250825,0,2,2
71868,6,3,250829,250829,250832,0,3,4
71869,5,3,250834,250834,250837,0,3,2
71870,2,2,250836,250837,250839,1,3,0
71871,5,2,250841,250841,250843,0,2,2
71872,6,2,250847,250847,250849,0,2,4
71873,1,3,250848,250849,250852,1,4,0
71874,1,2,250849,250852,250854,3,5,0
71875,3,1,250852,250854,250855,2,3,0
71876,2,3,250854,250855,250858,1,4,0
71877,1,1,250855,250858,250859,3,4,0
71878,6,2,250861,250861,250863,0,2,2
71879,5,2,250866,250866,250868,0,2,3
71880,6,2,250872,250872,250874,0,2,4
71881,3,2,250875,250875,250877,0,2,1
71882,6,3,250881,250881,250884,0,3,4
71883,2,2,250883,250884,250886,1,3,0
71884,4,2,250887,250887,250889,0,2,1
71885,2,2,250889,250889,250891,0,2,0
71886,5,3,250894,250894,250897,0,3,3
71887,6,3,250900,250900,250903,0,3,3
71888,1,1,250901,250903,250904,2,3,0
71889,5,1,250906,250906,250907,0,1,2
71890,4,3,250910,250910,250913,0,3,3
71891,1,1,250911,250913,250914,2,3,0
71892,1,1,250912,250914,250915,2,3,0
71893,6,2,250918,250918,250920,0,2,3
71894,4,2,250922,250922,250924,0,2,2
71895,5,3,250927,250927,250930,0,3,3
71896,5,2,250932,250932,250934,0,2,2
71897,4,3,250936,250936,250939,0,3,2
71898,5,2,250941,250941,250943,0,2,2
71899,4,1,250945,250945,250946,0,1,2
71900,4,3,250949,250949,250952,0,3,3
71901,6,2,250955,250955,250957,0,2,3
71902,6,2,250961,250961,250963,0,2,4
71903,6,3,250967,250967,250970,0,3,4
71904,4,3,250971,250971,250974,0,3,1
71905,2,1,250973,250974,250975,1,2,0
71906,1,2,250974,250975,250977,1,3,0
71907,1,3,250975,250977,250980,2,5,0
71908,3,3,250978,250980,250983,2,5,0
71909,6,2,250984,250984,250986,0,2,1
71910,5,1,250989,250989,250990,0,1,3
71911,6,1,250995,250995,250996,0,1,5
71912,1,2,250996,250996,250998,0,2,0
71913,4,3,251000,251000,251003,0,3,2
71914,1,3,251001,251003,251006,2,5,0
71915,6,2,251007,251007,251009,0,2,1
71916,5,3,251012,251012,251015,0,3,3
71917,6,1,251018,251018,251019,0,1,3
71918,3,1,251021,251021,251022,0,1,2
71919,5,2,251026,251026,251028,0,2,4
71920,5,1,251031,251031,251032,0,1,3
71921,4,2,251035,251035,251037,0,2,3
71922,1,1,251036,251037,251038,1,2,0
71923,2,2,251038,251038,251040,0,2,0
71924,2,3,251040,251040,251043,0,3,0
71925,1,2,251041,251043,251045,2,4,0
71926,5,2,251046,251046,251048,0,2,1
71927,1,2,251047,251048,251050,1,3,0
71928,5,3,251052,251052,251055,0,3,2
71929,3,2,251055,251055,251057,0,2,0
71930,3,2,251058,251058,251060,0,2,1
71931,6,1,251064,251064,251065,0,1,4
71932,5,1,251069,251069,251070,0,1,4
71933,6,1,251075,251075,251076,0,1,5
71934,5,3,251080,251080,251083,0,3,4
71935,2,1,251082,251083,251084,1,2,0
71936,6,2,251088,251088,251090,0,2,4
71937,2,1,251090,251090,251091,0,1,0
71938,2,3,251092,251092,251095,0,3,1
71939,6,2,251098,251098,251100,0,2,3
71940,5,3,251103,251103,251106,0,3,3
71941,3,3,251106,251106,251109,0,3,0
71942,4,2,251110,251110,251112,0,2,1
71943,6,1,251116,251116,251117,0,1,4
71944,4,2,251120,251120,251122,0,2,3
71945,6,1,251126,251126,251127,0,1,4
71946,2,3,251128,251128,251131,0,3,1
71947,3,2,251131,251131,251133,0,2,0
71948,2,1,251133,251133,251134,0,1,0
71949,2,1,251135,251135,251136,0,1,1
71950,1,3,251136,251136,251139,0,3,0
71951,6,1,251142,251142,251143,0,1,3
71952,1,1,251143,251143,251144,0,1,0
71953,5,2,251148,251148,251150,0,2,4
71954,1,3,251149,251150,251153,1,4,0
71955,2,3,251151,251153,251156,2,5,0
71956,2,3,251153,251156,251159,3,6,0
71957,6,2,251159,251159,251161,0,2,0
71958,2,3,251161,251161,251164,0,3,0
71959,4,2,251165,251165,251167,0,2,1
71960,2,3,251167,251167,251170,0,3,0
71961,2,2,251169,251170,251172,1,3,0
71962,1,2,251170,251172,251174,2,4,0
71963,4,1,251174,251174,251175,0,1,0
71964,2,2,251176,251176,251178,0,2,1
71965,6,3,251182,251182,251185,0,3,4
71966,4,2,251186,251186,251188,0,2,1
71967,4,3,251190,251190,251193,0,3,2
71968,4,1,251194,251194,251195,0,1,1
71969,6,1,251200,251200,251201,0,1,5
71970,5,1,251205,251205,251206,0,1,4
71971,1,2,251206,251206,251208,0,2,0
71972,1,1,251207,251208,251209,1,2,0
71973,2,1,251209,251209,251210,0,1,0
71974,6,2,251215,251215,251217,0,2,5
71975,4,3,251219,251219,251222,0,3,2
71976,1,2,251220,251222,251224,2,4,0
71977,6,2,251226,251226,251228,0,2,2
71978,5,2,251231,251231,251233,0,2,3
71979,4,2,251235,251235,251237,0,2,2
71980,3,2,251238,251238,251240,0,2,1
71981,1,2,251239,251240,251242,1,3,0
71982,1,3,251240,251242,251245,2,5,0
71983,6,1,251246,251246,251247,0,1,1
71984,3,2,251249,251249,251251,0,2,2
71985,3,1,251252,251252,251253,0,1,1
71986,1,3,251253,251253,251256,0,3,0
71987,2,1,251255,251256,251257,1,2,0
71988,3,1,251258,251258,251259,0,1,1
71989,4,3,251262,251262,251265,0,3,3
71990,2,1,251264,251265,251266,1,2,0
71991,5,1,251269,251269,251270,0,1,3
71992,2,1,251271,251271,251272,0,1,1
71993,5,1,251276,251276,251277,0,1,4
71994,1,1,251277,251277,251278,0,1,0
71995,6,3,251283,251283,251286,0,3,5
71996,4,3,251287,251287,251290,0,3,1
71997,3,2,251290,251290,251292,0,2,0
71998,5,1,251295,251295,251296,0,1,3
71999,3,1,251298,251298,251299,0,1,2
72000,4,2,251302,251302,251304,0,2,3
72001,6,3,251308,251308,251311,0,3,4
72002,3,3,251311,251311,251314,0,3,0
72003,6,3,251317,251317,251320,0,3,3
72004,2,3,251319,251320,251323,1,4,0
72005,4,1,251323,251323,251324,0,1,0
72006,3,2,251326,251326,251328,0,2,2
72007,1,2,251327,251328,251330,1,3,0
72008,4,2,251331,251331,251333,0,2,1
72009,5,2,251336,251336,251338,0,2,3
72010,5,1,251341,251341,251342,0,1,3
72011,4,1,251345,251345,251346,0,1,3
72012,4,1,251349,251349,251350,0,1,3
72013,4,1,251353,251353,251354,0,1,3
72014,3,1,251356,251356,251357,0,1,2
72015,3,3,251359,251359,251362,0,3,2
72016,5,1,251364,251364,251365,0,1,2
72017,5,3,251369,251369,251372,0,3,4
72018,6,3,251375,251375,251378,0,3,3
72019,4,3,251379,251379,251382,0,3,1
72020,3,2,251382,251382,251384,0,2,0
72021,5,3,251387,251387,251390,0,3,3
72022,5,1,251392,251392,251393,0,1,2
72023,2,1,251394,251394,251395,0,1,1
72024,4,3,251398,251398,251401,0,3,3
72025,1,3,251399,251401,251404,2,5,0
72026,2,2,251401,251404,251406,3,5,0
72027,3,2,251404,251406,251408,2,4,0
72028,6,3,251410,251410,251413,0,3,2
72029,3,2,251413,251413,251415,0,2,0
72030,3,1,251416,251416,251417,0,1,1
72031,5,3,251421,251421,251424,0,3,4
72032,1,2,251422,251424,251426,2,4,0
72033,4,1,251426,251426,251427,0,1,0
72034,2,2,251428,251428,251430,0,2,1
72035,4,3,251432,251432,251435,0,3,2
72036,5,3,251437,251437,251440,0,3,2
72037,1,1,251438,251440,251441,2,3,0
72038,4,2,251442,251442,251444,0,2,1
72039,6,3,251448,251448,251451,0,3,4
72040,5,2,251453,251453,251455,0,2,2
72041,4,3,251457,251457,251460,0,3,2
72042,5,1,251462,251462,251463,0,1,2
72043,4,3,251466,251466,251469,0,3,3
72044,5,3,251471,251471,251474,0,3,2
72045,6,2,251477,251477,251479,0,2,3
72046,4,2,251481,251481,251483,0,2,2
72047,2,3,251483,251483,251486,0,3,0
72048,6,3,251489,251489,251492,0,3,3
72049,4,2,251493,251493,251495,0,2,1
72050,6,1,251499,251499,251500,0,1,4
72051,5,1,251504,251504,251505,0,1,4
72052,6,3,251510,251510,251513,0,3,5
72053,5,3,251515,251515,251518,0,3,2
72054,5,2,251520,251520,251522,0,2,2
72055,1,1,251521,251522,251523,1,2,0
72056,1,2,251522,251523,251525,1,3,0
72057,3,2,251525,251525,251527,0,2,0
72058,6,1,251531,251531,251532,0,1,4
72059,4,2,251535,251535,251537,0,2,3
72060,2,3,251537,251537,251540,0,3,0
72061,2,3,251539,251540,251543,1,4,0
72062,4,1,251543,251543,251544,0,1,0
72063,1,3,251544,251544,251547,0,3,0
72064,1,3,251545,251547,251550,2,5,0
72065,5,3,251550,251550,251553,0,3,0
72066,6,3,251556,251556,251559,0,3,3
72067,6,1,251562,251562,251563,0,1,3
72068,2,3,251564,251564,251567,0,3,1
72069,6,3,251570,251570,251573,0,3,3
72070,2,3,251572,251573,251576,1,4,0
72071,2,2,251574,251576,251578,2,4,0
72072,1,3,251575,251578,251581,3,6,0
72073,4,3,251579,251581,251584,2,5,0
72074,3,2,251582,251584,251586,2,4,0
72075,2,3,251584,251586,251589,2,5,0
72076,6,1,251590,251590,251591,0,1,1
72077,6,1,251596,251596,251597,0,1,5
72078,2,2,251598,251598,251600,0,2,1
72079,2,1,251600,251600,251601,0,1,0
72080,4,1,251604,251604,251605,0,1,3
72081,4,1,251608,251608,251609,0,1,3
72082,6,2,251614,251614,251616,0,2,5
72083,3,3,251617,251617,251620,0,3,1
72084,3,2,251620,251620,251622,0,2,0
72085,3,1,251623,251623,251624,0,1,1
72086,4,1,251627,251627,251628,0,1,3
72087,3,3,251630,251630,251633,0,3,2
72088,2,2,251632,251633,251635,1,3,0
72089,6,3,251638,251638,251641,0,3,3
72090,3,3,251641,251641,251644,0,3,0
72091,2,3,251643,251644,251647,1,4,0
72092,3,1,251646,251647,251648,1,2,0
72093,5,1,251651,251651,251652,0,1,3
72094,6,3,251657,251657,251660,0,3,5
72095,5,2,251662,251662,251664,0,2,2
72096,4,1,251666,251666,251667,0,1,2
72097,4,2,251670,251670,251672,0,2,3
72098,2,2,251672,251672,251674,0,2,0
72099,6,2,251678,251678,251680,0,2,4
72100,1,1,251679,251680,251681,1,2,0
72101,1,2,251680,251681,251683,1,3,0
72102,4,2,251684,251684,251686,0,2,1
72103,5,2,251689,251689,251691,0,2,3
72104,6,1,251695,251695,251696,0,1,4
72105,1,3,251696,251696,251699,0,3,0
72106,3,3,251699,251699,251702,0,3,0
72107,6,3,251705,251705,251708,0,3,3
72108,1,1,251706,251708,251709,2,3,0
72109,1,3,251707,251709,251712,2,5,0
72110,3,3,251710,251712,251715,2,5,0
72111,6,3,251716,251716,251719,0,3,1
72112,6,1,251722,251722,251723,0,1,3
72113,4,3,251726,251726,251729,0,3,3
72114,5,2,251731,251731,251733,0,2,2
72115,4,3,251735,251735,251738,0,3,2
72116,4,3,251739,251739,251742,0,3,1
72117,4,2,251743,251743,251745,0,2,1
72118,5,1,251748,251748,251749,0,1,3
72119,3,3,251751,251751,251754,0,3,2
72120,5,3,251756,251756,251759,0,3,2
72121,4,3,251760,251760,251763,0,3,1
72122,3,1,251763,251763,251764,0,1,0
72123,2,2,251765,251765,251767,0,2,1
72124,2,2,251767,251767,251769,0,2,0
72125,3,1,251770,251770,251771,0,1,1
72126,6,1,251776,251776,251777,0,1,5
72127,3,2,251779,251779,251781,0,2,2
72128,3,2,251782,251782,251784,0,2,1
72129,5,1,251787,251787,251788,0,1,3
72130,2,2,251789,251789,251791,0,2,1
72131,5,2,251794,251794,251796,0,2,3
72132,6,2,251800,251800,251802,0,2,4
72133,2,3,251802,251802,251805,0,3,0
72134,2,3,251804,251805,251808,1,4,0
72135,6,1,251810,251810,251811,0,1,2
72136,4,1,251814,251814,251815,0,1,3
72137,4,2,251818,251818,251820,0,2,3
72138,4,1,251822,251822,251823,0,1,2
72139,5,2,251827,251827,251829,0,2,4
72140,5,3,251832,251832,251835,0,3,3
72141,5,2,251837,251837,251839,0,2,2
72142,2,2,251839,251839,251841,0,2,0
72143,1,2,251840,251841,251843,1,3,0
72144,2,3,251842,251843,251846,1,4,0
72145,1,2,251843,251846,251848,3,5,0
72146,5,3,251848,251848,251851,0,3,0
72147,4,1,251852,251852,251853,0,1,1
72148,5,3,251857,251857,251860,0,3,4
72149,5,3,251862,251862,251865,0,3,2
72150,5,2,251867,251867,251869,0,2,2
72151,1,1,251868,251869,251870,1,2,0
72152,1,2,251869,251870,251872,1,3,0
72153,4,2,251873,251873,251875,0,2,1
72154,6,1,251879,251879,251880,0,1,4
72155,1,1,251880,251880,251881,0,1,0
72156,6,3,251886,251886,251889,0,3,5
72157,3,2,251889,251889,251891,0,2,0
72158,4,1,251893,251893,251894,0,1,2
72159,1,1,251894,251894,251895,0,1,0
72160,4,3,251898,251898,251901,0,3,3
72161,3,3,251901,251901,251904,0,3,0
72162,1,3,251902,251904,251907,2,5,0
72163,4,1,251906,251907,251908,1,2,0
72164,3,3,251909,251909,251912,0,3,1
72165,3,2,251912,251912,251914,0,2,0
72166,5,3,251917,251917,251920,0,3,3
72167,5,2,251922,251922,251924,0,2,2
72168,6,2,251928,251928,251930,0,2,4
72169,1,1,251929,251930,251931,1,2,0
72170,2,1,251931,251931,251932,0,1,0
72171,3,1,251934,251934,251935,0,1,2
72172,1,3,251935,251935,251938,0,3,0
72173,1,3,251936,251938,251941,2,5,0
72174,5,2,251941,251941,251943,0,2,0
72175,6,2,251947,251947,251949,0,2,4
72176,1,3,251948,251949,251952,1,4,0
72177,5,2,251953,251953,251955,0,2,1
72178,1,2,251954,251955,251957,1,3,0
72179,5,1,251959,251959,251960,0,1,2
72180,1,3,251960,251960,251963,0,3,0
72181,1,1,251961,251963,251964,2,3,0
72182,6,2,251967,251967,251969,0,2,3
72183,5,1,251972,251972,251973,0,1,3
72184,2,3,251974,251974,251977,0,3,1
72185,6,3,251980,251980,251983,0,3,3
72186,2,1,251982,251983,251984,1,2,0
72187,4,3,251986,251986,251989,0,3,2
72188,5,2,251991,251991,251993,0,2,2
72189,4,2,251995,251995,251997,0,2,2
72190,4,1,251999,251999,252000,0,1,2
72191,1,2,252000,252000,252002,0,2,0
72192,2,2,252002,252002,252004,0,2,0
72193,6,2,252008,252008,252010,0,2,4
72194,4,3,252012,252012,252015,0,3,2
72195,6,1,252018,252018,252019,0,1,3
72196,4,1,252022,252022,252023,0,1,3
72197,6,3,252028,252028,252031,0,3,5
72198,3,2,252031,252031,252033,0,2,0
72199,4,2,252035,252035,252037,0,2,2
72200,4,1,252039,252039,252040,0,1,2
72201,6,3,252045,252045,252048,0,3,5
72202,4,2,252049,252049,252051,0,2,1
72203,6,2,252055,252055,252057,0,2,4
72204,1,3,252056,252057,252060,1,4,0
72205,2,2,252058,252060,252062,2,4,0
72206,6,2,252064,252064,252066,0,2,2
72207,1,3,252065,252066,252069,1,4,0
72208,6,3,252071,252071,252074,0,3,2
72209,4,1,252075,252075,252076,0,1,1
72210,3,2,252078,252078,252080,0,2,2
72211,1,1,252079,252080,252081,1,2,0
72212,4,2,252083,252083,252085,0,2,2
72213,2,1,252085,252085,252086,0,1,0
72214,6,1,252091,252091,252092,0,1,5
72215,4,2,252095,252095,252097,0,2,3
72216,6,2,252101,252101,252103,0,2,4
72217,3,2,252104,252104,252106,0,2,1
72218,6,2,252110,252110,252112,0,2,4
72219,1,2,252111,252112,252114,1,3,0
72220,1,1,252112,252114,252115,2,3,0
72221,3,2,252115,252115,252117,0,2,0
72222,3,3,252118,252118,252121,0,3,1
72223,3,1,252121,252121,252122,0,1,0
72224,2,2,252123,252123,252125,0,2,1
72225,5,1,252128,252128,252129,0,1,3
72226,3,2,252131,252131,252133,0,2,2
72227,5,3,252136,252136,252139,0,3,3
72228,3,2,252139,252139,252141,0,2,0
72229,2,2,252141,252141,252143,0,2,0
72230,2,1,252143,252143,252144,0,1,0
72231,2,2,252145,252145,252147,0,2,1
72232,3,1,252148,252148,252149,0,1,1
72233,1,2,252149,252149,252151,0,2,0
72234,2,1,252151,252151,252152,0,1,0
72235,3,3,252154,252154,252157,0,3,2
72236,2,3,252156,252157,252160,1,4,0
72237,4,2,252160,252160,252162,0,2,0
72238,4,3,252164,252164,252167,0,3,2
72239,3,3,252167,252167,252170,0,3,0
72240,5,1,252172,252172,252173,0,1,2
72241,6,1,252178,252178,252179,0,1,5
72242,3,1,252181,252181,252182,0,1,2
72243,3,3,252184,252184,252187,0,3,2
72244,3,3,252187,252187,252190,0,3,0
72245,3,3,252190,252190,252193,0,3,0
72246,2,2,252192,252193,252195,1,3,0
72247,6,3,252198,252198,252201,0,3,3
72248,2,1,252200,252201,252202,1,2,0
72249,2,2,252202,252202,252204,0,2,0
72250,3,1,252205,252205,252206,0,1,1
72251,5,2,252210,252210,252212,0,2,4
72252,6,3,252216,252216,252219,0,3,4
72253,2,2,252218,252219,252221,1,3,0
72254,2,1,252220,252221,252222,1,2,0
72255,1,2,252221,252222,252224,1,3,0
72256,4,1,252225,252225,252226,0,1,1
72257,6,1,252231,252231,252232,0,1,5
72258,2,1,252233,252233,252234,0,1,1
72259,5,3,252238,252238,252241,0,3,4
72260,6,3,252244,252244,252247,0,3,3
72261,4,2,252248,252248,252250,0,2,1
72262,2,3,252250,252250,252253,0,3,0
72263,2,2,252252,252253,252255,1,3,0
72264,4,1,252256,252256,252257,0,1,1
72265,4,2,252260,252260,252262,0,2,3
72266,6,2,252266,252266,252268,0,2,4
72267,5,3,252271,252271,252274,0,3,3
72268,2,1,252273,252274,252275,1,2,0
72269,4,1,252277,252277,252278,0,1,2
72270,2,3,252279,252279,252282,0,3,1
72271,3,1,252282,252282,252283,0,1,0
72272,3,2,252285,252285,252287,0,2,2
72273,5,2,252290,252290,252292,0,2,3
72274,3,1,252293,252293,252294,0,1,1
72275,1,2,252294,252294,252296,0,2,0
72276,2,3,252296,252296,252299,0,3,0
72277,2,2,252298,252299,252301,1,3,0
72278,3,2,252301,252301,252303,0,2,0
72279,2,2,252303,252303,252305,0,2,0
72280,3,1,252306,252306,252307,0,1,1
72281,6,3,252312,252312,252315,0,3,5
72282,1,3,252313,252315,252318,2,5,0
72283,2,1,252315,252318,252319,3,4,0
72284,2,1,252317,252319,252320,2,3,0
72285,2,3,252319,252320,252323,1,4,0
72286,3,1,252322,252323,252324,1,2,0
72287,4,2,252326,252326,252328,0,2,2
72288,4,2,252330,252330,252332,0,2,2
72289,6,3,252336,252336,252339,0,3,4
72290,5,1,252341,252341,252342,0,1,2
72291,4,3,252345,252345,252348,0,3,3
72292,4,3,252349,252349,252352,0,3,1
72293,2,1,252351,252352,252353,1,2,0
72294,2,1,252353,252353,252354,0,1,0
72295,1,3,252354,252354,252357,0,3,0
72296,4,3,252358,252358,252361,0,3,1
72297,1,1,252359,252361,252362,2,3,0
72298,4,1,252363,252363,252364,0,1,1
72299,3,1,252366,252366,252367,0,1,2
72300,1,2,252367,252367,252369,0,2,0
72301,3,1,252370,252370,252371,0,1,1
72302,4,3,252374,252374,252377,0,3,3
72303,3,3,252377,252377,252380,0,3,0
72304,3,2,252380,252380,252382,0,2,0
72305,4,2,252384,252384,252386,0,2,2
72306,5,3,252389,252389,252392,0,3,3
72307,6,2,252395,252395,252397,0,2,3
72308,4,3,252399,252399,252402,0,3,2
72309,5,2,252404,252404,252406,0,2,2
72310,2,1,252406,252406,252407,0,1,0
72311,1,1,252407,252407,252408,0,1,0
72312,2,3,252409,252409,252412,0,3,1
72313,3,3,252412,252412,252415,0,3,0
72314,1,2,252413,252415,252417,2,4,0
72315,3,3,252416,252417,252420,1,4,0
72316,5,3,252421,252421,252424,0,3,1
72317,2,3,252423,252424,252427,1,4,0
72318,6,2,252429,252429,252431,0,2,2
72319,5,2,252434,252434,252436,0,2,3
72320,1,2,252435,252436,252438,1,3,0
72321,1,2,252436,252438,252440,2,4,0
72322,1,1,252437,252440,252441,3,4,0
72323,2,2,252439,252441,252443,2,4,0
72324,4,2,252443,252443,252445,0,2,0
72325,2,3,252445,252445,252448,0,3,0
72326,3,1,252448,252448,252449,0,1,0
72327,2,3,252450,252450,252453,0,3,1
72328,5,1,252455,252455,252456,0,1,2
72329,6,1,252461,252461,252462,0,1,5
72330,5,2,252466,252466,252468,0,2,4
72331,3,2,252469,252469,252471,0,2,1
72332,3,2,252472,252472,252474,0,2,1
72333,6,2,252478,252478,252480,0,2,4
72334,1,2,252479,252480,252482,1,3,0
72335,3,3,252482,252482,252485,0,3,0
72336,4,3,252486,252486,252489,0,3,1
72337,2,1,252488,252489,252490,1,2,0
72338,2,1,252490,252490,252491,0,1,0
72339,2,1,252492,252492,252493,0,1,1
72340,6,1,252498,252498,252499,0,1,5
72341,3,1,252501,252501,252502,0,1,2
72342,6,1,252507,252507,252508,0,1,5
72343,3,1,252510,252510,252511,0,1,2
72344,5,3,252515,252515,252518,0,3,4
72345,6,2,252521,252521,252523,0,2,3
72346,1,3,252522,252523,252526,1,4,0
72347,3,2,252525,252526,252528,1,3,0
72348,6,1,252531,252531,252532,0,1,3
72349,3,3,252534,252534,252537,0,3,2
72350,4,1,252538,252538,252539,0,1,1
72351,3,3,252541,252541,252544,0,3,2
72352,5,2,252546,252546,252548,0,2,2
72353,3,1,252549,252549,252550,0,1,1
72354,6,1,252555,252555,252556,0,1,5
72355,5,2,252560,252560,252562,0,2,4
72356,6,1,252566,252566,252567,0,1,4
72357,5,3,252571,252571,252574,0,3,4
72358,2,3,252573,252574,252577,1,4,0
72359,3,1,252576,252577,252578,1,2,0
72360,6,1,252582,252582,252583,0,1,4
72361,2,2,252584,252584,252586,0,2,1
72362,6,3,252590,252590,252593,0,3,4
72363,4,2,252594,252594,252596,0,2,1
72364,6,1,252600,252600,252601,0,1,4
72365,3,3,252603,252603,252606,0,3,2
72366,1,2,252604,252606,252608,2,4,0
72367,3,2,252607,252608,252610,1,3,0
72368,4,2,252611,252611,252613,0,2,1
72369,4,1,252615,252615,252616,0,1,2
72370,1,1,252616,252616,252617,0,1,0
72371,4,2,252620,252620,252622,0,2,3
72372,4,2,252624,252624,252626,0,2,2
72373,1,1,252625,252626,252627,1,2,0
72374,5,2,252630,252630,252632,0,2,3
72375,1,3,252631,252632,252635,1,4,0
72376,1,1,252632,252635,252636,3,4,0
72377,1,2,252633,252636,252638,3,5,0
72378,5,1,252638,252638,252639,0,1,0
72379,2,1,252640,252640,252641,0,1,1
72380,2,1,252642,252642,252643,0,1,1
72381,5,3,252647,252647,252650,0,3,4
72382,4,1,252651,252651,252652,0,1,1
72383,5,1,252656,252656,252657,0,1,4
72384,3,2,252659,252659,252661,0,2,2
72385,2,3,252661,252661,252664,0,3,0
72386,6,2,252667,252667,252669,0,2,3
72387,1,3,252668,252669,252672,1,4,0
72388,2,1,252670,252672,252673,2,3,0
72389,3,3,252673,252673,252676,0,3,0
72390,1,2,252674,252676,252678,2,4,0
72391,3,3,252677,252678,252681,1,4,0
72392,6,2,252683,252683,252685,0,2,2
72393,4,1,252687,252687,252688,0,1,2
72394,4,2,252691,252691,252693,0,2,3
72395,3,1,252694,252694,252695,0,1,1
72396,2,1,252696,252696,252697,0,1,1
72397,5,3,252701,252701,252704,0,3,4
72398,5,3,252706,252706,252709,0,3,2
72399,4,1,252710,252710,252711,0,1,1
72400,6,3,252716,252716,252719,0,3,5
72401,6,2,252722,252722,252724,0,2,3
72402,5,1,252727,252727,252728,0,1,3
72403,5,3,252732,252732,252735,0,3,4
72404,3,3,252735,252735,252738,0,3,0
72405,3,1,252738,252738,252739,0,1,0
72406,3,1,252741,252741,252742,0,1,2
72407,3,2,252744,252744,252746,0,2,2
72408,5,2,252749,252749,252751,0,2,3
72409,1,2,252750,252751,252753,1,3,0
72410,3,1,252753,252753,252754,0,1,0
72411,2,3,252755,252755,252758,0,3,1
72412,4,2,252759,252759,252761,0,2,1
72413,1,1,252760,252761,252762,1,2,0
72414,5,3,252765,252765,252768,0,3,3
72415,4,1,252769,252769,252770,0,1,1
72416,1,2,252770,252770,252772,0,2,0
72417,5,3,252775,252775,252778,0,3,3
72418,3,3,252778,252778,252781,0,3,0
72419,1,3,252779,252781,252784,2,5,0
72420,5,2,252784,252784,252786,0,2,0
72421,4,3,252788,252788,252791,0,3,2
72422,1,2,252789,252791,252793,2,4,0
72423,4,2,252793,252793,252795,0,2,0
72424,1,1,252794,252795,252796,1,2,0
72425,6,3,252800,252800,252803,0,3,4
72426,1,2,252801,252803,252805,2,4,0
72427,2,2,252803,252805,252807,2,4,0
72428,3,2,252806,252807,252809,1,3,0
72429,6,1,252812,252812,252813,0,1,3
72430,6,2,252818,252818,252820,0,2,5
72431,3,2,252821,252821,252823,0,2,1
72432,3,1,252824,252824,252825,0,1,1
72433,6,1,252830,252830,252831,0,1,5
72434,1,1,252831,252831,252832,0,1,0
72435,6,3,252837,252837,252840,0,3,5
72436,5,2,252842,252842,252844,0,2,2
72437,2,1,252844,252844,252845,0,1,0
72438,4,2,252848,252848,252850,0,2,3
72439,6,3,252854,252854,252857,0,3,4
72440,2,3,252856,252857,252860,1,4,0
72441,1,1,252857,252860,252861,3,4,0
72442,4,1,252861,252861,252862,0,1,0
72443,1,3,252862,252862,252865,0,3,0
72444,4,2,252866,252866,252868,0,2,1
72445,5,3,252871,252871,252874,0,3,3
72446,6,1,252877,252877,252878,0,1,3
72447,5,2,252882,252882,252884,0,2,4
72448,6,3,252888,252888,252891,0,3,4
72449,4,3,252892,252892,252895,0,3,1
72450,1,3,252893,252895,252898,2,5,0
72451,2,3,252895,252898,252901,3,6,0
72452,2,1,252897,252901,252902,4,5,0
72453,1,1,252898,252902,252903,4,5,0
72454,2,2,252900,252903,252905,3,5,0
72455,5,1,252905,252905,252906,0,1,0
72456,1,1,252906,252906,252907,0,1,0
72457,6,1,252912,252912,252913,0,1,5
72458,6,2,252918,252918,252920,0,2,5
72459,1,3,252919,252920,252923,1,4,0
72460,3,1,252922,252923,252924,1,2,0
72461,2,1,252924,252924,252925,0,1,0
72462,1,3,252925,252925,252928,0,3,0
72463,6,2,252931,252931,252933,0,2,3
72464,1,1,252932,252933,252934,1,2,0
72465,2,1,252934,252934,252935,0,1,0
72466,3,1,252937,252937,252938,0,1,2
72467,6,2,252943,252943,252945,0,2,5
72468,5,2,252948,252948,252950,0,2,3
72469,3,1,252951,252951,252952,0,1,1
72470,1,3,252952,252952,252955,0,3,0
72471,3,2,252955,252955,252957,0,2,0
72472,5,3,252960,252960,252963,0,3,3
72473,1,1,252961,252963,252964,2,3,0
72474,6,2,252967,252967,252969,0,2,3
72475,1,2,252968,252969,252971,1,3,0
72476,6,3,252974,252974,252977,0,3,3
72477,2,1,252976,252977,252978,1,2,0
72478,1,3,252977,252978,252981,1,4,0
72479,3,2,252980,252981,252983,1,3,0
72480,6,1,252986,252986,252987,0,1,3
72481,5,2,252991,252991,252993,0,2,4
72482,6,3,252997,252997,253000,0,3,4
72483,1,1,252998,253000,253001,2,3,0
72484,5,1,253003,253003,253004,0,1,2
72485,4,1,253007,253007,253008,0,1,3
72486,2,3,253009,253009,253012,0,3,1
72487,2,1,253011,253012,253013,1,2,0
72488,6,1,253017,253017,253018,0,1,4
72489,4,1,253021,253021,253022,0,1,3
72490,4,1,253025,253025,253026,0,1,3
72491,6,3,253031,253031,253034,0,3,5
72492,6,1,253037,253037,253038,0,1,3
72493,5,1,253042,253042,253043,0,1,4
72494,6,1,253048,253048,253049,0,1,5
72495,5,3,253053,253053,253056,0,3,4
72496,5,3,253058,253058,253061,0,3,2
72497,5,2,253063,253063,253065,0,2,2
72498,3,2,253066,253066,253068,0,2,1
72499,3,1,253069,253069,253070,0,1,1
72500,2,2,253071,253071,253073,0,2,1
72501,6,3,253077,253077,253080,0,3,4
72502,4,2,253081,253081,253083,0,2,1
72503,3,2,253084,253084,253086,0,2,1
72504,3,3,253087,253087,253090,0,3,1
72505,5,2,253092,253092,253094,0,2,2
72506,5,1,253097,253097,253098,0,1,3
72507,3,3,253100,253100,253103,0,3,2
72508,2,3,253102,253103,253106,1,4,0
72509,2,3,253104,253106,253109,2,5,0
72510,2,1,253106,253109,253110,3,4,0
72511,2,3,253108,253110,253113,2,5,0
72512,4,1,253112,253113,253114,1,2,0
72513,4,1,253116,253116,253117,0,1,2
72514,2,1,253118,253118,253119,0,1,1
72515,4,3,253122,253122,253125,0,3,3
72516,5,2,253127,253127,253129,0,2,2
72517,6,2,253133,253133,253135,0,2,4
72518,5,3,253138,253138,253141,0,3,3
72519,3,3,253141,253141,253144,0,3,0
72520,6,1,253147,253147,253148,0,1,3
72521,4,3,253151,253151,253154,0,3,3
72522,5,1,253156,253156,253157,0,1,2
72523,6,1,253162,253162,253163,0,1,5
72524,4,3,253166,253166,253169,0,3,3
72525,4,1,253170,253170,253171,0,1,1
72526,6,2,253176,253176,253178,0,2,5
72527,1,2,253177,253178,253180,1,3,0
72528,4,2,253181,253181,253183,0,2,1
72529,3,1,253184,253184,253185,0,1,1
72530,5,2,253189,253189,253191,0,2,4
72531,4,1,253193,253193,253194,0,1,2
72532,5,3,253198,253198,253201,0,3,4
72533,2,2,253200,253201,253203,1,3,0
72534,3,1,253203,253203,253204,0,1,0
72535,1,3,253204,253204,253207,0,3,0
72536,1,1,253205,253207,253208,2,3,0
72537,4,3,253209,253209,253212,0,3,1
72538,5,3,253214,253214,253217,0,3,2
72539,1,1,253215,253217,253218,2,3,0
72540,2,3,253217,253218,253221,1,4,0
72541,2,3,253219,253221,253224,2,5,0
72542,5,2,253224,253224,253226,0,2,0
72543,3,2,253227,253227,253229,0,2,1
72544,1,3,253228,253229,253232,1,4,0
72545,4,2,253232,253232,253234,0,2,0
72546,5,1,253237,253237,253238,0,1,3
72547,6,2,253243,253243,253245,0,2,5
72548,4,2,253247,253247,253249,0,2,2
72549,5,1,253252,253252,253253,0,1,3
72550,3,1,253255,253255,253256,0,1,2
72551,5,3,253260,253260,253263,0,3,4
72552,6,1,253266,253266,253267,0,1,3
72553,6,2,253272,253272,253274,0,2,5
72554,6,1,253278,253278,253279,0,1,4
72555,3,1,253281,253281,253282,0,1,2
72556,2,3,253283,253283,253286,0,3,1
72557,2,3,253285,253286,253289,1,4,0
72558,3,3,253288,253289,253292,1,4,0
72559,2,1,253290,253292,253293,2,3,0
72560,6,1,253296,253296,253297,0,1,3
72561,2,1,253298,253298,253299,0,1,1
72562,4,1,253302,253302,253303,0,1,3
72563,3,1,253305,253305,253306,0,1,2
72564,5,1,253310,253310,253311,0,1,4
72565,6,1,253316,253316,253317,0,1,5
72566,5,2,253321,253321,253323,0,2,4
72567,3,2,253324,253324,253326,0,2,1
72568,6,2,253330,253330,253332,0,2,4
72569,5,1,253335,253335,253336,0,1,3
72570,4,1,253339,253339,253340,0,1,3
72571,5,1,253344,253344,253345,0,1,4
72572,6,3,253350,253350,253353,0,3,5
72573,1,1,253351,253353,253354,2,3,0
72574,3,2,253354,253354,253356,0,2,0
72575,1,1,253355,253356,253357,1,2,0
72576,2,2,253357,253357,253359,0,2,0
72577,6,2,253363,253363,253365,0,2,4
72578,3,2,253366,253366,253368,0,2,1
72579,2,2,253368,253368,253370,0,2,0
72580,5,1,253373,253373,253374,0,1,3
72581,1,2,253374,253374,253376,0,2,0
72582,2,3,253376,253376,253379,0,3,0
72583,3,1,253379,253379,253380,0,1,0
72584,3,3,253382,253382,253385,0,3,2
72585,5,1,253387,253387,253388,0,1,2
72586,3,2,253390,253390,253392,0,2,2
72587,6,1,253396,253396,253397,0,1,4
72588,1,1,253397,253397,253398,0,1,0
72589,5,1,253402,253402,253403,0,1,4
72590,3,3,253405,253405,253408,0,3,2
72591,6,2,253411,253411,253413,0,2,3
72592,6,3,253417,253417,253420,0,3,4
72593,1,2,253418,253420,253422,2,4,0
72594,4,1,253422,253422,253423,0,1,0
72595,4,1,253426,253426,253427,0,1,3
72596,4,2,253430,253430,253432,0,2,3
72597,5,1,253435,253435,253436,0,1,3
72598,6,2,253441,253441,253443,0,2,5
72599,1,3,253442,253443,253446,1,4,0
72600,5,3,253447,253447,253450,0,3,1
72601,2,3,253449,253450,253453,1,4,0
72602,1,3,253450,253453,253456,3,6,0
72603,4,2,253454,253456,253458,2,4,0
72604,3,2,253457,253458,253460,1,3,0
72605,3,2,253460,253460,253462,0,2,0
72606,5,2,253465,253465,253467,0,2,3
72607,1,3,253466,253467,253470,1,4,0
72608,6,2,253472,253472,253474,0,2,2
72609,4,1,253476,253476,253477,0,1,2
72610,1,2,253477,253477,253479,0,2,0
72611,4,3,253481,253481,253484,0,3,2
72612,5,2,253486,253486,253488,0,2,2
72613,1,3,253487,253488,253491,1,4,0
72614,6,1,253493,253493,253494,0,1,2
72615,5,3,253498,253498,253501,0,3,4
72616,2,1,253500,253501,253502,1,2,0
72617,3,1,253503,253503,253504,0,1,1
72618,2,2,253505,253505,253507,0,2,1
72619,5,3,253510,253510,253513,0,3,3
72620,4,3,253514,253514,253517,0,3,1
72621,6,1,253520,253520,253521,0,1,3
72622,2,3,253522,253522,253525,0,3,1
72623,4,3,253526,253526,253529,0,3,1
72624,4,3,253530,253530,253533,0,3,1
72625,1,2,253531,253533,253535,2,4,0
72626,4,3,253535,253535,253538,0,3,0
72627,6,1,253541,253541,253542,0,1,3
72628,3,1,253544,253544,253545,0,1,2
72629,6,3,253550,253550,253553,0,3,5
72630,2,2,253552,253553,253555,1,3,0
72631,6,1,253558,253558,253559,0,1,3
72632,1,1,253559,253559,253560,0,1,0
72633,2,1,253561,253561,253562,0,1,1
72634,2,3,253563,253563,253566,0,3,1
72635,5,3,253568,253568,253571,0,3,2
72636,3,1,253571,253571,253572,0,1,0
72637,3,3,253574,253574,253577,0,3,2
72638,1,1,253575,253577,253578,2,3,0
72639,2,1,253577,253578,253579,1,2,0
72640,5,2,253582,253582,253584,0,2,3
72641,4,3,253586,253586,253589,0,3,2
72642,2,3,253588,253589,253592,1,4,0
72643,2,3,253590,253592,253595,2,5,0
72644,5,3,253595,253595,253598,0,3,0
72645,4,1,253599,253599,253600,0,1,1
72646,6,2,253605,253605,253607,0,2,5
72647,3,2,253608,253608,253610,0,2,1
72648,1,1,253609,253610,253611,1,2,0
72649,5,3,253614,253614,253617,0,3,3
72650,4,1,253618,253618,253619,0,1,1
72651,4,2,253622,253622,253624,0,2,3
72652,3,3,253625,253625,253628,0,3,1
72653,2,2,253627,253628,253630,1,3,0
72654,4,1,253631,253631,253632,0,1,1
72655,6,1,253637,253637,253638,0,1,5
72656,4,3,253641,253641,253644,0,3,3
72657,1,2,253642,253644,253646,2,4,0
72658,5,3,253647,253647,253650,0,3,1
72659,3,3,253650,253650,253653,0,3,0
72660,5,1,253655,253655,253656,0,1,2
72661,6,2,253661,253661,253663,0,2,5
72662,2,3,253663,253663,253666,0,3,0
72663,6,3,253669,253669,253672,0,3,3
72664,4,3,253673,253673,253676,0,3,1
72665,3,2,253676,253676,253678,0,2,0
72666,3,2,253679,253679,253681,0,2,1
72667,2,2,253681,253681,253683,0,2,0
72668,2,3,253683,253683,253686,0,3,0
72669,5,2,253688,253688,253690,0,2,2
72670,3,1,253691,253691,253692,0,1,1
72671,3,3,253694,253694,253697,0,3,2
72672,4,2,253698,253698,253700,0,2,1
72673,5,3,253703,253703,253706,0,3,3
72674,1,2,253704,253706,253708,2,4,0
72675,1,2,253705,253708,253710,3,5,0
72676,6,1,253711,253711,253712,0,1,1
72677,5,3,253716,253716,253719,0,3,4
72678,4,2,253720,253720,253722,0,2,1
72679,6,2,253726,253726,253728,0,2,4
72680,6,2,253732,253732,253734,0,2,4
72681,6,3,253738,253738,253741,0,3,4
72682,2,2,253740,253741,253743,1,3,0
72683,6,2,253746,253746,253748,0,2,3
72684,3,3,253749,253749,253752,0,3,1
72685,1,1,253750,253752,253753,2,3,0
72686,1,3,253751,253753,253756,2,5,0
72687,2,1,253753,253756,253757,3,4,0
72688,2,1,253755,253757,253758,2,3,0
72689,6,2,253761,253761,253763,0,2,3
72690,5,2,253766,253766,253768,0,2,3
72691,1,3,253767,253768,253771,1,4,0
72692,2,1,253769,253771,253772,2,3,0
72693,5,1,253774,253774,253775,0,1,2
72694,3,3,253777,253777,253780,0,3,2
72695,2,1,253779,253780,253781,1,2,0
72696,6,2,253785,253785,253787,0,2,4
72697,6,1,253791,253791,253792,0,1,4
72698,3,3,253794,253794,253797,0,3,2
72699,1,2,253795,253797,253799,2,4,0
72700,1,1,253796,253799,253800,3,4,0
72701,1,3,253797,253800,253803,3,6,0
72702,2,1,253799,253803,253804,4,5,0
72703,6,3,253805,253805,253808,0,3,1
72704,4,2,253809,253809,253811,0,2,1
72705,5,2,253814,253814,253816,0,2,3
72706,3,2,253817,253817,253819,0,2,1
72707,2,2,253819,253819,253821,0,2,0
72708,6,3,253825,253825,253828,0,3,4
72709,5,3,253830,253830,253833,0,3,2
72710,1,1,253831,253833,253834,2,3,0
72711,4,3,253835,253835,253838,0,3,1
72712,3,1,253838,253838,253839,0,1,0
72713,6,3,253844,253844,253847,0,3,5
72714,2,3,253846,253847,253850,1,4,0
72715,3,3,253849,253850,253853,1,4,0
72716,1,3,253850,253853,253856,3,6,0
72717,3,3,253853,253856,253859,3,6,0
72718,4,2,253857,253859,253861,2,4,0
72719,6,1,253863,253863,253864,0,1,2
72720,6,3,253869,253869,253872,0,3,5
72721,4,2,253873,253873,253875,0,2,1
72722,1,3,253874,253875,253878,1,4,0
72723,1,1,253875,253878,253879,3,4,0
72724,1,3,253876,253879,253882,3,6,0
72725,4,2,253880,253882,253884,2,4,0
72726,2,3,253882,253884,253887,2,5,0
72727,5,1,253887,253887,253888,0,1,0
72728,3,1,253890,253890,253891,0,1,2
72729,2,1,253892,253892,253893,0,1,1
72730,6,1,253898,253898,253899,0,1,5
72731,3,3,253901,253901,253904,0,3,2
72732,4,3,253905,253905,253908,0,3,1
72733,5,3,253910,253910,253913,0,3,2
72734,4,1,253914,253914,253915,0,1,1
72735,6,2,253920,253920,253922,0,2,5
72736,4,3,253924,253924,253927,0,3,2
72737,6,3,253930,253930,253933,0,3,3
72738,1,1,253931,253933,253934,2,3,0
72739,1,3,253932,253934,253937,2,5,0
72740,1,1,253933,253937,253938,4,5,0
72741,1,1,253934,253938,253939,4,5,0
72742,4,3,253938,253939,253942,1,4,0
72743,6,3,253944,253944,253947,0,3,2
72744,6,3,253950,253950,253953,0,3,3
72745,6,1,253956,253956,253957,0,1,3
72746,5,2,253961,253961,253963,0,2,4
72747,5,1,253966,253966,253967,0,1,3
72748,1,3,253967,253967,253970,0,3,0
72749,2,1,253969,253970,253971,1,2,0
72750,4,1,253973,253973,253974,0,1,2
72751,5,2,253978,253978,253980,0,2,4
72752,2,3,253980,253980,253983,0,3,0
72753,3,3,253983,253983,253986,0,3,0
72754,2,3,253985,253986,253989,1,4,0
72755,2,2,253987,253989,253991,2,4,0
72756,2,3,253989,253991,253994,2,5,0
72757,2,1,253991,253994,253995,3,4,0
72758,4,3,253995,253995,253998,0,3,0
72759,2,1,253997,253998,253999,1,2,0
72760,5,3,254002,254002,254005,0,3,3
72761,5,1,254007,254007,254008,0,1,2
72762,1,2,254008,254008,254010,0,2,0
72763,3,1,254011,254011,254012,0,1,1
72764,2,1,254013,254013,254014,0,1,1
72765,2,3,254015,254015,254018,0,3,1
72766,6,2,254021,254021,254023,0,2,3
72767,1,3,254022,254023,254026,1,4,0
72768,5,1,254027,254027,254028,0,1,1
72769,4,2,254031,254031,254033,0,2,3
72770,6,1,254037,254037,254038,0,1,4
72771,1,1,254038,254038,254039,0,1,0
72772,2,1,254040,254040,254041,0,1,1
72773,4,1,254044,254044,254045,0,1,3
72774,1,3,254045,254045,254048,0,3,0
72775,6,1,254051,254051,254052,0,1,3
72776,4,1,254055,254055,254056,0,1,3
72777,4,2,254059,254059,254061,0,2,3
72778,6,1,254065,254065,254066,0,1,4
72779,4,3,254069,254069,254072,0,3,3
72780,1,3,254070,254072,254075,2,5,0
72781,5,1,254075,254075,254076,0,1,0
72782,4,1,254079,254079,254080,0,1,3
72783,5,3,254084,254084,254087,0,3,4
72784,2,3,254086,254087,254090,1,4,0
72785,3,3,254089,254090,254093,1,4,0
72786,2,2,254091,254093,254095,2,4,0
72787,4,1,254095,254095,254096,0,1,0
72788,3,1,254098,254098,254099,0,1,2
72789,4,3,254102,254102,254105,0,3,3
72790,2,3,254104,254105,254108,1,4,0
72791,3,1,254107,254108,254109,1,2,0
72792,5,3,254112,254112,254115,0,3,3
72793,4,2,254116,254116,254118,0,2,1
72794,2,3,254118,254118,254121,0,3,0
72795,3,1,254121,254121,254122,0,1,0
72796,1,2,254122,254122,254124,0,2,0
72797,1,3,254123,254124,254127,1,4,0
72798,3,2,254126,254127,254129,1,3,0
72799,1,2,254127,254129,254131,2,4,0
72800,2,2,254129,254131,254133,2,4,0
72801,4,1,254133,254133,254134,0,1,0
72802,1,3,254134,254134,254137,0,3,0
72803,6,3,254140,254140,254143,0,3,3
72804,1,1,254141,254143,254144,2,3,0
72805,3,1,254144,254144,254145,0,1,0
72806,4,1,254148,254148,254149,0,1,3
72807,4,1,254152,254152,254153,0,1,3
72808,5,1,254157,254157,254158,0,1,4
72809,6,1,254163,254163,254164,0,1,5
72810,1,2,254164,254164,254166,0,2,0
72811,3,2,254167,254167,254169,0,2,1
72812,5,1,254172,254172,254173,0,1,3
72813,5,1,254177,254177,254178,0,1,4
72814,5,2,254182,254182,254184,0,2,4
72815,2,2,254184,254184,254186,0,2,0
72816,4,3,254188,254188,254191,0,3,2
72817,1,2,254189,254191,254193,2,4,0
72818,6,1,254195,254195,254196,0,1,2
72819,1,1,254196,254196,254197,0,1,0
72820,1,3,254197,254197,254200,0,3,0
72821,5,2,254202,254202,254204,0,2,2
72822,4,3,254206,254206,254209,0,3,2
72823,1,3,254207,254209,254212,2,5,0
72824,3,1,254210,254212,254213,2,3,0
72825,2,3,254212,254213,254216,1,4,0
72826,1,3,254213,254216,254219,3,6,0
72827,5,2,254218,254219,254221,1,3,0
72828,1,3,254219,254221,254224,2,5,0
72829,3,1,254222,254224,254225,2,3,0
72830,4,1,254226,254226,254227,0,1,1
72831,3,2,254229,254229,254231,0,2,2
72832,3,3,254232,254232,254235,0,3,1
72833,5,1,254237,254237,254238,0,1,2
72834,6,3,254243,254243,254246,0,3,5
72835,3,1,254246,254246,254247,0,1,0
72836,1,1,254247,254247,254248,0,1,0
72837,6,1,254253,254253,254254,0,1,5
72838,6,1,254259,254259,254260,0,1,5
72839,4,3,254263,254263,254266,0,3,3
72840,6,1,254269,254269,254270,0,1,3
72841,4,2,254273,254273,254275,0,2,3
72842,5,1,254278,254278,254279,0,1,3
72843,5,1,254283,254283,254284,0,1,4
72844,6,2,254289,254289,254291,0,2,5
72845,4,2,254293,254293,254295,0,2,2
72846,6,3,254299,254299,254302,0,3,4
72847,5,3,254304,254304,254307,0,3,2
72848,1,2,254305,254307,254309,2,4,0
72849,1,1,254306,254309,254310,3,4,0
72850,6,1,254312,254312,254313,0,1,2
72851,5,1,254317,254317,254318,0,1,4
72852,1,2,254318,254318,254320,0,2,0
72853,1,1,254319,254320,254321,1,2,0
72854,2,2,254321,254321,254323,0,2,0
72855,5,2,254326,254326,254328,0,2,3
72856,4,3,254330,254330,254333,0,3,2
72857,4,3,254334,254334,254337,0,3,1
72858,5,2,254339,254339,254341,0,2,2
72859,4,2,254343,254343,254345,0,2,2
72860,1,1,254344,254345,254346,1,2,0
72861,4,3,254348,254348,254351,0,3,2
72862,2,3,254350,254351,254354,1,4,0
72863,1,3,254351,254354,254357,3,6,0
72864,3,3,254354,254357,254360,3,6,0
72865,4,2,254358,254360,254362,2,4,0
72866,2,2,254360,254362,254364,2,4,0
72867,6,2,254366,254366,254368,0,2,2
72868,4,1,254370,254370,254371,0,1,2
72869,2,3,254372,254372,254375,0,3,1
72870,6,1,254378,254378,254379,0,1,3
72871,2,3,254380,254380,254383,0,3,1
72872,5,2,254385,254385,254387,0,2,2
72873,5,1,254390,254390,254391,0,1,3
72874,2,2,254392,254392,254394,0,2,1
72875,5,3,254397,254397,254400,0,3,3
72876,6,2,254403,254403,254405,0,2,3
72877,3,1,254406,254406,254407,0,1,1
72878,6,1,254412,254412,254413,0,1,5
72879,4,3,254416,254416,254419,0,3,3
72880,5,2,254421,254421,254423,0,2,2
72881,5,1,254426,254426,254427,0,1,3
72882,1,2,254427,254427,254429,0,2,0
72883,2,1,254429,254429,254430,0,1,0
72884,5,3,254434,254434,254437,0,3,4
72885,3,2,254437,254437,254439,0,2,0
72886,3,1,254440,254440,254441,0,1,1
72887,4,1,254444,254444,254445,0,1,3
72888,5,3,254449,254449,254452,0,3,4
72889,3,2,254452,254452,254454,0,2,0
72890,5,3,254457,254457,254460,0,3,3
72891,6,2,254463,254463,254465,0,2,3
72892,6,3,254469,254469,254472,0,3,4
72893,4,1,254473,254473,254474,0,1,1
72894,1,2,254474,254474,254476,0,2,0
72895,5,3,254479,254479,254482,0,3,3
72896,4,3,254483,254483,254486,0,3,1
72897,1,3,254484,254486,254489,2,5,0
72898,5,2,254489,254489,254491,0,2,0
72899,2,1,254491,254491,254492,0,1,0
72900,4,3,254495,254495,254498,0,3,3
72901,4,2,254499,254499,254501,0,2,1
72902,1,2,254500,254501,254503,1,3,0
72903,3,1,254503,254503,254504,0,1,0
72904,5,2,254508,254508,254510,0,2,4
72905,4,3,254512,254512,254515,0,3,2
72906,2,1,254514,254515,254516,1,2,0
72907,4,3,254518,254518,254521,0,3,2
72908,4,2,254522,254522,254524,0,2,1
72909,2,1,254524,254524,254525,0,1,0
72910,2,1,254526,254526,254527,0,1,1
72911,6,2,254532,254532,254534,0,2,5
72912,4,1,254536,254536,254537,0,1,2
72913,3,3,254539,254539,254542,0,3,2
72914,4,3,254543,254543,254546,0,3,1
72915,6,3,254549,254549,254552,0,3,3
72916,5,3,254554,254554,254557,0,3,2
72917,6,1,254560,254560,254561,0,1,3
72918,5,2,254565,254565,254567,0,2,4
72919,3,1,254568,254568,254569,0,1,1
72920,3,2,254571,254571,254573,0,2,2
72921,4,1,254575,254575,254576,0,1,2
72922,4,3,254579,254579,254582,0,3,3
72923,3,2,254582,254582,254584,0,2,0
72924,6,3,254588,254588,254591,0,3,4
72925,4,3,254592,254592,254595,0,3,1
72926,4,1,254596,254596,254597,0,1,1
72927,2,2,254598,254598,254600,0,2,1
72928,1,2,254599,254600,254602,1,3,0
72929,1,3,254600,254602,254605,2,5,0
72930,4,2,254604,254605,254607,1,3,0
72931,5,3,254609,254609,254612,0,3,2
72932,2,3,254611,254612,254615,1,4,0
72933,3,1,254614,254615,254616,1,2,0
72934,6,1,254620,254620,254621,0,1,4
72935,3,3,254623,254623,254626,0,3,2
72936,4,1,254627,254627,254628,0,1,1
72937,1,3,254628,254628,254631,0,3,0
72938,5,2,254633,254633,254635,0,2,2
72939,4,3,254637,254637,254640,0,3,2
72940,4,2,254641,254641,254643,0,2,1
72941,4,3,254645,254645,254648,0,3,2
72942,4,2,254649,254649,254651,0,2,1
72943,2,1,254651,254651,254652,0,1,0
72944,1,1,254652,254652,254653,0,1,0
72945,4,1,254656,254656,254657,0,1,3
72946,5,2,254661,254661,254663,0,2,4
72947,6,3,254667,254667,254670,0,3,4
72948,1,1,254668,254670,254671,2,3,0
72949,3,3,254671,254671,254674,0,3,0
72950,4,1,254675,254675,254676,0,1,1
72951,4,3,254679,254679,254682,0,3,3
72952,1,2,254680,254682,254684,2,4,0
72953,6,3,254686,254686,254689,0,3,2
72954,6,2,254692,254692,254694,0,2,3
72955,2,1,254694,254694,254695,0,1,0
72956,6,3,254700,254700,254703,0,3,5
72957,4,1,254704,254704,254705,0,1,1
72958,1,1,254705,254705,254706,0,1,0
72959,6,2,254711,254711,254713,0,2,5
72960,4,1,254715,254715,254716,0,1,2
72961,3,2,254718,254718,254720,0,2,2
72962,6,1,254724,254724,254725,0,1,4
72963,6,3,254730,254730,254733,0,3,5
72964,5,2,254735,254735,254737,0,2,2
72965,2,3,254737,254737,254740,0,3,0
72966,2,1,254739,254740,254741,1,2,0
72967,5,3,254744,254744,254747,0,3,3
72968,2,1,254746,254747,254748,1,2,0
72969,5,3,254751,254751,254754,0,3,3
72970,3,1,254754,254754,254755,0,1,0
72971,6,3,254760,254760,254763,0,3,5
72972,1,3,254761,254763,254766,2,5,0
72973,4,3,254765,254766,254769,1,4,0
72974,2,3,254767,254769,254772,2,5,0
72975,1,2,254768,254772,254774,4,6,0
72976,3,2,254771,254774,254776,3,5,0
72977,5,1,254776,254776,254777,0,1,0
72978,1,2,254777,254777,254779,0,2,0
72979,4,2,254781,254781,254783,0,2,2
72980,3,2,254784,254784,254786,0,2,1
72981,5,2,254789,254789,254791,0,2,3
72982,6,3,254795,254795,254798,0,3,4
72983,2,2,254797,254798,254800,1,3,0
72984,5,3,254802,254802,254805,0,3,2
72985,6,3,254808,254808,254811,0,3,3
72986,4,1,254812,254812,254813,0,1,1
72987,1,2,254813,254813,254815,0,2,0
72988,2,2,254815,254815,254817,0,2,0
72989,6,2,254821,254821,254823,0,2,4
72990,6,1,254827,254827,254828,0,1,4
72991,4,2,254831,254831,254833,0,2,3
72992,6,3,254837,254837,254840,0,3,4
72993,6,1,254843,254843,254844,0,1,3
72994,1,1,254844,254844,254845,0,1,0
72995,5,1,254849,254849,254850,0,1,4
72996,5,2,254854,254854,254856,0,2,4
72997,4,1,254858,254858,254859,0,1,2
72998,2,1,254860,254860,254861,0,1,1
72999,3,1,254863,254863,254864,0,1,2
73000,5,2,254868,254868,254870,0,2,4
73001,3,2,254871,254871,254873,0,2,1
73002,5,1,254876,254876,254877,0,1,3
73003,3,1,254879,254879,254880,0,1,2
73004,6,2,254885,254885,254887,0,2,5
73005,5,2,254890,254890,254892,0,2,3
73006,5,3,254895,254895,254898,0,3,3
73007,1,1,254896,254898,254899,2,3,0
73008,3,1,254899,254899,254900,0,1,0
73009,4,1,254903,254903,254904,0,1,3
73010,5,3,254908,254908,254911,0,3,4
73011,6,3,254914,254914,254917,0,3,3
73012,5,3,254919,254919,254922,0,3,2
73013,6,2,254925,254925,254927,0,2,3
73014,3,2,254928,254928,254930,0,2,1
73015,1,3,254929,254930,254933,1,4,0
73016,3,1,254932,254933,254934,1,2,0
73017,4,1,254936,254936,254937,0,1,2
73018,3,1,254939,254939,254940,0,1,2
73019,6,2,254945,254945,254947,0,2,5
73020,3,1,254948,254948,254949,0,1,1
73021,4,1,254952,254952,254953,0,1,3
73022,1,2,254953,254953,254955,0,2,0
73023,2,1,254955,254955,254956,0,1,0
73024,1,2,254956,254956,254958,0,2,0
73025,6,3,254962,254962,254965,0,3,4
73026,4,2,254966,254966,254968,0,2,1
73027,4,1,254970,254970,254971,0,1,2
73028,3,2,254973,254973,254975,0,2,2
73029,6,1,254979,254979,254980,0,1,4
73030,5,1,254984,254984,254985,0,1,4
73031,3,1,254987,254987,254988,0,1,2
73032,6,3,254993,254993,254996,0,3,5
73033,3,2,254996,254996,254998,0,2,0
73034,5,3,255001,255001,255004,0,3,3
73035,2,3,255003,255004,255007,1,4,0
73036,5,2,255008,255008,255010,0,2,1
73037,6,1,255014,255014,255015,0,1,4
73038,3,1,255017,255017,255018,0,1,2
73039,4,2,255021,255021,255023,0,2,3
73040,3,1,255024,255024,255025,0,1,1
73041,3,2,255027,255027,255029,0,2,2
73042,5,1,255032,255032,255033,0,1,3
73043,2,1,255034,255034,255035,0,1,1
73044,2,3,255036,255036,255039,0,3,1
73045,2,2,255038,255039,255041,1,3,0
73046,3,1,255041,255041,255042,0,1,0
73047,4,2,255045,255045,255047,0,2,3
73048,5,1,255050,255050,255051,0,1,3
73049,2,2,255052,255052,255054,0,2,1
73050,5,3,255057,255057,255060,0,3,3
73051,5,2,255062,255062,255064,0,2,2
73052,3,3,255065,255065,255068,0,3,1
73053,2,3,255067,255068,255071,1,4,0
73054,5,2,255072,255072,255074,0,2,1
73055,3,2,255075,255075,255077,0,2,1
73056,1,2,255076,255077,255079,1,3,0
73057,5,3,255081,255081,255084,0,3,2
73058,2,3,255083,255084,255087,1,4,0
73059,2,3,255085,255087,255090,2,5,0
73060,1,3,255086,255090,255093,4,7,0
73061,5,3,255091,255093,255096,2,5,0
73062,2,3,255093,255096,255099,3,6,0
73063,3,2,255096,255099,255101,3,5,0
73064,5,2,255101,255101,255103,0,2,0
73065,1,2,255102,255103,255105,1,3,0
73066,5,3,255107,255107,255110,0,3,2
73067,4,3,255111,255111,255114,0,3,1
73068,1,1,255112,255114,255115,2,3,0
73069,2,3,255114,255115,255118,1,4,0
73070,6,3,255120,255120,255123,0,3,2
73071,5,1,255125,255125,255126,0,1,2
73072,1,1,255126,255126,255127,0,1,0
73073,6,3,255132,255132,255135,0,3,5
73074,1,2,255133,255135,255137,2,4,0
73075,3,1,255136,255137,255138,1,2,0
73076,3,1,255139,255139,255140,0,1,1
73077,4,1,255143,255143,255144,0,1,3
73078,5,3,255148,255148,255151,0,3,4
73079,1,2,255149,255151,255153,2,4,0
73080,1,1,255150,255153,255154,3,4,0
73081,5,1,255155,255155,255156,0,1,1
73082,4,3,255159,255159,255162,0,3,3
73083,4,1,255163,255163,255164,0,1,1
73084,4,2,255167,255167,255169,0,2,3
73085,4,3,255171,255171,255174,0,3,2
73086,2,3,255173,255174,255177,1,4,0
73087,4,2,255177,255177,255179,0,2,0
73088,4,3,255181,255181,255184,0,3,2
73089,2,2,255183,255184,255186,1,3,0
73090,1,2,255184,255186,255188,2,4,0
73091,6,2,255190,255190,255192,0,2,2
73092,4,1,255194,255194,255195,0,1,2
73093,5,2,255199,255199,255201,0,2,4
73094,4,3,255203,255203,255206,0,3,2
73095,3,1,255206,255206,255207,0,1,0
73096,6,1,255212,255212,255213,0,1,5
73097,4,3,255216,255216,255219,0,3,3
73098,1,3,255217,255219,255222,2,5,0
73099,2,1,255219,255222,255223,3,4,0
73100,1,2,255220,255223,255225,3,5,0
73101,4,1,255224,255225,255226,1,2,0
73102,1,2,255225,255226,255228,1,3,0
73103,1,2,255226,255228,255230,2,4,0
73104,2,3,255228,255230,255233,2,5,0
73105,2,1,255230,255233,255234,3,4,0
73106,5,2,255235,255235,255237,0,2,1
73107,5,2,255240,255240,255242,0,2,3
73108,6,1,255246,255246,255247,0,1,4
73109,3,1,255249,255249,255250,0,1,2
73110,5,2,255254,255254,255256,0,2,4
73111,5,1,255259,255259,255260,0,1,3
73112,1,3,255260,255260,255263,0,3,0
73113,3,3,255263,255263,255266,0,3,0
73114,4,2,255267,255267,255269,0,2,1
73115,2,1,255269,255269,255270,0,1,0
73116,1,1,255270,255270,255271,0,1,0
73117,4,3,255274,255274,255277,0,3,3
73118,3,2,255277,255277,255279,0,2,0
73119,4,3,255281,255281,255284,0,3,2
73120,2,1,255283,255284,255285,1,2,0
73121,3,1,255286,255286,255287,0,1,1
73122,5,2,255291,255291,255293,0,2,4
73123,6,2,255297,255297,255299,0,2,4
73124,5,2,255302,255302,255304,0,2,3
73125,5,3,255307,255307,255310,0,3,3
73126,2,2,255309,255310,255312,1,3,0
73127,1,3,255310,255312,255315,2,5,0
73128,3,1,255313,255315,255316,2,3,0
73129,6,2,255319,255319,255321,0,2,3
73130,3,3,255322,255322,255325,0,3,1
73131,3,2,255325,255325,255327,0,2,0
73132,3,1,255328,255328,255329,0,1,1
73133,6,2,255334,255334,255336,0,2,5
73134,1,1,255335,255336,255337,1,2,0
73135,1,2,255336,255337,255339,1,3,0
73136,3,1,255339,255339,255340,0,1,0
73137,6,1,255345,255345,255346,0,1,5
73138,1,1,255346,255346,255347,0,1,0
73139,4,1,255350,255350,255351,0,1,3
73140,3,2,255353,255353,255355,0,2,2
73141,2,2,255355,255355,255357,0,2,0
73142,2,3,255357,255357,255360,0,3,0
73143,6,1,255363,255363,255364,0,1,3
73144,2,3,255365,255365,255368,0,3,1
73145,2,2,255367,255368,255370,1,3,0
73146,5,2,255372,255372,255374,0,2,2
73147,4,1,255376,255376,255377,0,1,2
73148,2,2,255378,255378,255380,0,2,1
73149,6,1,255384,255384,255385,0,1,4
73150,3,1,255387,255387,255388,0,1,2
73151,3,2,255390,255390,255392,0,2,2
73152,6,3,255396,255396,255399,0,3,4
73153,5,3,255401,255401,255404,0,3,2
73154,6,2,255407,255407,255409,0,2,3
73155,6,3,255413,255413,255416,0,3,4
73156,1,1,255414,255416,255417,2,3,0
73157,1,3,255415,255417,255420,2,5,0
73158,1,2,255416,255420,255422,4,6,0
73159,1,2,255417,255422,255424,5,7,0
73160,6,2,255423,255424,255426,1,3,0
73161,6,1,255429,255429,255430,0,1,3
73162,3,1,255432,255432,255433,0,1,2
73163,4,3,255436,255436,255439,0,3,3
73164,4,3,255440,255440,255443,0,3,1
73165,4,1,255444,255444,255445,0,1,1
73166,6,3,255450,255450,255453,0,3,5
73167,3,3,255453,255453,255456,0,3,0
73168,6,2,255459,255459,255461,0,2,3
73169,2,2,255461,255461,255463,0,2,0
73170,1,3,255462,255463,255466,1,4,0
73171,6,3,255468,255468,255471,0,3,2
73172,5,3,255473,255473,255476,0,3,2
73173,1,3,255474,255476,255479,2,5,0
73174,5,2,255479,255479,255481,0,2,0
73175,6,1,255485,255485,255486,0,1,4
73176,2,2,255487,255487,255489,0,2,1
73177,2,1,255489,255489,255490,0,1,0
73178,4,3,255493,255493,255496,0,3,3
73179,6,2,255499,255499,255501,0,2,3
73180,4,3,255503,255503,255506,0,3,2
73181,4,3,255507,255507,255510,0,3,1
73182,5,2,255512,255512,255514,0,2,2
73183,6,1,255518,255518,255519,0,1,4
73184,5,1,255523,255523,255524,0,1,4
73185,2,2,255525,255525,255527,0,2,1
73186,2,3,255527,255527,255530,0,3,0
73187,3,2,255530,255530,255532,0,2,0
73188,3,1,255533,255533,255534,0,1,1
73189,3,1,255536,255536,255537,0,1,2
73190,1,2,255537,255537,255539,0,2,0
73191,2,1,255539,255539,255540,0,1,0
73192,3,3,255542,255542,255545,0,3,2
73193,4,2,255546,255546,255548,0,2,1
73194,4,1,255550,255550,255551,0,1,2
73195,2,3,255552,255552,255555,0,3,1
73196,1,3,255553,255555,255558,2,5,0
73197,5,3,255558,255558,255561,0,3,0
73198,3,2,255561,255561,255563,0,2,0
73199,3,2,255564,255564,255566,0,2,1
73200,1,3,255565,255566,255569,1,4,0
73201,6,1,255571,255571,255572,0,1,2
73202,3,1,255574,255574,255575,0,1,2
73203,2,2,255576,255576,255578,0,2,1
73204,4,2,255580,255580,255582,0,2,2
73205,6,2,255586,255586,255588,0,2,4
73206,5,3,255591,255591,255594,0,3,3
73207,1,3,255592,255594,255597,2,5,0
73208,3,3,255595,255597,255600,2,5,0
73209,6,1,255601,255601,255602,0,1,1
73210,3,3,255604,255604,255607,0,3,2
73211,2,3,255606,255607,255610,1,4,0
73212,6,2,255612,255612,255614,0,2,2
73213,1,2,255613,255614,255616,1,3,0
73214,4,3,255617,255617,255620,0,3,1
73215,4,2,255621,255621,255623,0,2,1
73216,5,3,255626,255626,255629,0,3,3
73217,6,1,255632,255632,255633,0,1,3
73218,6,1,255638,255638,255639,0,1,5
73219,3,2,255641,255641,255643,0,2,2
73220,1,2,255642,255643,255645,1,3,0
73221,1,1,255643,255645,255646,2,3,0
73222,4,2,255647,255647,255649,0,2,1
73223,2,1,255649,255649,255650,0,1,0
73224,3,1,255652,255652,255653,0,1,2
73225,6,1,255658,255658,255659,0,1,5
73226,3,2,255661,255661,255663,0,2,2
73227,1,1,255662,255663,255664,1,2,0
73228,3,1,255665,255665,255666,0,1,1
73229,3,2,255668,255668,255670,0,2,2
73230,2,2,255670,255670,255672,0,2,0
73231,6,2,255676,255676,255678,0,2,4
73232,5,1,255681,255681,255682,0,1,3
73233,3,2,255684,255684,255686,0,2,2
73234,2,1,255686,255686,255687,0,1,0
73235,6,3,255692,255692,255695,0,3,5
73236,2,1,255694,255695,255696,1,2,0
73237,2,1,255696,255696,255697,0,1,0
73238,2,3,255698,255698,255701,0,3,1
73239,2,3,255700,255701,255704,1,4,0
73240,1,2,255701,255704,255706,3,5,0
73241,6,1,255707,255707,255708,0,1,1
73242,6,3,255713,255713,255716,0,3,5
73243,1,1,255714,255716,255717,2,3,0
73244,2,3,255716,255717,255720,1,4,0
73245,3,1,255719,255720,255721,1,2,0
73246,3,2,255722,255722,255724,0,2,1
73247,3,1,255725,255725,255726,0,1,1
73248,2,2,255727,255727,255729,0,2,1
73249,4,1,255731,255731,255732,0,1,2
73250,3,3,255734,255734,255737,0,3,2
73251,4,2,255738,255738,255740,0,2,1
73252,4,1,255742,255742,255743,0,1,2
73253,3,3,255745,255745,255748,0,3,2
73254,5,1,255750,255750,255751,0,1,2
73255,1,3,255751,255751,255754,0,3,0
73256,1,2,255752,255754,255756,2,4,0
73257,2,3,255754,255756,255759,2,5,0
73258,4,2,255758,255759,255761,1,3,0
73259,3,2,255761,255761,255763,0,2,0
73260,6,1,255767,255767,255768,0,1,4
73261,5,1,255772,255772,255773,0,1,4
73262,3,3,255775,255775,255778,0,3,2
73263,6,3,255781,255781,255784,0,3,3
73264,6,1,255787,255787,255788,0,1,3
73265,1,3,255788,255788,255791,0,3,0
73266,4,1,255792,255792,255793,0,1,1
73267,1,1,255793,255793,255794,0,1,0
73268,5,3,255798,255798,255801,0,3,4
73269,4,2,255802,255802,255804,0,2,1
73270,4,3,255806,255806,255809,0,3,2
73271,1,3,255807,255809,255812,2,5,0
73272,2,2,255809,255812,255814,3,5,0
73273,2,1,255811,255814,255815,3,4,0
73274,4,1,255815,255815,255816,0,1,0
73275,5,1,255820,255820,255821,0,1,4
73276,1,3,255821,255821,255824,0,3,0
73277,1,2,255822,255824,255826,2,4,0
73278,1,1,255823,255826,255827,3,4,0
73279,1,2,255824,255827,255829,3,5,0
73280,3,3,255827,255829,255832,2,5,0
73281,4,2,255831,255832,255834,1,3,0
73282,2,3,255833,255834,255837,1,4,0
73283,2,1,255835,255837,255838,2,3,0
73284,6,3,255841,255841,255844,0,3,3
73285,5,2,255846,255846,255848,0,2,2
73286,6,1,255852,255852,255853,0,1,4
73287,6,2,255858,255858,255860,0,2,5
73288,1,2,255859,255860,255862,1,3,0
73289,4,3,255863,255863,255866,0,3,1
73290,2,3,255865,255866,255869,1,4,0
73291,3,1,255868,255869,255870,1,2,0
73292,2,3,255870,255870,255873,0,3,0
73293,4,1,255874,255874,255875,0,1,1
73294,4,3,255878,255878,255881,0,3,3
73295,3,2,255881,255881,255883,0,2,0
73296,6,2,255887,255887,255889,0,2,4
73297,4,3,255891,255891,255894,0,3,2
73298,2,1,255893,255894,255895,1,2,0
73299,5,1,255898,255898,255899,0,1,3
73300,3,3,255901,255901,255904,0,3,2
73301,6,1,255907,255907,255908,0,1,3
73302,2,3,255909,255909,255912,0,3,1
73303,4,3,255913,255913,255916,0,3,1
73304,3,3,255916,255916,255919,0,3,0
73305,5,2,255921,255921,255923,0,2,2
73306,2,3,255923,255923,255926,0,3,0
73307,5,1,255928,255928,255929,0,1,2
73308,3,3,255931,255931,255934,0,3,2
73309,3,2,255934,255934,255936,0,2,0
73310,3,3,255937,255937,255940,0,3,1
73311,3,3,255940,255940,255943,0,3,0
73312,5,2,255945,255945,255947,0,2,2
73313,6,3,255951,255951,255954,0,3,4
73314,1,3,255952,255954,255957,2,5,0
73315,6,3,255958,255958,255961,0,3,1
73316,1,1,255959,255961,255962,2,3,0
73317,2,2,255961,255962,255964,1,3,0
73318,6,1,255967,255967,255968,0,1,3
73319,3,2,255970,255970,255972,0,2,2
73320,1,2,255971,255972,255974,1,3,0
73321,2,3,255973,255974,255977,1,4,0
73322,6,3,255979,255979,255982,0,3,2
73323,3,1,255982,255982,255983,0,1,0
73324,1,2,255983,255983,255985,0,2,0
73325,3,2,255986,255986,255988,0,2,1
73326,6,2,255992,255992,255994,0,2,4
73327,2,2,255994,255994,255996,0,2,0
73328,4,3,255998,255998,256001,0,3,2
73329,6,2,256004,256004,256006,0,2,3
73330,1,2,256005,256006,256008,1,3,0
73331,3,1,256008,256008,256009,0,1,0
73332,2,1,256010,256010,256011,0,1,1
73333,1,3,256011,256011,256014,0,3,0
73334,4,2,256015,256015,256017,0,2,1
73335,2,1,256017,256017,256018,0,1,0
73336,6,3,256023,256023,256026,0,3,5
73337,3,2,256026,256026,256028,0,2,0
73338,4,3,256030,256030,256033,0,3,2
73339,1,1,256031,256033,256034,2,3,0
73340,4,3,256035,256035,256038,0,3,1
73341,6,3,256041,256041,256044,0,3,3
73342,3,3,256044,256044,256047,0,3,0
73343,2,1,256046,256047,256048,1,2,0
73344,2,2,256048,256048,256050,0,2,0
73345,1,1,256049,256050,256051,1,2,0
73346,2,2,256051,256051,256053,0,2,0
73347,1,3,256052,256053,256056,1,4,0
73348,1,1,256053,256056,256057,3,4,0
73349,4,1,256057,256057,256058,0,1,0
73350,6,3,256063,256063,256066,0,3,5
73351,1,3,256064,256066,256069,2,5,0
73352,5,3,256069,256069,256072,0,3,0
73353,4,3,256073,256073,256076,0,3,1
73354,5,2,256078,256078,256080,0,2,2
73355,1,3,256079,256080,256083,1,4,0
73356,2,2,256081,256083,256085,2,4,0
73357,6,2,256087,256087,256089,0,2,2
73358,3,1,256090,256090,256091,0,1,1
73359,4,3,256094,256094,256097,0,3,3
73360,5,1,256099,256099,256100,0,1,2
73361,5,1,256104,256104,256105,0,1,4
73362,5,2,256109,256109,256111,0,2,4
73363,4,2,256113,256113,256115,0,2,2
73364,1,1,256114,256115,256116,1,2,0
73365,2,3,256116,256116,256119,0,3,0
73366,2,2,256118,256119,256121,1,3,0
73367,3,2,256121,256121,256123,0,2,0
73368,5,3,256126,256126,256129,0,3,3
73369,2,3,256128,256129,256132,1,4,0
73370,2,2,256130,256132,256134,2,4,0
73371,4,3,256134,256134,256137,0,3,0
73372,1,2,256135,256137,256139,2,4,0
73373,1,3,256136,256139,256142,3,6,0
73374,2,1,256138,256142,256143,4,5,0
73375,6,1,256144,256144,256145,0,1,1
73376,6,2,256150,256150,256152,0,2,5
73377,1,2,256151,256152,256154,1,3,0
73378,4,3,256155,256155,256158,0,3,1
73379,3,1,256158,256158,256159,0,1,0
73380,6,1,256164,256164,256165,0,1,5
73381,2,3,256166,256166,256169,0,3,1
73382,2,3,256168,256169,256172,1,4,0
73383,6,2,256174,256174,256176,0,2,2
73384,3,3,256177,256177,256180,0,3,1
73385,1,3,256178,256180,256183,2,5,0
73386,6,1,256184,256184,256185,0,1,1
73387,2,1,256186,256186,256187,0,1,1
73388,1,1,256187,256187,256188,0,1,0
73389,3,1,256190,256190,256191,0,1,2
73390,1,2,256191,256191,256193,0,2,0
73391,4,1,256195,256195,256196,0,1,2
73392,6,1,256201,256201,256202,0,1,5
73393,3,1,256204,256204,256205,0,1,2
73394,6,3,256210,256210,256213,0,3,5
73395,6,2,256216,256216,256218,0,2,3
73396,5,1,256221,256221,256222,0,1,3
73397,5,2,256226,256226,256228,0,2,4
73398,3,1,256229,256229,256230,0,1,1
73399,2,3,256231,256231,256234,0,3,1
73400,1,1,256232,256234,256235,2,3,0
73401,2,2,256234,256235,256237,1,3,0
73402,6,2,256240,256240,256242,0,2,3
73403,1,3,256241,256242,256245,1,4,0
73404,1,3,256242,256245,256248,3,6,0
73405,3,2,256245,256248,256250,3,5,0
73406,3,2,256248,256250,256252,2,4,0
73407,6,1,256254,256254,256255,0,1,2
73408,5,2,256259,256259,256261,0,2,4
73409,2,2,256261,256261,256263,0,2,0
73410,5,3,256266,256266,256269,0,3,3
73411,4,2,256270,256270,256272,0,2,1
73412,6,3,256276,256276,256279,0,3,4
73413,1,2,256277,256279,256281,2,4,0
73414,2,1,256279,256281,256282,2,3,0
73415,2,1,256281,256282,256283,1,2,0
73416,3,1,256284,256284,256285,0,1,1
73417,1,3,256285,256285,256288,0,3,0
73418,4,1,256289,256289,256290,0,1,1
73419,3,1,256292,256292,256293,0,1,2
73420,3,1,256295,256295,256296,0,1,2
73421,4,2,256299,256299,256301,0,2,3
73422,5,2,256304,256304,256306,0,2,3
73423,3,1,256307,256307,256308,0,1,1
73424,1,3,256308,256308,256311,0,3,0
73425,5,3,256313,256313,256316,0,3,2
73426,3,1,256316,256316,256317,0,1,0
73427,2,3,256318,256318,256321,0,3,1
73428,2,3,256320,256321,256324,1,4,0
73429,5,3,256325,256325,256328,0,3,1
73430,1,3,256326,256328,256331,2,5,0
73431,1,2,256327,256331,256333,4,6,0
73432,3,1,256330,256333,256334,3,4,0
73433,5,2,256335,256335,256337,0,2,1
73434,3,1,256338,256338,256339,0,1,1
73435,4,2,256342,256342,256344,0,2,3
73436,4,2,256346,256346,256348,0,2,2
73437,6,1,256352,256352,256353,0,1,4
73438,2,3,256354,256354,256357,0,3,1
73439,6,1,256360,256360,256361,0,1,3
73440,2,1,256362,256362,256363,0,1,1
73441,3,2,256365,256365,256367,0,2,2
73442,4,1,256369,256369,256370,0,1,2
73443,2,1,256371,256371,256372,0,1,1
73444,2,2,256373,256373,256375,0,2,1
73445,6,3,256379,256379,256382,0,3,4
73446,5,1,256384,256384,256385,0,1,2
73447,2,2,256386,256386,256388,0,2,1
73448,6,1,256392,256392,256393,0,1,4
73449,5,3,256397,256397,256400,0,3,4
73450,1,1,256398,256400,256401,2,3,0
73451,1,2,256399,256401,256403,2,4,0
73452,2,2,256401,256403,256405,2,4,0
73453,6,3,256407,256407,256410,0,3,2
73454,6,2,256413,256413,256415,0,2,3
73455,5,3,256418,256418,256421,0,3,3
73456,3,3,256421,256421,256424,0,3,0
73457,2,3,256423,256424,256427,1,4,0
73458,5,2,256428,256428,256430,0,2,1
73459,4,3,256432,256432,256435,0,3,2
73460,4,2,256436,256436,256438,0,2,1
73461,4,2,256440,256440,256442,0,2,2
73462,4,1,256444,256444,256445,0,1,2
73463,5,1,256449,256449,256450,0,1,4
73464,3,3,256452,256452,256455,0,3,2
73465,3,2,256455,256455,256457,0,2,0
73466,1,2,256456,256457,256459,1,3,0
73467,5,1,256461,256461,256462,0,1,2
73468,6,3,256467,256467,256470,0,3,5
73469,5,2,256472,256472,256474,0,2,2
73470,4,2,256476,256476,256478,0,2,2
73471,4,3,256480,256480,256483,0,3,2
73472,3,3,256483,256483,256486,0,3,0
73473,2,3,256485,256486,256489,1,4,0
73474,2,2,256487,256489,256491,2,4,0
73475,1,2,256488,256491,256493,3,5,0
73476,6,2,256494,256494,256496,0,2,1
73477,3,2,256497,256497,256499,0,2,1
73478,2,3,256499,256499,256502,0,3,0
73479,1,1,256500,256502,256503,2,3,0
73480,3,3,256503,256503,256506,0,3,0
73481,5,2,256508,256508,256510,0,2,2
73482,3,2,256511,256511,256513,0,2,1
73483,3,1,256514,256514,256515,0,1,1
73484,2,1,256516,256516,256517,0,1,1
73485,4,3,256520,256520,256523,0,3,3
73486,1,2,256521,256523,256525,2,4,0
73487,1,2,256522,256525,256527,3,5,0
73488,3,3,256525,256527,256530,2,5,0
73489,2,3,256527,256530,256533,3,6,0
73490,3,1,256530,256533,256534,3,4,0
73491,5,2,256535,256535,256537,0,2,1
73492,5,1,256540,256540,256541,0,1,3
73493,6,3,256546,256546,256549,0,3,5
73494,5,1,256551,256551,256552,0,1,2
73495,1,2,256552,256552,256554,0,2,0
73496,4,2,256556,256556,256558,0,2,2
73497,2,3,256558,256558,256561,0,3,0
73498,4,3,256562,256562,256565,0,3,1
73499,3,1,256565,256565,256566,0,1,0
73500,5,3,256570,256570,256573,0,3,4
73501,5,3,256575,256575,256578,0,3,2
73502,4,1,256579,256579,256580,0,1,1
73503,4,1,256583,256583,256584,0,1,3
73504,4,1,256587,256587,256588,0,1,3
73505,6,3,256593,256593,256596,0,3,5
73506,3,3,256596,256596,256599,0,3,0
73507,5,3,256601,256601,256604,0,3,2
73508,5,2,256606,256606,256608,0,2,2
73509,4,2,256610,256610,256612,0,2,2
73510,4,1,256614,256614,256615,0,1,2
73511,2,2,256616,256616,256618,0,2,1
73512,4,2,256620,256620,256622,0,2,2
73513,3,1,256623,256623,256624,0,1,1
73514,6,2,256629,256629,256631,0,2,5
73515,3,3,256632,256632,256635,0,3,1
73516,1,3,256633,256635,256638,2,5,0
73517,4,1,256637,256638,256639,1,2,0
73518,2,3,256639,256639,256642,0,3,0
73519,6,2,256645,256645,256647,0,2,3
73520,5,2,256650,256650,256652,0,2,3
73521,2,2,256652,256652,256654,0,2,0
73522,2,1,256654,256654,256655,0,1,0
73523,2,1,256656,256656,256657,0,1,1
73524,1,1,256657,256657,256658,0,1,0
73525,1,1,256658,256658,256659,0,1,0
73526,1,2,256659,256659,256661,0,2,0
73527,4,3,256663,256663,256666,0,3,2
73528,2,2,256665,256666,256668,1,3,0
73529,1,2,256666,256668,256670,2,4,0
73530,2,1,256668,256670,256671,2,3,0
73531,2,2,256670,256671,256673,1,3,0
73532,3,1,256673,256673,256674,0,1,0
73533,2,2,256675,256675,256677,0,2,1
73534,2,1,256677,256677,256678,0,1,0
73535,1,1,256678,256678,256679,0,1,0
73536,4,1,256682,256682,256683,0,1,3
73537,6,2,256688,256688,256690,0,2,5
73538,4,1,256692,256692,256693,0,1,2
73539,4,1,256696,256696,256697,0,1,3
73540,2,1,256698,256698,256699,0,1,1
73541,3,3,256701,256701,256704,0,3,2
73542,2,1,256703,256704,256705,1,2,0
73543,5,1,256708,256708,256709,0,1,3
73544,3,2,256711,256711,256713,0,2,2
73545,5,2,256716,256716,256718,0,2,3
73546,2,1,256718,256718,256719,0,1,0
73547,4,2,256722,256722,256724,0,2,3
73548,4,3,256726,256726,256729,0,3,2
73549,1,1,256727,256729,256730,2,3,0
73550,2,1,256729,256730,256731,1,2,0
73551,3,3,256732,256732,256735,0,3,1
73552,5,3,256737,256737,256740,0,3,2
73553,1,1,256738,256740,256741,2,3,0
73554,1,1,256739,256741,256742,2,3,0
73555,5,2,256744,256744,256746,0,2,2
73556,2,3,256746,256746,256749,0,3,0
73557,1,2,256747,256749,256751,2,4,0
73558,1,3,256748,256751,256754,3,6,0
73559,3,3,256751,256754,256757,3,6,0
73560,4,2,256755,256757,256759,2,4,0
73561,3,1,256758,256759,256760,1,2,0
73562,2,1,256760,256760,256761,0,1,0
73563,1,3,256761,256761,256764,0,3,0
73564,2,3,256763,256764,256767,1,4,0
73565,1,3,256764,256767,256770,3,6,0
73566,6,3,256770,256770,256773,0,3,0
73567,3,1,256773,256773,256774,0,1,0
73568,1,1,256774,256774,256775,0,1,0
73569,5,3,256779,256779,256782,0,3,4
73570,5,1,256784,256784,256785,0,1,2
73571,4,1,256788,256788,256789,0,1,3
73572,5,2,256793,256793,256795,0,2,4
73573,1,2,256794,256795,256797,1,3,0
73574,6,3,256800,256800,256803,0,3,3
73575,1,1,256801,256803,256804,2,3,0
73576,1,1,256802,256804,256805,2,3,0
73577,1,1,256803,256805,256806,2,3,0
73578,4,1,256807,256807,256808,0,1,1
73579,6,2,256813,256813,256815,0,2,5
73580,3,3,256816,256816,256819,0,3,1
73581,3,1,256819,256819,256820,0,1,0
73582,1,1,256820,256820,256821,0,1,0
73583,1,1,256821,256821,256822,0,1,0
73584,4,1,256825,256825,256826,0,1,3
73585,4,3,256829,256829,256832,0,3,3
73586,1,2,256830,256832,256834,2,4,0
73587,4,2,256834,256834,256836,0,2,0
73588,3,3,256837,256837,256840,0,3,1
73589,4,2,256841,256841,256843,0,2,1
73590,3,1,256844,256844,256845,0,1,1
73591,6,2,256850,256850,256852,0,2,5
73592,4,1,256854,256854,256855,0,1,2
73593,1,3,256855,256855,256858,0,3,0
73594,2,1,256857,256858,256859,1,2,0
73595,4,1,256861,256861,256862,0,1,2
73596,4,2,256865,256865,256867,0,2,3
73597,2,1,256867,256867,256868,0,1,0
73598,4,1,256871,256871,256872,0,1,3
73599,2,1,256873,256873,256874,0,1,1
73600,1,2,256874,256874,256876,0,2,0
73601,6,1,256880,256880,256881,0,1,4
73602,1,1,256881,256881,256882,0,1,0
73603,2,1,256883,256883,256884,0,1,1
73604,1,1,256884,256884,256885,0,1,0
73605,1,1,256885,256885,256886,0,1,0
73606,1,1,256886,256886,256887,0,1,0
73607,4,3,256890,256890,256893,0,3,3
73608,5,3,256895,256895,256898,0,3,2
73609,3,1,256898,256898,256899,0,1,0
73610,5,2,256903,256903,256905,0,2,4
73611,2,3,256905,256905,256908,0,3,0
73612,1,2,256906,256908,256910,2,4,0
73613,3,1,256909,256910,256911,1,2,0
73614,3,1,256912,256912,256913,0,1,1
73615,3,3,256915,256915,256918,0,3,2
73616,5,3,256920,256920,256923,0,3,2
73617,2,1,256922,256923,256924,1,2,0
73618,2,1,256924,256924,256925,0,1,0
73619,6,2,256930,256930,256932,0,2,5
73620,1,3,256931,256932,256935,1,4,0
73621,3,1,256934,256935,256936,1,2,0
73622,3,2,256937,256937,256939,0,2,1
73623,6,3,256943,256943,256946,0,3,4
73624,6,2,256949,256949,256951,0,2,3
73625,6,3,256955,256955,256958,0,3,4
73626,4,2,256959,256959,256961,0,2,1
73627,6,1,256965,256965,256966,0,1,4
73628,5,2,256970,256970,256972,0,2,4
73629,3,2,256973,256973,256975,0,2,1
73630,6,3,256979,256979,256982,0,3,4
73631,2,2,256981,256982,256984,1,3,0
73632,6,2,256987,256987,256989,0,2,3
73633,3,1,256990,256990,256991,0,1,1
73634,5,2,256995,256995,256997,0,2,4
73635,6,3,257001,257001,257004,0,3,4
73636,3,1,257004,257004,257005,0,1,0
73637,5,2,257009,257009,257011,0,2,4
73638,4,3,257013,257013,257016,0,3,2
73639,2,1,257015,257016,257017,1,2,0
73640,1,1,257016,257017,257018,1,2,0
73641,5,2,257021,257021,257023,0,2,3
73642,6,1,257027,257027,257028,0,1,4
73643,4,1,257031,257031,257032,0,1,3
73644,1,1,257032,257032,257033,0,1,0
73645,1,1,257033,257033,257034,0,1,0
73646,4,1,257037,257037,257038,0,1,3
73647,3,2,257040,257040,257042,0,2,2
73648,5,1,257045,257045,257046,0,1,3
73649,2,2,257047,257047,257049,0,2,1
73650,5,3,257052,257052,257055,0,3,3
73651,4,3,257056,257056,257059,0,3,1
73652,4,1,257060,257060,257061,0,1,1
73653,2,1,257062,257062,257063,0,1,1
73654,6,2,257068,257068,257070,0,2,5
73655,4,3,257072,257072,257075,0,3,2
73656,6,3,257078,257078,257081,0,3,3
73657,5,3,257083,257083,257086,0,3,2
73658,2,3,257085,257086,257089,1,4,0
73659,6,3,257091,257091,257094,0,3,2
73660,2,1,257093,257094,257095,1,2,0
73661,6,1,257099,257099,257100,0,1,4
73662,6,1,257105,257105,257106,0,1,5
73663,2,1,257107,257107,257108,0,1,1
73664,6,3,257113,257113,257116,0,3,5
73665,5,1,257118,257118,257119,0,1,2
73666,4,1,257122,257122,257123,0,1,3
73667,6,1,257128,257128,257129,0,1,5
73668,1,1,257129,257129,257130,0,1,0
73669,6,3,257135,257135,257138,0,3,5
73670,6,1,257141,257141,257142,0,1,3
73671,2,1,257143,257143,257144,0,1,1
73672,3,1,257146,257146,257147,0,1,2
73673,5,1,257151,257151,257152,0,1,4
73674,6,3,257157,257157,257160,0,3,5
73675,6,1,257163,257163,257164,0,1,3
73676,6,3,257169,257169,257172,0,3,5
73677,4,2,257173,257173,257175,0,2,1
73678,1,3,257174,257175,257178,1,4,0
73679,1,2,257175,257178,257180,3,5,0
73680,4,3,257179,257180,257183,1,4,0
73681,4,2,257183,257183,257185,0,2,0
73682,1,1,257184,257185,257186,1,2,0
73683,3,2,257187,257187,257189,0,2,1
73684,4,3,257191,257191,257194,0,3,2
73685,6,3,257197,257197,257200,0,3,3
73686,6,1,257203,257203,257204,0,1,3
73687,1,1,257204,257204,257205,0,1,0
73688,5,1,257209,257209,257210,0,1,4
73689,4,3,257213,257213,257216,0,3,3
73690,5,2,257218,257218,257220,0,2,2
73691,4,1,257222,257222,257223,0,1,2
73692,6,1,257228,257228,257229,0,1,5
73693,3,2,257231,257231,257233,0,2,2
73694,4,3,257235,257235,257238,0,3,2
73695,2,2,257237,257238,257240,1,3,0
73696,3,3,257240,257240,257243,0,3,0
73697,5,1,257245,257245,257246,0,1,2
73698,1,3,257246,257246,257249,0,3,0
73699,2,3,257248,257249,257252,1,4,0
73700,6,1,257254,257254,257255,0,1,2
73701,1,2,257255,257255,257257,0,2,0
73702,4,3,257259,257259,257262,0,3,2
73703,2,3,257261,257262,257265,1,4,0
73704,2,3,257263,257265,257268,2,5,0
73705,6,3,257269,257269,257272,0,3,1
73706,6,1,257275,257275,257276,0,1,3
73707,4,3,257279,257279,257282,0,3,3
73708,6,1,257285,257285,257286,0,1,3
73709,5,1,257290,257290,257291,0,1,4
73710,1,3,257291,257291,257294,0,3,0
73711,2,2,257293,257294,257296,1,3,0
73712,1,3,257294,257296,257299,2,5,0
73713,1,2,257295,257299,257301,4,6,0
73714,4,2,257299,257301,257303,2,4,0
73715,5,3,257304,257304,257307,0,3,1
73716,4,2,257308,257308,257310,0,2,1
73717,4,3,257312,257312,257315,0,3,2
73718,6,2,257318,257318,257320,0,2,3
73719,3,3,257321,257321,257324,0,3,1
73720,2,2,257323,257324,257326,1,3,0
73721,3,3,257326,257326,257329,0,3,0
73722,2,3,257328,257329,257332,1,4,0
73723,3,2,257331,257332,257334,1,3,0
73724,4,3,257335,257335,257338,0,3,1
73725,6,1,257341,257341,257342,0,1,3
73726,2,3,257343,257343,257346,0,3,1
73727,4,1,257347,257347,257348,0,1,1
73728,6,3,257353,257353,257356,0,3,5
73729,5,1,257358,257358,257359,0,1,2
73730,4,1,257362,257362,257363,0,1,3
73731,5,2,257367,257367,257369,0,2,4
73732,1,2,257368,257369,257371,1,3,0
73733,2,3,257370,257371,257374,1,4,0
73734,1,3,257371,257374,257377,3,6,0
73735,3,1,257374,257377,257378,3,4,0
73736,5,2,257379,257379,257381,0,2,1
73737,4,1,257383,257383,257384,0,1,2
73738,4,2,257387,257387,257389,0,2,3
73739,6,1,257393,257393,257394,0,1,4
73740,5,3,257398,257398,257401,0,3,4
73741,5,2,257403,257403,257405,0,2,2
73742,1,2,257404,257405,257407,1,3,0
73743,3,3,257407,257407,257410,0,3,0
73744,2,2,257409,257410,257412,1,3,0
73745,2,3,257411,257412,257415,1,4,0
73746,5,1,257416,257416,257417,0,1,1
73747,2,2,257418,257418,257420,0,2,1
73748,3,1,257421,257421,257422,0,1,1
73749,2,1,257423,257423,257424,0,1,1
73750,6,2,257429,257429,257431,0,2,5
73751,5,1,257434,257434,257435,0,1,3
73752,2,3,257436,257436,257439,0,3,1
73753,2,1,257438,257439,257440,1,2,0
73754,4,3,257442,257442,257445,0,3,2
73755,2,3,257444,257445,257448,1,4,0
73756,6,3,257450,257450,257453,0,3,2
73757,2,3,257452,257453,257456,1,4,0
73758,2,1,257454,257456,257457,2,3,0
73759,3,3,257457,257457,257460,0,3,0
73760,6,3,257463,257463,257466,0,3,3
73761,2,2,257465,257466,257468,1,3,0
73762,2,1,257467,257468,257469,1,2,0
73763,3,1,257470,257470,257471,0,1,1
73764,1,2,257471,257471,257473,0,2,0
73765,6,1,257477,257477,257478,0,1,4
73766,1,3,257478,257478,257481,0,3,0
73767,4,1,257482,257482,257483,0,1,1
73768,6,1,257488,257488,257489,0,1,5
73769,6,2,257494,257494,257496,0,2,5
73770,4,1,257498,257498,257499,0,1,2
73771,2,1,257500,257500,257501,0,1,1
73772,2,1,257502,257502,257503,0,1,1
73773,1,2,257503,257503,257505,0,2,0
73774,6,2,257509,257509,257511,0,2,4
73775,5,1,257514,257514,257515,0,1,3
73776,2,1,257516,257516,257517,0,1,1
73777,4,1,257520,257520,257521,0,1,3
73778,5,1,257525,257525,257526,0,1,4
73779,1,3,257526,257526,257529,0,3,0
73780,2,3,257528,257529,257532,1,4,0
73781,3,2,257531,257532,257534,1,3,0
73782,3,1,257534,257534,257535,0,1,0
73783,1,1,257535,257535,257536,0,1,0
73784,3,2,257538,257538,257540,0,2,2
73785,6,2,257544,257544,257546,0,2,4
73786,1,3,257545,257546,257549,1,4,0
73787,4,3,257549,257549,257552,0,3,0
73788,2,1,257551,257552,257553,1,2,0
73789,6,1,257557,257557,257558,0,1,4
73790,4,1,257561,257561,257562,0,1,3
73791,5,2,257566,257566,257568,0,2,4
73792,4,2,257570,257570,257572,0,2,2
73793,2,3,257572,257572,257575,0,3,0
73794,1,1,257573,257575,257576,2,3,0
73795,4,1,257577,257577,257578,0,1,1
73796,3,3,257580,257580,257583,0,3,2
73797,6,2,257586,257586,257588,0,2,3
73798,1,1,257587,257588,257589,1,2,0
73799,3,3,257590,257590,257593,0,3,1
73800,2,3,257592,257593,257596,1,4,0
73801,1,1,257593,257596,257597,3,4,0
73802,1,3,257594,257597,257600,3,6,0
73803,4,3,257598,257600,257603,2,5,0
73804,1,2,257599,257603,257605,4,6,0
73805,3,1,257602,257605,257606,3,4,0
73806,2,2,257604,257606,257608,2,4,0
73807,1,1,257605,257608,257609,3,4,0
73808,2,1,257607,257609,257610,2,3,0
73809,3,3,257610,257610,257613,0,3,0
73810,3,3,257613,257613,257616,0,3,0
73811,3,2,257616,257616,257618,0,2,0
73812,3,3,257619,257619,257622,0,3,1
73813,4,2,257623,257623,257625,0,2,1
73814,1,3,257624,257625,257628,1,4,0
73815,3,2,257627,257628,257630,1,3,0
73816,5,2,257632,257632,257634,0,2,2
73817,6,3,257638,257638,257641,0,3,4
73818,4,1,257642,257642,257643,0,1,1
73819,2,3,257644,257644,257647,0,3,1
73820,6,2,257650,257650,257652,0,2,3
73821,6,2,257656,257656,257658,0,2,4
73822,4,1,257660,257660,257661,0,1,2
73823,3,3,257663,257663,257666,0,3,2
73824,3,1,257666,257666,257667,0,1,0
73825,5,2,257671,257671,257673,0,2,4
73826,1,1,257672,257673,257674,1,2,0
73827,4,1,257676,257676,257677,0,1,2
73828,1,2,257677,257677,257679,0,2,0
73829,3,2,257680,257680,257682,0,2,1
73830,1,2,257681,257682,257684,1,3,0
73831,6,1,257687,257687,257688,0,1,3
73832,3,3,257690,257690,257693,0,3,2
73833,2,1,257692,257693,257694,1,2,0
73834,4,2,257696,257696,257698,0,2,2
73835,3,1,257699,257699,257700,0,1,1
73836,6,3,257705,257705,257708,0,3,5
73837,1,1,257706,257708,257709,2,3,0
73838,2,2,257708,257709,257711,1,3,0
73839,5,1,257713,257713,257714,0,1,2
73840,2,2,257715,257715,257717,0,2,1
73841,1,1,257716,257717,257718,1,2,0
73842,6,3,257722,257722,257725,0,3,4
73843,1,3,257723,257725,257728,2,5,0
73844,1,2,257724,257728,257730,4,6,0
73845,6,3,257730,257730,257733,0,3,0
73846,5,1,257735,257735,257736,0,1,2
73847,4,1,257739,257739,257740,0,1,3
73848,2,1,257741,257741,257742,0,1,1
73849,4,1,257745,257745,257746,0,1,3
73850,1,1,257746,257746,257747,0,1,0
73851,1,3,257747,257747,257750,0,3,0
73852,2,1,257749,257750,257751,1,2,0
73853,5,1,257754,257754,257755,0,1,3
73854,3,2,257757,257757,257759,0,2,2
73855,1,3,257758,257759,257762,1,4,0
73856,3,1,257761,257762,257763,1,2,0
73857,3,2,257764,257764,257766,0,2,1
73858,3,2,257767,257767,257769,0,2,1
73859,1,2,257768,257769,257771,1,3,0
73860,2,2,257770,257771,257773,1,3,0
73861,2,1,257772,257773,257774,1,2,0
73862,1,1,257773,257774,257775,1,2,0
73863,2,1,257775,257775,257776,0,1,0
73864,1,3,257776,257776,257779,0,3,0
73865,2,1,257778,257779,257780,1,2,0
73866,4,2,257782,257782,257784,0,2,2
73867,5,3,257787,257787,257790,0,3,3
73868,4,2,257791,257791,257793,0,2,1
73869,5,3,257796,257796,257799,0,3,3
73870,1,1,257797,257799,257800,2,3,0
73871,5,3,257802,257802,257805,0,3,2
73872,2,1,257804,257805,257806,1,2,0
73873,1,1,257805,257806,257807,1,2,0
73874,6,2,257811,257811,257813,0,2,4
73875,4,2,257815,257815,257817,0,2,2
73876,5,3,257820,257820,257823,0,3,3
73877,5,1,257825,257825,257826,0,1,2
73878,4,2,257829,257829,257831,0,2,3
73879,4,2,257833,257833,257835,0,2,2
73880,4,2,257837,257837,257839,0,2,2
73881,5,1,257842,257842,257843,0,1,3
73882,3,2,257845,257845,257847,0,2,2
73883,4,3,257849,257849,257852,0,3,2
73884,4,3,257853,257853,257856,0,3,1
73885,6,2,257859,257859,257861,0,2,3
73886,4,2,257863,257863,257865,0,2,2
73887,3,3,257866,257866,257869,0,3,1
73888,4,3,257870,257870,257873,0,3,1
73889,1,1,257871,257873,257874,2,3,0
73890,5,2,257876,257876,257878,0,2,2
73891,3,1,257879,257879,257880,0,1,1
73892,4,2,257883,257883,257885,0,2,3
73893,5,3,257888,257888,257891,0,3,3
73894,3,2,257891,257891,257893,0,2,0
73895,5,1,257896,257896,257897,0,1,3
73896,6,1,257902,257902,257903,0,1,5
73897,5,1,257907,257907,257908,0,1,4
73898,1,3,257908,257908,257911,0,3,0
73899,5,3,257913,257913,257916,0,3,2
73900,4,3,257917,257917,257920,0,3,1
73901,2,2,257919,257920,257922,1,3,0
73902,2,2,257921,257922,257924,1,3,0
73903,5,3,257926,257926,257929,0,3,2
73904,5,2,257931,257931,257933,0,2,2
73905,3,3,257934,257934,257937,0,3,1
73906,3,1,257937,257937,257938,0,1,0
73907,2,2,257939,257939,257941,0,2,1
73908,4,3,257943,257943,257946,0,3,2
73909,2,3,257945,257946,257949,1,4,0
73910,1,1,257946,257949,257950,3,4,0
73911,2,3,257948,257950,257953,2,5,0
73912,1,1,257949,257953,257954,4,5,0
73913,6,2,257955,257955,257957,0,2,1
73914,3,1,257958,257958,257959,0,1,1
73915,1,2,257959,257959,257961,0,2,0
73916,1,3,257960,257961,257964,1,4,0
73917,2,1,257962,257964,257965,2,3,0
73918,1,1,257963,257965,257966,2,3,0
73919,5,1,257968,257968,257969,0,1,2
73920,6,2,257974,257974,257976,0,2,5
73921,1,2,257975,257976,257978,1,3,0
73922,4,2,257979,257979,257981,0,2,1
73923,3,1,257982,257982,257983,0,1,1
73924,2,3,257984,257984,257987,0,3,1
73925,5,2,257989,257989,257991,0,2,2
73926,1,3,257990,257991,257994,1,4,0
73927,3,1,257993,257994,257995,1,2,0
73928,5,1,257998,257998,257999,0,1,3
73929,3,1,258001,258001,258002,0,1,2
73930,2,2,258003,258003,258005,0,2,1
73931,6,3,258009,258009,258012,0,3,4
73932,5,2,258014,258014,258016,0,2,2
73933,2,3,258016,258016,258019,0,3,0
73934,3,2,258019,258019,258021,0,2,0
73935,3,3,258022,258022,258025,0,3,1
73936,4,3,258026,258026,258029,0,3,1
73937,6,2,258032,258032,258034,0,2,3
73938,1,3,258033,258034,258037,1,4,0
73939,6,1,258039,258039,258040,0,1,2
73940,1,2,258040,258040,258042,0,2,0
73941,3,3,258043,258043,258046,0,3,1
73942,4,1,258047,258047,258048,0,1,1
73943,5,1,258052,258052,258053,0,1,4
73944,4,2,258056,258056,258058,0,2,3
73945,1,1,258057,258058,258059,1,2,0
73946,6,3,258063,258063,258066,0,3,4
73947,2,1,258065,258066,258067,1,2,0
73948,2,3,258067,258067,258070,0,3,0
73949,6,2,258073,258073,258075,0,2,3
73950,6,1,258079,258079,258080,0,1,4
73951,2,2,258081,258081,258083,0,2,1
73952,4,2,258085,258085,258087,0,2,2
73953,1,1,258086,258087,258088,1,2,0
73954,2,1,258088,258088,258089,0,1,0
73955,1,1,258089,258089,258090,0,1,0
73956,3,1,258092,258092,258093,0,1,2
73957,1,2,258093,258093,258095,0,2,0
73958,5,2,258098,258098,258100,0,2,3
73959,5,1,258103,258103,258104,0,1,3
73960,4,1,258107,258107,258108,0,1,3
73961,5,1,258112,258112,258113,0,1,4
73962,6,1,258118,258118,258119,0,1,5
73963,4,2,258122,258122,258124,0,2,3
73964,6,3,258128,258128,258131,0,3,4
73965,6,1,258134,258134,258135,0,1,3
73966,1,1,258135,258135,258136,0,1,0
73967,6,2,258141,258141,258143,0,2,5
73968,2,3,258143,258143,258146,0,3,0
73969,3,1,258146,258146,258147,0,1,0
73970,4,2,258150,258150,258152,0,2,3
73971,2,3,258152,258152,258155,0,3,0
73972,6,1,258158,258158,258159,0,1,3
73973,4,2,258162,258162,258164,0,2,3
73974,4,1,258166,258166,258167,0,1,2
73975,4,1,258170,258170,258171,0,1,3
73976,6,1,258176,258176,258177,0,1,5
73977,1,3,258177,258177,258180,0,3,0
73978,4,1,258181,258181,258182,0,1,1
73979,4,2,258185,258185,258187,0,2,3
73980,2,1,258187,258187,258188,0,1,0
73981,4,1,258191,258191,258192,0,1,3
73982,1,1,258192,258192,258193,0,1,0
73983,4,3,258196,258196,258199,0,3,3
73984,5,3,258201,258201,258204,0,3,2
73985,2,2,258203,258204,258206,1,3,0
73986,6,1,258209,258209,258210,0,1,3
73987,3,1,258212,258212,258213,0,1,2
73988,1,2,258213,258213,258215,0,2,0
73989,6,2,258219,258219,258221,0,2,4
73990,6,1,258225,258225,258226,0,1,4
73991,4,2,258229,258229,258231,0,2,3
73992,6,3,258235,258235,258238,0,3,4
73993,4,2,258239,258239,258241,0,2,1
73994,2,2,258241,258241,258243,0,2,0
73995,5,1,258246,258246,258247,0,1,3
73996,4,1,258250,258250,258251,0,1,3
73997,3,2,258253,258253,258255,0,2,2
73998,4,1,258257,258257,258258,0,1,2
73999,2,1,258259,258259,258260,0,1,1
74000,1,2,258260,258260,258262,0,2,0
74001,4,2,258264,258264,258266,0,2,2
74002,2,1,258266,258266,258267,0,1,0
74003,1,3,258267,258267,258270,0,3,0
74004,6,2,258273,258273,258275,0,2,3
74005,4,1,258277,258277,258278,0,1,2
74006,5,2,258282,258282,258284,0,2,4
74007,3,1,258285,258285,258286,0,1,1
74008,3,1,258288,258288,258289,0,1,2
74009,4,2,258292,258292,258294,0,2,3
74010,6,3,258298,258298,258301,0,3,4
74011,6,3,258304,258304,258307,0,3,3
74012,1,3,258305,258307,258310,2,5,0
74013,1,2,258306,258310,258312,4,6,0
74014,4,1,258310,258312,258313,2,3,0
74015,1,3,258311,258313,258316,2,5,0
74016,4,2,258315,258316,258318,1,3,0
74017,1,3,258316,258318,258321,2,5,0
74018,2,1,258318,258321,258322,3,4,0
74019,6,2,258324,258324,258326,0,2,2
74020,1,3,258325,258326,258329,1,4,0
74021,2,1,258327,258329,258330,2,3,0
74022,2,1,258329,258330,258331,1,2,0
74023,4,3,258333,258333,258336,0,3,2
74024,5,3,258338,258338,258341,0,3,2
74025,4,2,258342,258342,258344,0,2,1
74026,6,2,258348,258348,258350,0,2,4
74027,6,3,258354,258354,258357,0,3,4
74028,4,1,258358,258358,258359,0,1,1
74029,5,1,258363,258363,258364,0,1,4
74030,6,3,258369,258369,258372,0,3,5
74031,1,3,258370,258372,258375,2,5,0
74032,6,3,258376,258376,258379,0,3,1
74033,1,1,258377,258379,258380,2,3,0
74034,4,3,258381,258381,258384,0,3,1
74035,3,1,258384,258384,258385,0,1,0
74036,2,1,258386,258386,258387,0,1,1
74037,6,1,258392,258392,258393,0,1,5
74038,6,2,258398,258398,258400,0,2,5
74039,4,1,258402,258402,258403,0,1,2
74040,3,1,258405,258405,258406,0,1,2
74041,6,3,258411,258411,258414,0,3,5
74042,2,3,258413,258414,258417,1,4,0
74043,5,2,258418,258418,258420,0,2,1
74044,3,1,258421,258421,258422,0,1,1
74045,4,2,258425,258425,258427,0,2,3
74046,5,1,258430,258430,258431,0,1,3
74047,4,2,258434,258434,258436,0,2,3
74048,2,2,258436,258436,258438,0,2,0
74049,2,1,258438,258438,258439,0,1,0
74050,1,3,258439,258439,258442,0,3,0
74051,4,3,258443,258443,258446,0,3,1
74052,4,2,258447,258447,258449,0,2,1
74053,6,3,258453,258453,258456,0,3,4
74054,4,2,258457,258457,258459,0,2,1
74055,6,3,258463,258463,258466,0,3,4
74056,1,1,258464,258466,258467,2,3,0
74057,2,2,258466,258467,258469,1,3,0
74058,6,3,258472,258472,258475,0,3,3
74059,2,3,258474,258475,258478,1,4,0
74060,3,3,258477,258478,258481,1,4,0
74061,4,2,258481,258481,258483,0,2,0
74062,2,1,258483,258483,258484,0,1,0
74063,3,3,258486,258486,258489,0,3,2
74064,6,2,258492,258492,258494,0,2,3
74065,5,2,258497,258497,258499,0,2,3
74066,4,3,258501,258501,258504,0,3,2
74067,4,2,258505,258505,258507,0,2,1
74068,2,3,258507,258507,258510,0,3,0
74069,6,1,258513,258513,258514,0,1,3
74070,1,3,258514,258514,258517,0,3,0
74071,3,3,258517,258517,258520,0,3,0
74072,4,2,258521,258521,258523,0,2,1
74073,4,1,258525,258525,258526,0,1,2
74074,1,1,258526,258526,258527,0,1,0
74075,3,1,258529,258529,258530,0,1,2
74076,5,1,258534,258534,258535,0,1,4
74077,5,1,258539,258539,258540,0,1,4
74078,1,1,258540,258540,258541,0,1,0
74079,3,1,258543,258543,258544,0,1,2
74080,2,3,258545,258545,258548,0,3,1
74081,6,2,258551,258551,258553,0,2,3
74082,2,2,258553,258553,258555,0,2,0
74083,6,2,258559,258559,258561,0,2,4
74084,2,2,258561,258561,258563,0,2,0
74085,5,2,258566,258566,258568,0,2,3
74086,1,1,258567,258568,258569,1,2,0
74087,4,2,258571,258571,258573,0,2,2
74088,5,2,258576,258576,258578,0,2,3
74089,1,3,258577,258578,258581,1,4,0
74090,6,2,258583,258583,258585,0,2,2
74091,3,1,258586,258586,258587,0,1,1
74092,6,3,258592,258592,258595,0,3,5
74093,2,3,258594,258595,258598,1,4,0
74094,2,3,258596,258598,258601,2,5,0
74095,3,2,258599,258601,258603,2,4,0
74096,2,3,258601,258603,258606,2,5,0
74097,2,2,258603,258606,258608,3,5,0
74098,6,2,258609,258609,258611,0,2,1
74099,2,2,258611,258611,258613,0,2,0
74100,6,2,258617,258617,258619,0,2,4
74101,4,3,258621,258621,258624,0,3,2
74102,5,2,258626,258626,258628,0,2,2
74103,1,2,258627,258628,258630,1,3,0
74104,4,3,258631,258631,258634,0,3,1
74105,6,1,258637,258637,258638,0,1,3
74106,5,1,258642,258642,258643,0,1,4
74107,6,1,258648,258648,258649,0,1,5
74108,6,1,258654,258654,258655,0,1,5
74109,4,2,258658,258658,258660,0,2,3
74110,2,2,258660,258660,258662,0,2,0
74111,2,1,258662,258662,258663,0,1,0
74112,1,1,258663,258663,258664,0,1,0
74113,3,2,258666,258666,258668,0,2,2
74114,2,1,258668,258668,258669,0,1,0
74115,5,1,258673,258673,258674,0,1,4
74116,3,2,258676,258676,258678,0,2,2
74117,3,3,258679,258679,258682,0,3,1
74118,3,1,258682,258682,258683,0,1,0
74119,3,2,258685,258685,258687,0,2,2
74120,4,2,258689,258689,258691,0,2,2
74121,5,2,258694,258694,258696,0,2,3
74122,1,3,258695,258696,258699,1,4,0
74123,5,3,258700,258700,258703,0,3,1
74124,5,1,258705,258705,258706,0,1,2
74125,2,2,258707,258707,258709,0,2,1
74126,1,3,258708,258709,258712,1,4,0
74127,2,3,258710,258712,258715,2,5,0
74128,6,1,258716,258716,258717,0,1,1
74129,4,3,258720,258720,258723,0,3,3
74130,4,3,258724,258724,258727,0,3,1
74131,3,1,258727,258727,258728,0,1,0
74132,3,2,258730,258730,258732,0,2,2
74133,4,3,258734,258734,258737,0,3,2
74134,3,2,258737,258737,258739,0,2,0
74135,6,3,258743,258743,258746,0,3,4
74136,2,2,258745,258746,258748,1,3,0
74137,6,3,258751,258751,258754,0,3,3
74138,3,3,258754,258754,258757,0,3,0
74139,2,3,258756,258757,258760,1,4,0
74140,3,3,258759,258760,258763,1,4,0
74141,5,3,258764,258764,258767,0,3,1
74142,6,2,258770,258770,258772,0,2,3
74143,1,2,258771,258772,258774,1,3,0
74144,3,1,258774,258774,258775,0,1,0
74145,3,3,258777,258777,258780,0,3,2
74146,4,1,258781,258781,258782,0,1,1
74147,3,2,258784,258784,258786,0,2,2
74148,6,2,258790,258790,258792,0,2,4
74149,6,1,258796,258796,258797,0,1,4
74150,3,1,258799,258799,258800,0,1,2
74151,5,1,258804,258804,258805,0,1,4
74152,5,2,258809,258809,258811,0,2,4
74153,6,1,258815,258815,258816,0,1,4
74154,1,3,258816,258816,258819,0,3,0
74155,3,3,258819,258819,258822,0,3,0
74156,6,2,258825,258825,258827,0,2,3
74157,2,2,258827,258827,258829,0,2,0
74158,5,3,258832,258832,258835,0,3,3
74159,2,3,258834,258835,258838,1,4,0
74160,6,3,258840,258840,258843,0,3,2
74161,2,3,258842,258843,258846,1,4,0
74162,6,1,258848,258848,258849,0,1,2
74163,6,2,258854,258854,258856,0,2,5
74164,4,2,258858,258858,258860,0,2,2
74165,3,1,258861,258861,258862,0,1,1
74166,2,3,258863,258863,258866,0,3,1
74167,5,3,258868,258868,258871,0,3,2
74168,1,1,258869,258871,258872,2,3,0
74169,5,3,258874,258874,258877,0,3,2
74170,6,3,258880,258880,258883,0,3,3
74171,6,1,258886,258886,258887,0,1,3
74172,2,1,258888,258888,258889,0,1,1
74173,6,2,258894,258894,258896,0,2,5
74174,1,2,258895,258896,258898,1,3,0
74175,6,1,258901,258901,258902,0,1,3
74176,3,2,258904,258904,258906,0,2,2
74177,2,2,258906,258906,258908,0,2,0
74178,6,3,258912,258912,258915,0,3,4
74179,4,3,258916,258916,258919,0,3,1
74180,5,2,258921,258921,258923,0,2,2
74181,5,3,258926,258926,258929,0,3,3
74182,3,2,258929,258929,258931,0,2,0
74183,1,1,258930,258931,258932,1,2,0
74184,2,3,258932,258932,258935,0,3,0
74185,6,1,258938,258938,258939,0,1,3
74186,6,1,258944,258944,258945,0,1,5
74187,3,3,258947,258947,258950,0,3,2
74188,4,1,258951,258951,258952,0,1,1
74189,5,3,258956,258956,258959,0,3,4
74190,1,1,258957,258959,258960,2,3,0
74191,6,3,258963,258963,258966,0,3,3
74192,4,3,258967,258967,258970,0,3,1
74193,5,2,258972,258972,258974,0,2,2
74194,2,2,258974,258974,258976,0,2,0
74195,3,3,258977,258977,258980,0,3,1
74196,1,2,258978,258980,258982,2,4,0
74197,1,2,258979,258982,258984,3,5,0
74198,3,1,258982,258984,258985,2,3,0
74199,6,3,258988,258988,258991,0,3,3
74200,5,1,258993,258993,258994,0,1,2
74201,6,1,258999,258999,259000,0,1,5
74202,5,2,259004,259004,259006,0,2,4
74203,4,1,259008,259008,259009,0,1,2
74204,2,2,259010,259010,259012,0,2,1
74205,4,2,259014,259014,259016,0,2,2
74206,2,3,259016,259016,259019,0,3,0
74207,5,1,259021,259021,259022,0,1,2
74208,6,1,259027,259027,259028,0,1,5
74209,3,3,259030,259030,259033,0,3,2
74210,1,2,259031,259033,259035,2,4,0
74211,4,2,259035,259035,259037,0,2,0
74212,2,1,259037,259037,259038,0,1,0
74213,2,3,259039,259039,259042,0,3,1
74214,6,3,259045,259045,259048,0,3,3
74215,3,1,259048,259048,259049,0,1,0
74216,2,3,259050,259050,259053,0,3,1
74217,3,3,259053,259053,259056,0,3,0
74218,5,2,259058,259058,259060,0,2,2
74219,2,1,259060,259060,259061,0,1,0
74220,5,3,259065,259065,259068,0,3,4
74221,3,3,259068,259068,259071,0,3,0
74222,3,2,259071,259071,259073,0,2,0
74223,4,3,259075,259075,259078,0,3,2
74224,1,3,259076,259078,259081,2,5,0
74225,4,2,259080,259081,259083,1,3,0
74226,2,1,259082,259083,259084,1,2,0
74227,5,2,259087,259087,259089,0,2,3
74228,5,2,259092,259092,259094,0,2,3
74229,1,2,259093,259094,259096,1,3,0
74230,1,1,259094,259096,259097,2,3,0
74231,4,2,259098,259098,259100,0,2,1
74232,5,3,259103,259103,259106,0,3,3
74233,3,2,259106,259106,259108,0,2,0
74234,5,1,259111,259111,259112,0,1,3
74235,3,2,259114,259114,259116,0,2,2
74236,1,1,259115,259116,259117,1,2,0
74237,2,3,259117,259117,259120,0,3,0
74238,3,1,259120,259120,259121,0,1,0
74239,2,3,259122,259122,259125,0,3,1
74240,2,2,259124,259125,259127,1,3,0
74241,3,1,259127,259127,259128,0,1,0
74242,2,2,259129,259129,259131,0,2,1
74243,6,2,259135,259135,259137,0,2,4
74244,2,3,259137,259137,259140,0,3,0
74245,2,3,259139,259140,259143,1,4,0
74246,1,2,259140,259143,259145,3,5,0
74247,4,3,259144,259145,259148,1,4,0
74248,4,2,259148,259148,259150,0,2,0
74249,6,1,259154,259154,259155,0,1,4
74250,2,3,259156,259156,259159,0,3,1
74251,2,3,259158,259159,259162,1,4,0
74252,2,2,259160,259162,259164,2,4,0
74253,4,2,259164,259164,259166,0,2,0
74254,2,1,259166,259166,259167,0,1,0
74255,6,1,259172,259172,259173,0,1,5
74256,6,1,259178,259178,259179,0,1,5
74257,6,2,259184,259184,259186,0,2,5
74258,2,2,259186,259186,259188,0,2,0
74259,3,1,259189,259189,259190,0,1,1
74260,2,2,259191,259191,259193,0,2,1
74261,6,3,259197,259197,259200,0,3,4
74262,4,2,259201,259201,259203,0,2,1
74263,3,2,259204,259204,259206,0,2,1
74264,1,2,259205,259206,259208,1,3,0
74265,6,3,259211,259211,259214,0,3,3
74266,6,1,259217,259217,259218,0,1,3
74267,2,2,259219,259219,259221,0,2,1
74268,6,1,259225,259225,259226,0,1,4
74269,1,2,259226,259226,259228,0,2,0
74270,2,2,259228,259228,259230,0,2,0
74271,5,1,259233,259233,259234,0,1,3
74272,1,1,259234,259234,259235,0,1,0
74273,5,1,259239,259239,259240,0,1,4
74274,4,2,259243,259243,259245,0,2,3
74275,6,2,259249,259249,259251,0,2,4
74276,4,1,259253,259253,259254,0,1,2
74277,5,3,259258,259258,259261,0,3,4
74278,3,2,259261,259261,259263,0,2,0
74279,3,2,259264,259264,259266,0,2,1
74280,2,1,259266,259266,259267,0,1,0
74281,1,3,259267,259267,259270,0,3,0
74282,5,1,259272,259272,259273,0,1,2
74283,6,2,259278,259278,259280,0,2,5
74284,2,1,259280,259280,259281,0,1,0
74285,2,1,259282,259282,259283,0,1,1
74286,3,1,259285,259285,259286,0,1,2
74287,4,3,259289,259289,259292,0,3,3
74288,2,2,259291,259292,259294,1,3,0
74289,6,2,259297,259297,259299,0,2,3
74290,3,1,259300,259300,259301,0,1,1
74291,2,3,259302,259302,259305,0,3,1
74292,3,1,259305,259305,259306,0,1,0
74293,1,3,259306,259306,259309,0,3,0
74294,5,3,259311,259311,259314,0,3,2
74295,2,2,259313,259314,259316,1,3,0
74296,5,3,259318,259318,259321,0,3,2
74297,4,2,259322,259322,259324,0,2,1
74298,6,3,259328,259328,259331,0,3,4
74299,3,2,259331,259331,259333,0,2,0
74300,6,3,259337,259337,259340,0,3,4
74301,5,3,259342,259342,259345,0,3,2
74302,5,2,259347,259347,259349,0,2,2
74303,5,1,259352,259352,259353,0,1,3
74304,3,2,259355,259355,259357,0,2,2
74305,1,2,259356,259357,259359,1,3,0
74306,2,3,259358,259359,259362,1,4,0
74307,6,2,259364,259364,259366,0,2,2
74308,3,3,259367,259367,259370,0,3,1
74309,3,2,259370,259370,259372,0,2,0
74310,6,2,259376,259376,259378,0,2,4
74311,6,1,259382,259382,259383,0,1,4
74312,4,1,259386,259386,259387,0,1,3
74313,5,2,259391,259391,259393,0,2,4
74314,4,1,259395,259395,259396,0,1,2
74315,3,1,259398,259398,259399,0,1,2
74316,6,3,259404,259404,259407,0,3,5
74317,6,2,259410,259410,259412,0,2,3
74318,6,2,259416,259416,259418,0,2,4
74319,5,2,259421,259421,259423,0,2,3
74320,1,1,259422,259423,259424,1,2,0
74321,6,2,259428,259428,259430,0,2,4
74322,5,2,259433,259433,259435,0,2,3
74323,2,1,259435,259435,259436,0,1,0
74324,3,1,259438,259438,259439,0,1,2
74325,5,2,259443,259443,259445,0,2,4
74326,2,3,259445,259445,259448,0,3,0
74327,3,3,259448,259448,259451,0,3,0
74328,6,3,259454,259454,259457,0,3,3
74329,1,3,259455,259457,259460,2,5,0
74330,6,2,259461,259461,259463,0,2,1
74331,3,1,259464,259464,259465,0,1,1
74332,2,1,259466,259466,259467,0,1,1
74333,4,3,259470,259470,259473,0,3,3
74334,1,3,259471,259473,259476,2,5,0
74335,3,1,259474,259476,259477,2,3,0
74336,4,1,259478,259478,259479,0,1,1
74337,4,3,259482,259482,259485,0,3,3
74338,5,1,259487,259487,259488,0,1,2
74339,3,3,259490,259490,259493,0,3,2
74340,6,2,259496,259496,259498,0,2,3
74341,6,2,259502,259502,259504,0,2,4
74342,2,3,259504,259504,259507,0,3,0
74343,3,3,259507,259507,259510,0,3,0
74344,1,1,259508,259510,259511,2,3,0
74345,6,1,259514,259514,259515,0,1,3
74346,4,1,259518,259518,259519,0,1,3
74347,6,1,259524,259524,259525,0,1,5
74348,6,1,259530,259530,259531,0,1,5
74349,1,2,259531,259531,259533,0,2,0
74350,1,1,259532,259533,259534,1,2,0
74351,5,2,259537,259537,259539,0,2,3
74352,2,2,259539,259539,259541,0,2,0
74353,1,3,259540,259541,259544,1,4,0
74354,3,1,259543,259544,259545,1,2,0
74355,2,3,259545,259545,259548,0,3,0
74356,4,1,259549,259549,259550,0,1,1
74357,6,2,259555,259555,259557,0,2,5
74358,3,1,259558,259558,259559,0,1,1
74359,3,3,259561,259561,259564,0,3,2
74360,5,1,259566,259566,259567,0,1,2
74361,2,3,259568,259568,259571,0,3,1
74362,2,3,259570,259571,259574,1,4,0
74363,5,3,259575,259575,259578,0,3,1
74364,3,3,259578,259578,259581,0,3,0
74365,4,2,259582,259582,259584,0,2,1
74366,4,3,259586,259586,259589,0,3,2
74367,1,1,259587,259589,259590,2,3,0
74368,4,2,259591,259591,259593,0,2,1
74369,1,1,259592,259593,259594,1,2,0
74370,3,3,259595,259595,259598,0,3,1
74371,2,1,259597,259598,259599,1,2,0
74372,5,1,259602,259602,259603,0,1,3
74373,2,1,259604,259604,259605,0,1,1
74374,5,1,259609,259609,259610,0,1,4
74375,4,2,259613,259613,259615,0,2,3
74376,6,2,259619,259619,259621,0,2,4
74377,4,1,259623,259623,259624,0,1,2
74378,3,1,259626,259626,259627,0,1,2
74379,3,3,259629,259629,259632,0,3,2
74380,2,2,259631,259632,259634,1,3,0
74381,5,3,259636,259636,259639,0,3,2
74382,2,1,259638,259639,259640,1,2,0
74383,2,3,259640,259640,259643,0,3,0
74384,5,2,259645,259645,259647,0,2,2
74385,5,3,259650,259650,259653,0,3,3
74386,3,1,259653,259653,259654,0,1,0
74387,3,1,259656,259656,259657,0,1,2
74388,6,2,259662,259662,259664,0,2,5
74389,3,1,259665,259665,259666,0,1,1
74390,4,2,259669,259669,259671,0,2,3
74391,3,3,259672,259672,259675,0,3,1
74392,5,3,259677,259677,259680,0,3,2
74393,6,1,259683,259683,259684,0,1,3
74394,5,2,259688,259688,259690,0,2,4
74395,4,2,259692,259692,259694,0,2,2
74396,2,3,259694,259694,259697,0,3,0
74397,4,1,259698,259698,259699,0,1,1
74398,3,3,259701,259701,259704,0,3,2
74399,3,1,259704,259704,259705,0,1,0
74400,5,2,259709,259709,259711,0,2,4
74401,1,3,259710,259711,259714,1,4,0
74402,4,3,259714,259714,259717,0,3,0
74403,6,3,259720,259720,259723,0,3,3
74404,2,1,259722,259723,259724,1,2,0
74405,6,1,259728,259728,259729,0,1,4
74406,1,1,259729,259729,259730,0,1,0
74407,1,1,259730,259730,259731,0,1,0
74408,3,2,259733,259733,259735,0,2,2
74409,5,2,259738,259738,259740,0,2,3
74410,3,3,259741,259741,259744,0,3,1
74411,6,1,259747,259747,259748,0,1,3
74412,4,3,259751,259751,259754,0,3,3
74413,2,1,259753,259754,259755,1,2,0
74414,5,1,259758,259758,259759,0,1,3
74415,6,3,259764,259764,259767,0,3,5
74416,3,2,259767,259767,259769,0,2,0
74417,5,3,259772,259772,259775,0,3,3
74418,6,3,259778,259778,259781,0,3,3
74419,2,2,259780,259781,259783,1,3,0
74420,1,2,259781,259783,259785,2,4,0
74421,2,1,259783,259785,259786,2,3,0
74422,2,2,259785,259786,259788,1,3,0
74423,1,1,259786,259788,259789,2,3,0
74424,1,2,259787,259789,259791,2,4,0
74425,2,2,259789,259791,259793,2,4,0
74426,3,2,259792,259793,259795,1,3,0
74427,4,1,259796,259796,259797,0,1,1
74428,2,2,259798,259798,259800,0,2,1
74429,4,2,259802,259802,259804,0,2,2
74430,2,1,259804,259804,259805,0,1,0
74431,2,2,259806,259806,259808,0,2,1
74432,2,3,259808,259808,259811,0,3,0
74433,2,3,259810,259811,259814,1,4,0
74434,4,3,259814,259814,259817,0,3,0
74435,2,2,259816,259817,259819,1,3,0
74436,4,3,259820,259820,259823,0,3,1
74437,5,2,259825,259825,259827,0,2,2
74438,2,2,259827,259827,259829,0,2,0
74439,1,1,259828,259829,259830,1,2,0
74440,5,1,259833,259833,259834,0,1,3
74441,6,1,259839,259839,259840,0,1,5
74442,1,2,259840,259840,259842,0,2,0
74443,6,1,259846,259846,259847,0,1,4
74444,1,1,259847,259847,259848,0,1,0
74445,3,2,259850,259850,259852,0,2,2
74446,4,1,259854,259854,259855,0,1,2
74447,1,1,259855,259855,259856,0,1,0
74448,1,2,259856,259856,259858,0,2,0
74449,3,2,259859,259859,259861,0,2,1
74450,4,1,259863,259863,259864,0,1,2
74451,5,2,259868,259868,259870,0,2,4
74452,1,3,259869,259870,259873,1,4,0
74453,4,3,259873,259873,259876,0,3,0
74454,2,2,259875,259876,259878,1,3,0
74455,6,1,259881,259881,259882,0,1,3
74456,5,1,259886,259886,259887,0,1,4
74457,6,1,259892,259892,259893,0,1,5
74458,6,1,259898,259898,259899,0,1,5
74459,3,2,259901,259901,259903,0,2,2
74460,1,1,259902,259903,259904,1,2,0
74461,2,3,259904,259904,259907,0,3,0
74462,3,3,259907,259907,259910,0,3,0
74463,2,2,259909,259910,259912,1,3,0
74464,6,1,259915,259915,259916,0,1,3
74465,4,1,259919,259919,259920,0,1,3
74466,2,3,259921,259921,259924,0,3,1
74467,6,1,259927,259927,259928,0,1,3
74468,3,3,259930,259930,259933,0,3,2
74469,2,1,259932,259933,259934,1,2,0
74470,1,1,259933,259934,259935,1,2,0
74471,4,3,259937,259937,259940,0,3,2
74472,1,3,259938,259940,259943,2,5,0
74473,5,1,259943,259943,259944,0,1,0
74474,1,3,259944,259944,259947,0,3,0
74475,4,1,259948,259948,259949,0,1,1
74476,6,2,259954,259954,259956,0,2,5
74477,2,3,259956,259956,259959,0,3,0
74478,4,1,259960,259960,259961,0,1,1
74479,5,1,259965,259965,259966,0,1,4
74480,4,2,259969,259969,259971,0,2,3
74481,2,2,259971,259971,259973,0,2,0
74482,6,3,259977,259977,259980,0,3,4
74483,3,3,259980,259980,259983,0,3,0
74484,4,3,259984,259984,259987,0,3,1
74485,2,3,259986,259987,259990,1,4,0
74486,5,3,259991,259991,259994,0,3,1
74487,3,1,259994,259994,259995,0,1,0
74488,4,3,259998,259998,260001,0,3,3
74489,3,2,260001,260001,260003,0,2,0
74490,2,2,260003,260003,260005,0,2,0
74491,2,3,260005,260005,260008,0,3,0
74492,4,3,260009,260009,260012,0,3,1
74493,1,1,260010,260012,260013,2,3,0
74494,5,1,260015,260015,260016,0,1,2
74495,2,1,260017,260017,260018,0,1,1
74496,1,3,260018,260018,260021,0,3,0
74497,1,3,260019,260021,260024,2,5,0
74498,5,1,260024,260024,260025,0,1,0
74499,5,1,260029,260029,260030,0,1,4
74500,1,1,260030,260030,260031,0,1,0
74501,2,1,260032,260032,260033,0,1,1
74502,4,2,260036,260036,260038,0,2,3
74503,2,2,260038,260038,260040,0,2,0
74504,3,3,260041,260041,260044,0,3,1
74505,2,1,260043,260044,260045,1,2,0
74506,4,3,260047,260047,260050,0,3,2
74507,4,1,260051,260051,260052,0,1,1
74508,5,1,260056,260056,260057,0,1,4
74509,3,1,260059,260059,260060,0,1,2
74510,3,1,260062,260062,260063,0,1,2
74511,3,1,260065,260065,260066,0,1,2
74512,4,3,260069,260069,260072,0,3,3
74513,3,1,260072,260072,260073,0,1,0
74514,4,1,260076,260076,260077,0,1,3
74515,2,3,260078,260078,260081,0,3,1
74516,5,3,260083,260083,260086,0,3,2
74517,4,3,260087,260087,260090,0,3,1
74518,2,2,260089,260090,260092,1,3,0
74519,6,2,260095,260095,260097,0,2,3
74520,4,3,260099,260099,260102,0,3,2
74521,1,1,260100,260102,260103,2,3,0
74522,5,2,260105,260105,260107,0,2,2
74523,3,3,260108,260108,260111,0,3,1
74524,1,3,260109,260111,260114,2,5,0
74525,3,1,260112,260114,260115,2,3,0
74526,4,3,260116,260116,260119,0,3,1
74527,1,2,260117,260119,260121,2,4,0
74528,6,1,260123,260123,260124,0,1,2
74529,6,3,260129,260129,260132,0,3,5
74530,5,2,260134,260134,260136,0,2,2
74531,6,2,260140,260140,260142,0,2,4
74532,2,1,260142,260142,260143,0,1,0
74533,1,2,260143,260143,260145,0,2,0
74534,2,1,260145,260145,260146,0,1,0
74535,4,3,260149,260149,260152,0,3,3
74536,1,3,260150,260152,260155,2,5,0
74537,1,3,260151,260155,260158,4,7,0
74538,4,3,260155,260158,260161,3,6,0
74539,6,2,260161,260161,260163,0,2,0
74540,3,1,260164,260164,260165,0,1,1
74541,4,2,260168,260168,260170,0,2,3
74542,5,2,260173,260173,260175,0,2,3
74543,5,3,260178,260178,260181,0,3,3
74544,5,3,260183,260183,260186,0,3,2
74545,3,3,260186,260186,260189,0,3,0
74546,6,1,260192,260192,260193,0,1,3
74547,4,1,260196,260196,260197,0,1,3
74548,1,1,260197,260197,260198,0,1,0
74549,5,3,260202,260202,260205,0,3,4
74550,2,2,260204,260205,260207,1,3,0
74551,3,2,260207,260207,260209,0,2,0
74552,6,2,260213,260213,260215,0,2,4
74553,2,2,260215,260215,260217,0,2,0
74554,6,3,260221,260221,260224,0,3,4
74555,2,3,260223,260224,260227,1,4,0
74556,4,1,260227,260227,260228,0,1,0
74557,3,2,260230,260230,260232,0,2,2
74558,5,2,260235,260235,260237,0,2,3
74559,3,1,260238,260238,260239,0,1,1
74560,5,1,260243,260243,260244,0,1,4
74561,4,3,260247,260247,260250,0,3,3
74562,1,1,260248,260250,260251,2,3,0
74563,2,1,260250,260251,260252,1,2,0
74564,5,3,260255,260255,260258,0,3,3
74565,6,2,260261,260261,260263,0,2,3
74566,2,3,260263,260263,260266,0,3,0
74567,4,1,260267,260267,260268,0,1,1
74568,2,1,260269,260269,260270,0,1,1
74569,1,1,260270,260270,260271,0,1,0
74570,3,3,260273,260273,260276,0,3,2
74571,6,3,260279,260279,260282,0,3,3
74572,2,3,260281,260282,260285,1,4,0
74573,4,1,260285,260285,260286,0,1,0
74574,5,2,260290,260290,260292,0,2,4
74575,4,2,260294,260294,260296,0,2,2
74576,2,2,260296,260296,260298,0,2,0
74577,4,2,260300,260300,260302,0,2,2
74578,5,2,260305,260305,260307,0,2,3
74579,2,2,260307,260307,260309,0,2,0
74580,1,3,260308,260309,260312,1,4,0
74581,1,2,260309,260312,260314,3,5,0
74582,3,3,260312,260314,260317,2,5,0
74583,6,3,260318,260318,260321,0,3,1
74584,1,2,260319,260321,260323,2,4,0
74585,4,2,260323,260323,260325,0,2,0
74586,6,3,260329,260329,260332,0,3,4
74587,2,2,260331,260332,260334,1,3,0
74588,1,3,260332,260334,260337,2,5,0
74589,5,2,260337,260337,260339,0,2,0
74590,6,2,260343,260343,260345,0,2,4
74591,2,1,260345,260345,260346,0,1,0
74592,5,2,260350,260350,260352,0,2,4
74593,5,3,260355,260355,260358,0,3,3
74594,1,1,260356,260358,260359,2,3,0
74595,3,2,260359,260359,260361,0,2,0
74596,1,1,260360,260361,260362,1,2,0
74597,4,2,260364,260364,260366,0,2,2
74598,5,2,260369,260369,260371,0,2,3
74599,1,1,260370,260371,260372,1,2,0
74600,6,2,260376,260376,260378,0,2,4
74601,4,1,260380,260380,260381,0,1,2
74602,2,3,260382,260382,260385,0,3,1
74603,4,3,260386,260386,260389,0,3,1
74604,4,1,260390,260390,260391,0,1,1
74605,1,1,260391,260391,260392,0,1,0
74606,5,1,260396,260396,260397,0,1,4
74607,3,3,260399,260399,260402,0,3,2
74608,2,1,260401,260402,260403,1,2,0
74609,3,3,260404,260404,260407,0,3,1
74610,3,3,260407,260407,260410,0,3,0
74611,5,1,260412,260412,260413,0,1,2
74612,6,2,260418,260418,260420,0,2,5
74613,1,2,260419,260420,260422,1,3,0
74614,2,1,260421,260422,260423,1,2,0
74615,4,3,260425,260425,260428,0,3,2
74616,6,2,260431,260431,260433,0,2,3
74617,1,2,260432,260433,260435,1,3,0
74618,6,2,260438,260438,260440,0,2,3
74619,2,2,260440,260440,260442,0,2,0
74620,5,1,260445,260445,260446,0,1,3
74621,6,1,260451,260451,260452,0,1,5
74622,1,2,260452,260452,260454,0,2,0
74623,5,2,260457,260457,260459,0,2,3
74624,5,1,260462,260462,260463,0,1,3
74625,2,3,260464,260464,260467,0,3,1
74626,1,3,260465,260467,260470,2,5,0
74627,5,2,260470,260470,260472,0,2,0
74628,4,2,260474,260474,260476,0,2,2
74629,2,1,260476,260476,260477,0,1,0
74630,6,1,260482,260482,260483,0,1,5
74631,6,1,260488,260488,260489,0,1,5
74632,5,1,260493,260493,260494,0,1,4
74633,1,3,260494,260494,260497,0,3,0
74634,2,1,260496,260497,260498,1,2,0
74635,2,1,260498,260498,260499,0,1,0
74636,1,2,260499,260499,260501,0,2,0
74637,3,3,260502,260502,260505,0,3,1
74638,5,1,260507,260507,260508,0,1,2
74639,5,3,260512,260512,260515,0,3,4
74640,3,2,260515,260515,260517,0,2,0
74641,2,1,260517,260517,260518,0,1,0
74642,6,3,260523,260523,260526,0,3,5
74643,4,2,260527,260527,260529,0,2,1
74644,5,3,260532,260532,260535,0,3,3
74645,3,3,260535,260535,260538,0,3,0
74646,4,3,260539,260539,260542,0,3,1
74647,2,2,260541,260542,260544,1,3,0
74648,6,2,260547,260547,260549,0,2,3
74649,6,1,260553,260553,260554,0,1,4
74650,6,3,260559,260559,260562,0,3,5
74651,6,3,260565,260565,260568,0,3,3
74652,3,2,260568,260568,260570,0,2,0
74653,4,1,260572,260572,260573,0,1,2
74654,3,2,260575,260575,260577,0,2,2
74655,5,2,260580,260580,260582,0,2,3
74656,5,2,260585,260585,260587,0,2,3
74657,3,1,260588,260588,260589,0,1,1
74658,5,2,260593,260593,260595,0,2,4
74659,2,3,260595,260595,260598,0,3,0
74660,4,2,260599,260599,260601,0,2,1
74661,6,2,260605,260605,260607,0,2,4
74662,6,1,260611,260611,260612,0,1,4
74663,4,1,260615,260615,260616,0,1,3
74664,5,2,260620,260620,260622,0,2,4
74665,6,2,260626,260626,260628,0,2,4
74666,5,1,260631,260631,260632,0,1,3
74667,6,1,260637,260637,260638,0,1,5
74668,1,2,260638,260638,260640,0,2,0
74669,4,2,260642,260642,260644,0,2,2
74670,3,2,260645,260645,260647,0,2,1
74671,2,2,260647,260647,260649,0,2,0
74672,4,3,260651,260651,260654,0,3,2
74673,2,2,260653,260654,260656,1,3,0
74674,2,1,260655,260656,260657,1,2,0
74675,1,1,260656,260657,260658,1,2,0
74676,4,1,260660,260660,260661,0,1,2
74677,2,3,260662,260662,260665,0,3,1
74678,5,1,260667,260667,260668,0,1,2
74679,4,3,260671,260671,260674,0,3,3
74680,4,1,260675,260675,260676,0,1,1
74681,6,1,260681,260681,260682,0,1,5
74682,5,3,260686,260686,260689,0,3,4
74683,4,2,260690,260690,260692,0,2,1
74684,3,2,260693,260693,260695,0,2,1
74685,5,1,260698,260698,260699,0,1,3
74686,2,3,260700,260700,260703,0,3,1
74687,1,3,260701,260703,260706,2,5,0
74688,4,2,260705,260706,260708,1,3,0
74689,2,3,260707,260708,260711,1,4,0
74690,1,2,260708,260711,260713,3,5,0
74691,1,1,260709,260713,260714,4,5,0
74692,1,2,260710,260714,260716,4,6,0
74693,4,1,260714,260716,260717,2,3,0
74694,4,2,260718,260718,260720,0,2,1
74695,2,1,260720,260720,260721,0,1,0
74696,4,1,260724,260724,260725,0,1,3
74697,6,3,260730,260730,260733,0,3,5
74698,3,3,260733,260733,260736,0,3,0
74699,4,2,260737,260737,260739,0,2,1
74700,1,2,260738,260739,260741,1,3,0
74701,3,2,260741,260741,260743,0,2,0
74702,6,1,260747,260747,260748,0,1,4
74703,2,1,260749,260749,260750,0,1,1
74704,4,1,260753,260753,260754,0,1,3
74705,4,1,260757,260757,260758,0,1,3
74706,6,2,260763,260763,260765,0,2,5
74707,5,2,260768,260768,260770,0,2,3
74708,6,2,260774,260774,260776,0,2,4
74709,1,2,260775,260776,260778,1,3,0
74710,5,2,260780,260780,260782,0,2,2
74711,2,2,260782,260782,260784,0,2,0
74712,4,2,260786,260786,260788,0,2,2
74713,2,1,260788,260788,260789,0,1,0
74714,4,2,260792,260792,260794,0,2,3
74715,5,3,260797,260797,260800,0,3,3
74716,6,2,260803,260803,260805,0,2,3
74717,3,3,260806,260806,260809,0,3,1
74718,4,3,260810,260810,260813,0,3,1
74719,6,2,260816,260816,260818,0,2,3
74720,5,1,260821,260821,260822,0,1,3
74721,1,3,260822,260822,260825,0,3,0
74722,5,2,260827,260827,260829,0,2,2
74723,4,2,260831,260831,260833,0,2,2
74724,3,1,260834,260834,260835,0,1,1
74725,6,2,260840,260840,260842,0,2,5
74726,4,2,260844,260844,260846,0,2,2
74727,1,2,260845,260846,260848,1,3,0
74728,6,1,260851,260851,260852,0,1,3
74729,4,1,260855,260855,260856,0,1,3
74730,6,3,260861,260861,260864,0,3,5
74731,3,1,260864,260864,260865,0,1,0
74732,5,3,260869,260869,260872,0,3,4
74733,6,3,260875,260875,260878,0,3,3
74734,5,2,260880,260880,260882,0,2,2
74735,6,1,260886,260886,260887,0,1,4
74736,2,3,260888,260888,260891,0,3,1
74737,5,2,260893,260893,260895,0,2,2
74738,4,2,260897,260897,260899,0,2,2
74739,2,1,260899,260899,260900,0,1,0
74740,2,1,260901,260901,260902,0,1,1
74741,6,3,260907,260907,260910,0,3,5
74742,1,2,260908,260910,260912,2,4,0
74743,5,3,260913,260913,260916,0,3,1
74744,1,2,260914,260916,260918,2,4,0
74745,2,3,260916,260918,260921,2,5,0
74746,4,1,260920,260921,260922,1,2,0
74747,3,3,260923,260923,260926,0,3,1
74748,6,2,260929,260929,260931,0,2,3
74749,4,2,260933,260933,260935,0,2,2
74750,4,1,260937,260937,260938,0,1,2
74751,4,2,260941,260941,260943,0,2,3
74752,3,1,260944,260944,260945,0,1,1
74753,5,1,260949,260949,260950,0,1,4
74754,5,1,260954,260954,260955,0,1,4
74755,5,2,260959,260959,260961,0,2,4
74756,1,1,260960,260961,260962,1,2,0
74757,6,2,260966,260966,260968,0,2,4
74758,3,2,260969,260969,260971,0,2,1
74759,4,3,260973,260973,260976,0,3,2
74760,2,1,260975,260976,260977,1,2,0
74761,6,3,260981,260981,260984,0,3,4
74762,6,3,260987,260987,260990,0,3,3
74763,6,3,260993,260993,260996,0,3,3
74764,6,1,260999,260999,261000,0,1,3
74765,1,1,261000,261000,261001,0,1,0
74766,6,1,261006,261006,261007,0,1,5
74767,4,1,261010,261010,261011,0,1,3
74768,4,2,261014,261014,261016,0,2,3
74769,5,1,261019,261019,261020,0,1,3
74770,3,1,261022,261022,261023,0,1,2
74771,2,3,261024,261024,261027,0,3,1
74772,2,3,261026,261027,261030,1,4,0
74773,2,2,261028,261030,261032,2,4,0
74774,1,2,261029,261032,261034,3,5,0
74775,5,3,261034,261034,261037,0,3,0
74776,5,2,261039,261039,261041,0,2,2
74777,4,3,261043,261043,261046,0,3,2
74778,4,3,261047,261047,261050,0,3,1
74779,4,2,261051,261051,261053,0,2,1
74780,6,2,261057,261057,261059,0,2,4
74781,3,1,261060,261060,261061,0,1,1
74782,6,3,261066,261066,261069,0,3,5
74783,2,2,261068,261069,261071,1,3,0
74784,1,3,261069,261071,261074,2,5,0
74785,3,3,261072,261074,261077,2,5,0
74786,5,3,261077,261077,261080,0,3,0
74787,4,1,261081,261081,261082,0,1,1
74788,4,2,261085,261085,261087,0,2,3
74789,6,2,261091,261091,261093,0,2,4
74790,3,3,261094,261094,261097,0,3,1
74791,3,3,261097,261097,261100,0,3,0
74792,1,2,261098,261100,261102,2,4,0
74793,4,1,261102,261102,261103,0,1,0
74794,5,2,261107,261107,261109,0,2,4
74795,1,3,261108,261109,261112,1,4,0
74796,2,3,261110,261112,261115,2,5,0
74797,6,1,261116,261116,261117,0,1,1
74798,4,2,261120,261120,261122,0,2,3
74799,4,1,261124,261124,261125,0,1,2
74800,4,1,261128,261128,261129,0,1,3
74801,3,2,261131,261131,261133,0,2,2
74802,3,3,261134,261134,261137,0,3,1
74803,3,2,261137,261137,261139,0,2,0
74804,4,1,261141,261141,261142,0,1,2
74805,3,2,261144,261144,261146,0,2,2
74806,4,1,261148,261148,261149,0,1,2
74807,6,3,261154,261154,261157,0,3,5
74808,3,2,261157,261157,261159,0,2,0
74809,5,1,261162,261162,261163,0,1,3
74810,4,3,261166,261166,261169,0,3,3
74811,6,3,261172,261172,261175,0,3,3
74812,4,2,261176,261176,261178,0,2,1
74813,3,2,261179,261179,261181,0,2,1
74814,3,3,261182,261182,261185,0,3,1
74815,1,1,261183,261185,261186,2,3,0
74816,2,3,261185,261186,261189,1,4,0
74817,2,1,261187,261189,261190,2,3,0
74818,3,1,261190,261190,261191,0,1,0
74819,5,2,261195,261195,261197,0,2,4
74820,3,2,261198,261198,261200,0,2,1
74821,4,2,261202,261202,261204,0,2,2
74822,2,1,261204,261204,261205,0,1,0
74823,4,1,261208,261208,261209,0,1,3
74824,6,3,261214,261214,261217,0,3,5
74825,2,3,261216,261217,261220,1,4,0
74826,3,1,261219,261220,261221,1,2,0
74827,2,3,261221,261221,261224,0,3,0
74828,3,2,261224,261224,261226,0,2,0
74829,1,3,261225,261226,261229,1,4,0
74830,3,3,261228,261229,261232,1,4,0
74831,3,2,261231,261232,261234,1,3,0
74832,6,3,261237,261237,261240,0,3,3
74833,3,3,261240,261240,261243,0,3,0
74834,5,3,261245,261245,261248,0,3,2
74835,5,1,261250,261250,261251,0,1,2
74836,5,3,261255,261255,261258,0,3,4
74837,1,1,261256,261258,261259,2,3,0
74838,5,3,261261,261261,261264,0,3,2
74839,3,3,261264,261264,261267,0,3,0
74840,5,1,261269,261269,261270,0,1,2
74841,1,3,261270,261270,261273,0,3,0
74842,2,3,261272,261273,261276,1,4,0
74843,2,2,261274,261276,261278,2,4,0
74844,3,2,261277,261278,261280,1,3,0
74845,3,3,261280,261280,261283,0,3,0
74846,5,1,261285,261285,261286,0,1,2
74847,2,3,261287,261287,261290,0,3,1
74848,4,3,261291,261291,261294,0,3,1
74849,6,1,261297,261297,261298,0,1,3
74850,4,1,261301,261301,261302,0,1,3
74851,3,3,261304,261304,261307,0,3,2
74852,3,3,261307,261307,261310,0,3,0
74853,5,1,261312,261312,261313,0,1,2
74854,1,1,261313,261313,261314,0,1,0
74855,1,2,261314,261314,261316,0,2,0
74856,1,1,261315,261316,261317,1,2,0
74857,6,2,261321,261321,261323,0,2,4
74858,4,3,261325,261325,261328,0,3,2
74859,4,2,261329,261329,261331,0,2,1
74860,6,3,261335,261335,261338,0,3,4
74861,1,1,261336,261338,261339,2,3,0
74862,5,1,261341,261341,261342,0,1,2
74863,4,2,261345,261345,261347,0,2,3
74864,4,2,261349,261349,261351,0,2,2
74865,2,1,261351,261351,261352,0,1,0
74866,6,3,261357,261357,261360,0,3,5
74867,4,1,261361,261361,261362,0,1,1
74868,1,2,261362,261362,261364,0,2,0
74869,1,1,261363,261364,261365,1,2,0
74870,6,1,261369,261369,261370,0,1,4
74871,5,3,261374,261374,261377,0,3,4
74872,4,2,261378,261378,261380,0,2,1
74873,5,3,261383,261383,261386,0,3,3
74874,4,1,261387,261387,261388,0,1,1
74875,2,2,261389,261389,261391,0,2,1
74876,4,3,261393,261393,261396,0,3,2
74877,1,3,261394,261396,261399,2,5,0
74878,6,3,261400,261400,261403,0,3,1
74879,3,2,261403,261403,261405,0,2,0
74880,3,3,261406,261406,261409,0,3,1
74881,3,1,261409,261409,261410,0,1,0
74882,5,3,261414,261414,261417,0,3,4
74883,4,3,261418,261418,261421,0,3,1
74884,5,3,261423,261423,261426,0,3,2
74885,6,3,261429,261429,261432,0,3,3
74886,6,1,261435,261435,261436,0,1,3
74887,3,2,261438,261438,261440,0,2,2
74888,1,1,261439,261440,261441,1,2,0
74889,2,2,261441,261441,261443,0,2,0
74890,3,1,261444,261444,261445,0,1,1
74891,6,3,261450,261450,261453,0,3,5
74892,4,2,261454,261454,261456,0,2,1
74893,2,2,261456,261456,261458,0,2,0
74894,2,1,261458,261458,261459,0,1,0
74895,1,1,261459,261459,261460,0,1,0
74896,2,2,261461,261461,261463,0,2,1
74897,2,2,261463,261463,261465,0,2,0
74898,6,2,261469,261469,261471,0,2,4
74899,6,1,261475,261475,261476,0,1,4
74900,5,2,261480,261480,261482,0,2,4
74901,3,3,261483,261483,261486,0,3,1
74902,4,2,261487,261487,261489,0,2,1
74903,5,1,261492,261492,261493,0,1,3
74904,6,1,261498,261498,261499,0,1,5
74905,5,2,261503,261503,261505,0,2,4
74906,4,2,261507,261507,261509,0,2,2
74907,6,3,261513,261513,261516,0,3,4
74908,1,2,261514,261516,261518,2,4,0
74909,2,3,261516,261518,261521,2,5,0
74910,5,1,261521,261521,261522,0,1,0
74911,3,3,261524,261524,261527,0,3,2
74912,4,2,261528,261528,261530,0,2,1
74913,2,3,261530,261530,261533,0,3,0
74914,6,2,261536,261536,261538,0,2,3
74915,3,3,261539,261539,261542,0,3,1
74916,5,1,261544,261544,261545,0,1,2
74917,2,2,261546,261546,261548,0,2,1
74918,5,3,261551,261551,261554,0,3,3
74919,5,2,261556,261556,261558,0,2,2
74920,1,3,261557,261558,261561,1,4,0
74921,2,2,261559,261561,261563,2,4,0
74922,1,1,261560,261563,261564,3,4,0
74923,4,1,261564,261564,261565,0,1,0
74924,5,1,261569,261569,261570,0,1,4
74925,1,1,261570,261570,261571,0,1,0
74926,2,3,261572,261572,261575,0,3,1
74927,2,2,261574,261575,261577,1,3,0
74928,1,3,261575,261577,261580,2,5,0
74929,4,1,261579,261580,261581,1,2,0
74930,1,1,261580,261581,261582,1,2,0
74931,2,2,261582,261582,261584,0,2,0
74932,2,1,261584,261584,261585,0,1,0
74933,1,2,261585,261585,261587,0,2,0
74934,1,1,261586,261587,261588,1,2,0
74935,5,2,261591,261591,261593,0,2,3
74936,1,2,261592,261593,261595,1,3,0
74937,1,3,261593,261595,261598,2,5,0
74938,3,2,261596,261598,261600,2,4,0
74939,2,3,261598,261600,261603,2,5,0
74940,5,2,261603,261603,261605,0,2,0
74941,5,2,261608,261608,261610,0,2,3
74942,3,2,261611,261611,261613,0,2,1
74943,6,2,261617,261617,261619,0,2,4
74944,2,3,261619,261619,261622,0,3,0
74945,2,3,261621,261622,261625,1,4,0
74946,1,3,261622,261625,261628,3,6,0
74947,3,3,261625,261628,261631,3,6,0
74948,1,2,261626,261631,261633,5,7,0
74949,6,3,261632,261633,261636,1,4,0
74950,6,3,261638,261638,261641,0,3,2
74951,2,3,261640,261641,261644,1,4,0
74952,6,1,261646,261646,261647,0,1,2
74953,2,1,261648,261648,261649,0,1,1
74954,6,1,261654,261654,261655,0,1,5
74955,5,1,261659,261659,261660,0,1,4
74956,2,2,261661,261661,261663,0,2,1
74957,1,2,261662,261663,261665,1,3,0
74958,3,3,261665,261665,261668,0,3,0
74959,3,1,261668,261668,261669,0,1,0
74960,2,1,261670,261670,261671,0,1,1
74961,6,1,261676,261676,261677,0,1,5
74962,2,3,261678,261678,261681,0,3,1
74963,3,2,261681,261681,261683,0,2,0
74964,6,2,261687,261687,261689,0,2,4
74965,5,2,261692,261692,261694,0,2,3
74966,2,3,261694,261694,261697,0,3,0
74967,1,2,261695,261697,261699,2,4,0
74968,2,3,261697,261699,261702,2,5,0
74969,2,2,261699,261702,261704,3,5,0
74970,3,3,261702,261704,261707,2,5,0
74971,1,2,261703,261707,261709,4,6,0
74972,5,2,261708,261709,261711,1,3,0
74973,1,2,261709,261711,261713,2,4,0
74974,3,1,261712,261713,261714,1,2,0
74975,4,2,261716,261716,261718,0,2,2
74976,6,3,261722,261722,261725,0,3,4
74977,3,3,261725,261725,261728,0,3,0
74978,6,3,261731,261731,261734,0,3,3
74979,5,1,261736,261736,261737,0,1,2
74980,1,3,261737,261737,261740,0,3,0
74981,5,3,261742,261742,261745,0,3,2
74982,6,2,261748,261748,261750,0,2,3
74983,2,3,261750,261750,261753,0,3,0
74984,6,2,261756,261756,261758,0,2,3
74985,1,2,261757,261758,261760,1,3,0
74986,2,3,261759,261760,261763,1,4,0
74987,4,3,261763,261763,261766,0,3,0
74988,5,2,261768,261768,261770,0,2,2
74989,1,2,261769,261770,261772,1,3,0
74990,2,2,261771,261772,261774,1,3,0
74991,4,3,261775,261775,261778,0,3,1
74992,4,2,261779,261779,261781,0,2,1
74993,2,1,261781,261781,261782,0,1,0
74994,2,2,261783,261783,261785,0,2,1
74995,1,3,261784,261785,261788,1,4,0
74996,4,3,261788,261788,261791,0,3,0
74997,3,3,261791,261791,261794,0,3,0
74998,1,2,261792,261794,261796,2,4,0
74999,5,1,261797,261797,261798,0,1,1
75000,5,3,261802,261802,261805,0,3,4
75001,2,3,261804,261805,261808,1,4,0
75002,6,1,261810,261810,261811,0,1,2
75003,1,1,261811,261811,261812,0,1,0
75004,1,2,261812,261812,261814,0,2,0
75005,6,2,261818,261818,261820,0,2,4
75006,3,1,261821,261821,261822,0,1,1
75007,5,3,261826,261826,261829,0,3,4
75008,3,3,261829,261829,261832,0,3,0
75009,1,3,261830,261832,261835,2,5,0
75010,3,1,261833,261835,261836,2,3,0
75011,1,2,261834,261836,261838,2,4,0
75012,1,2,261835,261838,261840,3,5,0
75013,5,3,261840,261840,261843,0,3,0
75014,5,3,261845,261845,261848,0,3,2
75015,5,1,261850,261850,261851,0,1,2
75016,2,3,261852,261852,261855,0,3,1
75017,3,2,261855,261855,261857,0,2,0
75018,5,2,261860,261860,261862,0,2,3
75019,6,2,261866,261866,261868,0,2,4
75020,2,2,261868,261868,261870,0,2,0
75021,2,1,261870,261870,261871,0,1,0
75022,4,3,261874,261874,261877,0,3,3
75023,2,1,261876,261877,261878,1,2,0
75024,2,3,261878,261878,261881,0,3,0
75025,4,2,261882,261882,261884,0,2,1
75026,2,2,261884,261884,261886,0,2,0
75027,2,1,261886,261886,261887,0,1,0
75028,3,2,261889,261889,261891,0,2,2
75029,2,2,261891,261891,261893,0,2,0
75030,5,3,261896,261896,261899,0,3,3
75031,5,1,261901,261901,261902,0,1,2
75032,1,3,261902,261902,261905,0,3,0
75033,1,2,261903,261905,261907,2,4,0
75034,3,3,261906,261907,261910,1,4,0
75035,2,2,261908,261910,261912,2,4,0
75036,1,3,261909,261912,261915,3,6,0
75037,6,2,261915,261915,261917,0,2,0
75038,2,1,261917,261917,261918,0,1,0
75039,3,1,261920,261920,261921,0,1,2
75040,1,2,261921,261921,261923,0,2,0
75041,4,3,261925,261925,261928,0,3,2
75042,6,2,261931,261931,261933,0,2,3
75043,1,3,261932,261933,261936,1,4,0
75044,5,3,261937,261937,261940,0,3,1
75045,6,3,261943,261943,261946,0,3,3
75046,4,3,261947,261947,261950,0,3,1
75047,6,2,261953,261953,261955,0,2,3
75048,1,1,261954,261955,261956,1,2,0
75049,1,2,261955,261956,261958,1,3,0
75050,2,3,261957,261958,261961,1,4,0
75051,2,3,261959,261961,261964,2,5,0
75052,5,3,261964,261964,261967,0,3,0
75053,4,2,261968,261968,261970,0,2,1
75054,6,1,261974,261974,261975,0,1,4
75055,3,3,261977,261977,261980,0,3,2
75056,3,2,261980,261980,261982,0,2,0
75057,3,1,261983,261983,261984,0,1,1
75058,6,3,261989,261989,261992,0,3,5
75059,6,3,261995,261995,261998,0,3,3
75060,4,1,261999,261999,262000,0,1,1
75061,2,3,262001,262001,262004,0,3,1
75062,2,1,262003,262004,262005,1,2,0
75063,5,2,262008,262008,262010,0,2,3
75064,3,2,262011,262011,262013,0,2,1
75065,5,2,262016,262016,262018,0,2,3
75066,2,2,262018,262018,262020,0,2,0
75067,4,2,262022,262022,262024,0,2,2
75068,5,1,262027,262027,262028,0,1,3
75069,2,2,262029,262029,262031,0,2,1
75070,6,3,262035,262035,262038,0,3,4
75071,1,2,262036,262038,262040,2,4,0
75072,2,1,262038,262040,262041,2,3,0
75073,3,3,262041,262041,262044,0,3,0
75074,1,2,262042,262044,262046,2,4,0
75075,6,2,262048,262048,262050,0,2,2
75076,6,3,262054,262054,262057,0,3,4
75077,2,2,262056,262057,262059,1,3,0
75078,2,3,262058,262059,262062,1,4,0
75079,6,3,262064,262064,262067,0,3,2
75080,4,2,262068,262068,262070,0,2,1
75081,4,3,262072,262072,262075,0,3,2
75082,5,3,262077,262077,262080,0,3,2
75083,4,2,262081,262081,262083,0,2,1
75084,5,3,262086,262086,262089,0,3,3
75085,4,1,262090,262090,262091,0,1,1
75086,3,2,262093,262093,262095,0,2,2
75087,1,1,262094,262095,262096,1,2,0
75088,1,3,262095,262096,262099,1,4,0
75089,3,1,262098,262099,262100,1,2,0
75090,2,1,262100,262100,262101,0,1,0
75091,2,3,262102,262102,262105,0,3,1
75092,6,1,262108,262108,262109,0,1,3
75093,4,2,262112,262112,262114,0,2,3
75094,5,1,262117,262117,262118,0,1,3
75095,4,1,262121,262121,262122,0,1,3
75096,3,1,262124,262124,262125,0,1,2
75097,5,1,262129,262129,262130,0,1,4
75098,6,2,262135,262135,262137,0,2,5
75099,2,1,262137,262137,262138,0,1,0
75100,1,1,262138,262138,262139,0,1,0
75101,1,2,262139,262139,262141,0,2,0
75102,1,3,262140,262141,262144,1,4,0
75103,3,2,262143,262144,262146,1,3,0
75104,4,2,262147,262147,262149,0,2,1
75105,5,3,262152,262152,262155,0,3,3
75106,6,1,262158,262158,262159,0,1,3
75107,5,2,262163,262163,262165,0,2,4
75108,4,3,262167,262167,262170,0,3,2
75109,4,1,262171,262171,262172,0,1,1
75110,6,1,262177,262177,262178,0,1,5
75111,2,2,262179,262179,262181,0,2,1
75112,6,1,262185,262185,262186,0,1,4
75113,6,2,262191,262191,262193,0,2,5
75114,3,1,262194,262194,262195,0,1,1
75115,6,2,262200,262200,262202,0,2,5
75116,1,2,262201,262202,262204,1,3,0
75117,3,3,262204,262204,262207,0,3,0
75118,4,3,262208,262208,262211,0,3,1
75119,5,3,262213,262213,262216,0,3,2
75120,6,1,262219,262219,262220,0,1,3
75121,2,2,262221,262221,262223,0,2,1
75122,3,3,262224,262224,262227,0,3,1
75123,6,3,262230,262230,262233,0,3,3
75124,5,1,262235,262235,262236,0,1,2
75125,6,1,262241,262241,262242,0,1,5
75126,2,3,262243,262243,262246,0,3,1
75127,5,1,262248,262248,262249,0,1,2
75128,6,2,262254,262254,262256,0,2,5
75129,5,1,262259,262259,262260,0,1,3
75130,3,3,262262,262262,262265,0,3,2
75131,2,3,262264,262265,262268,1,4,0
75132,3,2,262267,262268,262270,1,3,0
75133,3,1,262270,262270,262271,0,1,0
75134,1,3,262271,262271,262274,0,3,0
75135,2,1,262273,262274,262275,1,2,0
75136,2,2,262275,262275,262277,0,2,0
75137,3,3,262278,262278,262281,0,3,1
75138,1,2,262279,262281,262283,2,4,0
75139,4,3,262283,262283,262286,0,3,0
75140,1,1,262284,262286,262287,2,3,0
75141,1,2,262285,262287,262289,2,4,0
75142,3,3,262288,262289,262292,1,4,0
75143,5,3,262293,262293,262296,0,3,1
75144,4,2,262297,262297,262299,0,2,1
75145,6,1,262303,262303,262304,0,1,4
75146,1,1,262304,262304,262305,0,1,0
75147,6,1,262310,262310,262311,0,1,5
75148,1,1,262311,262311,262312,0,1,0
75149,3,1,262314,262314,262315,0,1,2
75150,1,3,262315,262315,262318,0,3,0
75151,1,3,262316,262318,262321,2,5,0
75152,1,3,262317,262321,262324,4,7,0
75153,1,3,262318,262324,262327,6,9,0
75154,6,2,262324,262327,262329,3,5,0
75155,2,1,262326,262329,262330,3,4,0
75156,2,2,262328,262330,262332,2,4,0
75157,2,3,262330,262332,262335,2,5,0
75158,6,2,262336,262336,262338,0,2,1
75159,5,3,262341,262341,262344,0,3,3
75160,1,3,262342,262344,262347,2,5,0
75161,2,2,262344,262347,262349,3,5,0
75162,1,2,262345,262349,262351,4,6,0
75163,5,3,262350,262351,262354,1,4,0
75164,6,3,262356,262356,262359,0,3,2
75165,4,1,262360,262360,262361,0,1,1
75166,2,1,262362,262362,262363,0,1,1
75167,6,1,262368,262368,262369,0,1,5
75168,6,2,262374,262374,262376,0,2,5
75169,3,2,262377,262377,262379,0,2,1
75170,5,1,262382,262382,262383,0,1,3
75171,3,2,262385,262385,262387,0,2,2
75172,3,1,262388,262388,262389,0,1,1
75173,1,1,262389,262389,262390,0,1,0
75174,5,3,262394,262394,262397,0,3,4
75175,4,3,262398,262398,262401,0,3,1
75176,5,2,262403,262403,262405,0,2,2
75177,6,1,262409,262409,262410,0,1,4
75178,4,2,262413,262413,262415,0,2,3
75179,6,3,262419,262419,262422,0,3,4
75180,5,2,262424,262424,262426,0,2,2
75181,5,2,262429,262429,262431,0,2,3
75182,1,1,262430,262431,262432,1,2,0
75183,3,2,262433,262433,262435,0,2,1
75184,6,1,262439,262439,262440,0,1,4
75185,3,3,262442,262442,262445,0,3,2
75186,3,2,262445,262445,262447,0,2,0
75187,6,2,262451,262451,262453,0,2,4
75188,2,2,262453,262453,262455,0,2,0
75189,4,3,262457,262457,262460,0,3,2
75190,3,3,262460,262460,262463,0,3,0
75191,4,1,262464,262464,262465,0,1,1
75192,6,2,262470,262470,262472,0,2,5
75193,1,2,262471,262472,262474,1,3,0
75194,3,3,262474,262474,262477,0,3,0
75195,2,3,262476,262477,262480,1,4,0
75196,1,3,262477,262480,262483,3,6,0
75197,5,2,262482,262483,262485,1,3,0
75198,6,1,262488,262488,262489,0,1,3
75199,3,2,262491,262491,262493,0,2,2
75200,6,3,262497,262497,262500,0,3,4
75201,2,1,262499,262500,262501,1,2,0
75202,5,3,262504,262504,262507,0,3,3
75203,3,2,262507,262507,262509,0,2,0
75204,1,1,262508,262509,262510,1,2,0
75205,2,1,262510,262510,262511,0,1,0
75206,4,2,262514,262514,262516,0,2,3
75207,3,1,262517,262517,262518,0,1,1
75208,2,3,262519,262519,262522,0,3,1
75209,5,3,262524,262524,262527,0,3,2
75210,5,2,262529,262529,262531,0,2,2
75211,6,1,262535,262535,262536,0,1,4
75212,4,2,262539,262539,262541,0,2,3
75213,6,3,262545,262545,262548,0,3,4
75214,2,1,262547,262548,262549,1,2,0
75215,3,2,262550,262550,262552,0,2,1
75216,2,2,262552,262552,262554,0,2,0
75217,4,3,262556,262556,262559,0,3,2
75218,3,2,262559,262559,262561,0,2,0
75219,5,1,262564,262564,262565,0,1,3
75220,2,2,262566,262566,262568,0,2,1
75221,6,1,262572,262572,262573,0,1,4
75222,4,1,262576,262576,262577,0,1,3
75223,4,1,262580,262580,262581,0,1,3
75224,4,3,262584,262584,262587,0,3,3
75225,5,1,262589,262589,262590,0,1,2
75226,5,1,262594,262594,262595,0,1,4
75227,4,3,262598,262598,262601,0,3,3
75228,5,1,262603,262603,262604,0,1,2
75229,2,2,262605,262605,262607,0,2,1
75230,2,2,262607,262607,262609,0,2,0
75231,1,3,262608,262609,262612,1,4,0
75232,3,3,262611,262612,262615,1,4,0
75233,1,2,262612,262615,262617,3,5,0
75234,5,2,262617,262617,262619,0,2,0
75235,6,2,262623,262623,262625,0,2,4
75236,5,1,262628,262628,262629,0,1,3
75237,1,2,262629,262629,262631,0,2,0
75238,2,2,262631,262631,262633,0,2,0
75239,2,3,262633,262633,262636,0,3,0
75240,2,2,262635,262636,262638,1,3,0
75241,2,1,262637,262638,262639,1,2,0
75242,4,2,262641,262641,262643,0,2,2
75243,1,3,262642,262643,262646,1,4,0
75244,6,3,262648,262648,262651,0,3,2
75245,4,2,262652,262652,262654,0,2,1
75246,2,2,262654,262654,262656,0,2,0
75247,1,1,262655,262656,262657,1,2,0
75248,2,3,262657,262657,262660,0,3,0
75249,2,2,262659,262660,262662,1,3,0
75250,6,3,262665,262665,262668,0,3,3
75251,5,1,262670,262670,262671,0,1,2
75252,4,1,262674,262674,262675,0,1,3
75253,1,1,262675,262675,262676,0,1,0
75254,1,1,262676,262676,262677,0,1,0
75255,3,2,262679,262679,262681,0,2,2
75256,3,3,262682,262682,262685,0,3,1
75257,6,3,262688,262688,262691,0,3,3
75258,2,1,262690,262691,262692,1,2,0
75259,3,3,262693,262693,262696,0,3,1
75260,3,2,262696,262696,262698,0,2,0
75261,6,1,262702,262702,262703,0,1,4
75262,1,3,262703,262703,262706,0,3,0
75263,4,2,262707,262707,262709,0,2,1
75264,4,2,262711,262711,262713,0,2,2
75265,3,3,262714,262714,262717,0,3,1
75266,6,1,262720,262720,262721,0,1,3
75267,3,3,262723,262723,262726,0,3,2
75268,5,2,262728,262728,262730,0,2,2
75269,3,2,262731,262731,262733,0,2,1
75270,6,1,262737,262737,262738,0,1,4
75271,2,1,262739,262739,262740,0,1,1
75272,4,1,262743,262743,262744,0,1,3
75273,4,3,262747,262747,262750,0,3,3
75274,1,3,262748,262750,262753,2,5,0
75275,1,3,262749,262753,262756,4,7,0
75276,6,1,262755,262756,262757,1,2,0
75277,4,3,262759,262759,262762,0,3,2
75278,4,2,262763,262763,262765,0,2,1
75279,6,1,262769,262769,262770,0,1,4
75280,5,1,262774,262774,262775,0,1,4
75281,3,1,262777,262777,262778,0,1,2
75282,4,1,262781,262781,262782,0,1,3
75283,1,3,262782,262782,262785,0,3,0
75284,3,1,262785,262785,262786,0,1,0
75285,4,1,262789,262789,262790,0,1,3
75286,4,1,262793,262793,262794,0,1,3
75287,3,3,262796,262796,262799,0,3,2
75288,2,3,262798,262799,262802,1,4,0
75289,6,3,262804,262804,262807,0,3,2
75290,2,2,262806,262807,262809,1,3,0
75291,3,1,262809,262809,262810,0,1,0
75292,6,1,262815,262815,262816,0,1,5
75293,5,2,262820,262820,262822,0,2,4
75294,5,2,262825,262825,262827,0,2,3
75295,6,3,262831,262831,262834,0,3,4
75296,4,3,262835,262835,262838,0,3,1
75297,2,3,262837,262838,262841,1,4,0
75298,5,3,262842,262842,262845,0,3,1
75299,2,3,262844,262845,262848,1,4,0
75300,5,2,262849,262849,262851,0,2,1
75301,3,1,262852,262852,262853,0,1,1
75302,3,3,262855,262855,262858,0,3,2
75303,1,3,262856,262858,262861,2,5,0
75304,3,1,262859,262861,262862,2,3,0
75305,4,2,262863,262863,262865,0,2,1
75306,3,3,262866,262866,262869,0,3,1
75307,4,2,262870,262870,262872,0,2,1
75308,3,3,262873,262873,262876,0,3,1
75309,6,2,262879,262879,262881,0,2,3
75310,1,1,262880,262881,262882,1,2,0
75311,4,3,262884,262884,262887,0,3,2
75312,6,3,262890,262890,262893,0,3,3
75313,2,3,262892,262893,262896,1,4,0
75314,2,3,262894,262896,262899,2,5,0
75315,5,2,262899,262899,262901,0,2,0
75316,1,1,262900,262901,262902,1,2,0
75317,5,2,262905,262905,262907,0,2,3
75318,3,1,262908,262908,262909,0,1,1
75319,1,3,262909,262909,262912,0,3,0
75320,2,2,262911,262912,262914,1,3,0
75321,2,2,262913,262914,262916,1,3,0
75322,6,1,262919,262919,262920,0,1,3
75323,1,3,262920,262920,262923,0,3,0
75324,2,2,262922,262923,262925,1,3,0
75325,4,2,262926,262926,262928,0,2,1
75326,5,1,262931,262931,262932,0,1,3
75327,3,1,262934,262934,262935,0,1,2
75328,3,1,262937,262937,262938,0,1,2
75329,1,1,262938,262938,262939,0,1,0
75330,4,3,262942,262942,262945,0,3,3
75331,5,1,262947,262947,262948,0,1,2
75332,3,1,262950,262950,262951,0,1,2
75333,4,1,262954,262954,262955,0,1,3
75334,3,2,262957,262957,262959,0,2,2
75335,1,3,262958,262959,262962,1,4,0
75336,2,3,262960,262962,262965,2,5,0
75337,2,2,262962,262965,262967,3,5,0
75338,4,3,262966,262967,262970,1,4,0
75339,2,1,262968,262970,262971,2,3,0
75340,2,3,262970,262971,262974,1,4,0
75341,3,3,262973,262974,262977,1,4,0
75342,5,3,262978,262978,262981,0,3,1
75343,3,3,262981,262981,262984,0,3,0
75344,2,3,262983,262984,262987,1,4,0
75345,6,1,262989,262989,262990,0,1,2
75346,1,2,262990,262990,262992,0,2,0
75347,6,2,262996,262996,262998,0,2,4
75348,5,3,263001,263001,263004,0,3,3
75349,6,2,263007,263007,263009,0,2,3
75350,5,3,263012,263012,263015,0,3,3
75351,2,2,263014,263015,263017,1,3,0
75352,4,2,263018,263018,263020,0,2,1
75353,3,3,263021,263021,263024,0,3,1
75354,1,3,263022,263024,263027,2,5,0
75355,5,3,263027,263027,263030,0,3,0
75356,4,1,263031,263031,263032,0,1,1
75357,1,3,263032,263032,263035,0,3,0
75358,2,2,263034,263035,263037,1,3,0
75359,3,2,263037,263037,263039,0,2,0
75360,5,3,263042,263042,263045,0,3,3
75361,3,2,263045,263045,263047,0,2,0
75362,3,1,263048,263048,263049,0,1,1
75363,3,1,263051,263051,263052,0,1,2
75364,1,3,263052,263052,263055,0,3,0
75365,6,2,263058,263058,263060,0,2,3
75366,2,2,263060,263060,263062,0,2,0
75367,6,2,263066,263066,263068,0,2,4
75368,1,1,263067,263068,263069,1,2,0
75369,6,1,263073,263073,263074,0,1,4
75370,3,3,263076,263076,263079,0,3,2
75371,4,1,263080,263080,263081,0,1,1
75372,5,1,263085,263085,263086,0,1,4
75373,1,2,263086,263086,263088,0,2,0
75374,6,2,263092,263092,263094,0,2,4
75375,5,1,263097,263097,263098,0,1,3
75376,3,3,263100,263100,263103,0,3,2
75377,1,3,263101,263103,263106,2,5,0
75378,2,3,263103,263106,263109,3,6,0
75379,1,2,263104,263109,263111,5,7,0
75380,5,2,263109,263111,263113,2,4,0
75381,1,2,263110,263113,263115,3,5,0
75382,1,3,263111,263115,263118,4,7,0
75383,2,3,263113,263118,263121,5,8,0
75384,1,3,263114,263121,263124,7,10,0
75385,2,1,263116,263124,263125,8,9,0
75386,6,3,263122,263125,263128,3,6,0
75387,4,1,263126,263128,263129,2,3,0
75388,6,2,263132,263132,263134,0,2,3
75389,5,2,263137,263137,263139,0,2,3
75390,1,1,263138,263139,263140,1,2,0
75391,1,1,263139,263140,263141,1,2,0
75392,5,3,263144,263144,263147,0,3,3
75393,3,3,263147,263147,263150,0,3,0
75394,4,3,263151,263151,263154,0,3,1
75395,4,2,263155,263155,263157,0,2,1
75396,4,2,263159,263159,263161,0,2,2
75397,3,1,263162,263162,263163,0,1,1
75398,1,2,263163,263163,263165,0,2,0
75399,4,3,263167,263167,263170,0,3,2
75400,3,1,263170,263170,263171,0,1,0
75401,4,2,263174,263174,263176,0,2,3
75402,3,3,263177,263177,263180,0,3,1
75403,3,2,263180,263180,263182,0,2,0
75404,1,2,263181,263182,263184,1,3,0
75405,4,1,263185,263185,263186,0,1,1
75406,6,1,263191,263191,263192,0,1,5
75407,2,2,263193,263193,263195,0,2,1
75408,1,2,263194,263195,263197,1,3,0
75409,5,3,263199,263199,263202,0,3,2
75410,4,2,263203,263203,263205,0,2,1
75411,2,3,263205,263205,263208,0,3,0
75412,4,3,263209,263209,263212,0,3,1
75413,1,1,263210,263212,263213,2,3,0
75414,3,3,263213,263213,263216,0,3,0
75415,2,3,263215,263216,263219,1,4,0
75416,2,1,263217,263219,263220,2,3,0
75417,1,2,263218,263220,263222,2,4,0
75418,6,1,263224,263224,263225,0,1,2
75419,2,1,263226,263226,263227,0,1,1
75420,3,1,263229,263229,263230,0,1,2
75421,3,3,263232,263232,263235,0,3,2
75422,1,3,263233,263235,263238,2,5,0
75423,1,2,263234,263238,263240,4,6,0
75424,2,1,263236,263240,263241,4,5,0
75425,6,3,263242,263242,263245,0,3,1
75426,6,2,263248,263248,263250,0,2,3
75427,6,3,263254,263254,263257,0,3,4
75428,5,1,263259,263259,263260,0,1,2
75429,2,3,263261,263261,263264,0,3,1
75430,6,2,263267,263267,263269,0,2,3
75431,2,1,263269,263269,263270,0,1,0
75432,6,1,263275,263275,263276,0,1,5
75433,4,3,263279,263279,263282,0,3,3
75434,2,2,263281,263282,263284,1,3,0
75435,5,3,263286,263286,263289,0,3,2
75436,5,1,263291,263291,263292,0,1,2
75437,6,2,263297,263297,263299,0,2,5
75438,3,3,263300,263300,263303,0,3,1
75439,1,1,263301,263303,263304,2,3,0
75440,5,1,263306,263306,263307,0,1,2
75441,3,1,263309,263309,263310,0,1,2
75442,2,1,263311,263311,263312,0,1,1
75443,5,1,263316,263316,263317,0,1,4
75444,3,2,263319,263319,263321,0,2,2
75445,2,3,263321,263321,263324,0,3,0
75446,3,2,263324,263324,263326,0,2,0
75447,2,1,263326,263326,263327,0,1,0
75448,5,3,263331,263331,263334,0,3,4
75449,4,1,263335,263335,263336,0,1,1
75450,4,2,263339,263339,263341,0,2,3
75451,6,1,263345,263345,263346,0,1,4
75452,1,3,263346,263346,263349,0,3,0
75453,6,3,263352,263352,263355,0,3,3
75454,2,3,263354,263355,263358,1,4,0
75455,3,3,263357,263358,263361,1,4,0
75456,6,1,263363,263363,263364,0,1,2
75457,6,2,263369,263369,263371,0,2,5
75458,2,1,263371,263371,263372,0,1,0
75459,6,3,263377,263377,263380,0,3,5
75460,2,3,263379,263380,263383,1,4,0
75461,5,1,263384,263384,263385,0,1,1
75462,5,2,263389,263389,263391,0,2,4
75463,2,2,263391,263391,263393,0,2,0
75464,6,3,263397,263397,263400,0,3,4
75465,6,1,263403,263403,263404,0,1,3
75466,4,3,263407,263407,263410,0,3,3
75467,6,3,263413,263413,263416,0,3,3
75468,3,3,263416,263416,263419,0,3,0
75469,1,2,263417,263419,263421,2,4,0
75470,6,3,263423,263423,263426,0,3,2
75471,4,2,263427,263427,263429,0,2,1
75472,5,3,263432,263432,263435,0,3,3
75473,6,1,263438,263438,263439,0,1,3
75474,5,3,263443,263443,263446,0,3,4
75475,6,3,263449,263449,263452,0,3,3
75476,5,3,263454,263454,263457,0,3,2
75477,2,2,263456,263457,263459,1,3,0
75478,1,1,263457,263459,263460,2,3,0
75479,4,2,263461,263461,263463,0,2,1
75480,1,3,263462,263463,263466,1,4,0
75481,6,2,263468,263468,263470,0,2,2
75482,3,3,263471,263471,263474,0,3,1
75483,2,3,263473,263474,263477,1,4,0
75484,5,1,263478,263478,263479,0,1,1
75485,6,1,263484,263484,263485,0,1,5
75486,6,3,263490,263490,263493,0,3,5
75487,1,2,263491,263493,263495,2,4,0
75488,3,3,263494,263495,263498,1,4,0
75489,6,1,263500,263500,263501,0,1,2
75490,2,1,263502,263502,263503,0,1,1
75491,5,3,263507,263507,263510,0,3,4
75492,6,2,263513,263513,263515,0,2,3
75493,6,3,263519,263519,263522,0,3,4
75494,1,2,263520,263522,263524,2,4,0
75495,6,2,263526,263526,263528,0,2,2
75496,4,3,263530,263530,263533,0,3,2
75497,5,1,263535,263535,263536,0,1,2
75498,1,2,263536,263536,263538,0,2,0
75499,4,1,263540,263540,263541,0,1,2
75500,4,1,263544,263544,263545,0,1,3
75501,4,1,263548,263548,263549,0,1,3
75502,4,2,263552,263552,263554,0,2,3
75503,2,1,263554,263554,263555,0,1,0
75504,6,2,263560,263560,263562,0,2,5
75505,1,1,263561,263562,263563,1,2,0
75506,3,1,263564,263564,263565,0,1,1
75507,1,3,263565,263565,263568,0,3,0
75508,2,2,263567,263568,263570,1,3,0
75509,1,3,263568,263570,263573,2,5,0
75510,5,2,263573,263573,263575,0,2,0
75511,4,2,263577,263577,263579,0,2,2
75512,4,2,263581,263581,263583,0,2,2
75513,1,1,263582,263583,263584,1,2,0
75514,5,2,263587,263587,263589,0,2,3
75515,1,1,263588,263589,263590,1,2,0
75516,1,3,263589,263590,263593,1,4,0
75517,1,3,263590,263593,263596,3,6,0
75518,2,2,263592,263596,263598,4,6,0
75519,3,1,263595,263598,263599,3,4,0
75520,2,1,263597,263599,263600,2,3,0
75521,5,1,263602,263602,263603,0,1,2
75522,4,1,263606,263606,263607,0,1,3
75523,6,3,263612,263612,263615,0,3,5
75524,1,3,263613,263615,263618,2,5,0
75525,4,2,263617,263618,263620,1,3,0
75526,5,3,263622,263622,263625,0,3,2
75527,6,3,263628,263628,263631,0,3,3
75528,5,3,263633,263633,263636,0,3,2
75529,2,3,263635,263636,263639,1,4,0
75530,6,1,263641,263641,263642,0,1,2
75531,6,1,263647,263647,263648,0,1,5
75532,1,1,263648,263648,263649,0,1,0
75533,1,3,263649,263649,263652,0,3,0
75534,4,1,263653,263653,263654,0,1,1
75535,1,2,263654,263654,263656,0,2,0
75536,4,1,263658,263658,263659,0,1,2
75537,6,3,263664,263664,263667,0,3,5
75538,6,3,263670,263670,263673,0,3,3
75539,4,3,263674,263674,263677,0,3,1
75540,5,3,263679,263679,263682,0,3,2
75541,1,2,263680,263682,263684,2,4,0
75542,2,1,263682,263684,263685,2,3,0
75543,2,2,263684,263685,263687,1,3,0
75544,5,1,263689,263689,263690,0,1,2
75545,3,1,263692,263692,263693,0,1,2
75546,4,3,263696,263696,263699,0,3,3
75547,5,3,263701,263701,263704,0,3,2
75548,5,1,263706,263706,263707,0,1,2
75549,5,2,263711,263711,263713,0,2,4
75550,6,3,263717,263717,263720,0,3,4
75551,3,3,263720,263720,263723,0,3,0
75552,5,2,263725,263725,263727,0,2,2
75553,2,2,263727,263727,263729,0,2,0
75554,4,2,263731,263731,263733,0,2,2
75555,6,2,263737,263737,263739,0,2,4
75556,6,3,263743,263743,263746,0,3,4
75557,3,3,263746,263746,263749,0,3,0
75558,1,1,263747,263749,263750,2,3,0
75559,4,3,263751,263751,263754,0,3,1
75560,3,2,263754,263754,263756,0,2,0
75561,1,3,263755,263756,263759,1,4,0
75562,1,2,263756,263759,263761,3,5,0
75563,1,1,263757,263761,263762,4,5,0
75564,4,2,263761,263762,263764,1,3,0
75565,5,3,263766,263766,263769,0,3,2
75566,2,1,263768,263769,263770,1,2,0
75567,3,2,263771,263771,263773,0,2,1
75568,6,2,263777,263777,263779,0,2,4
75569,5,3,263782,263782,263785,0,3,3
75570,5,3,263787,263787,263790,0,3,2
75571,1,2,263788,263790,263792,2,4,0
75572,4,2,263792,263792,263794,0,2,0
75573,1,3,263793,263794,263797,1,4,0
75574,2,1,263795,263797,263798,2,3,0
75575,3,2,263798,263798,263800,0,2,0
75576,2,1,263800,263800,263801,0,1,0
75577,5,2,263805,263805,263807,0,2,4
75578,5,3,263810,263810,263813,0,3,3
75579,4,3,263814,263814,263817,0,3,1
75580,3,3,263817,263817,263820,0,3,0
75581,2,3,263819,263820,263823,1,4,0
75582,1,2,263820,263823,263825,3,5,0
75583,3,1,263823,263825,263826,2,3,0
75584,5,2,263828,263828,263830,0,2,2
75585,5,3,263833,263833,263836,0,3,3
75586,5,3,263838,263838,263841,0,3,2
75587,6,3,263844,263844,263847,0,3,3
75588,5,2,263849,263849,263851,0,2,2
75589,6,3,263855,263855,263858,0,3,4
75590,3,2,263858,263858,263860,0,2,0
75591,3,2,263861,263861,263863,0,2,1
75592,5,3,263866,263866,263869,0,3,3
75593,1,3,263867,263869,263872,2,5,0
75594,5,2,263872,263872,263874,0,2,0
75595,3,3,263875,263875,263878,0,3,1
75596,2,2,263877,263878,263880,1,3,0
75597,3,3,263880,263880,263883,0,3,0
75598,1,2,263881,263883,263885,2,4,0
75599,2,1,263883,263885,263886,2,3,0
75600,4,1,263887,263887,263888,0,1,1
75601,6,2,263893,263893,263895,0,2,5
75602,6,3,263899,263899,263902,0,3,4
75603,5,3,263904,263904,263907,0,3,2
75604,1,1,263905,263907,263908,2,3,0
75605,5,1,263910,263910,263911,0,1,2
75606,5,3,263915,263915,263918,0,3,4
75607,5,2,263920,263920,263922,0,2,2
75608,4,1,263924,263924,263925,0,1,2
75609,3,3,263927,263927,263930,0,3,2
75610,4,2,263931,263931,263933,0,2,1
75611,6,3,263937,263937,263940,0,3,4
75612,5,3,263942,263942,263945,0,3,2
75613,6,1,263948,263948,263949,0,1,3
75614,2,2,263950,263950,263952,0,2,1
75615,5,1,263955,263955,263956,0,1,3
75616,6,2,263961,263961,263963,0,2,5
75617,4,3,263965,263965,263968,0,3,2
75618,4,2,263969,263969,263971,0,2,1
75619,1,1,263970,263971,263972,1,2,0
75620,4,2,263974,263974,263976,0,2,2
75621,3,1,263977,263977,263978,0,1,1
75622,3,1,263980,263980,263981,0,1,2
75623,1,1,263981,263981,263982,0,1,0
75624,6,1,263987,263987,263988,0,1,5
75625,2,2,263989,263989,263991,0,2,1
75626,1,3,263990,263991,263994,1,4,0
75627,4,2,263994,263994,263996,0,2,0
75628,4,1,263998,263998,263999,0,1,2
75629,6,1,264004,264004,264005,0,1,5
75630,1,3,264005,264005,264008,0,3,0
75631,4,1,264009,264009,264010,0,1,1
75632,3,2,264012,264012,264014,0,2,2
75633,4,3,264016,264016,264019,0,3,2
75634,5,1,264021,264021,264022,0,1,2
75635,4,1,264025,264025,264026,0,1,3
75636,3,2,264028,264028,264030,0,2,2
75637,1,1,264029,264030,264031,1,2,0
75638,5,2,264034,264034,264036,0,2,3
75639,1,2,264035,264036,264038,1,3,0
75640,1,3,264036,264038,264041,2,5,0
75641,6,2,264042,264042,264044,0,2,1
75642,4,1,264046,264046,264047,0,1,2
75643,3,1,264049,264049,264050,0,1,2
75644,4,3,264053,264053,264056,0,3,3
75645,1,3,264054,264056,264059,2,5,0
75646,3,2,264057,264059,264061,2,4,0
75647,1,3,264058,264061,264064,3,6,0
75648,3,2,264061,264064,264066,3,5,0
75649,1,2,264062,264066,264068,4,6,0
75650,5,2,264067,264068,264070,1,3,0
75651,5,1,264072,264072,264073,0,1,2
75652,5,1,264077,264077,264078,0,1,4
75653,2,1,264079,264079,264080,0,1,1
75654,5,2,264084,264084,264086,0,2,4
75655,1,2,264085,264086,264088,1,3,0
75656,2,1,264087,264088,264089,1,2,0
75657,1,3,264088,264089,264092,1,4,0
75658,6,2,264094,264094,264096,0,2,2
75659,2,3,264096,264096,264099,0,3,0
75660,3,1,264099,264099,264100,0,1,0
75661,6,3,264105,264105,264108,0,3,5
75662,5,1,264110,264110,264111,0,1,2
75663,4,2,264114,264114,264116,0,2,3
75664,2,2,264116,264116,264118,0,2,0
75665,5,1,264121,264121,264122,0,1,3
75666,1,3,264122,264122,264125,0,3,0
75667,1,3,264123,264125,264128,2,5,0
75668,4,3,264127,264128,264131,1,4,0
75669,4,2,264131,264131,264133,0,2,0
75670,6,1,264137,264137,264138,0,1,4
75671,6,3,264143,264143,264146,0,3,5
75672,2,2,264145,264146,264148,1,3,0
75673,4,3,264149,264149,264152,0,3,1
75674,5,2,264154,264154,264156,0,2,2
75675,3,3,264157,264157,264160,0,3,1
75676,1,1,264158,264160,264161,2,3,0
75677,2,3,264160,264161,264164,1,4,0
75678,1,1,264161,264164,264165,3,4,0
75679,2,2,264163,264165,264167,2,4,0
75680,2,2,264165,264167,264169,2,4,0
75681,4,2,264169,264169,264171,0,2,0
75682,4,2,264173,264173,264175,0,2,2
75683,6,3,264179,264179,264182,0,3,4
75684,6,1,264185,264185,264186,0,1,3
75685,1,1,264186,264186,264187,0,1,0
75686,2,3,264188,264188,264191,0,3,1
75687,1,1,264189,264191,264192,2,3,0
75688,4,1,264193,264193,264194,0,1,1
75689,3,1,264196,264196,264197,0,1,2
75690,1,1,264197,264197,264198,0,1,0
75691,1,3,264198,264198,264201,0,3,0
75692,5,1,264203,264203,264204,0,1,2
75693,5,2,264208,264208,264210,0,2,4
75694,2,1,264210,264210,264211,0,1,0
75695,3,1,264213,264213,264214,0,1,2
75696,3,3,264216,264216,264219,0,3,2
75697,6,2,264222,264222,264224,0,2,3
75698,1,2,264223,264224,264226,1,3,0
75699,6,1,264229,264229,264230,0,1,3
75700,6,1,264235,264235,264236,0,1,5
75701,1,2,264236,264236,264238,0,2,0
75702,1,3,264237,264238,264241,1,4,0
75703,1,1,264238,264241,264242,3,4,0
75704,5,3,264243,264243,264246,0,3,1
75705,1,3,264244,264246,264249,2,5,0
75706,4,1,264248,264249,264250,1,2,0
75707,6,1,264254,264254,264255,0,1,4
75708,4,2,264258,264258,264260,0,2,3
75709,1,2,264259,264260,264262,1,3,0
75710,3,3,264262,264262,264265,0,3,0
75711,5,1,264267,264267,264268,0,1,2
75712,1,3,264268,264268,264271,0,3,0
75713,2,3,264270,264271,264274,1,4,0
75714,1,3,264271,264274,264277,3,6,0
75715,1,1,264272,264277,264278,5,6,0
75716,4,1,264276,264278,264279,2,3,0
75717,6,1,264282,264282,264283,0,1,3
75718,4,1,264286,264286,264287,0,1,3
75719,5,1,264291,264291,264292,0,1,4
75720,5,2,264296,264296,264298,0,2,4
75721,2,1,264298,264298,264299,0,1,0
75722,1,1,264299,264299,264300,0,1,0
75723,4,3,264303,264303,264306,0,3,3
75724,3,1,264306,264306,264307,0,1,0
75725,4,2,264310,264310,264312,0,2,3
75726,1,3,264311,264312,264315,1,4,0
75727,4,1,264315,264315,264316,0,1,0
75728,5,3,264320,264320,264323,0,3,4
75729,5,2,264325,264325,264327,0,2,2
75730,6,2,264331,264331,264333,0,2,4
75731,4,3,264335,264335,264338,0,3,2
75732,3,2,264338,264338,264340,0,2,0
75733,2,3,264340,264340,264343,0,3,0
75734,1,2,264341,264343,264345,2,4,0
75735,2,2,264343,264345,264347,2,4,0
75736,5,3,264348,264348,264351,0,3,1
75737,4,1,264352,264352,264353,0,1,1
75738,5,1,264357,264357,264358,0,1,4
75739,4,3,264361,264361,264364,0,3,3
75740,1,3,264362,264364,264367,2,5,0
75741,4,2,264366,264367,264369,1,3,0
75742,1,3,264367,264369,264372,2,5,0
75743,5,3,264372,264372,264375,0,3,0
75744,6,3,264378,264378,264381,0,3,3
75745,2,1,264380,264381,264382,1,2,0
75746,4,2,264384,264384,264386,0,2,2
75747,1,3,264385,264386,264389,1,4,0
75748,2,2,264387,264389,264391,2,4,0
75749,4,3,264391,264391,264394,0,3,0
75750,1,2,264392,264394,264396,2,4,0
75751,2,1,264394,264396,264397,2,3,0
75752,1,1,264395,264397,264398,2,3,0
75753,6,3,264401,264401,264404,0,3,3
75754,3,1,264404,264404,264405,0,1,0
75755,4,2,264408,264408,264410,0,2,3
75756,5,1,264413,264413,264414,0,1,3
75757,4,1,264417,264417,264418,0,1,3
75758,3,1,264420,264420,264421,0,1,2
75759,4,1,264424,264424,264425,0,1,3
75760,1,2,264425,264425,264427,0,2,0
75761,3,2,264428,264428,264430,0,2,1
75762,3,1,264431,264431,264432,0,1,1
75763,2,1,264433,264433,264434,0,1,1
75764,2,3,264435,264435,264438,0,3,1
75765,4,2,264439,264439,264441,0,2,1
75766,3,1,264442,264442,264443,0,1,1
75767,5,2,264447,264447,264449,0,2,4
75768,5,3,264452,264452,264455,0,3,3
75769,3,1,264455,264455,264456,0,1,0
75770,4,1,264459,264459,264460,0,1,3
75771,4,2,264463,264463,264465,0,2,3
75772,3,1,264466,264466,264467,0,1,1
75773,4,3,264470,264470,264473,0,3,3
75774,1,3,264471,264473,264476,2,5,0
75775,3,2,264474,264476,264478,2,4,0
75776,1,2,264475,264478,264480,3,5,0
75777,3,1,264478,264480,264481,2,3,0
75778,6,3,264484,264484,264487,0,3,3
75779,2,3,264486,264487,264490,1,4,0
75780,1,2,264487,264490,264492,3,5,0
75781,4,1,264491,264492,264493,1,2,0
75782,1,2,264492,264493,264495,1,3,0
75783,6,2,264498,264498,264500,0,2,3
75784,6,2,264504,264504,264506,0,2,4
75785,5,1,264509,264509,264510,0,1,3
75786,3,3,264512,264512,264515,0,3,2
75787,3,1,264515,264515,264516,0,1,0
75788,2,1,264517,264517,264518,0,1,1
75789,6,1,264523,264523,264524,0,1,5
75790,2,3,264525,264525,264528,0,3,1
75791,4,2,264529,264529,264531,0,2,1
75792,6,3,264535,264535,264538,0,3,4
75793,3,2,264538,264538,264540,0,2,0
75794,6,2,264544,264544,264546,0,2,4
75795,6,1,264550,264550,264551,0,1,4
75796,4,3,264554,264554,264557,0,3,3
75797,1,3,264555,264557,264560,2,5,0
75798,1,3,264556,264560,264563,4,7,0
75799,5,1,264561,264563,264564,2,3,0
75800,1,2,264562,264564,264566,2,4,0
75801,5,1,264567,264567,264568,0,1,1
75802,6,1,264573,264573,264574,0,1,5
75803,1,1,264574,264574,264575,0,1,0
75804,2,2,264576,264576,264578,0,2,1
75805,2,1,264578,264578,264579,0,1,0
75806,2,2,264580,264580,264582,0,2,1
75807,2,2,264582,264582,264584,0,2,0
75808,5,1,264587,264587,264588,0,1,3
75809,6,1,264593,264593,264594,0,1,5
75810,2,2,264595,264595,264597,0,2,1
75811,6,3,264601,264601,264604,0,3,4
75812,3,2,264604,264604,264606,0,2,0
75813,1,1,264605,264606,264607,1,2,0
75814,1,1,264606,264607,264608,1,2,0
75815,6,3,264612,264612,264615,0,3,4
75816,1,1,264613,264615,264616,2,3,0
75817,4,3,264617,264617,264620,0,3,1
75818,1,1,264618,264620,264621,2,3,0
75819,6,3,264624,264624,264627,0,3,3
75820,1,1,264625,264627,264628,2,3,0
75821,1,3,264626,264628,264631,2,5,0
75822,3,1,264629,264631,264632,2,3,0
75823,4,2,264633,264633,264635,0,2,1
75824,6,2,264639,264639,264641,0,2,4
75825,2,2,264641,264641,264643,0,2,0
75826,1,3,264642,264643,264646,1,4,0
75827,1,3,264643,264646,264649,3,6,0
75828,3,2,264646,264649,264651,3,5,0
75829,5,1,264651,264651,264652,0,1,0
75830,4,3,264655,264655,264658,0,3,3
75831,3,2,264658,264658,264660,0,2,0
75832,4,3,264662,264662,264665,0,3,2
75833,2,1,264664,264665,264666,1,2,0
75834,2,3,264666,264666,264669,0,3,0
75835,1,2,264667,264669,264671,2,4,0
75836,1,3,264668,264671,264674,3,6,0
75837,6,1,264674,264674,264675,0,1,0
75838,6,1,264680,264680,264681,0,1,5
75839,1,2,264681,264681,264683,0,2,0
75840,1,3,264682,264683,264686,1,4,0
75841,1,1,264683,264686,264687,3,4,0
75842,6,1,264689,264689,264690,0,1,2
75843,1,2,264690,264690,264692,0,2,0
75844,1,2,264691,264692,264694,1,3,0
75845,4,3,264695,264695,264698,0,3,1
75846,5,3,264700,264700,264703,0,3,2
75847,1,2,264701,264703,264705,2,4,0
75848,4,2,264705,264705,264707,0,2,0
75849,1,2,264706,264707,264709,1,3,0
75850,6,1,264712,264712,264713,0,1,3
75851,4,2,264716,264716,264718,0,2,3
75852,1,1,264717,264718,264719,1,2,0
75853,1,2,264718,264719,264721,1,3,0
75854,6,3,264724,264724,264727,0,3,3
75855,4,1,264728,264728,264729,0,1,1
75856,1,3,264729,264729,264732,0,3,0
75857,2,2,264731,264732,264734,1,3,0
75858,3,3,264734,264734,264737,0,3,0
75859,2,1,264736,264737,264738,1,2,0
75860,6,1,264742,264742,264743,0,1,4
75861,4,1,264746,264746,264747,0,1,3
75862,4,2,264750,264750,264752,0,2,3
75863,2,3,264752,264752,264755,0,3,0
75864,6,1,264758,264758,264759,0,1,3
75865,1,1,264759,264759,264760,0,1,0
75866,3,2,264762,264762,264764,0,2,2
75867,1,2,264763,264764,264766,1,3,0
75868,2,3,264765,264766,264769,1,4,0
75869,5,3,264770,264770,264773,0,3,1
75870,5,3,264775,264775,264778,0,3,2
75871,3,1,264778,264778,264779,0,1,0
75872,2,1,264780,264780,264781,0,1,1
75873,3,3,264783,264783,264786,0,3,2
75874,4,2,264787,264787,264789,0,2,1
75875,6,1,264793,264793,264794,0,1,4
75876,5,3,264798,264798,264801,0,3,4
75877,5,2,264803,264803,264805,0,2,2
75878,5,3,264808,264808,264811,0,3,3
75879,1,2,264809,264811,264813,2,4,0
75880,6,3,264815,264815,264818,0,3,2
75881,6,1,264821,264821,264822,0,1,3
75882,2,1,264823,264823,264824,0,1,1
75883,6,1,264829,264829,264830,0,1,5
75884,2,1,264831,264831,264832,0,1,1
75885,3,1,264834,264834,264835,0,1,2
75886,5,1,264839,264839,264840,0,1,4
75887,1,3,264840,264840,264843,0,3,0
75888,1,3,264841,264843,264846,2,5,0
75889,4,2,264845,264846,264848,1,3,0
75890,3,3,264848,264848,264851,0,3,0
75891,1,3,264849,264851,264854,2,5,0
75892,4,1,264853,264854,264855,1,2,0
75893,5,3,264858,264858,264861,0,3,3
75894,1,3,264859,264861,264864,2,5,0
75895,2,3,264861,264864,264867,3,6,0
75896,6,2,264867,264867,264869,0,2,0
75897,2,2,264869,264869,264871,0,2,0
75898,1,3,264870,264871,264874,1,4,0
75899,6,2,264876,264876,264878,0,2,2
75900,5,1,264881,264881,264882,0,1,3
75901,3,1,264884,264884,264885,0,1,2
75902,3,3,264887,264887,264890,0,3,2
75903,6,2,264893,264893,264895,0,2,3
75904,6,2,264899,264899,264901,0,2,4
75905,2,2,264901,264901,264903,0,2,0
75906,5,2,264906,264906,264908,0,2,3
75907,6,3,264912,264912,264915,0,3,4
75908,5,2,264917,264917,264919,0,2,2
75909,2,2,264919,264919,264921,0,2,0
75910,6,3,264925,264925,264928,0,3,4
75911,5,2,264930,264930,264932,0,2,2
75912,4,1,264934,264934,264935,0,1,2
75913,6,3,264940,264940,264943,0,3,5
75914,1,2,264941,264943,264945,2,4,0
75915,2,3,264943,264945,264948,2,5,0
75916,6,1,264949,264949,264950,0,1,1
75917,3,2,264952,264952,264954,0,2,2
75918,6,3,264958,264958,264961,0,3,4
75919,2,3,264960,264961,264964,1,4,0
75920,5,3,264965,264965,264968,0,3,1
75921,2,1,264967,264968,264969,1,2,0
75922,3,3,264970,264970,264973,0,3,1
75923,4,1,264974,264974,264975,0,1,1
75924,3,2,264977,264977,264979,0,2,2
75925,6,3,264983,264983,264986,0,3,4
75926,1,2,264984,264986,264988,2,4,0
75927,5,2,264989,264989,264991,0,2,1
75928,3,3,264992,264992,264995,0,3,1
75929,5,2,264997,264997,264999,0,2,2
75930,1,2,264998,264999,265001,1,3,0
75931,1,1,264999,265001,265002,2,3,0
75932,1,2,265000,265002,265004,2,4,0
75933,4,1,265004,265004,265005,0,1,0
75934,1,2,265005,265005,265007,0,2,0
75935,2,3,265007,265007,265010,0,3,0
75936,1,2,265008,265010,265012,2,4,0
75937,6,1,265014,265014,265015,0,1,2
75938,3,3,265017,265017,265020,0,3,2
75939,5,1,265022,265022,265023,0,1,2
75940,1,3,265023,265023,265026,0,3,0
75941,5,2,265028,265028,265030,0,2,2
75942,3,2,265031,265031,265033,0,2,1
75943,1,1,265032,265033,265034,1,2,0
75944,5,1,265037,265037,265038,0,1,3
75945,3,1,265040,265040,265041,0,1,2
75946,6,1,265046,265046,265047,0,1,5
75947,3,2,265049,265049,265051,0,2,2
75948,2,2,265051,265051,265053,0,2,0
75949,4,1,265055,265055,265056,0,1,2
75950,5,2,265060,265060,265062,0,2,4
75951,4,3,265064,265064,265067,0,3,2
75952,5,2,265069,265069,265071,0,2,2
75953,4,1,265073,265073,265074,0,1,2
75954,4,1,265077,265077,265078,0,1,3
75955,5,1,265082,265082,265083,0,1,4
75956,3,1,265085,265085,265086,0,1,2
75957,3,3,265088,265088,265091,0,3,2
75958,4,2,265092,265092,265094,0,2,1
75959,4,2,265096,265096,265098,0,2,2
75960,1,3,265097,265098,265101,1,4,0
75961,2,1,265099,265101,265102,2,3,0
75962,6,3,265105,265105,265108,0,3,3
75963,3,3,265108,265108,265111,0,3,0
75964,1,3,265109,265111,265114,2,5,0
75965,4,3,265113,265114,265117,1,4,0
75966,2,2,265115,265117,265119,2,4,0
75967,5,3,265120,265120,265123,0,3,1
75968,1,3,265121,265123,265126,2,5,0
75969,2,1,265123,265126,265127,3,4,0
75970,4,1,265127,265127,265128,0,1,0
75971,6,1,265133,265133,265134,0,1,5
75972,2,3,265135,265135,265138,0,3,1
75973,2,2,265137,265138,265140,1,3,0
75974,4,1,265141,265141,265142,0,1,1
75975,1,3,265142,265142,265145,0,3,0
75976,1,2,265143,265145,265147,2,4,0
75977,5,3,265148,265148,265151,0,3,1
75978,2,3,265150,265151,265154,1,4,0
75979,3,3,265153,265154,265157,1,4,0
75980,4,2,265157,265157,265159,0,2,0
75981,1,2,265158,265159,265161,1,3,0
75982,5,2,265163,265163,265165,0,2,2
75983,2,3,265165,265165,265168,0,3,0
75984,2,1,265167,265168,265169,1,2,0
75985,1,2,265168,265169,265171,1,3,0
75986,3,2,265171,265171,265173,0,2,0
75987,6,3,265177,265177,265180,0,3,4
75988,2,2,265179,265180,265182,1,3,0
75989,5,2,265184,265184,265186,0,2,2
75990,1,1,265185,265186,265187,1,2,0
75991,1,3,265186,265187,265190,1,4,0
75992,6,3,265192,265192,265195,0,3,2
75993,4,1,265196,265196,265197,0,1,1
75994,6,3,265202,265202,265205,0,3,5
75995,6,1,265208,265208,265209,0,1,3
75996,2,1,265210,265210,265211,0,1,1
75997,6,3,265216,265216,265219,0,3,5
75998,1,2,265217,265219,265221,2,4,0
75999,2,3,265219,265221,265224,2,5,0
76000,1,1,265220,265224,265225,4,5,0
76001,2,1,265222,265225,265226,3,4,0
76002,1,3,265223,265226,265229,3,6,0
76003,5,1,265228,265229,265230,1,2,0
76004,4,1,265232,265232,265233,0,1,2
76005,4,3,265236,265236,265239,0,3,3
76006,5,3,265241,265241,265244,0,3,2
76007,2,1,265243,265244,265245,1,2,0
76008,3,3,265246,265246,265249,0,3,1
76009,1,3,265247,265249,265252,2,5,0
76010,1,1,265248,265252,265253,4,5,0
76011,3,3,265251,265253,265256,2,5,0
76012,1,1,265252,265256,265257,4,5,0
76013,2,3,265254,265257,265260,3,6,0
76014,2,1,265256,265260,265261,4,5,0
76015,2,2,265258,265261,265263,3,5,0
76016,5,2,265263,265263,265265,0,2,0
76017,3,1,265266,265266,265267,0,1,1
76018,5,1,265271,265271,265272,0,1,4
76019,1,3,265272,265272,265275,0,3,0
76020,1,3,265273,265275,265278,2,5,0
76021,2,1,265275,265278,265279,3,4,0
76022,3,3,265278,265279,265282,1,4,0
76023,1,1,265279,265282,265283,3,4,0
76024,6,2,265285,265285,265287,0,2,2
76025,2,2,265287,265287,265289,0,2,0
76026,6,1,265293,265293,265294,0,1,4
76027,6,3,265299,265299,265302,0,3,5
76028,3,2,265302,265302,265304,0,2,0
76029,4,2,265306,265306,265308,0,2,2
76030,6,3,265312,265312,265315,0,3,4
76031,5,1,265317,265317,265318,0,1,2
76032,2,2,265319,265319,265321,0,2,1
76033,3,2,265322,265322,265324,0,2,1
76034,3,1,265325,265325,265326,0,1,1
76035,3,2,265328,265328,265330,0,2,2
76036,3,3,265331,265331,265334,0,3,1
76037,2,1,265333,265334,265335,1,2,0
76038,2,3,265335,265335,265338,0,3,0
76039,3,1,265338,265338,265339,0,1,0
76040,3,2,265341,265341,265343,0,2,2
76041,4,1,265345,265345,265346,0,1,2
76042,6,2,265351,265351,265353,0,2,5
76043,2,1,265353,265353,265354,0,1,0
76044,1,3,265354,265354,265357,0,3,0
76045,5,2,265359,265359,265361,0,2,2
76046,1,1,265360,265361,265362,1,2,0
76047,1,1,265361,265362,265363,1,2,0
76048,1,2,265362,265363,265365,1,3,0
76049,4,3,265366,265366,265369,0,3,1
76050,6,1,265372,265372,265373,0,1,3
76051,3,1,265375,265375,265376,0,1,2
76052,2,1,265377,265377,265378,0,1,1
76053,2,2,265379,265379,265381,0,2,1
76054,6,2,265385,265385,265387,0,2,4
76055,6,3,265391,265391,265394,0,3,4
76056,4,1,265395,265395,265396,0,1,1
76057,3,3,265398,265398,265401,0,3,2
76058,1,3,265399,265401,265404,2,5,0
76059,2,3,265401,265404,265407,3,6,0
76060,4,1,265405,265407,265408,2,3,0
76061,3,1,265408,265408,265409,0,1,0
76062,2,2,265410,265410,265412,0,2,1
76063,1,2,265411,265412,265414,1,3,0
76064,5,1,265416,265416,265417,0,1,2
76065,4,3,265420,265420,265423,0,3,3
76066,4,3,265424,265424,265427,0,3,1
76067,4,3,265428,265428,265431,0,3,1
76068,2,3,265430,265431,265434,1,4,0
76069,1,3,265431,265434,265437,3,6,0
76070,2,2,265433,265437,265439,4,6,0
76071,3,3,265436,265439,265442,3,6,0
76072,6,1,265442,265442,265443,0,1,0
76073,4,2,265446,265446,265448,0,2,3
76074,4,1,265450,265450,265451,0,1,2
76075,1,2,265451,265451,265453,0,2,0
76076,1,3,265452,265453,265456,1,4,0
76077,3,2,265455,265456,265458,1,3,0
76078,4,3,265459,265459,265462,0,3,1
76079,1,3,265460,265462,265465,2,5,0
76080,2,3,265462,265465,265468,3,6,0
76081,6,2,265468,265468,265470,0,2,0
76082,5,1,265473,265473,265474,0,1,3
76083,4,2,265477,265477,265479,0,2,3
76084,6,1,265483,265483,265484,0,1,4
76085,1,2,265484,265484,265486,0,2,0
76086,3,1,265487,265487,265488,0,1,1
76087,6,1,265493,265493,265494,0,1,5
76088,4,3,265497,265497,265500,0,3,3
76089,3,2,265500,265500,265502,0,2,0
76090,3,3,265503,265503,265506,0,3,1
76091,4,2,265507,265507,265509,0,2,1
76092,6,2,265513,265513,265515,0,2,4
76093,1,2,265514,265515,265517,1,3,0
76094,3,1,265517,265517,265518,0,1,0
76095,3,3,265520,265520,265523,0,3,2
76096,1,2,265521,265523,265525,2,4,0
76097,6,2,265527,265527,265529,0,2,2
76098,3,3,265530,265530,265533,0,3,1
76099,2,1,265532,265533,265534,1,2,0
76100,6,1,265538,265538,265539,0,1,4
76101,3,3,265541,265541,265544,0,3,2
76102,3,2,265544,265544,265546,0,2,0
76103,1,1,265545,265546,265547,1,2,0
76104,3,3,265548,265548,265551,0,3,1
76105,2,2,265550,265551,265553,1,3,0
76106,3,1,265553,265553,265554,0,1,0
76107,2,1,265555,265555,265556,0,1,1
76108,2,2,265557,265557,265559,0,2,1
76109,3,2,265560,265560,265562,0,2,1
76110,3,2,265563,265563,265565,0,2,1
76111,2,1,265565,265565,265566,0,1,0
76112,3,2,265568,265568,265570,0,2,2
76113,5,2,265573,265573,265575,0,2,3
76114,2,2,265575,265575,265577,0,2,0
76115,6,3,265581,265581,265584,0,3,4
76116,2,2,265583,265584,265586,1,3,0
76117,6,1,265589,265589,265590,0,1,3
76118,3,2,265592,265592,265594,0,2,2
76119,5,3,265597,265597,265600,0,3,3
76120,4,1,265601,265601,265602,0,1,1
76121,2,1,265603,265603,265604,0,1,1
76122,3,2,265606,265606,265608,0,2,2
76123,2,1,265608,265608,265609,0,1,0
76124,6,1,265614,265614,265615,0,1,5
76125,4,1,265618,265618,265619,0,1,3
76126,1,3,265619,265619,265622,0,3,0
76127,3,1,265622,265622,265623,0,1,0
76128,4,2,265626,265626,265628,0,2,3
76129,1,3,265627,265628,265631,1,4,0
76130,5,2,265632,265632,265634,0,2,1
76131,6,2,265638,265638,265640,0,2,4
76132,3,1,265641,265641,265642,0,1,1
76133,6,1,265647,265647,265648,0,1,5
76134,4,2,265651,265651,265653,0,2,3
76135,3,1,265654,265654,265655,0,1,1
76136,3,2,265657,265657,265659,0,2,2
76137,4,1,265661,265661,265662,0,1,2
76138,6,2,265667,265667,265669,0,2,5
76139,5,3,265672,265672,265675,0,3,3
76140,3,1,265675,265675,265676,0,1,0
76141,5,3,265680,265680,265683,0,3,4
76142,1,3,265681,265683,265686,2,5,0
76143,1,1,265682,265686,265687,4,5,0
76144,4,3,265686,265687,265690,1,4,0
76145,2,3,265688,265690,265693,2,5,0
76146,4,2,265692,265693,265695,1,3,0
76147,3,2,265695,265695,265697,0,2,0
76148,1,3,265696,265697,265700,1,4,0
76149,2,2,265698,265700,265702,2,4,0
76150,1,1,265699,265702,265703,3,4,0
76151,6,1,265705,265705,265706,0,1,2
76152,5,1,265710,265710,265711,0,1,4
76153,6,1,265716,265716,265717,0,1,5
76154,1,3,265717,265717,265720,0,3,0
76155,6,1,265723,265723,265724,0,1,3
76156,3,3,265726,265726,265729,0,3,2
76157,1,1,265727,265729,265730,2,3,0
76158,3,3,265730,265730,265733,0,3,0
76159,2,2,265732,265733,265735,1,3,0
76160,2,1,265734,265735,265736,1,2,0
76161,5,1,265739,265739,265740,0,1,3
76162,6,1,265745,265745,265746,0,1,5
76163,5,2,265750,265750,265752,0,2,4
76164,5,3,265755,265755,265758,0,3,3
76165,6,3,265761,265761,265764,0,3,3
76166,1,2,265762,265764,265766,2,4,0
76167,6,2,265768,265768,265770,0,2,2
76168,2,1,265770,265770,265771,0,1,0
76169,1,1,265771,265771,265772,0,1,0
76170,4,2,265775,265775,265777,0,2,3
76171,6,3,265781,265781,265784,0,3,4
76172,3,3,265784,265784,265787,0,3,0
76173,4,2,265788,265788,265790,0,2,1
76174,2,2,265790,265790,265792,0,2,0
76175,5,3,265795,265795,265798,0,3,3
76176,1,1,265796,265798,265799,2,3,0
76177,3,2,265799,265799,265801,0,2,0
76178,6,2,265805,265805,265807,0,2,4
76179,6,3,265811,265811,265814,0,3,4
76180,4,2,265815,265815,265817,0,2,1
76181,1,2,265816,265817,265819,1,3,0
76182,2,2,265818,265819,265821,1,3,0
76183,4,3,265822,265822,265825,0,3,1
76184,5,2,265827,265827,265829,0,2,2
76185,1,3,265828,265829,265832,1,4,0
76186,2,3,265830,265832,265835,2,5,0
76187,6,2,265836,265836,265838,0,2,1
76188,1,1,265837,265838,265839,1,2,0
76189,1,2,265838,265839,265841,1,3,0
76190,6,2,265844,265844,265846,0,2,3
76191,2,1,265846,265846,265847,0,1,0
76192,1,1,265847,265847,265848,0,1,0
76193,1,3,265848,265848,265851,0,3,0
76194,5,3,265853,265853,265856,0,3,2
76195,5,2,265858,265858,265860,0,2,2
76196,2,3,265860,265860,265863,0,3,0
76197,6,2,265866,265866,265868,0,2,3
76198,6,1,265872,265872,265873,0,1,4
76199,2,1,265874,265874,265875,0,1,1
76200,3,3,265877,265877,265880,0,3,2
76201,2,3,265879,265880,265883,1,4,0
76202,5,3,265884,265884,265887,0,3,1
76203,5,3,265889,265889,265892,0,3,2
76204,4,2,265893,265893,265895,0,2,1
76205,4,3,265897,265897,265900,0,3,2
76206,3,2,265900,265900,265902,0,2,0
76207,3,1,265903,265903,265904,0,1,1
76208,6,1,265909,265909,265910,0,1,5
76209,1,3,265910,265910,265913,0,3,0
76210,5,3,265915,265915,265918,0,3,2
76211,3,2,265918,265918,265920,0,2,0
76212,4,2,265922,265922,265924,0,2,2
76213,3,1,265925,265925,265926,0,1,1
76214,1,3,265926,265926,265929,0,3,0
76215,5,3,265931,265931,265934,0,3,2
76216,5,2,265936,265936,265938,0,2,2
76217,5,1,265941,265941,265942,0,1,3
76218,5,2,265946,265946,265948,0,2,4
76219,2,3,265948,265948,265951,0,3,0
76220,6,2,265954,265954,265956,0,2,3
76221,2,3,265956,265956,265959,0,3,0
76222,1,2,265957,265959,265961,2,4,0
76223,5,2,265962,265962,265964,0,2,1
76224,1,3,265963,265964,265967,1,4,0
76225,1,1,265964,265967,265968,3,4,0
76226,2,2,265966,265968,265970,2,4,0
76227,3,2,265969,265970,265972,1,3,0
76228,4,3,265973,265973,265976,0,3,1
76229,4,2,265977,265977,265979,0,2,1
76230,6,3,265983,265983,265986,0,3,4
76231,6,2,265989,265989,265991,0,2,3
76232,4,1,265993,265993,265994,0,1,2
76233,1,2,265994,265994,265996,0,2,0
76234,6,1,266000,266000,266001,0,1,4
76235,2,3,266002,266002,266005,0,3,1
76236,1,3,266003,266005,266008,2,5,0
76237,2,2,266005,266008,266010,3,5,0
76238,4,1,266009,266010,266011,1,2,0
76239,6,1,266015,266015,266016,0,1,4
76240,5,2,266020,266020,266022,0,2,4
76241,2,3,266022,266022,266025,0,3,0
76242,1,1,266023,266025,266026,2,3,0
76243,6,1,266029,266029,266030,0,1,3
76244,3,2,266032,266032,266034,0,2,2
76245,3,3,266035,266035,266038,0,3,1
76246,2,2,266037,266038,266040,1,3,0
76247,1,2,266038,266040,266042,2,4,0
76248,6,1,266044,266044,266045,0,1,2
76249,3,3,266047,266047,266050,0,3,2
76250,3,2,266050,266050,266052,0,2,0
76251,4,1,266054,266054,266055,0,1,2
76252,3,1,266057,266057,266058,0,1,2
76253,5,3,266062,266062,266065,0,3,4
76254,4,2,266066,266066,266068,0,2,1
76255,6,3,266072,266072,266075,0,3,4
76256,5,2,266077,266077,266079,0,2,2
76257,3,3,266080,266080,266083,0,3,1
76258,6,2,266086,266086,266088,0,2,3
76259,1,3,266087,266088,266091,1,4,0
76260,6,3,266093,266093,266096,0,3,2
76261,3,1,266096,266096,266097,0,1,0
76262,3,3,266099,266099,266102,0,3,2
76263,1,3,266100,266102,266105,2,5,0
76264,6,2,266106,266106,266108,0,2,1
76265,1,3,266107,266108,266111,1,4,0
76266,5,2,266112,266112,266114,0,2,1
76267,2,1,266114,266114,266115,0,1,0
76268,1,2,266115,266115,266117,0,2,0
76269,5,2,266120,266120,266122,0,2,3
76270,5,3,266125,266125,266128,0,3,3
76271,6,1,266131,266131,266132,0,1,3
76272,2,1,266133,266133,266134,0,1,1
76273,4,2,266137,266137,266139,0,2,3
76274,1,3,266138,266139,266142,1,4,0
76275,2,1,266140,266142,266143,2,3,0
76276,1,3,266141,266143,266146,2,5,0
76277,2,1,266143,266146,266147,3,4,0
76278,1,3,266144,266147,266150,3,6,0
76279,2,1,266146,266150,266151,4,5,0
76280,2,1,266148,266151,266152,3,4,0
76281,6,3,266154,266154,266157,0,3,2
76282,3,2,266157,266157,266159,0,2,0
76283,4,3,266161,266161,266164,0,3,2
76284,6,1,266167,266167,266168,0,1,3
76285,1,3,266168,266168,266171,0,3,0
76286,3,1,266171,266171,266172,0,1,0
76287,3,3,266174,266174,266177,0,3,2
76288,6,1,266180,266180,266181,0,1,3
76289,6,3,266186,266186,266189,0,3,5
76290,1,1,266187,266189,266190,2,3,0
76291,5,2,266192,266192,266194,0,2,2
76292,6,3,266198,266198,266201,0,3,4
76293,5,3,266203,266203,266206,0,3,2
76294,6,3,266209,266209,266212,0,3,3
76295,4,2,266213,266213,266215,0,2,1
76296,5,2,266218,266218,266220,0,2,3
76297,6,2,266224,266224,266226,0,2,4
76298,3,2,266227,266227,266229,0,2,1
76299,6,1,266233,266233,266234,0,1,4
76300,5,3,266238,266238,266241,0,3,4
76301,6,1,266244,266244,266245,0,1,3
76302,3,3,266247,266247,266250,0,3,2
76303,4,1,266251,266251,266252,0,1,1
76304,3,1,266254,266254,266255,0,1,2
76305,6,2,266260,266260,266262,0,2,5
76306,5,3,266265,266265,266268,0,3,3
76307,1,1,266266,266268,266269,2,3,0
76308,1,2,266267,266269,266271,2,4,0
76309,1,1,266268,266271,266272,3,4,0
76310,2,3,266270,266272,266275,2,5,0
76311,6,2,266276,266276,266278,0,2,1
76312,6,3,266282,266282,266285,0,3,4
76313,5,2,266287,266287,266289,0,2,2
76314,1,3,266288,266289,266292,1,4,0
76315,5,2,266293,266293,266295,0,2,1
76316,2,3,266295,266295,266298,0,3,0
76317,5,2,266300,266300,266302,0,2,2
76318,6,2,266306,266306,266308,0,2,4
76319,5,1,266311,266311,266312,0,1,3
76320,2,2,266313,266313,266315,0,2,1
76321,6,3,266319,266319,266322,0,3,4
76322,5,1,266324,266324,266325,0,1,2
76323,5,2,266329,266329,266331,0,2,4
76324,6,2,266335,266335,266337,0,2,4
76325,1,2,266336,266337,266339,1,3,0
76326,4,3,266340,266340,266343,0,3,1
76327,3,2,266343,266343,266345,0,2,0
76328,3,3,266346,266346,266349,0,3,1
76329,4,3,266350,266350,266353,0,3,1
76330,1,2,266351,266353,266355,2,4,0
76331,3,2,266354,266355,266357,1,3,0
76332,4,3,266358,266358,266361,0,3,1
76333,1,1,266359,266361,266362,2,3,0
76334,2,1,266361,266362,266363,1,2,0
76335,1,1,266362,266363,266364,1,2,0
76336,5,2,266367,266367,266369,0,2,3
76337,2,3,266369,266369,266372,0,3,0
76338,3,3,266372,266372,266375,0,3,0
76339,4,1,266376,266376,266377,0,1,1
76340,5,2,266381,266381,266383,0,2,4
76341,2,1,266383,266383,266384,0,1,0
76342,2,3,266385,266385,266388,0,3,1
76343,6,2,266391,266391,266393,0,2,3
76344,5,2,266396,266396,266398,0,2,3
76345,4,2,266400,266400,266402,0,2,2
76346,6,2,266406,266406,266408,0,2,4
76347,6,3,266412,266412,266415,0,3,4
76348,1,3,266413,266415,266418,2,5,0
76349,1,3,266414,266418,266421,4,7,0
76350,3,2,266417,266421,266423,4,6,0
76351,3,1,266420,266423,266424,3,4,0
76352,6,3,266426,266426,266429,0,3,2
76353,3,2,266429,266429,266431,0,2,0
76354,5,3,266434,266434,266437,0,3,3
76355,3,1,266437,266437,266438,0,1,0
76356,1,2,266438,266438,266440,0,2,0
76357,4,2,266442,266442,266444,0,2,2
76358,4,2,266446,266446,266448,0,2,2
76359,5,1,266451,266451,266452,0,1,3
76360,6,1,266457,266457,266458,0,1,5
76361,2,3,266459,266459,266462,0,3,1
76362,6,2,266465,266465,266467,0,2,3
76363,5,3,266470,266470,266473,0,3,3
76364,4,3,266474,266474,266477,0,3,1
76365,6,3,266480,266480,266483,0,3,3
76366,6,3,266486,266486,266489,0,3,3
76367,3,3,266489,266489,266492,0,3,0
76368,4,1,266493,266493,266494,0,1,1
76369,5,1,266498,266498,266499,0,1,4
76370,3,3,266501,266501,266504,0,3,2
76371,6,1,266507,266507,266508,0,1,3
76372,4,1,266511,266511,266512,0,1,3
76373,3,1,266514,266514,266515,0,1,2
76374,1,3,266515,266515,266518,0,3,0
76375,3,1,266518,266518,266519,0,1,0
76376,6,3,266524,266524,266527,0,3,5
76377,3,2,266527,266527,266529,0,2,0
76378,4,2,266531,266531,266533,0,2,2
76379,4,3,266535,266535,266538,0,3,2
76380,3,3,266538,266538,266541,0,3,0
76381,5,2,266543,266543,266545,0,2,2
76382,6,1,266549,266549,266550,0,1,4
76383,3,1,266552,266552,266553,0,1,2
76384,5,2,266557,266557,266559,0,2,4
76385,4,2,266561,266561,266563,0,2,2
76386,4,1,266565,266565,266566,0,1,2
76387,6,2,266571,266571,266573,0,2,5
76388,1,2,266572,266573,266575,1,3,0
76389,1,1,266573,266575,266576,2,3,0
76390,3,3,266576,266576,266579,0,3,0
76391,3,3,266579,266579,266582,0,3,0
76392,4,3,266583,266583,266586,0,3,1
76393,2,3,266585,266586,266589,1,4,0
76394,5,3,266590,266590,266593,0,3,1
76395,1,3,266591,266593,266596,2,5,0
76396,5,1,266596,266596,266597,0,1,0
76397,1,3,266597,266597,266600,0,3,0
76398,3,2,266600,266600,266602,0,2,0
76399,1,2,266601,266602,266604,1,3,0
76400,3,3,266604,266604,266607,0,3,0
76401,2,3,266606,266607,266610,1,4,0
76402,6,1,266612,266612,266613,0,1,2
76403,6,3,266618,266618,266621,0,3,5
76404,1,1,266619,266621,266622,2,3,0
76405,5,3,266624,266624,266627,0,3,2
76406,5,1,266629,266629,266630,0,1,2
76407,1,2,266630,266630,266632,0,2,0
76408,2,2,266632,266632,266634,0,2,0
76409,4,2,266636,266636,266638,0,2,2
76410,5,3,266641,266641,266644,0,3,3
76411,3,1,266644,266644,266645,0,1,0
76412,1,1,266645,266645,266646,0,1,0
76413,1,3,266646,266646,266649,0,3,0
76414,3,1,266649,266649,266650,0,1,0
76415,6,3,266655,266655,266658,0,3,5
76416,2,1,266657,266658,266659,1,2,0
76417,1,2,266658,266659,266661,1,3,0
76418,1,2,266659,266661,266663,2,4,0
76419,4,2,266663,266663,266665,0,2,0
76420,4,1,266667,266667,266668,0,1,2
76421,5,2,266672,266672,266674,0,2,4
76422,3,2,266675,266675,266677,0,2,1
76423,1,1,266676,266677,266678,1,2,0
76424,6,1,266682,266682,266683,0,1,4
76425,4,1,266686,266686,266687,0,1,3
76426,2,2,266688,266688,266690,0,2,1
76427,4,2,266692,266692,266694,0,2,2
76428,4,2,266696,266696,266698,0,2,2
76429,3,2,266699,266699,266701,0,2,1
76430,1,3,266700,266701,266704,1,4,0
76431,1,3,266701,266704,266707,3,6,0
76432,4,1,266705,266707,266708,2,3,0
76433,3,3,266708,266708,266711,0,3,0
76434,5,2,266713,266713,266715,0,2,2
76435,4,3,266717,266717,266720,0,3,2
76436,5,3,266722,266722,266725,0,3,2
76437,2,3,266724,266725,266728,1,4,0
76438,1,1,266725,266728,266729,3,4,0
76439,4,2,266729,266729,266731,0,2,0
76440,3,2,266732,266732,266734,0,2,1
76441,4,1,266736,266736,266737,0,1,2
76442,2,2,266738,266738,266740,0,2,1
76443,3,3,266741,266741,266744,0,3,1
76444,2,1,266743,266744,266745,1,2,0
76445,3,2,266746,266746,266748,0,2,1
76446,1,2,266747,266748,266750,1,3,0
76447,1,2,266748,266750,266752,2,4,0
76448,5,1,266753,266753,266754,0,1,1
76449,5,1,266758,266758,266759,0,1,4
76450,3,2,266761,266761,266763,0,2,2
76451,2,2,266763,266763,266765,0,2,0
76452,6,1,266769,266769,266770,0,1,4
76453,6,2,266775,266775,266777,0,2,5
76454,2,3,266777,266777,266780,0,3,0
76455,6,1,266783,266783,266784,0,1,3
76456,1,3,266784,266784,266787,0,3,0
76457,4,3,266788,266788,266791,0,3,1
76458,4,1,266792,266792,266793,0,1,1
76459,5,1,266797,266797,266798,0,1,4
76460,2,1,266799,266799,266800,0,1,1
76461,6,3,266805,266805,266808,0,3,5
76462,4,1,266809,266809,266810,0,1,1
76463,4,3,266813,266813,266816,0,3,3
76464,3,2,266816,266816,266818,0,2,0
76465,4,2,266820,266820,266822,0,2,2
76466,6,2,266826,266826,266828,0,2,4
76467,6,1,266832,266832,266833,0,1,4
76468,2,2,266834,266834,266836,0,2,1
76469,2,3,266836,266836,266839,0,3,0
76470,4,2,266840,266840,266842,0,2,1
76471,2,2,266842,266842,266844,0,2,0
76472,1,2,266843,266844,266846,1,3,0
76473,1,1,266844,266846,266847,2,3,0
76474,6,3,266850,266850,266853,0,3,3
76475,3,2,266853,266853,266855,0,2,0
76476,3,2,266856,266856,266858,0,2,1
76477,6,3,266862,266862,266865,0,3,4
76478,1,2,266863,266865,266867,2,4,0
76479,4,2,266867,266867,266869,0,2,0
76480,1,3,266868,266869,266872,1,4,0
76481,1,1,266869,266872,266873,3,4,0
76482,6,1,266875,266875,266876,0,1,2
76483,4,3,266879,266879,266882,0,3,3
76484,1,1,266880,266882,266883,2,3,0
76485,5,1,266885,266885,266886,0,1,2
76486,4,1,266889,266889,266890,0,1,3
76487,2,2,266891,266891,266893,0,2,1
76488,1,2,266892,266893,266895,1,3,0
76489,1,3,266893,266895,266898,2,5,0
76490,4,2,266897,266898,266900,1,3,0
76491,6,3,266903,266903,266906,0,3,3
76492,5,1,266908,266908,266909,0,1,2
76493,5,3,266913,266913,266916,0,3,4
76494,5,1,266918,266918,266919,0,1,2
76495,6,2,266924,266924,266926,0,2,5
76496,3,3,266927,266927,266930,0,3,1
76497,5,2,266932,266932,266934,0,2,2
76498,6,3,266938,266938,266941,0,3,4
76499,2,1,266940,266941,266942,1,2,0
76500,5,2,266945,266945,266947,0,2,3
76501,1,2,266946,266947,266949,1,3,0
76502,6,2,266952,266952,266954,0,2,3
76503,5,1,266957,266957,266958,0,1,3
76504,2,3,266959,266959,266962,0,3,1
76505,5,1,266964,266964,266965,0,1,2
76506,3,2,266967,266967,266969,0,2,2
76507,4,3,266971,266971,266974,0,3,2
76508,5,2,266976,266976,266978,0,2,2
76509,4,2,266980,266980,266982,0,2,2
76510,1,2,266981,266982,266984,1,3,0
76511,4,3,266985,266985,266988,0,3,1
76512,6,1,266991,266991,266992,0,1,3
76513,4,3,266995,266995,266998,0,3,3
76514,1,1,266996,266998,266999,2,3,0
76515,6,2,267002,267002,267004,0,2,3
76516,3,2,267005,267005,267007,0,2,1
76517,6,2,267011,267011,267013,0,2,4
76518,4,3,267015,267015,267018,0,3,2
76519,6,1,267021,267021,267022,0,1,3
76520,6,2,267027,267027,267029,0,2,5
76521,6,1,267033,267033,267034,0,1,4
76522,6,1,267039,267039,267040,0,1,5
76523,6,3,267045,267045,267048,0,3,5
76524,3,2,267048,267048,267050,0,2,0
76525,5,3,267053,267053,267056,0,3,3
76526,2,1,267055,267056,267057,1,2,0
76527,2,3,267057,267057,267060,0,3,0
76528,4,2,267061,267061,267063,0,2,1
76529,1,1,267062,267063,267064,1,2,0
76530,6,3,267068,267068,267071,0,3,4
76531,2,3,267070,267071,267074,1,4,0
76532,4,2,267074,267074,267076,0,2,0
76533,1,1,267075,267076,267077,1,2,0
76534,5,3,267080,267080,267083,0,3,3
76535,6,3,267086,267086,267089,0,3,3
76536,2,1,267088,267089,267090,1,2,0
76537,3,2,267091,267091,267093,0,2,1
76538,3,1,267094,267094,267095,0,1,1
76539,3,3,267097,267097,267100,0,3,2
76540,2,3,267099,267100,267103,1,4,0
76541,1,3,267100,267103,267106,3,6,0
76542,6,1,267106,267106,267107,0,1,0
76543,2,2,267108,267108,267110,0,2,1
76544,3,3,267111,267111,267114,0,3,1
76545,1,3,267112,267114,267117,2,5,0
76546,4,1,267116,267117,267118,1,2,0
76547,3,3,267119,267119,267122,0,3,1
76548,6,3,267125,267125,267128,0,3,3
76549,3,1,267128,267128,267129,0,1,0
76550,5,1,267133,267133,267134,0,1,4
76551,1,1,267134,267134,267135,0,1,0
76552,4,1,267138,267138,267139,0,1,3
76553,3,2,267141,267141,267143,0,2,2
76554,6,1,267147,267147,267148,0,1,4
76555,4,2,267151,267151,267153,0,2,3
76556,6,3,267157,267157,267160,0,3,4
76557,4,3,267161,267161,267164,0,3,1
76558,6,2,267167,267167,267169,0,2,3
76559,2,3,267169,267169,267172,0,3,0
76560,4,1,267173,267173,267174,0,1,1
76561,5,1,267178,267178,267179,0,1,4
76562,4,3,267182,267182,267185,0,3,3
76563,3,2,267185,267185,267187,0,2,0
76564,3,1,267188,267188,267189,0,1,1
76565,2,1,267190,267190,267191,0,1,1
76566,4,1,267194,267194,267195,0,1,3
76567,4,3,267198,267198,267201,0,3,3
76568,5,2,267203,267203,267205,0,2,2
76569,4,2,267207,267207,267209,0,2,2
76570,6,2,267213,267213,267215,0,2,4
76571,4,1,267217,267217,267218,0,1,2
76572,3,3,267220,267220,267223,0,3,2
76573,4,2,267224,267224,267226,0,2,1
76574,1,1,267225,267226,267227,1,2,0
76575,6,3,267231,267231,267234,0,3,4
76576,2,1,267233,267234,267235,1,2,0
76577,2,1,267235,267235,267236,0,1,0
76578,2,2,267237,267237,267239,0,2,1
76579,3,2,267240,267240,267242,0,2,1
76580,2,2,267242,267242,267244,0,2,0
76581,3,1,267245,267245,267246,0,1,1
76582,3,2,267248,267248,267250,0,2,2
76583,2,3,267250,267250,267253,0,3,0
76584,6,1,267256,267256,267257,0,1,3
76585,5,3,267261,267261,267264,0,3,4
76586,5,1,267266,267266,267267,0,1,2
76587,5,2,267271,267271,267273,0,2,4
76588,3,2,267274,267274,267276,0,2,1
76589,2,2,267276,267276,267278,0,2,0
76590,6,1,267282,267282,267283,0,1,4
76591,4,2,267286,267286,267288,0,2,3
76592,4,2,267290,267290,267292,0,2,2
76593,3,2,267293,267293,267295,0,2,1
76594,2,1,267295,267295,267296,0,1,0
76595,2,3,267297,267297,267300,0,3,1
76596,3,1,267300,267300,267301,0,1,0
76597,1,1,267301,267301,267302,0,1,0
76598,1,2,267302,267302,267304,0,2,0
76599,4,1,267306,267306,267307,0,1,2
76600,5,2,267311,267311,267313,0,2,4
76601,4,2,267315,267315,267317,0,2,2
76602,5,2,267320,267320,267322,0,2,3
76603,4,3,267324,267324,267327,0,3,2
76604,1,1,267325,267327,267328,2,3,0
76605,4,2,267329,267329,267331,0,2,1
76606,5,1,267334,267334,267335,0,1,3
76607,1,1,267335,267335,267336,0,1,0
76608,5,2,267340,267340,267342,0,2,4
76609,2,2,267342,267342,267344,0,2,0
76610,3,2,267345,267345,267347,0,2,1
76611,3,3,267348,267348,267351,0,3,1
76612,3,3,267351,267351,267354,0,3,0
76613,1,1,267352,267354,267355,2,3,0
76614,6,3,267358,267358,267361,0,3,3
76615,1,1,267359,267361,267362,2,3,0
76616,4,2,267363,267363,267365,0,2,1
76617,6,2,267369,267369,267371,0,2,4
76618,3,3,267372,267372,267375,0,3,1
76619,6,2,267378,267378,267380,0,2,3
76620,2,2,267380,267380,267382,0,2,0
76621,4,3,267384,267384,267387,0,3,2
76622,5,1,267389,267389,267390,0,1,2
76623,2,2,267391,267391,267393,0,2,1
76624,5,1,267396,267396,267397,0,1,3
76625,5,1,267401,267401,267402,0,1,4
76626,6,1,267407,267407,267408,0,1,5
76627,5,3,267412,267412,267415,0,3,4
76628,3,1,267415,267415,267416,0,1,0
76629,2,2,267417,267417,267419,0,2,1
76630,5,2,267422,267422,267424,0,2,3
76631,3,1,267425,267425,267426,0,1,1
76632,2,2,267427,267427,267429,0,2,1
76633,1,1,267428,267429,267430,1,2,0
76634,3,2,267431,267431,267433,0,2,1
76635,6,2,267437,267437,267439,0,2,4
76636,1,1,267438,267439,267440,1,2,0
76637,1,1,267439,267440,267441,1,2,0
76638,5,3,267444,267444,267447,0,3,3
76639,1,2,267445,267447,267449,2,4,0
76640,4,3,267449,267449,267452,0,3,0
76641,4,1,267453,267453,267454,0,1,1
76642,2,3,267455,267455,267458,0,3,1
76643,6,3,267461,267461,267464,0,3,3
76644,6,2,267467,267467,267469,0,2,3
76645,4,2,267471,267471,267473,0,2,2
76646,1,2,267472,267473,267475,1,3,0
76647,3,1,267475,267475,267476,0,1,0
76648,6,1,267481,267481,267482,0,1,5
76649,6,1,267487,267487,267488,0,1,5
76650,4,3,267491,267491,267494,0,3,3
76651,5,1,267496,267496,267497,0,1,2
76652,6,2,267502,267502,267504,0,2,5
76653,6,2,267508,267508,267510,0,2,4
76654,1,2,267509,267510,267512,1,3,0
76655,1,1,267510,267512,267513,2,3,0
76656,3,2,267513,267513,267515,0,2,0
76657,4,3,267517,267517,267520,0,3,2
76658,6,2,267523,267523,267525,0,2,3
76659,5,1,267528,267528,267529,0,1,3
76660,3,2,267531,267531,267533,0,2,2
76661,3,1,267534,267534,267535,0,1,1
76662,4,2,267538,267538,267540,0,2,3
76663,6,2,267544,267544,267546,0,2,4
76664,6,3,267550,267550,267553,0,3,4
76665,6,2,267556,267556,267558,0,2,3
76666,5,1,267561,267561,267562,0,1,3
76667,3,2,267564,267564,267566,0,2,2
76668,5,2,267569,267569,267571,0,2,3
76669,4,3,267573,267573,267576,0,3,2
76670,1,3,267574,267576,267579,2,5,0
76671,6,2,267580,267580,267582,0,2,1
76672,1,2,267581,267582,267584,1,3,0
76673,2,3,267583,267584,267587,1,4,0
76674,2,2,267585,267587,267589,2,4,0
76675,3,2,267588,267589,267591,1,3,0
76676,4,3,267592,267592,267595,0,3,1
76677,1,1,267593,267595,267596,2,3,0
76678,1,1,267594,267596,267597,2,3,0
76679,3,3,267597,267597,267600,0,3,0
76680,6,1,267603,267603,267604,0,1,3
76681,1,1,267604,267604,267605,0,1,0
76682,6,1,267610,267610,267611,0,1,5
76683,3,3,267613,267613,267616,0,3,2
76684,2,2,267615,267616,267618,1,3,0
76685,4,1,267619,267619,267620,0,1,1
76686,6,2,267625,267625,267627,0,2,5
76687,4,2,267629,267629,267631,0,2,2
76688,5,1,267634,267634,267635,0,1,3
76689,4,1,267638,267638,267639,0,1,3
76690,1,2,267639,267639,267641,0,2,0
76691,3,2,267642,267642,267644,0,2,1
76692,6,3,267648,267648,267651,0,3,4
76693,2,3,267650,267651,267654,1,4,0
76694,2,2,267652,267654,267656,2,4,0
76695,3,2,267655,267656,267658,1,3,0
76696,6,2,267661,267661,267663,0,2,3
76697,4,2,267665,267665,267667,0,2,2
76698,4,3,267669,267669,267672,0,3,2
76699,4,2,267673,267673,267675,0,2,1
76700,6,2,267679,267679,267681,0,2,4
76701,2,3,267681,267681,267684,0,3,0
76702,6,2,267687,267687,267689,0,2,3
76703,6,2,267693,267693,267695,0,2,4
76704,2,3,267695,267695,267698,0,3,0
76705,6,1,267701,267701,267702,0,1,3
76706,2,1,267703,267703,267704,0,1,1
76707,1,1,267704,267704,267705,0,1,0
76708,5,3,267709,267709,267712,0,3,4
76709,4,2,267713,267713,267715,0,2,1
76710,5,2,267718,267718,267720,0,2,3
76711,5,1,267723,267723,267724,0,1,3
76712,1,3,267724,267724,267727,0,3,0
76713,6,2,267730,267730,267732,0,2,3
76714,3,2,267733,267733,267735,0,2,1
76715,3,2,267736,267736,267738,0,2,1
76716,6,2,267742,267742,267744,0,2,4
76717,6,1,267748,267748,267749,0,1,4
76718,2,3,267750,267750,267753,0,3,1
76719,6,1,267756,267756,267757,0,1,3
76720,4,1,267760,267760,267761,0,1,3
76721,2,3,267762,267762,267765,0,3,1
76722,3,3,267765,267765,267768,0,3,0
76723,4,3,267769,267769,267772,0,3,1
76724,2,3,267771,267772,267775,1,4,0
76725,5,3,267776,267776,267779,0,3,1
76726,6,2,267782,267782,267784,0,2,3
76727,1,2,267783,267784,267786,1,3,0
76728,6,3,267789,267789,267792,0,3,3
76729,1,3,267790,267792,267795,2,5,0
76730,1,1,267791,267795,267796,4,5,0
76731,2,2,267793,267796,267798,3,5,0
76732,5,1,267798,267798,267799,0,1,0
76733,5,2,267803,267803,267805,0,2,4
76734,5,3,267808,267808,267811,0,3,3
76735,5,3,267813,267813,267816,0,3,2
76736,2,3,267815,267816,267819,1,4,0
76737,1,3,267816,267819,267822,3,6,0
76738,1,1,267817,267822,267823,5,6,0
76739,5,1,267822,267823,267824,1,2,0
76740,4,3,267826,267826,267829,0,3,2
76741,3,1,267829,267829,267830,0,1,0
76742,5,3,267834,267834,267837,0,3,4
76743,3,3,267837,267837,267840,0,3,0
76744,5,2,267842,267842,267844,0,2,2
76745,2,3,267844,267844,267847,0,3,0
76746,1,1,267845,267847,267848,2,3,0
76747,2,2,267847,267848,267850,1,3,0
76748,4,3,267851,267851,267854,0,3,1
76749,3,1,267854,267854,267855,0,1,0
76750,3,2,267857,267857,267859,0,2,2
76751,1,2,267858,267859,267861,1,3,0
76752,4,2,267862,267862,267864,0,2,1
76753,5,1,267867,267867,267868,0,1,3
76754,5,3,267872,267872,267875,0,3,4
76755,1,2,267873,267875,267877,2,4,0
76756,5,1,267878,267878,267879,0,1,1
76757,1,3,267879,267879,267882,0,3,0
76758,2,2,267881,267882,267884,1,3,0
76759,4,2,267885,267885,267887,0,2,1
76760,6,1,267891,267891,267892,0,1,4
76761,5,1,267896,267896,267897,0,1,4
76762,6,3,267902,267902,267905,0,3,5
76763,4,3,267906,267906,267909,0,3,1
76764,3,1,267909,267909,267910,0,1,0
76765,6,2,267915,267915,267917,0,2,5
76766,2,3,267917,267917,267920,0,3,0
76767,3,1,267920,267920,267921,0,1,0
76768,1,2,267921,267921,267923,0,2,0
76769,3,2,267924,267924,267926,0,2,1
76770,1,3,267925,267926,267929,1,4,0
76771,5,3,267930,267930,267933,0,3,1
76772,6,1,267936,267936,267937,0,1,3
76773,1,1,267937,267937,267938,0,1,0
76774,6,2,267943,267943,267945,0,2,5
76775,3,1,267946,267946,267947,0,1,1
76776,3,1,267949,267949,267950,0,1,2
76777,1,2,267950,267950,267952,0,2,0
76778,4,2,267954,267954,267956,0,2,2
76779,3,2,267957,267957,267959,0,2,1
76780,2,2,267959,267959,267961,0,2,0
76781,6,1,267965,267965,267966,0,1,4
76782,1,2,267966,267966,267968,0,2,0
76783,3,2,267969,267969,267971,0,2,1
76784,1,2,267970,267971,267973,1,3,0
76785,2,2,267972,267973,267975,1,3,0
76786,4,1,267976,267976,267977,0,1,1
76787,4,1,267980,267980,267981,0,1,3
76788,1,1,267981,267981,267982,0,1,0
76789,2,2,267983,267983,267985,0,2,1
76790,5,1,267988,267988,267989,0,1,3
76791,2,3,267990,267990,267993,0,3,1
76792,6,1,267996,267996,267997,0,1,3
76793,3,1,267999,267999,268000,0,1,2
76794,3,3,268002,268002,268005,0,3,2
76795,3,3,268005,268005,268008,0,3,0
76796,1,3,268006,268008,268011,2,5,0
76797,2,1,268008,268011,268012,3,4,0
76798,6,3,268014,268014,268017,0,3,2
76799,6,1,268020,268020,268021,0,1,3
76800,3,2,268023,268023,268025,0,2,2
76801,6,2,268029,268029,268031,0,2,4
76802,2,2,268031,268031,268033,0,2,0
76803,4,2,268035,268035,268037,0,2,2
76804,1,2,268036,268037,268039,1,3,0
76805,1,3,268037,268039,268042,2,5,0
76806,2,1,268039,268042,268043,3,4,0
76807,4,3,268043,268043,268046,0,3,0
76808,3,3,268046,268046,268049,0,3,0
76809,1,1,268047,268049,268050,2,3,0
76810,6,3,268053,268053,268056,0,3,3
76811,5,3,268058,268058,268061,0,3,2
76812,4,1,268062,268062,268063,0,1,1
76813,1,1,268063,268063,268064,0,1,0
76814,2,3,268065,268065,268068,0,3,1
76815,1,1,268066,268068,268069,2,3,0
76816,5,2,268071,268071,268073,0,2,2
76817,4,3,268075,268075,268078,0,3,2
76818,2,3,268077,268078,268081,1,4,0
76819,3,2,268080,268081,268083,1,3,0
76820,4,2,268084,268084,268086,0,2,1
76821,3,3,268087,268087,268090,0,3,1
76822,1,1,268088,268090,268091,2,3,0
76823,4,2,268092,268092,268094,0,2,1
76824,6,1,268098,268098,268099,0,1,4
76825,5,3,268103,268103,268106,0,3,4
76826,4,1,268107,268107,268108,0,1,1
76827,3,3,268110,268110,268113,0,3,2
76828,1,3,268111,268113,268116,2,5,0
76829,3,2,268114,268116,268118,2,4,0
76830,6,2,268120,268120,268122,0,2,2
76831,1,2,268121,268122,268124,1,3,0
76832,1,2,268122,268124,268126,2,4,0
76833,2,1,268124,268126,268127,2,3,0
76834,2,1,268126,268127,268128,1,2,0
76835,5,2,268131,268131,268133,0,2,3
76836,2,1,268133,268133,268134,0,1,0
76837,2,1,268135,268135,268136,0,1,1
76838,4,2,268139,268139,268141,0,2,3
76839,2,3,268141,268141,268144,0,3,0
76840,6,3,268147,268147,268150,0,3,3
76841,2,1,268149,268150,268151,1,2,0
76842,5,3,268154,268154,268157,0,3,3
76843,4,3,268158,268158,268161,0,3,1
76844,5,3,268163,268163,268166,0,3,2
76845,2,1,268165,268166,268167,1,2,0
76846,3,2,268168,268168,268170,0,2,1
76847,2,3,268170,268170,268173,0,3,0
76848,3,3,268173,268173,268176,0,3,0
76849,1,1,268174,268176,268177,2,3,0
76850,3,2,268177,268177,268179,0,2,0
76851,4,1,268181,268181,268182,0,1,2
76852,4,2,268185,268185,268187,0,2,3
76853,6,1,268191,268191,268192,0,1,4
76854,1,2,268192,268192,268194,0,2,0
76855,6,3,268198,268198,268201,0,3,4
76856,3,2,268201,268201,268203,0,2,0
76857,5,1,268206,268206,268207,0,1,3
76858,5,2,268211,268211,268213,0,2,4
76859,2,3,268213,268213,268216,0,3,0
76860,4,3,268217,268217,268220,0,3,1
76861,6,3,268223,268223,268226,0,3,3
76862,2,3,268225,268226,268229,1,4,0
76863,1,2,268226,268229,268231,3,5,0
76864,4,2,268230,268231,268233,1,3,0
76865,4,1,268234,268234,268235,0,1,1
76866,2,1,268236,268236,268237,0,1,1
76867,1,1,268237,268237,268238,0,1,0
76868,6,2,268243,268243,268245,0,2,5
76869,6,2,268249,268249,268251,0,2,4
76870,4,2,268253,268253,268255,0,2,2
76871,2,3,268255,268255,268258,0,3,0
76872,1,2,268256,268258,268260,2,4,0
76873,3,3,268259,268260,268263,1,4,0
76874,5,2,268264,268264,268266,0,2,1
76875,2,1,268266,268266,268267,0,1,0
76876,6,1,268272,268272,268273,0,1,5
76877,6,2,268278,268278,268280,0,2,5
76878,4,2,268282,268282,268284,0,2,2
76879,4,2,268286,268286,268288,0,2,2
76880,3,3,268289,268289,268292,0,3,1
76881,6,2,268295,268295,268297,0,2,3
76882,1,3,268296,268297,268300,1,4,0
76883,3,2,268299,268300,268302,1,3,0
76884,5,1,268304,268304,268305,0,1,2
76885,1,2,268305,268305,268307,0,2,0
76886,6,1,268311,268311,268312,0,1,4
76887,6,2,268317,268317,268319,0,2,5
76888,6,1,268323,268323,268324,0,1,4
76889,4,3,268327,268327,268330,0,3,3
76890,6,2,268333,268333,268335,0,2,3
76891,2,2,268335,268335,268337,0,2,0
76892,5,3,268340,268340,268343,0,3,3
76893,1,2,268341,268343,268345,2,4,0
76894,5,1,268346,268346,268347,0,1,1
76895,1,3,268347,268347,268350,0,3,0
76896,1,1,268348,268350,268351,2,3,0
76897,5,3,268353,268353,268356,0,3,2
76898,4,3,268357,268357,268360,0,3,1
76899,6,1,268363,268363,268364,0,1,3
76900,5,1,268368,268368,268369,0,1,4
76901,6,3,268374,268374,268377,0,3,5
76902,4,1,268378,268378,268379,0,1,1
76903,3,2,268381,268381,268383,0,2,2
76904,4,2,268385,268385,268387,0,2,2
76905,3,2,268388,268388,268390,0,2,1
76906,1,3,268389,268390,268393,1,4,0
76907,6,3,268395,268395,268398,0,3,2
76908,4,1,268399,268399,268400,0,1,1
76909,2,1,268401,268401,268402,0,1,1
76910,3,3,268404,268404,268407,0,3,2
76911,1,3,268405,268407,268410,2,5,0
76912,4,1,268409,268410,268411,1,2,0
76913,3,2,268412,268412,268414,0,2,1
76914,3,1,268415,268415,268416,0,1,1
76915,6,3,268421,268421,268424,0,3,5
76916,1,3,268422,268424,268427,2,5,0
76917,1,2,268423,268427,268429,4,6,0
76918,3,3,268426,268429,268432,3,6,0
76919,2,3,268428,268432,268435,4,7,0
76920,2,3,268430,268435,268438,5,8,0
76921,5,3,268435,268438,268441,3,6,0
76922,5,1,268440,268441,268442,1,2,0
76923,4,2,268444,268444,268446,0,2,2
76924,1,2,268445,268446,268448,1,3,0
76925,3,3,268448,268448,268451,0,3,0
76926,4,1,268452,268452,268453,0,1,1
76927,5,2,268457,268457,268459,0,2,4
76928,5,3,268462,268462,268465,0,3,3
76929,4,3,268466,268466,268469,0,3,1
76930,1,3,268467,268469,268472,2,5,0
76931,3,3,268470,268472,268475,2,5,0
76932,3,1,268473,268475,268476,2,3,0
76933,4,3,268477,268477,268480,0,3,1
76934,4,3,268481,268481,268484,0,3,1
76935,2,1,268483,268484,268485,1,2,0
76936,5,2,268488,268488,268490,0,2,3
76937,6,3,268494,268494,268497,0,3,4
76938,6,3,268500,268500,268503,0,3,3
76939,3,1,268503,268503,268504,0,1,0
76940,1,3,268504,268504,268507,0,3,0
76941,1,3,268505,268507,268510,2,5,0
76942,4,1,268509,268510,268511,1,2,0
76943,1,2,268510,268511,268513,1,3,0
76944,4,1,268514,268514,268515,0,1,1
76945,5,1,268519,268519,268520,0,1,4
76946,2,3,268521,268521,268524,0,3,1
76947,2,3,268523,268524,268527,1,4,0
76948,2,1,268525,268527,268528,2,3,0
76949,6,3,268531,268531,268534,0,3,3
76950,3,2,268534,268534,268536,0,2,0
76951,4,3,268538,268538,268541,0,3,2
76952,2,1,268540,268541,268542,1,2,0
76953,4,1,268544,268544,268545,0,1,2
76954,4,2,268548,268548,268550,0,2,3
76955,2,3,268550,268550,268553,0,3,0
76956,6,2,268556,268556,268558,0,2,3
76957,5,3,268561,268561,268564,0,3,3
76958,1,1,268562,268564,268565,2,3,0
76959,6,3,268568,268568,268571,0,3,3
76960,4,1,268572,268572,268573,0,1,1
76961,5,3,268577,268577,268580,0,3,4
76962,3,1,268580,268580,268581,0,1,0
76963,6,3,268586,268586,268589,0,3,5
76964,2,2,268588,268589,268591,1,3,0
76965,5,3,268593,268593,268596,0,3,2
76966,5,3,268598,268598,268601,0,3,2
76967,2,3,268600,268601,268604,1,4,0
76968,3,2,268603,268604,268606,1,3,0
76969,4,3,268607,268607,268610,0,3,1
76970,6,3,268613,268613,268616,0,3,3
76971,6,3,268619,268619,268622,0,3,3
76972,4,2,268623,268623,268625,0,2,1
76973,4,2,268627,268627,268629,0,2,2
76974,3,1,268630,268630,268631,0,1,1
76975,4,2,268634,268634,268636,0,2,3
76976,6,1,268640,268640,268641,0,1,4
76977,4,3,268644,268644,268647,0,3,3
76978,4,1,268648,268648,268649,0,1,1
76979,1,1,268649,268649,268650,0,1,0
76980,6,3,268655,268655,268658,0,3,5
76981,4,3,268659,268659,268662,0,3,1
76982,3,3,268662,268662,268665,0,3,0
76983,1,1,268663,268665,268666,2,3,0
76984,2,1,268665,268666,268667,1,2,0
76985,1,3,268666,268667,268670,1,4,0
76986,1,2,268667,268670,268672,3,5,0
76987,3,2,268670,268672,268674,2,4,0
76988,1,3,268671,268674,268677,3,6,0
76989,4,1,268675,268677,268678,2,3,0
76990,5,3,268680,268680,268683,0,3,2
76991,5,1,268685,268685,268686,0,1,2
76992,2,3,268687,268687,268690,0,3,1
76993,6,1,268693,268693,268694,0,1,3
76994,2,1,268695,268695,268696,0,1,1
76995,2,3,268697,268697,268700,0,3,1
76996,4,1,268701,268701,268702,0,1,1
76997,2,2,268703,268703,268705,0,2,1
76998,3,1,268706,268706,268707,0,1,1
76999,1,1,268707,268707,268708,0,1,0
77000,3,1,268710,268710,268711,0,1,2
77001,4,3,268714,268714,268717,0,3,3
77002,4,2,268718,268718,268720,0,2,1
77003,6,2,268724,268724,268726,0,2,4
77004,6,3,268730,268730,268733,0,3,4
77005,1,1,268731,268733,268734,2,3,0
77006,1,1,268732,268734,268735,2,3,0
77007,1,2,268733,268735,268737,2,4,0
77008,6,3,268739,268739,268742,0,3,2
77009,3,3,268742,268742,268745,0,3,0
77010,4,3,268746,268746,268749,0,3,1
77011,5,3,268751,268751,268754,0,3,2
77012,5,2,268756,268756,268758,0,2,2
77013,2,2,268758,268758,268760,0,2,0
77014,4,1,268762,268762,268763,0,1,2
77015,5,2,268767,268767,268769,0,2,4
77016,4,3,268771,268771,268774,0,3,2
77017,3,1,268774,268774,268775,0,1,0
77018,3,3,268777,268777,268780,0,3,2
77019,6,3,268783,268783,268786,0,3,3
77020,3,2,268786,268786,268788,0,2,0
77021,5,2,268791,268791,268793,0,2,3
77022,4,3,268795,268795,268798,0,3,2
77023,6,1,268801,268801,268802,0,1,3
77024,3,1,268804,268804,268805,0,1,2
77025,6,1,268810,268810,268811,0,1,5
77026,6,1,268816,268816,268817,0,1,5
77027,6,3,268822,268822,268825,0,3,5
77028,2,2,268824,268825,268827,1,3,0
77029,3,3,268827,268827,268830,0,3,0
77030,1,1,268828,268830,268831,2,3,0
77031,5,2,268833,268833,268835,0,2,2
77032,5,3,268838,268838,268841,0,3,3
77033,6,2,268844,268844,268846,0,2,3
77034,1,2,268845,268846,268848,1,3,0
77035,3,2,268848,268848,268850,0,2,0
77036,6,2,268854,268854,268856,0,2,4
77037,4,1,268858,268858,268859,0,1,2
77038,3,1,268861,268861,268862,0,1,2
77039,2,1,268863,268863,268864,0,1,1
77040,4,3,268867,268867,268870,0,3,3
77041,3,3,268870,268870,268873,0,3,0
77042,3,3,268873,268873,268876,0,3,0
77043,3,1,268876,268876,268877,0,1,0
77044,4,2,268880,268880,268882,0,2,3
77045,5,1,268885,268885,268886,0,1,3
77046,5,2,268890,268890,268892,0,2,4
77047,3,1,268893,268893,268894,0,1,1
77048,5,3,268898,268898,268901,0,3,4
77049,2,3,268900,268901,268904,1,4,0
77050,5,3,268905,268905,268908,0,3,1
77051,3,2,268908,268908,268910,0,2,0
77052,2,2,268910,268910,268912,0,2,0
77053,3,2,268913,268913,268915,0,2,1
77054,1,1,268914,268915,268916,1,2,0
77055,2,1,268916,268916,268917,0,1,0
77056,3,1,268919,268919,268920,0,1,2
77057,2,3,268921,268921,268924,0,3,1
77058,6,1,268927,268927,268928,0,1,3
77059,5,2,268932,268932,268934,0,2,4
77060,1,3,268933,268934,268937,1,4,0
77061,4,3,268937,268937,268940,0,3,0
77062,1,2,268938,268940,268942,2,4,0
77063,2,1,268940,268942,268943,2,3,0
77064,1,1,268941,268943,268944,2,3,0
77065,4,3,268945,268945,268948,0,3,1
77066,3,1,268948,268948,268949,0,1,0
77067,5,2,268953,268953,268955,0,2,4
77068,4,3,268957,268957,268960,0,3,2
77069,3,3,268960,268960,268963,0,3,0
77070,2,1,268962,268963,268964,1,2,0
77071,3,3,268965,268965,268968,0,3,1
77072,3,2,268968,268968,268970,0,2,0
77073,4,2,268972,268972,268974,0,2,2
77074,3,3,268975,268975,268978,0,3,1
77075,4,2,268979,268979,268981,0,2,1
77076,4,1,268983,268983,268984,0,1,2
77077,5,1,268988,268988,268989,0,1,4
77078,4,1,268992,268992,268993,0,1,3
77079,6,2,268998,268998,269000,0,2,5
77080,4,3,269002,269002,269005,0,3,2
77081,4,2,269006,269006,269008,0,2,1
77082,2,1,269008,269008,269009,0,1,0
77083,1,2,269009,269009,269011,0,2,0
77084,1,1,269010,269011,269012,1,2,0
77085,1,2,269011,269012,269014,1,3,0
77086,1,2,269012,269014,269016,2,4,0
77087,5,2,269017,269017,269019,0,2,1
77088,2,1,269019,269019,269020,0,1,0
77089,5,3,269024,269024,269027,0,3,4
77090,5,1,269029,269029,269030,0,1,2
77091,3,2,269032,269032,269034,0,2,2
77092,6,2,269038,269038,269040,0,2,4
77093,1,1,269039,269040,269041,1,2,0
77094,5,1,269044,269044,269045,0,1,3
77095,6,3,269050,269050,269053,0,3,5
77096,5,2,269055,269055,269057,0,2,2
77097,6,1,269061,269061,269062,0,1,4
77098,1,3,269062,269062,269065,0,3,0
77099,2,2,269064,269065,269067,1,3,0
77100,5,3,269069,269069,269072,0,3,2
77101,2,3,269071,269072,269075,1,4,0
77102,2,2,269073,269075,269077,2,4,0
77103,1,2,269074,269077,269079,3,5,0
77104,4,2,269078,269079,269081,1,3,0
77105,6,2,269084,269084,269086,0,2,3
77106,2,2,269086,269086,269088,0,2,0
77107,6,1,269092,269092,269093,0,1,4
77108,3,2,269095,269095,269097,0,2,2
77109,3,1,269098,269098,269099,0,1,1
77110,5,3,269103,269103,269106,0,3,4
77111,3,1,269106,269106,269107,0,1,0
77112,5,3,269111,269111,269114,0,3,4
77113,4,1,269115,269115,269116,0,1,1
77114,6,1,269121,269121,269122,0,1,5
77115,2,2,269123,269123,269125,0,2,1
77116,3,3,269126,269126,269129,0,3,1
77117,2,3,269128,269129,269132,1,4,0
77118,5,1,269133,269133,269134,0,1,1
77119,4,1,269137,269137,269138,0,1,3
77120,5,3,269142,269142,269145,0,3,4
77121,3,1,269145,269145,269146,0,1,0
77122,4,2,269149,269149,269151,0,2,3
77123,4,2,269153,269153,269155,0,2,2
77124,5,1,269158,269158,269159,0,1,3
77125,6,3,269164,269164,269167,0,3,5
77126,4,3,269168,269168,269171,0,3,1
77127,1,1,269169,269171,269172,2,3,0
77128,6,2,269175,269175,269177,0,2,3
77129,6,1,269181,269181,269182,0,1,4
77130,2,2,269183,269183,269185,0,2,1
77131,6,1,269189,269189,269190,0,1,4
77132,5,2,269194,269194,269196,0,2,4
77133,6,3,269200,269200,269203,0,3,4
77134,5,2,269205,269205,269207,0,2,2
77135,6,2,269211,269211,269213,0,2,4
77136,3,2,269214,269214,269216,0,2,1
77137,5,2,269219,269219,269221,0,2,3
77138,5,2,269224,269224,269226,0,2,3
77139,6,1,269230,269230,269231,0,1,4
77140,2,1,269232,269232,269233,0,1,1
77141,6,3,269238,269238,269241,0,3,5
77142,1,3,269239,269241,269244,2,5,0
77143,6,1,269245,269245,269246,0,1,1
77144,1,1,269246,269246,269247,0,1,0
77145,4,2,269250,269250,269252,0,2,3
77146,1,1,269251,269252,269253,1,2,0
77147,6,1,269257,269257,269258,0,1,4
77148,2,2,269259,269259,269261,0,2,1
77149,4,3,269263,269263,269266,0,3,2
77150,1,1,269264,269266,269267,2,3,0
77151,4,2,269268,269268,269270,0,2,1
77152,6,3,269274,269274,269277,0,3,4
77153,2,1,269276,269277,269278,1,2,0
77154,2,3,269278,269278,269281,0,3,0
77155,1,2,269279,269281,269283,2,4,0
77156,1,3,269280,269283,269286,3,6,0
77157,2,1,269282,269286,269287,4,5,0
77158,4,3,269286,269287,269290,1,4,0
77159,6,2,269292,269292,269294,0,2,2
77160,5,2,269297,269297,269299,0,2,3
77161,1,3,269298,269299,269302,1,4,0
77162,5,1,269303,269303,269304,0,1,1
77163,1,3,269304,269304,269307,0,3,0
77164,6,1,269310,269310,269311,0,1,3
77165,4,2,269314,269314,269316,0,2,3
77166,5,3,269319,269319,269322,0,3,3
77167,3,3,269322,269322,269325,0,3,0
77168,5,3,269327,269327,269330,0,3,2
77169,1,1,269328,269330,269331,2,3,0
77170,4,2,269332,269332,269334,0,2,1
77171,1,2,269333,269334,269336,1,3,0
77172,1,3,269334,269336,269339,2,5,0
77173,4,3,269338,269339,269342,1,4,0
77174,3,3,269341,269342,269345,1,4,0
77175,1,2,269342,269345,269347,3,5,0
77176,4,3,269346,269347,269350,1,4,0
77177,2,1,269348,269350,269351,2,3,0
77178,3,3,269351,269351,269354,0,3,0
77179,5,3,269356,269356,269359,0,3,2
77180,3,1,269359,269359,269360,0,1,0
77181,1,1,269360,269360,269361,0,1,0
77182,5,1,269365,269365,269366,0,1,4
77183,4,3,269369,269369,269372,0,3,3
77184,2,1,269371,269372,269373,1,2,0
77185,3,1,269374,269374,269375,0,1,1
77186,1,1,269375,269375,269376,0,1,0
77187,5,3,269380,269380,269383,0,3,4
77188,3,2,269383,269383,269385,0,2,0
77189,2,3,269385,269385,269388,0,3,0
77190,6,2,269391,269391,269393,0,2,3
77191,4,2,269395,269395,269397,0,2,2
77192,4,3,269399,269399,269402,0,3,2
77193,4,1,269403,269403,269404,0,1,1
77194,2,2,269405,269405,269407,0,2,1
77195,6,2,269411,269411,269413,0,2,4
77196,3,3,269414,269414,269417,0,3,1
77197,2,1,269416,269417,269418,1,2,0
77198,6,2,269422,269422,269424,0,2,4
77199,5,1,269427,269427,269428,0,1,3
77200,3,1,269430,269430,269431,0,1,2
77201,5,2,269435,269435,269437,0,2,4
77202,3,3,269438,269438,269441,0,3,1
77203,3,1,269441,269441,269442,0,1,0
77204,3,1,269444,269444,269445,0,1,2
77205,4,1,269448,269448,269449,0,1,3
77206,4,2,269452,269452,269454,0,2,3
77207,1,1,269453,269454,269455,1,2,0
77208,4,1,269457,269457,269458,0,1,2
77209,5,3,269462,269462,269465,0,3,4
77210,5,3,269467,269467,269470,0,3,2
77211,4,1,269471,269471,269472,0,1,1
77212,1,3,269472,269472,269475,0,3,0
77213,4,2,269476,269476,269478,0,2,1
77214,6,3,269482,269482,269485,0,3,4
77215,4,3,269486,269486,269489,0,3,1
77216,5,3,269491,269491,269494,0,3,2
77217,1,3,269492,269494,269497,2,5,0
77218,4,3,269496,269497,269500,1,4,0
77219,3,3,269499,269500,269503,1,4,0
77220,2,1,269501,269503,269504,2,3,0
77221,3,2,269504,269504,269506,0,2,0
77222,1,2,269505,269506,269508,1,3,0
77223,2,2,269507,269508,269510,1,3,0
77224,1,2,269508,269510,269512,2,4,0
77225,4,3,269512,269512,269515,0,3,0
77226,5,2,269517,269517,269519,0,2,2
77227,4,2,269521,269521,269523,0,2,2
77228,5,1,269526,269526,269527,0,1,3
77229,4,2,269530,269530,269532,0,2,3
77230,6,3,269536,269536,269539,0,3,4
77231,3,1,269539,269539,269540,0,1,0
77232,6,2,269545,269545,269547,0,2,5
77233,1,2,269546,269547,269549,1,3,0
77234,2,1,269548,269549,269550,1,2,0
77235,1,3,269549,269550,269553,1,4,0
77236,4,1,269553,269553,269554,0,1,0
77237,1,3,269554,269554,269557,0,3,0
77238,5,2,269559,269559,269561,0,2,2
77239,3,2,269562,269562,269564,0,2,1
77240,4,2,269566,269566,269568,0,2,2
77241,6,3,269572,269572,269575,0,3,4
77242,3,2,269575,269575,269577,0,2,0
77243,4,3,269579,269579,269582,0,3,2
77244,5,1,269584,269584,269585,0,1,2
77245,1,3,269585,269585,269588,0,3,0
77246,6,2,269591,269591,269593,0,2,3
77247,6,1,269597,269597,269598,0,1,4
77248,5,2,269602,269602,269604,0,2,4
77249,3,2,269605,269605,269607,0,2,1
77250,2,3,269607,269607,269610,0,3,0
77251,3,2,269610,269610,269612,0,2,0
77252,2,3,269612,269612,269615,0,3,0
77253,4,3,269616,269616,269619,0,3,1
77254,6,2,269622,269622,269624,0,2,3
77255,2,1,269624,269624,269625,0,1,0
77256,2,3,269626,269626,269629,0,3,1
77257,4,1,269630,269630,269631,0,1,1
77258,3,3,269633,269633,269636,0,3,2
77259,2,2,269635,269636,269638,1,3,0
77260,1,3,269636,269638,269641,2,5,0
77261,4,2,269640,269641,269643,1,3,0
77262,5,2,269645,269645,269647,0,2,2
77263,1,1,269646,269647,269648,1,2,0
77264,2,3,269648,269648,269651,0,3,0
77265,4,3,269652,269652,269655,0,3,1
77266,4,3,269656,269656,269659,0,3,1
77267,5,2,269661,269661,269663,0,2,2
77268,1,1,269662,269663,269664,1,2,0
77269,1,3,269663,269664,269667,1,4,0
77270,5,3,269668,269668,269671,0,3,1
77271,1,1,269669,269671,269672,2,3,0
77272,5,2,269674,269674,269676,0,2,2
77273,5,3,269679,269679,269682,0,3,3
77274,3,2,269682,269682,269684,0,2,0
77275,4,3,269686,269686,269689,0,3,2
77276,5,1,269691,269691,269692,0,1,2
77277,3,1,269694,269694,269695,0,1,2
77278,5,2,269699,269699,269701,0,2,4
77279,1,3,269700,269701,269704,1,4,0
77280,1,3,269701,269704,269707,3,6,0
77281,4,1,269705,269707,269708,2,3,0
77282,6,2,269711,269711,269713,0,2,3
77283,5,3,269716,269716,269719,0,3,3
77284,2,3,269718,269719,269722,1,4,0
77285,4,3,269722,269722,269725,0,3,0
77286,5,3,269727,269727,269730,0,3,2
77287,5,2,269732,269732,269734,0,2,2
77288,4,1,269736,269736,269737,0,1,2
77289,5,1,269741,269741,269742,0,1,4
77290,6,1,269747,269747,269748,0,1,5
77291,1,1,269748,269748,269749,0,1,0
77292,6,3,269754,269754,269757,0,3,5
77293,1,3,269755,269757,269760,2,5,0
77294,5,2,269760,269760,269762,0,2,0
77295,1,2,269761,269762,269764,1,3,0
77296,1,1,269762,269764,269765,2,3,0
77297,5,2,269767,269767,269769,0,2,2
77298,4,1,269771,269771,269772,0,1,2
77299,2,2,269773,269773,269775,0,2,1
77300,6,3,269779,269779,269782,0,3,4
77301,5,2,269784,269784,269786,0,2,2
77302,1,2,269785,269786,269788,1,3,0
77303,1,3,269786,269788,269791,2,5,0
77304,4,3,269790,269791,269794,1,4,0
77305,5,1,269795,269795,269796,0,1,1
77306,2,2,269797,269797,269799,0,2,1
77307,4,3,269801,269801,269804,0,3,2
77308,2,3,269803,269804,269807,1,4,0
77309,5,1,269808,269808,269809,0,1,1
77310,3,1,269811,269811,269812,0,1,2
77311,2,2,269813,269813,269815,0,2,1
77312,6,2,269819,269819,269821,0,2,4
77313,1,3,269820,269821,269824,1,4,0
77314,4,1,269824,269824,269825,0,1,0
77315,4,2,269828,269828,269830,0,2,3
77316,6,1,269834,269834,269835,0,1,4
77317,6,1,269840,269840,269841,0,1,5
77318,2,2,269842,269842,269844,0,2,1
77319,4,2,269846,269846,269848,0,2,2
77320,4,1,269850,269850,269851,0,1,2
77321,6,2,269856,269856,269858,0,2,5
77322,1,1,269857,269858,269859,1,2,0
77323,6,1,269863,269863,269864,0,1,4
77324,4,1,269867,269867,269868,0,1,3
77325,1,3,269868,269868,269871,0,3,0
77326,1,3,269869,269871,269874,2,5,0
77327,2,1,269871,269874,269875,3,4,0
77328,1,1,269872,269875,269876,3,4,0
77329,4,3,269876,269876,269879,0,3,0
77330,2,3,269878,269879,269882,1,4,0
77331,3,2,269881,269882,269884,1,3,0
77332,4,1,269885,269885,269886,0,1,1
77333,3,1,269888,269888,269889,0,1,2
77334,2,1,269890,269890,269891,0,1,1
77335,4,2,269894,269894,269896,0,2,3
77336,1,3,269895,269896,269899,1,4,0
77337,1,1,269896,269899,269900,3,4,0
77338,6,2,269902,269902,269904,0,2,2
77339,5,3,269907,269907,269910,0,3,3
77340,5,2,269912,269912,269914,0,2,2
77341,6,2,269918,269918,269920,0,2,4
77342,2,2,269920,269920,269922,0,2,0
77343,2,2,269922,269922,269924,0,2,0
77344,3,1,269925,269925,269926,0,1,1
77345,5,2,269930,269930,269932,0,2,4
77346,1,3,269931,269932,269935,1,4,0
77347,3,1,269934,269935,269936,1,2,0
77348,2,3,269936,269936,269939,0,3,0
77349,6,1,269942,269942,269943,0,1,3
77350,4,3,269946,269946,269949,0,3,3
77351,3,2,269949,269949,269951,0,2,0
77352,6,2,269955,269955,269957,0,2,4
77353,4,2,269959,269959,269961,0,2,2
77354,3,3,269962,269962,269965,0,3,1
77355,5,3,269967,269967,269970,0,3,2
77356,5,3,269972,269972,269975,0,3,2
77357,6,3,269978,269978,269981,0,3,3
77358,3,1,269981,269981,269982,0,1,0
77359,5,2,269986,269986,269988,0,2,4
77360,4,3,269990,269990,269993,0,3,2
77361,6,2,269996,269996,269998,0,2,3
77362,4,2,270000,270000,270002,0,2,2
77363,4,1,270004,270004,270005,0,1,2
77364,6,2,270010,270010,270012,0,2,5
77365,2,1,270012,270012,270013,0,1,0
77366,5,1,270017,270017,270018,0,1,4
77367,2,3,270019,270019,270022,0,3,1
77368,4,3,270023,270023,270026,0,3,1
77369,3,2,270026,270026,270028,0,2,0
77370,6,1,270032,270032,270033,0,1,4
77371,3,1,270035,270035,270036,0,1,2
77372,1,3,270036,270036,270039,0,3,0
77373,1,1,270037,270039,270040,2,3,0
77374,2,2,270039,270040,270042,1,3,0
77375,1,1,270040,270042,270043,2,3,0
77376,2,3,270042,270043,270046,1,4,0
77377,4,1,270046,270046,270047,0,1,0
77378,3,3,270049,270049,270052,0,3,2
77379,4,1,270053,270053,270054,0,1,1
77380,2,3,270055,270055,270058,0,3,1
77381,1,3,270056,270058,270061,2,5,0
77382,4,1,270060,270061,270062,1,2,0
77383,4,3,270064,270064,270067,0,3,2
77384,4,3,270068,270068,270071,0,3,1
77385,4,1,270072,270072,270073,0,1,1
77386,1,1,270073,270073,270074,0,1,0
77387,6,1,270079,270079,270080,0,1,5
77388,3,1,270082,270082,270083,0,1,2
77389,5,3,270087,270087,270090,0,3,4
77390,1,1,270088,270090,270091,2,3,0
77391,1,3,270089,270091,270094,2,5,0
77392,4,1,270093,270094,270095,1,2,0
77393,2,2,270095,270095,270097,0,2,0
77394,1,1,270096,270097,270098,1,2,0
77395,2,3,270098,270098,270101,0,3,0
77396,2,3,270100,270101,270104,1,4,0
77397,3,2,270103,270104,270106,1,3,0
77398,2,3,270105,270106,270109,1,4,0
77399,2,1,270107,270109,270110,2,3,0
77400,2,3,270109,270110,270113,1,4,0
77401,5,1,270114,270114,270115,0,1,1
77402,3,3,270117,270117,270120,0,3,2
77403,5,1,270122,270122,270123,0,1,2
77404,4,2,270126,270126,270128,0,2,3
77405,4,2,270130,270130,270132,0,2,2
77406,3,3,270133,270133,270136,0,3,1
77407,6,1,270139,270139,270140,0,1,3
77408,3,2,270142,270142,270144,0,2,2
77409,4,3,270146,270146,270149,0,3,2
77410,6,2,270152,270152,270154,0,2,3
77411,5,3,270157,270157,270160,0,3,3
77412,4,1,270161,270161,270162,0,1,1
77413,2,2,270163,270163,270165,0,2,1
77414,2,1,270165,270165,270166,0,1,0
77415,2,3,270167,270167,270170,0,3,1
77416,5,1,270172,270172,270173,0,1,2
77417,3,3,270175,270175,270178,0,3,2
77418,4,1,270179,270179,270180,0,1,1
77419,3,1,270182,270182,270183,0,1,2
77420,4,2,270186,270186,270188,0,2,3
77421,3,3,270189,270189,270192,0,3,1
77422,4,1,270193,270193,270194,0,1,1
77423,1,3,270194,270194,270197,0,3,0
77424,2,2,270196,270197,270199,1,3,0
77425,6,1,270202,270202,270203,0,1,3
77426,3,3,270205,270205,270208,0,3,2
77427,2,1,270207,270208,270209,1,2,0
77428,5,1,270212,270212,270213,0,1,3
77429,5,3,270217,270217,270220,0,3,4
77430,3,3,270220,270220,270223,0,3,0
77431,4,3,270224,270224,270227,0,3,1
77432,2,3,270226,270227,270230,1,4,0
77433,5,1,270231,270231,270232,0,1,1
77434,2,3,270233,270233,270236,0,3,1
77435,4,3,270237,270237,270240,0,3,1
77436,4,3,270241,270241,270244,0,3,1
77437,3,3,270244,270244,270247,0,3,0
77438,1,2,270245,270247,270249,2,4,0
77439,5,2,270250,270250,270252,0,2,1
77440,5,1,270255,270255,270256,0,1,3
77441,1,1,270256,270256,270257,0,1,0
77442,2,2,270258,270258,270260,0,2,1
77443,6,2,270264,270264,270266,0,2,4
77444,2,1,270266,270266,270267,0,1,0
77445,5,2,270271,270271,270273,0,2,4
77446,3,1,270274,270274,270275,0,1,1
77447,1,3,270275,270275,270278,0,3,0
77448,1,1,270276,270278,270279,2,3,0
77449,5,1,270281,270281,270282,0,1,2
77450,1,2,270282,270282,270284,0,2,0
77451,6,2,270288,270288,270290,0,2,4
77452,3,1,270291,270291,270292,0,1,1
77453,6,2,270297,270297,270299,0,2,5
77454,6,3,270303,270303,270306,0,3,4
77455,1,1,270304,270306,270307,2,3,0
77456,6,3,270310,270310,270313,0,3,3
77457,5,3,270315,270315,270318,0,3,2
77458,4,3,270319,270319,270322,0,3,1
77459,3,3,270322,270322,270325,0,3,0
77460,4,3,270326,270326,270329,0,3,1
77461,1,2,270327,270329,270331,2,4,0
77462,1,1,270328,270331,270332,3,4,0
77463,6,2,270334,270334,270336,0,2,2
77464,1,1,270335,270336,270337,1,2,0
77465,1,3,270336,270337,270340,1,4,0
77466,6,1,270342,270342,270343,0,1,2
77467,2,2,270344,270344,270346,0,2,1
77468,4,1,270348,270348,270349,0,1,2
77469,2,2,270350,270350,270352,0,2,1
77470,5,2,270355,270355,270357,0,2,3
77471,6,1,270361,270361,270362,0,1,4
77472,2,3,270363,270363,270366,0,3,1
77473,1,2,270364,270366,270368,2,4,0
77474,5,3,270369,270369,270372,0,3,1
77475,6,3,270375,270375,270378,0,3,3
77476,5,3,270380,270380,270383,0,3,2
77477,5,2,270385,270385,270387,0,2,2
77478,6,2,270391,270391,270393,0,2,4
77479,3,1,270394,270394,270395,0,1,1
77480,2,1,270396,270396,270397,0,1,1
77481,5,1,270401,270401,270402,0,1,4
77482,3,1,270404,270404,270405,0,1,2
77483,4,1,270408,270408,270409,0,1,3
77484,2,1,270410,270410,270411,0,1,1
77485,5,2,270415,270415,270417,0,2,4
77486,4,3,270419,270419,270422,0,3,2
77487,5,3,270424,270424,270427,0,3,2
77488,3,2,270427,270427,270429,0,2,0
77489,1,1,270428,270429,270430,1,2,0
77490,3,3,270431,270431,270434,0,3,1
77491,2,2,270433,270434,270436,1,3,0
77492,3,3,270436,270436,270439,0,3,0
77493,5,2,270441,270441,270443,0,2,2
77494,4,1,270445,270445,270446,0,1,2
77495,5,3,270450,270450,270453,0,3,4
77496,1,3,270451,270453,270456,2,5,0
77497,3,2,270454,270456,270458,2,4,0
77498,2,1,270456,270458,270459,2,3,0
77499,2,2,270458,270459,270461,1,3,0
77500,1,3,270459,270461,270464,2,5,0
77501,3,1,270462,270464,270465,2,3,0
77502,6,1,270468,270468,270469,0,1,3
77503,4,3,270472,270472,270475,0,3,3
77504,1,3,270473,270475,270478,2,5,0
77505,3,2,270476,270478,270480,2,4,0
77506,6,2,270482,270482,270484,0,2,2
77507,5,1,270487,270487,270488,0,1,3
77508,2,3,270489,270489,270492,0,3,1
77509,5,3,270494,270494,270497,0,3,2
77510,5,2,270499,270499,270501,0,2,2
77511,2,3,270501,270501,270504,0,3,0
77512,2,3,270503,270504,270507,1,4,0
77513,6,1,270509,270509,270510,0,1,2
77514,6,2,270515,270515,270517,0,2,5
77515,3,2,270518,270518,270520,0,2,1
77516,2,2,270520,270520,270522,0,2,0
77517,1,3,270521,270522,270525,1,4,0
77518,2,1,270523,270525,270526,2,3,0
77519,1,1,270524,270526,270527,2,3,0
77520,2,3,270526,270527,270530,1,4,0
77521,2,3,270528,270530,270533,2,5,0
77522,5,3,270533,270533,270536,0,3,0
77523,5,2,270538,270538,270540,0,2,2
77524,6,1,270544,270544,270545,0,1,4
77525,4,2,270548,270548,270550,0,2,3
77526,2,1,270550,270550,270551,0,1,0
77527,2,1,270552,270552,270553,0,1,1
77528,5,1,270557,270557,270558,0,1,4
77529,4,3,270561,270561,270564,0,3,3
77530,3,1,270564,270564,270565,0,1,0
77531,2,1,270566,270566,270567,0,1,1
77532,6,3,270572,270572,270575,0,3,5
77533,3,2,270575,270575,270577,0,2,0
77534,5,3,270580,270580,270583,0,3,3
77535,2,2,270582,270583,270585,1,3,0
77536,2,2,270584,270585,270587,1,3,0
77537,6,3,270590,270590,270593,0,3,3
77538,6,2,270596,270596,270598,0,2,3
77539,6,1,270602,270602,270603,0,1,4
77540,2,2,270604,270604,270606,0,2,1
77541,4,1,270608,270608,270609,0,1,2
77542,2,3,270610,270610,270613,0,3,1
77543,6,1,270616,270616,270617,0,1,3
77544,3,1,270619,270619,270620,0,1,2
77545,4,1,270623,270623,270624,0,1,3
77546,1,3,270624,270624,270627,0,3,0
77547,4,2,270628,270628,270630,0,2,1
77548,1,3,270629,270630,270633,1,4,0
77549,2,2,270631,270633,270635,2,4,0
77550,3,3,270634,270635,270638,1,4,0
77551,2,1,270636,270638,270639,2,3,0
77552,2,1,270638,270639,270640,1,2,0
77553,6,2,270644,270644,270646,0,2,4
77554,1,1,270645,270646,270647,1,2,0
77555,6,3,270651,270651,270654,0,3,4
77556,6,1,270657,270657,270658,0,1,3
77557,1,2,270658,270658,270660,0,2,0
77558,1,1,270659,270660,270661,1,2,0
77559,3,3,270662,270662,270665,0,3,1
77560,1,1,270663,270665,270666,2,3,0
77561,2,2,270665,270666,270668,1,3,0
77562,1,2,270666,270668,270670,2,4,0
77563,3,3,270669,270670,270673,1,4,0
77564,4,3,270673,270673,270676,0,3,0
77565,6,1,270679,270679,270680,0,1,3
77566,2,2,270681,270681,270683,0,2,1
77567,5,1,270686,270686,270687,0,1,3
77568,3,1,270689,270689,270690,0,1,2
77569,5,1,270694,270694,270695,0,1,4
77570,1,1,270695,270695,270696,0,1,0
77571,3,3,270698,270698,270701,0,3,2
77572,5,3,270703,270703,270706,0,3,2
77573,3,3,270706,270706,270709,0,3,0
77574,1,2,270707,270709,270711,2,4,0
77575,3,1,270710,270711,270712,1,2,0
77576,4,3,270714,270714,270717,0,3,2
77577,2,1,270716,270717,270718,1,2,0
77578,6,1,270722,270722,270723,0,1,4
77579,5,3,270727,270727,270730,0,3,4
77580,5,3,270732,270732,270735,0,3,2
77581,4,1,270736,270736,270737,0,1,1
77582,2,1,270738,270738,270739,0,1,1
77583,2,1,270740,270740,270741,0,1,1
77584,5,2,270745,270745,270747,0,2,4
77585,5,2,270750,270750,270752,0,2,3
77586,4,2,270754,270754,270756,0,2,2
77587,5,1,270759,270759,270760,0,1,3
77588,2,3,270761,270761,270764,0,3,1
77589,2,2,270763,270764,270766,1,3,0
77590,2,3,270765,270766,270769,1,4,0
77591,2,1,270767,270769,270770,2,3,0
77592,5,1,270772,270772,270773,0,1,2
77593,3,2,270775,270775,270777,0,2,2
77594,6,3,270781,270781,270784,0,3,4
77595,6,3,270787,270787,270790,0,3,3
77596,2,2,270789,270790,270792,1,3,0
77597,1,3,270790,270792,270795,2,5,0
77598,5,2,270795,270795,270797,0,2,0
77599,5,3,270800,270800,270803,0,3,3
77600,6,2,270806,270806,270808,0,2,3
77601,1,3,270807,270808,270811,1,4,0
77602,2,2,270809,270811,270813,2,4,0
77603,3,2,270812,270813,270815,1,3,0
77604,4,1,270816,270816,270817,0,1,1
77605,2,1,270818,270818,270819,0,1,1
77606,5,3,270823,270823,270826,0,3,4
77607,3,3,270826,270826,270829,0,3,0
77608,2,2,270828,270829,270831,1,3,0
77609,1,2,270829,270831,270833,2,4,0
77610,3,3,270832,270833,270836,1,4,0
77611,1,3,270833,270836,270839,3,6,0
77612,3,2,270836,270839,270841,3,5,0
77613,2,1,270838,270841,270842,3,4,0
77614,1,2,270839,270842,270844,3,5,0
77615,6,3,270845,270845,270848,0,3,1
77616,1,2,270846,270848,270850,2,4,0
77617,2,3,270848,270850,270853,2,5,0
77618,3,1,270851,270853,270854,2,3,0
77619,6,3,270857,270857,270860,0,3,3
77620,3,1,270860,270860,270861,0,1,0
77621,3,1,270863,270863,270864,0,1,2
77622,1,2,270864,270864,270866,0,2,0
77623,5,1,270869,270869,270870,0,1,3
77624,1,1,270870,270870,270871,0,1,0
77625,6,2,270876,270876,270878,0,2,5
77626,1,1,270877,270878,270879,1,2,0
77627,3,2,270880,270880,270882,0,2,1
77628,6,3,270886,270886,270889,0,3,4
77629,3,3,270889,270889,270892,0,3,0
77630,3,3,270892,270892,270895,0,3,0
77631,3,3,270895,270895,270898,0,3,0
77632,5,3,270900,270900,270903,0,3,2
77633,6,1,270906,270906,270907,0,1,3
77634,4,1,270910,270910,270911,0,1,3
77635,1,1,270911,270911,270912,0,1,0
77636,5,3,270916,270916,270919,0,3,4
77637,5,2,270921,270921,270923,0,2,2
77638,5,3,270926,270926,270929,0,3,3
77639,3,3,270929,270929,270932,0,3,0
77640,2,2,270931,270932,270934,1,3,0
77641,3,2,270934,270934,270936,0,2,0
77642,5,2,270939,270939,270941,0,2,3
77643,4,3,270943,270943,270946,0,3,2
77644,3,1,270946,270946,270947,0,1,0
77645,2,1,270948,270948,270949,0,1,1
77646,3,2,270951,270951,270953,0,2,2
77647,4,1,270955,270955,270956,0,1,2
77648,4,3,270959,270959,270962,0,3,3
77649,1,1,270960,270962,270963,2,3,0
77650,3,2,270963,270963,270965,0,2,0
77651,1,1,270964,270965,270966,1,2,0
77652,4,1,270968,270968,270969,0,1,2
77653,2,3,270970,270970,270973,0,3,1
77654,1,2,270971,270973,270975,2,4,0
77655,4,3,270975,270975,270978,0,3,0
77656,4,1,270979,270979,270980,0,1,1
77657,3,1,270982,270982,270983,0,1,2
77658,6,1,270988,270988,270989,0,1,5
77659,2,1,270990,270990,270991,0,1,1
77660,5,1,270995,270995,270996,0,1,4
77661,1,3,270996,270996,270999,0,3,0
77662,6,2,271002,271002,271004,0,2,3
77663,1,3,271003,271004,271007,1,4,0
77664,5,1,271008,271008,271009,0,1,1
77665,1,2,271009,271009,271011,0,2,0
77666,6,3,271015,271015,271018,0,3,4
77667,2,2,271017,271018,271020,1,3,0
77668,1,1,271018,271020,271021,2,3,0
77669,6,3,271024,271024,271027,0,3,3
77670,5,3,271029,271029,271032,0,3,2
77671,1,3,271030,271032,271035,2,5,0
77672,1,1,271031,271035,271036,4,5,0
77673,4,2,271035,271036,271038,1,3,0
77674,3,3,271038,271038,271041,0,3,0
77675,2,3,271040,271041,271044,1,4,0
77676,3,2,271043,271044,271046,1,3,0
77677,6,3,271049,271049,271052,0,3,3
77678,6,2,271055,271055,271057,0,2,3
77679,3,2,271058,271058,271060,0,2,1
77680,2,2,271060,271060,271062,0,2,0
77681,1,1,271061,271062,271063,1,2,0
77682,6,2,271067,271067,271069,0,2,4
77683,1,2,271068,271069,271071,1,3,0
77684,1,3,271069,271071,271074,2,5,0
77685,3,2,271072,271074,271076,2,4,0
77686,5,2,271077,271077,271079,0,2,1
77687,1,3,271078,271079,271082,1,4,0
77688,4,2,271082,271082,271084,0,2,0
77689,2,2,271084,271084,271086,0,2,0
77690,1,1,271085,271086,271087,1,2,0
77691,1,2,271086,271087,271089,1,3,0
77692,2,2,271088,271089,271091,1,3,0
77693,2,2,271090,271091,271093,1,3,0
77694,5,1,271095,271095,271096,0,1,2
77695,2,1,271097,271097,271098,0,1,1
77696,4,2,271101,271101,271103,0,2,3
77697,3,1,271104,271104,271105,0,1,1
77698,1,3,271105,271105,271108,0,3,0
77699,5,2,271110,271110,271112,0,2,2
77700,2,3,271112,271112,271115,0,3,0
77701,6,2,271118,271118,271120,0,2,3
77702,3,1,271121,271121,271122,0,1,1
77703,3,1,271124,271124,271125,0,1,2
77704,5,2,271129,271129,271131,0,2,4
77705,3,2,271132,271132,271134,0,2,1
77706,5,1,271137,271137,271138,0,1,3
77707,1,2,271138,271138,271140,0,2,0
77708,4,1,271142,271142,271143,0,1,2
77709,5,3,271147,271147,271150,0,3,4
77710,6,1,271153,271153,271154,0,1,3
77711,6,1,271159,271159,271160,0,1,5
77712,6,2,271165,271165,271167,0,2,5
77713,4,2,271169,271169,271171,0,2,2
77714,2,1,271171,271171,271172,0,1,0
77715,6,1,271177,271177,271178,0,1,5
77716,1,3,271178,271178,271181,0,3,0
77717,4,3,271182,271182,271185,0,3,1
77718,2,2,271184,271185,271187,1,3,0
77719,2,2,271186,271187,271189,1,3,0
77720,1,3,271187,271189,271192,2,5,0
77721,6,3,271193,271193,271196,0,3,1
77722,6,2,271199,271199,271201,0,2,3
77723,1,2,271200,271201,271203,1,3,0
77724,2,3,271202,271203,271206,1,4,0
77725,3,3,271205,271206,271209,1,4,0
77726,4,1,271209,271209,271210,0,1,0
77727,2,3,271211,271211,271214,0,3,1
77728,2,2,271213,271214,271216,1,3,0
77729,1,1,271214,271216,271217,2,3,0
77730,4,2,271218,271218,271220,0,2,1
77731,5,2,271223,271223,271225,0,2,3
77732,5,3,271228,271228,271231,0,3,3
77733,4,2,271232,271232,271234,0,2,1
77734,5,2,271237,271237,271239,0,2,3
77735,4,1,271241,271241,271242,0,1,2
77736,1,1,271242,271242,271243,0,1,0
77737,4,3,271246,271246,271249,0,3,3
77738,4,2,271250,271250,271252,0,2,1
77739,5,3,271255,271255,271258,0,3,3
77740,1,1,271256,271258,271259,2,3,0
77741,4,1,271260,271260,271261,0,1,1
77742,4,3,271264,271264,271267,0,3,3
77743,1,2,271265,271267,271269,2,4,0
77744,5,3,271270,271270,271273,0,3,1
77745,2,1,271272,271273,271274,1,2,0
77746,5,2,271277,271277,271279,0,2,3
77747,6,1,271283,271283,271284,0,1,4
77748,4,2,271287,271287,271289,0,2,3
77749,6,2,271293,271293,271295,0,2,4
77750,2,1,271295,271295,271296,0,1,0
77751,5,2,271300,271300,271302,0,2,4
77752,1,3,271301,271302,271305,1,4,0
77753,5,1,271306,271306,271307,0,1,1
77754,1,1,271307,271307,271308,0,1,0
77755,3,3,271310,271310,271313,0,3,2
77756,3,1,271313,271313,271314,0,1,0
77757,5,1,271318,271318,271319,0,1,4
77758,3,3,271321,271321,271324,0,3,2
77759,1,2,271322,271324,271326,2,4,0
77760,5,1,271327,271327,271328,0,1,1
77761,2,2,271329,271329,271331,0,2,1
77762,2,3,271331,271331,271334,0,3,0
77763,5,3,271336,271336,271339,0,3,2
77764,5,3,271341,271341,271344,0,3,2
77765,1,3,271342,271344,271347,2,5,0
77766,4,1,271346,271347,271348,1,2,0
77767,2,1,271348,271348,271349,0,1,0
77768,6,3,271354,271354,271357,0,3,5
77769,3,1,271357,271357,271358,0,1,0
77770,4,2,271361,271361,271363,0,2,3
77771,2,1,271363,271363,271364,0,1,0
77772,5,1,271368,271368,271369,0,1,4
77773,5,2,271373,271373,271375,0,2,4
77774,2,1,271375,271375,271376,0,1,0
77775,5,1,271380,271380,271381,0,1,4
77776,2,1,271382,271382,271383,0,1,1
77777,5,2,271387,271387,271389,0,2,4
77778,5,3,271392,271392,271395,0,3,3
77779,1,3,271393,271395,271398,2,5,0
77780,2,3,271395,271398,271401,3,6,0
77781,6,3,271401,271401,271404,0,3,0
77782,6,2,271407,271407,271409,0,2,3
77783,1,2,271408,271409,271411,1,3,0
77784,5,2,271413,271413,271415,0,2,2
77785,2,3,271415,271415,271418,0,3,0
77786,6,3,271421,271421,271424,0,3,3
77787,3,1,271424,271424,271425,0,1,0
77788,6,3,271430,271430,271433,0,3,5
77789,2,1,271432,271433,271434,1,2,0
77790,3,3,271435,271435,271438,0,3,1
77791,4,1,271439,271439,271440,0,1,1
77792,1,3,271440,271440,271443,0,3,0
77793,4,3,271444,271444,271447,0,3,1
77794,2,2,271446,271447,271449,1,3,0
77795,1,3,271447,271449,271452,2,5,0
77796,3,3,271450,271452,271455,2,5,0
77797,4,2,271454,271455,271457,1,3,0
77798,5,3,271459,271459,271462,0,3,2
77799,6,1,271465,271465,271466,0,1,3
77800,5,2,271470,271470,271472,0,2,4
77801,3,3,271473,271473,271476,0,3,1
77802,2,2,271475,271476,271478,1,3,0
77803,1,2,271476,271478,271480,2,4,0
77804,5,2,271481,271481,271483,0,2,1
77805,6,2,271487,271487,271489,0,2,4
77806,2,2,271489,271489,271491,0,2,0
77807,2,3,271491,271491,271494,0,3,0
77808,3,2,271494,271494,271496,0,2,0
77809,5,3,271499,271499,271502,0,3,3
77810,2,3,271501,271502,271505,1,4,0
77811,4,2,271505,271505,271507,0,2,0
77812,4,1,271509,271509,271510,0,1,2
77813,4,1,271513,271513,271514,0,1,3
77814,1,1,271514,271514,271515,0,1,0
77815,6,2,271520,271520,271522,0,2,5
77816,2,3,271522,271522,271525,0,3,0
77817,5,1,271527,271527,271528,0,1,2
77818,4,1,271531,271531,271532,0,1,3
77819,1,2,271532,271532,271534,0,2,0
77820,5,2,271537,271537,271539,0,2,3
77821,4,3,271541,271541,271544,0,3,2
77822,4,1,271545,271545,271546,0,1,1
77823,3,2,271548,271548,271550,0,2,2
77824,4,2,271552,271552,271554,0,2,2
77825,4,1,271556,271556,271557,0,1,2
77826,6,2,271562,271562,271564,0,2,5
77827,2,1,271564,271564,271565,0,1,0
77828,4,2,271568,271568,271570,0,2,3
77829,2,2,271570,271570,271572,0,2,0
77830,6,1,271576,271576,271577,0,1,4
77831,1,1,271577,271577,271578,0,1,0
77832,1,2,271578,271578,271580,0,2,0
77833,4,3,271582,271582,271585,0,3,2
77834,5,1,271587,271587,271588,0,1,2
77835,3,1,271590,271590,271591,0,1,2
77836,3,3,271593,271593,271596,0,3,2
77837,2,1,271595,271596,271597,1,2,0
77838,4,3,271599,271599,271602,0,3,2
77839,2,1,271601,271602,271603,1,2,0
77840,6,3,271607,271607,271610,0,3,4
77841,4,1,271611,271611,271612,0,1,1
77842,2,2,271613,271613,271615,0,2,1
77843,4,3,271617,271617,271620,0,3,2
77844,4,2,271621,271621,271623,0,2,1
77845,6,2,271627,271627,271629,0,2,4
77846,2,2,271629,271629,271631,0,2,0
77847,1,3,271630,271631,271634,1,4,0
77848,5,1,271635,271635,271636,0,1,1
77849,2,3,271637,271637,271640,0,3,1
77850,4,3,271641,271641,271644,0,3,1
77851,1,1,271642,271644,271645,2,3,0
77852,3,1,271645,271645,271646,0,1,0
77853,6,3,271651,271651,271654,0,3,5
77854,2,1,271653,271654,271655,1,2,0
77855,5,1,271658,271658,271659,0,1,3
77856,1,2,271659,271659,271661,0,2,0
77857,1,2,271660,271661,271663,1,3,0
77858,1,3,271661,271663,271666,2,5,0
77859,5,1,271666,271666,271667,0,1,0
77860,1,2,271667,271667,271669,0,2,0
77861,4,2,271671,271671,271673,0,2,2
77862,1,1,271672,271673,271674,1,2,0
77863,2,2,271674,271674,271676,0,2,0
77864,4,1,271678,271678,271679,0,1,2
77865,6,1,271684,271684,271685,0,1,5
77866,2,1,271686,271686,271687,0,1,1
77867,6,1,271692,271692,271693,0,1,5
77868,2,2,271694,271694,271696,0,2,1
77869,4,2,271698,271698,271700,0,2,2
77870,1,3,271699,271700,271703,1,4,0
77871,5,1,271704,271704,271705,0,1,1
77872,1,2,271705,271705,271707,0,2,0
77873,1,3,271706,271707,271710,1,4,0
77874,6,3,271712,271712,271715,0,3,2
77875,2,1,271714,271715,271716,1,2,0
77876,6,3,271720,271720,271723,0,3,4
77877,4,2,271724,271724,271726,0,2,1
77878,5,3,271729,271729,271732,0,3,3
77879,6,1,271735,271735,271736,0,1,3
77880,3,2,271738,271738,271740,0,2,2
77881,3,2,271741,271741,271743,0,2,1
77882,5,2,271746,271746,271748,0,2,3
77883,2,2,271748,271748,271750,0,2,0
77884,6,3,271754,271754,271757,0,3,4
77885,1,2,271755,271757,271759,2,4,0
77886,1,3,271756,271759,271762,3,6,0
77887,1,1,271757,271762,271763,5,6,0
77888,3,1,271760,271763,271764,3,4,0
77889,1,1,271761,271764,271765,3,4,0
77890,2,2,271763,271765,271767,2,4,0
77891,2,1,271765,271767,271768,2,3,0
77892,3,3,271768,271768,271771,0,3,0
77893,4,2,271772,271772,271774,0,2,1
77894,1,3,271773,271774,271777,1,4,0
77895,5,1,271778,271778,271779,0,1,1
77896,3,2,271781,271781,271783,0,2,2
77897,5,1,271786,271786,271787,0,1,3
77898,2,1,271788,271788,271789,0,1,1
77899,3,2,271791,271791,271793,0,2,2
77900,3,1,271794,271794,271795,0,1,1
77901,3,3,271797,271797,271800,0,3,2
77902,3,1,271800,271800,271801,0,1,0
77903,3,2,271803,271803,271805,0,2,2
77904,4,2,271807,271807,271809,0,2,2
77905,3,3,271810,271810,271813,0,3,1
77906,6,2,271816,271816,271818,0,2,3
77907,2,1,271818,271818,271819,0,1,0
77908,6,2,271824,271824,271826,0,2,5
77909,5,3,271829,271829,271832,0,3,3
77910,2,2,271831,271832,271834,1,3,0
77911,4,1,271835,271835,271836,0,1,1
77912,1,3,271836,271836,271839,0,3,0
77913,4,3,271840,271840,271843,0,3,1
77914,1,3,271841,271843,271846,2,5,0
77915,6,1,271847,271847,271848,0,1,1
77916,1,3,271848,271848,271851,0,3,0
77917,5,2,271853,271853,271855,0,2,2
77918,2,2,271855,271855,271857,0,2,0
77919,5,1,271860,271860,271861,0,1,3
77920,6,2,271866,271866,271868,0,2,5
77921,2,1,271868,271868,271869,0,1,0
77922,1,2,271869,271869,271871,0,2,0
77923,2,3,271871,271871,271874,0,3,0
77924,5,2,271876,271876,271878,0,2,2
77925,6,3,271882,271882,271885,0,3,4
77926,5,1,271887,271887,271888,0,1,2
77927,2,1,271889,271889,271890,0,1,1
77928,1,3,271890,271890,271893,0,3,0
77929,3,1,271893,271893,271894,0,1,0
77930,4,3,271897,271897,271900,0,3,3
77931,2,2,271899,271900,271902,1,3,0
77932,4,1,271903,271903,271904,0,1,1
77933,3,1,271906,271906,271907,0,1,2
77934,4,2,271910,271910,271912,0,2,3
77935,1,3,271911,271912,271915,1,4,0
77936,2,3,271913,271915,271918,2,5,0
77937,2,1,271915,271918,271919,3,4,0
77938,5,3,271920,271920,271923,0,3,1
77939,4,3,271924,271924,271927,0,3,1
77940,3,1,271927,271927,271928,0,1,0
77941,4,2,271931,271931,271933,0,2,3
77942,5,3,271936,271936,271939,0,3,3
77943,2,2,271938,271939,271941,1,3,0
77944,2,2,271940,271941,271943,1,3,0
77945,4,2,271944,271944,271946,0,2,1
77946,2,2,271946,271946,271948,0,2,0
77947,2,3,271948,271948,271951,0,3,0
77948,6,3,271954,271954,271957,0,3,3
77949,6,3,271960,271960,271963,0,3,3
77950,3,1,271963,271963,271964,0,1,0
77951,4,1,271967,271967,271968,0,1,3
77952,6,2,271973,271973,271975,0,2,5
77953,3,2,271976,271976,271978,0,2,1
77954,3,1,271979,271979,271980,0,1,1
77955,2,3,271981,271981,271984,0,3,1
77956,3,2,271984,271984,271986,0,2,0
77957,5,2,271989,271989,271991,0,2,3
77958,4,1,271993,271993,271994,0,1,2
77959,1,2,271994,271994,271996,0,2,0
77960,5,1,271999,271999,272000,0,1,3
77961,6,3,272005,272005,272008,0,3,5
77962,6,1,272011,272011,272012,0,1,3
77963,5,2,272016,272016,272018,0,2,4
77964,4,3,272020,272020,272023,0,3,2
77965,2,2,272022,272023,272025,1,3,0
77966,1,1,272023,272025,272026,2,3,0
77967,3,1,272026,272026,272027,0,1,0
77968,2,3,272028,272028,272031,0,3,1
77969,3,3,272031,272031,272034,0,3,0
77970,6,3,272037,272037,272040,0,3,3
77971,3,2,272040,272040,272042,0,2,0
77972,6,3,272046,272046,272049,0,3,4
77973,2,3,272048,272049,272052,1,4,0
77974,6,3,272054,272054,272057,0,3,2
77975,4,1,272058,272058,272059,0,1,1
77976,5,3,272063,272063,272066,0,3,4
77977,5,2,272068,272068,272070,0,2,2
77978,2,3,272070,272070,272073,0,3,0
77979,5,2,272075,272075,272077,0,2,2
77980,3,1,272078,272078,272079,0,1,1
77981,3,2,272081,272081,272083,0,2,2
77982,4,3,272085,272085,272088,0,3,2
77983,6,2,272091,272091,272093,0,2,3
77984,4,2,272095,272095,272097,0,2,2
77985,1,1,272096,272097,272098,1,2,0
77986,3,1,272099,272099,272100,0,1,1
77987,6,2,272105,272105,272107,0,2,5
77988,2,2,272107,272107,272109,0,2,0
77989,4,3,272111,272111,272114,0,3,2
77990,4,1,272115,272115,272116,0,1,1
77991,5,2,272120,272120,272122,0,2,4
77992,4,3,272124,272124,272127,0,3,2
77993,5,3,272129,272129,272132,0,3,2
77994,6,1,272135,272135,272136,0,1,3
77995,3,3,272138,272138,272141,0,3,2
77996,3,2,272141,272141,272143,0,2,0
77997,2,3,272143,272143,272146,0,3,0
77998,5,3,272148,272148,272151,0,3,2
77999,6,1,272154,272154,272155,0,1,3
78000,3,1,272157,272157,272158,0,1,2
78001,2,2,272159,272159,272161,0,2,1
78002,6,3,272165,272165,272168,0,3,4
78003,6,2,272171,272171,272173,0,2,3
78004,6,3,272177,272177,272180,0,3,4
78005,3,3,272180,272180,272183,0,3,0
78006,4,1,272184,272184,272185,0,1,1
78007,1,2,272185,272185,272187,0,2,0
78008,3,2,272188,272188,272190,0,2,1
78009,3,2,272191,272191,272193,0,2,1
78010,3,2,272194,272194,272196,0,2,1
78011,3,2,272197,272197,272199,0,2,1
78012,4,1,272201,272201,272202,0,1,2
78013,2,2,272203,272203,272205,0,2,1
78014,1,3,272204,272205,272208,1,4,0
78015,5,1,272209,272209,272210,0,1,1
78016,6,1,272215,272215,272216,0,1,5
78017,3,1,272218,272218,272219,0,1,2
78018,5,1,272223,272223,272224,0,1,4
78019,6,3,272229,272229,272232,0,3,5
78020,2,2,272231,272232,272234,1,3,0
78021,6,3,272237,272237,272240,0,3,3
78022,6,1,272243,272243,272244,0,1,3
78023,5,3,272248,272248,272251,0,3,4
78024,5,3,272253,272253,272256,0,3,2
78025,1,1,272254,272256,272257,2,3,0
78026,5,2,272259,272259,272261,0,2,2
78027,5,1,272264,272264,272265,0,1,3
78028,6,2,272270,272270,272272,0,2,5
78029,4,2,272274,272274,272276,0,2,2
78030,1,1,272275,272276,272277,1,2,0
78031,3,1,272278,272278,272279,0,1,1
78032,6,2,272284,272284,272286,0,2,5
78033,4,3,272288,272288,272291,0,3,2
78034,2,1,272290,272291,272292,1,2,0
78035,6,2,272296,272296,272298,0,2,4
78036,5,2,272301,272301,272303,0,2,3
78037,1,1,272302,272303,272304,1,2,0
78038,5,1,272307,272307,272308,0,1,3
78039,3,3,272310,272310,272313,0,3,2
78040,6,1,272316,272316,272317,0,1,3
78041,2,1,272318,272318,272319,0,1,1
78042,2,3,272320,272320,272323,0,3,1
78043,3,2,272323,272323,272325,0,2,0
78044,4,2,272327,272327,272329,0,2,2
78045,1,2,272328,272329,272331,1,3,0
78046,5,1,272333,272333,272334,0,1,2
78047,3,2,272336,272336,272338,0,2,2
78048,2,3,272338,272338,272341,0,3,0
78049,5,3,272343,272343,272346,0,3,2
78050,3,3,272346,272346,272349,0,3,0
78051,5,2,272351,272351,272353,0,2,2
78052,1,1,272352,272353,272354,1,2,0
78053,5,3,272357,272357,272360,0,3,3
78054,3,3,272360,272360,272363,0,3,0
78055,2,1,272362,272363,272364,1,2,0
78056,4,1,272366,272366,272367,0,1,2
78057,3,2,272369,272369,272371,0,2,2
78058,6,3,272375,272375,272378,0,3,4
78059,1,1,272376,272378,272379,2,3,0
78060,4,2,272380,272380,272382,0,2,1
78061,5,1,272385,272385,272386,0,1,3
78062,6,3,272391,272391,272394,0,3,5
78063,6,2,272397,272397,272399,0,2,3
78064,1,3,272398,272399,272402,1,4,0
78065,3,1,272401,272402,272403,1,2,0
78066,2,3,272403,272403,272406,0,3,0
78067,5,3,272408,272408,272411,0,3,2
78068,6,1,272414,272414,272415,0,1,3
78069,5,3,272419,272419,272422,0,3,4
78070,2,1,272421,272422,272423,1,2,0
78071,3,1,272424,272424,272425,0,1,1
78072,2,2,272426,272426,272428,0,2,1
78073,4,2,272430,272430,272432,0,2,2
78074,4,3,272434,272434,272437,0,3,2
78075,5,1,272439,272439,272440,0,1,2
78076,2,1,272441,272441,272442,0,1,1
78077,2,2,272443,272443,272445,0,2,1
78078,1,2,272444,272445,272447,1,3,0
78079,5,1,272449,272449,272450,0,1,2
78080,4,2,272453,272453,272455,0,2,3
78081,6,2,272459,272459,272461,0,2,4
78082,4,2,272463,272463,272465,0,2,2
78083,3,2,272466,272466,272468,0,2,1
78084,2,3,272468,272468,272471,0,3,0
78085,4,3,272472,272472,272475,0,3,1
78086,3,3,272475,272475,272478,0,3,0
78087,3,1,272478,272478,272479,0,1,0
78088,2,1,272480,272480,272481,0,1,1
78089,6,2,272486,272486,272488,0,2,5
78090,5,3,272491,272491,272494,0,3,3
78091,2,2,272493,272494,272496,1,3,0
78092,2,2,272495,272496,272498,1,3,0
78093,3,2,272498,272498,272500,0,2,0
78094,6,3,272504,272504,272507,0,3,4
78095,6,1,272510,272510,272511,0,1,3
78096,4,1,272514,272514,272515,0,1,3
78097,6,1,272520,272520,272521,0,1,5
78098,5,1,272525,272525,272526,0,1,4
78099,1,3,272526,272526,272529,0,3,0
78100,6,2,272532,272532,272534,0,2,3
78101,4,3,272536,272536,272539,0,3,2
78102,4,1,272540,272540,272541,0,1,1
78103,4,3,272544,272544,272547,0,3,3
78104,4,1,272548,272548,272549,0,1,1
78105,6,3,272554,272554,272557,0,3,5
78106,5,3,272559,272559,272562,0,3,2
78107,6,2,272565,272565,272567,0,2,3
78108,2,2,272567,272567,272569,0,2,0
78109,4,2,272571,272571,272573,0,2,2
78110,6,1,272577,272577,272578,0,1,4
78111,4,3,272581,272581,272584,0,3,3
78112,3,1,272584,272584,272585,0,1,0
78113,3,2,272587,272587,272589,0,2,2
78114,4,3,272591,272591,272594,0,3,2
78115,6,3,272597,272597,272600,0,3,3
78116,1,2,272598,272600,272602,2,4,0
78117,5,1,272603,272603,272604,0,1,1
78118,1,2,272604,272604,272606,0,2,0
78119,6,2,272610,272610,272612,0,2,4
78120,1,1,272611,272612,272613,1,2,0
78121,3,2,272614,272614,272616,0,2,1
78122,2,1,272616,272616,272617,0,1,0
78123,3,1,272619,272619,272620,0,1,2
78124,3,1,272622,272622,272623,0,1,2
78125,5,3,272627,272627,272630,0,3,4
78126,3,1,272630,272630,272631,0,1,0
78127,6,1,272636,272636,272637,0,1,5
78128,6,1,272642,272642,272643,0,1,5
78129,4,1,272646,272646,272647,0,1,3
78130,5,1,272651,272651,272652,0,1,4
78131,5,2,272656,272656,272658,0,2,4
78132,4,2,272660,272660,272662,0,2,2
78133,1,3,272661,272662,272665,1,4,0
78134,2,3,272663,272665,272668,2,5,0
78135,1,1,272664,272668,272669,4,5,0
78136,6,1,272670,272670,272671,0,1,1
78137,2,3,272672,272672,272675,0,3,1
78138,3,2,272675,272675,272677,0,2,0
78139,2,2,272677,272677,272679,0,2,0
78140,6,1,272683,272683,272684,0,1,4
78141,5,1,272688,272688,272689,0,1,4
78142,4,2,272692,272692,272694,0,2,3
78143,6,3,272698,272698,272701,0,3,4
78144,4,1,272702,272702,272703,0,1,1
78145,5,2,272707,272707,272709,0,2,4
78146,4,3,272711,272711,272714,0,3,2
78147,3,3,272714,272714,272717,0,3,0
78148,2,3,272716,272717,272720,1,4,0
78149,1,1,272717,272720,272721,3,4,0
78150,1,2,272718,272721,272723,3,5,0
78151,2,2,272720,272723,272725,3,5,0
78152,1,1,272721,272725,272726,4,5,0
78153,2,1,272723,272726,272727,3,4,0
78154,6,2,272729,272729,272731,0,2,2
78155,4,3,272733,272733,272736,0,3,2
78156,6,1,272739,272739,272740,0,1,3
78157,4,1,272743,272743,272744,0,1,3
78158,4,2,272747,272747,272749,0,2,3
78159,2,1,272749,272749,272750,0,1,0
78160,2,3,272751,272751,272754,0,3,1
78161,2,1,272753,272754,272755,1,2,0
78162,3,3,272756,272756,272759,0,3,1
78163,4,2,272760,272760,272762,0,2,1
78164,2,3,272762,272762,272765,0,3,0
78165,5,1,272767,272767,272768,0,1,2
78166,4,1,272771,272771,272772,0,1,3
78167,2,1,272773,272773,272774,0,1,1
78168,3,1,272776,272776,272777,0,1,2
78169,3,1,272779,272779,272780,0,1,2
78170,4,2,272783,272783,272785,0,2,3
78171,5,2,272788,272788,272790,0,2,3
78172,6,2,272794,272794,272796,0,2,4
78173,4,2,272798,272798,272800,0,2,2
78174,1,3,272799,272800,272803,1,4,0
78175,5,2,272804,272804,272806,0,2,1
78176,6,2,272810,272810,272812,0,2,4
78177,2,2,272812,272812,272814,0,2,0
78178,3,3,272815,272815,272818,0,3,1
78179,1,1,272816,272818,272819,2,3,0
78180,5,2,272821,272821,272823,0,2,2
78181,3,1,272824,272824,272825,0,1,1
78182,5,1,272829,272829,272830,0,1,4
78183,3,2,272832,272832,272834,0,2,2
78184,5,1,272837,272837,272838,0,1,3
78185,4,2,272841,272841,272843,0,2,3
78186,5,2,272846,272846,272848,0,2,3
78187,4,2,272850,272850,272852,0,2,2
78188,2,2,272852,272852,272854,0,2,0
78189,3,2,272855,272855,272857,0,2,1
78190,3,3,272858,272858,272861,0,3,1
78191,5,2,272863,272863,272865,0,2,2
78192,3,1,272866,272866,272867,0,1,1
78193,5,1,272871,272871,272872,0,1,4
78194,3,3,272874,272874,272877,0,3,2
78195,3,2,272877,272877,272879,0,2,0
78196,3,2,272880,272880,272882,0,2,1
78197,3,1,272883,272883,272884,0,1,1
78198,1,1,272884,272884,272885,0,1,0
78199,4,2,272888,272888,272890,0,2,3
78200,4,1,272892,272892,272893,0,1,2
78201,6,1,272898,272898,272899,0,1,5
78202,2,3,272900,272900,272903,0,3,1
78203,3,1,272903,272903,272904,0,1,0
78204,3,1,272906,272906,272907,0,1,2
78205,6,2,272912,272912,272914,0,2,5
78206,4,3,272916,272916,272919,0,3,2
78207,6,3,272922,272922,272925,0,3,3
78208,3,1,272925,272925,272926,0,1,0
78209,6,3,272931,272931,272934,0,3,5
78210,4,2,272935,272935,272937,0,2,1
78211,3,2,272938,272938,272940,0,2,1
78212,2,2,272940,272940,272942,0,2,0
78213,6,1,272946,272946,272947,0,1,4
78214,2,2,272948,272948,272950,0,2,1
78215,4,1,272952,272952,272953,0,1,2
78216,6,3,272958,272958,272961,0,3,5
78217,5,1,272963,272963,272964,0,1,2
78218,3,2,272966,272966,272968,0,2,2
78219,6,2,272972,272972,272974,0,2,4
78220,2,1,272974,272974,272975,0,1,0
78221,2,1,272976,272976,272977,0,1,1
78222,5,2,272981,272981,272983,0,2,4
78223,3,3,272984,272984,272987,0,3,1
78224,3,3,272987,272987,272990,0,3,0
78225,1,1,272988,272990,272991,2,3,0
78226,2,1,272990,272991,272992,1,2,0
78227,2,2,272992,272992,272994,0,2,0
78228,2,2,272994,272994,272996,0,2,0
78229,6,2,273000,273000,273002,0,2,4
78230,1,1,273001,273002,273003,1,2,0
78231,1,2,273002,273003,273005,1,3,0
78232,2,2,273004,273005,273007,1,3,0
78233,1,1,273005,273007,273008,2,3,0
78234,6,3,273011,273011,273014,0,3,3
78235,3,3,273014,273014,273017,0,3,0
78236,3,1,273017,273017,273018,0,1,0
78237,2,1,273019,273019,273020,0,1,1
78238,5,2,273024,273024,273026,0,2,4
78239,2,2,273026,273026,273028,0,2,0
78240,1,1,273027,273028,273029,1,2,0
78241,2,1,273029,273029,273030,0,1,0
78242,1,1,273030,273030,273031,0,1,0
78243,6,2,273036,273036,273038,0,2,5
78244,3,2,273039,273039,273041,0,2,1
78245,1,3,273040,273041,273044,1,4,0
78246,1,2,273041,273044,273046,3,5,0
78247,2,2,273043,273046,273048,3,5,0
78248,1,3,273044,273048,273051,4,7,0
78249,4,2,273048,273051,273053,3,5,0
78250,5,3,273053,273053,273056,0,3,0
78251,4,1,273057,273057,273058,0,1,1
78252,4,1,273061,273061,273062,0,1,3
78253,4,2,273065,273065,273067,0,2,3
78254,2,3,273067,273067,273070,0,3,0
78255,6,2,273073,273073,273075,0,2,3
78256,6,3,273079,273079,273082,0,3,4
78257,6,3,273085,273085,273088,0,3,3
78258,2,3,273087,273088,273091,1,4,0
78259,2,2,273089,273091,273093,2,4,0
78260,3,2,273092,273093,273095,1,3,0
78261,6,3,273098,273098,273101,0,3,3
78262,1,3,273099,273101,273104,2,5,0
78263,2,2,273101,273104,273106,3,5,0
78264,5,1,273106,273106,273107,0,1,0
78265,4,2,273110,273110,273112,0,2,3
78266,1,1,273111,273112,273113,1,2,0
78267,1,3,273112,273113,273116,1,4,0
78268,5,1,273117,273117,273118,0,1,1
78269,5,1,273122,273122,273123,0,1,4
78270,3,3,273125,273125,273128,0,3,2
78271,5,2,273130,273130,273132,0,2,2
78272,2,2,273132,273132,273134,0,2,0
78273,5,2,273137,273137,273139,0,2,3
78274,1,1,273138,273139,273140,1,2,0
78275,3,3,273141,273141,273144,0,3,1
78276,1,2,273142,273144,273146,2,4,0
78277,6,2,273148,273148,273150,0,2,2
78278,1,3,273149,273150,273153,1,4,0
78279,6,2,273155,273155,273157,0,2,2
78280,6,2,273161,273161,273163,0,2,4
78281,1,3,273162,273163,273166,1,4,0
78282,5,3,273167,273167,273170,0,3,1
78283,4,3,273171,273171,273174,0,3,1
78284,2,2,273173,273174,273176,1,3,0
78285,4,3,273177,273177,273180,0,3,1
78286,2,1,273179,273180,273181,1,2,0
78287,3,1,273182,273182,273183,0,1,1
78288,1,3,273183,273183,273186,0,3,0
78289,4,2,273187,273187,273189,0,2,1
78290,2,2,273189,273189,273191,0,2,0
78291,5,3,273194,273194,273197,0,3,3
78292,6,2,273200,273200,273202,0,2,3
78293,6,3,273206,273206,273209,0,3,4
78294,6,2,273212,273212,273214,0,2,3
78295,5,1,273217,273217,273218,0,1,3
78296,1,3,273218,273218,273221,0,3,0
78297,6,3,273224,273224,273227,0,3,3
78298,1,3,273225,273227,273230,2,5,0
78299,2,3,273227,273230,273233,3,6,0
78300,5,2,273232,273233,273235,1,3,0
78301,5,2,273237,273237,273239,0,2,2
78302,2,1,273239,273239,273240,0,1,0
78303,3,3,273242,273242,273245,0,3,2
78304,2,3,273244,273245,273248,1,4,0
78305,4,1,273248,273248,273249,0,1,0
78306,6,1,273254,273254,273255,0,1,5
78307,3,3,273257,273257,273260,0,3,2
78308,3,3,273260,273260,273263,0,3,0
78309,3,2,273263,273263,273265,0,2,0
78310,5,1,273268,273268,273269,0,1,3
78311,6,2,273274,273274,273276,0,2,5
78312,4,1,273278,273278,273279,0,1,2
78313,5,2,273283,273283,273285,0,2,4
78314,1,3,273284,273285,273288,1,4,0
78315,4,2,273288,273288,273290,0,2,0
78316,4,2,273292,273292,273294,0,2,2
78317,2,2,273294,273294,273296,0,2,0
78318,3,1,273297,273297,273298,0,1,1
78319,5,3,273302,273302,273305,0,3,4
78320,4,1,273306,273306,273307,0,1,1
78321,6,2,273312,273312,273314,0,2,5
78322,6,2,273318,273318,273320,0,2,4
78323,3,2,273321,273321,273323,0,2,1
78324,3,3,273324,273324,273327,0,3,1
78325,6,2,273330,273330,273332,0,2,3
78326,4,3,273334,273334,273337,0,3,2
78327,1,1,273335,273337,273338,2,3,0
78328,2,2,273337,273338,273340,1,3,0
78329,6,2,273343,273343,273345,0,2,3
78330,6,3,273349,273349,273352,0,3,4
78331,3,3,273352,273352,273355,0,3,0
78332,1,2,273353,273355,273357,2,4,0
78333,6,3,273359,273359,273362,0,3,2
78334,6,1,273365,273365,273366,0,1,3
78335,6,1,273371,273371,273372,0,1,5
78336,3,2,273374,273374,273376,0,2,2
78337,2,2,273376,273376,273378,0,2,0
78338,5,2,273381,273381,273383,0,2,3
78339,4,1,273385,273385,273386,0,1,2
78340,1,2,273386,273386,273388,0,2,0
78341,3,2,273389,273389,273391,0,2,1
78342,2,1,273391,273391,273392,0,1,0
78343,4,1,273395,273395,273396,0,1,3
78344,2,3,273397,273397,273400,0,3,1
78345,5,2,273402,273402,273404,0,2,2
78346,2,1,273404,273404,273405,0,1,0
78347,2,1,273406,273406,273407,0,1,1
78348,4,1,273410,273410,273411,0,1,3
78349,1,2,273411,273411,273413,0,2,0
78350,5,3,273416,273416,273419,0,3,3
78351,3,2,273419,273419,273421,0,2,0
78352,4,3,273423,273423,273426,0,3,2
78353,4,2,273427,273427,273429,0,2,1
78354,1,2,273428,273429,273431,1,3,0
78355,4,3,273432,273432,273435,0,3,1
78356,1,1,273433,273435,273436,2,3,0
78357,4,3,273437,273437,273440,0,3,1
78358,2,1,273439,273440,273441,1,2,0
78359,6,2,273445,273445,273447,0,2,4
78360,5,2,273450,273450,273452,0,2,3
78361,1,2,273451,273452,273454,1,3,0
78362,3,2,273454,273454,273456,0,2,0
78363,1,1,273455,273456,273457,1,2,0
78364,5,2,273460,273460,273462,0,2,3
78365,6,2,273466,273466,273468,0,2,4
78366,2,2,273468,273468,273470,0,2,0
78367,6,2,273474,273474,273476,0,2,4
78368,2,3,273476,273476,273479,0,3,0
78369,6,1,273482,273482,273483,0,1,3
78370,2,3,273484,273484,273487,0,3,1
78371,2,3,273486,273487,273490,1,4,0
78372,4,3,273490,273490,273493,0,3,0
78373,1,1,273491,273493,273494,2,3,0
78374,4,1,273495,273495,273496,0,1,1
78375,4,3,273499,273499,273502,0,3,3
78376,3,3,273502,273502,273505,0,3,0
78377,3,1,273505,273505,273506,0,1,0
78378,6,2,273511,273511,273513,0,2,5
78379,5,3,273516,273516,273519,0,3,3
78380,6,3,273522,273522,273525,0,3,3
78381,3,2,273525,273525,273527,0,2,0
78382,1,1,273526,273527,273528,1,2,0
78383,5,1,273531,273531,273532,0,1,3
78384,4,1,273535,273535,273536,0,1,3
78385,6,3,273541,273541,273544,0,3,5
78386,2,1,273543,273544,273545,1,2,0
78387,2,2,273545,273545,273547,0,2,0
78388,3,2,273548,273548,273550,0,2,1
78389,4,2,273552,273552,273554,0,2,2
78390,4,1,273556,273556,273557,0,1,2
78391,2,2,273558,273558,273560,0,2,1
78392,1,2,273559,273560,273562,1,3,0
78393,1,2,273560,273562,273564,2,4,0
78394,3,2,273563,273564,273566,1,3,0
78395,5,2,273568,273568,273570,0,2,2
78396,5,1,273573,273573,273574,0,1,3
78397,4,2,273577,273577,273579,0,2,3
78398,3,3,273580,273580,273583,0,3,1
78399,5,3,273585,273585,273588,0,3,2
78400,1,2,273586,273588,273590,2,4,0
78401,6,3,273592,273592,273595,0,3,2
78402,4,3,273596,273596,273599,0,3,1
78403,2,1,273598,273599,273600,1,2,0
78404,4,3,273602,273602,273605,0,3,2
78405,3,1,273605,273605,273606,0,1,0
78406,1,3,273606,273606,273609,0,3,0
78407,2,3,273608,273609,273612,1,4,0
78408,6,1,273614,273614,273615,0,1,2
78409,4,2,273618,273618,273620,0,2,3
78410,2,2,273620,273620,273622,0,2,0
78411,2,2,273622,273622,273624,0,2,0
78412,3,3,273625,273625,273628,0,3,1
78413,6,3,273631,273631,273634,0,3,3
78414,2,3,273633,273634,273637,1,4,0
78415,3,3,273636,273637,273640,1,4,0
78416,3,1,273639,273640,273641,1,2,0
78417,6,3,273645,273645,273648,0,3,4
78418,4,3,273649,273649,273652,0,3,1
78419,6,1,273655,273655,273656,0,1,3
78420,2,1,273657,273657,273658,0,1,1
78421,4,1,273661,273661,273662,0,1,3
78422,4,2,273665,273665,273667,0,2,3
78423,1,3,273666,273667,273670,1,4,0
78424,5,1,273671,273671,273672,0,1,1
78425,6,3,273677,273677,273680,0,3,5
78426,4,2,273681,273681,273683,0,2,1
78427,6,1,273687,273687,273688,0,1,4
78428,1,3,273688,273688,273691,0,3,0
78429,2,3,273690,273691,273694,1,4,0
78430,4,3,273694,273694,273697,0,3,0
78431,1,1,273695,273697,273698,2,3,0
78432,6,3,273701,273701,273704,0,3,3
78433,5,1,273706,273706,273707,0,1,2
78434,1,3,273707,273707,273710,0,3,0
78435,4,3,273711,273711,273714,0,3,1
78436,1,2,273712,273714,273716,2,4,0
78437,6,1,273718,273718,273719,0,1,2
78438,1,3,273719,273719,273722,0,3,0
78439,2,3,273721,273722,273725,1,4,0
78440,6,1,273727,273727,273728,0,1,2
78441,1,1,273728,273728,273729,0,1,0
78442,3,2,273731,273731,273733,0,2,2
78443,5,2,273736,273736,273738,0,2,3
78444,5,1,273741,273741,273742,0,1,3
78445,3,3,273744,273744,273747,0,3,2
78446,3,1,273747,273747,273748,0,1,0
78447,4,1,273751,273751,273752,0,1,3
78448,3,3,273754,273754,273757,0,3,2
78449,6,1,273760,273760,273761,0,1,3
78450,2,1,273762,273762,273763,0,1,1
78451,4,1,273766,273766,273767,0,1,3
78452,5,3,273771,273771,273774,0,3,4
78453,6,1,273777,273777,273778,0,1,3
78454,1,2,273778,273778,273780,0,2,0
78455,5,2,273783,273783,273785,0,2,3
78456,1,1,273784,273785,273786,1,2,0
78457,5,2,273789,273789,273791,0,2,3
78458,2,1,273791,273791,273792,0,1,0
78459,1,3,273792,273792,273795,0,3,0
78460,3,1,273795,273795,273796,0,1,0
78461,5,2,273800,273800,273802,0,2,4
78462,4,1,273804,273804,273805,0,1,2
78463,3,3,273807,273807,273810,0,3,2
78464,5,1,273812,273812,273813,0,1,2
78465,1,1,273813,273813,273814,0,1,0
78466,4,1,273817,273817,273818,0,1,3
78467,1,2,273818,273818,273820,0,2,0
78468,5,2,273823,273823,273825,0,2,3
78469,5,3,273828,273828,273831,0,3,3
78470,2,1,273830,273831,273832,1,2,0
78471,6,3,273836,273836,273839,0,3,4
78472,4,1,273840,273840,273841,0,1,1
78473,6,2,273846,273846,273848,0,2,5
78474,6,2,273852,273852,273854,0,2,4
78475,2,2,273854,273854,273856,0,2,0
78476,6,3,273860,273860,273863,0,3,4
78477,6,1,273866,273866,273867,0,1,3
78478,1,3,273867,273867,273870,0,3,0
78479,2,3,273869,273870,273873,1,4,0
78480,6,3,273875,273875,273878,0,3,2
78481,4,2,273879,273879,273881,0,2,1
78482,1,1,273880,273881,273882,1,2,0
78483,1,1,273881,273882,273883,1,2,0
78484,6,1,273887,273887,273888,0,1,4
78485,1,2,273888,273888,273890,0,2,0
78486,6,3,273894,273894,273897,0,3,4
78487,4,3,273898,273898,273901,0,3,1
78488,6,2,273904,273904,273906,0,2,3
78489,2,1,273906,273906,273907,0,1,0
78490,2,1,273908,273908,273909,0,1,1
78491,4,1,273912,273912,273913,0,1,3
78492,1,1,273913,273913,273914,0,1,0
78493,4,3,273917,273917,273920,0,3,3
78494,1,3,273918,273920,273923,2,5,0
78495,1,2,273919,273923,273925,4,6,0
78496,3,3,273922,273925,273928,3,6,0
78497,2,2,273924,273928,273930,4,6,0
78498,4,2,273928,273930,273932,2,4,0
78499,1,1,273929,273932,273933,3,4,0
78500,6,2,273935,273935,273937,0,2,2
78501,4,3,273939,273939,273942,0,3,2
78502,4,2,273943,273943,273945,0,2,1
78503,4,3,273947,273947,273950,0,3,2
78504,4,2,273951,273951,273953,0,2,1
78505,6,3,273957,273957,273960,0,3,4
78506,1,2,273958,273960,273962,2,4,0
78507,2,1,273960,273962,273963,2,3,0
78508,4,2,273964,273964,273966,0,2,1
78509,5,2,273969,273969,273971,0,2,3
78510,6,2,273975,273975,273977,0,2,4
78511,6,2,273981,273981,273983,0,2,4
78512,5,3,273986,273986,273989,0,3,3
78513,3,2,273989,273989,273991,0,2,0
78514,5,1,273994,273994,273995,0,1,3
78515,1,1,273995,273995,273996,0,1,0
78516,1,2,273996,273996,273998,0,2,0
78517,2,1,273998,273998,273999,0,1,0
78518,4,1,274002,274002,274003,0,1,3
78519,1,3,274003,274003,274006,0,3,0
78520,2,3,274005,274006,274009,1,4,0
78521,5,2,274010,274010,274012,0,2,1
78522,5,1,274015,274015,274016,0,1,3
78523,2,2,274017,274017,274019,0,2,1
78524,5,3,274022,274022,274025,0,3,3
78525,4,3,274026,274026,274029,0,3,1
78526,2,3,274028,274029,274032,1,4,0
78527,5,3,274033,274033,274036,0,3,1
78528,4,2,274037,274037,274039,0,2,1
78529,4,2,274041,274041,274043,0,2,2
78530,5,1,274046,274046,274047,0,1,3
78531,5,3,274051,274051,274054,0,3,4
78532,1,1,274052,274054,274055,2,3,0
78533,1,2,274053,274055,274057,2,4,0
78534,2,3,274055,274057,274060,2,5,0
78535,4,2,274059,274060,274062,1,3,0
78536,3,2,274062,274062,274064,0,2,0
78537,3,2,274065,274065,274067,0,2,1
78538,1,2,274066,274067,274069,1,3,0
78539,3,1,274069,274069,274070,0,1,0
78540,2,2,274071,274071,274073,0,2,1
78541,6,1,274077,274077,274078,0,1,4
78542,1,3,274078,274078,274081,0,3,0
78543,2,1,274080,274081,274082,1,2,0
78544,4,1,274084,274084,274085,0,1,2
78545,2,1,274086,274086,274087,0,1,1
78546,6,1,274092,274092,274093,0,1,5
78547,6,2,274098,274098,274100,0,2,5
78548,4,2,274102,274102,274104,0,2,2
78549,2,3,274104,274104,274107,0,3,0
78550,6,2,274110,274110,274112,0,2,3
78551,6,2,274116,274116,274118,0,2,4
78552,1,3,274117,274118,274121,1,4,0
78553,4,3,274121,274121,274124,0,3,0
78554,4,1,274125,274125,274126,0,1,1
78555,5,1,274130,274130,274131,0,1,4
78556,1,2,274131,274131,274133,0,2,0
78557,4,1,274135,274135,274136,0,1,2
78558,2,3,274137,274137,274140,0,3,1
78559,6,3,274143,274143,274146,0,3,3
78560,2,2,274145,274146,274148,1,3,0
78561,4,3,274149,274149,274152,0,3,1
78562,3,2,274152,274152,274154,0,2,0
78563,3,1,274155,274155,274156,0,1,1
78564,5,3,274160,274160,274163,0,3,4
78565,6,2,274166,274166,274168,0,2,3
78566,4,3,274170,274170,274173,0,3,2
78567,6,2,274176,274176,274178,0,2,3
78568,2,2,274178,274178,274180,0,2,0
78569,6,2,274184,274184,274186,0,2,4
78570,4,1,274188,274188,274189,0,1,2
78571,4,1,274192,274192,274193,0,1,3
78572,4,1,274196,274196,274197,0,1,3
78573,4,1,274200,274200,274201,0,1,3
78574,3,1,274203,274203,274204,0,1,2
78575,4,2,274207,274207,274209,0,2,3
78576,1,2,274208,274209,274211,1,3,0
78577,1,3,274209,274211,274214,2,5,0
78578,1,1,274210,274214,274215,4,5,0
78579,3,1,274213,274215,274216,2,3,0
78580,5,3,274218,274218,274221,0,3,2
78581,6,3,274224,274224,274227,0,3,3
78582,3,1,274227,274227,274228,0,1,0
78583,6,1,274233,274233,274234,0,1,5
78584,4,3,274237,274237,274240,0,3,3
78585,5,2,274242,274242,274244,0,2,2
78586,2,3,274244,274244,274247,0,3,0
78587,2,2,274246,274247,274249,1,3,0
78588,4,1,274250,274250,274251,0,1,1
78589,2,3,274252,274252,274255,0,3,1
78590,5,1,274257,274257,274258,0,1,2
78591,5,1,274262,274262,274263,0,1,4
78592,4,3,274266,274266,274269,0,3,3
78593,5,3,274271,274271,274274,0,3,2
78594,5,2,274276,274276,274278,0,2,2
78595,4,1,274280,274280,274281,0,1,2
78596,2,3,274282,274282,274285,0,3,1
78597,1,2,274283,274285,274287,2,4,0
78598,6,2,274289,274289,274291,0,2,2
78599,6,2,274295,274295,274297,0,2,4
78600,2,1,274297,274297,274298,0,1,0
78601,4,3,274301,274301,274304,0,3,3
78602,6,2,274307,274307,274309,0,2,3
78603,6,3,274313,274313,274316,0,3,4
78604,4,1,274317,274317,274318,0,1,1
78605,5,2,274322,274322,274324,0,2,4
78606,1,2,274323,274324,274326,1,3,0
78607,2,1,274325,274326,274327,1,2,0
78608,4,3,274329,274329,274332,0,3,2
78609,6,1,274335,274335,274336,0,1,3
78610,5,3,274340,274340,274343,0,3,4
78611,6,3,274346,274346,274349,0,3,3
78612,6,1,274352,274352,274353,0,1,3
78613,2,2,274354,274354,274356,0,2,1
78614,2,3,274356,274356,274359,0,3,0
78615,3,1,274359,274359,274360,0,1,0
78616,5,2,274364,274364,274366,0,2,4
78617,2,1,274366,274366,274367,0,1,0
78618,3,2,274369,274369,274371,0,2,2
78619,1,1,274370,274371,274372,1,2,0
78620,2,3,274372,274372,274375,0,3,0
78621,3,1,274375,274375,274376,0,1,0
78622,3,2,274378,274378,274380,0,2,2
78623,3,3,274381,274381,274384,0,3,1
78624,1,1,274382,274384,274385,2,3,0
78625,6,3,274388,274388,274391,0,3,3
78626,2,3,274390,274391,274394,1,4,0
78627,3,1,274393,274394,274395,1,2,0
78628,3,2,274396,274396,274398,0,2,1
78629,6,3,274402,274402,274405,0,3,4
78630,6,2,274408,274408,274410,0,2,3
78631,6,3,274414,274414,274417,0,3,4
78632,1,2,274415,274417,274419,2,4,0
78633,1,3,274416,274419,274422,3,6,0
78634,2,1,274418,274422,274423,4,5,0
78635,2,1,274420,274423,274424,3,4,0
78636,6,1,274426,274426,274427,0,1,2
78637,6,3,274432,274432,274435,0,3,5
78638,2,3,274434,274435,274438,1,4,0
78639,5,1,274439,274439,274440,0,1,1
78640,2,1,274441,274441,274442,0,1,1
78641,1,2,274442,274442,274444,0,2,0
78642,1,3,274443,274444,274447,1,4,0
78643,5,2,274448,274448,274450,0,2,1
78644,2,1,274450,274450,274451,0,1,0
78645,5,1,274455,274455,274456,0,1,4
78646,5,1,274460,274460,274461,0,1,4
78647,2,2,274462,274462,274464,0,2,1
78648,2,3,274464,274464,274467,0,3,0
78649,1,3,274465,274467,274470,2,5,0
78650,4,1,274469,274470,274471,1,2,0
78651,4,3,274473,274473,274476,0,3,2
78652,3,1,274476,274476,274477,0,1,0
78653,1,2,274477,274477,274479,0,2,0
78654,1,3,274478,274479,274482,1,4,0
78655,4,2,274482,274482,274484,0,2,0
78656,1,1,274483,274484,274485,1,2,0
78657,1,2,274484,274485,274487,1,3,0
78658,5,2,274489,274489,274491,0,2,2
78659,5,2,274494,274494,274496,0,2,3
78660,3,1,274497,274497,274498,0,1,1
78661,2,3,274499,274499,274502,0,3,1
78662,5,3,274504,274504,274507,0,3,2
78663,4,3,274508,274508,274511,0,3,1
78664,3,3,274511,274511,274514,0,3,0
78665,1,2,274512,274514,274516,2,4,0
78666,2,3,274514,274516,274519,2,5,0
78667,1,3,274515,274519,274522,4,7,0
78668,6,1,274521,274522,274523,1,2,0
78669,6,1,274527,274527,274528,0,1,4
78670,5,1,274532,274532,274533,0,1,4
78671,2,2,274534,274534,274536,0,2,1
78672,4,3,274538,274538,274541,0,3,2
78673,1,2,274539,274541,274543,2,4,0
78674,4,2,274543,274543,274545,0,2,0
78675,4,1,274547,274547,274548,0,1,2
78676,2,2,274549,274549,274551,0,2,1
78677,4,2,274553,274553,274555,0,2,2
78678,2,3,274555,274555,274558,0,3,0
78679,2,1,274557,274558,274559,1,2,0
78680,3,3,274560,274560,274563,0,3,1
78681,5,1,274565,274565,274566,0,1,2
78682,2,2,274567,274567,274569,0,2,1
78683,4,3,274571,274571,274574,0,3,2
78684,4,2,274575,274575,274577,0,2,1
78685,1,3,274576,274577,274580,1,4,0
78686,1,2,274577,274580,274582,3,5,0
78687,1,3,274578,274582,274585,4,7,0
78688,2,1,274580,274585,274586,5,6,0
78689,6,1,274586,274586,274587,0,1,0
78690,6,3,274592,274592,274595,0,3,5
78691,2,2,274594,274595,274597,1,3,0
78692,3,2,274597,274597,274599,0,2,0
78693,2,1,274599,274599,274600,0,1,0
78694,6,3,274605,274605,274608,0,3,5
78695,2,1,274607,274608,274609,1,2,0
78696,2,3,274609,274609,274612,0,3,0
78697,1,1,274610,274612,274613,2,3,0
78698,5,2,274615,274615,274617,0,2,2
78699,6,1,274621,274621,274622,0,1,4
78700,1,3,274622,274622,274625,0,3,0
78701,5,1,274627,274627,274628,0,1,2
78702,4,3,274631,274631,274634,0,3,3
78703,2,1,274633,274634,274635,1,2,0
78704,5,1,274638,274638,274639,0,1,3
78705,5,3,274643,274643,274646,0,3,4
78706,2,1,274645,274646,274647,1,2,0
78707,2,3,274647,274647,274650,0,3,0
78708,1,3,274648,274650,274653,2,5,0
78709,1,3,274649,274653,274656,4,7,0
78710,6,2,274655,274656,274658,1,3,0
78711,4,3,274659,274659,274662,0,3,1
78712,2,2,274661,274662,274664,1,3,0
78713,2,1,274663,274664,274665,1,2,0
78714,3,2,274666,274666,274668,0,2,1
78715,1,3,274667,274668,274671,1,4,0
78716,3,2,274670,274671,274673,1,3,0
78717,6,1,274676,274676,274677,0,1,3
78718,5,3,274681,274681,274684,0,3,4
78719,1,1,274682,274684,274685,2,3,0
78720,5,3,274687,274687,274690,0,3,2
78721,3,1,274690,274690,274691,0,1,0
78722,6,3,274696,274696,274699,0,3,5
78723,6,1,274702,274702,274703,0,1,3
78724,1,3,274703,274703,274706,0,3,0
78725,4,1,274707,274707,274708,0,1,1
78726,3,3,274710,274710,274713,0,3,2
78727,1,2,274711,274713,274715,2,4,0
78728,6,1,274717,274717,274718,0,1,2
78729,1,2,274718,274718,274720,0,2,0
78730,2,1,274720,274720,274721,0,1,0
78731,3,1,274723,274723,274724,0,1,2
78732,4,3,274727,274727,274730,0,3,3
78733,2,2,274729,274730,274732,1,3,0
78734,5,3,274734,274734,274737,0,3,2
78735,4,3,274738,274738,274741,0,3,1
78736,1,2,274739,274741,274743,2,4,0
78737,6,2,274745,274745,274747,0,2,2
78738,5,3,274750,274750,274753,0,3,3
78739,3,3,274753,274753,274756,0,3,0
78740,3,2,274756,274756,274758,0,2,0
78741,6,3,274762,274762,274765,0,3,4
78742,1,3,274763,274765,274768,2,5,0
78743,2,1,274765,274768,274769,3,4,0
78744,6,2,274771,274771,274773,0,2,2
78745,1,3,274772,274773,274776,1,4,0
78746,3,3,274775,274776,274779,1,4,0
78747,5,2,274780,274780,274782,0,2,1
78748,2,2,274782,274782,274784,0,2,0
78749,3,3,274785,274785,274788,0,3,1
78750,1,1,274786,274788,274789,2,3,0
78751,6,3,274792,274792,274795,0,3,3
78752,5,1,274797,274797,274798,0,1,2
78753,4,2,274801,274801,274803,0,2,3
78754,1,2,274802,274803,274805,1,3,0
78755,3,1,274805,274805,274806,0,1,0
78756,1,3,274806,274806,274809,0,3,0
78757,2,2,274808,274809,274811,1,3,0
78758,4,3,274812,274812,274815,0,3,1
78759,6,3,274818,274818,274821,0,3,3
78760,4,1,274822,274822,274823,0,1,1
78761,5,1,274827,274827,274828,0,1,4
78762,5,1,274832,274832,274833,0,1,4
78763,1,1,274833,274833,274834,0,1,0
78764,4,1,274837,274837,274838,0,1,3
78765,3,1,274840,274840,274841,0,1,2
78766,3,2,274843,274843,274845,0,2,2
78767,4,3,274847,274847,274850,0,3,2
78768,3,3,274850,274850,274853,0,3,0
78769,5,1,274855,274855,274856,0,1,2
78770,2,2,274857,274857,274859,0,2,1
78771,2,3,274859,274859,274862,0,3,0
78772,2,3,274861,274862,274865,1,4,0
78773,5,3,274866,274866,274869,0,3,1
78774,6,3,274872,274872,274875,0,3,3
78775,6,1,274878,274878,274879,0,1,3
78776,1,2,274879,274879,274881,0,2,0
78777,4,1,274883,274883,274884,0,1,2
78778,5,3,274888,274888,274891,0,3,4
78779,2,1,274890,274891,274892,1,2,0
78780,1,2,274891,274892,274894,1,3,0
78781,3,3,274894,274894,274897,0,3,0
78782,4,2,274898,274898,274900,0,2,1
78783,6,2,274904,274904,274906,0,2,4
78784,6,1,274910,274910,274911,0,1,4
78785,4,1,274914,274914,274915,0,1,3
78786,4,3,274918,274918,274921,0,3,3
78787,4,1,274922,274922,274923,0,1,1
78788,5,1,274927,274927,274928,0,1,4
78789,1,1,274928,274928,274929,0,1,0
78790,1,2,274929,274929,274931,0,2,0
78791,1,3,274930,274931,274934,1,4,0
78792,6,3,274936,274936,274939,0,3,2
78793,5,3,274941,274941,274944,0,3,2
78794,3,1,274944,274944,274945,0,1,0
78795,6,2,274950,274950,274952,0,2,5
78796,4,2,274954,274954,274956,0,2,2
78797,1,1,274955,274956,274957,1,2,0
78798,5,3,274960,274960,274963,0,3,3
78799,3,3,274963,274963,274966,0,3,0
78800,1,2,274964,274966,274968,2,4,0
78801,3,1,274967,274968,274969,1,2,0
78802,2,2,274969,274969,274971,0,2,0
78803,6,3,274975,274975,274978,0,3,4
78804,2,3,274977,274978,274981,1,4,0
78805,3,2,274980,274981,274983,1,3,0
78806,1,3,274981,274983,274986,2,5,0
78807,4,2,274985,274986,274988,1,3,0
78808,5,2,274990,274990,274992,0,2,2
78809,4,3,274994,274994,274997,0,3,2
78810,3,3,274997,274997,275000,0,3,0
78811,5,2,275002,275002,275004,0,2,2
78812,3,3,275005,275005,275008,0,3,1
78813,6,3,275011,275011,275014,0,3,3
78814,2,2,275013,275014,275016,1,3,0
78815,1,3,275014,275016,275019,2,5,0
78816,4,3,275018,275019,275022,1,4,0
78817,6,1,275024,275024,275025,0,1,2
78818,6,3,275030,275030,275033,0,3,5
78819,3,1,275033,275033,275034,0,1,0
78820,2,1,275035,275035,275036,0,1,1
78821,6,1,275041,275041,275042,0,1,5
78822,5,1,275046,275046,275047,0,1,4
78823,3,1,275049,275049,275050,0,1,2
78824,4,1,275053,275053,275054,0,1,3
78825,1,2,275054,275054,275056,0,2,0
78826,4,1,275058,275058,275059,0,1,2
78827,2,2,275060,275060,275062,0,2,1
78828,3,3,275063,275063,275066,0,3,1
78829,4,2,275067,275067,275069,0,2,1
78830,5,3,275072,275072,275075,0,3,3
78831,1,2,275073,275075,275077,2,4,0
78832,5,2,275078,275078,275080,0,2,1
78833,5,3,275083,275083,275086,0,3,3
78834,2,2,275085,275086,275088,1,3,0
78835,4,2,275089,275089,275091,0,2,1
78836,1,3,275090,275091,275094,1,4,0
78837,4,2,275094,275094,275096,0,2,0
78838,6,2,275100,275100,275102,0,2,4
78839,5,3,275105,275105,275108,0,3,3
78840,2,2,275107,275108,275110,1,3,0
78841,4,1,275111,275111,275112,0,1,1
78842,5,3,275116,275116,275119,0,3,4
78843,2,2,275118,275119,275121,1,3,0
78844,2,2,275120,275121,275123,1,3,0
78845,4,3,275124,275124,275127,0,3,1
78846,3,2,275127,275127,275129,0,2,0
78847,3,3,275130,275130,275133,0,3,1
78848,1,2,275131,275133,275135,2,4,0
78849,5,2,275136,275136,275138,0,2,1
78850,1,3,275137,275138,275141,1,4,0
78851,6,2,275143,275143,275145,0,2,2
78852,3,2,275146,275146,275148,0,2,1
78853,3,2,275149,275149,275151,0,2,1
78854,2,3,275151,275151,275154,0,3,0
78855,2,2,275153,275154,275156,1,3,0
78856,2,1,275155,275156,275157,1,2,0
78857,2,1,275157,275157,275158,0,1,0
78858,6,2,275163,275163,275165,0,2,5
78859,2,1,275165,275165,275166,0,1,0
78860,1,1,275166,275166,275167,0,1,0
78861,3,3,275169,275169,275172,0,3,2
78862,1,2,275170,275172,275174,2,4,0
78863,3,2,275173,275174,275176,1,3,0
78864,5,1,275178,275178,275179,0,1,2
78865,5,3,275183,275183,275186,0,3,4
78866,4,2,275187,275187,275189,0,2,1
78867,4,3,275191,275191,275194,0,3,2
78868,3,2,275194,275194,275196,0,2,0
78869,5,3,275199,275199,275202,0,3,3
78870,4,2,275203,275203,275205,0,2,1
78871,5,1,275208,275208,275209,0,1,3
78872,2,3,275210,275210,275213,0,3,1
78873,4,3,275214,275214,275217,0,3,1
78874,2,1,275216,275217,275218,1,2,0
78875,6,1,275222,275222,275223,0,1,4
78876,2,1,275224,275224,275225,0,1,1
78877,4,3,275228,275228,275231,0,3,3
78878,4,2,275232,275232,275234,0,2,1
78879,5,1,275237,275237,275238,0,1,3
78880,5,3,275242,275242,275245,0,3,4
78881,5,2,275247,275247,275249,0,2,2
78882,3,3,275250,275250,275253,0,3,1
78883,1,1,275251,275253,275254,2,3,0
78884,5,1,275256,275256,275257,0,1,2
78885,5,3,275261,275261,275264,0,3,4
78886,1,2,275262,275264,275266,2,4,0
78887,1,3,275263,275266,275269,3,6,0
78888,3,1,275266,275269,275270,3,4,0
78889,3,2,275269,275270,275272,1,3,0
78890,5,1,275274,275274,275275,0,1,2
78891,5,1,275279,275279,275280,0,1,4
78892,3,3,275282,275282,275285,0,3,2
78893,5,3,275287,275287,275290,0,3,2
78894,4,1,275291,275291,275292,0,1,1
78895,3,3,275294,275294,275297,0,3,2
78896,2,1,275296,275297,275298,1,2,0
78897,4,1,275300,275300,275301,0,1,2
78898,1,1,275301,275301,275302,0,1,0
78899,3,2,275304,275304,275306,0,2,2
78900,5,1,275309,275309,275310,0,1,3
78901,2,2,275311,275311,275313,0,2,1
78902,6,2,275317,275317,275319,0,2,4
78903,3,3,275320,275320,275323,0,3,1
78904,2,1,275322,275323,275324,1,2,0
78905,2,3,275324,275324,275327,0,3,0
78906,5,3,275329,275329,275332,0,3,2
78907,3,2,275332,275332,275334,0,2,0
78908,1,2,275333,275334,275336,1,3,0
78909,3,3,275336,275336,275339,0,3,0
78910,2,2,275338,275339,275341,1,3,0
78911,3,1,275341,275341,275342,0,1,0
78912,6,3,275347,275347,275350,0,3,5
78913,5,3,275352,275352,275355,0,3,2
78914,6,3,275358,275358,275361,0,3,3
78915,3,3,275361,275361,275364,0,3,0
78916,5,1,275366,275366,275367,0,1,2
78917,5,1,275371,275371,275372,0,1,4
78918,2,2,275373,275373,275375,0,2,1
78919,2,3,275375,275375,275378,0,3,0
78920,1,3,275376,275378,275381,2,5,0
78921,2,3,275378,275381,275384,3,6,0
78922,3,2,275381,275384,275386,3,5,0
78923,2,3,275383,275386,275389,3,6,0
78924,2,2,275385,275389,275391,4,6,0
78925,1,1,275386,275391,275392,5,6,0
78926,1,1,275387,275392,275393,5,6,0
78927,3,1,275390,275393,275394,3,4,0
78928,6,1,275396,275396,275397,0,1,2
78929,3,2,275399,275399,275401,0,2,2
78930,6,3,275405,275405,275408,0,3,4
78931,5,3,275410,275410,275413,0,3,2
78932,2,3,275412,275413,275416,1,4,0
78933,4,2,275416,275416,275418,0,2,0
78934,1,3,275417,275418,275421,1,4,0
78935,5,1,275422,275422,275423,0,1,1
78936,5,1,275427,275427,275428,0,1,4
78937,2,1,275429,275429,275430,0,1,1
78938,4,2,275433,275433,275435,0,2,3
78939,4,2,275437,275437,275439,0,2,2
78940,3,3,275440,275440,275443,0,3,1
78941,2,1,275442,275443,275444,1,2,0
78942,3,2,275445,275445,275447,0,2,1
78943,1,2,275446,275447,275449,1,3,0
78944,4,1,275450,275450,275451,0,1,1
78945,4,3,275454,275454,275457,0,3,3
78946,5,2,275459,275459,275461,0,2,2
78947,6,1,275465,275465,275466,0,1,4
78948,5,1,275470,275470,275471,0,1,4
78949,2,2,275472,275472,275474,0,2,1
78950,2,3,275474,275474,275477,0,3,0
78951,4,1,275478,275478,275479,0,1,1
78952,5,3,275483,275483,275486,0,3,4
78953,2,1,275485,275486,275487,1,2,0
78954,5,2,275490,275490,275492,0,2,3
78955,4,2,275494,275494,275496,0,2,2
78956,4,3,275498,275498,275501,0,3,2
78957,1,3,275499,275501,275504,2,5,0
78958,2,1,275501,275504,275505,3,4,0
78959,6,3,275507,275507,275510,0,3,2
78960,4,2,275511,275511,275513,0,2,1
78961,2,2,275513,275513,275515,0,2,0
78962,4,1,275517,275517,275518,0,1,2
78963,5,3,275522,275522,275525,0,3,4
78964,6,1,275528,275528,275529,0,1,3
78965,4,3,275532,275532,275535,0,3,3
78966,3,3,275535,275535,275538,0,3,0
78967,4,1,275539,275539,275540,0,1,1
78968,1,3,275540,275540,275543,0,3,0
78969,3,1,275543,275543,275544,0,1,0
78970,1,1,275544,275544,275545,0,1,0
78971,2,3,275546,275546,275549,0,3,1
78972,3,1,275549,275549,275550,0,1,0
78973,6,1,275555,275555,275556,0,1,5
78974,4,1,275559,275559,275560,0,1,3
78975,1,2,275560,275560,275562,0,2,0
78976,5,3,275565,275565,275568,0,3,3
78977,1,2,275566,275568,275570,2,4,0
78978,3,1,275569,275570,275571,1,2,0
78979,6,2,275575,275575,275577,0,2,4
78980,6,2,275581,275581,275583,0,2,4
78981,6,2,275587,275587,275589,0,2,4
78982,3,1,275590,275590,275591,0,1,1
78983,3,1,275593,275593,275594,0,1,2
78984,2,1,275595,275595,275596,0,1,1
78985,1,1,275596,275596,275597,0,1,0
78986,6,2,275602,275602,275604,0,2,5
78987,2,1,275604,275604,275605,0,1,0
78988,5,3,275609,275609,275612,0,3,4
78989,2,1,275611,275612,275613,1,2,0
78990,3,3,275614,275614,275617,0,3,1
78991,2,3,275616,275617,275620,1,4,0
78992,1,2,275617,275620,275622,3,5,0
78993,1,2,275618,275622,275624,4,6,0
78994,6,3,275624,275624,275627,0,3,0
78995,3,2,275627,275627,275629,0,2,0
78996,3,1,275630,275630,275631,0,1,1
78997,1,2,275631,275631,275633,0,2,0
78998,1,2,275632,275633,275635,1,3,0
78999,6,3,275638,275638,275641,0,3,3
79000,4,3,275642,275642,275645,0,3,1
79001,4,3,275646,275646,275649,0,3,1
79002,2,1,275648,275649,275650,1,2,0
79003,5,3,275653,275653,275656,0,3,3
79004,6,1,275659,275659,275660,0,1,3
79005,5,2,275664,275664,275666,0,2,4
79006,2,2,275666,275666,275668,0,2,0
79007,2,3,275668,275668,275671,0,3,0
79008,6,2,275674,275674,275676,0,2,3
79009,1,1,275675,275676,275677,1,2,0
79010,3,3,275678,275678,275681,0,3,1
79011,2,3,275680,275681,275684,1,4,0
79012,6,1,275686,275686,275687,0,1,2
79013,4,1,275690,275690,275691,0,1,3
79014,6,2,275696,275696,275698,0,2,5
79015,6,1,275702,275702,275703,0,1,4
79016,4,1,275706,275706,275707,0,1,3
79017,6,3,275712,275712,275715,0,3,5
79018,1,2,275713,275715,275717,2,4,0
79019,6,3,275719,275719,275722,0,3,2
79020,4,2,275723,275723,275725,0,2,1
79021,6,1,275729,275729,275730,0,1,4
79022,5,2,275734,275734,275736,0,2,4
79023,3,3,275737,275737,275740,0,3,1
79024,1,1,275738,275740,275741,2,3,0
79025,1,2,275739,275741,275743,2,4,0
79026,5,1,275744,275744,275745,0,1,1
79027,3,3,275747,275747,275750,0,3,2
79028,4,3,275751,275751,275754,0,3,1
79029,2,1,275753,275754,275755,1,2,0
79030,2,2,275755,275755,275757,0,2,0
79031,1,2,275756,275757,275759,1,3,0
79032,5,2,275761,275761,275763,0,2,2
79033,2,1,275763,275763,275764,0,1,0
79034,5,3,275768,275768,275771,0,3,4
79035,1,1,275769,275771,275772,2,3,0
79036,5,1,275774,275774,275775,0,1,2
79037,1,3,275775,275775,275778,0,3,0
79038,6,1,275781,275781,275782,0,1,3
79039,1,2,275782,275782,275784,0,2,0
79040,6,1,275788,275788,275789,0,1,4
79041,5,1,275793,275793,275794,0,1,4
79042,6,2,275799,275799,275801,0,2,5
79043,4,1,275803,275803,275804,0,1,2
79044,5,1,275808,275808,275809,0,1,4
79045,4,2,275812,275812,275814,0,2,3
79046,6,3,275818,275818,275821,0,3,4
79047,6,1,275824,275824,275825,0,1,3
79048,2,1,275826,275826,275827,0,1,1
79049,4,1,275830,275830,275831,0,1,3
79050,6,1,275836,275836,275837,0,1,5
79051,1,1,275837,275837,275838,0,1,0
79052,1,1,275838,275838,275839,0,1,0
79053,3,2,275841,275841,275843,0,2,2
79054,6,3,275847,275847,275850,0,3,4
79055,1,3,275848,275850,275853,2,5,0
79056,4,1,275852,275853,275854,1,2,0
79057,6,3,275858,275858,275861,0,3,4
79058,1,2,275859,275861,275863,2,4,0
79059,1,2,275860,275863,275865,3,5,0
79060,6,3,275866,275866,275869,0,3,1
79061,3,2,275869,275869,275871,0,2,0
79062,1,2,275870,275871,275873,1,3,0
79063,1,1,275871,275873,275874,2,3,0
79064,6,3,275877,275877,275880,0,3,3
79065,5,2,275882,275882,275884,0,2,2
79066,3,3,275885,275885,275888,0,3,1
79067,1,3,275886,275888,275891,2,5,0
79068,3,2,275889,275891,275893,2,4,0
79069,1,2,275890,275893,275895,3,5,0
79070,4,3,275894,275895,275898,1,4,0
79071,2,2,275896,275898,275900,2,4,0
79072,3,2,275899,275900,275902,1,3,0
79073,1,1,275900,275902,275903,2,3,0
79074,4,3,275904,275904,275907,0,3,1
79075,6,3,275910,275910,275913,0,3,3
79076,5,1,275915,275915,275916,0,1,2
79077,3,2,275918,275918,275920,0,2,2
79078,6,2,275924,275924,275926,0,2,4
79079,2,3,275926,275926,275929,0,3,0
79080,5,1,275931,275931,275932,0,1,2
79081,3,2,275934,275934,275936,0,2,2
79082,1,1,275935,275936,275937,1,2,0
79083,6,2,275941,275941,275943,0,2,4
79084,4,1,275945,275945,275946,0,1,2
79085,3,1,275948,275948,275949,0,1,2
79086,6,3,275954,275954,275957,0,3,5
79087,1,3,275955,275957,275960,2,5,0
79088,1,3,275956,275960,275963,4,7,0
79089,2,2,275958,275963,275965,5,7,0
79090,3,3,275961,275965,275968,4,7,0
79091,3,1,275964,275968,275969,4,5,0
79092,3,1,275967,275969,275970,2,3,0
79093,6,2,275973,275973,275975,0,2,3
79094,6,1,275979,275979,275980,0,1,4
79095,6,2,275985,275985,275987,0,2,5
79096,3,3,275988,275988,275991,0,3,1
79097,3,3,275991,275991,275994,0,3,0
79098,5,2,275996,275996,275998,0,2,2
79099,1,1,275997,275998,275999,1,2,0
79100,2,1,275999,275999,276000,0,1,0
79101,6,3,276005,276005,276008,0,3,5
79102,3,2,276008,276008,276010,0,2,0
79103,3,3,276011,276011,276014,0,3,1
79104,3,2,276014,276014,276016,0,2,0
79105,4,3,276018,276018,276021,0,3,2
79106,6,1,276024,276024,276025,0,1,3
79107,6,3,276030,276030,276033,0,3,5
79108,6,3,276036,276036,276039,0,3,3
79109,3,2,276039,276039,276041,0,2,0
79110,2,1,276041,276041,276042,0,1,0
79111,3,2,276044,276044,276046,0,2,2
79112,6,2,276050,276050,276052,0,2,4
79113,1,1,276051,276052,276053,1,2,0
79114,5,2,276056,276056,276058,0,2,3
79115,4,3,276060,276060,276063,0,3,2
79116,4,3,276064,276064,276067,0,3,1
79117,6,1,276070,276070,276071,0,1,3
79118,1,3,276071,276071,276074,0,3,0
79119,2,2,276073,276074,276076,1,3,0
79120,4,3,276077,276077,276080,0,3,1
79121,1,2,276078,276080,276082,2,4,0
79122,3,3,276081,276082,276085,1,4,0
79123,1,1,276082,276085,276086,3,4,0
79124,4,2,276086,276086,276088,0,2,0
79125,1,2,276087,276088,276090,1,3,0
79126,4,3,276091,276091,276094,0,3,1
79127,2,2,276093,276094,276096,1,3,0
79128,4,2,276097,276097,276099,0,2,1
79129,3,3,276100,276100,276103,0,3,1
79130,1,2,276101,276103,276105,2,4,0
79131,4,2,276105,276105,276107,0,2,0
79132,4,1,276109,276109,276110,0,1,2
79133,1,1,276110,276110,276111,0,1,0
79134,4,1,276114,276114,276115,0,1,3
79135,3,2,276117,276117,276119,0,2,2
79136,6,1,276123,276123,276124,0,1,4
79137,3,2,276126,276126,276128,0,2,2
79138,4,3,276130,276130,276133,0,3,2
79139,4,1,276134,276134,276135,0,1,1
79140,1,2,276135,276135,276137,0,2,0
79141,5,3,276140,276140,276143,0,3,3
79142,2,3,276142,276143,276146,1,4,0
79143,5,1,276147,276147,276148,0,1,1
79144,2,3,276149,276149,276152,0,3,1
79145,2,3,276151,276152,276155,1,4,0
79146,2,2,276153,276155,276157,2,4,0
79147,1,3,276154,276157,276160,3,6,0
79148,5,2,276159,276160,276162,1,3,0
79149,3,2,276162,276162,276164,0,2,0
79150,1,1,276163,276164,276165,1,2,0
79151,5,1,276168,276168,276169,0,1,3
79152,1,3,276169,276169,276172,0,3,0
79153,5,3,276174,276174,276177,0,3,2
79154,5,1,276179,276179,276180,0,1,2
79155,6,2,276185,276185,276187,0,2,5
79156,2,2,276187,276187,276189,0,2,0
79157,4,3,276191,276191,276194,0,3,2
79158,3,1,276194,276194,276195,0,1,0
79159,3,2,276197,276197,276199,0,2,2
79160,6,1,276203,276203,276204,0,1,4
79161,6,1,276209,276209,276210,0,1,5
79162,3,1,276212,276212,276213,0,1,2
79163,2,3,276214,276214,276217,0,3,1
79164,5,1,276219,276219,276220,0,1,2
79165,5,3,276224,276224,276227,0,3,4
79166,1,3,276225,276227,276230,2,5,0
79167,1,3,276226,276230,276233,4,7,0
79168,6,1,276232,276233,276234,1,2,0
79169,2,1,276234,276234,276235,0,1,0
79170,1,3,276235,276235,276238,0,3,0
79171,5,1,276240,276240,276241,0,1,2
79172,1,1,276241,276241,276242,0,1,0
79173,3,1,276244,276244,276245,0,1,2
79174,4,3,276248,276248,276251,0,3,3
79175,6,3,276254,276254,276257,0,3,3
79176,6,3,276260,276260,276263,0,3,3
79177,5,3,276265,276265,276268,0,3,2
79178,2,2,276267,276268,276270,1,3,0
79179,2,3,276269,276270,276273,1,4,0
79180,5,1,276274,276274,276275,0,1,1
79181,4,3,276278,276278,276281,0,3,3
79182,2,3,276280,276281,276284,1,4,0
79183,3,2,276283,276284,276286,1,3,0
79184,2,3,276285,276286,276289,1,4,0
79185,1,3,276286,276289,276292,3,6,0
79186,4,1,276290,276292,276293,2,3,0
79187,5,3,276295,276295,276298,0,3,2
79188,1,3,276296,276298,276301,2,5,0
79189,2,2,276298,276301,276303,3,5,0
79190,3,1,276301,276303,276304,2,3,0
79191,4,2,276305,276305,276307,0,2,1
79192,3,3,276308,276308,276311,0,3,1
79193,5,2,276313,276313,276315,0,2,2
79194,3,1,276316,276316,276317,0,1,1
79195,5,1,276321,276321,276322,0,1,4
79196,6,1,276327,276327,276328,0,1,5
79197,1,1,276328,276328,276329,0,1,0
79198,1,3,276329,276329,276332,0,3,0
79199,1,1,276330,276332,276333,2,3,0
79200,2,1,276332,276333,276334,1,2,0
79201,6,1,276338,276338,276339,0,1,4
79202,2,1,276340,276340,276341,0,1,1
79203,2,1,276342,276342,276343,0,1,1
79204,5,2,276347,276347,276349,0,2,4
79205,1,2,276348,276349,276351,1,3,0
79206,4,3,276352,276352,276355,0,3,1
79207,4,2,276356,276356,276358,0,2,1
79208,3,2,276359,276359,276361,0,2,1
79209,6,3,276365,276365,276368,0,3,4
79210,6,2,276371,276371,276373,0,2,3
79211,5,1,276376,276376,276377,0,1,3
79212,3,2,276379,276379,276381,0,2,2
79213,6,1,276385,276385,276386,0,1,4
79214,6,3,276391,276391,276394,0,3,5
79215,1,3,276392,276394,276397,2,5,0
79216,1,3,276393,276397,276400,4,7,0
79217,4,1,276397,276400,276401,3,4,0
79218,5,3,276402,276402,276405,0,3,1
79219,1,2,276403,276405,276407,2,4,0
79220,6,2,276409,276409,276411,0,2,2
79221,2,3,276411,276411,276414,0,3,0
79222,6,1,276417,276417,276418,0,1,3
79223,4,3,276421,276421,276424,0,3,3
79224,2,2,276423,276424,276426,1,3,0
79225,1,2,276424,276426,276428,2,4,0
79226,1,3,276425,276428,276431,3,6,0
79227,6,1,276431,276431,276432,0,1,0
79228,5,2,276436,276436,276438,0,2,4
79229,2,1,276438,276438,276439,0,1,0
79230,4,2,276442,276442,276444,0,2,3
79231,2,3,276444,276444,276447,0,3,0
79232,6,3,276450,276450,276453,0,3,3
79233,4,2,276454,276454,276456,0,2,1
79234,4,2,276458,276458,276460,0,2,2
79235,3,1,276461,276461,276462,0,1,1
79236,3,3,276464,276464,276467,0,3,2
79237,3,1,276467,276467,276468,0,1,0
79238,3,2,276470,276470,276472,0,2,2
79239,6,1,276476,276476,276477,0,1,4
79240,4,1,276480,276480,276481,0,1,3
79241,5,1,276485,276485,276486,0,1,4
79242,5,3,276490,276490,276493,0,3,4
79243,5,1,276495,276495,276496,0,1,2
79244,1,1,276496,276496,276497,0,1,0
79245,3,2,276499,276499,276501,0,2,2
79246,2,2,276501,276501,276503,0,2,0
79247,6,3,276507,276507,276510,0,3,4
79248,4,2,276511,276511,276513,0,2,1
79249,3,3,276514,276514,276517,0,3,1
79250,3,3,276517,276517,276520,0,3,0
79251,3,3,276520,276520,276523,0,3,0
79252,6,1,276526,276526,276527,0,1,3
79253,5,2,276531,276531,276533,0,2,4
79254,2,3,276533,276533,276536,0,3,0
79255,1,1,276534,276536,276537,2,3,0
79256,3,2,276537,276537,276539,0,2,0
79257,1,2,276538,276539,276541,1,3,0
79258,4,3,276542,276542,276545,0,3,1
79259,3,3,276545,276545,276548,0,3,0
79260,1,3,276546,276548,276551,2,5,0
79261,3,2,276549,276551,276553,2,4,0
79262,1,2,276550,276553,276555,3,5,0
79263,1,2,276551,276555,276557,4,6,0
79264,3,1,276554,276557,276558,3,4,0
79265,6,2,276560,276560,276562,0,2,2
79266,3,2,276563,276563,276565,0,2,1
79267,3,3,276566,276566,276569,0,3,1
79268,5,1,276571,276571,276572,0,1,2
79269,3,2,276574,276574,276576,0,2,2
79270,4,2,276578,276578,276580,0,2,2
79271,1,1,276579,276580,276581,1,2,0
79272,6,3,276585,276585,276588,0,3,4
79273,4,2,276589,276589,276591,0,2,1
79274,6,1,276595,276595,276596,0,1,4
79275,3,1,276598,276598,276599,0,1,2
79276,4,1,276602,276602,276603,0,1,3
79277,5,2,276607,276607,276609,0,2,4
79278,3,2,276610,276610,276612,0,2,1
79279,5,3,276615,276615,276618,0,3,3
79280,2,2,276617,276618,276620,1,3,0
79281,6,1,276623,276623,276624,0,1,3
79282,2,3,276625,276625,276628,0,3,1
79283,1,2,276626,276628,276630,2,4,0
79284,4,2,276630,276630,276632,0,2,0
79285,2,2,276632,276632,276634,0,2,0
79286,4,1,276636,276636,276637,0,1,2
79287,3,2,276639,276639,276641,0,2,2
79288,2,2,276641,276641,276643,0,2,0
79289,2,1,276643,276643,276644,0,1,0
79290,2,3,276645,276645,276648,0,3,1
79291,2,1,276647,276648,276649,1,2,0
79292,1,1,276648,276649,276650,1,2,0
79293,5,3,276653,276653,276656,0,3,3
79294,1,3,276654,276656,276659,2,5,0
79295,3,3,276657,276659,276662,2,5,0
79296,1,3,276658,276662,276665,4,7,0
79297,3,2,276661,276665,276667,4,6,0
79298,1,2,276662,276667,276669,5,7,0
79299,3,1,276665,276669,276670,4,5,0
79300,4,3,276669,276670,276673,1,4,0
79301,1,3,276670,276673,276676,3,6,0
79302,2,1,276672,276676,276677,4,5,0
79303,6,2,276678,276678,276680,0,2,1
79304,6,3,276684,276684,276687,0,3,4
79305,5,3,276689,276689,276692,0,3,2
79306,3,2,276692,276692,276694,0,2,0
79307,2,2,276694,276694,276696,0,2,0
79308,6,1,276700,276700,276701,0,1,4
79309,5,3,276705,276705,276708,0,3,4
79310,3,2,276708,276708,276710,0,2,0
79311,5,1,276713,276713,276714,0,1,3
79312,6,3,276719,276719,276722,0,3,5
79313,2,2,276721,276722,276724,1,3,0
79314,3,1,276724,276724,276725,0,1,0
79315,5,3,276729,276729,276732,0,3,4
79316,2,2,276731,276732,276734,1,3,0
79317,6,3,276737,276737,276740,0,3,3
79318,1,3,276738,276740,276743,2,5,0
79319,6,1,276744,276744,276745,0,1,1
79320,2,2,276746,276746,276748,0,2,1
79321,3,1,276749,276749,276750,0,1,1
79322,3,1,276752,276752,276753,0,1,2
79323,3,3,276755,276755,276758,0,3,2
79324,6,3,276761,276761,276764,0,3,3
79325,6,1,276767,276767,276768,0,1,3
79326,3,1,276770,276770,276771,0,1,2
79327,2,1,276772,276772,276773,0,1,1
79328,2,3,276774,276774,276777,0,3,1
79329,4,3,276778,276778,276781,0,3,1
79330,6,3,276784,276784,276787,0,3,3
79331,2,1,276786,276787,276788,1,2,0
79332,1,2,276787,276788,276790,1,3,0
79333,2,3,276789,276790,276793,1,4,0
79334,1,3,276790,276793,276796,3,6,0
79335,1,2,276791,276796,276798,5,7,0
79336,5,1,276796,276798,276799,2,3,0
79337,5,3,276801,276801,276804,0,3,2
79338,2,3,276803,276804,276807,1,4,0
79339,5,3,276808,276808,276811,0,3,1
79340,1,3,276809,276811,276814,2,5,0
79341,3,1,276812,276814,276815,2,3,0
79342,6,3,276818,276818,276821,0,3,3
79343,1,2,276819,276821,276823,2,4,0
79344,1,3,276820,276823,276826,3,6,0
79345,5,2,276825,276826,276828,1,3,0
79346,1,2,276826,276828,276830,2,4,0
79347,5,3,276831,276831,276834,0,3,1
79348,1,2,276832,276834,276836,2,4,0
79349,5,1,276837,276837,276838,0,1,1
79350,2,3,276839,276839,276842,0,3,1
79351,5,3,276844,276844,276847,0,3,2
79352,3,3,276847,276847,276850,0,3,0
79353,4,1,276851,276851,276852,0,1,1
79354,1,2,276852,276852,276854,0,2,0
79355,6,1,276858,276858,276859,0,1,4
79356,5,2,276863,276863,276865,0,2,4
79357,5,3,276868,276868,276871,0,3,3
79358,6,3,276874,276874,276877,0,3,3
79359,2,1,276876,276877,276878,1,2,0
79360,1,2,276877,276878,276880,1,3,0
79361,6,1,276883,276883,276884,0,1,3
79362,6,3,276889,276889,276892,0,3,5
79363,4,2,276893,276893,276895,0,2,1
79364,2,2,276895,276895,276897,0,2,0
79365,1,3,276896,276897,276900,1,4,0
79366,4,1,276900,276900,276901,0,1,0
79367,5,3,276905,276905,276908,0,3,4
79368,6,3,276911,276911,276914,0,3,3
79369,5,3,276916,276916,276919,0,3,2
79370,2,2,276918,276919,276921,1,3,0
79371,6,3,276924,276924,276927,0,3,3
79372,2,3,276926,276927,276930,1,4,0
79373,4,1,276930,276930,276931,0,1,0
79374,2,2,276932,276932,276934,0,2,1
79375,2,2,276934,276934,276936,0,2,0
79376,4,2,276938,276938,276940,0,2,2
79377,2,3,276940,276940,276943,0,3,0
79378,1,1,276941,276943,276944,2,3,0
79379,3,2,276944,276944,276946,0,2,0
79380,6,2,276950,276950,276952,0,2,4
79381,2,3,276952,276952,276955,0,3,0
79382,3,1,276955,276955,276956,0,1,0
79383,2,2,276957,276957,276959,0,2,1
79384,1,1,276958,276959,276960,1,2,0
79385,5,3,276963,276963,276966,0,3,3
79386,6,1,276969,276969,276970,0,1,3
79387,2,3,276971,276971,276974,0,3,1
79388,4,1,276975,276975,276976,0,1,1
79389,6,2,276981,276981,276983,0,2,5
79390,2,3,276983,276983,276986,0,3,0
79391,1,2,276984,276986,276988,2,4,0
79392,5,3,276989,276989,276992,0,3,1
79393,2,1,276991,276992,276993,1,2,0
79394,5,3,276996,276996,276999,0,3,3
79395,3,1,276999,276999,277000,0,1,0
79396,6,3,277005,277005,277008,0,3,5
79397,3,2,277008,277008,277010,0,2,0
79398,5,2,277013,277013,277015,0,2,3
79399,5,1,277018,277018,277019,0,1,3
79400,4,3,277022,277022,277025,0,3,3
79401,2,2,277024,277025,277027,1,3,0
79402,1,3,277025,277027,277030,2,5,0
79403,5,3,277030,277030,277033,0,3,0
79404,5,3,277035,277035,277038,0,3,2
79405,1,1,277036,277038,277039,2,3,0
79406,1,3,277037,277039,277042,2,5,0
79407,3,2,277040,277042,277044,2,4,0
79408,6,2,277046,277046,277048,0,2,2
79409,4,2,277050,277050,277052,0,2,2
79410,6,1,277056,277056,277057,0,1,4
79411,1,3,277057,277057,277060,0,3,0
79412,6,2,277063,277063,277065,0,2,3
79413,2,1,277065,277065,277066,0,1,0
79414,2,2,277067,277067,277069,0,2,1
79415,2,3,277069,277069,277072,0,3,0
79416,5,3,277074,277074,277077,0,3,2
79417,2,3,277076,277077,277080,1,4,0
79418,5,3,277081,277081,277084,0,3,1
79419,5,1,277086,277086,277087,0,1,2
79420,1,2,277087,277087,277089,0,2,0
79421,5,1,277092,277092,277093,0,1,3
79422,4,3,277096,277096,277099,0,3,3
79423,1,2,277097,277099,277101,2,4,0
79424,4,1,277101,277101,277102,0,1,0
79425,4,2,277105,277105,277107,0,2,3
79426,1,2,277106,277107,277109,1,3,0
79427,6,3,277112,277112,277115,0,3,3
79428,1,2,277113,277115,277117,2,4,0
79429,5,2,277118,277118,277120,0,2,1
79430,3,1,277121,277121,277122,0,1,1
79431,4,1,277125,277125,277126,0,1,3
79432,1,1,277126,277126,277127,0,1,0
79433,2,1,277128,277128,277129,0,1,1
79434,1,1,277129,277129,277130,0,1,0
79435,3,2,277132,277132,277134,0,2,2
79436,1,2,277133,277134,277136,1,3,0
79437,6,2,277139,277139,277141,0,2,3
79438,4,2,277143,277143,277145,0,2,2
79439,2,1,277145,277145,277146,0,1,0
79440,6,3,277151,277151,277154,0,3,5
79441,3,2,277154,277154,277156,0,2,0
79442,2,1,277156,277156,277157,0,1,0
79443,2,1,277158,277158,277159,0,1,1
79444,3,3,277161,277161,277164,0,3,2
79445,4,1,277165,277165,277166,0,1,1
79446,4,3,277169,277169,277172,0,3,3
79447,2,3,277171,277172,277175,1,4,0
79448,4,2,277175,277175,277177,0,2,0
79449,6,1,277181,277181,277182,0,1,4
79450,2,3,277183,277183,277186,0,3,1
79451,6,2,277189,277189,277191,0,2,3
79452,1,3,277190,277191,277194,1,4,0
79453,2,3,277192,277194,277197,2,5,0
79454,6,2,277198,277198,277200,0,2,1
79455,4,1,277202,277202,277203,0,1,2
79456,6,1,277208,277208,277209,0,1,5
79457,4,3,277212,277212,277215,0,3,3
79458,4,3,277216,277216,277219,0,3,1
79459,2,3,277218,277219,277222,1,4,0
79460,5,1,277223,277223,277224,0,1,1
79461,2,1,277225,277225,277226,0,1,1
79462,3,3,277228,277228,277231,0,3,2
79463,3,2,277231,277231,277233,0,2,0
79464,5,2,277236,277236,277238,0,2,3
79465,1,3,277237,277238,277241,1,4,0
79466,5,3,277242,277242,277245,0,3,1
79467,5,2,277247,277247,277249,0,2,2
79468,5,2,277252,277252,277254,0,2,3
79469,5,1,277257,277257,277258,0,1,3
79470,6,3,277263,277263,277266,0,3,5
79471,6,1,277269,277269,277270,0,1,3
79472,3,3,277272,277272,277275,0,3,2
79473,1,1,277273,277275,277276,2,3,0
79474,4,2,277277,277277,277279,0,2,1
79475,1,3,277278,277279,277282,1,4,0
79476,3,2,277281,277282,277284,1,3,0
79477,6,1,277287,277287,277288,0,1,3
79478,5,2,277292,277292,277294,0,2,4
79479,2,1,277294,277294,277295,0,1,0
79480,5,2,277299,277299,277301,0,2,4
79481,3,1,277302,277302,277303,0,1,1
79482,6,1,277308,277308,277309,0,1,5
79483,2,1,277310,277310,277311,0,1,1
79484,4,3,277314,277314,277317,0,3,3
79485,6,3,277320,277320,277323,0,3,3
79486,5,1,277325,277325,277326,0,1,2
79487,6,1,277331,277331,277332,0,1,5
79488,3,3,277334,277334,277337,0,3,2
79489,2,1,277336,277337,277338,1,2,0
79490,6,2,277342,277342,277344,0,2,4
79491,5,2,277347,277347,277349,0,2,3
79492,6,1,277353,277353,277354,0,1,4
79493,3,1,277356,277356,277357,0,1,2
79494,5,3,277361,277361,277364,0,3,4
79495,3,3,277364,277364,277367,0,3,0
79496,4,3,277368,277368,277371,0,3,1
79497,4,1,277372,277372,277373,0,1,1
79498,3,3,277375,277375,277378,0,3,2
79499,2,1,277377,277378,277379,1,2,0
79500,4,2,277381,277381,277383,0,2,2
79501,5,3,277386,277386,277389,0,3,3
79502,1,3,277387,277389,277392,2,5,0
79503,2,2,277389,277392,277394,3,5,0
79504,4,3,277393,277394,277397,1,4,0
79505,4,3,277397,277397,277400,0,3,0
79506,4,2,277401,277401,277403,0,2,1
79507,6,3,277407,277407,277410,0,3,4
79508,4,3,277411,277411,277414,0,3,1
79509,3,1,277414,277414,277415,0,1,0
79510,4,2,277418,277418,277420,0,2,3
79511,2,1,277420,277420,277421,0,1,0
79512,1,1,277421,277421,277422,0,1,0
79513,1,1,277422,277422,277423,0,1,0
79514,2,2,277424,277424,277426,0,2,1
79515,1,3,277425,277426,277429,1,4,0
79516,6,1,277431,277431,277432,0,1,2
79517,4,3,277435,277435,277438,0,3,3
79518,3,3,277438,277438,277441,0,3,0
79519,1,2,277439,277441,277443,2,4,0
79520,5,3,277444,277444,277447,0,3,1
79521,4,3,277448,277448,277451,0,3,1
79522,1,2,277449,277451,277453,2,4,0
79523,6,2,277455,277455,277457,0,2,2
79524,1,2,277456,277457,277459,1,3,0
79525,3,2,277459,277459,277461,0,2,0
79526,2,2,277461,277461,277463,0,2,0
79527,2,3,277463,277463,277466,0,3,0
79528,5,3,277468,277468,277471,0,3,2
79529,2,3,277470,277471,277474,1,4,0
79530,4,2,277474,277474,277476,0,2,0
79531,1,1,277475,277476,277477,1,2,0
79532,2,2,277477,277477,277479,0,2,0
79533,5,2,277482,277482,277484,0,2,3
79534,1,3,277483,277484,277487,1,4,0
79535,1,1,277484,277487,277488,3,4,0
79536,3,1,277487,277488,277489,1,2,0
79537,2,1,277489,277489,277490,0,1,0
79538,2,3,277491,277491,277494,0,3,1
79539,6,1,277497,277497,277498,0,1,3
79540,2,3,277499,277499,277502,0,3,1
79541,1,2,277500,277502,277504,2,4,0
79542,3,1,277503,277504,277505,1,2,0
79543,3,1,277506,277506,277507,0,1,1
79544,3,3,277509,277509,277512,0,3,2
79545,6,3,277515,277515,277518,0,3,3
79546,1,2,277516,277518,277520,2,4,0
79547,5,2,277521,277521,277523,0,2,1
79548,2,3,277523,277523,277526,0,3,0
79549,2,2,277525,277526,277528,1,3,0
79550,2,3,277527,277528,277531,1,4,0
79551,5,2,277532,277532,277534,0,2,1
79552,5,1,277537,277537,277538,0,1,3
79553,1,2,277538,277538,277540,0,2,0
79554,5,1,277543,277543,277544,0,1,3
79555,4,2,277547,277547,277549,0,2,3
79556,1,3,277548,277549,277552,1,4,0
79557,2,3,277550,277552,277555,2,5,0
79558,6,1,277556,277556,277557,0,1,1
79559,1,2,277557,277557,277559,0,2,0
79560,1,1,277558,277559,277560,1,2,0
79561,5,1,277563,277563,277564,0,1,3
79562,2,3,277565,277565,277568,0,3,1
79563,4,1,277569,277569,277570,0,1,1
79564,5,2,277574,277574,277576,0,2,4
79565,5,2,277579,277579,277581,0,2,3
79566,2,2,277581,277581,277583,0,2,0
79567,2,1,277583,277583,277584,0,1,0
79568,2,2,277585,277585,277587,0,2,1
79569,1,1,277586,277587,277588,1,2,0
79570,1,1,277587,277588,277589,1,2,0
79571,6,1,277593,277593,277594,0,1,4
79572,5,1,277598,277598,277599,0,1,4
79573,5,2,277603,277603,277605,0,2,4
79574,4,1,277607,277607,277608,0,1,2
79575,2,2,277609,277609,277611,0,2,1
79576,4,2,277613,277613,277615,0,2,2
79577,5,2,277618,277618,277620,0,2,3
79578,3,2,277621,277621,277623,0,2,1
79579,3,3,277624,277624,277627,0,3,1
79580,2,3,277626,277627,277630,1,4,0
79581,6,3,277632,277632,277635,0,3,2
79582,3,3,277635,277635,277638,0,3,0
79583,6,2,277641,277641,277643,0,2,3
79584,6,2,277647,277647,277649,0,2,4
79585,4,2,277651,277651,277653,0,2,2
79586,6,2,277657,277657,277659,0,2,4
79587,5,2,277662,277662,277664,0,2,3
79588,2,1,277664,277664,277665,0,1,0
79589,2,2,277666,277666,277668,0,2,1
79590,1,1,277667,277668,277669,1,2,0
79591,6,2,277673,277673,277675,0,2,4
79592,2,2,277675,277675,277677,0,2,0
79593,3,3,277678,277678,277681,0,3,1
79594,1,3,277679,277681,277684,2,5,0
79595,2,1,277681,277684,277685,3,4,0
79596,1,2,277682,277685,277687,3,5,0
79597,4,1,277686,277687,277688,1,2,0
79598,5,2,277691,277691,277693,0,2,3
79599,6,3,277697,277697,277700,0,3,4
79600,3,3,277700,277700,277703,0,3,0
79601,3,2,277703,277703,277705,0,2,0
79602,3,1,277706,277706,277707,0,1,1
79603,3,1,277709,277709,277710,0,1,2
79604,4,3,277713,277713,277716,0,3,3
79605,5,3,277718,277718,277721,0,3,2
79606,4,1,277722,277722,277723,0,1,1
79607,4,3,277726,277726,277729,0,3,3
79608,3,1,277729,277729,277730,0,1,0
79609,3,1,277732,277732,277733,0,1,2
79610,6,3,277738,277738,277741,0,3,5
79611,2,2,277740,277741,277743,1,3,0
79612,1,2,277741,277743,277745,2,4,0
79613,2,1,277743,277745,277746,2,3,0
79614,3,3,277746,277746,277749,0,3,0
79615,2,3,277748,277749,277752,1,4,0
79616,6,1,277754,277754,277755,0,1,2
79617,1,1,277755,277755,277756,0,1,0
79618,2,1,277757,277757,277758,0,1,1
79619,6,3,277763,277763,277766,0,3,5
79620,6,2,277769,277769,277771,0,2,3
79621,6,2,277775,277775,277777,0,2,4
79622,5,3,277780,277780,277783,0,3,3
79623,3,1,277783,277783,277784,0,1,0
79624,5,3,277788,277788,277791,0,3,4
79625,3,1,277791,277791,277792,0,1,0
79626,2,3,277793,277793,277796,0,3,1
79627,1,2,277794,277796,277798,2,4,0
79628,2,3,277796,277798,277801,2,5,0
79629,6,3,277802,277802,277805,0,3,1
79630,3,1,277805,277805,277806,0,1,0
79631,4,1,277809,277809,277810,0,1,3
79632,4,1,277813,277813,277814,0,1,3
79633,4,1,277817,277817,277818,0,1,3
79634,4,3,277821,277821,277824,0,3,3
79635,3,1,277824,277824,277825,0,1,0
79636,1,3,277825,277825,277828,0,3,0
79637,1,2,277826,277828,277830,2,4,0
79638,2,3,277828,277830,277833,2,5,0
79639,6,3,277834,277834,277837,0,3,1
79640,6,3,277840,277840,277843,0,3,3
79641,2,1,277842,277843,277844,1,2,0
79642,4,3,277846,277846,277849,0,3,2
79643,6,3,277852,277852,277855,0,3,3
79644,3,1,277855,277855,277856,0,1,0
79645,1,1,277856,277856,277857,0,1,0
79646,5,1,277861,277861,277862,0,1,4
79647,4,3,277865,277865,277868,0,3,3
79648,6,3,277871,277871,277874,0,3,3
79649,1,2,277872,277874,277876,2,4,0
79650,1,2,277873,277876,277878,3,5,0
79651,6,1,277879,277879,277880,0,1,1
79652,2,2,277881,277881,277883,0,2,1
79653,6,3,277887,277887,277890,0,3,4
79654,2,3,277889,277890,277893,1,4,0
79655,3,2,277892,277893,277895,1,3,0
79656,5,3,277897,277897,277900,0,3,2
79657,5,1,277902,277902,277903,0,1,2
79658,5,2,277907,277907,277909,0,2,4
79659,5,2,277912,277912,277914,0,2,3
79660,2,2,277914,277914,277916,0,2,0
79661,4,3,277918,277918,277921,0,3,2
79662,2,1,277920,277921,277922,1,2,0
79663,5,1,277925,277925,277926,0,1,3
79664,3,2,277928,277928,277930,0,2,2
79665,2,1,277930,277930,277931,0,1,0
79666,4,1,277934,277934,277935,0,1,3
79667,1,1,277935,277935,277936,0,1,0
79668,3,1,277938,277938,277939,0,1,2
79669,5,3,277943,277943,277946,0,3,4
79670,4,2,277947,277947,277949,0,2,1
79671,3,1,277950,277950,277951,0,1,1
79672,1,1,277951,277951,277952,0,1,0
79673,1,3,277952,277952,277955,0,3,0
79674,6,2,277958,277958,277960,0,2,3
79675,2,2,277960,277960,277962,0,2,0
79676,6,3,277966,277966,277969,0,3,4
79677,4,3,277970,277970,277973,0,3,1
79678,3,3,277973,277973,277976,0,3,0
79679,5,2,277978,277978,277980,0,2,2
79680,6,3,277984,277984,277987,0,3,4
79681,3,3,277987,277987,277990,0,3,0
79682,6,1,277993,277993,277994,0,1,3
79683,6,3,277999,277999,278002,0,3,5
79684,4,1,278003,278003,278004,0,1,1
79685,6,2,278009,278009,278011,0,2,5
79686,4,1,278013,278013,278014,0,1,2
79687,1,2,278014,278014,278016,0,2,0
79688,5,1,278019,278019,278020,0,1,3
79689,4,1,278023,278023,278024,0,1,3
79690,3,3,278026,278026,278029,0,3,2
79691,5,3,278031,278031,278034,0,3,2
79692,6,2,278037,278037,278039,0,2,3
79693,2,1,278039,278039,278040,0,1,0
79694,3,1,278042,278042,278043,0,1,2
79695,4,1,278046,278046,278047,0,1,3
79696,5,1,278051,278051,278052,0,1,4
79697,5,1,278056,278056,278057,0,1,4
79698,5,1,278061,278061,278062,0,1,4
79699,4,1,278065,278065,278066,0,1,3
79700,6,1,278071,278071,278072,0,1,5
79701,6,2,278077,278077,278079,0,2,5
79702,1,3,278078,278079,278082,1,4,0
79703,4,1,278082,278082,278083,0,1,0
79704,3,1,278085,278085,278086,0,1,2
79705,3,2,278088,278088,278090,0,2,2
79706,1,2,278089,278090,278092,1,3,0
79707,4,3,278093,278093,278096,0,3,1
79708,1,1,278094,278096,278097,2,3,0
79709,4,2,278098,278098,278100,0,2,1
79710,6,2,278104,278104,278106,0,2,4
79711,1,2,278105,278106,278108,1,3,0
79712,3,1,278108,278108,278109,0,1,0
79713,1,1,278109,278109,278110,0,1,0
79714,6,3,278115,278115,278118,0,3,5
79715,1,2,278116,278118,278120,2,4,0
79716,3,3,278119,278120,278123,1,4,0
79717,6,1,278125,278125,278126,0,1,2
79718,6,3,278131,278131,278134,0,3,5
79719,5,2,278136,278136,278138,0,2,2
79720,3,1,278139,278139,278140,0,1,1
79721,1,2,278140,278140,278142,0,2,0
79722,5,1,278145,278145,278146,0,1,3
79723,1,2,278146,278146,278148,0,2,0
79724,4,1,278150,278150,278151,0,1,2
79725,2,1,278152,278152,278153,0,1,1
79726,6,1,278158,278158,278159,0,1,5
79727,1,1,278159,278159,278160,0,1,0
79728,2,2,278161,278161,278163,0,2,1
79729,3,1,278164,278164,278165,0,1,1
79730,5,1,278169,278169,278170,0,1,4
79731,5,1,278174,278174,278175,0,1,4
79732,5,1,278179,278179,278180,0,1,4
79733,1,2,278180,278180,278182,0,2,0
79734,4,2,278184,278184,278186,0,2,2
79735,2,3,278186,278186,278189,0,3,0
79736,3,1,278189,278189,278190,0,1,0
79737,6,3,278195,278195,278198,0,3,5
79738,6,3,278201,278201,278204,0,3,3
79739,3,2,278204,278204,278206,0,2,0
79740,2,2,278206,278206,278208,0,2,0
79741,4,3,278210,278210,278213,0,3,2
79742,1,1,278211,278213,278214,2,3,0
79743,1,1,278212,278214,278215,2,3,0
79744,1,1,278213,278215,278216,2,3,0
79745,2,1,278215,278216,278217,1,2,0
79746,6,3,278221,278221,278224,0,3,4
79747,5,3,278226,278226,278229,0,3,2
79748,2,2,278228,278229,278231,1,3,0
79749,3,2,278231,278231,278233,0,2,0
79750,3,3,278234,278234,278237,0,3,1
79751,5,3,278239,278239,278242,0,3,2
79752,3,3,278242,278242,278245,0,3,0
79753,3,1,278245,278245,278246,0,1,0
79754,6,3,278251,278251,278254,0,3,5
79755,4,2,278255,278255,278257,0,2,1
79756,4,1,278259,278259,278260,0,1,2
79757,5,3,278264,278264,278267,0,3,4
79758,6,2,278270,278270,278272,0,2,3
79759,3,3,278273,278273,278276,0,3,1
79760,3,2,278276,278276,278278,0,2,0
79761,4,1,278280,278280,278281,0,1,2
79762,5,3,278285,278285,278288,0,3,4
79763,5,3,278290,278290,278293,0,3,2
79764,6,3,278296,278296,278299,0,3,3
79765,6,1,278302,278302,278303,0,1,3
79766,1,2,278303,278303,278305,0,2,0
79767,3,1,278306,278306,278307,0,1,1
79768,1,3,278307,278307,278310,0,3,0
79769,4,1,278311,278311,278312,0,1,1
79770,6,1,278317,278317,278318,0,1,5
79771,2,1,278319,278319,278320,0,1,1
79772,2,3,278321,278321,278324,0,3,1
79773,4,3,278325,278325,278328,0,3,1
79774,5,3,278330,278330,278333,0,3,2
79775,1,1,278331,278333,278334,2,3,0
79776,4,3,278335,278335,278338,0,3,1
79777,2,2,278337,278338,278340,1,3,0
79778,3,1,278340,278340,278341,0,1,0
79779,5,1,278345,278345,278346,0,1,4
79780,3,2,278348,278348,278350,0,2,2
79781,2,3,278350,278350,278353,0,3,0
79782,6,3,278356,278356,278359,0,3,3
79783,3,3,278359,278359,278362,0,3,0
79784,3,3,278362,278362,278365,0,3,0
79785,4,3,278366,278366,278369,0,3,1
79786,5,2,278371,278371,278373,0,2,2
79787,3,3,278374,278374,278377,0,3,1
79788,4,1,278378,278378,278379,0,1,1
79789,6,3,278384,278384,278387,0,3,5
79790,2,1,278386,278387,278388,1,2,0
79791,3,3,278389,278389,278392,0,3,1
79792,4,3,278393,278393,278396,0,3,1
79793,1,2,278394,278396,278398,2,4,0
79794,2,1,278396,278398,278399,2,3,0
79795,3,1,278399,278399,278400,0,1,0
79796,6,1,278405,278405,278406,0,1,5
79797,1,1,278406,278406,278407,0,1,0
79798,2,3,278408,278408,278411,0,3,1
79799,2,1,278410,278411,278412,1,2,0
79800,3,1,278413,278413,278414,0,1,1
79801,6,1,278419,278419,278420,0,1,5
79802,2,2,278421,278421,278423,0,2,1
79803,1,2,278422,278423,278425,1,3,0
79804,3,1,278425,278425,278426,0,1,0
79805,5,1,278430,278430,278431,0,1,4
79806,4,1,278434,278434,278435,0,1,3
79807,4,2,278438,278438,278440,0,2,3
79808,2,1,278440,278440,278441,0,1,0
79809,2,3,278442,278442,278445,0,3,1
79810,4,2,278446,278446,278448,0,2,1
79811,2,2,278448,278448,278450,0,2,0
79812,1,1,278449,278450,278451,1,2,0
79813,3,1,278452,278452,278453,0,1,1
79814,6,1,278458,278458,278459,0,1,5
79815,4,1,278462,278462,278463,0,1,3
79816,3,2,278465,278465,278467,0,2,2
79817,2,3,278467,278467,278470,0,3,0
79818,2,3,278469,278470,278473,1,4,0
79819,4,3,278473,278473,278476,0,3,0
79820,1,2,278474,278476,278478,2,4,0
79821,2,1,278476,278478,278479,2,3,0
79822,4,1,278480,278480,278481,0,1,1
79823,1,3,278481,278481,278484,0,3,0
79824,5,1,278486,278486,278487,0,1,2
79825,4,1,278490,278490,278491,0,1,3
79826,2,2,278492,278492,278494,0,2,1
79827,3,3,278495,278495,278498,0,3,1
79828,5,3,278500,278500,278503,0,3,2
79829,6,1,278506,278506,278507,0,1,3
79830,4,2,278510,278510,278512,0,2,3
79831,5,3,278515,278515,278518,0,3,3
79832,2,2,278517,278518,278520,1,3,0
79833,1,1,278518,278520,278521,2,3,0
79834,6,3,278524,278524,278527,0,3,3
79835,5,1,278529,278529,278530,0,1,2
79836,3,1,278532,278532,278533,0,1,2
79837,4,2,278536,278536,278538,0,2,3
79838,2,1,278538,278538,278539,0,1,0
79839,4,1,278542,278542,278543,0,1,3
79840,6,1,278548,278548,278549,0,1,5
79841,4,2,278552,278552,278554,0,2,3
79842,5,2,278557,278557,278559,0,2,3
79843,5,3,278562,278562,278565,0,3,3
79844,2,2,278564,278565,278567,1,3,0
79845,5,3,278569,278569,278572,0,3,2
79846,6,1,278575,278575,278576,0,1,3
79847,6,2,278581,278581,278583,0,2,5
79848,1,3,278582,278583,278586,1,4,0
79849,1,2,278583,278586,278588,3,5,0
79850,5,3,278588,278588,278591,0,3,0
79851,4,1,278592,278592,278593,0,1,1
79852,4,2,278596,278596,278598,0,2,3
79853,5,3,278601,278601,278604,0,3,3
79854,1,3,278602,278604,278607,2,5,0
79855,1,1,278603,278607,278608,4,5,0
79856,4,2,278607,278608,278610,1,3,0
79857,2,1,278609,278610,278611,1,2,0
79858,5,2,278614,278614,278616,0,2,3
79859,4,1,278618,278618,278619,0,1,2
79860,3,3,278621,278621,278624,0,3,2
79861,5,2,278626,278626,278628,0,2,2
79862,2,2,278628,278628,278630,0,2,0
79863,6,1,278634,278634,278635,0,1,4
79864,3,2,278637,278637,278639,0,2,2
79865,4,2,278641,278641,278643,0,2,2
79866,2,3,278643,278643,278646,0,3,0
79867,3,1,278646,278646,278647,0,1,0
79868,3,2,278649,278649,278651,0,2,2
79869,3,3,278652,278652,278655,0,3,1
79870,3,3,278655,278655,278658,0,3,0
79871,6,3,278661,278661,278664,0,3,3
79872,5,3,278666,278666,278669,0,3,2
79873,5,3,278671,278671,278674,0,3,2
79874,2,2,278673,278674,278676,1,3,0
79875,3,3,278676,278676,278679,0,3,0
79876,2,3,278678,278679,278682,1,4,0
79877,1,1,278679,278682,278683,3,4,0
79878,6,1,278685,278685,278686,0,1,2
79879,2,3,278687,278687,278690,0,3,1
79880,6,2,278693,278693,278695,0,2,3
79881,4,1,278697,278697,278698,0,1,2
79882,3,2,278700,278700,278702,0,2,2
79883,2,2,278702,278702,278704,0,2,0
79884,2,2,278704,278704,278706,0,2,0
79885,6,1,278710,278710,278711,0,1,4
79886,6,1,278716,278716,278717,0,1,5
79887,1,1,278717,278717,278718,0,1,0
79888,2,1,278719,278719,278720,0,1,1
79889,2,1,278721,278721,278722,0,1,1
79890,4,2,278725,278725,278727,0,2,3
79891,4,1,278729,278729,278730,0,1,2
79892,3,1,278732,278732,278733,0,1,2
79893,6,2,278738,278738,278740,0,2,5
79894,2,2,278740,278740,278742,0,2,0
79895,6,3,278746,278746,278749,0,3,4
79896,3,3,278749,278749,278752,0,3,0
79897,3,1,278752,278752,278753,0,1,0
79898,3,2,278755,278755,278757,0,2,2
79899,3,1,278758,278758,278759,0,1,1
79900,6,2,278764,278764,278766,0,2,5
79901,6,2,278770,278770,278772,0,2,4
79902,2,3,278772,278772,278775,0,3,0
79903,1,1,278773,278775,278776,2,3,0
79904,3,1,278776,278776,278777,0,1,0
79905,1,3,278777,278777,278780,0,3,0
79906,1,1,278778,278780,278781,2,3,0
79907,2,2,278780,278781,278783,1,3,0
79908,1,3,278781,278783,278786,2,5,0
79909,1,1,278782,278786,278787,4,5,0
79910,1,3,278783,278787,278790,4,7,0
79911,4,3,278787,278790,278793,3,6,0
79912,2,3,278789,278793,278796,4,7,0
79913,3,3,278792,278796,278799,4,7,0
79914,5,1,278797,278799,278800,2,3,0
79915,6,1,278803,278803,278804,0,1,3
79916,1,3,278804,278804,278807,0,3,0
79917,2,2,278806,278807,278809,1,3,0
79918,2,2,278808,278809,278811,1,3,0
79919,4,1,278812,278812,278813,0,1,1
79920,5,2,278817,278817,278819,0,2,4
79921,6,3,278823,278823,278826,0,3,4
79922,4,2,278827,278827,278829,0,2,1
79923,1,1,278828,278829,278830,1,2,0
79924,1,1,278829,278830,278831,1,2,0
79925,1,3,278830,278831,278834,1,4,0
79926,4,1,278834,278834,278835,0,1,0
79927,4,3,278838,278838,278841,0,3,3
79928,3,3,278841,278841,278844,0,3,0
79929,1,2,278842,278844,278846,2,4,0
79930,2,3,278844,278846,278849,2,5,0
79931,4,1,278848,278849,278850,1,2,0
79932,1,1,278849,278850,278851,1,2,0
79933,1,1,278850,278851,278852,1,2,0
79934,3,2,278853,278853,278855,0,2,1
79935,5,2,278858,278858,278860,0,2,3
79936,5,2,278863,278863,278865,0,2,3
79937,6,3,278869,278869,278872,0,3,4
79938,6,1,278875,278875,278876,0,1,3
79939,5,3,278880,278880,278883,0,3,4
79940,1,1,278881,278883,278884,2,3,0
79941,2,2,278883,278884,278886,1,3,0
79942,3,2,278886,278886,278888,0,2,0
79943,4,2,278890,278890,278892,0,2,2
79944,1,2,278891,278892,278894,1,3,0
79945,3,1,278894,278894,278895,0,1,0
79946,6,3,278900,278900,278903,0,3,5
79947,3,3,278903,278903,278906,0,3,0
79948,6,1,278909,278909,278910,0,1,3
79949,2,3,278911,278911,278914,0,3,1
79950,6,3,278917,278917,278920,0,3,3
79951,2,1,278919,278920,278921,1,2,0
79952,6,1,278925,278925,278926,0,1,4
79953,4,3,278929,278929,278932,0,3,3
79954,2,1,278931,278932,278933,1,2,0
79955,6,2,278937,278937,278939,0,2,4
79956,1,2,278938,278939,278941,1,3,0
79957,6,3,278944,278944,278947,0,3,3
79958,2,2,278946,278947,278949,1,3,0
79959,1,2,278947,278949,278951,2,4,0
79960,6,1,278953,278953,278954,0,1,2
79961,1,2,278954,278954,278956,0,2,0
79962,3,2,278957,278957,278959,0,2,1
79963,3,3,278960,278960,278963,0,3,1
79964,4,3,278964,278964,278967,0,3,1
79965,6,1,278970,278970,278971,0,1,3
79966,5,3,278975,278975,278978,0,3,4
79967,6,1,278981,278981,278982,0,1,3
79968,4,2,278985,278985,278987,0,2,3
79969,5,3,278990,278990,278993,0,3,3
79970,2,1,278992,278993,278994,1,2,0
79971,4,1,278996,278996,278997,0,1,2
79972,6,1,279002,279002,279003,0,1,5
79973,2,3,279004,279004,279007,0,3,1
79974,6,1,279010,279010,279011,0,1,3
79975,6,3,279016,279016,279019,0,3,5
79976,2,3,279018,279019,279022,1,4,0
79977,2,1,279020,279022,279023,2,3,0
79978,6,1,279026,279026,279027,0,1,3
79979,3,1,279029,279029,279030,0,1,2
79980,2,1,279031,279031,279032,0,1,1
79981,2,3,279033,279033,279036,0,3,1
79982,1,3,279034,279036,279039,2,5,0
79983,6,3,279040,279040,279043,0,3,1
79984,4,2,279044,279044,279046,0,2,1
79985,1,3,279045,279046,279049,1,4,0
79986,4,2,279049,279049,279051,0,2,0
79987,5,2,279054,279054,279056,0,2,3
79988,3,3,279057,279057,279060,0,3,1
79989,1,3,279058,279060,279063,2,5,0
79990,5,3,279063,279063,279066,0,3,0
79991,2,2,279065,279066,279068,1,3,0
79992,5,2,279070,279070,279072,0,2,2
79993,5,3,279075,279075,279078,0,3,3
79994,5,3,279080,279080,279083,0,3,2
79995,2,3,279082,279083,279086,1,4,0
79996,3,2,279085,279086,279088,1,3,0
79997,3,2,279088,279088,279090,0,2,0
79998,1,3,279089,279090,279093,1,4,0
79999,6,2,279095,279095,279097,0,2,2
80000,6,2,279101,279101,279103,0,2,4
80001,6,1,279107,279107,279108,0,1,4
80002,6,2,279113,279113,279115,0,2,5
80003,1,1,279114,279115,279116,1,2,0
80004,1,3,279115,279116,279119,1,4,0
80005,5,1,279120,279120,279121,0,1,1
80006,1,1,279121,279121,279122,0,1,0
80007,3,3,279124,279124,279127,0,3,2
80008,5,2,279129,279129,279131,0,2,2
80009,4,1,279133,279133,279134,0,1,2
80010,3,3,279136,279136,279139,0,3,2
80011,5,2,279141,279141,279143,0,2,2
80012,4,1,279145,279145,279146,0,1,2
80013,2,2,279147,279147,279149,0,2,1
80014,6,2,279153,279153,279155,0,2,4
80015,1,3,279154,279155,279158,1,4,0
80016,6,3,279160,279160,279163,0,3,2
80017,4,2,279164,279164,279166,0,2,1
80018,3,3,279167,279167,279170,0,3,1
80019,1,2,279168,279170,279172,2,4,0
80020,6,2,279174,279174,279176,0,2,2
80021,3,3,279177,279177,279180,0,3,1
80022,6,3,279183,279183,279186,0,3,3
80023,2,1,279185,279186,279187,1,2,0
80024,3,1,279188,279188,279189,0,1,1
80025,6,2,279194,279194,279196,0,2,5
80026,5,1,279199,279199,279200,0,1,3
80027,4,1,279203,279203,279204,0,1,3
80028,2,3,279205,279205,279208,0,3,1
80029,4,2,279209,279209,279211,0,2,1
80030,5,2,279214,279214,279216,0,2,3
80031,3,3,279217,279217,279220,0,3,1
80032,5,1,279222,279222,279223,0,1,2
80033,2,2,279224,279224,279226,0,2,1
80034,1,2,279225,279226,279228,1,3,0
80035,6,2,279231,279231,279233,0,2,3
80036,3,1,279234,279234,279235,0,1,1
80037,6,3,279240,279240,279243,0,3,5
80038,3,1,279243,279243,279244,0,1,0
80039,3,1,279246,279246,279247,0,1,2
80040,3,2,279249,279249,279251,0,2,2
80041,2,1,279251,279251,279252,0,1,0
80042,1,1,279252,279252,279253,0,1,0
80043,2,1,279254,279254,279255,0,1,1
80044,4,1,279258,279258,279259,0,1,3
80045,5,2,279263,279263,279265,0,2,4
80046,2,2,279265,279265,279267,0,2,0
80047,3,3,279268,279268,279271,0,3,1
80048,1,2,279269,279271,279273,2,4,0
80049,2,2,279271,279273,279275,2,4,0
80050,5,1,279276,279276,279277,0,1,1
80051,5,3,279281,279281,279284,0,3,4
80052,4,1,279285,279285,279286,0,1,1
80053,6,3,279291,279291,279294,0,3,5
80054,4,1,279295,279295,279296,0,1,1
80055,5,1,279300,279300,279301,0,1,4
80056,3,1,279303,279303,279304,0,1,2
80057,4,2,279307,279307,279309,0,2,3
80058,3,2,279310,279310,279312,0,2,1
80059,3,3,279313,279313,279316,0,3,1
80060,2,1,279315,279316,279317,1,2,0
80061,6,1,279321,279321,279322,0,1,4
80062,5,2,279326,279326,279328,0,2,4
80063,6,3,279332,279332,279335,0,3,4
80064,2,3,279334,279335,279338,1,4,0
80065,2,1,279336,279338,279339,2,3,0
80066,1,3,279337,279339,279342,2,5,0
80067,4,3,279341,279342,279345,1,4,0
80068,5,2,279346,279346,279348,0,2,1
80069,5,1,279351,279351,279352,0,1,3
80070,1,1,279352,279352,279353,0,1,0
80071,6,3,279358,279358,279361,0,3,5
80072,6,1,279364,279364,279365,0,1,3
80073,5,3,279369,279369,279372,0,3,4
80074,3,3,279372,279372,279375,0,3,0
80075,3,3,279375,279375,279378,0,3,0
80076,3,1,279378,279378,279379,0,1,0
80077,4,3,279382,279382,279385,0,3,3
80078,4,2,279386,279386,279388,0,2,1
80079,6,1,279392,279392,279393,0,1,4
80080,1,1,279393,279393,279394,0,1,0
80081,5,2,279398,279398,279400,0,2,4
80082,3,1,279401,279401,279402,0,1,1
80083,3,2,279404,279404,279406,0,2,2
80084,4,1,279408,279408,279409,0,1,2
80085,1,3,279409,279409,279412,0,3,0
80086,1,1,279410,279412,279413,2,3,0
80087,6,1,279416,279416,279417,0,1,3
80088,4,3,279420,279420,279423,0,3,3
80089,5,1,279425,279425,279426,0,1,2
80090,4,1,279429,279429,279430,0,1,3
80091,1,2,279430,279430,279432,0,2,0
80092,2,3,279432,279432,279435,0,3,0
80093,2,3,279434,279435,279438,1,4,0
80094,6,2,279440,279440,279442,0,2,2
80095,1,2,279441,279442,279444,1,3,0
80096,1,3,279442,279444,279447,2,5,0
80097,5,1,279447,279447,279448,0,1,0
80098,6,1,279453,279453,279454,0,1,5
80099,4,1,279457,279457,279458,0,1,3
80100,1,1,279458,279458,279459,0,1,0
80101,5,2,279463,279463,279465,0,2,4
80102,1,3,279464,279465,279468,1,4,0
80103,5,1,279469,279469,279470,0,1,1
80104,1,3,279470,279470,279473,0,3,0
80105,1,3,279471,279473,279476,2,5,0
80106,4,3,279475,279476,279479,1,4,0
80107,4,2,279479,279479,279481,0,2,0
80108,6,2,279485,279485,279487,0,2,4
80109,4,1,279489,279489,279490,0,1,2
80110,6,3,279495,279495,279498,0,3,5
80111,1,3,279496,279498,279501,2,5,0
80112,6,1,279502,279502,279503,0,1,1
80113,3,2,279505,279505,279507,0,2,2
80114,5,1,279510,279510,279511,0,1,3
80115,2,3,279512,279512,279515,0,3,1
80116,6,1,279518,279518,279519,0,1,3
80117,2,3,279520,279520,279523,0,3,1
80118,1,2,279521,279523,279525,2,4,0
80119,4,1,279525,279525,279526,0,1,0
80120,4,3,279529,279529,279532,0,3,3
80121,1,3,279530,279532,279535,2,5,0
80122,5,3,279535,279535,279538,0,3,0
80123,6,3,279541,279541,279544,0,3,3
80124,4,1,279545,279545,279546,0,1,1
80125,1,1,279546,279546,279547,0,1,0
80126,3,3,279549,279549,279552,0,3,2
80127,6,2,279555,279555,279557,0,2,3
80128,5,2,279560,279560,279562,0,2,3
80129,6,3,279566,279566,279569,0,3,4
80130,1,1,279567,279569,279570,2,3,0
80131,4,2,279571,279571,279573,0,2,1
80132,4,2,279575,279575,279577,0,2,2
80133,4,1,279579,279579,279580,0,1,2
80134,2,2,279581,279581,279583,0,2,1
80135,2,2,279583,279583,279585,0,2,0
80136,1,2,279584,279585,279587,1,3,0
80137,6,1,279590,279590,279591,0,1,3
80138,4,3,279594,279594,279597,0,3,3
80139,4,3,279598,279598,279601,0,3,1
80140,2,3,279600,279601,279604,1,4,0
80141,4,3,279604,279604,279607,0,3,0
80142,4,1,279608,279608,279609,0,1,1
80143,6,1,279614,279614,279615,0,1,5
80144,1,2,279615,279615,279617,0,2,0
80145,5,3,279620,279620,279623,0,3,3
80146,2,3,279622,279623,279626,1,4,0
80147,2,3,279624,279626,279629,2,5,0
80148,5,2,279629,279629,279631,0,2,0
80149,2,2,279631,279631,279633,0,2,0
80150,1,3,279632,279633,279636,1,4,0
80151,6,1,279638,279638,279639,0,1,2
80152,4,3,279642,279642,279645,0,3,3
80153,2,2,279644,279645,279647,1,3,0
80154,5,1,279649,279649,279650,0,1,2
80155,1,2,279650,279650,279652,0,2,0
80156,4,1,279654,279654,279655,0,1,2
80157,5,2,279659,279659,279661,0,2,4
80158,3,3,279662,279662,279665,0,3,1
80159,3,3,279665,279665,279668,0,3,0
80160,5,2,279670,279670,279672,0,2,2
80161,6,2,279676,279676,279678,0,2,4
80162,3,1,279679,279679,279680,0,1,1
80163,5,2,279684,279684,279686,0,2,4
80164,3,1,279687,279687,279688,0,1,1
80165,1,3,279688,279688,279691,0,3,0
80166,6,1,279694,279694,279695,0,1,3
80167,1,2,279695,279695,279697,0,2,0
80168,6,1,279701,279701,279702,0,1,4
80169,4,2,279705,279705,279707,0,2,3
80170,2,3,279707,279707,279710,0,3,0
80171,1,3,279708,279710,279713,2,5,0
80172,4,2,279712,279713,279715,1,3,0
80173,2,1,279714,279715,279716,1,2,0
80174,3,1,279717,279717,279718,0,1,1
80175,3,3,279720,279720,279723,0,3,2
80176,6,1,279726,279726,279727,0,1,3
80177,2,1,279728,279728,279729,0,1,1
80178,6,3,279734,279734,279737,0,3,5
80179,3,2,279737,279737,279739,0,2,0
80180,3,1,279740,279740,279741,0,1,1
80181,4,3,279744,279744,279747,0,3,3
80182,4,3,279748,279748,279751,0,3,1
80183,5,2,279753,279753,279755,0,2,2
80184,5,3,279758,279758,279761,0,3,3
80185,6,1,279764,279764,279765,0,1,3
80186,3,2,279767,279767,279769,0,2,2
80187,2,3,279769,279769,279772,0,3,0
80188,6,1,279775,279775,279776,0,1,3
80189,6,3,279781,279781,279784,0,3,5
80190,3,1,279784,279784,279785,0,1,0
80191,3,3,279787,279787,279790,0,3,2
80192,1,2,279788,279790,279792,2,4,0
80193,6,1,279794,279794,279795,0,1,2
80194,3,1,279797,279797,279798,0,1,2
80195,4,2,279801,279801,279803,0,2,3
80196,2,2,279803,279803,279805,0,2,0
80197,5,3,279808,279808,279811,0,3,3
80198,6,3,279814,279814,279817,0,3,3
80199,5,1,279819,279819,279820,0,1,2
80200,3,2,279822,279822,279824,0,2,2
80201,3,3,279825,279825,279828,0,3,1
80202,2,1,279827,279828,279829,1,2,0
80203,4,3,279831,279831,279834,0,3,2
80204,4,2,279835,279835,279837,0,2,1
80205,5,1,279840,279840,279841,0,1,3
80206,2,3,279842,279842,279845,0,3,1
80207,2,2,279844,279845,279847,1,3,0
80208,4,2,279848,279848,279850,0,2,1
80209,3,3,279851,279851,279854,0,3,1
80210,5,1,279856,279856,279857,0,1,2
80211,4,1,279860,279860,279861,0,1,3
80212,2,1,279862,279862,279863,0,1,1
80213,3,1,279865,279865,279866,0,1,2
80214,6,2,279871,279871,279873,0,2,5
80215,3,3,279874,279874,279877,0,3,1
80216,2,3,279876,279877,279880,1,4,0
80217,3,2,279879,279880,279882,1,3,0
80218,3,3,279882,279882,279885,0,3,0
80219,2,3,279884,279885,279888,1,4,0
80220,4,1,279888,279888,279889,0,1,0
80221,1,1,279889,279889,279890,0,1,0
80222,6,3,279895,279895,279898,0,3,5
80223,5,2,279900,279900,279902,0,2,2
80224,6,2,279906,279906,279908,0,2,4
80225,6,1,279912,279912,279913,0,1,4
80226,4,2,279916,279916,279918,0,2,3
80227,1,1,279917,279918,279919,1,2,0
80228,4,3,279921,279921,279924,0,3,2
80229,2,3,279923,279924,279927,1,4,0
80230,6,2,279929,279929,279931,0,2,2
80231,6,2,279935,279935,279937,0,2,4
80232,6,3,279941,279941,279944,0,3,4
80233,4,3,279945,279945,279948,0,3,1
80234,3,3,279948,279948,279951,0,3,0
80235,3,3,279951,279951,279954,0,3,0
80236,1,2,279952,279954,279956,2,4,0
80237,5,1,279957,279957,279958,0,1,1
80238,5,1,279962,279962,279963,0,1,4
80239,6,2,279968,279968,279970,0,2,5
80240,5,3,279973,279973,279976,0,3,3
80241,1,2,279974,279976,279978,2,4,0
80242,5,3,279979,279979,279982,0,3,1
80243,6,3,279985,279985,279988,0,3,3
80244,3,2,279988,279988,279990,0,2,0
80245,3,1,279991,279991,279992,0,1,1
80246,2,1,279993,279993,279994,0,1,1
80247,1,2,279994,279994,279996,0,2,0
80248,1,2,279995,279996,279998,1,3,0
80249,4,1,279999,279999,280000,0,1,1
80250,6,2,280005,280005,280007,0,2,5
80251,2,2,280007,280007,280009,0,2,0
80252,2,2,280009,280009,280011,0,2,0
80253,1,2,280010,280011,280013,1,3,0
80254,3,3,280013,280013,280016,0,3,0
80255,1,1,280014,280016,280017,2,3,0
80256,2,3,280016,280017,280020,1,4,0
80257,4,2,280020,280020,280022,0,2,0
80258,5,2,280025,280025,280027,0,2,3
80259,3,1,280028,280028,280029,0,1,1
80260,5,3,280033,280033,280036,0,3,4
80261,4,1,280037,280037,280038,0,1,1
80262,4,1,280041,280041,280042,0,1,3
80263,1,3,280042,280042,280045,0,3,0
80264,2,1,280044,280045,280046,1,2,0
80265,5,1,280049,280049,280050,0,1,3
80266,1,3,280050,280050,280053,0,3,0
80267,2,2,280052,280053,280055,1,3,0
80268,5,1,280057,280057,280058,0,1,2
80269,1,3,280058,280058,280061,0,3,0
80270,5,2,280063,280063,280065,0,2,2
80271,3,1,280066,280066,280067,0,1,1
80272,3,3,280069,280069,280072,0,3,2
80273,6,2,280075,280075,280077,0,2,3
80274,1,3,280076,280077,280080,1,4,0
80275,4,1,280080,280080,280081,0,1,0
80276,1,3,280081,280081,280084,0,3,0
80277,6,3,280087,280087,280090,0,3,3
80278,6,1,280093,280093,280094,0,1,3
80279,2,1,280095,280095,280096,0,1,1
80280,6,1,280101,280101,280102,0,1,5
80281,3,3,280104,280104,280107,0,3,2
80282,1,2,280105,280107,280109,2,4,0
80283,5,1,280110,280110,280111,0,1,1
80284,5,1,280115,280115,280116,0,1,4
80285,4,3,280119,280119,280122,0,3,3
80286,5,3,280124,280124,280127,0,3,2
80287,1,2,280125,280127,280129,2,4,0
80288,4,1,280129,280129,280130,0,1,0
80289,4,3,280133,280133,280136,0,3,3
80290,5,2,280138,280138,280140,0,2,2
80291,5,3,280143,280143,280146,0,3,3
80292,3,3,280146,280146,280149,0,3,0
80293,3,1,280149,280149,280150,0,1,0
80294,1,2,280150,280150,280152,0,2,0
80295,1,2,280151,280152,280154,1,3,0
80296,1,1,280152,280154,280155,2,3,0
80297,5,1,280157,280157,280158,0,1,2
80298,6,1,280163,280163,280164,0,1,5
80299,1,3,280164,280164,280167,0,3,0
80300,1,2,280165,280167,280169,2,4,0
80301,6,2,280171,280171,280173,0,2,2
80302,2,2,280173,280173,280175,0,2,0
80303,6,2,280179,280179,280181,0,2,4
80304,5,1,280184,280184,280185,0,1,3
80305,4,2,280188,280188,280190,0,2,3
80306,6,1,280194,280194,280195,0,1,4
80307,4,1,280198,280198,280199,0,1,3
80308,6,3,280204,280204,280207,0,3,5
80309,1,2,280205,280207,280209,2,4,0
80310,3,3,280208,280209,280212,1,4,0
80311,3,3,280211,280212,280215,1,4,0
80312,5,3,280216,280216,280219,0,3,1
80313,6,1,280222,280222,280223,0,1,3
80314,5,1,280227,280227,280228,0,1,4
80315,5,1,280232,280232,280233,0,1,4
80316,3,3,280235,280235,280238,0,3,2
80317,4,2,280239,280239,280241,0,2,1
80318,1,2,280240,280241,280243,1,3,0
80319,5,1,280245,280245,280246,0,1,2
80320,6,3,280251,280251,280254,0,3,5
80321,4,1,280255,280255,280256,0,1,1
80322,3,1,280258,280258,280259,0,1,2
80323,2,2,280260,280260,280262,0,2,1
80324,3,3,280263,280263,280266,0,3,1
80325,1,3,280264,280266,280269,2,5,0
80326,2,3,280266,280269,280272,3,6,0
80327,4,1,280270,280272,280273,2,3,0
80328,1,2,280271,280273,280275,2,4,0
80329,4,2,280275,280275,280277,0,2,0
80330,2,3,280277,280277,280280,0,3,0
80331,2,1,280279,280280,280281,1,2,0
80332,5,2,280284,280284,280286,0,2,3
80333,2,3,280286,280286,280289,0,3,0
80334,5,2,280291,280291,280293,0,2,2
80335,5,3,280296,280296,280299,0,3,3
80336,1,2,280297,280299,280301,2,4,0
80337,5,3,280302,280302,280305,0,3,1
80338,6,2,280308,280308,280310,0,2,3
80339,1,1,280309,280310,280311,1,2,0
80340,4,3,280313,280313,280316,0,3,2
80341,1,3,280314,280316,280319,2,5,0
80342,1,2,280315,280319,280321,4,6,0
80343,5,3,280320,280321,280324,1,4,0
80344,6,2,280326,280326,280328,0,2,2
80345,1,1,280327,280328,280329,1,2,0
80346,2,2,280329,280329,280331,0,2,0
80347,3,3,280332,280332,280335,0,3,1
80348,5,2,280337,280337,280339,0,2,2
80349,6,1,280343,280343,280344,0,1,4
80350,5,2,280348,280348,280350,0,2,4
80351,6,1,280354,280354,280355,0,1,4
80352,4,2,280358,280358,280360,0,2,3
80353,5,3,280363,280363,280366,0,3,3
80354,5,1,280368,280368,280369,0,1,2
80355,4,1,280372,280372,280373,0,1,3
80356,4,3,280376,280376,280379,0,3,3
80357,6,1,280382,280382,280383,0,1,3
80358,3,1,280385,280385,280386,0,1,2
80359,6,3,280391,280391,280394,0,3,5
80360,2,2,280393,280394,280396,1,3,0
80361,2,2,280395,280396,280398,1,3,0
80362,1,1,280396,280398,280399,2,3,0
80363,3,1,280399,280399,280400,0,1,0
80364,5,1,280404,280404,280405,0,1,4
80365,5,3,280409,280409,280412,0,3,4
80366,4,2,280413,280413,280415,0,2,1
80367,1,2,280414,280415,280417,1,3,0
80368,5,1,280419,280419,280420,0,1,2
80369,2,1,280421,280421,280422,0,1,1
80370,2,1,280423,280423,280424,0,1,1
80371,6,2,280429,280429,280431,0,2,5
80372,1,2,280430,280431,280433,1,3,0
80373,1,1,280431,280433,280434,2,3,0
80374,1,2,280432,280434,280436,2,4,0
80375,3,2,280435,280436,280438,1,3,0
80376,2,3,280437,280438,280441,1,4,0
80377,1,3,280438,280441,280444,3,6,0
80378,1,2,280439,280444,280446,5,7,0
80379,3,1,280442,280446,280447,4,5,0
80380,1,2,280443,280447,280449,4,6,0
80381,6,2,280449,280449,280451,0,2,0
80382,6,2,280455,280455,280457,0,2,4
80383,2,3,280457,280457,280460,0,3,0
80384,1,1,280458,280460,280461,2,3,0
80385,6,2,280464,280464,280466,0,2,3
80386,6,2,280470,280470,280472,0,2,4
80387,3,1,280473,280473,280474,0,1,1
80388,2,1,280475,280475,280476,0,1,1
80389,4,2,280479,280479,280481,0,2,3
80390,1,2,280480,280481,280483,1,3,0
80391,4,2,280484,280484,280486,0,2,1
80392,1,2,280485,280486,280488,1,3,0
80393,2,1,280487,280488,280489,1,2,0
80394,4,3,280491,280491,280494,0,3,2
80395,1,2,280492,280494,280496,2,4,0
80396,4,3,280496,280496,280499,0,3,0
80397,1,2,280497,280499,280501,2,4,0
80398,5,2,280502,280502,280504,0,2,1
80399,3,3,280505,280505,280508,0,3,1
80400,2,1,280507,280508,280509,1,2,0
80401,6,1,280513,280513,280514,0,1,4
80402,3,3,280516,280516,280519,0,3,2
80403,2,2,280518,280519,280521,1,3,0
80404,3,3,280521,280521,280524,0,3,0
80405,6,1,280527,280527,280528,0,1,3
80406,5,1,280532,280532,280533,0,1,4
80407,3,1,280535,280535,280536,0,1,2
80408,5,3,280540,280540,280543,0,3,4
80409,4,3,280544,280544,280547,0,3,1
80410,5,2,280549,280549,280551,0,2,2
80411,6,2,280555,280555,280557,0,2,4
80412,3,1,280558,280558,280559,0,1,1
80413,5,1,280563,280563,280564,0,1,4
80414,5,1,280568,280568,280569,0,1,4
80415,4,1,280572,280572,280573,0,1,3
80416,6,3,280578,280578,280581,0,3,5
80417,1,3,280579,280581,280584,2,5,0
80418,6,2,280585,280585,280587,0,2,1
80419,4,1,280589,280589,280590,0,1,2
80420,1,3,280590,280590,280593,0,3,0
80421,3,3,280593,280593,280596,0,3,0
80422,5,2,280598,280598,280600,0,2,2
80423,4,3,280602,280602,280605,0,3,2
80424,2,2,280604,280605,280607,1,3,0
80425,6,2,280610,280610,280612,0,2,3
80426,3,2,280613,280613,280615,0,2,1
80427,2,1,280615,280615,280616,0,1,0
80428,5,3,280620,280620,280623,0,3,4
80429,4,1,280624,280624,280625,0,1,1
80430,6,2,280630,280630,280632,0,2,5
80431,4,3,280634,280634,280637,0,3,2
80432,1,3,280635,280637,280640,2,5,0
80433,6,2,280641,280641,280643,0,2,1
80434,4,3,280645,280645,280648,0,3,2
80435,2,1,280647,280648,280649,1,2,0
80436,4,2,280651,280651,280653,0,2,2
80437,2,1,280653,280653,280654,0,1,0
80438,2,2,280655,280655,280657,0,2,1
80439,3,3,280658,280658,280661,0,3,1
80440,3,2,280661,280661,280663,0,2,0
80441,1,2,280662,280663,280665,1,3,0
80442,4,3,280666,280666,280669,0,3,1
80443,5,1,280671,280671,280672,0,1,2
80444,3,3,280674,280674,280677,0,3,2
80445,5,2,280679,280679,280681,0,2,2
80446,4,1,280683,280683,280684,0,1,2
80447,6,3,280689,280689,280692,0,3,5
80448,5,2,280694,280694,280696,0,2,2
80449,6,2,280700,280700,280702,0,2,4
80450,1,2,280701,280702,280704,1,3,0
80451,6,3,280707,280707,280710,0,3,3
80452,6,3,280713,280713,280716,0,3,3
80453,1,1,280714,280716,280717,2,3,0
80454,6,2,280720,280720,280722,0,2,3
80455,2,2,280722,280722,280724,0,2,0
80456,4,3,280726,280726,280729,0,3,2
80457,4,3,280730,280730,280733,0,3,1
80458,5,3,280735,280735,280738,0,3,2
80459,3,3,280738,280738,280741,0,3,0
80460,4,1,280742,280742,280743,0,1,1
80461,3,1,280745,280745,280746,0,1,2
80462,3,3,280748,280748,280751,0,3,2
80463,3,3,280751,280751,280754,0,3,0
80464,5,1,280756,280756,280757,0,1,2
80465,1,3,280757,280757,280760,0,3,0
80466,6,3,280763,280763,280766,0,3,3
80467,1,1,280764,280766,280767,2,3,0
80468,6,3,280770,280770,280773,0,3,3
80469,3,3,280773,280773,280776,0,3,0
80470,4,3,280777,280777,280780,0,3,1
80471,3,3,280780,280780,280783,0,3,0
80472,6,1,280786,280786,280787,0,1,3
80473,4,2,280790,280790,280792,0,2,3
80474,2,3,280792,280792,280795,0,3,0
80475,1,2,280793,280795,280797,2,4,0
80476,1,2,280794,280797,280799,3,5,0
80477,2,2,280796,280799,280801,3,5,0
80478,3,1,280799,280801,280802,2,3,0
80479,5,1,280804,280804,280805,0,1,2
80480,1,3,280805,280805,280808,0,3,0
80481,3,2,280808,280808,280810,0,2,0
80482,1,3,280809,280810,280813,1,4,0
80483,2,1,280811,280813,280814,2,3,0
80484,1,1,280812,280814,280815,2,3,0
80485,6,2,280818,280818,280820,0,2,3
80486,2,3,280820,280820,280823,0,3,0
80487,2,2,280822,280823,280825,1,3,0
80488,4,1,280826,280826,280827,0,1,1
80489,5,3,280831,280831,280834,0,3,4
80490,5,2,280836,280836,280838,0,2,2
80491,6,2,280842,280842,280844,0,2,4
80492,1,3,280843,280844,280847,1,4,0
80493,2,3,280845,280847,280850,2,5,0
80494,3,3,280848,280850,280853,2,5,0
80495,1,3,280849,280853,280856,4,7,0
80496,4,3,280853,280856,280859,3,6,0
80497,3,3,280856,280859,280862,3,6,0
80498,2,1,280858,280862,280863,4,5,0
80499,3,2,280861,280863,280865,2,4,0
80500,2,2,280863,280865,280867,2,4,0
80501,4,3,280867,280867,280870,0,3,0
80502,3,2,280870,280870,280872,0,2,0
80503,6,3,280876,280876,280879,0,3,4
80504,1,3,280877,280879,280882,2,5,0
80505,2,3,280879,280882,280885,3,6,0
80506,3,1,280882,280885,280886,3,4,0
80507,3,3,280885,280886,280889,1,4,0
80508,2,2,280887,280889,280891,2,4,0
80509,3,2,280890,280891,280893,1,3,0
80510,6,1,280896,280896,280897,0,1,3
80511,2,1,280898,280898,280899,0,1,1
80512,1,3,280899,280899,280902,0,3,0
80513,2,3,280901,280902,280905,1,4,0
80514,3,3,280904,280905,280908,1,4,0
80515,6,2,280910,280910,280912,0,2,2
80516,1,1,280911,280912,280913,1,2,0
80517,4,3,280915,280915,280918,0,3,2
80518,6,1,280921,280921,280922,0,1,3
80519,2,3,280923,280923,280926,0,3,1
80520,4,2,280927,280927,280929,0,2,1
80521,5,1,280932,280932,280933,0,1,3
80522,4,1,280936,280936,280937,0,1,3
80523,1,1,280937,280937,280938,0,1,0
80524,4,1,280941,280941,280942,0,1,3
80525,5,1,280946,280946,280947,0,1,4
80526,3,1,280949,280949,280950,0,1,2
80527,3,1,280952,280952,280953,0,1,2
80528,3,2,280955,280955,280957,0,2,2
80529,2,3,280957,280957,280960,0,3,0
80530,2,2,280959,280960,280962,1,3,0
80531,6,3,280965,280965,280968,0,3,3
80532,4,3,280969,280969,280972,0,3,1
80533,3,1,280972,280972,280973,0,1,0
80534,4,3,280976,280976,280979,0,3,3
80535,6,3,280982,280982,280985,0,3,3
80536,2,3,280984,280985,280988,1,4,0
80537,5,1,280989,280989,280990,0,1,1
80538,3,2,280992,280992,280994,0,2,2
80539,4,1,280996,280996,280997,0,1,2
80540,6,1,281002,281002,281003,0,1,5
80541,3,3,281005,281005,281008,0,3,2
80542,4,2,281009,281009,281011,0,2,1
80543,4,1,281013,281013,281014,0,1,2
80544,4,3,281017,281017,281020,0,3,3
80545,2,2,281019,281020,281022,1,3,0
80546,6,2,281025,281025,281027,0,2,3
80547,5,3,281030,281030,281033,0,3,3
80548,6,3,281036,281036,281039,0,3,3
80549,2,1,281038,281039,281040,1,2,0
80550,4,1,281042,281042,281043,0,1,2
80551,6,2,281048,281048,281050,0,2,5
80552,3,2,281051,281051,281053,0,2,1
80553,3,3,281054,281054,281057,0,3,1
80554,6,1,281060,281060,281061,0,1,3
80555,4,2,281064,281064,281066,0,2,3
80556,2,3,281066,281066,281069,0,3,0
80557,6,2,281072,281072,281074,0,2,3
80558,4,3,281076,281076,281079,0,3,2
80559,1,1,281077,281079,281080,2,3,0
80560,4,1,281081,281081,281082,0,1,1
80561,6,1,281087,281087,281088,0,1,5
80562,4,1,281091,281091,281092,0,1,3
80563,2,1,281093,281093,281094,0,1,1
80564,5,1,281098,281098,281099,0,1,4
80565,4,3,281102,281102,281105,0,3,3
80566,6,3,281108,281108,281111,0,3,3
80567,2,3,281110,281111,281114,1,4,0
80568,4,2,281114,281114,281116,0,2,0
80569,6,2,281120,281120,281122,0,2,4
80570,6,3,281126,281126,281129,0,3,4
80571,5,2,281131,281131,281133,0,2,2
80572,1,2,281132,281133,281135,1,3,0
80573,3,1,281135,281135,281136,0,1,0
80574,3,1,281138,281138,281139,0,1,2
80575,2,3,281140,281140,281143,0,3,1
80576,5,1,281145,281145,281146,0,1,2
80577,1,3,281146,281146,281149,0,3,0
80578,6,2,281152,281152,281154,0,2,3
80579,4,3,281156,281156,281159,0,3,2
80580,1,3,281157,281159,281162,2,5,0
80581,5,1,281162,281162,281163,0,1,0
80582,4,2,281166,281166,281168,0,2,3
80583,5,2,281171,281171,281173,0,2,3
80584,1,1,281172,281173,281174,1,2,0
80585,5,2,281177,281177,281179,0,2,3
80586,4,2,281181,281181,281183,0,2,2
80587,3,2,281184,281184,281186,0,2,1
80588,5,2,281189,281189,281191,0,2,3
80589,6,3,281195,281195,281198,0,3,4
80590,6,1,281201,281201,281202,0,1,3
80591,6,3,281207,281207,281210,0,3,5
80592,4,1,281211,281211,281212,0,1,1
80593,4,3,281215,281215,281218,0,3,3
80594,3,2,281218,281218,281220,0,2,0
80595,2,1,281220,281220,281221,0,1,0
80596,2,1,281222,281222,281223,0,1,1
80597,5,3,281227,281227,281230,0,3,4
80598,1,2,281228,281230,281232,2,4,0
80599,3,3,281231,281232,281235,1,4,0
80600,2,1,281233,281235,281236,2,3,0
80601,4,3,281237,281237,281240,0,3,1
80602,4,2,281241,281241,281243,0,2,1
80603,1,2,281242,281243,281245,1,3,0
80604,5,3,281247,281247,281250,0,3,2
80605,5,3,281252,281252,281255,0,3,2
80606,1,3,281253,281255,281258,2,5,0
80607,6,3,281259,281259,281262,0,3,1
80608,2,2,281261,281262,281264,1,3,0
80609,4,3,281265,281265,281268,0,3,1
80610,4,2,281269,281269,281271,0,2,1
80611,2,3,281271,281271,281274,0,3,0
80612,5,3,281276,281276,281279,0,3,2
80613,3,3,281279,281279,281282,0,3,0
80614,5,3,281284,281284,281287,0,3,2
80615,4,1,281288,281288,281289,0,1,1
80616,3,2,281291,281291,281293,0,2,2
80617,6,2,281297,281297,281299,0,2,4
80618,6,2,281303,281303,281305,0,2,4
80619,4,2,281307,281307,281309,0,2,2
80620,6,3,281313,281313,281316,0,3,4
80621,3,3,281316,281316,281319,0,3,0
80622,2,3,281318,281319,281322,1,4,0
80623,3,1,281321,281322,281323,1,2,0
80624,2,3,281323,281323,281326,0,3,0
80625,5,2,281328,281328,281330,0,2,2
80626,1,3,281329,281330,281333,1,4,0
80627,2,2,281331,281333,281335,2,4,0
80628,5,2,281336,281336,281338,0,2,1
80629,5,1,281341,281341,281342,0,1,3
80630,6,1,281347,281347,281348,0,1,5
80631,3,3,281350,281350,281353,0,3,2
80632,1,1,281351,281353,281354,2,3,0
80633,6,3,281357,281357,281360,0,3,3
80634,2,2,281359,281360,281362,1,3,0
80635,6,2,281365,281365,281367,0,2,3
80636,4,2,281369,281369,281371,0,2,2
80637,5,1,281374,281374,281375,0,1,3
80638,1,2,281375,281375,281377,0,2,0
80639,6,1,281381,281381,281382,0,1,4
80640,2,3,281383,281383,281386,0,3,1
80641,2,2,281385,281386,281388,1,3,0
80642,3,3,281388,281388,281391,0,3,0
80643,6,1,281394,281394,281395,0,1,3
80644,6,1,281400,281400,281401,0,1,5
80645,3,3,281403,281403,281406,0,3,2
80646,2,2,281405,281406,281408,1,3,0
80647,1,3,281406,281408,281411,2,5,0
80648,2,2,281408,281411,281413,3,5,0
80649,1,3,281409,281413,281416,4,7,0
80650,3,2,281412,281416,281418,4,6,0
80651,1,2,281413,281418,281420,5,7,0
80652,1,2,281414,281420,281422,6,8,0
80653,1,3,281415,281422,281425,7,10,0
80654,1,3,281416,281425,281428,9,12,0
80655,4,2,281420,281428,281430,8,10,0
80656,1,3,281421,281430,281433,9,12,0
80657,1,1,281422,281433,281434,11,12,0
80658,6,1,281428,281434,281435,6,7,0
80659,4,3,281432,281435,281438,3,6,0
80660,2,1,281434,281438,281439,4,5,0
80661,2,2,281436,281439,281441,3,5,0
80662,1,3,281437,281441,281444,4,7,0
80663,1,3,281438,281444,281447,6,9,0
80664,6,1,281444,281447,281448,3,4,0
80665,1,3,281445,281448,281451,3,6,0
80666,2,3,281447,281451,281454,4,7,0
80667,4,1,281451,281454,281455,3,4,0
80668,3,2,281454,281455,281457,1,3,0
80669,2,3,281456,281457,281460,1,4,0
80670,2,1,281458,281460,281461,2,3,0
80671,4,1,281462,281462,281463,0,1,1
80672,4,3,281466,281466,281469,0,3,3
80673,1,2,281467,281469,281471,2,4,0
80674,4,3,281471,281471,281474,0,3,0
80675,6,2,281477,281477,281479,0,2,3
80676,3,2,281480,281480,281482,0,2,1
80677,2,3,281482,281482,281485,0,3,0
80678,3,1,281485,281485,281486,0,1,0
80679,2,2,281487,281487,281489,0,2,1
80680,6,2,281493,281493,281495,0,2,4
80681,4,3,281497,281497,281500,0,3,2
80682,1,3,281498,281500,281503,2,5,0
80683,2,3,281500,281503,281506,3,6,0
80684,5,1,281505,281506,281507,1,2,0
80685,2,2,281507,281507,281509,0,2,0
80686,4,3,281511,281511,281514,0,3,2
80687,1,2,281512,281514,281516,2,4,0
80688,5,1,281517,281517,281518,0,1,1
80689,5,1,281522,281522,281523,0,1,4
80690,4,2,281526,281526,281528,0,2,3
80691,2,3,281528,281528,281531,0,3,0
80692,3,3,281531,281531,281534,0,3,0
80693,4,2,281535,281535,281537,0,2,1
80694,6,2,281541,281541,281543,0,2,4
80695,6,1,281547,281547,281548,0,1,4
80696,4,2,281551,281551,281553,0,2,3
80697,3,1,281554,281554,281555,0,1,1
80698,6,2,281560,281560,281562,0,2,5
80699,1,2,281561,281562,281564,1,3,0
80700,6,2,281567,281567,281569,0,2,3
80701,5,3,281572,281572,281575,0,3,3
80702,6,2,281578,281578,281580,0,2,3
80703,2,3,281580,281580,281583,0,3,0
80704,4,3,281584,281584,281587,0,3,1
80705,3,1,281587,281587,281588,0,1,0
80706,1,1,281588,281588,281589,0,1,0
80707,5,1,281593,281593,281594,0,1,4
80708,3,3,281596,281596,281599,0,3,2
80709,5,3,281601,281601,281604,0,3,2
80710,1,1,281602,281604,281605,2,3,0
80711,4,3,281606,281606,281609,0,3,1
80712,1,2,281607,281609,281611,2,4,0
80713,5,2,281612,281612,281614,0,2,1
80714,5,1,281617,281617,281618,0,1,3
80715,6,2,281623,281623,281625,0,2,5
80716,2,3,281625,281625,281628,0,3,0
80717,6,2,281631,281631,281633,0,2,3
80718,6,3,281637,281637,281640,0,3,4
80719,5,2,281642,281642,281644,0,2,2
80720,3,1,281645,281645,281646,0,1,1
80721,1,3,281646,281646,281649,0,3,0
80722,3,3,281649,281649,281652,0,3,0
80723,6,2,281655,281655,281657,0,2,3
80724,2,1,281657,281657,281658,0,1,0
80725,5,2,281662,281662,281664,0,2,4
80726,3,1,281665,281665,281666,0,1,1
80727,3,2,281668,281668,281670,0,2,2
80728,5,3,281673,281673,281676,0,3,3
80729,6,3,281679,281679,281682,0,3,3
80730,5,3,281684,281684,281687,0,3,2
80731,4,2,281688,281688,281690,0,2,1
80732,6,1,281694,281694,281695,0,1,4
80733,6,2,281700,281700,281702,0,2,5
80734,1,3,281701,281702,281705,1,4,0
80735,2,1,281703,281705,281706,2,3,0
80736,6,3,281709,281709,281712,0,3,3
80737,5,2,281714,281714,281716,0,2,2
80738,4,3,281718,281718,281721,0,3,2
80739,2,1,281720,281721,281722,1,2,0
80740,6,2,281726,281726,281728,0,2,4
80741,2,2,281728,281728,281730,0,2,0
80742,6,1,281734,281734,281735,0,1,4
80743,2,2,281736,281736,281738,0,2,1
80744,5,1,281741,281741,281742,0,1,3
80745,5,2,281746,281746,281748,0,2,4
80746,1,3,281747,281748,281751,1,4,0
80747,5,3,281752,281752,281755,0,3,1
80748,3,1,281755,281755,281756,0,1,0
80749,1,3,281756,281756,281759,0,3,0
80750,3,3,281759,281759,281762,0,3,0
80751,2,2,281761,281762,281764,1,3,0
80752,1,1,281762,281764,281765,2,3,0
80753,6,1,281768,281768,281769,0,1,3
80754,3,2,281771,281771,281773,0,2,2
80755,5,3,281776,281776,281779,0,3,3
80756,1,1,281777,281779,281780,2,3,0
80757,5,2,281782,281782,281784,0,2,2
80758,5,2,281787,281787,281789,0,2,3
80759,4,3,281791,281791,281794,0,3,2
80760,2,1,281793,281794,281795,1,2,0
80761,2,3,281795,281795,281798,0,3,0
80762,5,2,281800,281800,281802,0,2,2
80763,4,2,281804,281804,281806,0,2,2
80764,5,2,281809,281809,281811,0,2,3
80765,1,2,281810,281811,281813,1,3,0
80766,3,2,281813,281813,281815,0,2,0
80767,5,1,281818,281818,281819,0,1,3
80768,4,1,281822,281822,281823,0,1,3
80769,2,1,281824,281824,281825,0,1,1
80770,5,3,281829,281829,281832,0,3,4
80771,4,2,281833,281833,281835,0,2,1
80772,6,3,281839,281839,281842,0,3,4
80773,5,3,281844,281844,281847,0,3,2
80774,6,1,281850,281850,281851,0,1,3
80775,1,2,281851,281851,281853,0,2,0
80776,5,3,281856,281856,281859,0,3,3
80777,4,3,281860,281860,281863,0,3,1
80778,5,1,281865,281865,281866,0,1,2
80779,4,2,281869,281869,281871,0,2,3
80780,4,2,281873,281873,281875,0,2,2
80781,3,1,281876,281876,281877,0,1,1
80782,1,1,281877,281877,281878,0,1,0
80783,3,1,281880,281880,281881,0,1,2
80784,5,1,281885,281885,281886,0,1,4
80785,4,1,281889,281889,281890,0,1,3
80786,2,3,281891,281891,281894,0,3,1
80787,3,2,281894,281894,281896,0,2,0
80788,6,2,281900,281900,281902,0,2,4
80789,1,1,281901,281902,281903,1,2,0
80790,4,1,281905,281905,281906,0,1,2
80791,5,2,281910,281910,281912,0,2,4
80792,2,1,281912,281912,281913,0,1,0
80793,6,1,281918,281918,281919,0,1,5
80794,1,1,281919,281919,281920,0,1,0
80795,1,2,281920,281920,281922,0,2,0
80796,3,3,281923,281923,281926,0,3,1
80797,3,1,281926,281926,281927,0,1,0
80798,6,1,281932,281932,281933,0,1,5
80799,6,3,281938,281938,281941,0,3,5
80800,1,1,281939,281941,281942,2,3,0
80801,1,3,281940,281942,281945,2,5,0
80802,4,1,281944,281945,281946,1,2,0
80803,3,1,281947,281947,281948,0,1,1
80804,6,1,281953,281953,281954,0,1,5
80805,1,3,281954,281954,281957,0,3,0
80806,2,3,281956,281957,281960,1,4,0
80807,4,1,281960,281960,281961,0,1,0
80808,6,3,281966,281966,281969,0,3,5
80809,6,3,281972,281972,281975,0,3,3
80810,4,1,281976,281976,281977,0,1,1
80811,1,3,281977,281977,281980,0,3,0
80812,3,3,281980,281980,281983,0,3,0
80813,3,1,281983,281983,281984,0,1,0
80814,3,2,281986,281986,281988,0,2,2
80815,3,3,281989,281989,281992,0,3,1
80816,2,2,281991,281992,281994,1,3,0
80817,2,2,281993,281994,281996,1,3,0
80818,2,3,281995,281996,281999,1,4,0
80819,3,2,281998,281999,282001,1,3,0
80820,6,2,282004,282004,282006,0,2,3
80821,3,1,282007,282007,282008,0,1,1
80822,2,3,282009,282009,282012,0,3,1
80823,3,3,282012,282012,282015,0,3,0
80824,2,3,282014,282015,282018,1,4,0
80825,3,2,282017,282018,282020,1,3,0
80826,6,3,282023,282023,282026,0,3,3
80827,6,3,282029,282029,282032,0,3,3
80828,6,2,282035,282035,282037,0,2,3
80829,2,2,282037,282037,282039,0,2,0
80830,3,2,282040,282040,282042,0,2,1
80831,6,1,282046,282046,282047,0,1,4
80832,2,2,282048,282048,282050,0,2,1
80833,5,2,282053,282053,282055,0,2,3
80834,1,3,282054,282055,282058,1,4,0
80835,5,2,282059,282059,282061,0,2,1
80836,2,1,282061,282061,282062,0,1,0
80837,1,2,282062,282062,282064,0,2,0
80838,1,2,282063,282064,282066,1,3,0
80839,6,2,282069,282069,282071,0,2,3
80840,3,1,282072,282072,282073,0,1,1
80841,5,3,282077,282077,282080,0,3,4
80842,4,2,282081,282081,282083,0,2,1
80843,2,3,282083,282083,282086,0,3,0
80844,6,3,282089,282089,282092,0,3,3
80845,6,2,282095,282095,282097,0,2,3
80846,1,2,282096,282097,282099,1,3,0
80847,1,2,282097,282099,282101,2,4,0
80848,5,3,282102,282102,282105,0,3,1
80849,3,1,282105,282105,282106,0,1,0
80850,2,3,282107,282107,282110,0,3,1
80851,1,1,282108,282110,282111,2,3,0
80852,4,1,282112,282112,282113,0,1,1
80853,3,3,282115,282115,282118,0,3,2
80854,6,3,282121,282121,282124,0,3,3
80855,5,2,282126,282126,282128,0,2,2
80856,3,1,282129,282129,282130,0,1,1
80857,5,2,282134,282134,282136,0,2,4
80858,2,3,282136,282136,282139,0,3,0
80859,3,3,282139,282139,282142,0,3,0
80860,2,2,282141,282142,282144,1,3,0
80861,4,1,282145,282145,282146,0,1,1
80862,1,3,282146,282146,282149,0,3,0
80863,6,2,282152,282152,282154,0,2,3
80864,6,1,282158,282158,282159,0,1,4
80865,6,3,282164,282164,282167,0,3,5
80866,6,1,282170,282170,282171,0,1,3
80867,3,2,282173,282173,282175,0,2,2
80868,3,3,282176,282176,282179,0,3,1
80869,2,2,282178,282179,282181,1,3,0
80870,3,2,282181,282181,282183,0,2,0
80871,6,2,282187,282187,282189,0,2,4
80872,4,2,282191,282191,282193,0,2,2
80873,6,1,282197,282197,282198,0,1,4
80874,6,3,282203,282203,282206,0,3,5
80875,3,3,282206,282206,282209,0,3,0
80876,1,1,282207,282209,282210,2,3,0
80877,6,1,282213,282213,282214,0,1,3
80878,2,2,282215,282215,282217,0,2,1
80879,4,3,282219,282219,282222,0,3,2
80880,1,2,282220,282222,282224,2,4,0
80881,4,2,282224,282224,282226,0,2,0
80882,6,1,282230,282230,282231,0,1,4
80883,3,2,282233,282233,282235,0,2,2
80884,4,2,282237,282237,282239,0,2,2
80885,4,1,282241,282241,282242,0,1,2
80886,3,1,282244,282244,282245,0,1,2
80887,2,2,282246,282246,282248,0,2,1
80888,4,2,282250,282250,282252,0,2,2
80889,5,1,282255,282255,282256,0,1,3
80890,6,2,282261,282261,282263,0,2,5
80891,2,3,282263,282263,282266,0,3,0
80892,6,3,282269,282269,282272,0,3,3
80893,3,1,282272,282272,282273,0,1,0
80894,1,2,282273,282273,282275,0,2,0
80895,6,1,282279,282279,282280,0,1,4
80896,4,3,282283,282283,282286,0,3,3
80897,2,3,282285,282286,282289,1,4,0
80898,5,3,282290,282290,282293,0,3,1
80899,1,2,282291,282293,282295,2,4,0
80900,1,3,282292,282295,282298,3,6,0
80901,1,2,282293,282298,282300,5,7,0
80902,1,3,282294,282300,282303,6,9,0
80903,4,2,282298,282303,282305,5,7,0
80904,1,3,282299,282305,282308,6,9,0
80905,4,2,282303,282308,282310,5,7,0
80906,1,2,282304,282310,282312,6,8,0
80907,4,3,282308,282312,282315,4,7,0
80908,6,1,282314,282315,282316,1,2,0
80909,4,1,282318,282318,282319,0,1,2
80910,1,2,282319,282319,282321,0,2,0
80911,6,1,282325,282325,282326,0,1,4
80912,2,2,282327,282327,282329,0,2,1
80913,4,1,282331,282331,282332,0,1,2
80914,2,2,282333,282333,282335,0,2,1
80915,1,3,282334,282335,282338,1,4,0
80916,3,1,282337,282338,282339,1,2,0
80917,6,1,282343,282343,282344,0,1,4
80918,6,1,282349,282349,282350,0,1,5
80919,5,3,282354,282354,282357,0,3,4
80920,1,3,282355,282357,282360,2,5,0
80921,3,3,282358,282360,282363,2,5,0
80922,1,1,282359,282363,282364,4,5,0
80923,1,3,282360,282364,282367,4,7,0
80924,1,3,282361,282367,282370,6,9,0
80925,1,1,282362,282370,282371,8,9,0
80926,6,2,282368,282371,282373,3,5,0
80927,4,3,282372,282373,282376,1,4,0
80928,3,2,282375,282376,282378,1,3,0
80929,1,3,282376,282378,282381,2,5,0
80930,4,1,282380,282381,282382,1,2,0
80931,1,1,282381,282382,282383,1,2,0
80932,6,2,282387,282387,282389,0,2,4
80933,4,1,282391,282391,282392,0,1,2
80934,6,2,282397,282397,282399,0,2,5
80935,6,2,282403,282403,282405,0,2,4
80936,2,3,282405,282405,282408,0,3,0
80937,1,2,282406,282408,282410,2,4,0
80938,6,2,282412,282412,282414,0,2,2
80939,5,3,282417,282417,282420,0,3,3
80940,5,3,282422,282422,282425,0,3,2
80941,6,3,282428,282428,282431,0,3,3
80942,5,2,282433,282433,282435,0,2,2
80943,4,1,282437,282437,282438,0,1,2
80944,6,3,282443,282443,282446,0,3,5
80945,6,2,282449,282449,282451,0,2,3
80946,6,2,282455,282455,282457,0,2,4
80947,2,3,282457,282457,282460,0,3,0
80948,2,2,282459,282460,282462,1,3,0
80949,5,1,282464,282464,282465,0,1,2
80950,4,1,282468,282468,282469,0,1,3
80951,4,2,282472,282472,282474,0,2,3
80952,5,3,282477,282477,282480,0,3,3
80953,2,3,282479,282480,282483,1,4,0
80954,1,3,282480,282483,282486,3,6,0
80955,4,1,282484,282486,282487,2,3,0
80956,1,2,282485,282487,282489,2,4,0
80957,6,1,282491,282491,282492,0,1,2
80958,4,2,282495,282495,282497,0,2,3
80959,2,3,282497,282497,282500,0,3,0
80960,6,2,282503,282503,282505,0,2,3
80961,5,2,282508,282508,282510,0,2,3
80962,6,2,282514,282514,282516,0,2,4
80963,5,2,282519,282519,282521,0,2,3
80964,5,1,282524,282524,282525,0,1,3
80965,6,1,282530,282530,282531,0,1,5
80966,2,2,282532,282532,282534,0,2,1
80967,6,3,282538,282538,282541,0,3,4
80968,4,3,282542,282542,282545,0,3,1
80969,3,1,282545,282545,282546,0,1,0
80970,3,1,282548,282548,282549,0,1,2
80971,4,3,282552,282552,282555,0,3,3
80972,5,2,282557,282557,282559,0,2,2
80973,3,1,282560,282560,282561,0,1,1
80974,5,2,282565,282565,282567,0,2,4
80975,2,2,282567,282567,282569,0,2,0
80976,6,1,282573,282573,282574,0,1,4
80977,5,2,282578,282578,282580,0,2,4
80978,2,2,282580,282580,282582,0,2,0
80979,4,1,282584,282584,282585,0,1,2
80980,6,2,282590,282590,282592,0,2,5
80981,1,3,282591,282592,282595,1,4,0
80982,5,1,282596,282596,282597,0,1,1
80983,5,2,282601,282601,282603,0,2,4
80984,1,1,282602,282603,282604,1,2,0
80985,5,2,282607,282607,282609,0,2,3
80986,5,3,282612,282612,282615,0,3,3
80987,1,2,282613,282615,282617,2,4,0
80988,3,1,282616,282617,282618,1,2,0
80989,3,1,282619,282619,282620,0,1,1
80990,2,2,282621,282621,282623,0,2,1
80991,5,2,282626,282626,282628,0,2,3
80992,3,1,282629,282629,282630,0,1,1
80993,5,1,282634,282634,282635,0,1,4
80994,5,2,282639,282639,282641,0,2,4
80995,3,1,282642,282642,282643,0,1,1
80996,3,2,282645,282645,282647,0,2,2
80997,5,1,282650,282650,282651,0,1,3
80998,1,1,282651,282651,282652,0,1,0
80999,5,2,282656,282656,282658,0,2,4
81000,6,2,282662,282662,282664,0,2,4
81001,6,1,282668,282668,282669,0,1,4
81002,2,1,282670,282670,282671,0,1,1
81003,3,1,282673,282673,282674,0,1,2
81004,5,3,282678,282678,282681,0,3,4
81005,2,1,282680,282681,282682,1,2,0
81006,3,3,282683,282683,282686,0,3,1
81007,1,1,282684,282686,282687,2,3,0
81008,3,1,282687,282687,282688,0,1,0
81009,2,3,282689,282689,282692,0,3,1
81010,3,2,282692,282692,282694,0,2,0
81011,3,3,282695,282695,282698,0,3,1
81012,3,3,282698,282698,282701,0,3,0
81013,6,2,282704,282704,282706,0,2,3
81014,2,3,282706,282706,282709,0,3,0
81015,6,3,282712,282712,282715,0,3,3
81016,3,3,282715,282715,282718,0,3,0
81017,3,1,282718,282718,282719,0,1,0
81018,2,2,282720,282720,282722,0,2,1
81019,5,2,282725,282725,282727,0,2,3
81020,1,1,282726,282727,282728,1,2,0
81021,3,3,282729,282729,282732,0,3,1
81022,3,2,282732,282732,282734,0,2,0
81023,1,3,282733,282734,282737,1,4,0
81024,4,1,282737,282737,282738,0,1,0
81025,4,2,282741,282741,282743,0,2,3
81026,4,1,282745,282745,282746,0,1,2
81027,5,1,282750,282750,282751,0,1,4
81028,4,1,282754,282754,282755,0,1,3
81029,2,1,282756,282756,282757,0,1,1
81030,6,3,282762,282762,282765,0,3,5
81031,5,2,282767,282767,282769,0,2,2
81032,3,1,282770,282770,282771,0,1,1
81033,3,1,282773,282773,282774,0,1,2
81034,4,1,282777,282777,282778,0,1,3
81035,3,1,282780,282780,282781,0,1,2
81036,2,1,282782,282782,282783,0,1,1
81037,3,2,282785,282785,282787,0,2,2
81038,2,3,282787,282787,282790,0,3,0
81039,1,2,282788,282790,282792,2,4,0
81040,6,3,282794,282794,282797,0,3,2
81041,6,2,282800,282800,282802,0,2,3
81042,5,2,282805,282805,282807,0,2,3
81043,6,3,282811,282811,282814,0,3,4
81044,5,2,282816,282816,282818,0,2,2
81045,4,2,282820,282820,282822,0,2,2
81046,6,1,282826,282826,282827,0,1,4
81047,3,2,282829,282829,282831,0,2,2
81048,3,2,282832,282832,282834,0,2,1
81049,6,3,282838,282838,282841,0,3,4
81050,1,1,282839,282841,282842,2,3,0
81051,6,1,282845,282845,282846,0,1,3
81052,6,1,282851,282851,282852,0,1,5
81053,3,1,282854,282854,282855,0,1,2
81054,5,1,282859,282859,282860,0,1,4
81055,5,1,282864,282864,282865,0,1,4
81056,6,1,282870,282870,282871,0,1,5
81057,3,2,282873,282873,282875,0,2,2
81058,4,1,282877,282877,282878,0,1,2
81059,6,3,282883,282883,282886,0,3,5
81060,3,3,282886,282886,282889,0,3,0
81061,2,3,282888,282889,282892,1,4,0
81062,1,1,282889,282892,282893,3,4,0
81063,4,1,282893,282893,282894,0,1,0
81064,2,3,282895,282895,282898,0,3,1
81065,3,3,282898,282898,282901,0,3,0
81066,1,3,282899,282901,282904,2,5,0
81067,3,3,282902,282904,282907,2,5,0
81068,1,3,282903,282907,282910,4,7,0
81069,1,2,282904,282910,282912,6,8,0
81070,1,2,282905,282912,282914,7,9,0
81071,2,1,282907,282914,282915,7,8,0
81072,2,1,282909,282915,282916,6,7,0
81073,2,2,282911,282916,282918,5,7,0
81074,3,1,282914,282918,282919,4,5,0
81075,6,3,282920,282920,282923,0,3,1
81076,6,3,282926,282926,282929,0,3,3
81077,5,2,282931,282931,282933,0,2,2
81078,4,2,282935,282935,282937,0,2,2
81079,4,2,282939,282939,282941,0,2,2
81080,6,1,282945,282945,282946,0,1,4
81081,6,1,282951,282951,282952,0,1,5
81082,3,2,282954,282954,282956,0,2,2
81083,2,1,282956,282956,282957,0,1,0
81084,3,1,282959,282959,282960,0,1,2
81085,6,2,282965,282965,282967,0,2,5
81086,4,3,282969,282969,282972,0,3,2
81087,6,3,282975,282975,282978,0,3,3
81088,2,3,282977,282978,282981,1,4,0
81089,3,3,282980,282981,282984,1,4,0
81090,6,3,282986,282986,282989,0,3,2
81091,4,3,282990,282990,282993,0,3,1
81092,1,1,282991,282993,282994,2,3,0
81093,5,1,282996,282996,282997,0,1,2
81094,3,1,282999,282999,283000,0,1,2
81095,4,2,283003,283003,283005,0,2,3
81096,3,3,283006,283006,283009,0,3,1
81097,5,3,283011,283011,283014,0,3,2
81098,4,1,283015,283015,283016,0,1,1
81099,3,2,283018,283018,283020,0,2,2
81100,3,2,283021,283021,283023,0,2,1
81101,6,1,283027,283027,283028,0,1,4
81102,1,2,283028,283028,283030,0,2,0
81103,1,3,283029,283030,283033,1,4,0
81104,2,2,283031,283033,283035,2,4,0
81105,6,2,283037,283037,283039,0,2,2
81106,2,1,283039,283039,283040,0,1,0
81107,3,1,283042,283042,283043,0,1,2
81108,2,2,283044,283044,283046,0,2,1
81109,5,3,283049,283049,283052,0,3,3
81110,3,3,283052,283052,283055,0,3,0
81111,3,2,283055,283055,283057,0,2,0
81112,4,1,283059,283059,283060,0,1,2
81113,1,3,283060,283060,283063,0,3,0
81114,5,1,283065,283065,283066,0,1,2
81115,2,1,283067,283067,283068,0,1,1
81116,5,1,283072,283072,283073,0,1,4
81117,3,3,283075,283075,283078,0,3,2
81118,5,2,283080,283080,283082,0,2,2
81119,1,3,283081,283082,283085,1,4,0
81120,3,3,283084,283085,283088,1,4,0
81121,2,2,283086,283088,283090,2,4,0
81122,5,3,283091,283091,283094,0,3,1
81123,2,3,283093,283094,283097,1,4,0
81124,3,3,283096,283097,283100,1,4,0
81125,5,1,283101,283101,283102,0,1,1
81126,2,2,283103,283103,283105,0,2,1
81127,3,2,283106,283106,283108,0,2,1
81128,3,2,283109,283109,283111,0,2,1
81129,4,2,283113,283113,283115,0,2,2
81130,2,1,283115,283115,283116,0,1,0
81131,1,2,283116,283116,283118,0,2,0
81132,6,1,283122,283122,283123,0,1,4
81133,5,1,283127,283127,283128,0,1,4
81134,3,2,283130,283130,283132,0,2,2
81135,5,1,283135,283135,283136,0,1,3
81136,2,2,283137,283137,283139,0,2,1
81137,6,1,283143,283143,283144,0,1,4
81138,4,1,283147,283147,283148,0,1,3
81139,6,2,283153,283153,283155,0,2,5
81140,4,2,283157,283157,283159,0,2,2
81141,5,2,283162,283162,283164,0,2,3
81142,6,2,283168,283168,283170,0,2,4
81143,6,3,283174,283174,283177,0,3,4
81144,4,1,283178,283178,283179,0,1,1
81145,2,2,283180,283180,283182,0,2,1
81146,6,3,283186,283186,283189,0,3,4
81147,1,2,283187,283189,283191,2,4,0
81148,1,1,283188,283191,283192,3,4,0
81149,1,3,283189,283192,283195,3,6,0
81150,4,1,283193,283195,283196,2,3,0
81151,1,1,283194,283196,283197,2,3,0
81152,4,1,283198,283198,283199,0,1,1
81153,3,2,283201,283201,283203,0,2,2
81154,4,2,283205,283205,283207,0,2,2
81155,2,1,283207,283207,283208,0,1,0
81156,1,1,283208,283208,283209,0,1,0
81157,3,2,283211,283211,283213,0,2,2
81158,1,2,283212,283213,283215,1,3,0
81159,5,3,283217,283217,283220,0,3,2
81160,2,1,283219,283220,283221,1,2,0
81161,3,2,283222,283222,283224,0,2,1
81162,3,1,283225,283225,283226,0,1,1
81163,1,1,283226,283226,283227,0,1,0
81164,2,3,283228,283228,283231,0,3,1
81165,3,3,283231,283231,283234,0,3,0
81166,4,1,283235,283235,283236,0,1,1
81167,1,1,283236,283236,283237,0,1,0
81168,3,3,283239,283239,283242,0,3,2
81169,1,3,283240,283242,283245,2,5,0
81170,1,3,283241,283245,283248,4,7,0
81171,6,2,283247,283248,283250,1,3,0
81172,6,3,283253,283253,283256,0,3,3
81173,3,1,283256,283256,283257,0,1,0
81174,2,2,283258,283258,283260,0,2,1
81175,1,2,283259,283260,283262,1,3,0
81176,6,3,283265,283265,283268,0,3,3
81177,4,2,283269,283269,283271,0,2,1
81178,2,3,283271,283271,283274,0,3,0
81179,1,2,283272,283274,283276,2,4,0
81180,2,1,283274,283276,283277,2,3,0
81181,4,3,283278,283278,283281,0,3,1
81182,1,3,283279,283281,283284,2,5,0
81183,5,2,283284,283284,283286,0,2,0
81184,1,1,283285,283286,283287,1,2,0
81185,3,1,283288,283288,283289,0,1,1
81186,6,3,283294,283294,283297,0,3,5
81187,1,1,283295,283297,283298,2,3,0
81188,2,1,283297,283298,283299,1,2,0
81189,1,2,283298,283299,283301,1,3,0
81190,5,2,283303,283303,283305,0,2,2
81191,5,2,283308,283308,283310,0,2,3
81192,6,3,283314,283314,283317,0,3,4
81193,1,2,283315,283317,283319,2,4,0
81194,6,2,283321,283321,283323,0,2,2
81195,3,3,283324,283324,283327,0,3,1
81196,6,3,283330,283330,283333,0,3,3
81197,2,3,283332,283333,283336,1,4,0
81198,2,3,283334,283336,283339,2,5,0
81199,3,1,283337,283339,283340,2,3,0
81200,4,2,283341,283341,283343,0,2,1
81201,5,1,283346,283346,283347,0,1,3
81202,1,1,283347,283347,283348,0,1,0
81203,2,1,283349,283349,283350,0,1,1
81204,5,1,283354,283354,283355,0,1,4
81205,6,2,283360,283360,283362,0,2,5
81206,6,2,283366,283366,283368,0,2,4
81207,2,3,283368,283368,283371,0,3,0
81208,6,1,283374,283374,283375,0,1,3
81209,3,3,283377,283377,283380,0,3,2
81210,6,3,283383,283383,283386,0,3,3
81211,5,3,283388,283388,283391,0,3,2
81212,2,2,283390,283391,283393,1,3,0
81213,2,3,283392,283393,283396,1,4,0
81214,5,3,283397,283397,283400,0,3,1
81215,2,3,283399,283400,283403,1,4,0
81216,1,3,283400,283403,283406,3,6,0
81217,5,2,283405,283406,283408,1,3,0
81218,4,1,283409,283409,283410,0,1,1
81219,6,2,283415,283415,283417,0,2,5
81220,1,3,283416,283417,283420,1,4,0
81221,3,2,283419,283420,283422,1,3,0
81222,5,1,283424,283424,283425,0,1,2
81223,2,3,283426,283426,283429,0,3,1
81224,2,3,283428,283429,283432,1,4,0
81225,5,1,283433,283433,283434,0,1,1
81226,1,2,283434,283434,283436,0,2,0
81227,6,2,283440,283440,283442,0,2,4
81228,2,2,283442,283442,283444,0,2,0
81229,1,2,283443,283444,283446,1,3,0
81230,1,2,283444,283446,283448,2,4,0
81231,2,1,283446,283448,283449,2,3,0
81232,3,1,283449,283449,283450,0,1,0
81233,3,1,283452,283452,283453,0,1,2
81234,5,2,283457,283457,283459,0,2,4
81235,2,2,283459,283459,283461,0,2,0
81236,3,1,283462,283462,283463,0,1,1
81237,2,2,283464,283464,283466,0,2,1
81238,3,2,283467,283467,283469,0,2,1
81239,5,3,283472,283472,283475,0,3,3
81240,4,2,283476,283476,283478,0,2,1
81241,6,2,283482,283482,283484,0,2,4
81242,1,1,283483,283484,283485,1,2,0
81243,5,2,283488,283488,283490,0,2,3
81244,5,3,283493,283493,283496,0,3,3
81245,6,1,283499,283499,283500,0,1,3
81246,2,1,283501,283501,283502,0,1,1
81247,6,2,283507,283507,283509,0,2,5
81248,5,3,283512,283512,283515,0,3,3
81249,4,2,283516,283516,283518,0,2,1
81250,3,3,283519,283519,283522,0,3,1
81251,3,2,283522,283522,283524,0,2,0
81252,5,1,283527,283527,283528,0,1,3
81253,1,2,283528,283528,283530,0,2,0
81254,2,2,283530,283530,283532,0,2,0
81255,5,3,283535,283535,283538,0,3,3
81256,2,3,283537,283538,283541,1,4,0
81257,4,2,283541,283541,283543,0,2,0
81258,2,2,283543,283543,283545,0,2,0
81259,6,1,283549,283549,283550,0,1,4
81260,4,3,283553,283553,283556,0,3,3
81261,2,1,283555,283556,283557,1,2,0
81262,6,3,283561,283561,283564,0,3,4
81263,4,1,283565,283565,283566,0,1,1
81264,4,1,283569,283569,283570,0,1,3
81265,1,1,283570,283570,283571,0,1,0
81266,6,1,283576,283576,283577,0,1,5
81267,6,3,283582,283582,283585,0,3,5
81268,5,3,283587,283587,283590,0,3,2
81269,4,2,283591,283591,283593,0,2,1
81270,3,3,283594,283594,283597,0,3,1
81271,1,1,283595,283597,283598,2,3,0
81272,3,3,283598,283598,283601,0,3,0
81273,4,1,283602,283602,283603,0,1,1
81274,3,2,283605,283605,283607,0,2,2
81275,4,1,283609,283609,283610,0,1,2
81276,4,3,283613,283613,283616,0,3,3
81277,1,1,283614,283616,283617,2,3,0
81278,2,3,283616,283617,283620,1,4,0
81279,4,2,283620,283620,283622,0,2,0
81280,4,2,283624,283624,283626,0,2,2
81281,3,3,283627,283627,283630,0,3,1
81282,2,2,283629,283630,283632,1,3,0
81283,4,1,283633,283633,283634,0,1,1
81284,5,3,283638,283638,283641,0,3,4
81285,5,1,283643,283643,283644,0,1,2
81286,5,2,283648,283648,283650,0,2,4
81287,3,1,283651,283651,283652,0,1,1
81288,5,1,283656,283656,283657,0,1,4
81289,1,1,283657,283657,283658,0,1,0
81290,6,2,283663,283663,283665,0,2,5
81291,3,1,283666,283666,283667,0,1,1
81292,1,2,283667,283667,283669,0,2,0
81293,3,1,283670,283670,283671,0,1,1
81294,5,1,283675,283675,283676,0,1,4
81295,1,3,283676,283676,283679,0,3,0
81296,6,1,283682,283682,283683,0,1,3
81297,3,1,283685,283685,283686,0,1,2
81298,3,2,283688,283688,283690,0,2,2
81299,3,3,283691,283691,283694,0,3,1
81300,3,1,283694,283694,283695,0,1,0
81301,2,2,283696,283696,283698,0,2,1
81302,5,3,283701,283701,283704,0,3,3
81303,5,3,283706,283706,283709,0,3,2
81304,4,2,283710,283710,283712,0,2,1
81305,6,3,283716,283716,283719,0,3,4
81306,1,1,283717,283719,283720,2,3,0
81307,3,1,283720,283720,283721,0,1,0
81308,6,3,283726,283726,283729,0,3,5
81309,2,3,283728,283729,283732,1,4,0
81310,6,2,283734,283734,283736,0,2,2
81311,6,3,283740,283740,283743,0,3,4
81312,2,3,283742,283743,283746,1,4,0
81313,5,2,283747,283747,283749,0,2,1
81314,4,2,283751,283751,283753,0,2,2
81315,5,3,283756,283756,283759,0,3,3
81316,1,2,283757,283759,283761,2,4,0
81317,3,2,283760,283761,283763,1,3,0
81318,3,3,283763,283763,283766,0,3,0
81319,6,1,283769,283769,283770,0,1,3
81320,4,1,283773,283773,283774,0,1,3
81321,6,3,283779,283779,283782,0,3,5
81322,5,3,283784,283784,283787,0,3,2
81323,2,2,283786,283787,283789,1,3,0
81324,1,1,283787,283789,283790,2,3,0
81325,3,2,283790,283790,283792,0,2,0
81326,6,1,283796,283796,283797,0,1,4
81327,1,3,283797,283797,283800,0,3,0
81328,6,2,283803,283803,283805,0,2,3
81329,4,3,283807,283807,283810,0,3,2
81330,2,1,283809,283810,283811,1,2,0
81331,3,2,283812,283812,283814,0,2,1
81332,5,3,283817,283817,283820,0,3,3
81333,1,3,283818,283820,283823,2,5,0
81334,6,1,283824,283824,283825,0,1,1
81335,5,2,283829,283829,283831,0,2,4
81336,2,1,283831,283831,283832,0,1,0
81337,4,1,283835,283835,283836,0,1,3
81338,3,1,283838,283838,283839,0,1,2
81339,2,1,283840,283840,283841,0,1,1
81340,6,3,283846,283846,283849,0,3,5
81341,3,2,283849,283849,283851,0,2,0
81342,3,1,283852,283852,283853,0,1,1
81343,4,3,283856,283856,283859,0,3,3
81344,6,3,283862,283862,283865,0,3,3
81345,5,3,283867,283867,283870,0,3,2
81346,3,3,283870,283870,283873,0,3,0
81347,2,3,283872,283873,283876,1,4,0
81348,1,2,283873,283876,283878,3,5,0
81349,3,1,283876,283878,283879,2,3,0
81350,5,2,283881,283881,283883,0,2,2
81351,4,1,283885,283885,283886,0,1,2
81352,5,3,283890,283890,283893,0,3,4
81353,5,2,283895,283895,283897,0,2,2
81354,6,1,283901,283901,283902,0,1,4
81355,1,1,283902,283902,283903,0,1,0
81356,3,3,283905,283905,283908,0,3,2
81357,3,3,283908,283908,283911,0,3,0
81358,4,3,283912,283912,283915,0,3,1
81359,1,1,283913,283915,283916,2,3,0
81360,3,3,283916,283916,283919,0,3,0
81361,1,2,283917,283919,283921,2,4,0
81362,2,1,283919,283921,283922,2,3,0
81363,2,3,283921,283922,283925,1,4,0
81364,6,2,283927,283927,283929,0,2,2
81365,5,2,283932,283932,283934,0,2,3
81366,4,3,283936,283936,283939,0,3,2
81367,2,2,283938,283939,283941,1,3,0
81368,1,3,283939,283941,283944,2,5,0
81369,6,3,283945,283945,283948,0,3,1
81370,1,2,283946,283948,283950,2,4,0
81371,3,1,283949,283950,283951,1,2,0
81372,1,3,283950,283951,283954,1,4,0
81373,5,2,283955,283955,283957,0,2,1
81374,1,2,283956,283957,283959,1,3,0
81375,6,1,283962,283962,283963,0,1,3
81376,4,1,283966,283966,283967,0,1,3
81377,1,2,283967,283967,283969,0,2,0
81378,5,2,283972,283972,283974,0,2,3
81379,5,3,283977,283977,283980,0,3,3
81380,1,2,283978,283980,283982,2,4,0
81381,3,3,283981,283982,283985,1,4,0
81382,4,2,283985,283985,283987,0,2,0
81383,3,3,283988,283988,283991,0,3,1
81384,2,3,283990,283991,283994,1,4,0
81385,4,1,283994,283994,283995,0,1,0
81386,1,2,283995,283995,283997,0,2,0
81387,5,2,284000,284000,284002,0,2,3
81388,5,3,284005,284005,284008,0,3,3
81389,2,1,284007,284008,284009,1,2,0
81390,6,1,284013,284013,284014,0,1,4
81391,1,3,284014,284014,284017,0,3,0
81392,1,2,284015,284017,284019,2,4,0
81393,1,3,284016,284019,284022,3,6,0
81394,5,1,284021,284022,284023,1,2,0
81395,6,2,284027,284027,284029,0,2,4
81396,6,2,284033,284033,284035,0,2,4
81397,1,3,284034,284035,284038,1,4,0
81398,3,2,284037,284038,284040,1,3,0
81399,3,1,284040,284040,284041,0,1,0
81400,1,3,284041,284041,284044,0,3,0
81401,6,1,284047,284047,284048,0,1,3
81402,1,1,284048,284048,284049,0,1,0
81403,1,3,284049,284049,284052,0,3,0
81404,5,1,284054,284054,284055,0,1,2
81405,1,3,284055,284055,284058,0,3,0
81406,1,3,284056,284058,284061,2,5,0
81407,4,3,284060,284061,284064,1,4,0
81408,2,3,284062,284064,284067,2,5,0
81409,3,2,284065,284067,284069,2,4,0
81410,1,1,284066,284069,284070,3,4,0
81411,2,2,284068,284070,284072,2,4,0
81412,4,3,284072,284072,284075,0,3,0
81413,5,1,284077,284077,284078,0,1,2
81414,6,2,284083,284083,284085,0,2,5
81415,6,1,284089,284089,284090,0,1,4
81416,4,1,284093,284093,284094,0,1,3
81417,3,3,284096,284096,284099,0,3,2
81418,5,3,284101,284101,284104,0,3,2
81419,5,1,284106,284106,284107,0,1,2
81420,3,1,284109,284109,284110,0,1,2
81421,3,2,284112,284112,284114,0,2,2
81422,2,3,284114,284114,284117,0,3,0
81423,5,2,284119,284119,284121,0,2,2
81424,1,3,284120,284121,284124,1,4,0
81425,2,2,284122,284124,284126,2,4,0
81426,6,2,284128,284128,284130,0,2,2
81427,4,2,284132,284132,284134,0,2,2
81428,5,3,284137,284137,284140,0,3,3
81429,5,2,284142,284142,284144,0,2,2
81430,5,3,284147,284147,284150,0,3,3
81431,4,2,284151,284151,284153,0,2,1
81432,1,2,284152,284153,284155,1,3,0
81433,5,3,284157,284157,284160,0,3,2
81434,6,3,284163,284163,284166,0,3,3
81435,2,1,284165,284166,284167,1,2,0
81436,4,2,284169,284169,284171,0,2,2
81437,5,1,284174,284174,284175,0,1,3
81438,6,2,284180,284180,284182,0,2,5
81439,6,2,284186,284186,284188,0,2,4
81440,6,3,284192,284192,284195,0,3,4
81441,4,2,284196,284196,284198,0,2,1
81442,6,3,284202,284202,284205,0,3,4
81443,3,1,284205,284205,284206,0,1,0
81444,3,2,284208,284208,284210,0,2,2
81445,3,3,284211,284211,284214,0,3,1
81446,6,3,284217,284217,284220,0,3,3
81447,3,3,284220,284220,284223,0,3,0
81448,2,2,284222,284223,284225,1,3,0
81449,1,2,284223,284225,284227,2,4,0
81450,2,2,284225,284227,284229,2,4,0
81451,1,1,284226,284229,284230,3,4,0
81452,4,1,284230,284230,284231,0,1,0
81453,2,3,284232,284232,284235,0,3,1
81454,2,1,284234,284235,284236,1,2,0
81455,5,1,284239,284239,284240,0,1,3
81456,5,3,284244,284244,284247,0,3,4
81457,5,2,284249,284249,284251,0,2,2
81458,1,1,284250,284251,284252,1,2,0
81459,6,2,284256,284256,284258,0,2,4
81460,1,1,284257,284258,284259,1,2,0
81461,3,2,284260,284260,284262,0,2,1
81462,5,1,284265,284265,284266,0,1,3
81463,3,3,284268,284268,284271,0,3,2
81464,3,1,284271,284271,284272,0,1,0
81465,1,1,284272,284272,284273,0,1,0
81466,5,1,284277,284277,284278,0,1,4
81467,6,3,284283,284283,284286,0,3,5
81468,5,3,284288,284288,284291,0,3,2
81469,1,2,284289,284291,284293,2,4,0
81470,5,2,284294,284294,284296,0,2,1
81471,3,3,284297,284297,284300,0,3,1
81472,6,1,284303,284303,284304,0,1,3
81473,4,3,284307,284307,284310,0,3,3
81474,5,1,284312,284312,284313,0,1,2
81475,1,2,284313,284313,284315,0,2,0
81476,2,3,284315,284315,284318,0,3,0
81477,5,2,284320,284320,284322,0,2,2
81478,3,2,284323,284323,284325,0,2,1
81479,3,3,284326,284326,284329,0,3,1
81480,2,2,284328,284329,284331,1,3,0
81481,1,3,284329,284331,284334,2,5,0
81482,3,3,284332,284334,284337,2,5,0
81483,4,3,284336,284337,284340,1,4,0
81484,6,3,284342,284342,284345,0,3,2
81485,5,2,284347,284347,284349,0,2,2
81486,2,2,284349,284349,284351,0,2,0
81487,2,3,284351,284351,284354,0,3,0
81488,4,2,284355,284355,284357,0,2,1
81489,3,3,284358,284358,284361,0,3,1
81490,1,3,284359,284361,284364,2,5,0
81491,2,1,284361,284364,284365,3,4,0
81492,4,3,284365,284365,284368,0,3,0
81493,5,1,284370,284370,284371,0,1,2
81494,6,2,284376,284376,284378,0,2,5
81495,2,2,284378,284378,284380,0,2,0
81496,5,3,284383,284383,284386,0,3,3
81497,5,2,284388,284388,284390,0,2,2
81498,1,3,284389,284390,284393,1,4,0
81499,3,3,284392,284393,284396,1,4,0
81500,3,2,284395,284396,284398,1,3,0
81501,2,3,284397,284398,284401,1,4,0
81502,1,3,284398,284401,284404,3,6,0
81503,6,3,284404,284404,284407,0,3,0
81504,4,2,284408,284408,284410,0,2,1
81505,1,1,284409,284410,284411,1,2,0
81506,5,1,284414,284414,284415,0,1,3
81507,5,2,284419,284419,284421,0,2,4
81508,1,2,284420,284421,284423,1,3,0
81509,3,2,284423,284423,284425,0,2,0
81510,4,3,284427,284427,284430,0,3,2
81511,6,2,284433,284433,284435,0,2,3
81512,5,3,284438,284438,284441,0,3,3
81513,6,3,284444,284444,284447,0,3,3
81514,6,3,284450,284450,284453,0,3,3
81515,4,3,284454,284454,284457,0,3,1
81516,3,1,284457,284457,284458,0,1,0
81517,3,3,284460,284460,284463,0,3,2
81518,1,3,284461,284463,284466,2,5,0
81519,2,1,284463,284466,284467,3,4,0
81520,1,1,284464,284467,284468,3,4,0
81521,2,3,284466,284468,284471,2,5,0
81522,4,1,284470,284471,284472,1,2,0
81523,6,3,284476,284476,284479,0,3,4
81524,5,3,284481,284481,284484,0,3,2
81525,5,1,284486,284486,284487,0,1,2
81526,6,1,284492,284492,284493,0,1,5
81527,2,3,284494,284494,284497,0,3,1
81528,4,1,284498,284498,284499,0,1,1
81529,2,2,284500,284500,284502,0,2,1
81530,4,2,284504,284504,284506,0,2,2
81531,3,1,284507,284507,284508,0,1,1
81532,3,2,284510,284510,284512,0,2,2
81533,5,3,284515,284515,284518,0,3,3
81534,3,1,284518,284518,284519,0,1,0
81535,4,2,284522,284522,284524,0,2,3
81536,5,1,284527,284527,284528,0,1,3
81537,6,3,284533,284533,284536,0,3,5
81538,6,1,284539,284539,284540,0,1,3
81539,1,1,284540,284540,284541,0,1,0
81540,3,2,284543,284543,284545,0,2,2
81541,1,3,284544,284545,284548,1,4,0
81542,2,1,284546,284548,284549,2,3,0
81543,1,2,284547,284549,284551,2,4,0
81544,1,2,284548,284551,284553,3,5,0
81545,6,1,284554,284554,284555,0,1,1
81546,1,2,284555,284555,284557,0,2,0
81547,1,3,284556,284557,284560,1,4,0
81548,3,1,284559,284560,284561,1,2,0
81549,5,1,284564,284564,284565,0,1,3
81550,6,3,284570,284570,284573,0,3,5
81551,6,1,284576,284576,284577,0,1,3
81552,2,1,284578,284578,284579,0,1,1
81553,6,2,284584,284584,284586,0,2,5
81554,1,3,284585,284586,284589,1,4,0
81555,3,3,284588,284589,284592,1,4,0
81556,6,3,284594,284594,284597,0,3,2
81557,6,2,284600,284600,284602,0,2,3
81558,6,1,284606,284606,284607,0,1,4
81559,3,2,284609,284609,284611,0,2,2
81560,5,1,284614,284614,284615,0,1,3
81561,5,3,284619,284619,284622,0,3,4
81562,1,3,284620,284622,284625,2,5,0
81563,4,1,284624,284625,284626,1,2,0
81564,2,2,284626,284626,284628,0,2,0
81565,3,2,284629,284629,284631,0,2,1
81566,6,1,284635,284635,284636,0,1,4
81567,6,2,284641,284641,284643,0,2,5
81568,5,3,284646,284646,284649,0,3,3
81569,4,1,284650,284650,284651,0,1,1
81570,2,2,284652,284652,284654,0,2,1
81571,6,1,284658,284658,284659,0,1,4
81572,3,2,284661,284661,284663,0,2,2
81573,1,2,284662,284663,284665,1,3,0
81574,6,3,284668,284668,284671,0,3,3
81575,5,1,284673,284673,284674,0,1,2
81576,4,2,284677,284677,284679,0,2,3
81577,3,3,284680,284680,284683,0,3,1
81578,5,1,284685,284685,284686,0,1,2
81579,2,2,284687,284687,284689,0,2,1
81580,1,3,284688,284689,284692,1,4,0
81581,6,2,284694,284694,284696,0,2,2
81582,4,3,284698,284698,284701,0,3,2
81583,3,3,284701,284701,284704,0,3,0
81584,4,1,284705,284705,284706,0,1,1
81585,1,1,284706,284706,284707,0,1,0
81586,2,2,284708,284708,284710,0,2,1
81587,4,2,284712,284712,284714,0,2,2
81588,2,3,284714,284714,284717,0,3,0
81589,5,1,284719,284719,284720,0,1,2
81590,6,2,284725,284725,284727,0,2,5
81591,2,3,284727,284727,284730,0,3,0
81592,5,2,284732,284732,284734,0,2,2
81593,1,2,284733,284734,284736,1,3,0
81594,4,3,284737,284737,284740,0,3,1
81595,2,2,284739,284740,284742,1,3,0
81596,5,3,284744,284744,284747,0,3,2
81597,4,1,284748,284748,284749,0,1,1
81598,2,2,284750,284750,284752,0,2,1
81599,5,1,284755,284755,284756,0,1,3
81600,3,1,284758,284758,284759,0,1,2
81601,4,3,284762,284762,284765,0,3,3
81602,2,1,284764,284765,284766,1,2,0
81603,1,2,284765,284766,284768,1,3,0
81604,5,1,284770,284770,284771,0,1,2
81605,5,3,284775,284775,284778,0,3,4
81606,2,3,284777,284778,284781,1,4,0
81607,5,2,284782,284782,284784,0,2,1
81608,3,3,284785,284785,284788,0,3,1
81609,6,2,284791,284791,284793,0,2,3
81610,1,2,284792,284793,284795,1,3,0
81611,4,2,284796,284796,284798,0,2,1
81612,2,2,284798,284798,284800,0,2,0
81613,4,2,284802,284802,284804,0,2,2
81614,5,3,284807,284807,284810,0,3,3
81615,3,3,284810,284810,284813,0,3,0
81616,6,1,284816,284816,284817,0,1,3
81617,1,3,284817,284817,284820,0,3,0
81618,3,1,284820,284820,284821,0,1,0
81619,5,3,284825,284825,284828,0,3,4
81620,1,3,284826,284828,284831,2,5,0
81621,1,3,284827,284831,284834,4,7,0
81622,1,2,284828,284834,284836,6,8,0
81623,4,3,284832,284836,284839,4,7,0
81624,4,2,284836,284839,284841,3,5,0
81625,2,3,284838,284841,284844,3,6,0
81626,4,3,284842,284844,284847,2,5,0
81627,5,2,284847,284847,284849,0,2,0
81628,3,3,284850,284850,284853,0,3,1
81629,5,1,284855,284855,284856,0,1,2
81630,6,1,284861,284861,284862,0,1,5
81631,4,2,284865,284865,284867,0,2,3
81632,2,3,284867,284867,284870,0,3,0
81633,2,3,284869,284870,284873,1,4,0
81634,5,1,284874,284874,284875,0,1,1
81635,5,3,284879,284879,284882,0,3,4
81636,4,2,284883,284883,284885,0,2,1
81637,4,1,284887,284887,284888,0,1,2
81638,2,2,284889,284889,284891,0,2,1
81639,4,1,284893,284893,284894,0,1,2
81640,4,3,284897,284897,284900,0,3,3
81641,4,3,284901,284901,284904,0,3,1
81642,1,2,284902,284904,284906,2,4,0
81643,1,3,284903,284906,284909,3,6,0
81644,3,2,284906,284909,284911,3,5,0
81645,6,2,284912,284912,284914,0,2,1
81646,6,1,284918,284918,284919,0,1,4
81647,6,2,284924,284924,284926,0,2,5
81648,4,1,284928,284928,284929,0,1,2
81649,1,2,284929,284929,284931,0,2,0
81650,5,1,284934,284934,284935,0,1,3
81651,2,3,284936,284936,284939,0,3,1
81652,2,3,284938,284939,284942,1,4,0
81653,4,2,284942,284942,284944,0,2,0
81654,5,1,284947,284947,284948,0,1,3
81655,2,3,284949,284949,284952,0,3,1
81656,4,3,284953,284953,284956,0,3,1
81657,4,2,284957,284957,284959,0,2,1
81658,3,1,284960,284960,284961,0,1,1
81659,1,2,284961,284961,284963,0,2,0
81660,2,2,284963,284963,284965,0,2,0
81661,6,1,284969,284969,284970,0,1,4
81662,1,3,284970,284970,284973,0,3,0
81663,6,1,284976,284976,284977,0,1,3
81664,6,1,284982,284982,284983,0,1,5
81665,6,3,284988,284988,284991,0,3,5
81666,3,3,284991,284991,284994,0,3,0
81667,5,1,284996,284996,284997,0,1,2
81668,3,3,284999,284999,285002,0,3,2
81669,6,1,285005,285005,285006,0,1,3
81670,2,3,285007,285007,285010,0,3,1
81671,5,3,285012,285012,285015,0,3,2
81672,5,2,285017,285017,285019,0,2,2
81673,3,3,285020,285020,285023,0,3,1
81674,5,3,285025,285025,285028,0,3,2
81675,2,2,285027,285028,285030,1,3,0
81676,2,2,285029,285030,285032,1,3,0
81677,4,1,285033,285033,285034,0,1,1
81678,5,3,285038,285038,285041,0,3,4
81679,1,3,285039,285041,285044,2,5,0
81680,6,2,285045,285045,285047,0,2,1
81681,1,2,285046,285047,285049,1,3,0
81682,5,2,285051,285051,285053,0,2,2
81683,2,1,285053,285053,285054,0,1,0
81684,2,2,285055,285055,285057,0,2,1
81685,3,1,285058,285058,285059,0,1,1
81686,3,3,285061,285061,285064,0,3,2
81687,6,3,285067,285067,285070,0,3,3
81688,6,1,285073,285073,285074,0,1,3
81689,6,3,285079,285079,285082,0,3,5
81690,1,3,285080,285082,285085,2,5,0
81691,2,3,285082,285085,285088,3,6,0
81692,6,2,285088,285088,285090,0,2,0
81693,1,1,285089,285090,285091,1,2,0
81694,1,1,285090,285091,285092,1,2,0
81695,4,3,285094,285094,285097,0,3,2
81696,3,3,285097,285097,285100,0,3,0
81697,2,1,285099,285100,285101,1,2,0
81698,1,2,285100,285101,285103,1,3,0
81699,5,1,285105,285105,285106,0,1,2
81700,4,1,285109,285109,285110,0,1,3
81701,3,3,285112,285112,285115,0,3,2
81702,1,1,285113,285115,285116,2,3,0
81703,2,1,285115,285116,285117,1,2,0
81704,3,2,285118,285118,285120,0,2,1
81705,1,2,285119,285120,285122,1,3,0
81706,6,2,285125,285125,285127,0,2,3
81707,6,1,285131,285131,285132,0,1,4
81708,4,1,285135,285135,285136,0,1,3
81709,2,3,285137,285137,285140,0,3,1
81710,4,3,285141,285141,285144,0,3,1
81711,1,2,285142,285144,285146,2,4,0
81712,4,1,285146,285146,285147,0,1,0
81713,1,3,285147,285147,285150,0,3,0
81714,5,1,285152,285152,285153,0,1,2
81715,5,2,285157,285157,285159,0,2,4
81716,6,2,285163,285163,285165,0,2,4
81717,3,3,285166,285166,285169,0,3,1
81718,2,2,285168,285169,285171,1,3,0
81719,6,3,285174,285174,285177,0,3,3
81720,3,1,285177,285177,285178,0,1,0
81721,1,2,285178,285178,285180,0,2,0
81722,2,2,285180,285180,285182,0,2,0
81723,6,1,285186,285186,285187,0,1,4
81724,6,2,285192,285192,285194,0,2,5
81725,5,3,285197,285197,285200,0,3,3
81726,2,2,285199,285200,285202,1,3,0
81727,6,2,285205,285205,285207,0,2,3
81728,4,1,285209,285209,285210,0,1,2
81729,6,3,285215,285215,285218,0,3,5
81730,4,3,285219,285219,285222,0,3,1
81731,3,1,285222,285222,285223,0,1,0
81732,4,2,285226,285226,285228,0,2,3
81733,4,2,285230,285230,285232,0,2,2
81734,4,2,285234,285234,285236,0,2,2
81735,4,1,285238,285238,285239,0,1,2
81736,4,1,285242,285242,285243,0,1,3
81737,2,3,285244,285244,285247,0,3,1
81738,3,3,285247,285247,285250,0,3,0
81739,3,3,285250,285250,285253,0,3,0
81740,6,2,285256,285256,285258,0,2,3
81741,4,2,285260,285260,285262,0,2,2
81742,3,2,285263,285263,285265,0,2,1
81743,5,2,285268,285268,285270,0,2,3
81744,3,3,285271,285271,285274,0,3,1
81745,4,1,285275,285275,285276,0,1,1
81746,3,2,285278,285278,285280,0,2,2
81747,6,3,285284,285284,285287,0,3,4
81748,2,2,285286,285287,285289,1,3,0
81749,6,1,285292,285292,285293,0,1,3
81750,6,1,285298,285298,285299,0,1,5
81751,2,1,285300,285300,285301,0,1,1
81752,3,3,285303,285303,285306,0,3,2
81753,6,3,285309,285309,285312,0,3,3
81754,4,1,285313,285313,285314,0,1,1
81755,3,1,285316,285316,285317,0,1,2
81756,4,2,285320,285320,285322,0,2,3
81757,2,3,285322,285322,285325,0,3,0
81758,5,1,285327,285327,285328,0,1,2
81759,6,3,285333,285333,285336,0,3,5
81760,2,2,285335,285336,285338,1,3,0
81761,5,3,285340,285340,285343,0,3,2
81762,2,3,285342,285343,285346,1,4,0
81763,6,2,285348,285348,285350,0,2,2
81764,1,3,285349,285350,285353,1,4,0
81765,1,3,285350,285353,285356,3,6,0
81766,4,2,285354,285356,285358,2,4,0
81767,1,3,285355,285358,285361,3,6,0
81768,6,1,285361,285361,285362,0,1,0
81769,6,1,285367,285367,285368,0,1,5
81770,4,3,285371,285371,285374,0,3,3
81771,6,3,285377,285377,285380,0,3,3
81772,3,1,285380,285380,285381,0,1,0
81773,1,1,285381,285381,285382,0,1,0
81774,1,1,285382,285382,285383,0,1,0
81775,6,2,285388,285388,285390,0,2,5
81776,4,2,285392,285392,285394,0,2,2
81777,1,2,285393,285394,285396,1,3,0
81778,1,2,285394,285396,285398,2,4,0
81779,4,1,285398,285398,285399,0,1,0
81780,4,2,285402,285402,285404,0,2,3
81781,1,1,285403,285404,285405,1,2,0
81782,5,3,285408,285408,285411,0,3,3
81783,2,2,285410,285411,285413,1,3,0
81784,2,2,285412,285413,285415,1,3,0
81785,2,2,285414,285415,285417,1,3,0
81786,2,3,285416,285417,285420,1,4,0
81787,1,3,285417,285420,285423,3,6,0
81788,2,1,285419,285423,285424,4,5,0
81789,3,3,285422,285424,285427,2,5,0
81790,3,1,285425,285427,285428,2,3,0
81791,1,3,285426,285428,285431,2,5,0
81792,2,3,285428,285431,285434,3,6,0
81793,4,2,285432,285434,285436,2,4,0
81794,5,3,285437,285437,285440,0,3,1
81795,1,1,285438,285440,285441,2,3,0
81796,1,1,285439,285441,285442,2,3,0
81797,5,3,285444,285444,285447,0,3,2
81798,3,3,285447,285447,285450,0,3,0
81799,2,1,285449,285450,285451,1,2,0
81800,6,3,285455,285455,285458,0,3,4
81801,3,1,285458,285458,285459,0,1,0
81802,6,3,285464,285464,285467,0,3,5
81803,4,2,285468,285468,285470,0,2,1
81804,4,2,285472,285472,285474,0,2,2
81805,6,2,285478,285478,285480,0,2,4
81806,5,1,285483,285483,285484,0,1,3
81807,4,1,285487,285487,285488,0,1,3
81808,5,2,285492,285492,285494,0,2,4
81809,2,3,285494,285494,285497,0,3,0
81810,5,1,285499,285499,285500,0,1,2
81811,6,2,285505,285505,285507,0,2,5
81812,6,2,285511,285511,285513,0,2,4
81813,2,1,285513,285513,285514,0,1,0
81814,2,2,285515,285515,285517,0,2,1
81815,4,3,285519,285519,285522,0,3,2
81816,3,1,285522,285522,285523,0,1,0
81817,5,2,285527,285527,285529,0,2,4
81818,3,2,285530,285530,285532,0,2,1
81819,6,1,285536,285536,285537,0,1,4
81820,3,3,285539,285539,285542,0,3,2
81821,1,3,285540,285542,285545,2,5,0
81822,1,2,285541,285545,285547,4,6,0
81823,4,1,285545,285547,285548,2,3,0
81824,6,3,285551,285551,285554,0,3,3
81825,1,2,285552,285554,285556,2,4,0
81826,1,2,285553,285556,285558,3,5,0
81827,1,3,285554,285558,285561,4,7,0
81828,2,3,285556,285561,285564,5,8,0
81829,3,2,285559,285564,285566,5,7,0
81830,3,1,285562,285566,285567,4,5,0
81831,1,2,285563,285567,285569,4,6,0
81832,5,1,285568,285569,285570,1,2,0
81833,1,2,285569,285570,285572,1,3,0
81834,4,3,285573,285573,285576,0,3,1
81835,1,3,285574,285576,285579,2,5,0
81836,3,3,285577,285579,285582,2,5,0
81837,5,1,285582,285582,285583,0,1,0
81838,1,3,285583,285583,285586,0,3,0
81839,4,3,285587,285587,285590,0,3,1
81840,6,2,285593,285593,285595,0,2,3
81841,6,2,285599,285599,285601,0,2,4
81842,6,1,285605,285605,285606,0,1,4
81843,2,2,285607,285607,285609,0,2,1
81844,6,3,285613,285613,285616,0,3,4
81845,5,2,285618,285618,285620,0,2,2
81846,1,1,285619,285620,285621,1,2,0
81847,6,3,285625,285625,285628,0,3,4
81848,3,1,285628,285628,285629,0,1,0
81849,3,1,285631,285631,285632,0,1,2
81850,1,3,285632,285632,285635,0,3,0
81851,6,3,285638,285638,285641,0,3,3
81852,4,1,285642,285642,285643,0,1,1
81853,4,2,285646,285646,285648,0,2,3
81854,1,2,285647,285648,285650,1,3,0
81855,6,2,285653,285653,285655,0,2,3
81856,2,2,285655,285655,285657,0,2,0
81857,3,1,285658,285658,285659,0,1,1
81858,4,2,285662,285662,285664,0,2,3
81859,4,2,285666,285666,285668,0,2,2
81860,3,1,285669,285669,285670,0,1,1
81861,3,1,285672,285672,285673,0,1,2
81862,1,1,285673,285673,285674,0,1,0
81863,6,3,285679,285679,285682,0,3,5
81864,2,2,285681,285682,285684,1,3,0
81865,6,2,285687,285687,285689,0,2,3
81866,4,3,285691,285691,285694,0,3,2
81867,1,2,285692,285694,285696,2,4,0
81868,1,1,285693,285696,285697,3,4,0
81869,2,1,285695,285697,285698,2,3,0
81870,2,2,285697,285698,285700,1,3,0
81871,2,1,285699,285700,285701,1,2,0
81872,5,3,285704,285704,285707,0,3,3
81873,6,3,285710,285710,285713,0,3,3
81874,2,3,285712,285713,285716,1,4,0
81875,6,1,285718,285718,285719,0,1,2
81876,6,3,285724,285724,285727,0,3,5
81877,1,2,285725,285727,285729,2,4,0
81878,4,1,285729,285729,285730,0,1,0
81879,3,2,285732,285732,285734,0,2,2
81880,3,3,285735,285735,285738,0,3,1
81881,3,2,285738,285738,285740,0,2,0
81882,5,2,285743,285743,285745,0,2,3
81883,4,3,285747,285747,285750,0,3,2
81884,1,1,285748,285750,285751,2,3,0
81885,2,3,285750,285751,285754,1,4,0
81886,1,3,285751,285754,285757,3,6,0
81887,4,3,285755,285757,285760,2,5,0
81888,1,3,285756,285760,285763,4,7,0
81889,3,3,285759,285763,285766,4,7,0
81890,3,3,285762,285766,285769,4,7,0
81891,3,3,285765,285769,285772,4,7,0
81892,2,2,285767,285772,285774,5,7,0
81893,1,1,285768,285774,285775,6,7,0
81894,6,1,285774,285775,285776,1,2,0
81895,4,2,285778,285778,285780,0,2,2
81896,4,1,285782,285782,285783,0,1,2
81897,2,3,285784,285784,285787,0,3,1
81898,3,1,285787,285787,285788,0,1,0
81899,6,3,285793,285793,285796,0,3,5
81900,2,1,285795,285796,285797,1,2,0
81901,6,3,285801,285801,285804,0,3,4
81902,1,2,285802,285804,285806,2,4,0
81903,3,3,285805,285806,285809,1,4,0
81904,4,3,285809,285809,285812,0,3,0
81905,1,1,285810,285812,285813,2,3,0
81906,3,3,285813,285813,285816,0,3,0
81907,4,2,285817,285817,285819,0,2,1
81908,4,2,285821,285821,285823,0,2,2
81909,2,1,285823,285823,285824,0,1,0
81910,1,1,285824,285824,285825,0,1,0
81911,2,3,285826,285826,285829,0,3,1
81912,5,3,285831,285831,285834,0,3,2
81913,3,1,285834,285834,285835,0,1,0
81914,5,1,285839,285839,285840,0,1,4
81915,4,1,285843,285843,285844,0,1,3
81916,4,1,285847,285847,285848,0,1,3
81917,2,3,285849,285849,285852,0,3,1
81918,2,2,285851,285852,285854,1,3,0
81919,6,3,285857,285857,285860,0,3,3
81920,1,3,285858,285860,285863,2,5,0
81921,2,3,285860,285863,285866,3,6,0
81922,5,3,285865,285866,285869,1,4,0
81923,4,1,285869,285869,285870,0,1,0
81924,6,2,285875,285875,285877,0,2,5
81925,6,1,285881,285881,285882,0,1,4
81926,1,1,285882,285882,285883,0,1,0
81927,2,2,285884,285884,285886,0,2,1
81928,5,2,285889,285889,285891,0,2,3
81929,6,2,285895,285895,285897,0,2,4
81930,5,3,285900,285900,285903,0,3,3
81931,1,1,285901,285903,285904,2,3,0
81932,2,3,285903,285904,285907,1,4,0
81933,6,3,285909,285909,285912,0,3,2
81934,6,1,285915,285915,285916,0,1,3
81935,6,3,285921,285921,285924,0,3,5
81936,6,1,285927,285927,285928,0,1,3
81937,1,3,285928,285928,285931,0,3,0
81938,3,2,285931,285931,285933,0,2,0
81939,2,2,285933,285933,285935,0,2,0
81940,1,3,285934,285935,285938,1,4,0
81941,5,3,285939,285939,285942,0,3,1
81942,4,1,285943,285943,285944,0,1,1
81943,5,1,285948,285948,285949,0,1,4
81944,5,2,285953,285953,285955,0,2,4
81945,4,3,285957,285957,285960,0,3,2
81946,2,1,285959,285960,285961,1,2,0
81947,3,1,285962,285962,285963,0,1,1
81948,2,3,285964,285964,285967,0,3,1
81949,4,3,285968,285968,285971,0,3,1
81950,1,3,285969,285971,285974,2,5,0
81951,1,3,285970,285974,285977,4,7,0
81952,2,3,285972,285977,285980,5,8,0
81953,3,2,285975,285980,285982,5,7,0
81954,3,3,285978,285982,285985,4,7,0
81955,1,3,285979,285985,285988,6,9,0
81956,6,3,285985,285988,285991,3,6,0
81957,4,3,285989,285991,285994,2,5,0
81958,5,2,285994,285994,285996,0,2,0
81959,2,3,285996,285996,285999,0,3,0
81960,5,2,286001,286001,286003,0,2,2
81961,1,2,286002,286003,286005,1,3,0
81962,2,1,286004,286005,286006,1,2,0
81963,6,3,286010,286010,286013,0,3,4
81964,2,3,286012,286013,286016,1,4,0
81965,2,3,286014,286016,286019,2,5,0
81966,5,1,286019,286019,286020,0,1,0
81967,4,3,286023,286023,286026,0,3,3
81968,2,1,286025,286026,286027,1,2,0
81969,5,2,286030,286030,286032,0,2,3
81970,1,3,286031,286032,286035,1,4,0
81971,1,3,286032,286035,286038,3,6,0
81972,3,3,286035,286038,286041,3,6,0
81973,6,3,286041,286041,286044,0,3,0
81974,2,3,286043,286044,286047,1,4,0
81975,5,3,286048,286048,286051,0,3,1
81976,2,2,286050,286051,286053,1,3,0
81977,2,1,286052,286053,286054,1,2,0
81978,6,1,286058,286058,286059,0,1,4
81979,3,2,286061,286061,286063,0,2,2
81980,5,1,286066,286066,286067,0,1,3
81981,4,1,286070,286070,286071,0,1,3
81982,3,2,286073,286073,286075,0,2,2
81983,6,3,286079,286079,286082,0,3,4
81984,6,1,286085,286085,286086,0,1,3
81985,2,1,286087,286087,286088,0,1,1
81986,4,3,286091,286091,286094,0,3,3
81987,3,1,286094,286094,286095,0,1,0
81988,1,2,286095,286095,286097,0,2,0
81989,5,2,286100,286100,286102,0,2,3
81990,2,3,286102,286102,286105,0,3,0
81991,3,1,286105,286105,286106,0,1,0
81992,6,3,286111,286111,286114,0,3,5
81993,1,1,286112,286114,286115,2,3,0
81994,6,3,286118,286118,286121,0,3,3
81995,5,2,286123,286123,286125,0,2,2
81996,6,1,286129,286129,286130,0,1,4
81997,2,1,286131,286131,286132,0,1,1
81998,4,3,286135,286135,286138,0,3,3
81999,1,3,286136,286138,286141,2,5,0
82000,6,3,286142,286142,286145,0,3,1
82001,6,3,286148,286148,286151,0,3,3
82002,3,2,286151,286151,286153,0,2,0
82003,1,3,286152,286153,286156,1,4,0
82004,3,2,286155,286156,286158,1,3,0
82005,5,1,286160,286160,286161,0,1,2
82006,5,1,286165,286165,286166,0,1,4
82007,5,3,286170,286170,286173,0,3,4
82008,5,1,286175,286175,286176,0,1,2
82009,2,3,286177,286177,286180,0,3,1
82010,1,1,286178,286180,286181,2,3,0
82011,1,2,286179,286181,286183,2,4,0
82012,2,3,286181,286183,286186,2,5,0
82013,5,2,286186,286186,286188,0,2,0
82014,6,3,286192,286192,286195,0,3,4
82015,4,2,286196,286196,286198,0,2,1
82016,1,2,286197,286198,286200,1,3,0
82017,4,1,286201,286201,286202,0,1,1
82018,2,1,286203,286203,286204,0,1,1
82019,5,2,286208,286208,286210,0,2,4
82020,5,2,286213,286213,286215,0,2,3
82021,2,3,286215,286215,286218,0,3,0
82022,2,1,286217,286218,286219,1,2,0
82023,4,1,286221,286221,286222,0,1,2
82024,3,1,286224,286224,286225,0,1,2
82025,3,3,286227,286227,286230,0,3,2
82026,5,3,286232,286232,286235,0,3,2
82027,2,2,286234,286235,286237,1,3,0
82028,5,3,286239,286239,286242,0,3,2
82029,1,3,286240,286242,286245,2,5,0
82030,5,1,286245,286245,286246,0,1,0
82031,4,3,286249,286249,286252,0,3,3
82032,4,2,286253,286253,286255,0,2,1
82033,4,1,286257,286257,286258,0,1,2
82034,4,1,286261,286261,286262,0,1,3
82035,1,1,286262,286262,286263,0,1,0
82036,3,2,286265,286265,286267,0,2,2
82037,4,3,286269,286269,286272,0,3,2
82038,2,2,286271,286272,286274,1,3,0
82039,4,1,286275,286275,286276,0,1,1
82040,1,2,286276,286276,286278,0,2,0
82041,1,3,286277,286278,286281,1,4,0
82042,3,1,286280,286281,286282,1,2,0
82043,4,3,286284,286284,286287,0,3,2
82044,1,2,286285,286287,286289,2,4,0
82045,5,2,286290,286290,286292,0,2,1
82046,2,2,286292,286292,286294,0,2,0
82047,4,3,286296,286296,286299,0,3,2
82048,6,3,286302,286302,286305,0,3,3
82049,6,2,286308,286308,286310,0,2,3
82050,2,1,286310,286310,286311,0,1,0
82051,2,1,286312,286312,286313,0,1,1
82052,2,1,286314,286314,286315,0,1,1
82053,4,1,286318,286318,286319,0,1,3
82054,5,2,286323,286323,286325,0,2,4
82055,2,1,286325,286325,286326,0,1,0
82056,2,1,286327,286327,286328,0,1,1
82057,2,1,286329,286329,286330,0,1,1
82058,4,1,286333,286333,286334,0,1,3
82059,3,1,286336,286336,286337,0,1,2
82060,6,3,286342,286342,286345,0,3,5
82061,2,2,286344,286345,286347,1,3,0
82062,2,3,286346,286347,286350,1,4,0
82063,4,1,286350,286350,286351,0,1,0
82064,4,2,286354,286354,286356,0,2,3
82065,2,2,286356,286356,286358,0,2,0
82066,2,2,286358,286358,286360,0,2,0
82067,4,3,286362,286362,286365,0,3,2
82068,6,1,286368,286368,286369,0,1,3
82069,4,2,286372,286372,286374,0,2,3
82070,2,2,286374,286374,286376,0,2,0
82071,6,1,286380,286380,286381,0,1,4
82072,4,2,286384,286384,286386,0,2,3
82073,5,1,286389,286389,286390,0,1,3
82074,4,2,286393,286393,286395,0,2,3
82075,2,2,286395,286395,286397,0,2,0
82076,6,2,286401,286401,286403,0,2,4
82077,5,2,286406,286406,286408,0,2,3
82078,2,3,286408,286408,286411,0,3,0
82079,3,2,286411,286411,286413,0,2,0
82080,2,2,286413,286413,286415,0,2,0
82081,2,3,286415,286415,286418,0,3,0
82082,5,3,286420,286420,286423,0,3,2
82083,2,3,286422,286423,286426,1,4,0
82084,6,3,286428,286428,286431,0,3,2
82085,3,2,286431,286431,286433,0,2,0
82086,3,1,286434,286434,286435,0,1,1
82087,2,3,286436,286436,286439,0,3,1
82088,2,1,286438,286439,286440,1,2,0
82089,4,2,286442,286442,286444,0,2,2
82090,6,3,286448,286448,286451,0,3,4
82091,5,2,286453,286453,286455,0,2,2
82092,1,2,286454,286455,286457,1,3,0
82093,4,1,286458,286458,286459,0,1,1
82094,5,2,286463,286463,286465,0,2,4
82095,2,3,286465,286465,286468,0,3,0
82096,4,2,286469,286469,286471,0,2,1
82097,4,2,286473,286473,286475,0,2,2
82098,1,3,286474,286475,286478,1,4,0
82099,5,2,286479,286479,286481,0,2,1
82100,2,3,286481,286481,286484,0,3,0
82101,6,1,286487,286487,286488,0,1,3
82102,6,1,286493,286493,286494,0,1,5
82103,4,1,286497,286497,286498,0,1,3
82104,4,3,286501,286501,286504,0,3,3
82105,5,1,286506,286506,286507,0,1,2
82106,4,1,286510,286510,286511,0,1,3
82107,4,2,286514,286514,286516,0,2,3
82108,4,1,286518,286518,286519,0,1,2
82109,6,2,286524,286524,286526,0,2,5
82110,1,3,286525,286526,286529,1,4,0
82111,4,3,286529,286529,286532,0,3,0
82112,3,2,286532,286532,286534,0,2,0
82113,4,3,286536,286536,286539,0,3,2
82114,4,1,286540,286540,286541,0,1,1
82115,1,1,286541,286541,286542,0,1,0
82116,3,2,286544,286544,286546,0,2,2
82117,5,2,286549,286549,286551,0,2,3
82118,5,2,286554,286554,286556,0,2,3
82119,2,2,286556,286556,286558,0,2,0
82120,6,1,286562,286562,286563,0,1,4
82121,6,3,286568,286568,286571,0,3,5
82122,6,3,286574,286574,286577,0,3,3
82123,4,1,286578,286578,286579,0,1,1
82124,1,2,286579,286579,286581,0,2,0
82125,6,2,286585,286585,286587,0,2,4
82126,4,1,286589,286589,286590,0,1,2
82127,1,3,286590,286590,286593,0,3,0
82128,4,1,286594,286594,286595,0,1,1
82129,6,1,286600,286600,286601,0,1,5
82130,2,1,286602,286602,286603,0,1,1
82131,6,3,286608,286608,286611,0,3,5
82132,2,1,286610,286611,286612,1,2,0
82133,5,1,286615,286615,286616,0,1,3
82134,2,2,286617,286617,286619,0,2,1
82135,4,2,286621,286621,286623,0,2,2
82136,5,1,286626,286626,286627,0,1,3
82137,2,2,286628,286628,286630,0,2,1
82138,6,2,286634,286634,286636,0,2,4
82139,2,2,286636,286636,286638,0,2,0
82140,1,3,286637,286638,286641,1,4,0
82141,4,2,286641,286641,286643,0,2,0
82142,2,2,286643,286643,286645,0,2,0
82143,6,3,286649,286649,286652,0,3,4
82144,6,3,286655,286655,286658,0,3,3
82145,4,3,286659,286659,286662,0,3,1
82146,1,3,286660,286662,286665,2,5,0
82147,6,3,286666,286666,286669,0,3,1
82148,2,1,286668,286669,286670,1,2,0
82149,2,2,286670,286670,286672,0,2,0
82150,6,1,286676,286676,286677,0,1,4
82151,1,2,286677,286677,286679,0,2,0
82152,4,2,286681,286681,286683,0,2,2
82153,6,3,286687,286687,286690,0,3,4
82154,1,1,286688,286690,286691,2,3,0
82155,6,2,286694,286694,286696,0,2,3
82156,4,1,286698,286698,286699,0,1,2
82157,5,2,286703,286703,286705,0,2,4
82158,5,3,286708,286708,286711,0,3,3
82159,1,3,286709,286711,286714,2,5,0
82160,3,3,286712,286714,286717,2,5,0
82161,5,1,286717,286717,286718,0,1,0
82162,3,1,286720,286720,286721,0,1,2
82163,4,2,286724,286724,286726,0,2,3
82164,3,2,286727,286727,286729,0,2,1
82165,3,2,286730,286730,286732,0,2,1
82166,3,3,286733,286733,286736,0,3,1
82167,4,3,286737,286737,286740,0,3,1
82168,6,3,286743,286743,286746,0,3,3
82169,2,2,286745,286746,286748,1,3,0
82170,3,1,286748,286748,286749,0,1,0
82171,2,2,286750,286750,286752,0,2,1
82172,5,1,286755,286755,286756,0,1,3
82173,5,3,286760,286760,286763,0,3,4
82174,5,3,286765,286765,286768,0,3,2
82175,4,1,286769,286769,286770,0,1,1
82176,2,3,286771,286771,286774,0,3,1
82177,4,3,286775,286775,286778,0,3,1
82178,6,2,286781,286781,286783,0,2,3
82179,5,2,286786,286786,286788,0,2,3
82180,3,2,286789,286789,286791,0,2,1
82181,2,3,286791,286791,286794,0,3,0
82182,1,1,286792,286794,286795,2,3,0
82183,3,1,286795,286795,286796,0,1,0
82184,1,2,286796,286796,286798,0,2,0
82185,5,1,286801,286801,286802,0,1,3
82186,4,1,286805,286805,286806,0,1,3
82187,3,3,286808,286808,286811,0,3,2
82188,3,1,286811,286811,286812,0,1,0
82189,5,2,286816,286816,286818,0,2,4
82190,5,1,286821,286821,286822,0,1,3
82191,1,3,286822,286822,286825,0,3,0
82192,4,1,286826,286826,286827,0,1,1
82193,2,2,286828,286828,286830,0,2,1
82194,5,1,286833,286833,286834,0,1,3
82195,3,2,286836,286836,286838,0,2,2
82196,3,3,286839,286839,286842,0,3,1
82197,5,1,286844,286844,286845,0,1,2
82198,5,3,286849,286849,286852,0,3,4
82199,6,2,286855,286855,286857,0,2,3
82200,3,2,286858,286858,286860,0,2,1
82201,5,3,286863,286863,286866,0,3,3
82202,4,3,286867,286867,286870,0,3,1
82203,3,3,286870,286870,286873,0,3,0
82204,2,3,286872,286873,286876,1,4,0
82205,5,2,286877,286877,286879,0,2,1
82206,3,2,286880,286880,286882,0,2,1
82207,3,3,286883,286883,286886,0,3,1
82208,2,3,286885,286886,286889,1,4,0
82209,4,3,286889,286889,286892,0,3,0
82210,2,2,286891,286892,286894,1,3,0
82211,1,2,286892,286894,286896,2,4,0
82212,5,2,286897,286897,286899,0,2,1
82213,6,1,286903,286903,286904,0,1,4
82214,4,2,286907,286907,286909,0,2,3
82215,5,1,286912,286912,286913,0,1,3
82216,4,3,286916,286916,286919,0,3,3
82217,6,1,286922,286922,286923,0,1,3
82218,6,2,286928,286928,286930,0,2,5
82219,2,3,286930,286930,286933,0,3,0
82220,3,2,286933,286933,286935,0,2,0
82221,6,3,286939,286939,286942,0,3,4
82222,1,2,286940,286942,286944,2,4,0
82223,3,2,286943,286944,286946,1,3,0
82224,2,2,286945,286946,286948,1,3,0
82225,4,1,286949,286949,286950,0,1,1
82226,4,2,286953,286953,286955,0,2,3
82227,4,3,286957,286957,286960,0,3,2
82228,2,2,286959,286960,286962,1,3,0
82229,4,3,286963,286963,286966,0,3,1
82230,6,2,286969,286969,286971,0,2,3
82231,6,2,286975,286975,286977,0,2,4
82232,2,3,286977,286977,286980,0,3,0
82233,5,1,286982,286982,286983,0,1,2
82234,5,3,286987,286987,286990,0,3,4
82235,3,2,286990,286990,286992,0,2,0
82236,3,2,286993,286993,286995,0,2,1
82237,4,1,286997,286997,286998,0,1,2
82238,2,2,286999,286999,287001,0,2,1
82239,5,3,287004,287004,287007,0,3,3
82240,1,2,287005,287007,287009,2,4,0
82241,1,2,287006,287009,287011,3,5,0
82242,3,1,287009,287011,287012,2,3,0
82243,4,1,287013,287013,287014,0,1,1
82244,6,3,287019,287019,287022,0,3,5
82245,2,2,287021,287022,287024,1,3,0
82246,3,1,287024,287024,287025,0,1,0
82247,2,1,287026,287026,287027,0,1,1
82248,4,1,287030,287030,287031,0,1,3
82249,6,1,287036,287036,287037,0,1,5
82250,4,1,287040,287040,287041,0,1,3
82251,1,3,287041,287041,287044,0,3,0
82252,6,2,287047,287047,287049,0,2,3
82253,4,2,287051,287051,287053,0,2,2
82254,4,2,287055,287055,287057,0,2,2
82255,3,1,287058,287058,287059,0,1,1
82256,5,1,287063,287063,287064,0,1,4
82257,4,2,287067,287067,287069,0,2,3
82258,5,1,287072,287072,287073,0,1,3
82259,5,2,287077,287077,287079,0,2,4
82260,5,3,287082,287082,287085,0,3,3
82261,5,3,287087,287087,287090,0,3,2
82262,5,2,287092,287092,287094,0,2,2
82263,4,2,287096,287096,287098,0,2,2
82264,1,2,287097,287098,287100,1,3,0
82265,1,3,287098,287100,287103,2,5,0
82266,2,3,287100,287103,287106,3,6,0
82267,5,3,287105,287106,287109,1,4,0
82268,3,1,287108,287109,287110,1,2,0
82269,1,3,287109,287110,287113,1,4,0
82270,5,3,287114,287114,287117,0,3,1
82271,3,3,287117,287117,287120,0,3,0
82272,1,3,287118,287120,287123,2,5,0
82273,1,2,287119,287123,287125,4,6,0
82274,4,3,287123,287125,287128,2,5,0
82275,3,1,287126,287128,287129,2,3,0
82276,6,1,287132,287132,287133,0,1,3
82277,5,1,287137,287137,287138,0,1,4
82278,1,2,287138,287138,287140,0,2,0
82279,1,1,287139,287140,287141,1,2,0
82280,2,1,287141,287141,287142,0,1,0
82281,2,2,287143,287143,287145,0,2,1
82282,1,1,287144,287145,287146,1,2,0
82283,4,3,287148,287148,287151,0,3,2
82284,1,2,287149,287151,287153,2,4,0
82285,3,1,287152,287153,287154,1,2,0
82286,1,2,287153,287154,287156,1,3,0
82287,6,2,287159,287159,287161,0,2,3
82288,5,3,287164,287164,287167,0,3,3
82289,4,3,287168,287168,287171,0,3,1
82290,4,1,287172,287172,287173,0,1,1
82291,4,3,287176,287176,287179,0,3,3
82292,5,2,287181,287181,287183,0,2,2
82293,5,1,287186,287186,287187,0,1,3
82294,2,1,287188,287188,287189,0,1,1
82295,6,2,287194,287194,287196,0,2,5
82296,6,2,287200,287200,287202,0,2,4
82297,2,3,287202,287202,287205,0,3,0
82298,3,3,287205,287205,287208,0,3,0
82299,6,2,287211,287211,287213,0,2,3
82300,4,2,287215,287215,287217,0,2,2
82301,3,3,287218,287218,287221,0,3,1
82302,1,2,287219,287221,287223,2,4,0
82303,5,3,287224,287224,287227,0,3,1
82304,2,3,287226,287227,287230,1,4,0
82305,1,2,287227,287230,287232,3,5,0
82306,5,2,287232,287232,287234,0,2,0
82307,2,2,287234,287234,287236,0,2,0
82308,4,3,287238,287238,287241,0,3,2
82309,5,3,287243,287243,287246,0,3,2
82310,5,3,287248,287248,287251,0,3,2
82311,5,3,287253,287253,287256,0,3,2
82312,2,3,287255,287256,287259,1,4,0
82313,4,3,287259,287259,287262,0,3,0
82314,6,2,287265,287265,287267,0,2,3
82315,2,1,287267,287267,287268,0,1,0
82316,6,1,287273,287273,287274,0,1,5
82317,1,2,287274,287274,287276,0,2,0
82318,1,2,287275,287276,287278,1,3,0
82319,3,3,287278,287278,287281,0,3,0
82320,5,3,287283,287283,287286,0,3,2
82321,3,1,287286,287286,287287,0,1,0
82322,6,1,287292,287292,287293,0,1,5
82323,2,3,287294,287294,287297,0,3,1
82324,3,1,287297,287297,287298,0,1,0
82325,5,2,287302,287302,287304,0,2,4
82326,3,2,287305,287305,287307,0,2,1
82327,4,1,287309,287309,287310,0,1,2
82328,6,3,287315,287315,287318,0,3,5
82329,5,2,287320,287320,287322,0,2,2
82330,5,2,287325,287325,287327,0,2,3
82331,3,3,287328,287328,287331,0,3,1
82332,6,3,287334,287334,287337,0,3,3
82333,2,1,287336,287337,287338,1,2,0
82334,1,3,287337,287338,287341,1,4,0
82335,2,2,287339,287341,287343,2,4,0
82336,4,3,287343,287343,287346,0,3,0
82337,1,1,287344,287346,287347,2,3,0
82338,4,1,287348,287348,287349,0,1,1
82339,6,2,287354,287354,287356,0,2,5
82340,1,1,287355,287356,287357,1,2,0
82341,5,3,287360,287360,287363,0,3,3
82342,3,3,287363,287363,287366,0,3,0
82343,4,3,287367,287367,287370,0,3,1
82344,1,1,287368,287370,287371,2,3,0
82345,4,2,287372,287372,287374,0,2,1
82346,3,3,287375,287375,287378,0,3,1
82347,2,1,287377,287378,287379,1,2,0
82348,5,1,287382,287382,287383,0,1,3
82349,1,3,287383,287383,287386,0,3,0
82350,5,1,287388,287388,287389,0,1,2
82351,1,1,287389,287389,287390,0,1,0
82352,5,2,287394,287394,287396,0,2,4
82353,2,3,287396,287396,287399,0,3,0
82354,2,1,287398,287399,287400,1,2,0
82355,4,1,287402,287402,287403,0,1,2
82356,6,1,287408,287408,287409,0,1,5
82357,6,1,287414,287414,287415,0,1,5
82358,1,3,287415,287415,287418,0,3,0
82359,4,3,287419,287419,287422,0,3,1
82360,6,2,287425,287425,287427,0,2,3
82361,5,3,287430,287430,287433,0,3,3
82362,3,1,287433,287433,287434,0,1,0
82363,4,3,287437,287437,287440,0,3,3
82364,3,2,287440,287440,287442,0,2,0
82365,5,2,287445,287445,287447,0,2,3
82366,5,2,287450,287450,287452,0,2,3
82367,3,3,287453,287453,287456,0,3,1
82368,3,2,287456,287456,287458,0,2,0
82369,2,3,287458,287458,287461,0,3,0
82370,2,2,287460,287461,287463,1,3,0
82371,6,1,287466,287466,287467,0,1,3
82372,4,3,287470,287470,287473,0,3,3
82373,1,2,287471,287473,287475,2,4,0
82374,1,3,287472,287475,287478,3,6,0
82375,2,2,287474,287478,287480,4,6,0
82376,3,2,287477,287480,287482,3,5,0
82377,6,3,287483,287483,287486,0,3,1
82378,4,2,287487,287487,287489,0,2,1
82379,1,1,287488,287489,287490,1,2,0
82380,3,1,287491,287491,287492,0,1,1
82381,5,3,287496,287496,287499,0,3,4
82382,4,1,287500,287500,287501,0,1,1
82383,2,2,287502,287502,287504,0,2,1
82384,4,3,287506,287506,287509,0,3,2
82385,4,1,287510,287510,287511,0,1,1
82386,3,1,287513,287513,287514,0,1,2
82387,5,2,287518,287518,287520,0,2,4
82388,2,1,287520,287520,287521,0,1,0
82389,6,1,287526,287526,287527,0,1,5
82390,1,2,287527,287527,287529,0,2,0
82391,5,3,287532,287532,287535,0,3,3
82392,2,2,287534,287535,287537,1,3,0
82393,1,2,287535,287537,287539,2,4,0
82394,3,2,287538,287539,287541,1,3,0
82395,1,2,287539,287541,287543,2,4,0
82396,5,3,287544,287544,287547,0,3,1
82397,6,3,287550,287550,287553,0,3,3
82398,5,2,287555,287555,287557,0,2,2
82399,2,3,287557,287557,287560,0,3,0
82400,3,1,287560,287560,287561,0,1,0
82401,3,1,287563,287563,287564,0,1,2
82402,5,3,287568,287568,287571,0,3,4
82403,1,3,287569,287571,287574,2,5,0
82404,4,1,287573,287574,287575,1,2,0
82405,6,1,287579,287579,287580,0,1,4
82406,3,3,287582,287582,287585,0,3,2
82407,4,3,287586,287586,287589,0,3,1
82408,2,2,287588,287589,287591,1,3,0
82409,6,2,287594,287594,287596,0,2,3
82410,3,3,287597,287597,287600,0,3,1
82411,3,3,287600,287600,287603,0,3,0
82412,2,3,287602,287603,287606,1,4,0
82413,1,2,287603,287606,287608,3,5,0
82414,5,2,287608,287608,287610,0,2,0
82415,6,2,287614,287614,287616,0,2,4
82416,3,2,287617,287617,287619,0,2,1
82417,2,3,287619,287619,287622,0,3,0
82418,2,2,287621,287622,287624,1,3,0
82419,3,1,287624,287624,287625,0,1,0
82420,4,1,287628,287628,287629,0,1,3
82421,3,3,287631,287631,287634,0,3,2
82422,4,1,287635,287635,287636,0,1,1
82423,4,3,287639,287639,287642,0,3,3
82424,6,2,287645,287645,287647,0,2,3
82425,2,1,287647,287647,287648,0,1,0
82426,6,3,287653,287653,287656,0,3,5
82427,5,3,287658,287658,287661,0,3,2
82428,6,2,287664,287664,287666,0,2,3
82429,3,1,287667,287667,287668,0,1,1
82430,3,1,287670,287670,287671,0,1,2
82431,3,1,287673,287673,287674,0,1,2
82432,3,3,287676,287676,287679,0,3,2
82433,4,1,287680,287680,287681,0,1,1
82434,3,3,287683,287683,287686,0,3,2
82435,5,2,287688,287688,287690,0,2,2
82436,2,3,287690,287690,287693,0,3,0
82437,2,3,287692,287693,287696,1,4,0
82438,4,2,287696,287696,287698,0,2,0
82439,4,2,287700,287700,287702,0,2,2
82440,1,1,287701,287702,287703,1,2,0
82441,2,1,287703,287703,287704,0,1,0
82442,3,1,287706,287706,287707,0,1,2
82443,4,2,287710,287710,287712,0,2,3
82444,4,3,287714,287714,287717,0,3,2
82445,2,3,287716,287717,287720,1,4,0
82446,2,2,287718,287720,287722,2,4,0
82447,1,2,287719,287722,287724,3,5,0
82448,4,1,287723,287724,287725,1,2,0
82449,6,1,287729,287729,287730,0,1,4
82450,2,1,287731,287731,287732,0,1,1
82451,3,3,287734,287734,287737,0,3,2
82452,3,2,287737,287737,287739,0,2,0
82453,1,1,287738,287739,287740,1,2,0
82454,2,1,287740,287740,287741,0,1,0
82455,6,2,287746,287746,287748,0,2,5
82456,6,1,287752,287752,287753,0,1,4
82457,5,3,287757,287757,287760,0,3,4
82458,6,3,287763,287763,287766,0,3,3
82459,6,1,287769,287769,287770,0,1,3
82460,3,3,287772,287772,287775,0,3,2
82461,4,2,287776,287776,287778,0,2,1
82462,6,1,287782,287782,287783,0,1,4
82463,4,1,287786,287786,287787,0,1,3
82464,3,3,287789,287789,287792,0,3,2
82465,1,1,287790,287792,287793,2,3,0
82466,4,3,287794,287794,287797,0,3,1
82467,2,1,287796,287797,287798,1,2,0
82468,5,3,287801,287801,287804,0,3,3
82469,3,3,287804,287804,287807,0,3,0
82470,2,2,287806,287807,287809,1,3,0
82471,6,1,287812,287812,287813,0,1,3
82472,5,3,287817,287817,287820,0,3,4
82473,4,2,287821,287821,287823,0,2,1
82474,1,2,287822,287823,287825,1,3,0
82475,4,2,287826,287826,287828,0,2,1
82476,6,1,287832,287832,287833,0,1,4
82477,2,3,287834,287834,287837,0,3,1
82478,2,3,287836,287837,287840,1,4,0
82479,6,2,287842,287842,287844,0,2,2
82480,3,3,287845,287845,287848,0,3,1
82481,3,1,287848,287848,287849,0,1,0
82482,1,3,287849,287849,287852,0,3,0
82483,1,2,287850,287852,287854,2,4,0
82484,6,1,287856,287856,287857,0,1,2
82485,6,3,287862,287862,287865,0,3,5
82486,3,2,287865,287865,287867,0,2,0
82487,4,3,287869,287869,287872,0,3,2
82488,5,3,287874,287874,287877,0,3,2
82489,4,1,287878,287878,287879,0,1,1
82490,5,3,287883,287883,287886,0,3,4
82491,4,2,287887,287887,287889,0,2,1
82492,6,1,287893,287893,287894,0,1,4
82493,6,3,287899,287899,287902,0,3,5
82494,6,2,287905,287905,287907,0,2,3
82495,5,3,287910,287910,287913,0,3,3
82496,2,2,287912,287913,287915,1,3,0
82497,5,2,287917,287917,287919,0,2,2
82498,2,3,287919,287919,287922,0,3,0
82499,3,2,287922,287922,287924,0,2,0
82500,4,2,287926,287926,287928,0,2,2
82501,6,1,287932,287932,287933,0,1,4
82502,3,2,287935,287935,287937,0,2,2
82503,3,2,287938,287938,287940,0,2,1
82504,5,2,287943,287943,287945,0,2,3
82505,4,2,287947,287947,287949,0,2,2
82506,3,2,287950,287950,287952,0,2,1
82507,4,2,287954,287954,287956,0,2,2
82508,2,1,287956,287956,287957,0,1,0
82509,3,3,287959,287959,287962,0,3,2
82510,4,2,287963,287963,287965,0,2,1
82511,3,3,287966,287966,287969,0,3,1
82512,2,1,287968,287969,287970,1,2,0
82513,1,2,287969,287970,287972,1,3,0
82514,5,3,287974,287974,287977,0,3,2
82515,5,3,287979,287979,287982,0,3,2
82516,6,1,287985,287985,287986,0,1,3
82517,6,2,287991,287991,287993,0,2,5
82518,6,2,287997,287997,287999,0,2,4
82519,6,2,288003,288003,288005,0,2,4
82520,2,1,288005,288005,288006,0,1,0
82521,6,2,288011,288011,288013,0,2,5
82522,1,2,288012,288013,288015,1,3,0
82523,4,3,288016,288016,288019,0,3,1
82524,3,3,288019,288019,288022,0,3,0
82525,4,1,288023,288023,288024,0,1,1
82526,6,2,288029,288029,288031,0,2,5
82527,3,1,288032,288032,288033,0,1,1
82528,6,1,288038,288038,288039,0,1,5
82529,2,1,288040,288040,288041,0,1,1
82530,2,1,288042,288042,288043,0,1,1
82531,3,1,288045,288045,288046,0,1,2
82532,4,3,288049,288049,288052,0,3,3
82533,2,2,288051,288052,288054,1,3,0
82534,1,1,288052,288054,288055,2,3,0
82535,3,3,288055,288055,288058,0,3,0
82536,6,1,288061,288061,288062,0,1,3
82537,4,1,288065,288065,288066,0,1,3
82538,1,1,288066,288066,288067,0,1,0
82539,3,3,288069,288069,288072,0,3,2
82540,1,3,288070,288072,288075,2,5,0
82541,5,1,288075,288075,288076,0,1,0
82542,2,3,288077,288077,288080,0,3,1
82543,5,1,288082,288082,288083,0,1,2
82544,3,1,288085,288085,288086,0,1,2
82545,1,2,288086,288086,288088,0,2,0
82546,1,2,288087,288088,288090,1,3,0
82547,5,2,288092,288092,288094,0,2,2
82548,1,2,288093,288094,288096,1,3,0
82549,3,3,288096,288096,288099,0,3,0
82550,1,3,288097,288099,288102,2,5,0
82551,2,1,288099,288102,288103,3,4,0
82552,1,1,288100,288103,288104,3,4,0
82553,2,3,288102,288104,288107,2,5,0
82554,4,1,288106,288107,288108,1,2,0
82555,3,3,288109,288109,288112,0,3,1
82556,5,1,288114,288114,288115,0,1,2
82557,6,1,288120,288120,288121,0,1,5
82558,1,2,288121,288121,288123,0,2,0
82559,2,1,288123,288123,288124,0,1,0
82560,1,2,288124,288124,288126,0,2,0
82561,2,1,288126,288126,288127,0,1,0
82562,3,3,288129,288129,288132,0,3,2
82563,6,1,288135,288135,288136,0,1,3
82564,2,3,288137,288137,288140,0,3,1
82565,5,2,288142,288142,288144,0,2,2
82566,4,1,288146,288146,288147,0,1,2
82567,2,2,288148,288148,288150,0,2,1
82568,2,2,288150,288150,288152,0,2,0
82569,2,3,288152,288152,288155,0,3,0
82570,2,2,288154,288155,288157,1,3,0
82571,2,2,288156,288157,288159,1,3,0
82572,6,2,288162,288162,288164,0,2,3
82573,5,1,288167,288167,288168,0,1,3
82574,3,2,288170,288170,288172,0,2,2
82575,1,2,288171,288172,288174,1,3,0
82576,2,3,288173,288174,288177,1,4,0
82577,1,2,288174,288177,288179,3,5,0
82578,5,3,288179,288179,288182,0,3,0
82579,3,1,288182,288182,288183,0,1,0
82580,4,3,288186,288186,288189,0,3,3
82581,4,3,288190,288190,288193,0,3,1
82582,4,3,288194,288194,288197,0,3,1
82583,3,3,288197,288197,288200,0,3,0
82584,5,1,288202,288202,288203,0,1,2
82585,6,2,288208,288208,288210,0,2,5
82586,5,1,288213,288213,288214,0,1,3
82587,5,1,288218,288218,288219,0,1,4
82588,5,3,288223,288223,288226,0,3,4
82589,4,2,288227,288227,288229,0,2,1
82590,6,1,288233,288233,288234,0,1,4
82591,3,1,288236,288236,288237,0,1,2
82592,5,2,288241,288241,288243,0,2,4
82593,3,1,288244,288244,288245,0,1,1
82594,6,3,288250,288250,288253,0,3,5
82595,3,3,288253,288253,288256,0,3,0
82596,6,1,288259,288259,288260,0,1,3
82597,1,3,288260,288260,288263,0,3,0
82598,4,1,288264,288264,288265,0,1,1
82599,1,2,288265,288265,288267,0,2,0
82600,5,2,288270,288270,288272,0,2,3
82601,1,1,288271,288272,288273,1,2,0
82602,6,1,288277,288277,288278,0,1,4
82603,5,3,288282,288282,288285,0,3,4
82604,1,2,288283,288285,288287,2,4,0
82605,4,1,288287,288287,288288,0,1,0
82606,1,2,288288,288288,288290,0,2,0
82607,2,3,288290,288290,288293,0,3,0
82608,5,1,288295,288295,288296,0,1,2
82609,1,1,288296,288296,288297,0,1,0
82610,1,2,288297,288297,288299,0,2,0
82611,6,2,288303,288303,288305,0,2,4
82612,1,2,288304,288305,288307,1,3,0
82613,4,3,288308,288308,288311,0,3,1
82614,2,3,288310,288311,288314,1,4,0
82615,4,1,288314,288314,288315,0,1,0
82616,2,2,288316,288316,288318,0,2,1
82617,6,2,288322,288322,288324,0,2,4
82618,2,3,288324,288324,288327,0,3,0
82619,1,2,288325,288327,288329,2,4,0
82620,3,2,288328,288329,288331,1,3,0
82621,2,2,288330,288331,288333,1,3,0
82622,4,1,288334,288334,288335,0,1,1
82623,2,3,288336,288336,288339,0,3,1
82624,6,1,288342,288342,288343,0,1,3
82625,2,3,288344,288344,288347,0,3,1
82626,5,3,288349,288349,288352,0,3,2
82627,6,3,288355,288355,288358,0,3,3
82628,6,1,288361,288361,288362,0,1,3
82629,3,1,288364,288364,288365,0,1,2
82630,2,3,288366,288366,288369,0,3,1
82631,3,2,288369,288369,288371,0,2,0
82632,3,1,288372,288372,288373,0,1,1
82633,5,1,288377,288377,288378,0,1,4
82634,1,2,288378,288378,288380,0,2,0
82635,3,3,288381,288381,288384,0,3,1
82636,6,1,288387,288387,288388,0,1,3
82637,1,1,288388,288388,288389,0,1,0
82638,2,3,288390,288390,288393,0,3,1
82639,4,2,288394,288394,288396,0,2,1
82640,6,1,288400,288400,288401,0,1,4
82641,4,3,288404,288404,288407,0,3,3
82642,6,2,288410,288410,288412,0,2,3
82643,1,3,288411,288412,288415,1,4,0
82644,2,3,288413,288415,288418,2,5,0
82645,2,2,288415,288418,288420,3,5,0
82646,1,1,288416,288420,288421,4,5,0
82647,2,1,288418,288421,288422,3,4,0
82648,6,3,288424,288424,288427,0,3,2
82649,1,2,288425,288427,288429,2,4,0
82650,5,1,288430,288430,288431,0,1,1
82651,2,1,288432,288432,288433,0,1,1
82652,2,1,288434,288434,288435,0,1,1
82653,6,1,288440,288440,288441,0,1,5
82654,2,2,288442,288442,288444,0,2,1
82655,6,1,288448,288448,288449,0,1,4
82656,5,3,288453,288453,288456,0,3,4
82657,4,2,288457,288457,288459,0,2,1
82658,5,3,288462,288462,288465,0,3,3
82659,3,2,288465,288465,288467,0,2,0
82660,1,1,288466,288467,288468,1,2,0
82661,3,2,288469,288469,288471,0,2,1
82662,2,3,288471,288471,288474,0,3,0
82663,5,3,288476,288476,288479,0,3,2
82664,4,3,288480,288480,288483,0,3,1
82665,6,3,288486,288486,288489,0,3,3
82666,1,3,288487,288489,288492,2,5,0
82667,1,1,288488,288492,288493,4,5,0
82668,1,1,288489,288493,288494,4,5,0
82669,3,2,288492,288494,288496,2,4,0
82670,5,2,288497,288497,288499,0,2,1
82671,3,1,288500,288500,288501,0,1,1
82672,3,1,288503,288503,288504,0,1,2
82673,5,1,288508,288508,288509,0,1,4
82674,4,1,288512,288512,288513,0,1,3
82675,6,1,288518,288518,288519,0,1,5
82676,5,2,288523,288523,288525,0,2,4
82677,6,1,288529,288529,288530,0,1,4
82678,2,2,288531,288531,288533,0,2,1
82679,2,1,288533,288533,288534,0,1,0
82680,6,2,288539,288539,288541,0,2,5
82681,2,2,288541,288541,288543,0,2,0
82682,3,1,288544,288544,288545,0,1,1
82683,2,3,288546,288546,288549,0,3,1
82684,2,3,288548,288549,288552,1,4,0
82685,5,2,288553,288553,288555,0,2,1
82686,5,3,288558,288558,288561,0,3,3
82687,2,3,288560,288561,288564,1,4,0
82688,2,2,288562,288564,288566,2,4,0
82689,6,2,288568,288568,288570,0,2,2
82690,6,3,288574,288574,288577,0,3,4
82691,1,1,288575,288577,288578,2,3,0
82692,3,1,288578,288578,288579,0,1,0
82693,3,2,288581,288581,288583,0,2,2
82694,5,2,288586,288586,288588,0,2,3
82695,1,1,288587,288588,288589,1,2,0
82696,4,3,288591,288591,288594,0,3,2
82697,2,1,288593,288594,288595,1,2,0
82698,1,3,288594,288595,288598,1,4,0
82699,3,2,288597,288598,288600,1,3,0
82700,5,2,288602,288602,288604,0,2,2
82701,3,2,288605,288605,288607,0,2,1
82702,1,1,288606,288607,288608,1,2,0
82703,5,3,288611,288611,288614,0,3,3
82704,5,3,288616,288616,288619,0,3,2
82705,6,3,288622,288622,288625,0,3,3
82706,4,1,288626,288626,288627,0,1,1
82707,2,1,288628,288628,288629,0,1,1
82708,6,1,288634,288634,288635,0,1,5
82709,1,1,288635,288635,288636,0,1,0
82710,1,2,288636,288636,288638,0,2,0
82711,6,3,288642,288642,288645,0,3,4
82712,2,3,288644,288645,288648,1,4,0
82713,6,1,288650,288650,288651,0,1,2
82714,4,2,288654,288654,288656,0,2,3
82715,2,3,288656,288656,288659,0,3,0
82716,4,1,288660,288660,288661,0,1,1
82717,3,2,288663,288663,288665,0,2,2
82718,6,1,288669,288669,288670,0,1,4
82719,4,3,288673,288673,288676,0,3,3
82720,6,3,288679,288679,288682,0,3,3
82721,3,3,288682,288682,288685,0,3,0
82722,5,2,288687,288687,288689,0,2,2
82723,3,2,288690,288690,288692,0,2,1
82724,3,3,288693,288693,288696,0,3,1
82725,4,1,288697,288697,288698,0,1,1
82726,6,1,288703,288703,288704,0,1,5
82727,5,1,288708,288708,288709,0,1,4
82728,4,2,288712,288712,288714,0,2,3
82729,6,2,288718,288718,288720,0,2,4
82730,4,1,288722,288722,288723,0,1,2
82731,6,3,288728,288728,288731,0,3,5
82732,5,2,288733,288733,288735,0,2,2
82733,3,1,288736,288736,288737,0,1,1
82734,5,2,288741,288741,288743,0,2,4
82735,3,2,288744,288744,288746,0,2,1
82736,2,2,288746,288746,288748,0,2,0
82737,1,3,288747,288748,288751,1,4,0
82738,4,3,288751,288751,288754,0,3,0
82739,1,2,288752,288754,288756,2,4,0
82740,5,1,288757,288757,288758,0,1,1
82741,1,3,288758,288758,288761,0,3,0
82742,5,2,288763,288763,288765,0,2,2
82743,6,3,288769,288769,288772,0,3,4
82744,4,3,288773,288773,288776,0,3,1
82745,3,3,288776,288776,288779,0,3,0
82746,6,1,288782,288782,288783,0,1,3
82747,4,2,288786,288786,288788,0,2,3
82748,4,3,288790,288790,288793,0,3,2
82749,6,1,288796,288796,288797,0,1,3
82750,4,2,288800,288800,288802,0,2,3
82751,5,1,288805,288805,288806,0,1,3
82752,6,1,288811,288811,288812,0,1,5
82753,6,2,288817,288817,288819,0,2,5
82754,3,1,288820,288820,288821,0,1,1
82755,3,2,288823,288823,288825,0,2,2
82756,5,2,288828,288828,288830,0,2,3
82757,1,3,288829,288830,288833,1,4,0
82758,1,1,288830,288833,288834,3,4,0
82759,2,3,288832,288834,288837,2,5,0
82760,4,3,288836,288837,288840,1,4,0
82761,3,2,288839,288840,288842,1,3,0
82762,1,1,288840,288842,288843,2,3,0
82763,6,2,288846,288846,288848,0,2,3
82764,3,1,288849,288849,288850,0,1,1
82765,6,2,288855,288855,288857,0,2,5
82766,4,2,288859,288859,288861,0,2,2
82767,4,1,288863,288863,288864,0,1,2
82768,1,2,288864,288864,288866,0,2,0
82769,2,1,288866,288866,288867,0,1,0
82770,6,3,288872,288872,288875,0,3,5
82771,4,1,288876,288876,288877,0,1,1
82772,4,2,288880,288880,288882,0,2,3
82773,6,3,288886,288886,288889,0,3,4
82774,6,2,288892,288892,288894,0,2,3
82775,4,1,288896,288896,288897,0,1,2
82776,6,1,288902,288902,288903,0,1,5
82777,1,3,288903,288903,288906,0,3,0
82778,1,1,288904,288906,288907,2,3,0
82779,2,3,288906,288907,288910,1,4,0
82780,6,2,288912,288912,288914,0,2,2
82781,4,1,288916,288916,288917,0,1,2
82782,6,3,288922,288922,288925,0,3,5
82783,2,2,288924,288925,288927,1,3,0
82784,3,1,288927,288927,288928,0,1,0
82785,3,2,288930,288930,288932,0,2,2
82786,2,2,288932,288932,288934,0,2,0
82787,6,3,288938,288938,288941,0,3,4
82788,5,1,288943,288943,288944,0,1,2
82789,4,2,288947,288947,288949,0,2,3
82790,2,1,288949,288949,288950,0,1,0
82791,1,1,288950,288950,288951,0,1,0
82792,5,3,288955,288955,288958,0,3,4
82793,6,2,288961,288961,288963,0,2,3
82794,6,1,288967,288967,288968,0,1,4
82795,6,2,288973,288973,288975,0,2,5
82796,5,3,288978,288978,288981,0,3,3
82797,6,1,288984,288984,288985,0,1,3
82798,1,2,288985,288985,288987,0,2,0
82799,1,3,288986,288987,288990,1,4,0
82800,4,3,288990,288990,288993,0,3,0
82801,3,3,288993,288993,288996,0,3,0
82802,6,3,288999,288999,289002,0,3,3
82803,2,1,289001,289002,289003,1,2,0
82804,6,1,289007,289007,289008,0,1,4
82805,4,2,289011,289011,289013,0,2,3
82806,4,1,289015,289015,289016,0,1,2
82807,4,2,289019,289019,289021,0,2,3
82808,3,3,289022,289022,289025,0,3,1
82809,5,3,289027,289027,289030,0,3,2
82810,4,3,289031,289031,289034,0,3,1
82811,3,2,289034,289034,289036,0,2,0
82812,6,2,289040,289040,289042,0,2,4
82813,2,2,289042,289042,289044,0,2,0
82814,4,2,289046,289046,289048,0,2,2
82815,5,2,289051,289051,289053,0,2,3
82816,4,3,289055,289055,289058,0,3,2
82817,4,1,289059,289059,289060,0,1,1
82818,2,3,289061,289061,289064,0,3,1
82819,5,3,289066,289066,289069,0,3,2
82820,1,2,289067,289069,289071,2,4,0
82821,3,2,289070,289071,289073,1,3,0
82822,4,1,289074,289074,289075,0,1,1
82823,4,1,289078,289078,289079,0,1,3
82824,5,2,289083,289083,289085,0,2,4
82825,3,1,289086,289086,289087,0,1,1
82826,2,1,289088,289088,289089,0,1,1
82827,2,3,289090,289090,289093,0,3,1
82828,6,3,289096,289096,289099,0,3,3
82829,3,2,289099,289099,289101,0,2,0
82830,3,3,289102,289102,289105,0,3,1
82831,5,3,289107,289107,289110,0,3,2
82832,3,2,289110,289110,289112,0,2,0
82833,3,3,289113,289113,289116,0,3,1
82834,2,1,289115,289116,289117,1,2,0
82835,6,3,289121,289121,289124,0,3,4
82836,4,3,289125,289125,289128,0,3,1
82837,6,2,289131,289131,289133,0,2,3
82838,3,2,289134,289134,289136,0,2,1
82839,1,2,289135,289136,289138,1,3,0
82840,6,3,289141,289141,289144,0,3,3
82841,5,2,289146,289146,289148,0,2,2
82842,4,3,289150,289150,289153,0,3,2
82843,2,1,289152,289153,289154,1,2,0
82844,5,3,289157,289157,289160,0,3,3
82845,1,2,289158,289160,289162,2,4,0
82846,5,3,289163,289163,289166,0,3,1
82847,2,3,289165,289166,289169,1,4,0
82848,3,3,289168,289169,289172,1,4,0
82849,5,1,289173,289173,289174,0,1,1
82850,5,1,289178,289178,289179,0,1,4
82851,5,2,289183,289183,289185,0,2,4
82852,6,1,289189,289189,289190,0,1,4
82853,2,2,289191,289191,289193,0,2,1
82854,6,1,289197,289197,289198,0,1,4
82855,5,3,289202,289202,289205,0,3,4
82856,2,1,289204,289205,289206,1,2,0
82857,2,3,289206,289206,289209,0,3,0
82858,5,3,289211,289211,289214,0,3,2
82859,6,3,289217,289217,289220,0,3,3
82860,2,3,289219,289220,289223,1,4,0
82861,3,2,289222,289223,289225,1,3,0
82862,6,1,289228,289228,289229,0,1,3
82863,6,2,289234,289234,289236,0,2,5
82864,6,2,289240,289240,289242,0,2,4
82865,1,2,289241,289242,289244,1,3,0
82866,2,1,289243,289244,289245,1,2,0
82867,6,2,289249,289249,289251,0,2,4
82868,5,3,289254,289254,289257,0,3,3
82869,4,2,289258,289258,289260,0,2,1
82870,6,2,289264,289264,289266,0,2,4
82871,2,1,289266,289266,289267,0,1,0
82872,3,1,289269,289269,289270,0,1,2
82873,3,3,289272,289272,289275,0,3,2
82874,2,3,289274,289275,289278,1,4,0
82875,4,1,289278,289278,289279,0,1,0
82876,5,2,289283,289283,289285,0,2,4
82877,5,1,289288,289288,289289,0,1,3
82878,1,2,289289,289289,289291,0,2,0
82879,5,3,289294,289294,289297,0,3,3
82880,2,2,289296,289297,289299,1,3,0
82881,6,2,289302,289302,289304,0,2,3
82882,3,1,289305,289305,289306,0,1,1
82883,1,1,289306,289306,289307,0,1,0
82884,3,3,289309,289309,289312,0,3,2
82885,6,1,289315,289315,289316,0,1,3
82886,3,1,289318,289318,289319,0,1,2
82887,5,3,289323,289323,289326,0,3,4
82888,6,1,289329,289329,289330,0,1,3
82889,4,1,289333,289333,289334,0,1,3
82890,2,3,289335,289335,289338,0,3,1
82891,2,3,289337,289338,289341,1,4,0
82892,2,2,289339,289341,289343,2,4,0
82893,4,1,289343,289343,289344,0,1,0
82894,5,3,289348,289348,289351,0,3,4
82895,5,3,289353,289353,289356,0,3,2
82896,1,2,289354,289356,289358,2,4,0
82897,2,2,289356,289358,289360,2,4,0
82898,6,2,289362,289362,289364,0,2,2
82899,5,1,289367,289367,289368,0,1,3
82900,2,2,289369,289369,289371,0,2,1
82901,4,1,289373,289373,289374,0,1,2
82902,5,1,289378,289378,289379,0,1,4
82903,1,2,289379,289379,289381,0,2,0
82904,3,3,289382,289382,289385,0,3,1
82905,1,3,289383,289385,289388,2,5,0
82906,5,1,289388,289388,289389,0,1,0
82907,3,2,289391,289391,289393,0,2,2
82908,6,1,289397,289397,289398,0,1,4
82909,3,2,289400,289400,289402,0,2,2
82910,1,1,289401,289402,289403,1,2,0
82911,2,2,289403,289403,289405,0,2,0
82912,1,1,289404,289405,289406,1,2,0
82913,6,3,289410,289410,289413,0,3,4
82914,5,3,289415,289415,289418,0,3,2
82915,6,1,289421,289421,289422,0,1,3
82916,4,3,289425,289425,289428,0,3,3
82917,4,2,289429,289429,289431,0,2,1
82918,4,1,289433,289433,289434,0,1,2
82919,4,2,289437,289437,289439,0,2,3
82920,1,3,289438,289439,289442,1,4,0
82921,1,3,289439,289442,289445,3,6,0
82922,3,3,289442,289445,289448,3,6,0
82923,5,3,289447,289448,289451,1,4,0
82924,3,1,289450,289451,289452,1,2,0
82925,5,3,289455,289455,289458,0,3,3
82926,2,2,289457,289458,289460,1,3,0
82927,2,2,289459,289460,289462,1,3,0
82928,1,1,289460,289462,289463,2,3,0
82929,3,3,289463,289463,289466,0,3,0
82930,3,1,289466,289466,289467,0,1,0
82931,2,3,289468,289468,289471,0,3,1
82932,2,1,289470,289471,289472,1,2,0
82933,5,1,289475,289475,289476,0,1,3
82934,3,2,289478,289478,289480,0,2,2
82935,5,1,289483,289483,289484,0,1,3
82936,5,1,289488,289488,289489,0,1,4
82937,1,3,289489,289489,289492,0,3,0
82938,3,2,289492,289492,289494,0,2,0
82939,1,3,289493,289494,289497,1,4,0
82940,1,1,289494,289497,289498,3,4,0
82941,5,2,289499,289499,289501,0,2,1
82942,4,2,289503,289503,289505,0,2,2
82943,5,3,289508,289508,289511,0,3,3
82944,1,1,289509,289511,289512,2,3,0
82945,5,3,289514,289514,289517,0,3,2
82946,6,3,289520,289520,289523,0,3,3
82947,1,3,289521,289523,289526,2,5,0
82948,5,3,289526,289526,289529,0,3,0
82949,4,2,289530,289530,289532,0,2,1
82950,5,2,289535,289535,289537,0,2,3
82951,5,3,289540,289540,289543,0,3,3
82952,1,2,289541,289543,289545,2,4,0
82953,4,1,289545,289545,289546,0,1,0
82954,4,3,289549,289549,289552,0,3,3
82955,1,2,289550,289552,289554,2,4,0
82956,2,3,289552,289554,289557,2,5,0
82957,4,2,289556,289557,289559,1,3,0
82958,4,3,289560,289560,289563,0,3,1
82959,5,3,289565,289565,289568,0,3,2
82960,4,1,289569,289569,289570,0,1,1
82961,6,2,289575,289575,289577,0,2,5
82962,1,1,289576,289577,289578,1,2,0
82963,3,1,289579,289579,289580,0,1,1
82964,4,2,289583,289583,289585,0,2,3
82965,6,1,289589,289589,289590,0,1,4
82966,2,2,289591,289591,289593,0,2,1
82967,3,3,289594,289594,289597,0,3,1
82968,2,2,289596,289597,289599,1,3,0
82969,3,2,289599,289599,289601,0,2,0
82970,5,1,289604,289604,289605,0,1,3
82971,2,2,289606,289606,289608,0,2,1
82972,3,3,289609,289609,289612,0,3,1
82973,3,1,289612,289612,289613,0,1,0
82974,4,3,289616,289616,289619,0,3,3
82975,1,2,289617,289619,289621,2,4,0
82976,3,2,289620,289621,289623,1,3,0
82977,2,1,289622,289623,289624,1,2,0
82978,6,3,289628,289628,289631,0,3,4
82979,2,2,289630,289631,289633,1,3,0
82980,6,3,289636,289636,289639,0,3,3
82981,2,1,289638,289639,289640,1,2,0
82982,3,1,289641,289641,289642,0,1,1
82983,5,1,289646,289646,289647,0,1,4
82984,1,1,289647,289647,289648,0,1,0
82985,3,1,289650,289650,289651,0,1,2
82986,3,1,289653,289653,289654,0,1,2
82987,5,1,289658,289658,289659,0,1,4
82988,3,2,289661,289661,289663,0,2,2
82989,2,2,289663,289663,289665,0,2,0
82990,6,2,289669,289669,289671,0,2,4
82991,2,3,289671,289671,289674,0,3,0
82992,6,2,289677,289677,289679,0,2,3
82993,2,3,289679,289679,289682,0,3,0
82994,6,3,289685,289685,289688,0,3,3
82995,1,1,289686,289688,289689,2,3,0
82996,6,3,289692,289692,289695,0,3,3
82997,5,1,289697,289697,289698,0,1,2
82998,1,3,289698,289698,289701,0,3,0
82999,1,3,289699,289701,289704,2,5,0
83000,4,1,289703,289704,289705,1,2,0
83001,4,1,289707,289707,289708,0,1,2
83002,1,2,289708,289708,289710,0,2,0
83003,6,1,289714,289714,289715,0,1,4
83004,3,3,289717,289717,289720,0,3,2
83005,6,3,289723,289723,289726,0,3,3
83006,3,3,289726,289726,289729,0,3,0
83007,4,2,289730,289730,289732,0,2,1
83008,1,2,289731,289732,289734,1,3,0
83009,2,3,289733,289734,289737,1,4,0
83010,5,3,289738,289738,289741,0,3,1
83011,6,3,289744,289744,289747,0,3,3
83012,1,2,289745,289747,289749,2,4,0
83013,1,2,289746,289749,289751,3,5,0
83014,2,1,289748,289751,289752,3,4,0
83015,4,1,289752,289752,289753,0,1,0
83016,4,1,289756,289756,289757,0,1,3
83017,4,2,289760,289760,289762,0,2,3
83018,1,1,289761,289762,289763,1,2,0
83019,2,2,289763,289763,289765,0,2,0
83020,6,3,289769,289769,289772,0,3,4
83021,1,1,289770,289772,289773,2,3,0
83022,4,3,289774,289774,289777,0,3,1
83023,3,3,289777,289777,289780,0,3,0
83024,6,3,289783,289783,289786,0,3,3
83025,6,2,289789,289789,289791,0,2,3
83026,2,1,289791,289791,289792,0,1,0
83027,4,3,289795,289795,289798,0,3,3
83028,1,1,289796,289798,289799,2,3,0
83029,3,2,289799,289799,289801,0,2,0
83030,4,3,289803,289803,289806,0,3,2
83031,2,3,289805,289806,289809,1,4,0
83032,4,3,289809,289809,289812,0,3,0
83033,1,3,289810,289812,289815,2,5,0
83034,1,2,289811,289815,289817,4,6,0
83035,4,2,289815,289817,289819,2,4,0
83036,1,1,289816,289819,289820,3,4,0
83037,4,3,289820,289820,289823,0,3,0
83038,3,3,289823,289823,289826,0,3,0
83039,5,1,289828,289828,289829,0,1,2
83040,2,3,289830,289830,289833,0,3,1
83041,1,2,289831,289833,289835,2,4,0
83042,5,1,289836,289836,289837,0,1,1
83043,1,2,289837,289837,289839,0,2,0
83044,1,2,289838,289839,289841,1,3,0
83045,4,2,289842,289842,289844,0,2,1
83046,4,2,289846,289846,289848,0,2,2
83047,5,2,289851,289851,289853,0,2,3
83048,1,1,289852,289853,289854,1,2,0
83049,5,1,289857,289857,289858,0,1,3
83050,2,2,289859,289859,289861,0,2,1
83051,2,2,289861,289861,289863,0,2,0
83052,3,2,289864,289864,289866,0,2,1
83053,5,3,289869,289869,289872,0,3,3
83054,1,1,289870,289872,289873,2,3,0
83055,1,2,289871,289873,289875,2,4,0
83056,3,1,289874,289875,289876,1,2,0
83057,4,2,289878,289878,289880,0,2,2
83058,6,3,289884,289884,289887,0,3,4
83059,6,3,289890,289890,289893,0,3,3
83060,3,2,289893,289893,289895,0,2,0
83061,4,3,289897,289897,289900,0,3,2
83062,2,3,289899,289900,289903,1,4,0
83063,1,3,289900,289903,289906,3,6,0
83064,1,1,289901,289906,289907,5,6,0
83065,5,2,289906,289907,289909,1,3,0
83066,3,3,289909,289909,289912,0,3,0
83067,6,1,289915,289915,289916,0,1,3
83068,2,1,289917,289917,289918,0,1,1
83069,6,1,289923,289923,289924,0,1,5
83070,3,2,289926,289926,289928,0,2,2
83071,3,2,289929,289929,289931,0,2,1
83072,1,2,289930,289931,289933,1,3,0
83073,6,1,289936,289936,289937,0,1,3
83074,6,3,289942,289942,289945,0,3,5
83075,6,3,289948,289948,289951,0,3,3
83076,1,2,289949,289951,289953,2,4,0
83077,2,1,289951,289953,289954,2,3,0
83078,2,1,289953,289954,289955,1,2,0
83079,1,1,289954,289955,289956,1,2,0
83080,6,2,289960,289960,289962,0,2,4
83081,5,1,289965,289965,289966,0,1,3
83082,4,3,289969,289969,289972,0,3,3
83083,2,3,289971,289972,289975,1,4,0
83084,1,1,289972,289975,289976,3,4,0
83085,6,3,289978,289978,289981,0,3,2
83086,4,2,289982,289982,289984,0,2,1
83087,3,1,289985,289985,289986,0,1,1
83088,2,2,289987,289987,289989,0,2,1
83089,2,3,289989,289989,289992,0,3,0
83090,6,1,289995,289995,289996,0,1,3
83091,5,2,290000,290000,290002,0,2,4
83092,6,3,290006,290006,290009,0,3,4
83093,5,1,290011,290011,290012,0,1,2
83094,3,3,290014,290014,290017,0,3,2
83095,1,3,290015,290017,290020,2,5,0
83096,2,3,290017,290020,290023,3,6,0
83097,5,1,290022,290023,290024,1,2,0
83098,1,1,290023,290024,290025,1,2,0
83099,2,3,290025,290025,290028,0,3,0
83100,6,3,290031,290031,290034,0,3,3
83101,5,3,290036,290036,290039,0,3,2
83102,4,1,290040,290040,290041,0,1,1
83103,3,2,290043,290043,290045,0,2,2
83104,4,2,290047,290047,290049,0,2,2
83105,2,3,290049,290049,290052,0,3,0
83106,2,1,290051,290052,290053,1,2,0
83107,3,1,290054,290054,290055,0,1,1
83108,3,2,290057,290057,290059,0,2,2
83109,4,1,290061,290061,290062,0,1,2
83110,5,3,290066,290066,290069,0,3,4
83111,1,1,290067,290069,290070,2,3,0
83112,2,2,290069,290070,290072,1,3,0
83113,5,2,290074,290074,290076,0,2,2
83114,6,3,290080,290080,290083,0,3,4
83115,1,1,290081,290083,290084,2,3,0
83116,4,1,290085,290085,290086,0,1,1
83117,1,2,290086,290086,290088,0,2,0
83118,5,2,290091,290091,290093,0,2,3
83119,6,3,290097,290097,290100,0,3,4
83120,5,2,290102,290102,290104,0,2,2
83121,1,1,290103,290104,290105,1,2,0
83122,5,2,290108,290108,290110,0,2,3
83123,1,2,290109,290110,290112,1,3,0
83124,6,3,290115,290115,290118,0,3,3
83125,4,3,290119,290119,290122,0,3,1
83126,2,2,290121,290122,290124,1,3,0
83127,3,1,290124,290124,290125,0,1,0
83128,1,1,290125,290125,290126,0,1,0
83129,1,3,290126,290126,290129,0,3,0
83130,6,1,290132,290132,290133,0,1,3
83131,5,3,290137,290137,290140,0,3,4
83132,1,1,290138,290140,290141,2,3,0
83133,1,3,290139,290141,290144,2,5,0
83134,4,1,290143,290144,290145,1,2,0
83135,4,2,290147,290147,290149,0,2,2
83136,4,1,290151,290151,290152,0,1,2
83137,1,1,290152,290152,290153,0,1,0
83138,6,3,290158,290158,290161,0,3,5
83139,1,3,290159,290161,290164,2,5,0
83140,3,2,290162,290164,290166,2,4,0
83141,2,1,290164,290166,290167,2,3,0
83142,1,1,290165,290167,290168,2,3,0
83143,2,1,290167,290168,290169,1,2,0
83144,5,1,290172,290172,290173,0,1,3
83145,5,1,290177,290177,290178,0,1,4
83146,4,3,290181,290181,290184,0,3,3
83147,1,1,290182,290184,290185,2,3,0
83148,5,3,290187,290187,290190,0,3,2
83149,3,2,290190,290190,290192,0,2,0
83150,1,3,290191,290192,290195,1,4,0
83151,5,1,290196,290196,290197,0,1,1
83152,6,2,290202,290202,290204,0,2,5
83153,4,2,290206,290206,290208,0,2,2
83154,2,2,290208,290208,290210,0,2,0
83155,6,3,290214,290214,290217,0,3,4
83156,6,3,290220,290220,290223,0,3,3
83157,2,3,290222,290223,290226,1,4,0
83158,6,3,290228,290228,290231,0,3,2
83159,2,2,290230,290231,290233,1,3,0
83160,3,1,290233,290233,290234,0,1,0
83161,1,1,290234,290234,290235,0,1,0
83162,5,1,290239,290239,290240,0,1,4
83163,6,2,290245,290245,290247,0,2,5
83164,3,3,290248,290248,290251,0,3,1
83165,3,1,290251,290251,290252,0,1,0
83166,5,1,290256,290256,290257,0,1,4
83167,5,3,290261,290261,290264,0,3,4
83168,4,2,290265,290265,290267,0,2,1
83169,6,1,290271,290271,290272,0,1,4
83170,6,3,290277,290277,290280,0,3,5
83171,2,2,290279,290280,290282,1,3,0
83172,2,2,290281,290282,290284,1,3,0
83173,6,2,290287,290287,290289,0,2,3
83174,5,3,290292,290292,290295,0,3,3
83175,6,1,290298,290298,290299,0,1,3
83176,3,1,290301,290301,290302,0,1,2
83177,3,1,290304,290304,290305,0,1,2
83178,2,2,290306,290306,290308,0,2,1
83179,5,2,290311,290311,290313,0,2,3
83180,4,1,290315,290315,290316,0,1,2
83181,3,1,290318,290318,290319,0,1,2
83182,5,1,290323,290323,290324,0,1,4
83183,4,1,290327,290327,290328,0,1,3
83184,1,2,290328,290328,290330,0,2,0
83185,4,3,290332,290332,290335,0,3,2
83186,6,2,290338,290338,290340,0,2,3
83187,5,2,290343,290343,290345,0,2,3
83188,3,3,290346,290346,290349,0,3,1
83189,6,3,290352,290352,290355,0,3,3
83190,2,2,290354,290355,290357,1,3,0
83191,3,1,290357,290357,290358,0,1,0
83192,4,2,290361,290361,290363,0,2,3
83193,2,2,290363,290363,290365,0,2,0
83194,5,3,290368,290368,290371,0,3,3
83195,3,2,290371,290371,290373,0,2,0
83196,1,3,290372,290373,290376,1,4,0
83197,4,3,290376,290376,290379,0,3,0
83198,1,3,290377,290379,290382,2,5,0
83199,6,3,290383,290383,290386,0,3,1
83200,5,3,290388,290388,290391,0,3,2
83201,2,3,290390,290391,290394,1,4,0
83202,3,3,290393,290394,290397,1,4,0
83203,2,1,290395,290397,290398,2,3,0
83204,1,3,290396,290398,290401,2,5,0
83205,4,3,290400,290401,290404,1,4,0
83206,3,1,290403,290404,290405,1,2,0
83207,5,3,290408,290408,290411,0,3,3
83208,6,2,290414,290414,290416,0,2,3
83209,4,3,290418,290418,290421,0,3,2
83210,1,2,290419,290421,290423,2,4,0
83211,6,1,290425,290425,290426,0,1,2
83212,2,1,290427,290427,290428,0,1,1
83213,4,1,290431,290431,290432,0,1,3
83214,6,2,290437,290437,290439,0,2,5
83215,5,3,290442,290442,290445,0,3,3
83216,4,2,290446,290446,290448,0,2,1
83217,5,1,290451,290451,290452,0,1,3
83218,5,2,290456,290456,290458,0,2,4
83219,6,2,290462,290462,290464,0,2,4
83220,2,3,290464,290464,290467,0,3,0
83221,1,1,290465,290467,290468,2,3,0
83222,5,1,290470,290470,290471,0,1,2
83223,3,2,290473,290473,290475,0,2,2
83224,1,3,290474,290475,290478,1,4,0
83225,5,3,290479,290479,290482,0,3,1
83226,4,2,290483,290483,290485,0,2,1
83227,1,1,290484,290485,290486,1,2,0
83228,5,2,290489,290489,290491,0,2,3
83229,2,3,290491,290491,290494,0,3,0
83230,2,2,290493,290494,290496,1,3,0
83231,1,2,290494,290496,290498,2,4,0
83232,1,1,290495,290498,290499,3,4,0
83233,2,2,290497,290499,290501,2,4,0
83234,3,2,290500,290501,290503,1,3,0
83235,4,3,290504,290504,290507,0,3,1
83236,3,1,290507,290507,290508,0,1,0
83237,6,1,290513,290513,290514,0,1,5
83238,2,3,290515,290515,290518,0,3,1
83239,5,3,290520,290520,290523,0,3,2
83240,2,1,290522,290523,290524,1,2,0
83241,2,3,290524,290524,290527,0,3,0
83242,5,1,290529,290529,290530,0,1,2
83243,4,2,290533,290533,290535,0,2,3
83244,6,2,290539,290539,290541,0,2,4
83245,3,3,290542,290542,290545,0,3,1
83246,5,2,290547,290547,290549,0,2,2
83247,2,2,290549,290549,290551,0,2,0
83248,2,1,290551,290551,290552,0,1,0
83249,6,2,290557,290557,290559,0,2,5
83250,5,1,290562,290562,290563,0,1,3
83251,1,3,290563,290563,290566,0,3,0
83252,5,1,290568,290568,290569,0,1,2
83253,3,2,290571,290571,290573,0,2,2
83254,6,3,290577,290577,290580,0,3,4
83255,1,3,290578,290580,290583,2,5,0
83256,3,2,290581,290583,290585,2,4,0
83257,3,2,290584,290585,290587,1,3,0
83258,5,2,290589,290589,290591,0,2,2
83259,4,2,290593,290593,290595,0,2,2
83260,6,3,290599,290599,290602,0,3,4
83261,4,3,290603,290603,290606,0,3,1
83262,3,2,290606,290606,290608,0,2,0
83263,1,3,290607,290608,290611,1,4,0
83264,2,3,290609,290611,290614,2,5,0
83265,2,3,290611,290614,290617,3,6,0
83266,2,2,290613,290617,290619,4,6,0
83267,1,2,290614,290619,290621,5,7,0
83268,3,3,290617,290621,290624,4,7,0
83269,2,3,290619,290624,290627,5,8,0
83270,2,2,290621,290627,290629,6,8,0
83271,3,3,290624,290629,290632,5,8,0
83272,1,1,290625,290632,290633,7,8,0
83273,5,1,290630,290633,290634,3,4,0
83274,3,1,290633,290634,290635,1,2,0
83275,6,3,290639,290639,290642,0,3,4
83276,2,2,290641,290642,290644,1,3,0
83277,3,3,290644,290644,290647,0,3,0
83278,6,2,290650,290650,290652,0,2,3
83279,3,1,290653,290653,290654,0,1,1
83280,2,2,290655,290655,290657,0,2,1
83281,3,3,290658,290658,290661,0,3,1
83282,5,3,290663,290663,290666,0,3,2
83283,5,3,290668,290668,290671,0,3,2
83284,3,1,290671,290671,290672,0,1,0
83285,6,1,290677,290677,290678,0,1,5
83286,4,1,290681,290681,290682,0,1,3
83287,1,1,290682,290682,290683,0,1,0
83288,5,3,290687,290687,290690,0,3,4
83289,2,1,290689,290690,290691,1,2,0
83290,6,2,290695,290695,290697,0,2,4
83291,5,3,290700,290700,290703,0,3,3
83292,2,1,290702,290703,290704,1,2,0
83293,6,2,290708,290708,290710,0,2,4
83294,6,3,290714,290714,290717,0,3,4
83295,3,3,290717,290717,290720,0,3,0
83296,3,2,290720,290720,290722,0,2,0
83297,1,2,290721,290722,290724,1,3,0
83298,3,2,290724,290724,290726,0,2,0
83299,4,2,290728,290728,290730,0,2,2
83300,1,1,290729,290730,290731,1,2,0
83301,1,2,290730,290731,290733,1,3,0
83302,1,1,290731,290733,290734,2,3,0
83303,6,2,290737,290737,290739,0,2,3
83304,4,2,290741,290741,290743,0,2,2
83305,3,3,290744,290744,290747,0,3,1
83306,4,1,290748,290748,290749,0,1,1
83307,6,2,290754,290754,290756,0,2,5
83308,6,1,290760,290760,290761,0,1,4
83309,6,1,290766,290766,290767,0,1,5
83310,4,2,290770,290770,290772,0,2,3
83311,5,2,290775,290775,290777,0,2,3
83312,5,2,290780,290780,290782,0,2,3
83313,1,2,290781,290782,290784,1,3,0
83314,6,3,290787,290787,290790,0,3,3
83315,5,1,290792,290792,290793,0,1,2
83316,6,3,290798,290798,290801,0,3,5
83317,3,3,290801,290801,290804,0,3,0
83318,4,1,290805,290805,290806,0,1,1
83319,6,2,290811,290811,290813,0,2,5
83320,6,1,290817,290817,290818,0,1,4
83321,6,2,290823,290823,290825,0,2,5
83322,6,3,290829,290829,290832,0,3,4
83323,2,2,290831,290832,290834,1,3,0
83324,5,2,290836,290836,290838,0,2,2
83325,1,3,290837,290838,290841,1,4,0
83326,6,2,290843,290843,290845,0,2,2
83327,5,2,290848,290848,290850,0,2,3
83328,1,2,290849,290850,290852,1,3,0
83329,6,2,290855,290855,290857,0,2,3
83330,1,2,290856,290857,290859,1,3,0
83331,1,1,290857,290859,290860,2,3,0
83332,2,1,290859,290860,290861,1,2,0
83333,3,3,290862,290862,290865,0,3,1
83334,3,1,290865,290865,290866,0,1,0
83335,3,3,290868,290868,290871,0,3,2
83336,3,1,290871,290871,290872,0,1,0
83337,3,2,290874,290874,290876,0,2,2
83338,3,2,290877,290877,290879,0,2,1
83339,1,3,290878,290879,290882,1,4,0
83340,6,1,290884,290884,290885,0,1,2
83341,3,2,290887,290887,290889,0,2,2
83342,1,1,290888,290889,290890,1,2,0
83343,5,1,290893,290893,290894,0,1,3
83344,2,3,290895,290895,290898,0,3,1
83345,6,1,290901,290901,290902,0,1,3
83346,5,2,290906,290906,290908,0,2,4
83347,2,2,290908,290908,290910,0,2,0
83348,2,1,290910,290910,290911,0,1,0
83349,2,1,290912,290912,290913,0,1,1
83350,2,1,290914,290914,290915,0,1,1
83351,3,1,290917,290917,290918,0,1,2
83352,6,2,290923,290923,290925,0,2,5
83353,1,2,290924,290925,290927,1,3,0
83354,5,2,290929,290929,290931,0,2,2
83355,1,1,290930,290931,290932,1,2,0
83356,2,2,290932,290932,290934,0,2,0
83357,2,3,290934,290934,290937,0,3,0
83358,5,2,290939,290939,290941,0,2,2
83359,2,1,290941,290941,290942,0,1,0
83360,2,2,290943,290943,290945,0,2,1
83361,5,3,290948,290948,290951,0,3,3
83362,2,2,290950,290951,290953,1,3,0
83363,4,3,290954,290954,290957,0,3,1
83364,1,2,290955,290957,290959,2,4,0
83365,5,1,290960,290960,290961,0,1,1
83366,2,2,290962,290962,290964,0,2,1
83367,2,1,290964,290964,290965,0,1,0
83368,3,2,290967,290967,290969,0,2,2
83369,6,1,290973,290973,290974,0,1,4
83370,6,3,290979,290979,290982,0,3,5
83371,6,3,290985,290985,290988,0,3,3
83372,2,3,290987,290988,290991,1,4,0
83373,2,3,290989,290991,290994,2,5,0
83374,4,3,290993,290994,290997,1,4,0
83375,4,2,290997,290997,290999,0,2,0
83376,4,2,291001,291001,291003,0,2,2
83377,1,2,291002,291003,291005,1,3,0
83378,3,1,291005,291005,291006,0,1,0
83379,4,3,291009,291009,291012,0,3,3
83380,3,3,291012,291012,291015,0,3,0
83381,3,1,291015,291015,291016,0,1,0
83382,3,1,291018,291018,291019,0,1,2
83383,4,2,291022,291022,291024,0,2,3
83384,2,2,291024,291024,291026,0,2,0
83385,2,2,291026,291026,291028,0,2,0
83386,1,1,291027,291028,291029,1,2,0
83387,4,2,291031,291031,291033,0,2,2
83388,1,2,291032,291033,291035,1,3,0
83389,1,1,291033,291035,291036,2,3,0
83390,2,2,291035,291036,291038,1,3,0
83391,1,1,291036,291038,291039,2,3,0
83392,6,2,291042,291042,291044,0,2,3
83393,2,1,291044,291044,291045,0,1,0
83394,5,1,291049,291049,291050,0,1,4
83395,4,2,291053,291053,291055,0,2,3
83396,6,3,291059,291059,291062,0,3,4
83397,1,2,291060,291062,291064,2,4,0
83398,4,2,291064,291064,291066,0,2,0
83399,3,2,291067,291067,291069,0,2,1
83400,3,3,291070,291070,291073,0,3,1
83401,5,2,291075,291075,291077,0,2,2
83402,1,2,291076,291077,291079,1,3,0
83403,1,3,291077,291079,291082,2,5,0
83404,6,2,291083,291083,291085,0,2,1
83405,3,1,291086,291086,291087,0,1,1
83406,2,2,291088,291088,291090,0,2,1
83407,2,1,291090,291090,291091,0,1,0
83408,6,2,291096,291096,291098,0,2,5
83409,2,3,291098,291098,291101,0,3,0
83410,6,2,291104,291104,291106,0,2,3
83411,5,2,291109,291109,291111,0,2,3
83412,1,3,291110,291111,291114,1,4,0
83413,5,2,291115,291115,291117,0,2,1
83414,4,3,291119,291119,291122,0,3,2
83415,5,2,291124,291124,291126,0,2,2
83416,5,3,291129,291129,291132,0,3,3
83417,2,3,291131,291132,291135,1,4,0
83418,3,1,291134,291135,291136,1,2,0
83419,5,2,291139,291139,291141,0,2,3
83420,4,1,291143,291143,291144,0,1,2
83421,2,1,291145,291145,291146,0,1,1
83422,1,2,291146,291146,291148,0,2,0
83423,4,1,291150,291150,291151,0,1,2
83424,5,3,291155,291155,291158,0,3,4
83425,4,1,291159,291159,291160,0,1,1
83426,5,1,291164,291164,291165,0,1,4
83427,5,3,291169,291169,291172,0,3,4
83428,6,3,291175,291175,291178,0,3,3
83429,4,1,291179,291179,291180,0,1,1
83430,2,3,291181,291181,291184,0,3,1
83431,6,3,291187,291187,291190,0,3,3
83432,6,2,291193,291193,291195,0,2,3
83433,3,3,291196,291196,291199,0,3,1
83434,3,1,291199,291199,291200,0,1,0
83435,3,2,291202,291202,291204,0,2,2
83436,4,2,291206,291206,291208,0,2,2
83437,2,3,291208,291208,291211,0,3,0
83438,4,2,291212,291212,291214,0,2,1
83439,5,2,291217,291217,291219,0,2,3
83440,1,3,291218,291219,291222,1,4,0
83441,3,3,291221,291222,291225,1,4,0
83442,5,3,291226,291226,291229,0,3,1
83443,3,1,291229,291229,291230,0,1,0
83444,6,3,291235,291235,291238,0,3,5
83445,3,2,291238,291238,291240,0,2,0
83446,5,1,291243,291243,291244,0,1,3
83447,2,1,291245,291245,291246,0,1,1
83448,4,3,291249,291249,291252,0,3,3
83449,3,2,291252,291252,291254,0,2,0
83450,2,3,291254,291254,291257,0,3,0
83451,5,2,291259,291259,291261,0,2,2
83452,6,1,291265,291265,291266,0,1,4
83453,6,3,291271,291271,291274,0,3,5
83454,1,2,291272,291274,291276,2,4,0
83455,3,2,291275,291276,291278,1,3,0
83456,3,3,291278,291278,291281,0,3,0
83457,5,3,291283,291283,291286,0,3,2
83458,1,2,291284,291286,291288,2,4,0
83459,6,1,291290,291290,291291,0,1,2
83460,6,2,291296,291296,291298,0,2,5
83461,3,2,291299,291299,291301,0,2,1
83462,2,3,291301,291301,291304,0,3,0
83463,1,2,291302,291304,291306,2,4,0
83464,6,2,291308,291308,291310,0,2,2
83465,2,3,291310,291310,291313,0,3,0
83466,6,2,291316,291316,291318,0,2,3
83467,3,3,291319,291319,291322,0,3,1
83468,2,2,291321,291322,291324,1,3,0
83469,6,3,291327,291327,291330,0,3,3
83470,5,3,291332,291332,291335,0,3,2
83471,5,3,291337,291337,291340,0,3,2
83472,3,1,291340,291340,291341,0,1,0
83473,3,3,291343,291343,291346,0,3,2
83474,5,3,291348,291348,291351,0,3,2
83475,4,1,291352,291352,291353,0,1,1
83476,1,1,291353,291353,291354,0,1,0
83477,3,1,291356,291356,291357,0,1,2
83478,2,3,291358,291358,291361,0,3,1
83479,6,2,291364,291364,291366,0,2,3
83480,1,3,291365,291366,291369,1,4,0
83481,4,1,291369,291369,291370,0,1,0
83482,1,2,291370,291370,291372,0,2,0
83483,2,1,291372,291372,291373,0,1,0
83484,5,1,291377,291377,291378,0,1,4
83485,3,3,291380,291380,291383,0,3,2
83486,1,1,291381,291383,291384,2,3,0
83487,4,2,291385,291385,291387,0,2,1
83488,6,1,291391,291391,291392,0,1,4
83489,1,2,291392,291392,291394,0,2,0
83490,4,2,291396,291396,291398,0,2,2
83491,3,3,291399,291399,291402,0,3,1
83492,4,2,291403,291403,291405,0,2,1
83493,4,3,291407,291407,291410,0,3,2
83494,2,1,291409,291410,291411,1,2,0
83495,2,2,291411,291411,291413,0,2,0
83496,4,1,291415,291415,291416,0,1,2
83497,6,1,291421,291421,291422,0,1,5
83498,4,1,291425,291425,291426,0,1,3
83499,2,2,291427,291427,291429,0,2,1
83500,3,1,291430,291430,291431,0,1,1
83501,4,3,291434,291434,291437,0,3,3
83502,3,1,291437,291437,291438,0,1,0
83503,2,2,291439,291439,291441,0,2,1
83504,2,2,291441,291441,291443,0,2,0
83505,2,2,291443,291443,291445,0,2,0
83506,3,2,291446,291446,291448,0,2,1
83507,2,2,291448,291448,291450,0,2,0
83508,4,3,291452,291452,291455,0,3,2
83509,2,3,291454,291455,291458,1,4,0
83510,6,2,291460,291460,291462,0,2,2
83511,2,1,291462,291462,291463,0,1,0
83512,4,3,291466,291466,291469,0,3,3
83513,2,1,291468,291469,291470,1,2,0
83514,4,3,291472,291472,291475,0,3,2
83515,1,3,291473,291475,291478,2,5,0
83516,4,1,291477,291478,291479,1,2,0
83517,6,2,291483,291483,291485,0,2,4
83518,4,2,291487,291487,291489,0,2,2
83519,1,1,291488,291489,291490,1,2,0
83520,4,1,291492,291492,291493,0,1,2
83521,6,2,291498,291498,291500,0,2,5
83522,3,1,291501,291501,291502,0,1,1
83523,6,1,291507,291507,291508,0,1,5
83524,2,1,291509,291509,291510,0,1,1
83525,5,3,291514,291514,291517,0,3,4
83526,1,2,291515,291517,291519,2,4,0
83527,5,3,291520,291520,291523,0,3,1
83528,1,3,291521,291523,291526,2,5,0
83529,2,2,291523,291526,291528,3,5,0
83530,2,1,291525,291528,291529,3,4,0
83531,6,3,291531,291531,291534,0,3,2
83532,2,3,291533,291534,291537,1,4,0
83533,5,2,291538,291538,291540,0,2,1
83534,1,2,291539,291540,291542,1,3,0
83535,5,1,291544,291544,291545,0,1,2
83536,3,3,291547,291547,291550,0,3,2
83537,1,1,291548,291550,291551,2,3,0
83538,2,3,291550,291551,291554,1,4,0
83539,1,2,291551,291554,291556,3,5,0
83540,2,2,291553,291556,291558,3,5,0
83541,4,2,291557,291558,291560,1,3,0
83542,2,2,291559,291560,291562,1,3,0
83543,6,2,291565,291565,291567,0,2,3
83544,2,2,291567,291567,291569,0,2,0
83545,2,3,291569,291569,291572,0,3,0
83546,6,1,291575,291575,291576,0,1,3
83547,6,2,291581,291581,291583,0,2,5
83548,4,2,291585,291585,291587,0,2,2
83549,6,1,291591,291591,291592,0,1,4
83550,2,2,291593,291593,291595,0,2,1
83551,5,1,291598,291598,291599,0,1,3
83552,3,3,291601,291601,291604,0,3,2
83553,2,3,291603,291604,291607,1,4,0
83554,4,2,291607,291607,291609,0,2,0
83555,3,1,291610,291610,291611,0,1,1
83556,1,3,291611,291611,291614,0,3,0
83557,4,3,291615,291615,291618,0,3,1
83558,2,3,291617,291618,291621,1,4,0
83559,4,1,291621,291621,291622,0,1,0
83560,2,3,291623,291623,291626,0,3,1
83561,6,3,291629,291629,291632,0,3,3
83562,6,2,291635,291635,291637,0,2,3
83563,5,3,291640,291640,291643,0,3,3
83564,1,2,291641,291643,291645,2,4,0
83565,1,2,291642,291645,291647,3,5,0
83566,6,3,291648,291648,291651,0,3,1
83567,1,2,291649,291651,291653,2,4,0
83568,2,2,291651,291653,291655,2,4,0
83569,3,2,291654,291655,291657,1,3,0
83570,1,2,291655,291657,291659,2,4,0
83571,4,3,291659,291659,291662,0,3,0
83572,5,2,291664,291664,291666,0,2,2
83573,3,2,291667,291667,291669,0,2,1
83574,4,1,291671,291671,291672,0,1,2
83575,2,3,291673,291673,291676,0,3,1
83576,3,2,291676,291676,291678,0,2,0
83577,1,3,291677,291678,291681,1,4,0
83578,2,1,291679,291681,291682,2,3,0
83579,6,2,291685,291685,291687,0,2,3
83580,4,1,291689,291689,291690,0,1,2
83581,2,3,291691,291691,291694,0,3,1
83582,2,3,291693,291694,291697,1,4,0
83583,4,2,291697,291697,291699,0,2,0
83584,4,2,291701,291701,291703,0,2,2
83585,1,2,291702,291703,291705,1,3,0
83586,6,3,291708,291708,291711,0,3,3
83587,4,2,291712,291712,291714,0,2,1
83588,5,2,291717,291717,291719,0,2,3
83589,3,3,291720,291720,291723,0,3,1
83590,3,1,291723,291723,291724,0,1,0
83591,1,2,291724,291724,291726,0,2,0
83592,3,2,291727,291727,291729,0,2,1
83593,1,3,291728,291729,291732,1,4,0
83594,5,3,291733,291733,291736,0,3,1
83595,2,1,291735,291736,291737,1,2,0
83596,4,1,291739,291739,291740,0,1,2
83597,6,1,291745,291745,291746,0,1,5
83598,1,3,291746,291746,291749,0,3,0
83599,5,3,291751,291751,291754,0,3,2
83600,2,3,291753,291754,291757,1,4,0
83601,5,2,291758,291758,291760,0,2,1
83602,6,2,291764,291764,291766,0,2,4
83603,3,1,291767,291767,291768,0,1,1
83604,6,2,291773,291773,291775,0,2,5
83605,5,1,291778,291778,291779,0,1,3
83606,2,2,291780,291780,291782,0,2,1
83607,6,2,291786,291786,291788,0,2,4
83608,6,1,291792,291792,291793,0,1,4
83609,3,3,291795,291795,291798,0,3,2
83610,2,1,291797,291798,291799,1,2,0
83611,5,3,291802,291802,291805,0,3,3
83612,5,2,291807,291807,291809,0,2,2
83613,5,1,291812,291812,291813,0,1,3
83614,2,2,291814,291814,291816,0,2,1
83615,5,3,291819,291819,291822,0,3,3
83616,1,2,291820,291822,291824,2,4,0
83617,3,3,291823,291824,291827,1,4,0
83618,2,2,291825,291827,291829,2,4,0
83619,4,3,291829,291829,291832,0,3,0
83620,6,1,291835,291835,291836,0,1,3
83621,4,2,291839,291839,291841,0,2,3
83622,2,1,291841,291841,291842,0,1,0
83623,6,1,291847,291847,291848,0,1,5
83624,2,2,291849,291849,291851,0,2,1
83625,6,3,291855,291855,291858,0,3,4
83626,4,2,291859,291859,291861,0,2,1
83627,4,3,291863,291863,291866,0,3,2
83628,4,3,291867,291867,291870,0,3,1
83629,6,3,291873,291873,291876,0,3,3
83630,4,2,291877,291877,291879,0,2,1
83631,1,2,291878,291879,291881,1,3,0
83632,3,2,291881,291881,291883,0,2,0
83633,4,3,291885,291885,291888,0,3,2
83634,3,1,291888,291888,291889,0,1,0
83635,3,2,291891,291891,291893,0,2,2
83636,6,3,291897,291897,291900,0,3,4
83637,3,1,291900,291900,291901,0,1,0
83638,6,2,291906,291906,291908,0,2,5
83639,5,2,291911,291911,291913,0,2,3
83640,4,2,291915,291915,291917,0,2,2
83641,2,1,291917,291917,291918,0,1,0
83642,6,1,291923,291923,291924,0,1,5
83643,6,2,291929,291929,291931,0,2,5
83644,2,2,291931,291931,291933,0,2,0
83645,5,2,291936,291936,291938,0,2,3
83646,2,3,291938,291938,291941,0,3,0
83647,3,1,291941,291941,291942,0,1,0
83648,3,2,291944,291944,291946,0,2,2
83649,1,1,291945,291946,291947,1,2,0
83650,2,1,291947,291947,291948,0,1,0
83651,1,3,291948,291948,291951,0,3,0
83652,3,1,291951,291951,291952,0,1,0
83653,6,1,291957,291957,291958,0,1,5
83654,6,2,291963,291963,291965,0,2,5
83655,2,1,291965,291965,291966,0,1,0
83656,2,2,291967,291967,291969,0,2,1
83657,2,1,291969,291969,291970,0,1,0
83658,3,1,291972,291972,291973,0,1,2
83659,4,3,291976,291976,291979,0,3,3
83660,3,3,291979,291979,291982,0,3,0
83661,3,2,291982,291982,291984,0,2,0
83662,2,3,291984,291984,291987,0,3,0
83663,6,3,291990,291990,291993,0,3,3
83664,6,1,291996,291996,291997,0,1,3
83665,2,1,291998,291998,291999,0,1,1
83666,4,3,292002,292002,292005,0,3,3
83667,3,2,292005,292005,292007,0,2,0
83668,3,2,292008,292008,292010,0,2,1
83669,3,1,292011,292011,292012,0,1,1
83670,3,1,292014,292014,292015,0,1,2
83671,1,3,292015,292015,292018,0,3,0
83672,3,2,292018,292018,292020,0,2,0
83673,3,2,292021,292021,292023,0,2,1
83674,2,1,292023,292023,292024,0,1,0
83675,4,2,292027,292027,292029,0,2,3
83676,5,1,292032,292032,292033,0,1,3
83677,3,3,292035,292035,292038,0,3,2
83678,4,3,292039,292039,292042,0,3,1
83679,4,2,292043,292043,292045,0,2,1
83680,3,3,292046,292046,292049,0,3,1
83681,4,2,292050,292050,292052,0,2,1
83682,3,1,292053,292053,292054,0,1,1
83683,6,1,292059,292059,292060,0,1,5
83684,2,2,292061,292061,292063,0,2,1
83685,3,3,292064,292064,292067,0,3,1
83686,5,3,292069,292069,292072,0,3,2
83687,3,3,292072,292072,292075,0,3,0
83688,2,1,292074,292075,292076,1,2,0
83689,4,3,292078,292078,292081,0,3,2
83690,6,2,292084,292084,292086,0,2,3
83691,3,1,292087,292087,292088,0,1,1
83692,3,2,292090,292090,292092,0,2,2
83693,2,1,292092,292092,292093,0,1,0
83694,1,2,292093,292093,292095,0,2,0
83695,3,2,292096,292096,292098,0,2,1
83696,5,2,292101,292101,292103,0,2,3
83697,2,2,292103,292103,292105,0,2,0
83698,4,3,292107,292107,292110,0,3,2
83699,1,3,292108,292110,292113,2,5,0
83700,4,1,292112,292113,292114,1,2,0
83701,1,2,292113,292114,292116,1,3,0
83702,3,3,292116,292116,292119,0,3,0
83703,6,3,292122,292122,292125,0,3,3
83704,5,3,292127,292127,292130,0,3,2
83705,6,1,292133,292133,292134,0,1,3
83706,4,2,292137,292137,292139,0,2,3
83707,4,3,292141,292141,292144,0,3,2
83708,2,3,292143,292144,292147,1,4,0
83709,6,1,292149,292149,292150,0,1,2
83710,1,3,292150,292150,292153,0,3,0
83711,2,2,292152,292153,292155,1,3,0
83712,3,2,292155,292155,292157,0,2,0
83713,5,2,292160,292160,292162,0,2,3
83714,1,1,292161,292162,292163,1,2,0
83715,1,3,292162,292163,292166,1,4,0
83716,1,2,292163,292166,292168,3,5,0
83717,2,2,292165,292168,292170,3,5,0
83718,2,3,292167,292170,292173,3,6,0
83719,3,3,292170,292173,292176,3,6,0
83720,4,3,292174,292176,292179,2,5,0
83721,6,2,292180,292180,292182,0,2,1
83722,5,1,292185,292185,292186,0,1,3
83723,1,1,292186,292186,292187,0,1,0
83724,5,1,292191,292191,292192,0,1,4
83725,4,1,292195,292195,292196,0,1,3
83726,2,1,292197,292197,292198,0,1,1
83727,1,1,292198,292198,292199,0,1,0
83728,1,1,292199,292199,292200,0,1,0
83729,4,3,292203,292203,292206,0,3,3
83730,6,3,292209,292209,292212,0,3,3
83731,6,1,292215,292215,292216,0,1,3
83732,2,1,292217,292217,292218,0,1,1
83733,2,1,292219,292219,292220,0,1,1
83734,3,2,292222,292222,292224,0,2,2
83735,4,3,292226,292226,292229,0,3,2
83736,5,1,292231,292231,292232,0,1,2
83737,5,1,292236,292236,292237,0,1,4
83738,3,3,292239,292239,292242,0,3,2
83739,2,2,292241,292242,292244,1,3,0
83740,5,3,292246,292246,292249,0,3,2
83741,2,1,292248,292249,292250,1,2,0
83742,3,3,292251,292251,292254,0,3,1
83743,1,3,292252,292254,292257,2,5,0
83744,1,1,292253,292257,292258,4,5,0
83745,4,2,292257,292258,292260,1,3,0
83746,3,2,292260,292260,292262,0,2,0
83747,2,3,292262,292262,292265,0,3,0
83748,2,1,292264,292265,292266,1,2,0
83749,2,2,292266,292266,292268,0,2,0
83750,3,3,292269,292269,292272,0,3,1
83751,6,1,292275,292275,292276,0,1,3
83752,4,1,292279,292279,292280,0,1,3
83753,3,1,292282,292282,292283,0,1,2
83754,5,1,292287,292287,292288,0,1,4
83755,4,3,292291,292291,292294,0,3,3
83756,5,3,292296,292296,292299,0,3,2
83757,5,1,292301,292301,292302,0,1,2
83758,6,1,292307,292307,292308,0,1,5
83759,1,1,292308,292308,292309,0,1,0
83760,4,2,292312,292312,292314,0,2,3
83761,2,2,292314,292314,292316,0,2,0
83762,2,1,292316,292316,292317,0,1,0
83763,6,2,292322,292322,292324,0,2,5
83764,6,2,292328,292328,292330,0,2,4
83765,5,3,292333,292333,292336,0,3,3
83766,6,3,292339,292339,292342,0,3,3
83767,2,3,292341,292342,292345,1,4,0
83768,2,3,292343,292345,292348,2,5,0
83769,4,1,292347,292348,292349,1,2,0
83770,1,1,292348,292349,292350,1,2,0
83771,5,3,292353,292353,292356,0,3,3
83772,4,2,292357,292357,292359,0,2,1
83773,4,3,292361,292361,292364,0,3,2
83774,5,2,292366,292366,292368,0,2,2
83775,3,2,292369,292369,292371,0,2,1
83776,5,2,292374,292374,292376,0,2,3
83777,4,2,292378,292378,292380,0,2,2
83778,1,3,292379,292380,292383,1,4,0
83779,1,2,292380,292383,292385,3,5,0
83780,1,3,292381,292385,292388,4,7,0
83781,1,3,292382,292388,292391,6,9,0
83782,5,3,292387,292391,292394,4,7,0
83783,4,2,292391,292394,292396,3,5,0
83784,3,3,292394,292396,292399,2,5,0
83785,4,2,292398,292399,292401,1,3,0
83786,2,1,292400,292401,292402,1,2,0
83787,4,3,292404,292404,292407,0,3,2
83788,2,1,292406,292407,292408,1,2,0
83789,3,2,292409,292409,292411,0,2,1
83790,2,3,292411,292411,292414,0,3,0
83791,6,3,292417,292417,292420,0,3,3
83792,3,1,292420,292420,292421,0,1,0
83793,6,1,292426,292426,292427,0,1,5
83794,1,2,292427,292427,292429,0,2,0
83795,2,3,292429,292429,292432,0,3,0
83796,2,2,292431,292432,292434,1,3,0
83797,1,1,292432,292434,292435,2,3,0
83798,5,2,292437,292437,292439,0,2,2
83799,5,3,292442,292442,292445,0,3,3
83800,5,1,292447,292447,292448,0,1,2
83801,2,3,292449,292449,292452,0,3,1
83802,5,2,292454,292454,292456,0,2,2
83803,2,2,292456,292456,292458,0,2,0
83804,5,2,292461,292461,292463,0,2,3
83805,3,2,292464,292464,292466,0,2,1
83806,6,2,292470,292470,292472,0,2,4
83807,5,3,292475,292475,292478,0,3,3
83808,2,2,292477,292478,292480,1,3,0
83809,4,3,292481,292481,292484,0,3,1
83810,4,2,292485,292485,292487,0,2,1
83811,2,1,292487,292487,292488,0,1,0
83812,3,3,292490,292490,292493,0,3,2
83813,3,1,292493,292493,292494,0,1,0
83814,3,1,292496,292496,292497,0,1,2
83815,4,2,292500,292500,292502,0,2,3
83816,3,1,292503,292503,292504,0,1,1
83817,6,1,292509,292509,292510,0,1,5
83818,6,3,292515,292515,292518,0,3,5
83819,6,1,292521,292521,292522,0,1,3
83820,6,3,292527,292527,292530,0,3,5
83821,2,3,292529,292530,292533,1,4,0
83822,3,3,292532,292533,292536,1,4,0
83823,5,3,292537,292537,292540,0,3,1
83824,3,3,292540,292540,292543,0,3,0
83825,6,1,292546,292546,292547,0,1,3
83826,4,3,292550,292550,292553,0,3,3
83827,3,2,292553,292553,292555,0,2,0
83828,3,3,292556,292556,292559,0,3,1
83829,3,3,292559,292559,292562,0,3,0
83830,2,3,292561,292562,292565,1,4,0
83831,2,3,292563,292565,292568,2,5,0
83832,3,3,292566,292568,292571,2,5,0
83833,2,3,292568,292571,292574,3,6,0
83834,4,2,292572,292574,292576,2,4,0
83835,3,2,292575,292576,292578,1,3,0
83836,1,1,292576,292578,292579,2,3,0
83837,2,1,292578,292579,292580,1,2,0
83838,1,2,292579,292580,292582,1,3,0
83839,3,2,292582,292582,292584,0,2,0
83840,6,2,292588,292588,292590,0,2,4
83841,4,1,292592,292592,292593,0,1,2
83842,3,2,292595,292595,292597,0,2,2
83843,3,1,292598,292598,292599,0,1,1
83844,4,3,292602,292602,292605,0,3,3
83845,2,3,292604,292605,292608,1,4,0
83846,3,2,292607,292608,292610,1,3,0
83847,4,1,292611,292611,292612,0,1,1
83848,4,2,292615,292615,292617,0,2,3
83849,3,1,292618,292618,292619,0,1,1
83850,1,2,292619,292619,292621,0,2,0
83851,5,2,292624,292624,292626,0,2,3
83852,6,1,292630,292630,292631,0,1,4
83853,4,1,292634,292634,292635,0,1,3
83854,3,3,292637,292637,292640,0,3,2
83855,3,3,292640,292640,292643,0,3,0
83856,6,1,292646,292646,292647,0,1,3
83857,6,2,292652,292652,292654,0,2,5
83858,3,1,292655,292655,292656,0,1,1
83859,4,2,292659,292659,292661,0,2,3
83860,6,2,292665,292665,292667,0,2,4
83861,1,3,292666,292667,292670,1,4,0
83862,6,1,292672,292672,292673,0,1,2
83863,6,3,292678,292678,292681,0,3,5
83864,2,2,292680,292681,292683,1,3,0
83865,4,3,292684,292684,292687,0,3,1
83866,4,2,292688,292688,292690,0,2,1
83867,1,1,292689,292690,292691,1,2,0
83868,5,3,292694,292694,292697,0,3,3
83869,2,1,292696,292697,292698,1,2,0
83870,5,3,292701,292701,292704,0,3,3
83871,6,3,292707,292707,292710,0,3,3
83872,4,3,292711,292711,292714,0,3,1
83873,5,3,292716,292716,292719,0,3,2
83874,5,3,292721,292721,292724,0,3,2
83875,3,2,292724,292724,292726,0,2,0
83876,2,1,292726,292726,292727,0,1,0
83877,3,2,292729,292729,292731,0,2,2
83878,3,1,292732,292732,292733,0,1,1
83879,6,3,292738,292738,292741,0,3,5
83880,2,3,292740,292741,292744,1,4,0
83881,2,2,292742,292744,292746,2,4,0
83882,2,3,292744,292746,292749,2,5,0
83883,6,3,292750,292750,292753,0,3,1
83884,4,3,292754,292754,292757,0,3,1
83885,4,3,292758,292758,292761,0,3,1
83886,2,1,292760,292761,292762,1,2,0
83887,1,2,292761,292762,292764,1,3,0
83888,5,2,292766,292766,292768,0,2,2
83889,1,1,292767,292768,292769,1,2,0
83890,6,1,292773,292773,292774,0,1,4
83891,5,3,292778,292778,292781,0,3,4
83892,4,3,292782,292782,292785,0,3,1
83893,5,2,292787,292787,292789,0,2,2
83894,2,1,292789,292789,292790,0,1,0
83895,1,3,292790,292790,292793,0,3,0
83896,1,1,292791,292793,292794,2,3,0
83897,2,1,292793,292794,292795,1,2,0
83898,4,2,292797,292797,292799,0,2,2
83899,4,3,292801,292801,292804,0,3,2
83900,6,2,292807,292807,292809,0,2,3
83901,3,3,292810,292810,292813,0,3,1
83902,5,1,292815,292815,292816,0,1,2
83903,6,1,292821,292821,292822,0,1,5
83904,4,1,292825,292825,292826,0,1,3
83905,1,1,292826,292826,292827,0,1,0
83906,6,2,292832,292832,292834,0,2,5
83907,3,3,292835,292835,292838,0,3,1
83908,6,2,292841,292841,292843,0,2,3
83909,5,2,292846,292846,292848,0,2,3
83910,6,3,292852,292852,292855,0,3,4
83911,5,2,292857,292857,292859,0,2,2
83912,1,1,292858,292859,292860,1,2,0
83913,5,1,292863,292863,292864,0,1,3
83914,3,1,292866,292866,292867,0,1,2
83915,2,2,292868,292868,292870,0,2,1
83916,1,1,292869,292870,292871,1,2,0
83917,3,2,292872,292872,292874,0,2,1
83918,3,2,292875,292875,292877,0,2,1
83919,4,1,292879,292879,292880,0,1,2
83920,4,3,292883,292883,292886,0,3,3
83921,5,1,292888,292888,292889,0,1,2
83922,6,3,292894,292894,292897,0,3,5
83923,5,3,292899,292899,292902,0,3,2
83924,5,3,292904,292904,292907,0,3,2
83925,6,2,292910,292910,292912,0,2,3
83926,4,2,292914,292914,292916,0,2,2
83927,6,3,292920,292920,292923,0,3,4
83928,1,2,292921,292923,292925,2,4,0
83929,6,3,292927,292927,292930,0,3,2
83930,1,2,292928,292930,292932,2,4,0
83931,3,3,292931,292932,292935,1,4,0
83932,5,3,292936,292936,292939,0,3,1
83933,5,3,292941,292941,292944,0,3,2
83934,6,3,292947,292947,292950,0,3,3
83935,5,2,292952,292952,292954,0,2,2
83936,6,2,292958,292958,292960,0,2,4
83937,1,1,292959,292960,292961,1,2,0
83938,6,3,292965,292965,292968,0,3,4
83939,4,2,292969,292969,292971,0,2,1
83940,1,3,292970,292971,292974,1,4,0
83941,3,2,292973,292974,292976,1,3,0
83942,3,1,292976,292976,292977,0,1,0
83943,1,1,292977,292977,292978,0,1,0
83944,1,3,292978,292978,292981,0,3,0
83945,3,2,292981,292981,292983,0,2,0
83946,6,3,292987,292987,292990,0,3,4
83947,6,3,292993,292993,292996,0,3,3
83948,4,1,292997,292997,292998,0,1,1
83949,2,1,292999,292999,293000,0,1,1
83950,2,2,293001,293001,293003,0,2,1
83951,1,1,293002,293003,293004,1,2,0
83952,1,2,293003,293004,293006,1,3,0
83953,2,1,293005,293006,293007,1,2,0
83954,4,3,293009,293009,293012,0,3,2
83955,3,3,293012,293012,293015,0,3,0
83956,5,2,293017,293017,293019,0,2,2
83957,6,1,293023,293023,293024,0,1,4
83958,2,1,293025,293025,293026,0,1,1
83959,4,2,293029,293029,293031,0,2,3
83960,6,1,293035,293035,293036,0,1,4
83961,1,1,293036,293036,293037,0,1,0
83962,3,1,293039,293039,293040,0,1,2
83963,1,2,293040,293040,293042,0,2,0
83964,3,2,293043,293043,293045,0,2,1
83965,3,3,293046,293046,293049,0,3,1
83966,3,3,293049,293049,293052,0,3,0
83967,4,3,293053,293053,293056,0,3,1
83968,3,2,293056,293056,293058,0,2,0
83969,5,1,293061,293061,293062,0,1,3
83970,4,3,293065,293065,293068,0,3,3
83971,6,2,293071,293071,293073,0,2,3
83972,3,2,293074,293074,293076,0,2,1
83973,2,2,293076,293076,293078,0,2,0
83974,1,3,293077,293078,293081,1,4,0
83975,6,2,293083,293083,293085,0,2,2
83976,4,3,293087,293087,293090,0,3,2
83977,2,3,293089,293090,293093,1,4,0
83978,1,3,293090,293093,293096,3,6,0
83979,2,2,293092,293096,293098,4,6,0
83980,5,2,293097,293098,293100,1,3,0
83981,6,3,293103,293103,293106,0,3,3
83982,5,1,293108,293108,293109,0,1,2
83983,6,2,293114,293114,293116,0,2,5
83984,5,3,293119,293119,293122,0,3,3
83985,2,2,293121,293122,293124,1,3,0
83986,1,3,293122,293124,293127,2,5,0
83987,6,1,293128,293128,293129,0,1,1
83988,1,2,293129,293129,293131,0,2,0
83989,3,1,293132,293132,293133,0,1,1
83990,3,3,293135,293135,293138,0,3,2
83991,1,1,293136,293138,293139,2,3,0
83992,6,2,293142,293142,293144,0,2,3
83993,3,1,293145,293145,293146,0,1,1
83994,4,3,293149,293149,293152,0,3,3
83995,4,3,293153,293153,293156,0,3,1
83996,1,1,293154,293156,293157,2,3,0
83997,1,2,293155,293157,293159,2,4,0
83998,4,1,293159,293159,293160,0,1,0
83999,1,3,293160,293160,293163,0,3,0
84000,6,1,293166,293166,293167,0,1,3
84001,3,2,293169,293169,293171,0,2,2
84002,2,3,293171,293171,293174,0,3,0
84003,2,3,293173,293174,293177,1,4,0
84004,5,1,293178,293178,293179,0,1,1
84005,1,2,293179,293179,293181,0,2,0
84006,6,3,293185,293185,293188,0,3,4
84007,1,1,293186,293188,293189,2,3,0
84008,5,1,293191,293191,293192,0,1,2
84009,5,3,293196,293196,293199,0,3,4
84010,3,1,293199,293199,293200,0,1,0
84011,5,3,293204,293204,293207,0,3,4
84012,1,1,293205,293207,293208,2,3,0
84013,1,3,293206,293208,293211,2,5,0
84014,6,2,293212,293212,293214,0,2,1
84015,4,2,293216,293216,293218,0,2,2
84016,1,3,293217,293218,293221,1,4,0
84017,4,2,293221,293221,293223,0,2,0
84018,6,2,293227,293227,293229,0,2,4
84019,6,2,293233,293233,293235,0,2,4
84020,4,3,293237,293237,293240,0,3,2
84021,3,1,293240,293240,293241,0,1,0
84022,6,1,293246,293246,293247,0,1,5
84023,6,1,293252,293252,293253,0,1,5
84024,4,1,293256,293256,293257,0,1,3
84025,6,3,293262,293262,293265,0,3,5
84026,5,3,293267,293267,293270,0,3,2
84027,2,1,293269,293270,293271,1,2,0
84028,1,3,293270,293271,293274,1,4,0
84029,2,2,293272,293274,293276,2,4,0
84030,5,3,293277,293277,293280,0,3,1
84031,6,1,293283,293283,293284,0,1,3
84032,3,1,293286,293286,293287,0,1,2
84033,6,2,293292,293292,293294,0,2,5
84034,3,2,293295,293295,293297,0,2,1
84035,5,3,293300,293300,293303,0,3,3
84036,1,3,293301,293303,293306,2,5,0
84037,5,3,293306,293306,293309,0,3,0
84038,3,1,293309,293309,293310,0,1,0
84039,1,1,293310,293310,293311,0,1,0
84040,2,3,293312,293312,293315,0,3,1
84041,1,1,293313,293315,293316,2,3,0
84042,3,1,293316,293316,293317,0,1,0
84043,1,1,293317,293317,293318,0,1,0
84044,2,1,293319,293319,293320,0,1,1
84045,2,1,293321,293321,293322,0,1,1
84046,6,1,293327,293327,293328,0,1,5
84047,5,3,293332,293332,293335,0,3,4
84048,6,1,293338,293338,293339,0,1,3
84049,4,2,293342,293342,293344,0,2,3
84050,2,3,293344,293344,293347,0,3,0
84051,4,2,293348,293348,293350,0,2,1
84052,4,2,293352,293352,293354,0,2,2
84053,3,2,293355,293355,293357,0,2,1
84054,3,1,293358,293358,293359,0,1,1
84055,4,1,293362,293362,293363,0,1,3
84056,3,3,293365,293365,293368,0,3,2
84057,5,1,293370,293370,293371,0,1,2
84058,5,3,293375,293375,293378,0,3,4
84059,4,1,293379,293379,293380,0,1,1
84060,4,3,293383,293383,293386,0,3,3
84061,2,3,293385,293386,293389,1,4,0
84062,6,3,293391,293391,293394,0,3,2
84063,3,2,293394,293394,293396,0,2,0
84064,3,1,293397,293397,293398,0,1,1
84065,1,3,293398,293398,293401,0,3,0
84066,1,2,293399,293401,293403,2,4,0
84067,6,3,293405,293405,293408,0,3,2
84068,5,3,293410,293410,293413,0,3,2
84069,3,2,293413,293413,293415,0,2,0
84070,4,1,293417,293417,293418,0,1,2
84071,1,1,293418,293418,293419,0,1,0
84072,5,2,293423,293423,293425,0,2,4
84073,6,2,293429,293429,293431,0,2,4
84074,4,2,293433,293433,293435,0,2,2
84075,5,3,293438,293438,293441,0,3,3
84076,4,2,293442,293442,293444,0,2,1
84077,6,3,293448,293448,293451,0,3,4
84078,6,3,293454,293454,293457,0,3,3
84079,2,1,293456,293457,293458,1,2,0
84080,6,1,293462,293462,293463,0,1,4
84081,3,1,293465,293465,293466,0,1,2
84082,3,3,293468,293468,293471,0,3,2
84083,5,1,293473,293473,293474,0,1,2
84084,1,1,293474,293474,293475,0,1,0
84085,5,2,293479,293479,293481,0,2,4
84086,6,2,293485,293485,293487,0,2,4
84087,2,2,293487,293487,293489,0,2,0
84088,4,1,293491,293491,293492,0,1,2
84089,4,1,293495,293495,293496,0,1,3
84090,1,2,293496,293496,293498,0,2,0
84091,3,1,293499,293499,293500,0,1,1
84092,1,3,293500,293500,293503,0,3,0
84093,6,3,293506,293506,293509,0,3,3
84094,4,2,293510,293510,293512,0,2,1
84095,3,3,293513,293513,293516,0,3,1
84096,2,3,293515,293516,293519,1,4,0
84097,1,3,293516,293519,293522,3,6,0
84098,1,1,293517,293522,293523,5,6,0
84099,5,2,293522,293523,293525,1,3,0
84100,1,2,293523,293525,293527,2,4,0
84101,5,3,293528,293528,293531,0,3,1
84102,1,1,293529,293531,293532,2,3,0
84103,4,2,293533,293533,293535,0,2,1
84104,4,1,293537,293537,293538,0,1,2
84105,2,3,293539,293539,293542,0,3,1
84106,4,2,293543,293543,293545,0,2,1
84107,2,3,293545,293545,293548,0,3,0
84108,5,1,293550,293550,293551,0,1,2
84109,1,3,293551,293551,293554,0,3,0
84110,2,3,293553,293554,293557,1,4,0
84111,5,3,293558,293558,293561,0,3,1
84112,4,3,293562,293562,293565,0,3,1
84113,3,3,293565,293565,293568,0,3,0
84114,4,1,293569,293569,293570,0,1,1
84115,6,3,293575,293575,293578,0,3,5
84116,4,1,293579,293579,293580,0,1,1
84117,5,1,293584,293584,293585,0,1,4
84118,5,1,293589,293589,293590,0,1,4
84119,5,1,293594,293594,293595,0,1,4
84120,6,2,293600,293600,293602,0,2,5
84121,6,2,293606,293606,293608,0,2,4
84122,6,1,293612,293612,293613,0,1,4
84123,6,3,293618,293618,293621,0,3,5
84124,5,1,293623,293623,293624,0,1,2
84125,2,1,293625,293625,293626,0,1,1
84126,1,2,293626,293626,293628,0,2,0
84127,5,2,293631,293631,293633,0,2,3
84128,1,2,293632,293633,293635,1,3,0
84129,4,3,293636,293636,293639,0,3,1
84130,2,3,293638,293639,293642,1,4,0
84131,1,3,293639,293642,293645,3,6,0
84132,5,1,293644,293645,293646,1,2,0
84133,2,2,293646,293646,293648,0,2,0
84134,5,2,293651,293651,293653,0,2,3
84135,3,2,293654,293654,293656,0,2,1
84136,5,3,293659,293659,293662,0,3,3
84137,1,1,293660,293662,293663,2,3,0
84138,3,2,293663,293663,293665,0,2,0
84139,2,1,293665,293665,293666,0,1,0
84140,6,1,293671,293671,293672,0,1,5
84141,6,3,293677,293677,293680,0,3,5
84142,4,1,293681,293681,293682,0,1,1
84143,2,2,293683,293683,293685,0,2,1
84144,4,1,293687,293687,293688,0,1,2
84145,3,2,293690,293690,293692,0,2,2
84146,5,3,293695,293695,293698,0,3,3
84147,2,3,293697,293698,293701,1,4,0
84148,3,2,293700,293701,293703,1,3,0
84149,1,1,293701,293703,293704,2,3,0
84150,3,2,293704,293704,293706,0,2,0
84151,4,1,293708,293708,293709,0,1,2
84152,2,1,293710,293710,293711,0,1,1
84153,3,3,293713,293713,293716,0,3,2
84154,6,2,293719,293719,293721,0,2,3
84155,4,3,293723,293723,293726,0,3,2
84156,3,1,293726,293726,293727,0,1,0
84157,5,3,293731,293731,293734,0,3,4
84158,1,1,293732,293734,293735,2,3,0
84159,5,1,293737,293737,293738,0,1,2
84160,3,2,293740,293740,293742,0,2,2
84161,5,2,293745,293745,293747,0,2,3
84162,4,3,293749,293749,293752,0,3,2
84163,6,3,293755,293755,293758,0,3,3
84164,1,1,293756,293758,293759,2,3,0
84165,2,3,293758,293759,293762,1,4,0
84166,6,2,293764,293764,293766,0,2,2
84167,1,2,293765,293766,293768,1,3,0
84168,6,1,293771,293771,293772,0,1,3
84169,4,2,293775,293775,293777,0,2,3
84170,3,2,293778,293778,293780,0,2,1
84171,2,1,293780,293780,293781,0,1,0
84172,2,1,293782,293782,293783,0,1,1
84173,6,3,293788,293788,293791,0,3,5
84174,1,3,293789,293791,293794,2,5,0
84175,5,2,293794,293794,293796,0,2,0
84176,3,1,293797,293797,293798,0,1,1
84177,5,1,293802,293802,293803,0,1,4
84178,5,2,293807,293807,293809,0,2,4
84179,6,2,293813,293813,293815,0,2,4
84180,3,1,293816,293816,293817,0,1,1
84181,2,3,293818,293818,293821,0,3,1
84182,1,1,293819,293821,293822,2,3,0
84183,5,2,293824,293824,293826,0,2,2
84184,3,1,293827,293827,293828,0,1,1
84185,4,1,293831,293831,293832,0,1,3
84186,2,1,293833,293833,293834,0,1,1
84187,4,2,293837,293837,293839,0,2,3
84188,4,1,293841,293841,293842,0,1,2
84189,1,3,293842,293842,293845,0,3,0
84190,5,3,293847,293847,293850,0,3,2
84191,2,2,293849,293850,293852,1,3,0
84192,4,1,293853,293853,293854,0,1,1
84193,1,1,293854,293854,293855,0,1,0
84194,3,1,293857,293857,293858,0,1,2
84195,2,3,293859,293859,293862,0,3,1
84196,6,1,293865,293865,293866,0,1,3
84197,4,3,293869,293869,293872,0,3,3
84198,3,3,293872,293872,293875,0,3,0
84199,4,2,293876,293876,293878,0,2,1
84200,2,2,293878,293878,293880,0,2,0
84201,5,3,293883,293883,293886,0,3,3
84202,3,3,293886,293886,293889,0,3,0
84203,2,3,293888,293889,293892,1,4,0
84204,4,2,293892,293892,293894,0,2,0
84205,2,1,293894,293894,293895,0,1,0
84206,4,1,293898,293898,293899,0,1,3
84207,1,3,293899,293899,293902,0,3,0
84208,2,2,293901,293902,293904,1,3,0
84209,5,3,293906,293906,293909,0,3,2
84210,1,1,293907,293909,293910,2,3,0
84211,5,2,293912,293912,293914,0,2,2
84212,5,3,293917,293917,293920,0,3,3
84213,2,3,293919,293920,293923,1,4,0
84214,2,2,293921,293923,293925,2,4,0
84215,2,3,293923,293925,293928,2,5,0
84216,2,1,293925,293928,293929,3,4,0
84217,5,3,293930,293930,293933,0,3,1
84218,2,2,293932,293933,293935,1,3,0
84219,3,1,293935,293935,293936,0,1,0
84220,6,1,293941,293941,293942,0,1,5
84221,3,2,293944,293944,293946,0,2,2
84222,4,2,293948,293948,293950,0,2,2
84223,5,2,293953,293953,293955,0,2,3
84224,5,2,293958,293958,293960,0,2,3
84225,2,3,293960,293960,293963,0,3,0
84226,6,2,293966,293966,293968,0,2,3
84227,3,2,293969,293969,293971,0,2,1
84228,1,3,293970,293971,293974,1,4,0
84229,3,3,293973,293974,293977,1,4,0
84230,2,1,293975,293977,293978,2,3,0
84231,1,2,293976,293978,293980,2,4,0
84232,1,2,293977,293980,293982,3,5,0
84233,3,1,293980,293982,293983,2,3,0
84234,6,1,293986,293986,293987,0,1,3
84235,2,2,293988,293988,293990,0,2,1
84236,2,2,293990,293990,293992,0,2,0
84237,4,1,293994,293994,293995,0,1,2
84238,2,2,293996,293996,293998,0,2,1
84239,6,2,294002,294002,294004,0,2,4
84240,2,1,294004,294004,294005,0,1,0
84241,6,1,294010,294010,294011,0,1,5
84242,1,3,294011,294011,294014,0,3,0
84243,6,2,294017,294017,294019,0,2,3
84244,3,3,294020,294020,294023,0,3,1
84245,1,1,294021,294023,294024,2,3,0
84246,5,1,294026,294026,294027,0,1,2
84247,4,1,294030,294030,294031,0,1,3
84248,1,1,294031,294031,294032,0,1,0
84249,4,3,294035,294035,294038,0,3,3
84250,2,3,294037,294038,294041,1,4,0
84251,5,2,294042,294042,294044,0,2,1
84252,6,2,294048,294048,294050,0,2,4
84253,3,2,294051,294051,294053,0,2,1
84254,4,2,294055,294055,294057,0,2,2
84255,4,2,294059,294059,294061,0,2,2
84256,5,2,294064,294064,294066,0,2,3
84257,5,3,294069,294069,294072,0,3,3
84258,6,1,294075,294075,294076,0,1,3
84259,6,1,294081,294081,294082,0,1,5
84260,1,3,294082,294082,294085,0,3,0
84261,2,1,294084,294085,294086,1,2,0
84262,1,3,294085,294086,294089,1,4,0
84263,1,1,294086,294089,294090,3,4,0
84264,1,1,294087,294090,294091,3,4,0
84265,3,1,294090,294091,294092,1,2,0
84266,1,2,294091,294092,294094,1,3,0
84267,5,1,294096,294096,294097,0,1,2
84268,5,2,294101,294101,294103,0,2,4
84269,6,1,294107,294107,294108,0,1,4
84270,6,3,294113,294113,294116,0,3,5
84271,1,1,294114,294116,294117,2,3,0
84272,3,3,294117,294117,294120,0,3,0
84273,1,1,294118,294120,294121,2,3,0
84274,2,2,294120,294121,294123,1,3,0
84275,4,2,294124,294124,294126,0,2,1
84276,3,3,294127,294127,294130,0,3,1
84277,5,2,294132,294132,294134,0,2,2
84278,3,2,294135,294135,294137,0,2,1
84279,3,3,294138,294138,294141,0,3,1
84280,2,3,294140,294141,294144,1,4,0
84281,3,1,294143,294144,294145,1,2,0
84282,6,2,294149,294149,294151,0,2,4
84283,2,3,294151,294151,294154,0,3,0
84284,2,1,294153,294154,294155,1,2,0
84285,3,1,294156,294156,294157,0,1,1
84286,2,3,294158,294158,294161,0,3,1
84287,3,1,294161,294161,294162,0,1,0
84288,4,2,294165,294165,294167,0,2,3
84289,2,1,294167,294167,294168,0,1,0
84290,2,2,294169,294169,294171,0,2,1
84291,3,3,294172,294172,294175,0,3,1
84292,6,2,294178,294178,294180,0,2,3
84293,1,1,294179,294180,294181,1,2,0
84294,3,1,294182,294182,294183,0,1,1
84295,1,1,294183,294183,294184,0,1,0
84296,2,1,294185,294185,294186,0,1,1
84297,4,1,294189,294189,294190,0,1,3
84298,6,1,294195,294195,294196,0,1,5
84299,2,2,294197,294197,294199,0,2,1
84300,4,1,294201,294201,294202,0,1,2
84301,6,1,294207,294207,294208,0,1,5
84302,3,1,294210,294210,294211,0,1,2
84303,6,2,294216,294216,294218,0,2,5
84304,1,3,294217,294218,294221,1,4,0
84305,5,1,294222,294222,294223,0,1,1
84306,3,1,294225,294225,294226,0,1,2
84307,1,1,294226,294226,294227,0,1,0
84308,1,1,294227,294227,294228,0,1,0
84309,2,2,294229,294229,294231,0,2,1
84310,4,1,294233,294233,294234,0,1,2
84311,4,2,294237,294237,294239,0,2,3
84312,5,2,294242,294242,294244,0,2,3
84313,2,3,294244,294244,294247,0,3,0
84314,5,3,294249,294249,294252,0,3,2
84315,1,1,294250,294252,294253,2,3,0
84316,4,3,294254,294254,294257,0,3,1
84317,5,2,294259,294259,294261,0,2,2
84318,4,1,294263,294263,294264,0,1,2
84319,6,1,294269,294269,294270,0,1,5
84320,3,2,294272,294272,294274,0,2,2
84321,4,2,294276,294276,294278,0,2,2
84322,6,3,294282,294282,294285,0,3,4
84323,6,1,294288,294288,294289,0,1,3
84324,3,3,294291,294291,294294,0,3,2
84325,5,2,294296,294296,294298,0,2,2
84326,5,1,294301,294301,294302,0,1,3
84327,1,1,294302,294302,294303,0,1,0
84328,4,3,294306,294306,294309,0,3,3
84329,3,1,294309,294309,294310,0,1,0
84330,3,3,294312,294312,294315,0,3,2
84331,4,3,294316,294316,294319,0,3,1
84332,6,2,294322,294322,294324,0,2,3
84333,2,2,294324,294324,294326,0,2,0
84334,2,2,294326,294326,294328,0,2,0
84335,5,1,294331,294331,294332,0,1,3
84336,3,2,294334,294334,294336,0,2,2
84337,3,3,294337,294337,294340,0,3,1
84338,2,3,294339,294340,294343,1,4,0
84339,3,3,294342,294343,294346,1,4,0
84340,1,3,294343,294346,294349,3,6,0
84341,4,3,294347,294349,294352,2,5,0
84342,3,1,294350,294352,294353,2,3,0
84343,2,2,294352,294353,294355,1,3,0
84344,4,2,294356,294356,294358,0,2,1
84345,2,2,294358,294358,294360,0,2,0
84346,5,1,294363,294363,294364,0,1,3
84347,5,2,294368,294368,294370,0,2,4
84348,4,1,294372,294372,294373,0,1,2
84349,2,3,294374,294374,294377,0,3,1
84350,4,2,294378,294378,294380,0,2,1
84351,5,1,294383,294383,294384,0,1,3
84352,1,1,294384,294384,294385,0,1,0
84353,2,1,294386,294386,294387,0,1,1
84354,3,1,294389,294389,294390,0,1,2
84355,3,3,294392,294392,294395,0,3,2
84356,3,1,294395,294395,294396,0,1,0
84357,5,3,294400,294400,294403,0,3,4
84358,1,3,294401,294403,294406,2,5,0
84359,3,2,294404,294406,294408,2,4,0
84360,3,2,294407,294408,294410,1,3,0
84361,6,1,294413,294413,294414,0,1,3
84362,2,2,294415,294415,294417,0,2,1
84363,5,1,294420,294420,294421,0,1,3
84364,2,1,294422,294422,294423,0,1,1
84365,6,2,294428,294428,294430,0,2,5
84366,4,2,294432,294432,294434,0,2,2
84367,3,2,294435,294435,294437,0,2,1
84368,1,3,294436,294437,294440,1,4,0
84369,5,2,294441,294441,294443,0,2,1
84370,6,3,294447,294447,294450,0,3,4
84371,3,2,294450,294450,294452,0,2,0
84372,4,1,294454,294454,294455,0,1,2
84373,3,3,294457,294457,294460,0,3,2
84374,1,1,294458,294460,294461,2,3,0
84375,4,3,294462,294462,294465,0,3,1
84376,1,2,294463,294465,294467,2,4,0
84377,1,3,294464,294467,294470,3,6,0
84378,6,3,294470,294470,294473,0,3,0
84379,5,3,294475,294475,294478,0,3,2
84380,3,3,294478,294478,294481,0,3,0
84381,6,3,294484,294484,294487,0,3,3
84382,1,3,294485,294487,294490,2,5,0
84383,1,1,294486,294490,294491,4,5,0
84384,4,1,294490,294491,294492,1,2,0
84385,4,3,294494,294494,294497,0,3,2
84386,5,3,294499,294499,294502,0,3,2
84387,6,3,294505,294505,294508,0,3,3
84388,5,3,294510,294510,294513,0,3,2
84389,6,1,294516,294516,294517,0,1,3
84390,3,2,294519,294519,294521,0,2,2
84391,1,1,294520,294521,294522,1,2,0
84392,3,3,294523,294523,294526,0,3,1
84393,6,3,294529,294529,294532,0,3,3
84394,6,1,294535,294535,294536,0,1,3
84395,4,1,294539,294539,294540,0,1,3
84396,6,3,294545,294545,294548,0,3,5
84397,5,2,294550,294550,294552,0,2,2
84398,4,3,294554,294554,294557,0,3,2
84399,1,2,294555,294557,294559,2,4,0
84400,4,1,294559,294559,294560,0,1,0
84401,5,2,294564,294564,294566,0,2,4
84402,3,1,294567,294567,294568,0,1,1
84403,3,2,294570,294570,294572,0,2,2
84404,5,1,294575,294575,294576,0,1,3
84405,5,3,294580,294580,294583,0,3,4
84406,4,2,294584,294584,294586,0,2,1
84407,5,1,294589,294589,294590,0,1,3
84408,1,1,294590,294590,294591,0,1,0
84409,4,3,294594,294594,294597,0,3,3
84410,6,2,294600,294600,294602,0,2,3
84411,5,1,294605,294605,294606,0,1,3
84412,6,2,294611,294611,294613,0,2,5
84413,5,3,294616,294616,294619,0,3,3
84414,4,1,294620,294620,294621,0,1,1
84415,6,1,294626,294626,294627,0,1,5
84416,3,2,294629,294629,294631,0,2,2
84417,5,2,294634,294634,294636,0,2,3
84418,5,3,294639,294639,294642,0,3,3
84419,1,2,294640,294642,294644,2,4,0
84420,4,1,294644,294644,294645,0,1,0
84421,2,3,294646,294646,294649,0,3,1
84422,3,2,294649,294649,294651,0,2,0
84423,6,2,294655,294655,294657,0,2,4
84424,2,1,294657,294657,294658,0,1,0
84425,1,2,294658,294658,294660,0,2,0
84426,4,1,294662,294662,294663,0,1,2
84427,2,1,294664,294664,294665,0,1,1
84428,5,1,294669,294669,294670,0,1,4
84429,3,3,294672,294672,294675,0,3,2
84430,2,1,294674,294675,294676,1,2,0
84431,3,2,294677,294677,294679,0,2,1
84432,2,3,294679,294679,294682,0,3,0
84433,2,3,294681,294682,294685,1,4,0
84434,5,1,294686,294686,294687,0,1,1
84435,3,2,294689,294689,294691,0,2,2
84436,4,1,294693,294693,294694,0,1,2
84437,6,3,294699,294699,294702,0,3,5
84438,4,2,294703,294703,294705,0,2,1
84439,3,2,294706,294706,294708,0,2,1
84440,2,2,294708,294708,294710,0,2,0
84441,6,1,294714,294714,294715,0,1,4
84442,5,2,294719,294719,294721,0,2,4
84443,3,2,294722,294722,294724,0,2,1
84444,1,3,294723,294724,294727,1,4,0
84445,5,1,294728,294728,294729,0,1,1
84446,4,1,294732,294732,294733,0,1,3
84447,4,1,294736,294736,294737,0,1,3
84448,5,3,294741,294741,294744,0,3,4
84449,2,2,294743,294744,294746,1,3,0
84450,3,1,294746,294746,294747,0,1,0
84451,3,3,294749,294749,294752,0,3,2
84452,4,2,294753,294753,294755,0,2,1
84453,6,2,294759,294759,294761,0,2,4
84454,5,1,294764,294764,294765,0,1,3
84455,2,3,294766,294766,294769,0,3,1
84456,5,1,294771,294771,294772,0,1,2
84457,1,3,294772,294772,294775,0,3,0
84458,4,1,294776,294776,294777,0,1,1
84459,3,2,294779,294779,294781,0,2,2
84460,6,2,294785,294785,294787,0,2,4
84461,6,1,294791,294791,294792,0,1,4
84462,1,1,294792,294792,294793,0,1,0
84463,1,3,294793,294793,294796,0,3,0
84464,3,2,294796,294796,294798,0,2,0
84465,4,1,294800,294800,294801,0,1,2
84466,6,3,294806,294806,294809,0,3,5
84467,6,2,294812,294812,294814,0,2,3
84468,6,2,294818,294818,294820,0,2,4
84469,5,1,294823,294823,294824,0,1,3
84470,3,2,294826,294826,294828,0,2,2
84471,3,2,294829,294829,294831,0,2,1
84472,6,1,294835,294835,294836,0,1,4
84473,5,3,294840,294840,294843,0,3,4
84474,2,1,294842,294843,294844,1,2,0
84475,2,2,294844,294844,294846,0,2,0
84476,1,1,294845,294846,294847,1,2,0
84477,5,3,294850,294850,294853,0,3,3
84478,1,1,294851,294853,294854,2,3,0
84479,5,2,294856,294856,294858,0,2,2
84480,4,1,294860,294860,294861,0,1,2
84481,2,2,294862,294862,294864,0,2,1
84482,3,2,294865,294865,294867,0,2,1
84483,3,1,294868,294868,294869,0,1,1
84484,6,2,294874,294874,294876,0,2,5
84485,5,2,294879,294879,294881,0,2,3
84486,6,2,294885,294885,294887,0,2,4
84487,6,1,294891,294891,294892,0,1,4
84488,6,1,294897,294897,294898,0,1,5
84489,3,3,294900,294900,294903,0,3,2
84490,5,2,294905,294905,294907,0,2,2
84491,2,2,294907,294907,294909,0,2,0
84492,5,1,294912,294912,294913,0,1,3
84493,3,1,294915,294915,294916,0,1,2
84494,1,3,294916,294916,294919,0,3,0
84495,6,2,294922,294922,294924,0,2,3
84496,2,2,294924,294924,294926,0,2,0
84497,3,1,294927,294927,294928,0,1,1
84498,2,3,294929,294929,294932,0,3,1
84499,5,2,294934,294934,294936,0,2,2
84500,1,2,294935,294936,294938,1,3,0
84501,2,3,294937,294938,294941,1,4,0
84502,1,3,294938,294941,294944,3,6,0
84503,5,1,294943,294944,294945,1,2,0
84504,2,1,294945,294945,294946,0,1,0
84505,5,3,294950,294950,294953,0,3,4
84506,1,3,294951,294953,294956,2,5,0
84507,6,2,294957,294957,294959,0,2,1
84508,1,1,294958,294959,294960,1,2,0
84509,1,2,294959,294960,294962,1,3,0
84510,1,1,294960,294962,294963,2,3,0
84511,6,1,294966,294966,294967,0,1,3
84512,5,1,294971,294971,294972,0,1,4
84513,1,2,294972,294972,294974,0,2,0
84514,1,1,294973,294974,294975,1,2,0
84515,6,3,294979,294979,294982,0,3,4
84516,4,2,294983,294983,294985,0,2,1
84517,1,3,294984,294985,294988,1,4,0
84518,3,3,294987,294988,294991,1,4,0
84519,5,1,294992,294992,294993,0,1,1
84520,2,1,294994,294994,294995,0,1,1
84521,5,2,294999,294999,295001,0,2,4
84522,1,2,295000,295001,295003,1,3,0
84523,6,1,295006,295006,295007,0,1,3
84524,2,1,295008,295008,295009,0,1,1
84525,2,3,295010,295010,295013,0,3,1
84526,4,2,295014,295014,295016,0,2,1
84527,4,3,295018,295018,295021,0,3,2
84528,5,3,295023,295023,295026,0,3,2
84529,5,3,295028,295028,295031,0,3,2
84530,1,1,295029,295031,295032,2,3,0
84531,6,1,295035,295035,295036,0,1,3
84532,2,2,295037,295037,295039,0,2,1
84533,1,1,295038,295039,295040,1,2,0
84534,5,3,295043,295043,295046,0,3,3
84535,1,3,295044,295046,295049,2,5,0
84536,6,1,295050,295050,295051,0,1,1
84537,4,2,295054,295054,295056,0,2,3
84538,3,2,295057,295057,295059,0,2,1
84539,2,3,295059,295059,295062,0,3,0
84540,6,1,295065,295065,295066,0,1,3
84541,1,1,295066,295066,295067,0,1,0
84542,4,3,295070,295070,295073,0,3,3
84543,6,3,295076,295076,295079,0,3,3
84544,6,2,295082,295082,295084,0,2,3
84545,5,3,295087,295087,295090,0,3,3
84546,2,1,295089,295090,295091,1,2,0
84547,2,3,295091,295091,295094,0,3,0
84548,5,3,295096,295096,295099,0,3,2
84549,6,3,295102,295102,295105,0,3,3
84550,1,1,295103,295105,295106,2,3,0
84551,1,2,295104,295106,295108,2,4,0
84552,2,3,295106,295108,295111,2,5,0
84553,3,2,295109,295111,295113,2,4,0
84554,4,3,295113,295113,295116,0,3,0
84555,4,1,295117,295117,295118,0,1,1
84556,1,1,295118,295118,295119,0,1,0
84557,3,2,295121,295121,295123,0,2,2
84558,5,3,295126,295126,295129,0,3,3
84559,3,1,295129,295129,295130,0,1,0
84560,3,3,295132,295132,295135,0,3,2
84561,3,3,295135,295135,295138,0,3,0
84562,4,1,295139,295139,295140,0,1,1
84563,5,1,295144,295144,295145,0,1,4
84564,3,2,295147,295147,295149,0,2,2
84565,3,3,295150,295150,295153,0,3,1
84566,5,2,295155,295155,295157,0,2,2
84567,3,1,295158,295158,295159,0,1,1
84568,5,1,295163,295163,295164,0,1,4
84569,6,3,295169,295169,295172,0,3,5
84570,4,3,295173,295173,295176,0,3,1
84571,1,1,295174,295176,295177,2,3,0
84572,6,3,295180,295180,295183,0,3,3
84573,1,2,295181,295183,295185,2,4,0
84574,2,1,295183,295185,295186,2,3,0
84575,2,3,295185,295186,295189,1,4,0
84576,1,1,295186,295189,295190,3,4,0
84577,5,3,295191,295191,295194,0,3,1
84578,6,2,295197,295197,295199,0,2,3
84579,3,3,295200,295200,295203,0,3,1
84580,2,2,295202,295203,295205,1,3,0
84581,6,2,295208,295208,295210,0,2,3
84582,4,1,295212,295212,295213,0,1,2
84583,6,2,295218,295218,295220,0,2,5
84584,5,2,295223,295223,295225,0,2,3
84585,3,2,295226,295226,295228,0,2,1
84586,4,2,295230,295230,295232,0,2,2
84587,2,3,295232,295232,295235,0,3,0
84588,3,1,295235,295235,295236,0,1,0
84589,5,3,295240,295240,295243,0,3,4
84590,4,2,295244,295244,295246,0,2,1
84591,4,2,295248,295248,295250,0,2,2
84592,1,2,295249,295250,295252,1,3,0
84593,3,1,295252,295252,295253,0,1,0
84594,2,2,295254,295254,295256,0,2,1
84595,6,2,295260,295260,295262,0,2,4
84596,5,3,295265,295265,295268,0,3,3
84597,6,2,295271,295271,295273,0,2,3
84598,2,3,295273,295273,295276,0,3,0
84599,3,3,295276,295276,295279,0,3,0
84600,3,3,295279,295279,295282,0,3,0
84601,5,3,295284,295284,295287,0,3,2
84602,2,2,295286,295287,295289,1,3,0
84603,6,2,295292,295292,295294,0,2,3
84604,6,2,295298,295298,295300,0,2,4
84605,2,1,295300,295300,295301,0,1,0
84606,3,1,295303,295303,295304,0,1,2
84607,3,3,295306,295306,295309,0,3,2
84608,2,2,295308,295309,295311,1,3,0
84609,1,3,295309,295311,295314,2,5,0
84610,4,3,295313,295314,295317,1,4,0
84611,5,3,295318,295318,295321,0,3,1
84612,2,3,295320,295321,295324,1,4,0
84613,5,2,295325,295325,295327,0,2,1
84614,5,1,295330,295330,295331,0,1,3
84615,3,2,295333,295333,295335,0,2,2
84616,5,3,295338,295338,295341,0,3,3
84617,3,1,295341,295341,295342,0,1,0
84618,3,1,295344,295344,295345,0,1,2
84619,2,3,295346,295346,295349,0,3,1
84620,2,2,295348,295349,295351,1,3,0
84621,6,2,295354,295354,295356,0,2,3
84622,5,2,295359,295359,295361,0,2,3
84623,6,2,295365,295365,295367,0,2,4
84624,6,3,295371,295371,295374,0,3,4
84625,2,2,295373,295374,295376,1,3,0
84626,1,3,295374,295376,295379,2,5,0
84627,1,2,295375,295379,295381,4,6,0
84628,3,2,295378,295381,295383,3,5,0
84629,1,1,295379,295383,295384,4,5,0
84630,4,1,295383,295384,295385,1,2,0
84631,6,3,295389,295389,295392,0,3,4
84632,1,3,295390,295392,295395,2,5,0
84633,4,2,295394,295395,295397,1,3,0
84634,4,3,295398,295398,295401,0,3,1
84635,5,2,295403,295403,295405,0,2,2
84636,2,2,295405,295405,295407,0,2,0
84637,4,2,295409,295409,295411,0,2,2
84638,1,3,295410,295411,295414,1,4,0
84639,6,1,295416,295416,295417,0,1,2
84640,4,2,295420,295420,295422,0,2,3
84641,2,1,295422,295422,295423,0,1,0
84642,2,1,295424,295424,295425,0,1,1
84643,2,1,295426,295426,295427,0,1,1
84644,4,1,295430,295430,295431,0,1,3
84645,1,3,295431,295431,295434,0,3,0
84646,1,2,295432,295434,295436,2,4,0
84647,3,2,295435,295436,295438,1,3,0
84648,2,2,295437,295438,295440,1,3,0
84649,6,3,295443,295443,295446,0,3,3
84650,4,1,295447,295447,295448,0,1,1
84651,4,2,295451,295451,295453,0,2,3
84652,1,2,295452,295453,295455,1,3,0
84653,5,3,295457,295457,295460,0,3,2
84654,6,3,295463,295463,295466,0,3,3
84655,4,2,295467,295467,295469,0,2,1
84656,6,3,295473,295473,295476,0,3,4
84657,6,3,295479,295479,295482,0,3,3
84658,3,2,295482,295482,295484,0,2,0
84659,1,3,295483,295484,295487,1,4,0
84660,6,1,295489,295489,295490,0,1,2
84661,6,1,295495,295495,295496,0,1,5
84662,5,2,295500,295500,295502,0,2,4
84663,1,1,295501,295502,295503,1,2,0
84664,2,3,295503,295503,295506,0,3,0
84665,5,2,295508,295508,295510,0,2,2
84666,6,3,295514,295514,295517,0,3,4
84667,2,3,295516,295517,295520,1,4,0
84668,6,3,295522,295522,295525,0,3,2
84669,3,2,295525,295525,295527,0,2,0
84670,5,2,295530,295530,295532,0,2,3
84671,4,1,295534,295534,295535,0,1,2
84672,3,3,295537,295537,295540,0,3,2
84673,1,3,295538,295540,295543,2,5,0
84674,4,2,295542,295543,295545,1,3,0
84675,1,3,295543,295545,295548,2,5,0
84676,4,2,295547,295548,295550,1,3,0
84677,2,2,295549,295550,295552,1,3,0
84678,1,2,295550,295552,295554,2,4,0
84679,4,3,295554,295554,295557,0,3,0
84680,1,2,295555,295557,295559,2,4,0
84681,5,1,295560,295560,295561,0,1,1
84682,4,3,295564,295564,295567,0,3,3
84683,4,3,295568,295568,295571,0,3,1
84684,1,1,295569,295571,295572,2,3,0
84685,1,1,295570,295572,295573,2,3,0
84686,4,2,295574,295574,295576,0,2,1
84687,4,3,295578,295578,295581,0,3,2
84688,6,1,295584,295584,295585,0,1,3
84689,1,3,295585,295585,295588,0,3,0
84690,1,3,295586,295588,295591,2,5,0
84691,2,2,295588,295591,295593,3,5,0
84692,3,3,295591,295593,295596,2,5,0
84693,2,1,295593,295596,295597,3,4,0
84694,4,3,295597,295597,295600,0,3,0
84695,5,3,295602,295602,295605,0,3,2
84696,5,1,295607,295607,295608,0,1,2
84697,2,1,295609,295609,295610,0,1,1
84698,3,2,295612,295612,295614,0,2,2
84699,3,1,295615,295615,295616,0,1,1
84700,3,2,295618,295618,295620,0,2,2
84701,2,2,295620,295620,295622,0,2,0
84702,2,2,295622,295622,295624,0,2,0
84703,2,3,295624,295624,295627,0,3,0
84704,2,1,295626,295627,295628,1,2,0
84705,5,2,295631,295631,295633,0,2,3
84706,1,3,295632,295633,295636,1,4,0
84707,2,2,295634,295636,295638,2,4,0
84708,1,1,295635,295638,295639,3,4,0
84709,4,1,295639,295639,295640,0,1,0
84710,4,2,295643,295643,295645,0,2,3
84711,1,1,295644,295645,295646,1,2,0
84712,6,2,295650,295650,295652,0,2,4
84713,4,1,295654,295654,295655,0,1,2
84714,6,3,295660,295660,295663,0,3,5
84715,6,3,295666,295666,295669,0,3,3
84716,2,3,295668,295669,295672,1,4,0
84717,6,3,295674,295674,295677,0,3,2
84718,2,3,295676,295677,295680,1,4,0
84719,2,2,295678,295680,295682,2,4,0
84720,1,2,295679,295682,295684,3,5,0
84721,2,3,295681,295684,295687,3,6,0
84722,1,2,295682,295687,295689,5,7,0
84723,1,2,295683,295689,295691,6,8,0
84724,1,2,295684,295691,295693,7,9,0
84725,6,1,295690,295693,295694,3,4,0
84726,2,1,295692,295694,295695,2,3,0
84727,1,3,295693,295695,295698,2,5,0
84728,6,1,295699,295699,295700,0,1,1
84729,3,2,295702,295702,295704,0,2,2
84730,6,2,295708,295708,295710,0,2,4
84731,2,2,295710,295710,295712,0,2,0
84732,4,1,295714,295714,295715,0,1,2
84733,1,1,295715,295715,295716,0,1,0
84734,6,2,295721,295721,295723,0,2,5
84735,3,1,295724,295724,295725,0,1,1
84736,2,3,295726,295726,295729,0,3,1
84737,3,3,295729,295729,295732,0,3,0
84738,2,3,295731,295732,295735,1,4,0
84739,5,2,295736,295736,295738,0,2,1
84740,5,2,295741,295741,295743,0,2,3
84741,1,3,295742,295743,295746,1,4,0
84742,4,1,295746,295746,295747,0,1,0
84743,5,1,295751,295751,295752,0,1,4
84744,4,2,295755,295755,295757,0,2,3
84745,1,2,295756,295757,295759,1,3,0
84746,3,3,295759,295759,295762,0,3,0
84747,2,1,295761,295762,295763,1,2,0
84748,1,3,295762,295763,295766,1,4,0
84749,2,3,295764,295766,295769,2,5,0
84750,6,1,295770,295770,295771,0,1,1
84751,3,2,295773,295773,295775,0,2,2
84752,2,1,295775,295775,295776,0,1,0
84753,5,2,295780,295780,295782,0,2,4
84754,5,2,295785,295785,295787,0,2,3
84755,3,1,295788,295788,295789,0,1,1
84756,4,1,295792,295792,295793,0,1,3
84757,2,1,295794,295794,295795,0,1,1
84758,4,3,295798,295798,295801,0,3,3
84759,1,2,295799,295801,295803,2,4,0
84760,3,3,295802,295803,295806,1,4,0
84761,2,2,295804,295806,295808,2,4,0
84762,4,3,295808,295808,295811,0,3,0
84763,6,3,295814,295814,295817,0,3,3
84764,3,3,295817,295817,295820,0,3,0
84765,3,1,295820,295820,295821,0,1,0
84766,6,3,295826,295826,295829,0,3,5
84767,5,3,295831,295831,295834,0,3,2
84768,3,3,295834,295834,295837,0,3,0
84769,4,1,295838,295838,295839,0,1,1
84770,1,3,295839,295839,295842,0,3,0
84771,4,3,295843,295843,295846,0,3,1
84772,1,2,295844,295846,295848,2,4,0
84773,4,2,295848,295848,295850,0,2,0
84774,5,1,295853,295853,295854,0,1,3
84775,6,2,295859,295859,295861,0,2,5
84776,5,3,295864,295864,295867,0,3,3
84777,1,1,295865,295867,295868,2,3,0
84778,3,3,295868,295868,295871,0,3,0
84779,1,3,295869,295871,295874,2,5,0
84780,2,2,295871,295874,295876,3,5,0
84781,4,3,295875,295876,295879,1,4,0
84782,6,2,295881,295881,295883,0,2,2
84783,5,3,295886,295886,295889,0,3,3
84784,4,2,295890,295890,295892,0,2,1
84785,3,3,295893,295893,295896,0,3,1
84786,4,3,295897,295897,295900,0,3,1
84787,2,2,295899,295900,295902,1,3,0
84788,2,1,295901,295902,295903,1,2,0
84789,6,2,295907,295907,295909,0,2,4
84790,5,1,295912,295912,295913,0,1,3
84791,6,1,295918,295918,295919,0,1,5
84792,3,1,295921,295921,295922,0,1,2
84793,4,2,295925,295925,295927,0,2,3
84794,2,2,295927,295927,295929,0,2,0
84795,1,2,295928,295929,295931,1,3,0
84796,3,2,295931,295931,295933,0,2,0
84797,2,2,295933,295933,295935,0,2,0
84798,4,2,295937,295937,295939,0,2,2
84799,1,3,295938,295939,295942,1,4,0
84800,3,2,295941,295942,295944,1,3,0
84801,4,1,295945,295945,295946,0,1,1
84802,4,3,295949,295949,295952,0,3,3
84803,3,1,295952,295952,295953,0,1,0
84804,3,1,295955,295955,295956,0,1,2
84805,1,1,295956,295956,295957,0,1,0
84806,3,2,295959,295959,295961,0,2,2
84807,3,2,295962,295962,295964,0,2,1
84808,4,1,295966,295966,295967,0,1,2
84809,2,1,295968,295968,295969,0,1,1
84810,5,1,295973,295973,295974,0,1,4
84811,6,1,295979,295979,295980,0,1,5
84812,6,1,295985,295985,295986,0,1,5
84813,5,3,295990,295990,295993,0,3,4
84814,6,2,295996,295996,295998,0,2,3
84815,6,1,296002,296002,296003,0,1,4
84816,4,2,296006,296006,296008,0,2,3
84817,4,2,296010,296010,296012,0,2,2
84818,3,3,296013,296013,296016,0,3,1
84819,1,1,296014,296016,296017,2,3,0
84820,1,1,296015,296017,296018,2,3,0
84821,6,3,296021,296021,296024,0,3,3
84822,1,1,296022,296024,296025,2,3,0
84823,3,1,296025,296025,296026,0,1,0
84824,6,1,296031,296031,296032,0,1,5
84825,3,2,296034,296034,296036,0,2,2
84826,3,1,296037,296037,296038,0,1,1
84827,3,3,296040,296040,296043,0,3,2
84828,4,2,296044,296044,296046,0,2,1
84829,4,3,296048,296048,296051,0,3,2
84830,5,2,296053,296053,296055,0,2,2
84831,1,1,296054,296055,296056,1,2,0
84832,4,2,296058,296058,296060,0,2,2
84833,1,3,296059,296060,296063,1,4,0
84834,5,3,296064,296064,296067,0,3,1
84835,6,1,296070,296070,296071,0,1,3
84836,4,1,296074,296074,296075,0,1,3
84837,6,2,296080,296080,296082,0,2,5
84838,1,1,296081,296082,296083,1,2,0
84839,1,3,296082,296083,296086,1,4,0
84840,1,1,296083,296086,296087,3,4,0
84841,3,3,296086,296087,296090,1,4,0
84842,1,3,296087,296090,296093,3,6,0
84843,5,2,296092,296093,296095,1,3,0
84844,2,1,296094,296095,296096,1,2,0
84845,5,1,296099,296099,296100,0,1,3
84846,1,3,296100,296100,296103,0,3,0
84847,1,3,296101,296103,296106,2,5,0
84848,5,2,296106,296106,296108,0,2,0
84849,2,2,296108,296108,296110,0,2,0
84850,4,1,296112,296112,296113,0,1,2
84851,2,2,296114,296114,296116,0,2,1
84852,5,2,296119,296119,296121,0,2,3
84853,1,3,296120,296121,296124,1,4,0
84854,3,2,296123,296124,296126,1,3,0
84855,4,2,296127,296127,296129,0,2,1
84856,3,1,296130,296130,296131,0,1,1
84857,5,1,296135,296135,296136,0,1,4
84858,6,3,296141,296141,296144,0,3,5
84859,1,3,296142,296144,296147,2,5,0
84860,4,1,296146,296147,296148,1,2,0
84861,1,2,296147,296148,296150,1,3,0
84862,6,1,296153,296153,296154,0,1,3
84863,3,1,296156,296156,296157,0,1,2
84864,2,2,296158,296158,296160,0,2,1
84865,6,1,296164,296164,296165,0,1,4
84866,5,2,296169,296169,296171,0,2,4
84867,2,3,296171,296171,296174,0,3,0
84868,1,1,296172,296174,296175,2,3,0
84869,3,3,296175,296175,296178,0,3,0
84870,1,3,296176,296178,296181,2,5,0
84871,5,1,296181,296181,296182,0,1,0
84872,1,3,296182,296182,296185,0,3,0
84873,1,2,296183,296185,296187,2,4,0
84874,3,2,296186,296187,296189,1,3,0
84875,2,2,296188,296189,296191,1,3,0
84876,3,2,296191,296191,296193,0,2,0
84877,2,1,296193,296193,296194,0,1,0
84878,4,2,296197,296197,296199,0,2,3
84879,2,2,296199,296199,296201,0,2,0
84880,1,3,296200,296201,296204,1,4,0
84881,4,1,296204,296204,296205,0,1,0
84882,1,1,296205,296205,296206,0,1,0
84883,6,2,296211,296211,296213,0,2,5
84884,1,1,296212,296213,296214,1,2,0
84885,5,3,296217,296217,296220,0,3,3
84886,4,1,296221,296221,296222,0,1,1
84887,6,2,296227,296227,296229,0,2,5
84888,2,3,296229,296229,296232,0,3,0
84889,5,2,296234,296234,296236,0,2,2
84890,5,1,296239,296239,296240,0,1,3
84891,1,3,296240,296240,296243,0,3,0
84892,2,3,296242,296243,296246,1,4,0
84893,6,2,296248,296248,296250,0,2,2
84894,4,3,296252,296252,296255,0,3,2
84895,5,3,296257,296257,296260,0,3,2
84896,2,3,296259,296260,296263,1,4,0
84897,5,2,296264,296264,296266,0,2,1
84898,4,3,296268,296268,296271,0,3,2
84899,6,3,296274,296274,296277,0,3,3
84900,6,1,296280,296280,296281,0,1,3
84901,3,2,296283,296283,296285,0,2,2
84902,2,1,296285,296285,296286,0,1,0
84903,1,2,296286,296286,296288,0,2,0
84904,4,2,296290,296290,296292,0,2,2
84905,1,3,296291,296292,296295,1,4,0
84906,4,2,296295,296295,296297,0,2,0
84907,6,3,296301,296301,296304,0,3,4
84908,5,1,296306,296306,296307,0,1,2
84909,6,1,296312,296312,296313,0,1,5
84910,1,2,296313,296313,296315,0,2,0
84911,4,1,296317,296317,296318,0,1,2
84912,3,3,296320,296320,296323,0,3,2
84913,5,3,296325,296325,296328,0,3,2
84914,6,2,296331,296331,296333,0,2,3
84915,1,1,296332,296333,296334,1,2,0
84916,1,3,296333,296334,296337,1,4,0
84917,6,1,296339,296339,296340,0,1,2
84918,5,2,296344,296344,296346,0,2,4
84919,1,2,296345,296346,296348,1,3,0
84920,5,3,296350,296350,296353,0,3,2
84921,2,2,296352,296353,296355,1,3,0
84922,2,3,296354,296355,296358,1,4,0
84923,3,3,296357,296358,296361,1,4,0
84924,4,2,296361,296361,296363,0,2,0
84925,6,2,296367,296367,296369,0,2,4
84926,1,2,296368,296369,296371,1,3,0
84927,3,3,296371,296371,296374,0,3,0
84928,1,3,296372,296374,296377,2,5,0
84929,3,1,296375,296377,296378,2,3,0
84930,5,2,296380,296380,296382,0,2,2
84931,1,2,296381,296382,296384,1,3,0
84932,3,3,296384,296384,296387,0,3,0
84933,3,2,296387,296387,296389,0,2,0
84934,3,3,296390,296390,296393,0,3,1
84935,1,1,296391,296393,296394,2,3,0
84936,2,3,296393,296394,296397,1,4,0
84937,6,3,296399,296399,296402,0,3,2
84938,1,3,296400,296402,296405,2,5,0
84939,5,2,296405,296405,296407,0,2,0
84940,1,1,296406,296407,296408,1,2,0
84941,4,1,296410,296410,296411,0,1,2
84942,5,2,296415,296415,296417,0,2,4
84943,2,3,296417,296417,296420,0,3,0
84944,4,2,296421,296421,296423,0,2,1
84945,6,3,296427,296427,296430,0,3,4
84946,6,2,296433,296433,296435,0,2,3
84947,4,1,296437,296437,296438,0,1,2
84948,5,1,296442,296442,296443,0,1,4
84949,6,1,296448,296448,296449,0,1,5
84950,6,1,296454,296454,296455,0,1,5
84951,4,3,296458,296458,296461,0,3,3
84952,3,1,296461,296461,296462,0,1,0
84953,6,3,296467,296467,296470,0,3,5
84954,2,3,296469,296470,296473,1,4,0
84955,6,3,296475,296475,296478,0,3,2
84956,6,3,296481,296481,296484,0,3,3
84957,4,3,296485,296485,296488,0,3,1
84958,4,3,296489,296489,296492,0,3,1
84959,3,1,296492,296492,296493,0,1,0
84960,1,3,296493,296493,296496,0,3,0
84961,4,3,296497,296497,296500,0,3,1
84962,3,1,296500,296500,296501,0,1,0
84963,6,2,296506,296506,296508,0,2,5
84964,2,3,296508,296508,296511,0,3,0
84965,4,1,296512,296512,296513,0,1,1
84966,5,2,296517,296517,296519,0,2,4
84967,3,2,296520,296520,296522,0,2,1
84968,5,3,296525,296525,296528,0,3,3
84969,1,3,296526,296528,296531,2,5,0
84970,5,1,296531,296531,296532,0,1,0
84971,3,3,296534,296534,296537,0,3,2
84972,5,2,296539,296539,296541,0,2,2
84973,6,3,296545,296545,296548,0,3,4
84974,6,1,296551,296551,296552,0,1,3
84975,4,2,296555,296555,296557,0,2,3
84976,6,1,296561,296561,296562,0,1,4
84977,4,1,296565,296565,296566,0,1,3
84978,5,1,296570,296570,296571,0,1,4
84979,3,3,296573,296573,296576,0,3,2
84980,3,3,296576,296576,296579,0,3,0
84981,1,1,296577,296579,296580,2,3,0
84982,3,3,296580,296580,296583,0,3,0
84983,5,2,296585,296585,296587,0,2,2
84984,2,2,296587,296587,296589,0,2,0
84985,5,1,296592,296592,296593,0,1,3
84986,5,1,296597,296597,296598,0,1,4
84987,5,3,296602,296602,296605,0,3,4
84988,6,3,296608,296608,296611,0,3,3
84989,4,3,296612,296612,296615,0,3,1
84990,3,2,296615,296615,296617,0,2,0
84991,6,1,296621,296621,296622,0,1,4
84992,1,1,296622,296622,296623,0,1,0
84993,3,3,296625,296625,296628,0,3,2
84994,6,3,296631,296631,296634,0,3,3
84995,6,2,296637,296637,296639,0,2,3
84996,1,1,296638,296639,296640,1,2,0
84997,6,3,296644,296644,296647,0,3,4
84998,4,3,296648,296648,296651,0,3,1
84999,2,2,296650,296651,296653,1,3,0
85000,1,1,296651,296653,296654,2,3,0
85001,4,2,296655,296655,296657,0,2,1
85002,2,1,296657,296657,296658,0,1,0
85003,1,3,296658,296658,296661,0,3,0
85004,6,1,296664,296664,296665,0,1,3
85005,3,2,296667,296667,296669,0,2,2
85006,1,3,296668,296669,296672,1,4,0
85007,6,1,296674,296674,296675,0,1,2
85008,2,3,296676,296676,296679,0,3,1
85009,5,3,296681,296681,296684,0,3,2
85010,4,1,296685,296685,296686,0,1,1
85011,4,1,296689,296689,296690,0,1,3
85012,6,1,296695,296695,296696,0,1,5
85013,3,3,296698,296698,296701,0,3,2
85014,4,3,296702,296702,296705,0,3,1
85015,6,1,296708,296708,296709,0,1,3
85016,4,1,296712,296712,296713,0,1,3
85017,3,3,296715,296715,296718,0,3,2
85018,2,2,296717,296718,296720,1,3,0
85019,5,1,296722,296722,296723,0,1,2
85020,1,1,296723,296723,296724,0,1,0
85021,6,2,296729,296729,296731,0,2,5
85022,3,3,296732,296732,296735,0,3,1
85023,5,2,296737,296737,296739,0,2,2
85024,4,3,296741,296741,296744,0,3,2
85025,3,3,296744,296744,296747,0,3,0
85026,4,2,296748,296748,296750,0,2,1
85027,2,3,296750,296750,296753,0,3,0
85028,5,3,296755,296755,296758,0,3,2
85029,1,1,296756,296758,296759,2,3,0
85030,1,1,296757,296759,296760,2,3,0
85031,3,3,296760,296760,296763,0,3,0
85032,1,3,296761,296763,296766,2,5,0
85033,5,1,296766,296766,296767,0,1,0
85034,3,2,296769,296769,296771,0,2,2
85035,1,1,296770,296771,296772,1,2,0
85036,1,2,296771,296772,296774,1,3,0
85037,1,1,296772,296774,296775,2,3,0
85038,4,1,296776,296776,296777,0,1,1
85039,1,3,296777,296777,296780,0,3,0
85040,5,3,296782,296782,296785,0,3,2
85041,2,2,296784,296785,296787,1,3,0
85042,3,1,296787,296787,296788,0,1,0
85043,5,3,296792,296792,296795,0,3,4
85044,5,2,296797,296797,296799,0,2,2
85045,6,1,296803,296803,296804,0,1,4
85046,2,2,296805,296805,296807,0,2,1
85047,3,2,296808,296808,296810,0,2,1
85048,4,1,296812,296812,296813,0,1,2
85049,4,3,296816,296816,296819,0,3,3
85050,6,3,296822,296822,296825,0,3,3
85051,1,1,296823,296825,296826,2,3,0
85052,6,1,296829,296829,296830,0,1,3
85053,6,3,296835,296835,296838,0,3,5
85054,1,3,296836,296838,296841,2,5,0
85055,2,3,296838,296841,296844,3,6,0
85056,1,2,296839,296844,296846,5,7,0
85057,6,1,296845,296846,296847,1,2,0
85058,2,2,296847,296847,296849,0,2,0
85059,1,1,296848,296849,296850,1,2,0
85060,3,2,296851,296851,296853,0,2,1
85061,1,3,296852,296853,296856,1,4,0
85062,3,2,296855,296856,296858,1,3,0
85063,4,3,296859,296859,296862,0,3,1
85064,6,2,296865,296865,296867,0,2,3
85065,5,2,296870,296870,296872,0,2,3
85066,5,3,296875,296875,296878,0,3,3
85067,3,2,296878,296878,296880,0,2,0
85068,3,2,296881,296881,296883,0,2,1
85069,5,2,296886,296886,296888,0,2,3
85070,5,2,296891,296891,296893,0,2,3
85071,4,3,296895,296895,296898,0,3,2
85072,6,1,296901,296901,296902,0,1,3
85073,2,1,296903,296903,296904,0,1,1
85074,5,1,296908,296908,296909,0,1,4
85075,2,1,296910,296910,296911,0,1,1
85076,2,3,296912,296912,296915,0,3,1
85077,2,2,296914,296915,296917,1,3,0
85078,6,1,296920,296920,296921,0,1,3
85079,6,3,296926,296926,296929,0,3,5
85080,6,1,296932,296932,296933,0,1,3
85081,1,1,296933,296933,296934,0,1,0
85082,4,2,296937,296937,296939,0,2,3
85083,1,3,296938,296939,296942,1,4,0
85084,1,2,296939,296942,296944,3,5,0
85085,3,3,296942,296944,296947,2,5,0
85086,3,3,296945,296947,296950,2,5,0
85087,4,3,296949,296950,296953,1,4,0
85088,3,3,296952,296953,296956,1,4,0
85089,6,1,296958,296958,296959,0,1,2
85090,6,3,296964,296964,296967,0,3,5
85091,6,2,296970,296970,296972,0,2,3
85092,5,1,296975,296975,296976,0,1,3
85093,4,3,296979,296979,296982,0,3,3
85094,2,2,296981,296982,296984,1,3,0
85095,2,3,296983,296984,296987,1,4,0
85096,4,1,296987,296987,296988,0,1,0
85097,5,2,296992,296992,296994,0,2,4
85098,2,2,296994,296994,296996,0,2,0
85099,3,3,296997,296997,297000,0,3,1
85100,1,1,296998,297000,297001,2,3,0
85101,5,2,297003,297003,297005,0,2,2
85102,3,3,297006,297006,297009,0,3,1
85103,5,1,297011,297011,297012,0,1,2
85104,1,2,297012,297012,297014,0,2,0
85105,3,3,297015,297015,297018,0,3,1
85106,1,1,297016,297018,297019,2,3,0
85107,4,3,297020,297020,297023,0,3,1
85108,5,1,297025,297025,297026,0,1,2
85109,1,2,297026,297026,297028,0,2,0
85110,2,2,297028,297028,297030,0,2,0
85111,1,3,297029,297030,297033,1,4,0
85112,3,2,297032,297033,297035,1,3,0
85113,3,3,297035,297035,297038,0,3,0
85114,5,3,297040,297040,297043,0,3,2
85115,4,1,297044,297044,297045,0,1,1
85116,5,3,297049,297049,297052,0,3,4
85117,3,2,297052,297052,297054,0,2,0
85118,5,3,297057,297057,297060,0,3,3
85119,6,1,297063,297063,297064,0,1,3
85120,3,3,297066,297066,297069,0,3,2
85121,4,1,297070,297070,297071,0,1,1
85122,1,2,297071,297071,297073,0,2,0
85123,5,3,297076,297076,297079,0,3,3
85124,4,2,297080,297080,297082,0,2,1
85125,6,3,297086,297086,297089,0,3,4
85126,5,1,297091,297091,297092,0,1,2
85127,5,3,297096,297096,297099,0,3,4
85128,1,1,297097,297099,297100,2,3,0
85129,6,3,297103,297103,297106,0,3,3
85130,1,3,297104,297106,297109,2,5,0
85131,3,3,297107,297109,297112,2,5,0
85132,3,3,297110,297112,297115,2,5,0
85133,2,2,297112,297115,297117,3,5,0
85134,5,1,297117,297117,297118,0,1,0
85135,5,1,297122,297122,297123,0,1,4
85136,5,3,297127,297127,297130,0,3,4
85137,5,3,297132,297132,297135,0,3,2
85138,1,3,297133,297135,297138,2,5,0
85139,4,3,297137,297138,297141,1,4,0
85140,1,1,297138,297141,297142,3,4,0
85141,1,3,297139,297142,297145,3,6,0
85142,4,1,297143,297145,297146,2,3,0
85143,3,1,297146,297146,297147,0,1,0
85144,4,3,297150,297150,297153,0,3,3
85145,5,1,297155,297155,297156,0,1,2
85146,5,1,297160,297160,297161,0,1,4
85147,4,3,297164,297164,297167,0,3,3
85148,4,2,297168,297168,297170,0,2,1
85149,4,3,297172,297172,297175,0,3,2
85150,5,3,297177,297177,297180,0,3,2
85151,4,2,297181,297181,297183,0,2,1
85152,2,3,297183,297183,297186,0,3,0
85153,6,1,297189,297189,297190,0,1,3
85154,6,1,297195,297195,297196,0,1,5
85155,4,3,297199,297199,297202,0,3,3
85156,5,1,297204,297204,297205,0,1,2
85157,1,1,297205,297205,297206,0,1,0
85158,6,2,297211,297211,297213,0,2,5
85159,6,2,297217,297217,297219,0,2,4
85160,1,3,297218,297219,297222,1,4,0
85161,4,1,297222,297222,297223,0,1,0
85162,4,3,297226,297226,297229,0,3,3
85163,4,3,297230,297230,297233,0,3,1
85164,3,2,297233,297233,297235,0,2,0
85165,5,1,297238,297238,297239,0,1,3
85166,3,1,297241,297241,297242,0,1,2
85167,5,2,297246,297246,297248,0,2,4
85168,2,3,297248,297248,297251,0,3,0
85169,4,1,297252,297252,297253,0,1,1
85170,2,2,297254,297254,297256,0,2,1
85171,5,2,297259,297259,297261,0,2,3
85172,3,2,297262,297262,297264,0,2,1
85173,2,3,297264,297264,297267,0,3,0
85174,5,1,297269,297269,297270,0,1,2
85175,3,3,297272,297272,297275,0,3,2
85176,1,1,297273,297275,297276,2,3,0
85177,4,3,297277,297277,297280,0,3,1
85178,5,3,297282,297282,297285,0,3,2
85179,3,2,297285,297285,297287,0,2,0
85180,5,1,297290,297290,297291,0,1,3
85181,2,2,297292,297292,297294,0,2,1
85182,4,3,297296,297296,297299,0,3,2
85183,5,3,297301,297301,297304,0,3,2
85184,5,3,297306,297306,297309,0,3,2
85185,3,2,297309,297309,297311,0,2,0
85186,1,3,297310,297311,297314,1,4,0
85187,6,2,297316,297316,297318,0,2,2
85188,1,3,297317,297318,297321,1,4,0
85189,4,1,297321,297321,297322,0,1,0
85190,1,2,297322,297322,297324,0,2,0
85191,5,2,297327,297327,297329,0,2,3
85192,4,3,297331,297331,297334,0,3,2
85193,2,1,297333,297334,297335,1,2,0
85194,4,1,297337,297337,297338,0,1,2
85195,4,1,297341,297341,297342,0,1,3
85196,5,1,297346,297346,297347,0,1,4
85197,5,3,297351,297351,297354,0,3,4
85198,6,2,297357,297357,297359,0,2,3
85199,4,3,297361,297361,297364,0,3,2
85200,3,1,297364,297364,297365,0,1,0
85201,4,1,297368,297368,297369,0,1,3
85202,3,1,297371,297371,297372,0,1,2
85203,5,2,297376,297376,297378,0,2,4
85204,2,3,297378,297378,297381,0,3,0
85205,5,3,297383,297383,297386,0,3,2
85206,2,2,297385,297386,297388,1,3,0
85207,3,2,297388,297388,297390,0,2,0
85208,1,2,297389,297390,297392,1,3,0
85209,2,2,297391,297392,297394,1,3,0
85210,1,2,297392,297394,297396,2,4,0
85211,4,2,297396,297396,297398,0,2,0
85212,6,1,297402,297402,297403,0,1,4
85213,1,2,297403,297403,297405,0,2,0
85214,6,2,297409,297409,297411,0,2,4
85215,4,1,297413,297413,297414,0,1,2
85216,5,2,297418,297418,297420,0,2,4
85217,5,1,297423,297423,297424,0,1,3
85218,2,1,297425,297425,297426,0,1,1
85219,2,1,297427,297427,297428,0,1,1
85220,1,3,297428,297428,297431,0,3,0
85221,2,1,297430,297431,297432,1,2,0
85222,4,1,297434,297434,297435,0,1,2
85223,6,1,297440,297440,297441,0,1,5
85224,1,1,297441,297441,297442,0,1,0
85225,6,2,297447,297447,297449,0,2,5
85226,3,1,297450,297450,297451,0,1,1
85227,5,1,297455,297455,297456,0,1,4
85228,1,3,297456,297456,297459,0,3,0
85229,5,3,297461,297461,297464,0,3,2
85230,5,2,297466,297466,297468,0,2,2
85231,5,1,297471,297471,297472,0,1,3
85232,5,3,297476,297476,297479,0,3,4
85233,3,1,297479,297479,297480,0,1,0
85234,2,2,297481,297481,297483,0,2,1
85235,5,3,297486,297486,297489,0,3,3
85236,1,3,297487,297489,297492,2,5,0
85237,4,2,297491,297492,297494,1,3,0
85238,4,3,297495,297495,297498,0,3,1
85239,5,2,297500,297500,297502,0,2,2
85240,2,1,297502,297502,297503,0,1,0
85241,4,1,297506,297506,297507,0,1,3
85242,5,3,297511,297511,297514,0,3,4
85243,6,1,297517,297517,297518,0,1,3
85244,4,1,297521,297521,297522,0,1,3
85245,5,1,297526,297526,297527,0,1,4
85246,2,3,297528,297528,297531,0,3,1
85247,3,1,297531,297531,297532,0,1,0
85248,4,2,297535,297535,297537,0,2,3
85249,2,1,297537,297537,297538,0,1,0
85250,5,3,297542,297542,297545,0,3,4
85251,1,1,297543,297545,297546,2,3,0
85252,6,1,297549,297549,297550,0,1,3
85253,1,3,297550,297550,297553,0,3,0
85254,5,3,297555,297555,297558,0,3,2
85255,1,3,297556,297558,297561,2,5,0
85256,3,3,297559,297561,297564,2,5,0
85257,3,1,297562,297564,297565,2,3,0
85258,3,3,297565,297565,297568,0,3,0
85259,4,3,297569,297569,297572,0,3,1
85260,2,2,297571,297572,297574,1,3,0
85261,5,3,297576,297576,297579,0,3,2
85262,4,3,297580,297580,297583,0,3,1
85263,3,3,297583,297583,297586,0,3,0
85264,6,3,297589,297589,297592,0,3,3
85265,2,3,297591,297592,297595,1,4,0
85266,4,2,297595,297595,297597,0,2,0
85267,5,1,297600,297600,297601,0,1,3
85268,3,1,297603,297603,297604,0,1,2
85269,4,1,297607,297607,297608,0,1,3
85270,5,2,297612,297612,297614,0,2,4
85271,5,2,297617,297617,297619,0,2,3
85272,6,1,297623,297623,297624,0,1,4
85273,1,2,297624,297624,297626,0,2,0
85274,2,3,297626,297626,297629,0,3,0
85275,6,3,297632,297632,297635,0,3,3
85276,1,3,297633,297635,297638,2,5,0
85277,2,2,297635,297638,297640,3,5,0
85278,1,3,297636,297640,297643,4,7,0
85279,3,1,297639,297643,297644,4,5,0
85280,1,3,297640,297644,297647,4,7,0
85281,4,3,297644,297647,297650,3,6,0
85282,1,1,297645,297650,297651,5,6,0
85283,3,1,297648,297651,297652,3,4,0
85284,5,3,297653,297653,297656,0,3,1
85285,5,1,297658,297658,297659,0,1,2
85286,4,2,297662,297662,297664,0,2,3
85287,3,1,297665,297665,297666,0,1,1
85288,4,1,297669,297669,297670,0,1,3
85289,4,1,297673,297673,297674,0,1,3
85290,5,1,297678,297678,297679,0,1,4
85291,5,3,297683,297683,297686,0,3,4
85292,6,2,297689,297689,297691,0,2,3
85293,4,3,297693,297693,297696,0,3,2
85294,2,1,297695,297696,297697,1,2,0
85295,6,2,297701,297701,297703,0,2,4
85296,3,2,297704,297704,297706,0,2,1
85297,4,1,297708,297708,297709,0,1,2
85298,5,3,297713,297713,297716,0,3,4
85299,6,1,297719,297719,297720,0,1,3
85300,4,1,297723,297723,297724,0,1,3
85301,6,1,297729,297729,297730,0,1,5
85302,3,2,297732,297732,297734,0,2,2
85303,4,2,297736,297736,297738,0,2,2
85304,6,3,297742,297742,297745,0,3,4
85305,5,2,297747,297747,297749,0,2,2
85306,6,1,297753,297753,297754,0,1,4
85307,2,2,297755,297755,297757,0,2,1
85308,3,3,297758,297758,297761,0,3,1
85309,4,3,297762,297762,297765,0,3,1
85310,1,2,297763,297765,297767,2,4,0
85311,4,1,297767,297767,297768,0,1,0
85312,3,1,297770,297770,297771,0,1,2
85313,1,1,297771,297771,297772,0,1,0
85314,4,3,297775,297775,297778,0,3,3
85315,3,2,297778,297778,297780,0,2,0
85316,1,1,297779,297780,297781,1,2,0
85317,5,1,297784,297784,297785,0,1,3
85318,6,1,297790,297790,297791,0,1,5
85319,3,3,297793,297793,297796,0,3,2
85320,4,3,297797,297797,297800,0,3,1
85321,6,3,297803,297803,297806,0,3,3
85322,3,3,297806,297806,297809,0,3,0
85323,1,3,297807,297809,297812,2,5,0
85324,1,2,297808,297812,297814,4,6,0
85325,1,3,297809,297814,297817,5,8,0
85326,5,2,297814,297817,297819,3,5,0
85327,2,3,297816,297819,297822,3,6,0
85328,4,3,297820,297822,297825,2,5,0
85329,1,1,297821,297825,297826,4,5,0
85330,6,1,297827,297827,297828,0,1,1
85331,3,2,297830,297830,297832,0,2,2
85332,4,1,297834,297834,297835,0,1,2
85333,4,1,297838,297838,297839,0,1,3
85334,6,3,297844,297844,297847,0,3,5
85335,2,3,297846,297847,297850,1,4,0
85336,1,1,297847,297850,297851,3,4,0
85337,3,1,297850,297851,297852,1,2,0
85338,1,2,297851,297852,297854,1,3,0
85339,5,3,297856,297856,297859,0,3,2
85340,4,3,297860,297860,297863,0,3,1
85341,6,2,297866,297866,297868,0,2,3
85342,6,1,297872,297872,297873,0,1,4
85343,5,2,297877,297877,297879,0,2,4
85344,6,3,297883,297883,297886,0,3,4
85345,3,3,297886,297886,297889,0,3,0
85346,6,3,297892,297892,297895,0,3,3
85347,3,3,297895,297895,297898,0,3,0
85348,1,2,297896,297898,297900,2,4,0
85349,5,2,297901,297901,297903,0,2,1
85350,5,1,297906,297906,297907,0,1,3
85351,2,3,297908,297908,297911,0,3,1
85352,5,3,297913,297913,297916,0,3,2
85353,2,3,297915,297916,297919,1,4,0
85354,1,3,297916,297919,297922,3,6,0
85355,2,3,297918,297922,297925,4,7,0
85356,3,2,297921,297925,297927,4,6,0
85357,6,2,297927,297927,297929,0,2,0
85358,6,3,297933,297933,297936,0,3,4
85359,3,2,297936,297936,297938,0,2,0
85360,1,1,297937,297938,297939,1,2,0
85361,5,1,297942,297942,297943,0,1,3
85362,3,1,297945,297945,297946,0,1,2
85363,6,2,297951,297951,297953,0,2,5
85364,4,1,297955,297955,297956,0,1,2
85365,1,2,297956,297956,297958,0,2,0
85366,2,2,297958,297958,297960,0,2,0
85367,6,2,297964,297964,297966,0,2,4
85368,1,3,297965,297966,297969,1,4,0
85369,4,2,297969,297969,297971,0,2,0
85370,6,3,297975,297975,297978,0,3,4
85371,2,3,297977,297978,297981,1,4,0
85372,4,2,297981,297981,297983,0,2,0
85373,1,2,297982,297983,297985,1,3,0
85374,1,1,297983,297985,297986,2,3,0
85375,4,3,297987,297987,297990,0,3,1
85376,6,1,297993,297993,297994,0,1,3
85377,1,1,297994,297994,297995,0,1,0
85378,5,1,297999,297999,298000,0,1,4
85379,2,3,298001,298001,298004,0,3,1
85380,5,1,298006,298006,298007,0,1,2
85381,4,1,298010,298010,298011,0,1,3
85382,1,3,298011,298011,298014,0,3,0
85383,4,1,298015,298015,298016,0,1,1
85384,3,1,298018,298018,298019,0,1,2
85385,3,1,298021,298021,298022,0,1,2
85386,1,2,298022,298022,298024,0,2,0
85387,4,3,298026,298026,298029,0,3,2
85388,1,2,298027,298029,298031,2,4,0
85389,5,2,298032,298032,298034,0,2,1
85390,2,1,298034,298034,298035,0,1,0
85391,3,1,298037,298037,298038,0,1,2
85392,5,3,298042,298042,298045,0,3,4
85393,5,2,298047,298047,298049,0,2,2
85394,6,3,298053,298053,298056,0,3,4
85395,4,1,298057,298057,298058,0,1,1
85396,3,1,298060,298060,298061,0,1,2
85397,5,1,298065,298065,298066,0,1,4
85398,2,2,298067,298067,298069,0,2,1
85399,2,3,298069,298069,298072,0,3,0
85400,5,3,298074,298074,298077,0,3,2
85401,2,3,298076,298077,298080,1,4,0
85402,2,1,298078,298080,298081,2,3,0
85403,6,1,298084,298084,298085,0,1,3
85404,1,3,298085,298085,298088,0,3,0
85405,4,3,298089,298089,298092,0,3,1
85406,2,2,298091,298092,298094,1,3,0
85407,3,3,298094,298094,298097,0,3,0
85408,3,2,298097,298097,298099,0,2,0
85409,2,3,298099,298099,298102,0,3,0
85410,2,2,298101,298102,298104,1,3,0
85411,1,2,298102,298104,298106,2,4,0
85412,6,1,298108,298108,298109,0,1,2
85413,6,3,298114,298114,298117,0,3,5
85414,4,2,298118,298118,298120,0,2,1
85415,6,3,298124,298124,298127,0,3,4
85416,6,2,298130,298130,298132,0,2,3
85417,3,1,298133,298133,298134,0,1,1
85418,5,1,298138,298138,298139,0,1,4
85419,4,2,298142,298142,298144,0,2,3
85420,6,1,298148,298148,298149,0,1,4
85421,4,1,298152,298152,298153,0,1,3
85422,2,2,298154,298154,298156,0,2,1
85423,3,3,298157,298157,298160,0,3,1
85424,6,1,298163,298163,298164,0,1,3
85425,6,1,298169,298169,298170,0,1,5
85426,3,1,298172,298172,298173,0,1,2
85427,5,2,298177,298177,298179,0,2,4
85428,4,1,298181,298181,298182,0,1,2
85429,3,3,298184,298184,298187,0,3,2
85430,1,3,298185,298187,298190,2,5,0
85431,3,1,298188,298190,298191,2,3,0
85432,1,2,298189,298191,298193,2,4,0
85433,5,2,298194,298194,298196,0,2,1
85434,3,1,298197,298197,298198,0,1,1
85435,3,3,298200,298200,298203,0,3,2
85436,6,3,298206,298206,298209,0,3,3
85437,4,2,298210,298210,298212,0,2,1
85438,1,2,298211,298212,298214,1,3,0
85439,2,2,298213,298214,298216,1,3,0
85440,4,2,298217,298217,298219,0,2,1
85441,1,2,298218,298219,298221,1,3,0
85442,1,2,298219,298221,298223,2,4,0
85443,3,3,298222,298223,298226,1,4,0
85444,5,3,298227,298227,298230,0,3,1
85445,6,2,298233,298233,298235,0,2,3
85446,5,3,298238,298238,298241,0,3,3
85447,4,3,298242,298242,298245,0,3,1
85448,6,3,298248,298248,298251,0,3,3
85449,5,3,298253,298253,298256,0,3,2
85450,6,1,298259,298259,298260,0,1,3
85451,6,1,298265,298265,298266,0,1,5
85452,5,3,298270,298270,298273,0,3,4
85453,1,2,298271,298273,298275,2,4,0
85454,2,3,298273,298275,298278,2,5,0
85455,1,1,298274,298278,298279,4,5,0
85456,1,2,298275,298279,298281,4,6,0
85457,4,2,298279,298281,298283,2,4,0
85458,1,2,298280,298283,298285,3,5,0
85459,6,1,298286,298286,298287,0,1,1
85460,6,1,298292,298292,298293,0,1,5
85461,6,1,298298,298298,298299,0,1,5
85462,2,3,298300,298300,298303,0,3,1
85463,2,2,298302,298303,298305,1,3,0
85464,3,2,298305,298305,298307,0,2,0
85465,2,2,298307,298307,298309,0,2,0
85466,4,3,298311,298311,298314,0,3,2
85467,3,1,298314,298314,298315,0,1,0
85468,2,2,298316,298316,298318,0,2,1
85469,5,1,298321,298321,298322,0,1,3
85470,1,3,298322,298322,298325,0,3,0
85471,2,1,298324,298325,298326,1,2,0
85472,3,2,298327,298327,298329,0,2,1
85473,5,1,298332,298332,298333,0,1,3
85474,5,2,298337,298337,298339,0,2,4
85475,6,3,298343,298343,298346,0,3,4
85476,2,1,298345,298346,298347,1,2,0
85477,5,2,298350,298350,298352,0,2,3
85478,4,2,298354,298354,298356,0,2,2
85479,1,2,298355,298356,298358,1,3,0
85480,1,3,298356,298358,298361,2,5,0
85481,4,2,298360,298361,298363,1,3,0
85482,6,1,298366,298366,298367,0,1,3
85483,1,2,298367,298367,298369,0,2,0
85484,2,3,298369,298369,298372,0,3,0
85485,3,3,298372,298372,298375,0,3,0
85486,1,3,298373,298375,298378,2,5,0
85487,4,1,298377,298378,298379,1,2,0
85488,4,2,298381,298381,298383,0,2,2
85489,2,1,298383,298383,298384,0,1,0
85490,6,2,298389,298389,298391,0,2,5
85491,2,3,298391,298391,298394,0,3,0
85492,3,3,298394,298394,298397,0,3,0
85493,4,1,298398,298398,298399,0,1,1
85494,5,2,298403,298403,298405,0,2,4
85495,3,2,298406,298406,298408,0,2,1
85496,4,1,298410,298410,298411,0,1,2
85497,6,1,298416,298416,298417,0,1,5
85498,2,2,298418,298418,298420,0,2,1
85499,5,3,298423,298423,298426,0,3,3
85500,2,1,298425,298426,298427,1,2,0
85501,1,1,298426,298427,298428,1,2,0
85502,1,2,298427,298428,298430,1,3,0
85503,4,1,298431,298431,298432,0,1,1
85504,5,2,298436,298436,298438,0,2,4
85505,2,1,298438,298438,298439,0,1,0
85506,3,1,298441,298441,298442,0,1,2
85507,4,1,298445,298445,298446,0,1,3
85508,4,1,298449,298449,298450,0,1,3
85509,4,2,298453,298453,298455,0,2,3
85510,3,2,298456,298456,298458,0,2,1
85511,4,2,298460,298460,298462,0,2,2
85512,3,1,298463,298463,298464,0,1,1
85513,4,2,298467,298467,298469,0,2,3
85514,5,1,298472,298472,298473,0,1,3
85515,3,1,298475,298475,298476,0,1,2
85516,3,2,298478,298478,298480,0,2,2
85517,6,2,298484,298484,298486,0,2,4
85518,6,2,298490,298490,298492,0,2,4
85519,6,3,298496,298496,298499,0,3,4
85520,6,3,298502,298502,298505,0,3,3
85521,2,3,298504,298505,298508,1,4,0
85522,2,3,298506,298508,298511,2,5,0
85523,3,2,298509,298511,298513,2,4,0
85524,6,2,298515,298515,298517,0,2,2
85525,4,2,298519,298519,298521,0,2,2
85526,3,3,298522,298522,298525,0,3,1
85527,1,3,298523,298525,298528,2,5,0
85528,5,3,298528,298528,298531,0,3,0
85529,3,1,298531,298531,298532,0,1,0
85530,3,3,298534,298534,298537,0,3,2
85531,4,2,298538,298538,298540,0,2,1
85532,5,1,298543,298543,298544,0,1,3
85533,1,2,298544,298544,298546,0,2,0
85534,4,2,298548,298548,298550,0,2,2
85535,6,1,298554,298554,298555,0,1,4
85536,2,1,298556,298556,298557,0,1,1
85537,2,1,298558,298558,298559,0,1,1
85538,1,3,298559,298559,298562,0,3,0
85539,2,2,298561,298562,298564,1,3,0
85540,3,3,298564,298564,298567,0,3,0
85541,1,3,298565,298567,298570,2,5,0
85542,3,1,298568,298570,298571,2,3,0
85543,4,3,298572,298572,298575,0,3,1
85544,4,1,298576,298576,298577,0,1,1
85545,1,2,298577,298577,298579,0,2,0
85546,4,1,298581,298581,298582,0,1,2
85547,4,1,298585,298585,298586,0,1,3
85548,5,1,298590,298590,298591,0,1,4
85549,4,1,298594,298594,298595,0,1,3
85550,1,1,298595,298595,298596,0,1,0
85551,4,3,298599,298599,298602,0,3,3
85552,4,1,298603,298603,298604,0,1,1
85553,1,3,298604,298604,298607,0,3,0
85554,4,1,298608,298608,298609,0,1,1
85555,4,1,298612,298612,298613,0,1,3
85556,5,2,298617,298617,298619,0,2,4
85557,3,3,298620,298620,298623,0,3,1
85558,5,3,298625,298625,298628,0,3,2
85559,6,1,298631,298631,298632,0,1,3
85560,4,2,298635,298635,298637,0,2,3
85561,4,3,298639,298639,298642,0,3,2
85562,1,1,298640,298642,298643,2,3,0
85563,1,2,298641,298643,298645,2,4,0
85564,6,2,298647,298647,298649,0,2,2
85565,1,2,298648,298649,298651,1,3,0
85566,5,2,298653,298653,298655,0,2,2
85567,2,1,298655,298655,298656,0,1,0
85568,5,1,298660,298660,298661,0,1,4
85569,6,1,298666,298666,298667,0,1,5
85570,3,1,298669,298669,298670,0,1,2
85571,3,2,298672,298672,298674,0,2,2
85572,1,1,298673,298674,298675,1,2,0
85573,4,3,298677,298677,298680,0,3,2
85574,5,1,298682,298682,298683,0,1,2
85575,1,1,298683,298683,298684,0,1,0
85576,3,3,298686,298686,298689,0,3,2
85577,6,2,298692,298692,298694,0,2,3
85578,2,1,298694,298694,298695,0,1,0
85579,2,3,298696,298696,298699,0,3,1
85580,3,3,298699,298699,298702,0,3,0
85581,5,1,298704,298704,298705,0,1,2
85582,4,2,298708,298708,298710,0,2,3
85583,3,1,298711,298711,298712,0,1,1
85584,1,3,298712,298712,298715,0,3,0
85585,1,1,298713,298715,298716,2,3,0
85586,2,1,298715,298716,298717,1,2,0
85587,3,1,298718,298718,298719,0,1,1
85588,2,2,298720,298720,298722,0,2,1
85589,3,2,298723,298723,298725,0,2,1
85590,2,3,298725,298725,298728,0,3,0
85591,5,2,298730,298730,298732,0,2,2
85592,2,2,298732,298732,298734,0,2,0
85593,3,3,298735,298735,298738,0,3,1
85594,5,3,298740,298740,298743,0,3,2
85595,1,2,298741,298743,298745,2,4,0
85596,3,3,298744,298745,298748,1,4,0
85597,5,3,298749,298749,298752,0,3,1
85598,1,3,298750,298752,298755,2,5,0
85599,1,3,298751,298755,298758,4,7,0
85600,4,2,298755,298758,298760,3,5,0
85601,4,2,298759,298760,298762,1,3,0
85602,2,2,298761,298762,298764,1,3,0
85603,2,1,298763,298764,298765,1,2,0
85604,1,3,298764,298765,298768,1,4,0
85605,4,3,298768,298768,298771,0,3,0
85606,3,1,298771,298771,298772,0,1,0
85607,3,2,298774,298774,298776,0,2,2
85608,6,3,298780,298780,298783,0,3,4
85609,1,1,298781,298783,298784,2,3,0
85610,6,3,298787,298787,298790,0,3,3
85611,1,1,298788,298790,298791,2,3,0
85612,2,1,298790,298791,298792,1,2,0
85613,3,1,298793,298793,298794,0,1,1
85614,6,2,298799,298799,298801,0,2,5
85615,6,3,298805,298805,298808,0,3,4
85616,3,3,298808,298808,298811,0,3,0
85617,5,3,298813,298813,298816,0,3,2
85618,3,2,298816,298816,298818,0,2,0
85619,4,2,298820,298820,298822,0,2,2
85620,3,3,298823,298823,298826,0,3,1
85621,3,1,298826,298826,298827,0,1,0
85622,6,3,298832,298832,298835,0,3,5
85623,3,3,298835,298835,298838,0,3,0
85624,2,3,298837,298838,298841,1,4,0
85625,5,3,298842,298842,298845,0,3,1
85626,2,1,298844,298845,298846,1,2,0
85627,5,3,298849,298849,298852,0,3,3
85628,5,1,298854,298854,298855,0,1,2
85629,5,3,298859,298859,298862,0,3,4
85630,2,1,298861,298862,298863,1,2,0
85631,5,1,298866,298866,298867,0,1,3
85632,3,3,298869,298869,298872,0,3,2
85633,5,1,298874,298874,298875,0,1,2
85634,2,3,298876,298876,298879,0,3,1
85635,4,3,298880,298880,298883,0,3,1
85636,2,2,298882,298883,298885,1,3,0
85637,5,1,298887,298887,298888,0,1,2
85638,6,1,298893,298893,298894,0,1,5
85639,6,1,298899,298899,298900,0,1,5
85640,1,3,298900,298900,298903,0,3,0
85641,1,3,298901,298903,298906,2,5,0
85642,5,3,298906,298906,298909,0,3,0
85643,3,2,298909,298909,298911,0,2,0
85644,5,2,298914,298914,298916,0,2,3
85645,3,1,298917,298917,298918,0,1,1
85646,4,3,298921,298921,298924,0,3,3
85647,4,2,298925,298925,298927,0,2,1
85648,5,1,298930,298930,298931,0,1,3
85649,3,2,298933,298933,298935,0,2,2
85650,3,2,298936,298936,298938,0,2,1
85651,5,3,298941,298941,298944,0,3,3
85652,2,3,298943,298944,298947,1,4,0
85653,3,3,298946,298947,298950,1,4,0
85654,6,1,298952,298952,298953,0,1,2
85655,2,3,298954,298954,298957,0,3,1
85656,5,1,298959,298959,298960,0,1,2
85657,3,3,298962,298962,298965,0,3,2
85658,2,1,298964,298965,298966,1,2,0
85659,4,2,298968,298968,298970,0,2,2
85660,3,3,298971,298971,298974,0,3,1
85661,5,1,298976,298976,298977,0,1,2
85662,6,3,298982,298982,298985,0,3,5
85663,3,1,298985,298985,298986,0,1,0
85664,6,1,298991,298991,298992,0,1,5
85665,1,1,298992,298992,298993,0,1,0
85666,6,3,298998,298998,299001,0,3,5
85667,3,2,299001,299001,299003,0,2,0
85668,6,2,299007,299007,299009,0,2,4
85669,4,1,299011,299011,299012,0,1,2
85670,3,3,299014,299014,299017,0,3,2
85671,1,3,299015,299017,299020,2,5,0
85672,3,2,299018,299020,299022,2,4,0
85673,1,2,299019,299022,299024,3,5,0
85674,2,3,299021,299024,299027,3,6,0
85675,1,3,299022,299027,299030,5,8,0
85676,1,2,299023,299030,299032,7,9,0
85677,3,1,299026,299032,299033,6,7,0
85678,3,2,299029,299033,299035,4,6,0
85679,6,1,299035,299035,299036,0,1,0
85680,6,1,299041,299041,299042,0,1,5
85681,3,3,299044,299044,299047,0,3,2
85682,4,2,299048,299048,299050,0,2,1
85683,5,2,299053,299053,299055,0,2,3
85684,4,2,299057,299057,299059,0,2,2
85685,3,3,299060,299060,299063,0,3,1
85686,3,2,299063,299063,299065,0,2,0
85687,6,1,299069,299069,299070,0,1,4
85688,6,3,299075,299075,299078,0,3,5
85689,2,1,299077,299078,299079,1,2,0
85690,5,2,299082,299082,299084,0,2,3
85691,4,1,299086,299086,299087,0,1,2
85692,3,1,299089,299089,299090,0,1,2
85693,2,1,299091,299091,299092,0,1,1
85694,6,3,299097,299097,299100,0,3,5
85695,6,1,299103,299103,299104,0,1,3
85696,4,1,299107,299107,299108,0,1,3
85697,4,1,299111,299111,299112,0,1,3
85698,4,1,299115,299115,299116,0,1,3
85699,3,2,299118,299118,299120,0,2,2
85700,1,1,299119,299120,299121,1,2,0
85701,6,1,299125,299125,299126,0,1,4
85702,1,2,299126,299126,299128,0,2,0
85703,5,3,299131,299131,299134,0,3,3
85704,2,3,299133,299134,299137,1,4,0
85705,1,1,299134,299137,299138,3,4,0
85706,2,2,299136,299138,299140,2,4,0
85707,2,2,299138,299140,299142,2,4,0
85708,5,2,299143,299143,299145,0,2,1
85709,5,1,299148,299148,299149,0,1,3
85710,4,3,299152,299152,299155,0,3,3
85711,2,1,299154,299155,299156,1,2,0
85712,1,2,299155,299156,299158,1,3,0
85713,6,2,299161,299161,299163,0,2,3
85714,6,3,299167,299167,299170,0,3,4
85715,4,3,299171,299171,299174,0,3,1
85716,2,1,299173,299174,299175,1,2,0
85717,6,1,299179,299179,299180,0,1,4
85718,3,1,299182,299182,299183,0,1,2
85719,5,2,299187,299187,299189,0,2,4
85720,1,1,299188,299189,299190,1,2,0
85721,2,2,299190,299190,299192,0,2,0
85722,2,1,299192,299192,299193,0,1,0
85723,2,1,299194,299194,299195,0,1,1
85724,1,3,299195,299195,299198,0,3,0
85725,3,3,299198,299198,299201,0,3,0
85726,1,1,299199,299201,299202,2,3,0
85727,1,1,299200,299202,299203,2,3,0
85728,6,1,299206,299206,299207,0,1,3
85729,6,3,299212,299212,299215,0,3,5
85730,1,3,299213,299215,299218,2,5,0
85731,5,2,299218,299218,299220,0,2,0
85732,4,3,299222,299222,299225,0,3,2
85733,4,1,299226,299226,299227,0,1,1
85734,2,3,299228,299228,299231,0,3,1
85735,2,2,299230,299231,299233,1,3,0
85736,1,3,299231,299233,299236,2,5,0
85737,3,3,299234,299236,299239,2,5,0
85738,5,3,299239,299239,299242,0,3,0
85739,5,1,299244,299244,299245,0,1,2
85740,5,1,299249,299249,299250,0,1,4
85741,4,2,299253,299253,299255,0,2,3
85742,5,3,299258,299258,299261,0,3,3
85743,3,2,299261,299261,299263,0,2,0
85744,6,1,299267,299267,299268,0,1,4
85745,4,3,299271,299271,299274,0,3,3
85746,4,2,299275,299275,299277,0,2,1
85747,4,2,299279,299279,299281,0,2,2
85748,4,2,299283,299283,299285,0,2,2
85749,4,2,299287,299287,299289,0,2,2
85750,4,3,299291,299291,299294,0,3,2
85751,6,2,299297,299297,299299,0,2,3
85752,5,3,299302,299302,299305,0,3,3
85753,2,2,299304,299305,299307,1,3,0
85754,3,3,299307,299307,299310,0,3,0
85755,2,2,299309,299310,299312,1,3,0
85756,6,2,299315,299315,299317,0,2,3
85757,1,3,299316,299317,299320,1,4,0
85758,5,1,299321,299321,299322,0,1,1
85759,2,2,299323,299323,299325,0,2,1
85760,1,2,299324,299325,299327,1,3,0
85761,1,3,299325,299327,299330,2,5,0
85762,5,3,299330,299330,299333,0,3,0
85763,4,1,299334,299334,299335,0,1,1
85764,3,2,299337,299337,299339,0,2,2
85765,4,2,299341,299341,299343,0,2,2
85766,4,2,299345,299345,299347,0,2,2
85767,2,1,299347,299347,299348,0,1,0
85768,3,2,299350,299350,299352,0,2,2
85769,1,3,299351,299352,299355,1,4,0
85770,1,3,299352,299355,299358,3,6,0
85771,3,3,299355,299358,299361,3,6,0
85772,6,1,299361,299361,299362,0,1,0
85773,5,1,299366,299366,299367,0,1,4
85774,1,1,299367,299367,299368,0,1,0
85775,6,3,299373,299373,299376,0,3,5
85776,1,1,299374,299376,299377,2,3,0
85777,3,3,299377,299377,299380,0,3,0
85778,3,2,299380,299380,299382,0,2,0
85779,1,2,299381,299382,299384,1,3,0
85780,2,2,299383,299384,299386,1,3,0
85781,3,1,299386,299386,299387,0,1,0
85782,6,2,299392,299392,299394,0,2,5
85783,1,1,299393,299394,299395,1,2,0
85784,2,2,299395,299395,299397,0,2,0
85785,4,3,299399,299399,299402,0,3,2
85786,3,3,299402,299402,299405,0,3,0
85787,5,2,299407,299407,299409,0,2,2
85788,3,1,299410,299410,299411,0,1,1
85789,4,1,299414,299414,299415,0,1,3
85790,6,3,299420,299420,299423,0,3,5
85791,4,2,299424,299424,299426,0,2,1
85792,2,3,299426,299426,299429,0,3,0
85793,1,2,299427,299429,299431,2,4,0
85794,4,2,299431,299431,299433,0,2,0
85795,5,1,299436,299436,299437,0,1,3
85796,5,2,299441,299441,299443,0,2,4
85797,6,2,299447,299447,299449,0,2,4
85798,1,2,299448,299449,299451,1,3,0
85799,6,2,299454,299454,299456,0,2,3
85800,2,2,299456,299456,299458,0,2,0
85801,6,1,299462,299462,299463,0,1,4
85802,1,1,299463,299463,299464,0,1,0
85803,4,1,299467,299467,299468,0,1,3
85804,6,3,299473,299473,299476,0,3,5
85805,4,3,299477,299477,299480,0,3,1
85806,2,2,299479,299480,299482,1,3,0
85807,1,2,299480,299482,299484,2,4,0
85808,4,1,299484,299484,299485,0,1,0
85809,6,1,299490,299490,299491,0,1,5
85810,2,1,299492,299492,299493,0,1,1
85811,6,2,299498,299498,299500,0,2,5
85812,3,1,299501,299501,299502,0,1,1
85813,2,1,299503,299503,299504,0,1,1
85814,5,3,299508,299508,299511,0,3,4
85815,5,2,299513,299513,299515,0,2,2
85816,5,1,299518,299518,299519,0,1,3
85817,5,1,299523,299523,299524,0,1,4
85818,1,1,299524,299524,299525,0,1,0
85819,2,1,299526,299526,299527,0,1,1
85820,6,2,299532,299532,299534,0,2,5
85821,1,1,299533,299534,299535,1,2,0
85822,5,3,299538,299538,299541,0,3,3
85823,2,2,299540,299541,299543,1,3,0
85824,1,3,299541,299543,299546,2,5,0
85825,1,2,299542,299546,299548,4,6,0
85826,3,3,299545,299548,299551,3,6,0
85827,2,1,299547,299551,299552,4,5,0
85828,4,3,299551,299552,299555,1,4,0
85829,6,3,299557,299557,299560,0,3,2
85830,1,2,299558,299560,299562,2,4,0
85831,2,1,299560,299562,299563,2,3,0
85832,1,3,299561,299563,299566,2,5,0
85833,2,3,299563,299566,299569,3,6,0
85834,5,2,299568,299569,299571,1,3,0
85835,5,3,299573,299573,299576,0,3,2
85836,1,3,299574,299576,299579,2,5,0
85837,2,3,299576,299579,299582,3,6,0
85838,3,2,299579,299582,299584,3,5,0
85839,3,1,299582,299584,299585,2,3,0
85840,6,1,299588,299588,299589,0,1,3
85841,4,3,299592,299592,299595,0,3,3
85842,1,3,299593,299595,299598,2,5,0
85843,5,3,299598,299598,299601,0,3,0
85844,2,1,299600,299601,299602,1,2,0
85845,2,1,299602,299602,299603,0,1,0
85846,2,3,299604,299604,299607,0,3,1
85847,2,2,299606,299607,299609,1,3,0
85848,3,3,299609,299609,299612,0,3,0
85849,5,1,299614,299614,299615,0,1,2
85850,1,2,299615,299615,299617,0,2,0
85851,1,2,299616,299617,299619,1,3,0
85852,5,2,299621,299621,299623,0,2,2
85853,4,1,299625,299625,299626,0,1,2
85854,5,3,299630,299630,299633,0,3,4
85855,2,3,299632,299633,299636,1,4,0
85856,1,3,299633,299636,299639,3,6,0
85857,2,2,299635,299639,299641,4,6,0
85858,6,2,299641,299641,299643,0,2,0
85859,5,3,299646,299646,299649,0,3,3
85860,6,3,299652,299652,299655,0,3,3
85861,4,1,299656,299656,299657,0,1,1
85862,2,3,299658,299658,299661,0,3,1
85863,3,2,299661,299661,299663,0,2,0
85864,5,1,299666,299666,299667,0,1,3
85865,4,1,299670,299670,299671,0,1,3
85866,4,3,299674,299674,299677,0,3,3
85867,6,2,299680,299680,299682,0,2,3
85868,6,1,299686,299686,299687,0,1,4
85869,2,2,299688,299688,299690,0,2,1
85870,1,3,299689,299690,299693,1,4,0
85871,5,2,299694,299694,299696,0,2,1
85872,3,3,299697,299697,299700,0,3,1
85873,1,2,299698,299700,299702,2,4,0
85874,4,1,299702,299702,299703,0,1,0
85875,6,1,299708,299708,299709,0,1,5
85876,1,1,299709,299709,299710,0,1,0
85877,4,3,299713,299713,299716,0,3,3
85878,5,3,299718,299718,299721,0,3,2
85879,4,3,299722,299722,299725,0,3,1
85880,4,1,299726,299726,299727,0,1,1
85881,5,1,299731,299731,299732,0,1,4
85882,1,2,299732,299732,299734,0,2,0
85883,5,1,299737,299737,299738,0,1,3
85884,6,2,299743,299743,299745,0,2,5
85885,6,3,299749,299749,299752,0,3,4
85886,2,1,299751,299752,299753,1,2,0
85887,5,2,299756,299756,299758,0,2,3
85888,1,3,299757,299758,299761,1,4,0
85889,3,2,299760,299761,299763,1,3,0
85890,1,1,299761,299763,299764,2,3,0
85891,2,3,299763,299764,299767,1,4,0
85892,1,1,299764,299767,299768,3,4,0
85893,2,1,299766,299768,299769,2,3,0
85894,2,2,299768,299769,299771,1,3,0
85895,6,2,299774,299774,299776,0,2,3
85896,5,2,299779,299779,299781,0,2,3
85897,2,1,299781,299781,299782,0,1,0
85898,4,2,299785,299785,299787,0,2,3
85899,6,3,299791,299791,299794,0,3,4
85900,3,3,299794,299794,299797,0,3,0
85901,6,1,299800,299800,299801,0,1,3
85902,4,2,299804,299804,299806,0,2,3
85903,5,2,299809,299809,299811,0,2,3
85904,5,3,299814,299814,299817,0,3,3
85905,1,3,299815,299817,299820,2,5,0
85906,6,1,299821,299821,299822,0,1,1
85907,5,3,299826,299826,299829,0,3,4
85908,6,1,299832,299832,299833,0,1,3
85909,4,1,299836,299836,299837,0,1,3
85910,5,1,299841,299841,299842,0,1,4
85911,3,3,299844,299844,299847,0,3,2
85912,6,1,299850,299850,299851,0,1,3
85913,6,1,299856,299856,299857,0,1,5
85914,1,3,299857,299857,299860,0,3,0
85915,4,1,299861,299861,299862,0,1,1
85916,1,1,299862,299862,299863,0,1,0
85917,6,3,299868,299868,299871,0,3,5
85918,6,2,299874,299874,299876,0,2,3
85919,5,2,299879,299879,299881,0,2,3
85920,2,3,299881,299881,299884,0,3,0
85921,4,2,299885,299885,299887,0,2,1
85922,2,1,299887,299887,299888,0,1,0
85923,4,2,299891,299891,299893,0,2,3
85924,4,3,299895,299895,299898,0,3,2
85925,1,2,299896,299898,299900,2,4,0
85926,2,3,299898,299900,299903,2,5,0
85927,6,1,299904,299904,299905,0,1,1
85928,5,1,299909,299909,299910,0,1,4
85929,4,3,299913,299913,299916,0,3,3
85930,5,3,299918,299918,299921,0,3,2
85931,2,3,299920,299921,299924,1,4,0
85932,5,2,299925,299925,299927,0,2,1
85933,3,1,299928,299928,299929,0,1,1
85934,4,3,299932,299932,299935,0,3,3
85935,1,3,299933,299935,299938,2,5,0
85936,3,2,299936,299938,299940,2,4,0
85937,3,3,299939,299940,299943,1,4,0
85938,6,1,299945,299945,299946,0,1,2
85939,5,3,299950,299950,299953,0,3,4
85940,3,1,299953,299953,299954,0,1,0
85941,3,2,299956,299956,299958,0,2,2
85942,6,3,299962,299962,299965,0,3,4
85943,3,1,299965,299965,299966,0,1,0
85944,6,2,299971,299971,299973,0,2,5
85945,6,3,299977,299977,299980,0,3,4
85946,3,3,299980,299980,299983,0,3,0
85947,1,3,299981,299983,299986,2,5,0
85948,6,3,299987,299987,299990,0,3,1
85949,5,2,299992,299992,299994,0,2,2
85950,5,1,299997,299997,299998,0,1,3
85951,1,3,299998,299998,300001,0,3,0
85952,6,3,300004,300004,300007,0,3,3
85953,6,1,300010,300010,300011,0,1,3
85954,4,1,300014,300014,300015,0,1,3
85955,6,3,300020,300020,300023,0,3,5
85956,4,2,300024,300024,300026,0,2,1
85957,4,1,300028,300028,300029,0,1,2
85958,6,1,300034,300034,300035,0,1,5
85959,6,2,300040,300040,300042,0,2,5
85960,4,1,300044,300044,300045,0,1,2
85961,1,1,300045,300045,300046,0,1,0
85962,6,3,300051,300051,300054,0,3,5
85963,1,3,300052,300054,300057,2,5,0
85964,3,2,300055,300057,300059,2,4,0
85965,3,3,300058,300059,300062,1,4,0
85966,5,1,300063,300063,300064,0,1,1
85967,2,2,300065,300065,300067,0,2,1
85968,4,1,300069,300069,300070,0,1,2
85969,1,1,300070,300070,300071,0,1,0
85970,6,1,300076,300076,300077,0,1,5
85971,5,3,300081,300081,300084,0,3,4
85972,3,1,300084,300084,300085,0,1,0
85973,3,2,300087,300087,300089,0,2,2
85974,5,1,300092,300092,300093,0,1,3
85975,2,3,300094,300094,300097,0,3,1
85976,1,3,300095,300097,300100,2,5,0
85977,2,1,300097,300100,300101,3,4,0
85978,4,2,300101,300101,300103,0,2,0
85979,1,1,300102,300103,300104,1,2,0
85980,1,1,300103,300104,300105,1,2,0
85981,2,2,300105,300105,300107,0,2,0
85982,2,2,300107,300107,300109,0,2,0
85983,3,2,300110,300110,300112,0,2,1
85984,6,2,300116,300116,300118,0,2,4
85985,6,2,300122,300122,300124,0,2,4
85986,2,2,300124,300124,300126,0,2,0
85987,5,1,300129,300129,300130,0,1,3
85988,6,2,300135,300135,300137,0,2,5
85989,3,3,300138,300138,300141,0,3,1
85990,1,2,300139,300141,300143,2,4,0
85991,4,2,300143,300143,300145,0,2,0
85992,2,3,300145,300145,300148,0,3,0
85993,6,1,300151,300151,300152,0,1,3
85994,2,3,300153,300153,300156,0,3,1
85995,3,2,300156,300156,300158,0,2,0
85996,3,1,300159,300159,300160,0,1,1
85997,4,1,300163,300163,300164,0,1,3
85998,2,1,300165,300165,300166,0,1,1
85999,6,3,300171,300171,300174,0,3,5
86000,4,1,300175,300175,300176,0,1,1
86001,2,3,300177,300177,300180,0,3,1
86002,3,1,300180,300180,300181,0,1,0
86003,6,3,300186,300186,300189,0,3,5
86004,6,1,300192,300192,300193,0,1,3
86005,1,1,300193,300193,300194,0,1,0
86006,3,3,300196,300196,300199,0,3,2
86007,4,1,300200,300200,300201,0,1,1
86008,5,2,300205,300205,300207,0,2,4
86009,5,3,300210,300210,300213,0,3,3
86010,5,1,300215,300215,300216,0,1,2
86011,3,1,300218,300218,300219,0,1,2
86012,3,1,300221,300221,300222,0,1,2
86013,2,3,300223,300223,300226,0,3,1
86014,2,3,300225,300226,300229,1,4,0
86015,5,1,300230,300230,300231,0,1,1
86016,1,1,300231,300231,300232,0,1,0
86017,4,1,300235,300235,300236,0,1,3
86018,2,1,300237,300237,300238,0,1,1
86019,6,3,300243,300243,300246,0,3,5
86020,6,3,300249,300249,300252,0,3,3
86021,2,1,300251,300252,300253,1,2,0
86022,6,2,300257,300257,300259,0,2,4
86023,4,3,300261,300261,300264,0,3,2
86024,1,3,300262,300264,300267,2,5,0
86025,1,2,300263,300267,300269,4,6,0
86026,3,3,300266,300269,300272,3,6,0
86027,4,1,300270,300272,300273,2,3,0
86028,4,2,300274,300274,300276,0,2,1
86029,5,2,300279,300279,300281,0,2,3
86030,1,3,300280,300281,300284,1,4,0
86031,2,1,300282,300284,300285,2,3,0
86032,6,2,300288,300288,300290,0,2,3
86033,5,1,300293,300293,300294,0,1,3
86034,5,1,300298,300298,300299,0,1,4
86035,6,1,300304,300304,300305,0,1,5
86036,2,1,300306,300306,300307,0,1,1
86037,4,3,300310,300310,300313,0,3,3
86038,3,1,300313,300313,300314,0,1,0
86039,2,2,300315,300315,300317,0,2,1
86040,1,3,300316,300317,300320,1,4,0
86041,2,1,300318,300320,300321,2,3,0
86042,1,3,300319,300321,300324,2,5,0
86043,1,1,300320,300324,300325,4,5,0
86044,6,1,300326,300326,300327,0,1,1
86045,4,2,300330,300330,300332,0,2,3
86046,5,3,300335,300335,300338,0,3,3
86047,4,2,300339,300339,300341,0,2,1
86048,4,2,300343,300343,300345,0,2,2
86049,1,3,300344,300345,300348,1,4,0
86050,3,1,300347,300348,300349,1,2,0
86051,1,3,300348,300349,300352,1,4,0
86052,2,1,300350,300352,300353,2,3,0
86053,4,3,300354,300354,300357,0,3,1
86054,2,1,300356,300357,300358,1,2,0
86055,3,3,300359,300359,300362,0,3,1
86056,5,3,300364,300364,300367,0,3,2
86057,3,1,300367,300367,300368,0,1,0
86058,4,3,300371,300371,300374,0,3,3
86059,3,1,300374,300374,300375,0,1,0
86060,3,1,300377,300377,300378,0,1,2
86061,1,2,300378,300378,300380,0,2,0
86062,5,2,300383,300383,300385,0,2,3
86063,5,2,300388,300388,300390,0,2,3
86064,6,3,300394,300394,300397,0,3,4
86065,2,1,300396,300397,300398,1,2,0
86066,3,2,300399,300399,300401,0,2,1
86067,2,3,300401,300401,300404,0,3,0
86068,6,1,300407,300407,300408,0,1,3
86069,4,1,300411,300411,300412,0,1,3
86070,6,1,300417,300417,300418,0,1,5
86071,2,2,300419,300419,300421,0,2,1
86072,6,2,300425,300425,300427,0,2,4
86073,4,3,300429,300429,300432,0,3,2
86074,2,2,300431,300432,300434,1,3,0
86075,3,3,300434,300434,300437,0,3,0
86076,6,3,300440,300440,300443,0,3,3
86077,5,2,300445,300445,300447,0,2,2
86078,6,3,300451,300451,300454,0,3,4
86079,3,3,300454,300454,300457,0,3,0
86080,6,2,300460,300460,300462,0,2,3
86081,6,2,300466,300466,300468,0,2,4
86082,2,3,300468,300468,300471,0,3,0
86083,1,2,300469,300471,300473,2,4,0
86084,3,1,300472,300473,300474,1,2,0
86085,4,1,300476,300476,300477,0,1,2
86086,5,3,300481,300481,300484,0,3,4
86087,3,2,300484,300484,300486,0,2,0
86088,5,2,300489,300489,300491,0,2,3
86089,3,1,300492,300492,300493,0,1,1
86090,1,2,300493,300493,300495,0,2,0
86091,2,1,300495,300495,300496,0,1,0
86092,6,3,300501,300501,300504,0,3,5
86093,3,3,300504,300504,300507,0,3,0
86094,4,2,300508,300508,300510,0,2,1
86095,5,2,300513,300513,300515,0,2,3
86096,4,1,300517,300517,300518,0,1,2
86097,3,2,300520,300520,300522,0,2,2
86098,2,1,300522,300522,300523,0,1,0
86099,4,3,300526,300526,300529,0,3,3
86100,5,2,300531,300531,300533,0,2,2
86101,3,3,300534,300534,300537,0,3,1
86102,6,1,300540,300540,300541,0,1,3
86103,4,1,300544,300544,300545,0,1,3
86104,3,2,300547,300547,300549,0,2,2
86105,5,2,300552,300552,300554,0,2,3
86106,3,2,300555,300555,300557,0,2,1
86107,6,2,300561,300561,300563,0,2,4
86108,4,2,300565,300565,300567,0,2,2
86109,1,2,300566,300567,300569,1,3,0
86110,3,1,300569,300569,300570,0,1,0
86111,2,2,300571,300571,300573,0,2,1
86112,6,3,300577,300577,300580,0,3,4
86113,5,3,300582,300582,300585,0,3,2
86114,3,2,300585,300585,300587,0,2,0
86115,3,1,300588,300588,300589,0,1,1
86116,1,2,300589,300589,300591,0,2,0
86117,6,1,300595,300595,300596,0,1,4
86118,5,2,300600,300600,300602,0,2,4
86119,4,3,300604,300604,300607,0,3,2
86120,3,1,300607,300607,300608,0,1,0
86121,5,3,300612,300612,300615,0,3,4
86122,4,3,300616,300616,300619,0,3,1
86123,4,1,300620,300620,300621,0,1,1
86124,2,2,300622,300622,300624,0,2,1
86125,3,2,300625,300625,300627,0,2,1
86126,1,3,300626,300627,300630,1,4,0
86127,4,1,300630,300630,300631,0,1,0
86128,6,1,300636,300636,300637,0,1,5
86129,5,1,300641,300641,300642,0,1,4
86130,3,1,300644,300644,300645,0,1,2
86131,5,2,300649,300649,300651,0,2,4
86132,2,1,300651,300651,300652,0,1,0
86133,4,3,300655,300655,300658,0,3,3
86134,6,3,300661,300661,300664,0,3,3
86135,5,1,300666,300666,300667,0,1,2
86136,5,1,300671,300671,300672,0,1,4
86137,6,3,300677,300677,300680,0,3,5
86138,4,2,300681,300681,300683,0,2,1
86139,4,1,300685,300685,300686,0,1,2
86140,4,2,300689,300689,300691,0,2,3
86141,5,1,300694,300694,300695,0,1,3
86142,4,1,300698,300698,300699,0,1,3
86143,2,3,300700,300700,300703,0,3,1
86144,6,2,300706,300706,300708,0,2,3
86145,2,1,300708,300708,300709,0,1,0
86146,5,2,300713,300713,300715,0,2,4
86147,3,3,300716,300716,300719,0,3,1
86148,5,2,300721,300721,300723,0,2,2
86149,3,3,300724,300724,300727,0,3,1
86150,6,3,300730,300730,300733,0,3,3
86151,6,1,300736,300736,300737,0,1,3
86152,4,1,300740,300740,300741,0,1,3
86153,3,1,300743,300743,300744,0,1,2
86154,2,2,300745,300745,300747,0,2,1
86155,5,2,300750,300750,300752,0,2,3
86156,4,2,300754,300754,300756,0,2,2
86157,2,2,300756,300756,300758,0,2,0
86158,5,1,300761,300761,300762,0,1,3
86159,3,1,300764,300764,300765,0,1,2
86160,1,3,300765,300765,300768,0,3,0
86161,5,2,300770,300770,300772,0,2,2
86162,4,3,300774,300774,300777,0,3,2
86163,4,3,300778,300778,300781,0,3,1
86164,3,2,300781,300781,300783,0,2,0
86165,2,3,300783,300783,300786,0,3,0
86166,3,1,300786,300786,300787,0,1,0
86167,4,3,300790,300790,300793,0,3,3
86168,3,2,300793,300793,300795,0,2,0
86169,6,3,300799,300799,300802,0,3,4
86170,4,2,300803,300803,300805,0,2,1
86171,4,1,300807,300807,300808,0,1,2
86172,4,3,300811,300811,300814,0,3,3
86173,2,2,300813,300814,300816,1,3,0
86174,3,1,300816,300816,300817,0,1,0
86175,1,2,300817,300817,300819,0,2,0
86176,6,2,300823,300823,300825,0,2,4
86177,1,3,300824,300825,300828,1,4,0
86178,6,1,300830,300830,300831,0,1,2
86179,2,3,300832,300832,300835,0,3,1
86180,4,3,300836,300836,300839,0,3,1
86181,6,2,300842,300842,300844,0,2,3
86182,1,1,300843,300844,300845,1,2,0
86183,5,1,300848,300848,300849,0,1,3
86184,2,1,300850,300850,300851,0,1,1
86185,3,3,300853,300853,300856,0,3,2
86186,3,3,300856,300856,300859,0,3,0
86187,6,3,300862,300862,300865,0,3,3
86188,2,1,300864,300865,300866,1,2,0
86189,2,1,300866,300866,300867,0,1,0
86190,1,3,300867,300867,300870,0,3,0
86191,5,2,300872,300872,300874,0,2,2
86192,6,1,300878,300878,300879,0,1,4
86193,4,3,300882,300882,300885,0,3,3
86194,3,2,300885,300885,300887,0,2,0
86195,3,1,300888,300888,300889,0,1,1
86196,1,2,300889,300889,300891,0,2,0
86197,4,1,300893,300893,300894,0,1,2
86198,4,2,300897,300897,300899,0,2,3
86199,1,1,300898,300899,300900,1,2,0
86200,5,2,300903,300903,300905,0,2,3
86201,2,1,300905,300905,300906,0,1,0
86202,5,1,300910,300910,300911,0,1,4
86203,4,1,300914,300914,300915,0,1,3
86204,1,2,300915,300915,300917,0,2,0
86205,1,3,300916,300917,300920,1,4,0
86206,6,1,300922,300922,300923,0,1,2
86207,4,2,300926,300926,300928,0,2,3
86208,1,1,300927,300928,300929,1,2,0
86209,5,1,300932,300932,300933,0,1,3
86210,6,1,300938,300938,300939,0,1,5
86211,4,3,300942,300942,300945,0,3,3
86212,5,3,300947,300947,300950,0,3,2
86213,1,1,300948,300950,300951,2,3,0
86214,3,1,300951,300951,300952,0,1,0
86215,3,3,300954,300954,300957,0,3,2
86216,1,3,300955,300957,300960,2,5,0
86217,1,1,300956,300960,300961,4,5,0
86218,1,3,300957,300961,300964,4,7,0
86219,2,1,300959,300964,300965,5,6,0
86220,3,1,300962,300965,300966,3,4,0
86221,4,2,300966,300966,300968,0,2,0
86222,1,3,300967,300968,300971,1,4,0
86223,2,3,300969,300971,300974,2,5,0
86224,6,2,300975,300975,300977,0,2,1
86225,3,3,300978,300978,300981,0,3,1
86226,1,1,300979,300981,300982,2,3,0
86227,3,1,300982,300982,300983,0,1,0
86228,6,3,300988,300988,300991,0,3,5
86229,1,2,300989,300991,300993,2,4,0
86230,5,3,300994,300994,300997,0,3,1
86231,3,2,300997,300997,300999,0,2,0
86232,4,1,301001,301001,301002,0,1,2
86233,4,1,301005,301005,301006,0,1,3
86234,4,2,301009,301009,301011,0,2,3
86235,2,1,301011,301011,301012,0,1,0
86236,1,2,301012,301012,301014,0,2,0
86237,6,2,301018,301018,301020,0,2,4
86238,5,2,301023,301023,301025,0,2,3
86239,1,3,301024,301025,301028,1,4,0
86240,2,1,301026,301028,301029,2,3,0
86241,6,2,301032,301032,301034,0,2,3
86242,2,2,301034,301034,301036,0,2,0
86243,2,2,301036,301036,301038,0,2,0
86244,2,1,301038,301038,301039,0,1,0
86245,4,1,301042,301042,301043,0,1,3
86246,3,2,301045,301045,301047,0,2,2
86247,3,1,301048,301048,301049,0,1,1
86248,4,2,301052,301052,301054,0,2,3
86249,6,3,301058,301058,301061,0,3,4
86250,6,3,301064,301064,301067,0,3,3
86251,2,3,301066,301067,301070,1,4,0
86252,5,3,301071,301071,301074,0,3,1
86253,2,1,301073,301074,301075,1,2,0
86254,1,2,301074,301075,301077,1,3,0
86255,1,2,301075,301077,301079,2,4,0
86256,3,2,301078,301079,301081,1,3,0
86257,6,1,301084,301084,301085,0,1,3
86258,6,2,301090,301090,301092,0,2,5
86259,4,3,301094,301094,301097,0,3,2
86260,4,3,301098,301098,301101,0,3,1
86261,6,3,301104,301104,301107,0,3,3
86262,2,1,301106,301107,301108,1,2,0
86263,4,3,301110,301110,301113,0,3,2
86264,1,1,301111,301113,301114,2,3,0
86265,3,1,301114,301114,301115,0,1,0
86266,2,2,301116,301116,301118,0,2,1
86267,1,3,301117,301118,301121,1,4,0
86268,4,1,301121,301121,301122,0,1,0
86269,3,3,301124,301124,301127,0,3,2
86270,3,2,301127,301127,301129,0,2,0
86271,3,1,301130,301130,301131,0,1,1
86272,2,1,301132,301132,301133,0,1,1
86273,3,2,301135,301135,301137,0,2,2
86274,4,1,301139,301139,301140,0,1,2
86275,2,2,301141,301141,301143,0,2,1
86276,3,1,301144,301144,301145,0,1,1
86277,3,2,301147,301147,301149,0,2,2
86278,3,3,301150,301150,301153,0,3,1
86279,6,1,301156,301156,301157,0,1,3
86280,1,1,301157,301157,301158,0,1,0
86281,2,1,301159,301159,301160,0,1,1
86282,2,1,301161,301161,301162,0,1,1
86283,4,2,301165,301165,301167,0,2,3
86284,4,3,301169,301169,301172,0,3,2
86285,1,2,301170,301172,301174,2,4,0
86286,4,3,301174,301174,301177,0,3,0
86287,5,1,301179,301179,301180,0,1,2
86288,1,3,301180,301180,301183,0,3,0
86289,4,3,301184,301184,301187,0,3,1
86290,1,3,301185,301187,301190,2,5,0
86291,4,2,301189,301190,301192,1,3,0
86292,4,3,301193,301193,301196,0,3,1
86293,5,2,301198,301198,301200,0,2,2
86294,2,3,301200,301200,301203,0,3,0
86295,3,1,301203,301203,301204,0,1,0
86296,5,3,301208,301208,301211,0,3,4
86297,4,1,301212,301212,301213,0,1,1
86298,3,2,301215,301215,301217,0,2,2
86299,6,1,301221,301221,301222,0,1,4
86300,2,1,301223,301223,301224,0,1,1
86301,2,1,301225,301225,301226,0,1,1
86302,1,2,301226,301226,301228,0,2,0
86303,1,1,301227,301228,301229,1,2,0
86304,4,3,301231,301231,301234,0,3,2
86305,5,2,301236,301236,301238,0,2,2
86306,2,1,301238,301238,301239,0,1,0
86307,4,2,301242,301242,301244,0,2,3
86308,3,3,301245,301245,301248,0,3,1
86309,4,1,301249,301249,301250,0,1,1
86310,2,2,301251,301251,301253,0,2,1
86311,1,2,301252,301253,301255,1,3,0
86312,6,1,301258,301258,301259,0,1,3
86313,3,1,301261,301261,301262,0,1,2
86314,6,1,301267,301267,301268,0,1,5
86315,5,3,301272,301272,301275,0,3,4
86316,4,2,301276,301276,301278,0,2,1
86317,6,1,301282,301282,301283,0,1,4
86318,5,2,301287,301287,301289,0,2,4
86319,2,3,301289,301289,301292,0,3,0
86320,1,3,301290,301292,301295,2,5,0
86321,1,3,301291,301295,301298,4,7,0
86322,4,2,301295,301298,301300,3,5,0
86323,2,2,301297,301300,301302,3,5,0
86324,6,2,301303,301303,301305,0,2,1
86325,2,1,301305,301305,301306,0,1,0
86326,5,1,301310,301310,301311,0,1,4
86327,4,3,301314,301314,301317,0,3,3
86328,4,2,301318,301318,301320,0,2,1
86329,2,1,301320,301320,301321,0,1,0
86330,4,2,301324,301324,301326,0,2,3
86331,6,3,301330,301330,301333,0,3,4
86332,6,1,301336,301336,301337,0,1,3
86333,3,3,301339,301339,301342,0,3,2
86334,4,1,301343,301343,301344,0,1,1
86335,6,3,301349,301349,301352,0,3,5
86336,1,1,301350,301352,301353,2,3,0
86337,5,2,301355,301355,301357,0,2,2
86338,1,2,301356,301357,301359,1,3,0
86339,6,3,301362,301362,301365,0,3,3
86340,3,3,301365,301365,301368,0,3,0
86341,6,1,301371,301371,301372,0,1,3
86342,5,2,301376,301376,301378,0,2,4
86343,5,1,301381,301381,301382,0,1,3
86344,3,2,301384,301384,301386,0,2,2
86345,3,3,301387,301387,301390,0,3,1
86346,1,1,301388,301390,301391,2,3,0
86347,5,2,301393,301393,301395,0,2,2
86348,5,2,301398,301398,301400,0,2,3
86349,5,2,301403,301403,301405,0,2,3
86350,4,1,301407,301407,301408,0,1,2
86351,2,1,301409,301409,301410,0,1,1
86352,4,3,301413,301413,301416,0,3,3
86353,4,2,301417,301417,301419,0,2,1
86354,1,3,301418,301419,301422,1,4,0
86355,6,1,301424,301424,301425,0,1,2
86356,2,2,301426,301426,301428,0,2,1
86357,6,2,301432,301432,301434,0,2,4
86358,4,2,301436,301436,301438,0,2,2
86359,5,3,301441,301441,301444,0,3,3
86360,3,2,301444,301444,301446,0,2,0
86361,6,2,301450,301450,301452,0,2,4
86362,4,1,301454,301454,301455,0,1,2
86363,3,2,301457,301457,301459,0,2,2
86364,4,1,301461,301461,301462,0,1,2
86365,2,3,301463,301463,301466,0,3,1
86366,1,2,301464,301466,301468,2,4,0
86367,1,1,301465,301468,301469,3,4,0
86368,1,3,301466,301469,301472,3,6,0
86369,4,3,301470,301472,301475,2,5,0
86370,2,2,301472,301475,301477,3,5,0
86371,2,1,301474,301477,301478,3,4,0
86372,3,2,301477,301478,301480,1,3,0
86373,4,1,301481,301481,301482,0,1,1
86374,1,3,301482,301482,301485,0,3,0
86375,1,1,301483,301485,301486,2,3,0
86376,4,3,301487,301487,301490,0,3,1
86377,2,2,301489,301490,301492,1,3,0
86378,3,2,301492,301492,301494,0,2,0
86379,3,2,301495,301495,301497,0,2,1
86380,5,2,301500,301500,301502,0,2,3
86381,2,1,301502,301502,301503,0,1,0
86382,2,2,301504,301504,301506,0,2,1
86383,1,2,301505,301506,301508,1,3,0
86384,4,3,301509,301509,301512,0,3,1
86385,1,2,301510,301512,301514,2,4,0
86386,4,3,301514,301514,301517,0,3,0
86387,3,3,301517,301517,301520,0,3,0
86388,6,1,301523,301523,301524,0,1,3
86389,3,2,301526,301526,301528,0,2,2
86390,5,1,301531,301531,301532,0,1,3
86391,4,1,301535,301535,301536,0,1,3
86392,6,1,301541,301541,301542,0,1,5
86393,4,1,301545,301545,301546,0,1,3
86394,3,3,301548,301548,301551,0,3,2
86395,1,2,301549,301551,301553,2,4,0
86396,3,2,301552,301553,301555,1,3,0
86397,1,1,301553,301555,301556,2,3,0
86398,1,3,301554,301556,301559,2,5,0
86399,2,2,301556,301559,301561,3,5,0
86400,6,1,301562,301562,301563,0,1,1
86401,5,2,301567,301567,301569,0,2,4
86402,4,2,301571,301571,301573,0,2,2
86403,3,2,301574,301574,301576,0,2,1
86404,5,2,301579,301579,301581,0,2,3
86405,4,3,301583,301583,301586,0,3,2
86406,6,2,301589,301589,301591,0,2,3
86407,3,3,301592,301592,301595,0,3,1
86408,1,1,301593,301595,301596,2,3,0
86409,1,1,301594,301596,301597,2,3,0
86410,6,3,301600,301600,301603,0,3,3
86411,6,1,301606,301606,301607,0,1,3
86412,3,2,301609,301609,301611,0,2,2
86413,3,1,301612,301612,301613,0,1,1
86414,4,1,301616,301616,301617,0,1,3
86415,3,1,301619,301619,301620,0,1,2
86416,5,3,301624,301624,301627,0,3,4
86417,1,3,301625,301627,301630,2,5,0
86418,1,2,301626,301630,301632,4,6,0
86419,1,1,301627,301632,301633,5,6,0
86420,1,2,301628,301633,301635,5,7,0
86421,6,1,301634,301635,301636,1,2,0
86422,3,3,301637,301637,301640,0,3,1
86423,6,3,301643,301643,301646,0,3,3
86424,3,1,301646,301646,301647,0,1,0
86425,3,2,301649,301649,301651,0,2,2
86426,4,3,301653,301653,301656,0,3,2
86427,4,3,301657,301657,301660,0,3,1
86428,6,2,301663,301663,301665,0,2,3
86429,3,2,301666,301666,301668,0,2,1
86430,5,3,301671,301671,301674,0,3,3
86431,5,1,301676,301676,301677,0,1,2
86432,2,1,301678,301678,301679,0,1,1
86433,2,2,301680,301680,301682,0,2,1
86434,2,1,301682,301682,301683,0,1,0
86435,1,3,301683,301683,301686,0,3,0
86436,3,3,301686,301686,301689,0,3,0
86437,5,2,301691,301691,301693,0,2,2
86438,6,3,301697,301697,301700,0,3,4
86439,3,3,301700,301700,301703,0,3,0
86440,6,2,301706,301706,301708,0,2,3
86441,3,3,301709,301709,301712,0,3,1
86442,6,2,301715,301715,301717,0,2,3
86443,2,3,301717,301717,301720,0,3,0
86444,5,3,301722,301722,301725,0,3,2
86445,1,2,301723,301725,301727,2,4,0
86446,6,3,301729,301729,301732,0,3,2
86447,1,1,301730,301732,301733,2,3,0
86448,1,1,301731,301733,301734,2,3,0
86449,1,2,301732,301734,301736,2,4,0
86450,5,1,301737,301737,301738,0,1,1
86451,5,3,301742,301742,301745,0,3,4
86452,3,2,301745,301745,301747,0,2,0
86453,6,2,301751,301751,301753,0,2,4
86454,5,1,301756,301756,301757,0,1,3
86455,4,2,301760,301760,301762,0,2,3
86456,5,2,301765,301765,301767,0,2,3
86457,5,1,301770,301770,301771,0,1,3
86458,5,1,301775,301775,301776,0,1,4
86459,4,1,301779,301779,301780,0,1,3
86460,1,1,301780,301780,301781,0,1,0
86461,2,3,301782,301782,301785,0,3,1
86462,3,3,301785,301785,301788,0,3,0
86463,1,1,301786,301788,301789,2,3,0
86464,2,1,301788,301789,301790,1,2,0
86465,2,1,301790,301790,301791,0,1,0
86466,6,1,301796,301796,301797,0,1,5
86467,6,1,301802,301802,301803,0,1,5
86468,5,3,301807,301807,301810,0,3,4
86469,6,3,301813,301813,301816,0,3,3
86470,2,1,301815,301816,301817,1,2,0
86471,1,1,301816,301817,301818,1,2,0
86472,5,1,301821,301821,301822,0,1,3
86473,2,2,301823,301823,301825,0,2,1
86474,5,2,301828,301828,301830,0,2,3
86475,4,3,301832,301832,301835,0,3,2
86476,6,2,301838,301838,301840,0,2,3
86477,6,2,301844,301844,301846,0,2,4
86478,4,2,301848,301848,301850,0,2,2
86479,5,3,301853,301853,301856,0,3,3
86480,3,3,301856,301856,301859,0,3,0
86481,5,1,301861,301861,301862,0,1,2
86482,2,1,301863,301863,301864,0,1,1
86483,5,3,301868,301868,301871,0,3,4
86484,4,1,301872,301872,301873,0,1,1
86485,5,3,301877,301877,301880,0,3,4
86486,4,2,301881,301881,301883,0,2,1
86487,6,3,301887,301887,301890,0,3,4
86488,2,1,301889,301890,301891,1,2,0
86489,6,1,301895,301895,301896,0,1,4
86490,6,1,301901,301901,301902,0,1,5
86491,1,2,301902,301902,301904,0,2,0
86492,3,3,301905,301905,301908,0,3,1
86493,1,1,301906,301908,301909,2,3,0
86494,4,3,301910,301910,301913,0,3,1
86495,5,1,301915,301915,301916,0,1,2
86496,4,3,301919,301919,301922,0,3,3
86497,3,3,301922,301922,301925,0,3,0
86498,6,1,301928,301928,301929,0,1,3
86499,5,3,301933,301933,301936,0,3,4
86500,4,3,301937,301937,301940,0,3,1
86501,5,2,301942,301942,301944,0,2,2
86502,5,3,301947,301947,301950,0,3,3
86503,5,2,301952,301952,301954,0,2,2
86504,3,2,301955,301955,301957,0,2,1
86505,4,3,301959,301959,301962,0,3,2
86506,3,3,301962,301962,301965,0,3,0
86507,3,1,301965,301965,301966,0,1,0
86508,1,3,301966,301966,301969,0,3,0
86509,5,1,301971,301971,301972,0,1,2
86510,2,3,301973,301973,301976,0,3,1
86511,1,3,301974,301976,301979,2,5,0
86512,1,1,301975,301979,301980,4,5,0
86513,5,3,301980,301980,301983,0,3,0
86514,6,1,301986,301986,301987,0,1,3
86515,6,2,301992,301992,301994,0,2,5
86516,2,3,301994,301994,301997,0,3,0
86517,5,3,301999,301999,302002,0,3,2
86518,2,3,302001,302002,302005,1,4,0
86519,2,1,302003,302005,302006,2,3,0
86520,1,3,302004,302006,302009,2,5,0
86521,1,2,302005,302009,302011,4,6,0
86522,1,3,302006,302011,302014,5,8,0
86523,3,1,302009,302014,302015,5,6,0
86524,6,1,302015,302015,302016,0,1,0
86525,4,1,302019,302019,302020,0,1,3
86526,2,2,302021,302021,302023,0,2,1
86527,6,2,302027,302027,302029,0,2,4
86528,3,3,302030,302030,302033,0,3,1
86529,1,3,302031,302033,302036,2,5,0
86530,2,3,302033,302036,302039,3,6,0
86531,3,2,302036,302039,302041,3,5,0
86532,5,2,302041,302041,302043,0,2,0
86533,4,2,302045,302045,302047,0,2,2
86534,2,1,302047,302047,302048,0,1,0
86535,5,2,302052,302052,302054,0,2,4
86536,3,3,302055,302055,302058,0,3,1
86537,3,3,302058,302058,302061,0,3,0
86538,5,3,302063,302063,302066,0,3,2
86539,3,2,302066,302066,302068,0,2,0
86540,4,2,302070,302070,302072,0,2,2
86541,2,2,302072,302072,302074,0,2,0
86542,2,1,302074,302074,302075,0,1,0
86543,5,2,302079,302079,302081,0,2,4
86544,3,3,302082,302082,302085,0,3,1
86545,5,2,302087,302087,302089,0,2,2
86546,1,2,302088,302089,302091,1,3,0
86547,2,3,302090,302091,302094,1,4,0
86548,1,2,302091,302094,302096,3,5,0
86549,4,3,302095,302096,302099,1,4,0
86550,4,1,302099,302099,302100,0,1,0
86551,2,2,302101,302101,302103,0,2,1
86552,1,2,302102,302103,302105,1,3,0
86553,1,1,302103,302105,302106,2,3,0
86554,4,2,302107,302107,302109,0,2,1
86555,2,2,302109,302109,302111,0,2,0
86556,5,3,302114,302114,302117,0,3,3
86557,1,3,302115,302117,302120,2,5,0
86558,2,3,302117,302120,302123,3,6,0
86559,2,3,302119,302123,302126,4,7,0
86560,1,2,302120,302126,302128,6,8,0
86561,5,1,302125,302128,302129,3,4,0
86562,6,2,302131,302131,302133,0,2,2
86563,3,1,302134,302134,302135,0,1,1
86564,4,2,302138,302138,302140,0,2,3
86565,6,3,302144,302144,302147,0,3,4
86566,4,2,302148,302148,302150,0,2,1
86567,2,3,302150,302150,302153,0,3,0
86568,2,2,302152,302153,302155,1,3,0
86569,6,3,302158,302158,302161,0,3,3
86570,3,2,302161,302161,302163,0,2,0
86571,4,2,302165,302165,302167,0,2,2
86572,4,2,302169,302169,302171,0,2,2
86573,6,1,302175,302175,302176,0,1,4
86574,4,2,302179,302179,302181,0,2,3
86575,2,1,302181,302181,302182,0,1,0
86576,4,3,302185,302185,302188,0,3,3
86577,3,1,302188,302188,302189,0,1,0
86578,1,1,302189,302189,302190,0,1,0
86579,1,2,302190,302190,302192,0,2,0
86580,5,1,302195,302195,302196,0,1,3
86581,5,3,302200,302200,302203,0,3,4
86582,4,3,302204,302204,302207,0,3,1
86583,1,3,302205,302207,302210,2,5,0
86584,4,2,302209,302210,302212,1,3,0
86585,2,3,302211,302212,302215,1,4,0
86586,5,2,302216,302216,302218,0,2,1
86587,2,1,302218,302218,302219,0,1,0
86588,5,2,302223,302223,302225,0,2,4
86589,2,2,302225,302225,302227,0,2,0
86590,1,1,302226,302227,302228,1,2,0
86591,5,1,302231,302231,302232,0,1,3
86592,6,3,302237,302237,302240,0,3,5
86593,3,2,302240,302240,302242,0,2,0
86594,3,3,302243,302243,302246,0,3,1
86595,5,2,302248,302248,302250,0,2,2
86596,2,3,302250,302250,302253,0,3,0
86597,3,3,302253,302253,302256,0,3,0
86598,1,3,302254,302256,302259,2,5,0
86599,6,3,302260,302260,302263,0,3,1
86600,1,3,302261,302263,302266,2,5,0
86601,6,2,302267,302267,302269,0,2,1
86602,1,3,302268,302269,302272,1,4,0
86603,5,1,302273,302273,302274,0,1,1
86604,4,1,302277,302277,302278,0,1,3
86605,3,1,302280,302280,302281,0,1,2
86606,6,2,302286,302286,302288,0,2,5
86607,5,3,302291,302291,302294,0,3,3
86608,6,1,302297,302297,302298,0,1,3
86609,4,3,302301,302301,302304,0,3,3
86610,3,2,302304,302304,302306,0,2,0
86611,3,2,302307,302307,302309,0,2,1
86612,6,1,302313,302313,302314,0,1,4
86613,4,2,302317,302317,302319,0,2,3
86614,1,3,302318,302319,302322,1,4,0
86615,6,1,302324,302324,302325,0,1,2
86616,5,1,302329,302329,302330,0,1,4
86617,5,1,302334,302334,302335,0,1,4
86618,6,3,302340,302340,302343,0,3,5
86619,4,2,302344,302344,302346,0,2,1
86620,1,3,302345,302346,302349,1,4,0
86621,3,3,302348,302349,302352,1,4,0
86622,4,1,302352,302352,302353,0,1,0
86623,3,2,302355,302355,302357,0,2,2
86624,4,2,302359,302359,302361,0,2,2
86625,4,2,302363,302363,302365,0,2,2
86626,3,1,302366,302366,302367,0,1,1
86627,6,3,302372,302372,302375,0,3,5
86628,3,2,302375,302375,302377,0,2,0
86629,1,2,302376,302377,302379,1,3,0
86630,3,1,302379,302379,302380,0,1,0
86631,3,2,302382,302382,302384,0,2,2
86632,1,3,302383,302384,302387,1,4,0
86633,1,1,302384,302387,302388,3,4,0
86634,2,3,302386,302388,302391,2,5,0
86635,6,3,302392,302392,302395,0,3,1
86636,5,3,302397,302397,302400,0,3,2
86637,5,1,302402,302402,302403,0,1,2
86638,3,2,302405,302405,302407,0,2,2
86639,1,1,302406,302407,302408,1,2,0
86640,4,3,302410,302410,302413,0,3,2
86641,5,2,302415,302415,302417,0,2,2
86642,3,2,302418,302418,302420,0,2,1
86643,2,1,302420,302420,302421,0,1,0
86644,2,1,302422,302422,302423,0,1,1
86645,1,1,302423,302423,302424,0,1,0
86646,3,3,302426,302426,302429,0,3,2
86647,6,2,302432,302432,302434,0,2,3
86648,1,3,302433,302434,302437,1,4,0
86649,1,1,302434,302437,302438,3,4,0
86650,5,1,302439,302439,302440,0,1,1
86651,5,3,302444,302444,302447,0,3,4
86652,6,2,302450,302450,302452,0,2,3
86653,2,1,302452,302452,302453,0,1,0
86654,1,1,302453,302453,302454,0,1,0
86655,1,3,302454,302454,302457,0,3,0
86656,6,1,302460,302460,302461,0,1,3
86657,1,3,302461,302461,302464,0,3,0
86658,2,3,302463,302464,302467,1,4,0
86659,3,3,302466,302467,302470,1,4,0
86660,1,1,302467,302470,302471,3,4,0
86661,4,3,302471,302471,302474,0,3,0
86662,4,3,302475,302475,302478,0,3,1
86663,5,1,302480,302480,302481,0,1,2
86664,5,3,302485,302485,302488,0,3,4
86665,4,1,302489,302489,302490,0,1,1
86666,4,2,302493,302493,302495,0,2,3
86667,5,2,302498,302498,302500,0,2,3
86668,4,3,302502,302502,302505,0,3,2
86669,5,1,302507,302507,302508,0,1,2
86670,6,1,302513,302513,302514,0,1,5
86671,4,3,302517,302517,302520,0,3,3
86672,4,1,302521,302521,302522,0,1,1
86673,3,2,302524,302524,302526,0,2,2
86674,3,2,302527,302527,302529,0,2,1
86675,6,3,302533,302533,302536,0,3,4
86676,1,2,302534,302536,302538,2,4,0
86677,5,1,302539,302539,302540,0,1,1
86678,3,1,302542,302542,302543,0,1,2
86679,2,3,302544,302544,302547,0,3,1
86680,3,2,302547,302547,302549,0,2,0
86681,4,2,302551,302551,302553,0,2,2
86682,4,2,302555,302555,302557,0,2,2
86683,5,1,302560,302560,302561,0,1,3
86684,2,3,302562,302562,302565,0,3,1
86685,3,1,302565,302565,302566,0,1,0
86686,3,1,302568,302568,302569,0,1,2
86687,4,3,302572,302572,302575,0,3,3
86688,4,2,302576,302576,302578,0,2,1
86689,3,3,302579,302579,302582,0,3,1
86690,5,1,302584,302584,302585,0,1,2
86691,4,3,302588,302588,302591,0,3,3
86692,2,1,302590,302591,302592,1,2,0
86693,5,1,302595,302595,302596,0,1,3
86694,3,3,302598,302598,302601,0,3,2
86695,5,1,302603,302603,302604,0,1,2
86696,5,3,302608,302608,302611,0,3,4
86697,4,1,302612,302612,302613,0,1,1
86698,2,1,302614,302614,302615,0,1,1
86699,3,2,302617,302617,302619,0,2,2
86700,1,2,302618,302619,302621,1,3,0
86701,3,1,302621,302621,302622,0,1,0
86702,5,1,302626,302626,302627,0,1,4
86703,3,3,302629,302629,302632,0,3,2
86704,6,1,302635,302635,302636,0,1,3
86705,5,2,302640,302640,302642,0,2,4
86706,2,2,302642,302642,302644,0,2,0
86707,5,1,302647,302647,302648,0,1,3
86708,5,1,302652,302652,302653,0,1,4
86709,6,2,302658,302658,302660,0,2,5
86710,1,2,302659,302660,302662,1,3,0
86711,2,1,302661,302662,302663,1,2,0
86712,2,3,302663,302663,302666,0,3,0
86713,5,1,302668,302668,302669,0,1,2
86714,1,1,302669,302669,302670,0,1,0
86715,4,3,302673,302673,302676,0,3,3
86716,5,1,302678,302678,302679,0,1,2
86717,1,1,302679,302679,302680,0,1,0
86718,3,2,302682,302682,302684,0,2,2
86719,5,3,302687,302687,302690,0,3,3
86720,6,1,302693,302693,302694,0,1,3
86721,1,3,302694,302694,302697,0,3,0
86722,3,1,302697,302697,302698,0,1,0
86723,1,3,302698,302698,302701,0,3,0
86724,2,1,302700,302701,302702,1,2,0
86725,4,2,302704,302704,302706,0,2,2
86726,1,2,302705,302706,302708,1,3,0
86727,6,1,302711,302711,302712,0,1,3
86728,5,2,302716,302716,302718,0,2,4
86729,1,3,302717,302718,302721,1,4,0
86730,3,2,302720,302721,302723,1,3,0
86731,3,2,302723,302723,302725,0,2,0
86732,4,1,302727,302727,302728,0,1,2
86733,6,1,302733,302733,302734,0,1,5
86734,5,3,302738,302738,302741,0,3,4
86735,6,2,302744,302744,302746,0,2,3
86736,1,1,302745,302746,302747,1,2,0
86737,6,2,302751,302751,302753,0,2,4
86738,1,2,302752,302753,302755,1,3,0
86739,6,2,302758,302758,302760,0,2,3
86740,1,1,302759,302760,302761,1,2,0
86741,6,1,302765,302765,302766,0,1,4
86742,2,1,302767,302767,302768,0,1,1
86743,4,3,302771,302771,302774,0,3,3
86744,4,1,302775,302775,302776,0,1,1
86745,1,1,302776,302776,302777,0,1,0
86746,3,2,302779,302779,302781,0,2,2
86747,3,1,302782,302782,302783,0,1,1
86748,4,3,302786,302786,302789,0,3,3
86749,5,1,302791,302791,302792,0,1,2
86750,4,2,302795,302795,302797,0,2,3
86751,4,1,302799,302799,302800,0,1,2
86752,2,3,302801,302801,302804,0,3,1
86753,3,1,302804,302804,302805,0,1,0
86754,5,3,302809,302809,302812,0,3,4
86755,5,1,302814,302814,302815,0,1,2
86756,2,3,302816,302816,302819,0,3,1
86757,6,1,302822,302822,302823,0,1,3
86758,3,1,302825,302825,302826,0,1,2
86759,6,2,302831,302831,302833,0,2,5
86760,2,2,302833,302833,302835,0,2,0
86761,5,3,302838,302838,302841,0,3,3
86762,6,1,302844,302844,302845,0,1,3
86763,3,2,302847,302847,302849,0,2,2
86764,2,1,302849,302849,302850,0,1,0
86765,1,3,302850,302850,302853,0,3,0
86766,6,3,302856,302856,302859,0,3,3
86767,2,1,302858,302859,302860,1,2,0
86768,4,3,302862,302862,302865,0,3,2
86769,6,2,302868,302868,302870,0,2,3
86770,4,1,302872,302872,302873,0,1,2
86771,6,3,302878,302878,302881,0,3,5
86772,5,2,302883,302883,302885,0,2,2
86773,5,3,302888,302888,302891,0,3,3
86774,5,2,302893,302893,302895,0,2,2
86775,1,2,302894,302895,302897,1,3,0
86776,1,2,302895,302897,302899,2,4,0
86777,3,2,302898,302899,302901,1,3,0
86778,6,2,302904,302904,302906,0,2,3
86779,3,3,302907,302907,302910,0,3,1
86780,2,2,302909,302910,302912,1,3,0
86781,2,2,302911,302912,302914,1,3,0
86782,2,1,302913,302914,302915,1,2,0
86783,5,1,302918,302918,302919,0,1,3
86784,2,3,302920,302920,302923,0,3,1
86785,5,1,302925,302925,302926,0,1,2
86786,5,3,302930,302930,302933,0,3,4
86787,3,3,302933,302933,302936,0,3,0
86788,6,2,302939,302939,302941,0,2,3
86789,4,1,302943,302943,302944,0,1,2
86790,3,3,302946,302946,302949,0,3,2
86791,3,1,302949,302949,302950,0,1,0
86792,2,2,302951,302951,302953,0,2,1
86793,3,2,302954,302954,302956,0,2,1
86794,2,3,302956,302956,302959,0,3,0
86795,6,2,302962,302962,302964,0,2,3
86796,4,3,302966,302966,302969,0,3,2
86797,2,1,302968,302969,302970,1,2,0
86798,5,2,302973,302973,302975,0,2,3
86799,4,2,302977,302977,302979,0,2,2
86800,5,2,302982,302982,302984,0,2,3
86801,5,1,302987,302987,302988,0,1,3
86802,4,2,302991,302991,302993,0,2,3
86803,4,2,302995,302995,302997,0,2,2
86804,4,1,302999,302999,303000,0,1,2
86805,4,2,303003,303003,303005,0,2,3
86806,6,2,303009,303009,303011,0,2,4
86807,1,2,303010,303011,303013,1,3,0
86808,2,2,303012,303013,303015,1,3,0
86809,1,1,303013,303015,303016,2,3,0
86810,1,1,303014,303016,303017,2,3,0
86811,6,1,303020,303020,303021,0,1,3
86812,4,1,303024,303024,303025,0,1,3
86813,1,2,303025,303025,303027,0,2,0
86814,2,2,303027,303027,303029,0,2,0
86815,2,3,303029,303029,303032,0,3,0
86816,1,1,303030,303032,303033,2,3,0
86817,2,3,303032,303033,303036,1,4,0
86818,1,1,303033,303036,303037,3,4,0
86819,3,1,303036,303037,303038,1,2,0
86820,1,2,303037,303038,303040,1,3,0
86821,5,3,303042,303042,303045,0,3,2
86822,5,3,303047,303047,303050,0,3,2
86823,1,2,303048,303050,303052,2,4,0
86824,5,3,303053,303053,303056,0,3,1
86825,3,3,303056,303056,303059,0,3,0
86826,1,1,303057,303059,303060,2,3,0
86827,4,3,303061,303061,303064,0,3,1
86828,4,3,303065,303065,303068,0,3,1
86829,5,1,303070,303070,303071,0,1,2
86830,2,2,303072,303072,303074,0,2,1
86831,1,3,303073,303074,303077,1,4,0
86832,4,1,303077,303077,303078,0,1,0
86833,1,1,303078,303078,303079,0,1,0
86834,4,3,303082,303082,303085,0,3,3
86835,6,2,303088,303088,303090,0,2,3
86836,4,3,303092,303092,303095,0,3,2
86837,5,2,303097,303097,303099,0,2,2
86838,1,1,303098,303099,303100,1,2,0
86839,2,1,303100,303100,303101,0,1,0
86840,5,1,303105,303105,303106,0,1,4
86841,5,3,303110,303110,303113,0,3,4
86842,6,3,303116,303116,303119,0,3,3
86843,1,3,303117,303119,303122,2,5,0
86844,3,3,303120,303122,303125,2,5,0
86845,4,3,303124,303125,303128,1,4,0
86846,5,3,303129,303129,303132,0,3,1
86847,1,3,303130,303132,303135,2,5,0
86848,3,1,303133,303135,303136,2,3,0
86849,3,1,303136,303136,303137,0,1,0
86850,2,3,303138,303138,303141,0,3,1
86851,1,3,303139,303141,303144,2,5,0
86852,2,2,303141,303144,303146,3,5,0
86853,5,3,303146,303146,303149,0,3,0
86854,2,3,303148,303149,303152,1,4,0
86855,1,2,303149,303152,303154,3,5,0
86856,6,3,303155,303155,303158,0,3,1
86857,4,1,303159,303159,303160,0,1,1
86858,3,3,303162,303162,303165,0,3,2
86859,6,2,303168,303168,303170,0,2,3
86860,6,2,303174,303174,303176,0,2,4
86861,1,2,303175,303176,303178,1,3,0
86862,6,3,303181,303181,303184,0,3,3
86863,4,3,303185,303185,303188,0,3,1
86864,5,2,303190,303190,303192,0,2,2
86865,5,3,303195,303195,303198,0,3,3
86866,3,2,303198,303198,303200,0,2,0
86867,6,3,303204,303204,303207,0,3,4
86868,1,1,303205,303207,303208,2,3,0
86869,4,2,303209,303209,303211,0,2,1
86870,4,2,303213,303213,303215,0,2,2
86871,5,2,303218,303218,303220,0,2,3
86872,3,3,303221,303221,303224,0,3,1
86873,4,3,303225,303225,303228,0,3,1
86874,5,3,303230,303230,303233,0,3,2
86875,2,2,303232,303233,303235,1,3,0
86876,3,2,303235,303235,303237,0,2,0
86877,3,1,303238,303238,303239,0,1,1
86878,5,1,303243,303243,303244,0,1,4
86879,3,1,303246,303246,303247,0,1,2
86880,1,1,303247,303247,303248,0,1,0
86881,5,1,303252,303252,303253,0,1,4
86882,6,2,303258,303258,303260,0,2,5
86883,3,3,303261,303261,303264,0,3,1
86884,6,2,303267,303267,303269,0,2,3
86885,6,1,303273,303273,303274,0,1,4
86886,2,3,303275,303275,303278,0,3,1
86887,3,1,303278,303278,303279,0,1,0
86888,5,3,303283,303283,303286,0,3,4
86889,6,3,303289,303289,303292,0,3,3
86890,4,1,303293,303293,303294,0,1,1
86891,4,2,303297,303297,303299,0,2,3
86892,5,1,303302,303302,303303,0,1,3
86893,1,1,303303,303303,303304,0,1,0
86894,5,2,303308,303308,303310,0,2,4
86895,2,2,303310,303310,303312,0,2,0
86896,5,2,303315,303315,303317,0,2,3
86897,1,3,303316,303317,303320,1,4,0
86898,5,2,303321,303321,303323,0,2,1
86899,4,1,303325,303325,303326,0,1,2
86900,4,3,303329,303329,303332,0,3,3
86901,3,2,303332,303332,303334,0,2,0
86902,1,1,303333,303334,303335,1,2,0
86903,1,2,303334,303335,303337,1,3,0
86904,2,3,303336,303337,303340,1,4,0
86905,6,1,303342,303342,303343,0,1,2
86906,2,3,303344,303344,303347,0,3,1
86907,4,3,303348,303348,303351,0,3,1
86908,6,2,303354,303354,303356,0,2,3
86909,4,1,303358,303358,303359,0,1,2
86910,6,1,303364,303364,303365,0,1,5
86911,3,2,303367,303367,303369,0,2,2
86912,6,2,303373,303373,303375,0,2,4
86913,3,2,303376,303376,303378,0,2,1
86914,4,1,303380,303380,303381,0,1,2
86915,4,1,303384,303384,303385,0,1,3
86916,5,1,303389,303389,303390,0,1,4
86917,5,1,303394,303394,303395,0,1,4
86918,4,2,303398,303398,303400,0,2,3
86919,2,2,303400,303400,303402,0,2,0
86920,4,1,303404,303404,303405,0,1,2
86921,5,2,303409,303409,303411,0,2,4
86922,2,2,303411,303411,303413,0,2,0
86923,1,2,303412,303413,303415,1,3,0
86924,2,1,303414,303415,303416,1,2,0
86925,5,3,303419,303419,303422,0,3,3
86926,3,2,303422,303422,303424,0,2,0
86927,4,2,303426,303426,303428,0,2,2
86928,5,3,303431,303431,303434,0,3,3
86929,5,1,303436,303436,303437,0,1,2
86930,4,1,303440,303440,303441,0,1,3
86931,1,1,303441,303441,303442,0,1,0
86932,6,3,303447,303447,303450,0,3,5
86933,1,2,303448,303450,303452,2,4,0
86934,1,2,303449,303452,303454,3,5,0
86935,4,3,303453,303454,303457,1,4,0
86936,4,3,303457,303457,303460,0,3,0
86937,4,2,303461,303461,303463,0,2,1
86938,1,3,303462,303463,303466,1,4,0
86939,4,1,303466,303466,303467,0,1,0
86940,3,1,303469,303469,303470,0,1,2
86941,1,3,303470,303470,303473,0,3,0
86942,1,2,303471,303473,303475,2,4,0
86943,3,2,303474,303475,303477,1,3,0
86944,6,2,303480,303480,303482,0,2,3
86945,4,3,303484,303484,303487,0,3,2
86946,3,2,303487,303487,303489,0,2,0
86947,1,2,303488,303489,303491,1,3,0
86948,2,3,303490,303491,303494,1,4,0
86949,4,3,303494,303494,303497,0,3,0
86950,6,2,303500,303500,303502,0,2,3
86951,3,1,303503,303503,303504,0,1,1
86952,1,1,303504,303504,303505,0,1,0
86953,4,1,303508,303508,303509,0,1,3
86954,6,3,303514,303514,303517,0,3,5
86955,5,2,303519,303519,303521,0,2,2
86956,6,2,303525,303525,303527,0,2,4
86957,3,2,303528,303528,303530,0,2,1
86958,6,1,303534,303534,303535,0,1,4
86959,1,3,303535,303535,303538,0,3,0
86960,3,1,303538,303538,303539,0,1,0
86961,6,1,303544,303544,303545,0,1,5
86962,4,3,303548,303548,303551,0,3,3
86963,4,2,303552,303552,303554,0,2,1
86964,5,2,303557,303557,303559,0,2,3
86965,2,3,303559,303559,303562,0,3,0
86966,4,3,303563,303563,303566,0,3,1
86967,6,3,303569,303569,303572,0,3,3
86968,6,2,303575,303575,303577,0,2,3
86969,2,3,303577,303577,303580,0,3,0
86970,5,1,303582,303582,303583,0,1,2
86971,1,2,303583,303583,303585,0,2,0
86972,6,3,303589,303589,303592,0,3,4
86973,1,3,303590,303592,303595,2,5,0
86974,4,1,303594,303595,303596,1,2,0
86975,5,1,303599,303599,303600,0,1,3
86976,5,1,303604,303604,303605,0,1,4
86977,4,3,303608,303608,303611,0,3,3
86978,4,1,303612,303612,303613,0,1,1
86979,3,1,303615,303615,303616,0,1,2
86980,4,3,303619,303619,303622,0,3,3
86981,1,1,303620,303622,303623,2,3,0
86982,5,3,303625,303625,303628,0,3,2
86983,6,1,303631,303631,303632,0,1,3
86984,2,3,303633,303633,303636,0,3,1
86985,2,3,303635,303636,303639,1,4,0
86986,4,3,303639,303639,303642,0,3,0
86987,4,1,303643,303643,303644,0,1,1
86988,5,3,303648,303648,303651,0,3,4
86989,5,2,303653,303653,303655,0,2,2
86990,5,1,303658,303658,303659,0,1,3
86991,4,3,303662,303662,303665,0,3,3
86992,2,1,303664,303665,303666,1,2,0
86993,4,1,303668,303668,303669,0,1,2
86994,4,1,303672,303672,303673,0,1,3
86995,6,3,303678,303678,303681,0,3,5
86996,5,1,303683,303683,303684,0,1,2
86997,3,3,303686,303686,303689,0,3,2
86998,3,2,303689,303689,303691,0,2,0
86999,6,1,303695,303695,303696,0,1,4
87000,1,1,303696,303696,303697,0,1,0
87001,2,2,303698,303698,303700,0,2,1
87002,5,1,303703,303703,303704,0,1,3
87003,6,2,303709,303709,303711,0,2,5
87004,2,3,303711,303711,303714,0,3,0
87005,4,1,303715,303715,303716,0,1,1
87006,5,2,303720,303720,303722,0,2,4
87007,5,3,303725,303725,303728,0,3,3
87008,4,3,303729,303729,303732,0,3,1
87009,6,2,303735,303735,303737,0,2,3
87010,5,1,303740,303740,303741,0,1,3
87011,1,1,303741,303741,303742,0,1,0
87012,6,1,303747,303747,303748,0,1,5
87013,2,3,303749,303749,303752,0,3,1
87014,6,1,303755,303755,303756,0,1,3
87015,2,3,303757,303757,303760,0,3,1
87016,3,2,303760,303760,303762,0,2,0
87017,6,3,303766,303766,303769,0,3,4
87018,2,2,303768,303769,303771,1,3,0
87019,5,2,303773,303773,303775,0,2,2
87020,2,1,303775,303775,303776,0,1,0
87021,5,3,303780,303780,303783,0,3,4
87022,5,3,303785,303785,303788,0,3,2
87023,1,3,303786,303788,303791,2,5,0
87024,6,1,303792,303792,303793,0,1,1
87025,5,1,303797,303797,303798,0,1,4
87026,5,1,303802,303802,303803,0,1,4
87027,5,1,303807,303807,303808,0,1,4
87028,4,2,303811,303811,303813,0,2,3
87029,5,2,303816,303816,303818,0,2,3
87030,5,2,303821,303821,303823,0,2,3
87031,3,3,303824,303824,303827,0,3,1
87032,6,3,303830,303830,303833,0,3,3
87033,6,2,303836,303836,303838,0,2,3
87034,3,3,303839,303839,303842,0,3,1
87035,3,1,303842,303842,303843,0,1,0
87036,3,2,303845,303845,303847,0,2,2
87037,4,2,303849,303849,303851,0,2,2
87038,6,1,303855,303855,303856,0,1,4
87039,3,1,303858,303858,303859,0,1,2
87040,2,3,303860,303860,303863,0,3,1
87041,6,1,303866,303866,303867,0,1,3
87042,1,3,303867,303867,303870,0,3,0
87043,3,1,303870,303870,303871,0,1,0
87044,5,1,303875,303875,303876,0,1,4
87045,1,2,303876,303876,303878,0,2,0
87046,1,2,303877,303878,303880,1,3,0
87047,2,1,303879,303880,303881,1,2,0
87048,3,1,303882,303882,303883,0,1,1
87049,2,3,303884,303884,303887,0,3,1
87050,1,3,303885,303887,303890,2,5,0
87051,2,1,303887,303890,303891,3,4,0
87052,4,2,303891,303891,303893,0,2,0
87053,4,2,303895,303895,303897,0,2,2
87054,3,3,303898,303898,303901,0,3,1
87055,2,1,303900,303901,303902,1,2,0
87056,5,2,303905,303905,303907,0,2,3
87057,1,3,303906,303907,303910,1,4,0
87058,4,3,303910,303910,303913,0,3,0
87059,4,1,303914,303914,303915,0,1,1
87060,6,3,303920,303920,303923,0,3,5
87061,3,1,303923,303923,303924,0,1,0
87062,4,1,303927,303927,303928,0,1,3
87063,1,3,303928,303928,303931,0,3,0
87064,2,1,303930,303931,303932,1,2,0
87065,3,3,303933,303933,303936,0,3,1
87066,6,3,303939,303939,303942,0,3,3
87067,3,1,303942,303942,303943,0,1,0
87068,5,2,303947,303947,303949,0,2,4
87069,2,2,303949,303949,303951,0,2,0
87070,5,3,303954,303954,303957,0,3,3
87071,4,1,303958,303958,303959,0,1,1
87072,1,2,303959,303959,303961,0,2,0
87073,6,2,303965,303965,303967,0,2,4
87074,2,1,303967,303967,303968,0,1,0
87075,4,3,303971,303971,303974,0,3,3
87076,5,3,303976,303976,303979,0,3,2
87077,5,3,303981,303981,303984,0,3,2
87078,5,2,303986,303986,303988,0,2,2
87079,5,3,303991,303991,303994,0,3,3
87080,2,3,303993,303994,303997,1,4,0
87081,6,3,303999,303999,304002,0,3,2
87082,3,3,304002,304002,304005,0,3,0
87083,4,3,304006,304006,304009,0,3,1
87084,1,2,304007,304009,304011,2,4,0
87085,3,1,304010,304011,304012,1,2,0
87086,1,1,304011,304012,304013,1,2,0
87087,6,3,304017,304017,304020,0,3,4
87088,6,1,304023,304023,304024,0,1,3
87089,2,1,304025,304025,304026,0,1,1
87090,3,3,304028,304028,304031,0,3,2
87091,6,1,304034,304034,304035,0,1,3
87092,6,1,304040,304040,304041,0,1,5
87093,1,3,304041,304041,304044,0,3,0
87094,6,2,304047,304047,304049,0,2,3
87095,4,3,304051,304051,304054,0,3,2
87096,5,2,304056,304056,304058,0,2,2
87097,3,2,304059,304059,304061,0,2,1
87098,5,2,304064,304064,304066,0,2,3
87099,4,1,304068,304068,304069,0,1,2
87100,1,1,304069,304069,304070,0,1,0
87101,4,2,304073,304073,304075,0,2,3
87102,1,2,304074,304075,304077,1,3,0
87103,1,3,304075,304077,304080,2,5,0
87104,4,3,304079,304080,304083,1,4,0
87105,6,3,304085,304085,304088,0,3,2
87106,3,3,304088,304088,304091,0,3,0
87107,4,1,304092,304092,304093,0,1,1
87108,3,1,304095,304095,304096,0,1,2
87109,3,2,304098,304098,304100,0,2,2
87110,2,2,304100,304100,304102,0,2,0
87111,5,2,304105,304105,304107,0,2,3
87112,3,3,304108,304108,304111,0,3,1
87113,4,2,304112,304112,304114,0,2,1
87114,1,1,304113,304114,304115,1,2,0
87115,4,2,304117,304117,304119,0,2,2
87116,2,1,304119,304119,304120,0,1,0
87117,4,2,304123,304123,304125,0,2,3
87118,6,2,304129,304129,304131,0,2,4
87119,1,2,304130,304131,304133,1,3,0
87120,1,2,304131,304133,304135,2,4,0
87121,2,2,304133,304135,304137,2,4,0
87122,1,3,304134,304137,304140,3,6,0
87123,2,2,304136,304140,304142,4,6,0
87124,2,2,304138,304142,304144,4,6,0
87125,5,2,304143,304144,304146,1,3,0
87126,3,3,304146,304146,304149,0,3,0
87127,2,2,304148,304149,304151,1,3,0
87128,6,2,304154,304154,304156,0,2,3
87129,5,3,304159,304159,304162,0,3,3
87130,1,3,304160,304162,304165,2,5,0
87131,2,2,304162,304165,304167,3,5,0
87132,2,3,304164,304167,304170,3,6,0
87133,4,3,304168,304170,304173,2,5,0
87134,2,1,304170,304173,304174,3,4,0
87135,5,1,304175,304175,304176,0,1,1
87136,6,2,304181,304181,304183,0,2,5
87137,2,3,304183,304183,304186,0,3,0
87138,2,2,304185,304186,304188,1,3,0
87139,5,1,304190,304190,304191,0,1,2
87140,3,3,304193,304193,304196,0,3,2
87141,2,3,304195,304196,304199,1,4,0
87142,3,1,304198,304199,304200,1,2,0
87143,6,1,304204,304204,304205,0,1,4
87144,6,3,304210,304210,304213,0,3,5
87145,4,3,304214,304214,304217,0,3,1
87146,5,3,304219,304219,304222,0,3,2
87147,6,3,304225,304225,304228,0,3,3
87148,4,2,304229,304229,304231,0,2,1
87149,4,3,304233,304233,304236,0,3,2
87150,1,3,304234,304236,304239,2,5,0
87151,5,3,304239,304239,304242,0,3,0
87152,4,2,304243,304243,304245,0,2,1
87153,2,1,304245,304245,304246,0,1,0
87154,4,3,304249,304249,304252,0,3,3
87155,2,1,304251,304252,304253,1,2,0
87156,5,1,304256,304256,304257,0,1,3
87157,6,3,304262,304262,304265,0,3,5
87158,4,1,304266,304266,304267,0,1,1
87159,3,1,304269,304269,304270,0,1,2
87160,6,3,304275,304275,304278,0,3,5
87161,4,2,304279,304279,304281,0,2,1
87162,6,1,304285,304285,304286,0,1,4
87163,2,3,304287,304287,304290,0,3,1
87164,6,2,304293,304293,304295,0,2,3
87165,3,1,304296,304296,304297,0,1,1
87166,5,1,304301,304301,304302,0,1,4
87167,3,3,304304,304304,304307,0,3,2
87168,1,1,304305,304307,304308,2,3,0
87169,6,2,304311,304311,304313,0,2,3
87170,3,2,304314,304314,304316,0,2,1
87171,3,1,304317,304317,304318,0,1,1
87172,2,2,304319,304319,304321,0,2,1
87173,4,3,304323,304323,304326,0,3,2
87174,4,1,304327,304327,304328,0,1,1
87175,4,2,304331,304331,304333,0,2,3
87176,5,1,304336,304336,304337,0,1,3
87177,6,1,304342,304342,304343,0,1,5
87178,3,1,304345,304345,304346,0,1,2
87179,6,2,304351,304351,304353,0,2,5
87180,5,1,304356,304356,304357,0,1,3
87181,2,3,304358,304358,304361,0,3,1
87182,5,1,304363,304363,304364,0,1,2
87183,4,3,304367,304367,304370,0,3,3
87184,3,1,304370,304370,304371,0,1,0
87185,1,1,304371,304371,304372,0,1,0
87186,5,2,304376,304376,304378,0,2,4
87187,3,2,304379,304379,304381,0,2,1
87188,5,1,304384,304384,304385,0,1,3
87189,5,3,304389,304389,304392,0,3,4
87190,3,3,304392,304392,304395,0,3,0
87191,5,2,304397,304397,304399,0,2,2
87192,1,2,304398,304399,304401,1,3,0
87193,2,3,304400,304401,304404,1,4,0
87194,4,2,304404,304404,304406,0,2,0
87195,3,3,304407,304407,304410,0,3,1
87196,3,3,304410,304410,304413,0,3,0
87197,3,1,304413,304413,304414,0,1,0
87198,3,3,304416,304416,304419,0,3,2
87199,3,1,304419,304419,304420,0,1,0
87200,3,2,304422,304422,304424,0,2,2
87201,4,1,304426,304426,304427,0,1,2
87202,4,3,304430,304430,304433,0,3,3
87203,5,2,304435,304435,304437,0,2,2
87204,2,1,304437,304437,304438,0,1,0
87205,5,1,304442,304442,304443,0,1,4
87206,4,1,304446,304446,304447,0,1,3
87207,2,3,304448,304448,304451,0,3,1
87208,4,1,304452,304452,304453,0,1,1
87209,2,1,304454,304454,304455,0,1,1
87210,4,2,304458,304458,304460,0,2,3
87211,3,2,304461,304461,304463,0,2,1
87212,4,3,304465,304465,304468,0,3,2
87213,6,2,304471,304471,304473,0,2,3
87214,3,1,304474,304474,304475,0,1,1
87215,1,1,304475,304475,304476,0,1,0
87216,1,3,304476,304476,304479,0,3,0
87217,4,2,304480,304480,304482,0,2,1
87218,3,1,304483,304483,304484,0,1,1
87219,1,1,304484,304484,304485,0,1,0
87220,1,2,304485,304485,304487,0,2,0
87221,4,2,304489,304489,304491,0,2,2
87222,5,3,304494,304494,304497,0,3,3
87223,5,1,304499,304499,304500,0,1,2
87224,1,2,304500,304500,304502,0,2,0
87225,6,3,304506,304506,304509,0,3,4
87226,6,1,304512,304512,304513,0,1,3
87227,4,2,304516,304516,304518,0,2,3
87228,4,3,304520,304520,304523,0,3,2
87229,5,3,304525,304525,304528,0,3,2
87230,5,1,304530,304530,304531,0,1,2
87231,2,3,304532,304532,304535,0,3,1
87232,4,3,304536,304536,304539,0,3,1
87233,3,2,304539,304539,304541,0,2,0
87234,2,2,304541,304541,304543,0,2,0
87235,2,3,304543,304543,304546,0,3,0
87236,2,1,304545,304546,304547,1,2,0
87237,4,3,304549,304549,304552,0,3,2
87238,5,3,304554,304554,304557,0,3,2
87239,4,1,304558,304558,304559,0,1,1
87240,2,2,304560,304560,304562,0,2,1
87241,3,1,304563,304563,304564,0,1,1
87242,1,1,304564,304564,304565,0,1,0
87243,6,3,304570,304570,304573,0,3,5
87244,6,1,304576,304576,304577,0,1,3
87245,5,2,304581,304581,304583,0,2,4
87246,4,1,304585,304585,304586,0,1,2
87247,1,2,304586,304586,304588,0,2,0
87248,3,1,304589,304589,304590,0,1,1
87249,5,3,304594,304594,304597,0,3,4
87250,1,1,304595,304597,304598,2,3,0
87251,1,3,304596,304598,304601,2,5,0
87252,5,1,304601,304601,304602,0,1,0
87253,2,3,304603,304603,304606,0,3,1
87254,5,2,304608,304608,304610,0,2,2
87255,6,2,304614,304614,304616,0,2,4
87256,4,3,304618,304618,304621,0,3,2
87257,1,2,304619,304621,304623,2,4,0
87258,3,1,304622,304623,304624,1,2,0
87259,1,3,304623,304624,304627,1,4,0
87260,2,2,304625,304627,304629,2,4,0
87261,2,2,304627,304629,304631,2,4,0
87262,5,3,304632,304632,304635,0,3,1
87263,3,3,304635,304635,304638,0,3,0
87264,6,3,304641,304641,304644,0,3,3
87265,1,3,304642,304644,304647,2,5,0
87266,6,2,304648,304648,304650,0,2,1
87267,2,3,304650,304650,304653,0,3,0
87268,2,1,304652,304653,304654,1,2,0
87269,2,2,304654,304654,304656,0,2,0
87270,5,3,304659,304659,304662,0,3,3
87271,3,3,304662,304662,304665,0,3,0
87272,1,1,304663,304665,304666,2,3,0
87273,2,2,304665,304666,304668,1,3,0
87274,1,3,304666,304668,304671,2,5,0
87275,2,2,304668,304671,304673,3,5,0
87276,6,1,304674,304674,304675,0,1,1
87277,2,2,304676,304676,304678,0,2,1
87278,1,3,304677,304678,304681,1,4,0
87279,2,2,304679,304681,304683,2,4,0
87280,6,3,304685,304685,304688,0,3,2
87281,1,1,304686,304688,304689,2,3,0
87282,3,3,304689,304689,304692,0,3,0
87283,5,1,304694,304694,304695,0,1,2
87284,1,3,304695,304695,304698,0,3,0
87285,5,1,304700,304700,304701,0,1,2
87286,2,3,304702,304702,304705,0,3,1
87287,2,1,304704,304705,304706,1,2,0
87288,4,3,304708,304708,304711,0,3,2
87289,3,1,304711,304711,304712,0,1,0
87290,3,3,304714,304714,304717,0,3,2
87291,5,3,304719,304719,304722,0,3,2
87292,1,3,304720,304722,304725,2,5,0
87293,1,1,304721,304725,304726,4,5,0
87294,4,2,304725,304726,304728,1,3,0
87295,4,3,304729,304729,304732,0,3,1
87296,2,2,304731,304732,304734,1,3,0
87297,2,3,304733,304734,304737,1,4,0
87298,1,2,304734,304737,304739,3,5,0
87299,4,2,304738,304739,304741,1,3,0
87300,2,3,304740,304741,304744,1,4,0
87301,1,3,304741,304744,304747,3,6,0
87302,3,1,304744,304747,304748,3,4,0
87303,6,1,304750,304750,304751,0,1,2
87304,1,1,304751,304751,304752,0,1,0
87305,5,2,304756,304756,304758,0,2,4
87306,4,1,304760,304760,304761,0,1,2
87307,4,1,304764,304764,304765,0,1,3
87308,3,3,304767,304767,304770,0,3,2
87309,5,3,304772,304772,304775,0,3,2
87310,6,2,304778,304778,304780,0,2,3
87311,4,2,304782,304782,304784,0,2,2
87312,5,3,304787,304787,304790,0,3,3
87313,1,3,304788,304790,304793,2,5,0
87314,1,1,304789,304793,304794,4,5,0
87315,4,3,304793,304794,304797,1,4,0
87316,6,1,304799,304799,304800,0,1,2
87317,1,2,304800,304800,304802,0,2,0
87318,3,2,304803,304803,304805,0,2,1
87319,2,3,304805,304805,304808,0,3,0
87320,3,2,304808,304808,304810,0,2,0
87321,3,2,304811,304811,304813,0,2,1
87322,3,1,304814,304814,304815,0,1,1
87323,6,2,304820,304820,304822,0,2,5
87324,6,3,304826,304826,304829,0,3,4
87325,3,2,304829,304829,304831,0,2,0
87326,2,2,304831,304831,304833,0,2,0
87327,2,2,304833,304833,304835,0,2,0
87328,5,2,304838,304838,304840,0,2,3
87329,2,2,304840,304840,304842,0,2,0
87330,3,2,304843,304843,304845,0,2,1
87331,2,3,304845,304845,304848,0,3,0
87332,5,2,304850,304850,304852,0,2,2
87333,6,1,304856,304856,304857,0,1,4
87334,4,1,304860,304860,304861,0,1,3
87335,1,2,304861,304861,304863,0,2,0
87336,5,1,304866,304866,304867,0,1,3
87337,4,3,304870,304870,304873,0,3,3
87338,3,1,304873,304873,304874,0,1,0
87339,6,1,304879,304879,304880,0,1,5
87340,4,2,304883,304883,304885,0,2,3
87341,1,1,304884,304885,304886,1,2,0
87342,6,2,304890,304890,304892,0,2,4
87343,4,2,304894,304894,304896,0,2,2
87344,4,1,304898,304898,304899,0,1,2
87345,2,1,304900,304900,304901,0,1,1
87346,2,3,304902,304902,304905,0,3,1
87347,1,2,304903,304905,304907,2,4,0
87348,5,3,304908,304908,304911,0,3,1
87349,2,1,304910,304911,304912,1,2,0
87350,6,3,304916,304916,304919,0,3,4
87351,6,3,304922,304922,304925,0,3,3
87352,6,1,304928,304928,304929,0,1,3
87353,6,1,304934,304934,304935,0,1,5
87354,5,1,304939,304939,304940,0,1,4
87355,4,3,304943,304943,304946,0,3,3
87356,1,1,304944,304946,304947,2,3,0
87357,5,3,304949,304949,304952,0,3,2
87358,4,1,304953,304953,304954,0,1,1
87359,2,3,304955,304955,304958,0,3,1
87360,5,1,304960,304960,304961,0,1,2
87361,1,3,304961,304961,304964,0,3,0
87362,6,2,304967,304967,304969,0,2,3
87363,2,1,304969,304969,304970,0,1,0
87364,4,3,304973,304973,304976,0,3,3
87365,2,3,304975,304976,304979,1,4,0
87366,5,3,304980,304980,304983,0,3,1
87367,4,1,304984,304984,304985,0,1,1
87368,3,1,304987,304987,304988,0,1,2
87369,6,3,304993,304993,304996,0,3,5
87370,6,3,304999,304999,305002,0,3,3
87371,5,2,305004,305004,305006,0,2,2
87372,2,3,305006,305006,305009,0,3,0
87373,3,1,305009,305009,305010,0,1,0
87374,2,1,305011,305011,305012,0,1,1
87375,3,1,305014,305014,305015,0,1,2
87376,5,2,305019,305019,305021,0,2,4
87377,3,1,305022,305022,305023,0,1,1
87378,1,3,305023,305023,305026,0,3,0
87379,1,2,305024,305026,305028,2,4,0
87380,2,2,305026,305028,305030,2,4,0
87381,6,3,305032,305032,305035,0,3,2
87382,4,1,305036,305036,305037,0,1,1
87383,2,2,305038,305038,305040,0,2,1
87384,6,2,305044,305044,305046,0,2,4
87385,2,3,305046,305046,305049,0,3,0
87386,4,3,305050,305050,305053,0,3,1
87387,3,2,305053,305053,305055,0,2,0
87388,2,1,305055,305055,305056,0,1,0
87389,1,2,305056,305056,305058,0,2,0
87390,1,1,305057,305058,305059,1,2,0
87391,2,1,305059,305059,305060,0,1,0
87392,5,1,305064,305064,305065,0,1,4
87393,1,3,305065,305065,305068,0,3,0
87394,2,2,305067,305068,305070,1,3,0
87395,5,3,305072,305072,305075,0,3,2
87396,2,3,305074,305075,305078,1,4,0
87397,2,3,305076,305078,305081,2,5,0
87398,5,2,305081,305081,305083,0,2,0
87399,3,1,305084,305084,305085,0,1,1
87400,6,1,305090,305090,305091,0,1,5
87401,5,1,305095,305095,305096,0,1,4
87402,3,3,305098,305098,305101,0,3,2
87403,3,3,305101,305101,305104,0,3,0
87404,5,1,305106,305106,305107,0,1,2
87405,6,1,305112,305112,305113,0,1,5
87406,6,2,305118,305118,305120,0,2,5
87407,5,2,305123,305123,305125,0,2,3
87408,3,2,305126,305126,305128,0,2,1
87409,5,1,305131,305131,305132,0,1,3
87410,5,3,305136,305136,305139,0,3,4
87411,3,1,305139,305139,305140,0,1,0
87412,4,3,305143,305143,305146,0,3,3
87413,3,3,305146,305146,305149,0,3,0
87414,1,2,305147,305149,305151,2,4,0
87415,5,3,305152,305152,305155,0,3,1
87416,6,3,305158,305158,305161,0,3,3
87417,3,1,305161,305161,305162,0,1,0
87418,1,1,305162,305162,305163,0,1,0
87419,2,2,305164,305164,305166,0,2,1
87420,4,1,305168,305168,305169,0,1,2
87421,5,3,305173,305173,305176,0,3,4
87422,6,2,305179,305179,305181,0,2,3
87423,1,1,305180,305181,305182,1,2,0
87424,4,3,305184,305184,305187,0,3,2
87425,5,1,305189,305189,305190,0,1,2
87426,6,1,305195,305195,305196,0,1,5
87427,5,2,305200,305200,305202,0,2,4
87428,6,1,305206,305206,305207,0,1,4
87429,4,1,305210,305210,305211,0,1,3
87430,1,3,305211,305211,305214,0,3,0
87431,3,2,305214,305214,305216,0,2,0
87432,6,2,305220,305220,305222,0,2,4
87433,3,2,305223,305223,305225,0,2,1
87434,5,2,305228,305228,305230,0,2,3
87435,5,1,305233,305233,305234,0,1,3
87436,4,1,305237,305237,305238,0,1,3
87437,5,3,305242,305242,305245,0,3,4
87438,6,2,305248,305248,305250,0,2,3
87439,2,1,305250,305250,305251,0,1,0
87440,5,3,305255,305255,305258,0,3,4
87441,4,2,305259,305259,305261,0,2,1
87442,3,3,305262,305262,305265,0,3,1
87443,5,1,305267,305267,305268,0,1,2
87444,3,1,305270,305270,305271,0,1,2
87445,4,3,305274,305274,305277,0,3,3
87446,4,3,305278,305278,305281,0,3,1
87447,2,2,305280,305281,305283,1,3,0
87448,3,3,305283,305283,305286,0,3,0
87449,4,1,305287,305287,305288,0,1,1
87450,2,3,305289,305289,305292,0,3,1
87451,3,1,305292,305292,305293,0,1,0
87452,2,3,305294,305294,305297,0,3,1
87453,3,2,305297,305297,305299,0,2,0
87454,3,2,305300,305300,305302,0,2,1
87455,1,1,305301,305302,305303,1,2,0
87456,1,1,305302,305303,305304,1,2,0
87457,4,3,305306,305306,305309,0,3,2
87458,6,1,305312,305312,305313,0,1,3
87459,4,1,305316,305316,305317,0,1,3
87460,2,1,305318,305318,305319,0,1,1
87461,5,3,305323,305323,305326,0,3,4
87462,6,1,305329,305329,305330,0,1,3
87463,6,3,305335,305335,305338,0,3,5
87464,1,3,305336,305338,305341,2,5,0
87465,2,3,305338,305341,305344,3,6,0
87466,5,3,305343,305344,305347,1,4,0
87467,2,1,305345,305347,305348,2,3,0
87468,4,3,305349,305349,305352,0,3,1
87469,6,2,305355,305355,305357,0,2,3
87470,2,3,305357,305357,305360,0,3,0
87471,3,3,305360,305360,305363,0,3,0
87472,1,3,305361,305363,305366,2,5,0
87473,1,1,305362,305366,305367,4,5,0
87474,6,2,305368,305368,305370,0,2,1
87475,6,3,305374,305374,305377,0,3,4
87476,1,3,305375,305377,305380,2,5,0
87477,6,3,305381,305381,305384,0,3,1
87478,1,3,305382,305384,305387,2,5,0
87479,3,3,305385,305387,305390,2,5,0
87480,2,1,305387,305390,305391,3,4,0
87481,4,3,305391,305391,305394,0,3,0
87482,6,2,305397,305397,305399,0,2,3
87483,4,2,305401,305401,305403,0,2,2
87484,2,2,305403,305403,305405,0,2,0
87485,5,2,305408,305408,305410,0,2,3
87486,6,3,305414,305414,305417,0,3,4
87487,5,2,305419,305419,305421,0,2,2
87488,2,2,305421,305421,305423,0,2,0
87489,4,3,305425,305425,305428,0,3,2
87490,3,3,305428,305428,305431,0,3,0
87491,1,2,305429,305431,305433,2,4,0
87492,6,3,305435,305435,305438,0,3,2
87493,3,2,305438,305438,305440,0,2,0
87494,6,1,305444,305444,305445,0,1,4
87495,5,3,305449,305449,305452,0,3,4
87496,2,2,305451,305452,305454,1,3,0
87497,6,3,305457,305457,305460,0,3,3
87498,1,2,305458,305460,305462,2,4,0
87499,6,2,305464,305464,305466,0,2,2
87500,5,2,305469,305469,305471,0,2,3
87501,4,2,305473,305473,305475,0,2,2
87502,5,2,305478,305478,305480,0,2,3
87503,2,2,305480,305480,305482,0,2,0
87504,4,3,305484,305484,305487,0,3,2
87505,2,1,305486,305487,305488,1,2,0
87506,6,3,305492,305492,305495,0,3,4
87507,5,3,305497,305497,305500,0,3,2
87508,6,1,305503,305503,305504,0,1,3
87509,3,2,305506,305506,305508,0,2,2
87510,4,2,305510,305510,305512,0,2,2
87511,4,3,305514,305514,305517,0,3,2
87512,3,1,305517,305517,305518,0,1,0
87513,2,2,305519,305519,305521,0,2,1
87514,3,3,305522,305522,305525,0,3,1
87515,6,2,305528,305528,305530,0,2,3
87516,1,3,305529,305530,305533,1,4,0
87517,3,1,305532,305533,305534,1,2,0
87518,2,3,305534,305534,305537,0,3,0
87519,2,2,305536,305537,305539,1,3,0
87520,1,2,305537,305539,305541,2,4,0
87521,5,1,305542,305542,305543,0,1,1
87522,5,2,305547,305547,305549,0,2,4
87523,6,2,305553,305553,305555,0,2,4
87524,4,1,305557,305557,305558,0,1,2
87525,4,3,305561,305561,305564,0,3,3
87526,4,1,305565,305565,305566,0,1,1
87527,1,3,305566,305566,305569,0,3,0
87528,6,3,305572,305572,305575,0,3,3
87529,1,3,305573,305575,305578,2,5,0
87530,6,3,305579,305579,305582,0,3,1
87531,4,3,305583,305583,305586,0,3,1
87532,6,2,305589,305589,305591,0,2,3
87533,4,2,305593,305593,305595,0,2,2
87534,1,2,305594,305595,305597,1,3,0
87535,1,1,305595,305597,305598,2,3,0
87536,6,2,305601,305601,305603,0,2,3
87537,5,1,305606,305606,305607,0,1,3
87538,3,1,305609,305609,305610,0,1,2
87539,6,3,305615,305615,305618,0,3,5
87540,6,3,305621,305621,305624,0,3,3
87541,6,1,305627,305627,305628,0,1,3
87542,3,2,305630,305630,305632,0,2,2
87543,5,3,305635,305635,305638,0,3,3
87544,6,1,305641,305641,305642,0,1,3
87545,4,1,305645,305645,305646,0,1,3
87546,6,3,305651,305651,305654,0,3,5
87547,4,2,305655,305655,305657,0,2,1
87548,1,3,305656,305657,305660,1,4,0
87549,6,2,305662,305662,305664,0,2,2
87550,4,3,305666,305666,305669,0,3,2
87551,5,1,305671,305671,305672,0,1,2
87552,6,2,305677,305677,305679,0,2,5
87553,1,3,305678,305679,305682,1,4,0
87554,6,3,305684,305684,305687,0,3,2
87555,1,1,305685,305687,305688,2,3,0
87556,2,2,305687,305688,305690,1,3,0
87557,6,2,305693,305693,305695,0,2,3
87558,5,1,305698,305698,305699,0,1,3
87559,5,1,305703,305703,305704,0,1,4
87560,5,1,305708,305708,305709,0,1,4
87561,2,1,305710,305710,305711,0,1,1
87562,6,2,305716,305716,305718,0,2,5
87563,1,1,305717,305718,305719,1,2,0
87564,2,1,305719,305719,305720,0,1,0
87565,3,3,305722,305722,305725,0,3,2
87566,1,2,305723,305725,305727,2,4,0
87567,5,3,305728,305728,305731,0,3,1
87568,1,1,305729,305731,305732,2,3,0
87569,5,2,305734,305734,305736,0,2,2
87570,4,3,305738,305738,305741,0,3,2
87571,5,1,305743,305743,305744,0,1,2
87572,6,3,305749,305749,305752,0,3,5
87573,6,3,305755,305755,305758,0,3,3
87574,1,3,305756,305758,305761,2,5,0
87575,3,2,305759,305761,305763,2,4,0
87576,2,2,305761,305763,305765,2,4,0
87577,1,1,305762,305765,305766,3,4,0
87578,4,3,305766,305766,305769,0,3,0
87579,1,1,305767,305769,305770,2,3,0
87580,5,3,305772,305772,305775,0,3,2
87581,3,2,305775,305775,305777,0,2,0
87582,2,3,305777,305777,305780,0,3,0
87583,4,3,305781,305781,305784,0,3,1
87584,6,3,305787,305787,305790,0,3,3
87585,4,3,305791,305791,305794,0,3,1
87586,3,1,305794,305794,305795,0,1,0
87587,2,2,305796,305796,305798,0,2,1
87588,1,1,305797,305798,305799,1,2,0
87589,1,2,305798,305799,305801,1,3,0
87590,4,2,305802,305802,305804,0,2,1
87591,3,3,305805,305805,305808,0,3,1
87592,5,2,305810,305810,305812,0,2,2
87593,1,2,305811,305812,305814,1,3,0
87594,5,3,305816,305816,305819,0,3,2
87595,3,3,305819,305819,305822,0,3,0
87596,1,2,305820,305822,305824,2,4,0
87597,6,2,305826,305826,305828,0,2,2
87598,6,2,305832,305832,305834,0,2,4
87599,2,3,305834,305834,305837,0,3,0
87600,3,2,305837,305837,305839,0,2,0
87601,1,1,305838,305839,305840,1,2,0
87602,5,1,305843,305843,305844,0,1,3
87603,5,3,305848,305848,305851,0,3,4
87604,1,3,305849,305851,305854,2,5,0
87605,6,3,305855,305855,305858,0,3,1
87606,2,1,305857,305858,305859,1,2,0
87607,4,3,305861,305861,305864,0,3,2
87608,3,3,305864,305864,305867,0,3,0
87609,5,2,305869,305869,305871,0,2,2
87610,1,3,305870,305871,305874,1,4,0
87611,2,1,305872,305874,305875,2,3,0
87612,4,2,305876,305876,305878,0,2,1
87613,2,2,305878,305878,305880,0,2,0
87614,3,3,305881,305881,305884,0,3,1
87615,3,3,305884,305884,305887,0,3,0
87616,3,3,305887,305887,305890,0,3,0
87617,3,3,305890,305890,305893,0,3,0
87618,5,1,305895,305895,305896,0,1,2
87619,5,1,305900,305900,305901,0,1,4
87620,4,3,305904,305904,305907,0,3,3
87621,6,2,305910,305910,305912,0,2,3
87622,2,1,305912,305912,305913,0,1,0
87623,3,2,305915,305915,305917,0,2,2
87624,5,1,305920,305920,305921,0,1,3
87625,3,3,305923,305923,305926,0,3,2
87626,3,1,305926,305926,305927,0,1,0
87627,3,2,305929,305929,305931,0,2,2
87628,2,2,305931,305931,305933,0,2,0
87629,3,1,305934,305934,305935,0,1,1
87630,3,3,305937,305937,305940,0,3,2
87631,1,2,305938,305940,305942,2,4,0
87632,1,2,305939,305942,305944,3,5,0
87633,1,1,305940,305944,305945,4,5,0
87634,6,3,305946,305946,305949,0,3,1
87635,1,1,305947,305949,305950,2,3,0
87636,1,2,305948,305950,305952,2,4,0
87637,3,2,305951,305952,305954,1,3,0
87638,6,3,305957,305957,305960,0,3,3
87639,3,3,305960,305960,305963,0,3,0
87640,5,1,305965,305965,305966,0,1,2
87641,4,3,305969,305969,305972,0,3,3
87642,2,3,305971,305972,305975,1,4,0
87643,3,1,305974,305975,305976,1,2,0
87644,5,3,305979,305979,305982,0,3,3
87645,3,2,305982,305982,305984,0,2,0
87646,4,3,305986,305986,305989,0,3,2
87647,3,3,305989,305989,305992,0,3,0
87648,6,2,305995,305995,305997,0,2,3
87649,2,2,305997,305997,305999,0,2,0
87650,6,3,306003,306003,306006,0,3,4
87651,5,3,306008,306008,306011,0,3,2
87652,6,2,306014,306014,306016,0,2,3
87653,6,2,306020,306020,306022,0,2,4
87654,4,3,306024,306024,306027,0,3,2
87655,6,2,306030,306030,306032,0,2,3
87656,4,2,306034,306034,306036,0,2,2
87657,2,1,306036,306036,306037,0,1,0
87658,4,1,306040,306040,306041,0,1,3
87659,6,1,306046,306046,306047,0,1,5
87660,5,3,306051,306051,306054,0,3,4
87661,1,3,306052,306054,306057,2,5,0
87662,3,2,306055,306057,306059,2,4,0
87663,5,2,306060,306060,306062,0,2,1
87664,3,2,306063,306063,306065,0,2,1
87665,6,2,306069,306069,306071,0,2,4
87666,5,2,306074,306074,306076,0,2,3
87667,4,1,306078,306078,306079,0,1,2
87668,4,3,306082,306082,306085,0,3,3
87669,2,2,306084,306085,306087,1,3,0
87670,5,1,306089,306089,306090,0,1,2
87671,1,2,306090,306090,306092,0,2,0
87672,4,3,306094,306094,306097,0,3,2
87673,1,1,306095,306097,306098,2,3,0
87674,4,1,306099,306099,306100,0,1,1
87675,6,2,306105,306105,306107,0,2,5
87676,6,1,306111,306111,306112,0,1,4
87677,1,1,306112,306112,306113,0,1,0
87678,4,1,306116,306116,306117,0,1,3
87679,3,2,306119,306119,306121,0,2,2
87680,3,1,306122,306122,306123,0,1,1
87681,5,3,306127,306127,306130,0,3,4
87682,4,3,306131,306131,306134,0,3,1
87683,1,2,306132,306134,306136,2,4,0
87684,5,2,306137,306137,306139,0,2,1
87685,2,3,306139,306139,306142,0,3,0
87686,6,3,306145,306145,306148,0,3,3
87687,4,3,306149,306149,306152,0,3,1
87688,2,3,306151,306152,306155,1,4,0
87689,3,2,306154,306155,306157,1,3,0
87690,6,2,306160,306160,306162,0,2,3
87691,4,2,306164,306164,306166,0,2,2
87692,2,3,306166,306166,306169,0,3,0
87693,5,2,306171,306171,306173,0,2,2
87694,2,3,306173,306173,306176,0,3,0
87695,6,3,306179,306179,306182,0,3,3
87696,2,3,306181,306182,306185,1,4,0
87697,3,2,306184,306185,306187,1,3,0
87698,4,3,306188,306188,306191,0,3,1
87699,6,2,306194,306194,306196,0,2,3
87700,5,2,306199,306199,306201,0,2,3
87701,2,3,306201,306201,306204,0,3,0
87702,6,3,306207,306207,306210,0,3,3
87703,2,2,306209,306210,306212,1,3,0
87704,5,1,306214,306214,306215,0,1,2
87705,6,1,306220,306220,306221,0,1,5
87706,5,1,306225,306225,306226,0,1,4
87707,1,3,306226,306226,306229,0,3,0
87708,1,3,306227,306229,306232,2,5,0
87709,4,3,306231,306232,306235,1,4,0
87710,1,2,306232,306235,306237,3,5,0
87711,6,1,306238,306238,306239,0,1,1
87712,2,1,306240,306240,306241,0,1,1
87713,6,3,306246,306246,306249,0,3,5
87714,5,1,306251,306251,306252,0,1,2
87715,1,1,306252,306252,306253,0,1,0
87716,4,2,306256,306256,306258,0,2,3
87717,1,3,306257,306258,306261,1,4,0
87718,6,2,306263,306263,306265,0,2,2
87719,1,1,306264,306265,306266,1,2,0
87720,3,3,306267,306267,306270,0,3,1
87721,1,1,306268,306270,306271,2,3,0
87722,4,2,306272,306272,306274,0,2,1
87723,5,3,306277,306277,306280,0,3,3
87724,6,1,306283,306283,306284,0,1,3
87725,1,2,306284,306284,306286,0,2,0
87726,6,2,306290,306290,306292,0,2,4
87727,5,3,306295,306295,306298,0,3,3
87728,5,3,306300,306300,306303,0,3,2
87729,6,3,306306,306306,306309,0,3,3
87730,1,1,306307,306309,306310,2,3,0
87731,6,3,306313,306313,306316,0,3,3
87732,4,1,306317,306317,306318,0,1,1
87733,1,1,306318,306318,306319,0,1,0
87734,1,3,306319,306319,306322,0,3,0
87735,1,2,306320,306322,306324,2,4,0
87736,1,2,306321,306324,306326,3,5,0
87737,6,1,306327,306327,306328,0,1,1
87738,4,1,306331,306331,306332,0,1,3
87739,6,1,306337,306337,306338,0,1,5
87740,6,1,306343,306343,306344,0,1,5
87741,3,2,306346,306346,306348,0,2,2
87742,4,3,306350,306350,306353,0,3,2
87743,1,1,306351,306353,306354,2,3,0
87744,2,2,306353,306354,306356,1,3,0
87745,5,1,306358,306358,306359,0,1,2
87746,2,3,306360,306360,306363,0,3,1
87747,2,2,306362,306363,306365,1,3,0
87748,3,2,306365,306365,306367,0,2,0
87749,6,3,306371,306371,306374,0,3,4
87750,4,2,306375,306375,306377,0,2,1
87751,1,2,306376,306377,306379,1,3,0
87752,2,2,306378,306379,306381,1,3,0
87753,1,2,306379,306381,306383,2,4,0
87754,3,2,306382,306383,306385,1,3,0
87755,2,2,306384,306385,306387,1,3,0
87756,5,2,306389,306389,306391,0,2,2
87757,4,1,306393,306393,306394,0,1,2
87758,6,3,306399,306399,306402,0,3,5
87759,2,2,306401,306402,306404,1,3,0
87760,4,2,306405,306405,306407,0,2,1
87761,3,3,306408,306408,306411,0,3,1
87762,6,3,306414,306414,306417,0,3,3
87763,3,2,306417,306417,306419,0,2,0
87764,6,3,306423,306423,306426,0,3,4
87765,2,1,306425,306426,306427,1,2,0
87766,3,1,306428,306428,306429,0,1,1
87767,1,2,306429,306429,306431,0,2,0
87768,1,2,306430,306431,306433,1,3,0
87769,4,2,306434,306434,306436,0,2,1
87770,1,1,306435,306436,306437,1,2,0
87771,1,3,306436,306437,306440,1,4,0
87772,2,3,306438,306440,306443,2,5,0
87773,3,3,306441,306443,306446,2,5,0
87774,2,2,306443,306446,306448,3,5,0
87775,4,2,306447,306448,306450,1,3,0
87776,1,3,306448,306450,306453,2,5,0
87777,2,3,306450,306453,306456,3,6,0
87778,5,2,306455,306456,306458,1,3,0
87779,4,1,306459,306459,306460,0,1,1
87780,5,3,306464,306464,306467,0,3,4
87781,3,2,306467,306467,306469,0,2,0
87782,3,2,306470,306470,306472,0,2,1
87783,2,1,306472,306472,306473,0,1,0
87784,3,2,306475,306475,306477,0,2,2
87785,3,2,306478,306478,306480,0,2,1
87786,5,1,306483,306483,306484,0,1,3
87787,1,3,306484,306484,306487,0,3,0
87788,1,3,306485,306487,306490,2,5,0
87789,3,1,306488,306490,306491,2,3,0
87790,2,1,306490,306491,306492,1,2,0
87791,1,2,306491,306492,306494,1,3,0
87792,6,1,306497,306497,306498,0,1,3
87793,1,2,306498,306498,306500,0,2,0
87794,2,2,306500,306500,306502,0,2,0
87795,6,1,306506,306506,306507,0,1,4
87796,4,3,306510,306510,306513,0,3,3
87797,4,1,306514,306514,306515,0,1,1
87798,1,3,306515,306515,306518,0,3,0
87799,3,3,306518,306518,306521,0,3,0
87800,3,3,306521,306521,306524,0,3,0
87801,1,3,306522,306524,306527,2,5,0
87802,2,2,306524,306527,306529,3,5,0
87803,3,3,306527,306529,306532,2,5,0
87804,2,3,306529,306532,306535,3,6,0
87805,1,1,306530,306535,306536,5,6,0
87806,6,1,306536,306536,306537,0,1,0
87807,1,3,306537,306537,306540,0,3,0
87808,3,1,306540,306540,306541,0,1,0
87809,3,1,306543,306543,306544,0,1,2
87810,1,1,306544,306544,306545,0,1,0
87811,3,2,306547,306547,306549,0,2,2
87812,4,1,306551,306551,306552,0,1,2
87813,2,2,306553,306553,306555,0,2,1
87814,4,2,306557,306557,306559,0,2,2
87815,6,1,306563,306563,306564,0,1,4
87816,4,2,306567,306567,306569,0,2,3
87817,3,1,306570,306570,306571,0,1,1
87818,5,2,306575,306575,306577,0,2,4
87819,3,1,306578,306578,306579,0,1,1
87820,3,3,306581,306581,306584,0,3,2
87821,3,3,306584,306584,306587,0,3,0
87822,3,1,306587,306587,306588,0,1,0
87823,6,2,306593,306593,306595,0,2,5
87824,5,3,306598,306598,306601,0,3,3
87825,6,3,306604,306604,306607,0,3,3
87826,3,3,306607,306607,306610,0,3,0
87827,3,3,306610,306610,306613,0,3,0
87828,3,2,306613,306613,306615,0,2,0
87829,4,2,306617,306617,306619,0,2,2
87830,6,2,306623,306623,306625,0,2,4
87831,5,2,306628,306628,306630,0,2,3
87832,6,2,306634,306634,306636,0,2,4
87833,6,3,306640,306640,306643,0,3,4
87834,4,3,306644,306644,306647,0,3,1
87835,6,3,306650,306650,306653,0,3,3
87836,4,1,306654,306654,306655,0,1,1
87837,2,3,306656,306656,306659,0,3,1
87838,4,3,306660,306660,306663,0,3,1
87839,2,2,306662,306663,306665,1,3,0
87840,4,3,306666,306666,306669,0,3,1
87841,4,3,306670,306670,306673,0,3,1
87842,1,1,306671,306673,306674,2,3,0
87843,1,2,306672,306674,306676,2,4,0
87844,1,2,306673,306676,306678,3,5,0
87845,2,1,306675,306678,306679,3,4,0
87846,5,2,306680,306680,306682,0,2,1
87847,6,1,306686,306686,306687,0,1,4
87848,3,2,306689,306689,306691,0,2,2
87849,6,3,306695,306695,306698,0,3,4
87850,5,3,306700,306700,306703,0,3,2
87851,1,3,306701,306703,306706,2,5,0
87852,6,3,306707,306707,306710,0,3,1
87853,2,2,306709,306710,306712,1,3,0
87854,5,2,306714,306714,306716,0,2,2
87855,3,3,306717,306717,306720,0,3,1
87856,3,2,306720,306720,306722,0,2,0
87857,2,2,306722,306722,306724,0,2,0
87858,2,1,306724,306724,306725,0,1,0
87859,2,1,306726,306726,306727,0,1,1
87860,6,2,306732,306732,306734,0,2,5
87861,6,3,306738,306738,306741,0,3,4
87862,6,1,306744,306744,306745,0,1,3
87863,1,2,306745,306745,306747,0,2,0
87864,1,2,306746,306747,306749,1,3,0
87865,4,1,306750,306750,306751,0,1,1
87866,1,1,306751,306751,306752,0,1,0
87867,3,1,306754,306754,306755,0,1,2
87868,6,3,306760,306760,306763,0,3,5
87869,4,2,306764,306764,306766,0,2,1
87870,2,3,306766,306766,306769,0,3,0
87871,6,3,306772,306772,306775,0,3,3
87872,4,3,306776,306776,306779,0,3,1
87873,6,1,306782,306782,306783,0,1,3
87874,6,3,306788,306788,306791,0,3,5
87875,2,2,306790,306791,306793,1,3,0
87876,1,2,306791,306793,306795,2,4,0
87877,2,1,306793,306795,306796,2,3,0
87878,3,3,306796,306796,306799,0,3,0
87879,4,3,306800,306800,306803,0,3,1
87880,6,2,306806,306806,306808,0,2,3
87881,1,3,306807,306808,306811,1,4,0
87882,6,3,306813,306813,306816,0,3,2
87883,5,3,306818,306818,306821,0,3,2
87884,1,3,306819,306821,306824,2,5,0
87885,5,2,306824,306824,306826,0,2,0
87886,4,1,306828,306828,306829,0,1,2
87887,4,1,306832,306832,306833,0,1,3
87888,1,3,306833,306833,306836,0,3,0
87889,6,2,306839,306839,306841,0,2,3
87890,1,3,306840,306841,306844,1,4,0
87891,4,1,306844,306844,306845,0,1,0
87892,3,2,306847,306847,306849,0,2,2
87893,2,1,306849,306849,306850,0,1,0
87894,1,2,306850,306850,306852,0,2,0
87895,1,1,306851,306852,306853,1,2,0
87896,1,3,306852,306853,306856,1,4,0
87897,1,1,306853,306856,306857,3,4,0
87898,6,1,306859,306859,306860,0,1,2
87899,2,3,306861,306861,306864,0,3,1
87900,6,1,306867,306867,306868,0,1,3
87901,3,1,306870,306870,306871,0,1,2
87902,4,2,306874,306874,306876,0,2,3
87903,3,3,306877,306877,306880,0,3,1
87904,5,3,306882,306882,306885,0,3,2
87905,3,3,306885,306885,306888,0,3,0
87906,4,3,306889,306889,306892,0,3,1
87907,2,2,306891,306892,306894,1,3,0
87908,6,1,306897,306897,306898,0,1,3
87909,6,1,306903,306903,306904,0,1,5
87910,6,1,306909,306909,306910,0,1,5
87911,1,3,306910,306910,306913,0,3,0
87912,1,2,306911,306913,306915,2,4,0
87913,1,2,306912,306915,306917,3,5,0
87914,4,2,306916,306917,306919,1,3,0
87915,2,3,306918,306919,306922,1,4,0
87916,5,3,306923,306923,306926,0,3,1
87917,6,3,306929,306929,306932,0,3,3
87918,3,2,306932,306932,306934,0,2,0
87919,6,1,306938,306938,306939,0,1,4
87920,5,2,306943,306943,306945,0,2,4
87921,1,3,306944,306945,306948,1,4,0
87922,3,1,306947,306948,306949,1,2,0
87923,4,1,306951,306951,306952,0,1,2
87924,4,3,306955,306955,306958,0,3,3
87925,1,3,306956,306958,306961,2,5,0
87926,4,1,306960,306961,306962,1,2,0
87927,6,3,306966,306966,306969,0,3,4
87928,1,2,306967,306969,306971,2,4,0
87929,1,1,306968,306971,306972,3,4,0
87930,6,2,306974,306974,306976,0,2,2
87931,6,1,306980,306980,306981,0,1,4
87932,4,2,306984,306984,306986,0,2,3
87933,1,3,306985,306986,306989,1,4,0
87934,4,3,306989,306989,306992,0,3,0
87935,6,1,306995,306995,306996,0,1,3
87936,6,2,307001,307001,307003,0,2,5
87937,6,2,307007,307007,307009,0,2,4
87938,3,1,307010,307010,307011,0,1,1
87939,3,1,307013,307013,307014,0,1,2
87940,2,1,307015,307015,307016,0,1,1
87941,3,2,307018,307018,307020,0,2,2
87942,4,2,307022,307022,307024,0,2,2
87943,1,1,307023,307024,307025,1,2,0
87944,1,1,307024,307025,307026,1,2,0
87945,5,3,307029,307029,307032,0,3,3
87946,1,1,307030,307032,307033,2,3,0
87947,4,3,307034,307034,307037,0,3,1
87948,3,2,307037,307037,307039,0,2,0
87949,6,1,307043,307043,307044,0,1,4
87950,1,2,307044,307044,307046,0,2,0
87951,4,2,307048,307048,307050,0,2,2
87952,4,3,307052,307052,307055,0,3,2
87953,5,3,307057,307057,307060,0,3,2
87954,3,1,307060,307060,307061,0,1,0
87955,1,1,307061,307061,307062,0,1,0
87956,2,2,307063,307063,307065,0,2,1
87957,2,1,307065,307065,307066,0,1,0
87958,1,1,307066,307066,307067,0,1,0
87959,1,2,307067,307067,307069,0,2,0
87960,6,2,307073,307073,307075,0,2,4
87961,4,1,307077,307077,307078,0,1,2
87962,1,2,307078,307078,307080,0,2,0
87963,2,1,307080,307080,307081,0,1,0
87964,4,2,307084,307084,307086,0,2,3
87965,1,2,307085,307086,307088,1,3,0
87966,6,2,307091,307091,307093,0,2,3
87967,3,2,307094,307094,307096,0,2,1
87968,1,2,307095,307096,307098,1,3,0
87969,2,2,307097,307098,307100,1,3,0
87970,5,2,307102,307102,307104,0,2,2
87971,4,2,307106,307106,307108,0,2,2
87972,1,1,307107,307108,307109,1,2,0
87973,3,1,307110,307110,307111,0,1,1
87974,6,2,307116,307116,307118,0,2,5
87975,5,1,307121,307121,307122,0,1,3
87976,2,1,307123,307123,307124,0,1,1
87977,3,2,307126,307126,307128,0,2,2
87978,1,3,307127,307128,307131,1,4,0
87979,3,3,307130,307131,307134,1,4,0
87980,3,2,307133,307134,307136,1,3,0
87981,4,3,307137,307137,307140,0,3,1
87982,2,3,307139,307140,307143,1,4,0
87983,1,3,307140,307143,307146,3,6,0
87984,2,1,307142,307146,307147,4,5,0
87985,6,3,307148,307148,307151,0,3,1
87986,3,1,307151,307151,307152,0,1,0
87987,5,3,307156,307156,307159,0,3,4
87988,2,3,307158,307159,307162,1,4,0
87989,6,1,307164,307164,307165,0,1,2
87990,1,2,307165,307165,307167,0,2,0
87991,2,2,307167,307167,307169,0,2,0
87992,2,1,307169,307169,307170,0,1,0
87993,4,1,307173,307173,307174,0,1,3
87994,3,2,307176,307176,307178,0,2,2
87995,3,2,307179,307179,307181,0,2,1
87996,5,3,307184,307184,307187,0,3,3
87997,3,2,307187,307187,307189,0,2,0
87998,4,3,307191,307191,307194,0,3,2
87999,5,2,307196,307196,307198,0,2,2
88000,3,3,307199,307199,307202,0,3,1
88001,5,1,307204,307204,307205,0,1,2
88002,2,2,307206,307206,307208,0,2,1
88003,5,1,307211,307211,307212,0,1,3
88004,4,2,307215,307215,307217,0,2,3
88005,1,1,307216,307217,307218,1,2,0
88006,4,3,307220,307220,307223,0,3,2
88007,5,3,307225,307225,307228,0,3,2
88008,2,1,307227,307228,307229,1,2,0
88009,6,1,307233,307233,307234,0,1,4
88010,6,2,307239,307239,307241,0,2,5
88011,3,1,307242,307242,307243,0,1,1
88012,5,3,307247,307247,307250,0,3,4
88013,4,3,307251,307251,307254,0,3,1
88014,3,1,307254,307254,307255,0,1,0
88015,5,3,307259,307259,307262,0,3,4
88016,5,2,307264,307264,307266,0,2,2
88017,2,3,307266,307266,307269,0,3,0
88018,4,2,307270,307270,307272,0,2,1
88019,3,3,307273,307273,307276,0,3,1
88020,6,3,307279,307279,307282,0,3,3
88021,5,2,307284,307284,307286,0,2,2
88022,3,2,307287,307287,307289,0,2,1
88023,5,1,307292,307292,307293,0,1,3
88024,5,1,307297,307297,307298,0,1,4
88025,6,2,307303,307303,307305,0,2,5
88026,2,1,307305,307305,307306,0,1,0
88027,3,2,307308,307308,307310,0,2,2
88028,5,1,307313,307313,307314,0,1,3
88029,3,2,307316,307316,307318,0,2,2
88030,6,2,307322,307322,307324,0,2,4
88031,6,2,307328,307328,307330,0,2,4
88032,2,1,307330,307330,307331,0,1,0
88033,6,2,307336,307336,307338,0,2,5
88034,3,3,307339,307339,307342,0,3,1
88035,1,1,307340,307342,307343,2,3,0
88036,5,3,307345,307345,307348,0,3,2
88037,2,3,307347,307348,307351,1,4,0
88038,6,3,307353,307353,307356,0,3,2
88039,1,2,307354,307356,307358,2,4,0
88040,1,3,307355,307358,307361,3,6,0
88041,2,2,307357,307361,307363,4,6,0
88042,3,3,307360,307363,307366,3,6,0
88043,1,2,307361,307366,307368,5,7,0
88044,6,1,307367,307368,307369,1,2,0
88045,6,3,307373,307373,307376,0,3,4
88046,1,2,307374,307376,307378,2,4,0
88047,1,3,307375,307378,307381,3,6,0
88048,4,1,307379,307381,307382,2,3,0
88049,2,3,307381,307382,307385,1,4,0
88050,1,2,307382,307385,307387,3,5,0
88051,6,3,307388,307388,307391,0,3,1
88052,5,1,307393,307393,307394,0,1,2
88053,5,3,307398,307398,307401,0,3,4
88054,1,3,307399,307401,307404,2,5,0
88055,1,2,307400,307404,307406,4,6,0
88056,6,1,307406,307406,307407,0,1,0
88057,3,1,307409,307409,307410,0,1,2
88058,1,3,307410,307410,307413,0,3,0
88059,6,3,307416,307416,307419,0,3,3
88060,1,2,307417,307419,307421,2,4,0
88061,5,1,307422,307422,307423,0,1,1
88062,1,2,307423,307423,307425,0,2,0
88063,2,3,307425,307425,307428,0,3,0
88064,5,2,307430,307430,307432,0,2,2
88065,4,3,307434,307434,307437,0,3,2
88066,6,1,307440,307440,307441,0,1,3
88067,3,2,307443,307443,307445,0,2,2
88068,2,2,307445,307445,307447,0,2,0
88069,5,2,307450,307450,307452,0,2,3
88070,5,2,307455,307455,307457,0,2,3
88071,3,2,307458,307458,307460,0,2,1
88072,1,3,307459,307460,307463,1,4,0
88073,2,3,307461,307463,307466,2,5,0
88074,3,3,307464,307466,307469,2,5,0
88075,3,2,307467,307469,307471,2,4,0
88076,5,1,307472,307472,307473,0,1,1
88077,1,1,307473,307473,307474,0,1,0
88078,3,1,307476,307476,307477,0,1,2
88079,1,3,307477,307477,307480,0,3,0
88080,1,2,307478,307480,307482,2,4,0
88081,5,2,307483,307483,307485,0,2,1
88082,6,3,307489,307489,307492,0,3,4
88083,6,1,307495,307495,307496,0,1,3
88084,3,2,307498,307498,307500,0,2,2
88085,3,3,307501,307501,307504,0,3,1
88086,1,3,307502,307504,307507,2,5,0
88087,2,2,307504,307507,307509,3,5,0
88088,1,1,307505,307509,307510,4,5,0
88089,5,2,307510,307510,307512,0,2,0
88090,3,3,307513,307513,307516,0,3,1
88091,3,3,307516,307516,307519,0,3,0
88092,3,2,307519,307519,307521,0,2,0
88093,6,3,307525,307525,307528,0,3,4
88094,6,1,307531,307531,307532,0,1,3
88095,3,2,307534,307534,307536,0,2,2
88096,1,3,307535,307536,307539,1,4,0
88097,3,2,307538,307539,307541,1,3,0
88098,3,3,307541,307541,307544,0,3,0
88099,4,1,307545,307545,307546,0,1,1
88100,6,2,307551,307551,307553,0,2,5
88101,5,3,307556,307556,307559,0,3,3
88102,1,1,307557,307559,307560,2,3,0
88103,1,1,307558,307560,307561,2,3,0
88104,4,2,307562,307562,307564,0,2,1
88105,2,2,307564,307564,307566,0,2,0
88106,2,1,307566,307566,307567,0,1,0
88107,3,2,307569,307569,307571,0,2,2
88108,1,1,307570,307571,307572,1,2,0
88109,5,3,307575,307575,307578,0,3,3
88110,5,1,307580,307580,307581,0,1,2
88111,6,3,307586,307586,307589,0,3,5
88112,6,2,307592,307592,307594,0,2,3
88113,1,3,307593,307594,307597,1,4,0
88114,1,3,307594,307597,307600,3,6,0
88115,5,3,307599,307600,307603,1,4,0
88116,1,1,307600,307603,307604,3,4,0
88117,5,2,307605,307605,307607,0,2,1
88118,6,3,307611,307611,307614,0,3,4
88119,3,1,307614,307614,307615,0,1,0
88120,4,1,307618,307618,307619,0,1,3
88121,2,2,307620,307620,307622,0,2,1
88122,3,2,307623,307623,307625,0,2,1
88123,6,1,307629,307629,307630,0,1,4
88124,3,2,307632,307632,307634,0,2,2
88125,5,3,307637,307637,307640,0,3,3
88126,2,3,307639,307640,307643,1,4,0
88127,2,3,307641,307643,307646,2,5,0
88128,2,2,307643,307646,307648,3,5,0
88129,2,2,307645,307648,307650,3,5,0
88130,1,2,307646,307650,307652,4,6,0
88131,3,3,307649,307652,307655,3,6,0
88132,5,1,307654,307655,307656,1,2,0
88133,1,2,307655,307656,307658,1,3,0
88134,6,3,307661,307661,307664,0,3,3
88135,1,1,307662,307664,307665,2,3,0
88136,3,3,307665,307665,307668,0,3,0
88137,5,2,307670,307670,307672,0,2,2
88138,3,2,307673,307673,307675,0,2,1
88139,2,2,307675,307675,307677,0,2,0
88140,2,1,307677,307677,307678,0,1,0
88141,6,2,307683,307683,307685,0,2,5
88142,1,1,307684,307685,307686,1,2,0
88143,5,1,307689,307689,307690,0,1,3
88144,4,3,307693,307693,307696,0,3,3
88145,2,1,307695,307696,307697,1,2,0
88146,6,3,307701,307701,307704,0,3,4
88147,6,3,307707,307707,307710,0,3,3
88148,3,2,307710,307710,307712,0,2,0
88149,2,3,307712,307712,307715,0,3,0
88150,2,2,307714,307715,307717,1,3,0
88151,4,2,307718,307718,307720,0,2,1
88152,6,2,307724,307724,307726,0,2,4
88153,6,1,307730,307730,307731,0,1,4
88154,1,1,307731,307731,307732,0,1,0
88155,5,1,307736,307736,307737,0,1,4
88156,3,3,307739,307739,307742,0,3,2
88157,6,2,307745,307745,307747,0,2,3
88158,2,3,307747,307747,307750,0,3,0
88159,4,1,307751,307751,307752,0,1,1
88160,4,1,307755,307755,307756,0,1,3
88161,4,2,307759,307759,307761,0,2,3
88162,5,1,307764,307764,307765,0,1,3
88163,2,3,307766,307766,307769,0,3,1
88164,2,3,307768,307769,307772,1,4,0
88165,2,2,307770,307772,307774,2,4,0
88166,2,2,307772,307774,307776,2,4,0
88167,1,2,307773,307776,307778,3,5,0
88168,2,2,307775,307778,307780,3,5,0
88169,4,2,307779,307780,307782,1,3,0
88170,3,3,307782,307782,307785,0,3,0
88171,1,3,307783,307785,307788,2,5,0
88172,4,2,307787,307788,307790,1,3,0
88173,5,2,307792,307792,307794,0,2,2
88174,3,3,307795,307795,307798,0,3,1
88175,5,1,307800,307800,307801,0,1,2
88176,3,3,307803,307803,307806,0,3,2
88177,5,1,307808,307808,307809,0,1,2
88178,2,1,307810,307810,307811,0,1,1
88179,6,3,307816,307816,307819,0,3,5
88180,4,3,307820,307820,307823,0,3,1
88181,2,2,307822,307823,307825,1,3,0
88182,3,1,307825,307825,307826,0,1,0
88183,1,3,307826,307826,307829,0,3,0
88184,1,3,307827,307829,307832,2,5,0
88185,3,1,307830,307832,307833,2,3,0
88186,5,3,307835,307835,307838,0,3,2
88187,4,2,307839,307839,307841,0,2,1
88188,2,3,307841,307841,307844,0,3,0
88189,2,1,307843,307844,307845,1,2,0
88190,6,1,307849,307849,307850,0,1,4
88191,3,3,307852,307852,307855,0,3,2
88192,1,3,307853,307855,307858,2,5,0
88193,6,2,307859,307859,307861,0,2,1
88194,1,1,307860,307861,307862,1,2,0
88195,5,1,307865,307865,307866,0,1,3
88196,4,2,307869,307869,307871,0,2,3
88197,1,2,307870,307871,307873,1,3,0
88198,1,2,307871,307873,307875,2,4,0
88199,2,1,307873,307875,307876,2,3,0
88200,5,2,307878,307878,307880,0,2,2
88201,3,1,307881,307881,307882,0,1,1
88202,3,2,307884,307884,307886,0,2,2
88203,6,1,307890,307890,307891,0,1,4
88204,6,2,307896,307896,307898,0,2,5
88205,1,2,307897,307898,307900,1,3,0
88206,2,1,307899,307900,307901,1,2,0
88207,4,2,307903,307903,307905,0,2,2
88208,2,2,307905,307905,307907,0,2,0
88209,2,2,307907,307907,307909,0,2,0
88210,1,1,307908,307909,307910,1,2,0
88211,1,2,307909,307910,307912,1,3,0
88212,4,2,307913,307913,307915,0,2,1
88213,1,3,307914,307915,307918,1,4,0
88214,4,3,307918,307918,307921,0,3,0
88215,5,1,307923,307923,307924,0,1,2
88216,1,1,307924,307924,307925,0,1,0
88217,4,3,307928,307928,307931,0,3,3
88218,3,1,307931,307931,307932,0,1,0
88219,6,1,307937,307937,307938,0,1,5
88220,1,1,307938,307938,307939,0,1,0
88221,5,1,307943,307943,307944,0,1,4
88222,3,3,307946,307946,307949,0,3,2
88223,3,3,307949,307949,307952,0,3,0
88224,5,3,307954,307954,307957,0,3,2
88225,3,2,307957,307957,307959,0,2,0
88226,1,3,307958,307959,307962,1,4,0
88227,4,3,307962,307962,307965,0,3,0
88228,3,2,307965,307965,307967,0,2,0
88229,2,2,307967,307967,307969,0,2,0
88230,4,1,307971,307971,307972,0,1,2
88231,1,1,307972,307972,307973,0,1,0
88232,5,1,307977,307977,307978,0,1,4
88233,2,2,307979,307979,307981,0,2,1
88234,4,3,307983,307983,307986,0,3,2
88235,6,1,307989,307989,307990,0,1,3
88236,2,2,307991,307991,307993,0,2,1
88237,5,1,307996,307996,307997,0,1,3
88238,3,1,307999,307999,308000,0,1,2
88239,3,2,308002,308002,308004,0,2,2
88240,4,1,308006,308006,308007,0,1,2
88241,1,2,308007,308007,308009,0,2,0
88242,5,3,308012,308012,308015,0,3,3
88243,3,3,308015,308015,308018,0,3,0
88244,4,1,308019,308019,308020,0,1,1
88245,5,1,308024,308024,308025,0,1,4
88246,2,2,308026,308026,308028,0,2,1
88247,3,2,308029,308029,308031,0,2,1
88248,1,3,308030,308031,308034,1,4,0
88249,2,1,308032,308034,308035,2,3,0
88250,2,3,308034,308035,308038,1,4,0
88251,3,3,308037,308038,308041,1,4,0
88252,6,1,308043,308043,308044,0,1,2
88253,3,1,308046,308046,308047,0,1,2
88254,4,2,308050,308050,308052,0,2,3
88255,2,1,308052,308052,308053,0,1,0
88256,5,1,308057,308057,308058,0,1,4
88257,1,1,308058,308058,308059,0,1,0
88258,1,2,308059,308059,308061,0,2,0
88259,5,3,308064,308064,308067,0,3,3
88260,6,1,308070,308070,308071,0,1,3
88261,5,2,308075,308075,308077,0,2,4
88262,5,1,308080,308080,308081,0,1,3
88263,1,2,308081,308081,308083,0,2,0
88264,2,2,308083,308083,308085,0,2,0
88265,1,1,308084,308085,308086,1,2,0
88266,4,2,308088,308088,308090,0,2,2
88267,4,1,308092,308092,308093,0,1,2
88268,5,3,308097,308097,308100,0,3,4
88269,4,2,308101,308101,308103,0,2,1
88270,2,2,308103,308103,308105,0,2,0
88271,1,3,308104,308105,308108,1,4,0
88272,3,1,308107,308108,308109,1,2,0
88273,4,3,308111,308111,308114,0,3,2
88274,1,3,308112,308114,308117,2,5,0
88275,5,2,308117,308117,308119,0,2,0
88276,6,2,308123,308123,308125,0,2,4
88277,5,3,308128,308128,308131,0,3,3
88278,2,1,308130,308131,308132,1,2,0
88279,1,1,308131,308132,308133,1,2,0
88280,2,1,308133,308133,308134,0,1,0
88281,1,3,308134,308134,308137,0,3,0
88282,4,3,308138,308138,308141,0,3,1
88283,6,3,308144,308144,308147,0,3,3
88284,6,2,308150,308150,308152,0,2,3
88285,2,2,308152,308152,308154,0,2,0
88286,3,1,308155,308155,308156,0,1,1
88287,5,2,308160,308160,308162,0,2,4
88288,2,1,308162,308162,308163,0,1,0
88289,5,3,308167,308167,308170,0,3,4
88290,4,3,308171,308171,308174,0,3,1
88291,4,2,308175,308175,308177,0,2,1
88292,4,3,308179,308179,308182,0,3,2
88293,3,1,308182,308182,308183,0,1,0
88294,3,1,308185,308185,308186,0,1,2
88295,3,2,308188,308188,308190,0,2,2
88296,1,3,308189,308190,308193,1,4,0
88297,2,2,308191,308193,308195,2,4,0
88298,5,3,308196,308196,308199,0,3,1
88299,1,3,308197,308199,308202,2,5,0
88300,2,1,308199,308202,308203,3,4,0
88301,6,1,308205,308205,308206,0,1,2
88302,3,2,308208,308208,308210,0,2,2
88303,1,2,308209,308210,308212,1,3,0
88304,2,3,308211,308212,308215,1,4,0
88305,1,1,308212,308215,308216,3,4,0
88306,5,1,308217,308217,308218,0,1,1
88307,4,3,308221,308221,308224,0,3,3
88308,5,2,308226,308226,308228,0,2,2
88309,4,1,308230,308230,308231,0,1,2
88310,2,1,308232,308232,308233,0,1,1
88311,5,1,308237,308237,308238,0,1,4
88312,2,2,308239,308239,308241,0,2,1
88313,5,1,308244,308244,308245,0,1,3
88314,1,2,308245,308245,308247,0,2,0
88315,5,2,308250,308250,308252,0,2,3
88316,6,3,308256,308256,308259,0,3,4
88317,1,2,308257,308259,308261,2,4,0
88318,5,2,308262,308262,308264,0,2,1
88319,2,3,308264,308264,308267,0,3,0
88320,2,3,308266,308267,308270,1,4,0
88321,2,1,308268,308270,308271,2,3,0
88322,4,1,308272,308272,308273,0,1,1
88323,5,2,308277,308277,308279,0,2,4
88324,6,1,308283,308283,308284,0,1,4
88325,2,1,308285,308285,308286,0,1,1
88326,6,3,308291,308291,308294,0,3,5
88327,4,2,308295,308295,308297,0,2,1
88328,4,3,308299,308299,308302,0,3,2
88329,5,2,308304,308304,308306,0,2,2
88330,2,2,308306,308306,308308,0,2,0
88331,1,3,308307,308308,308311,1,4,0
88332,4,3,308311,308311,308314,0,3,0
88333,3,3,308314,308314,308317,0,3,0
88334,5,2,308319,308319,308321,0,2,2
88335,6,2,308325,308325,308327,0,2,4
88336,5,3,308330,308330,308333,0,3,3
88337,6,2,308336,308336,308338,0,2,3
88338,5,2,308341,308341,308343,0,2,3
88339,1,1,308342,308343,308344,1,2,0
88340,3,3,308345,308345,308348,0,3,1
88341,2,2,308347,308348,308350,1,3,0
88342,6,1,308353,308353,308354,0,1,3
88343,3,3,308356,308356,308359,0,3,2
88344,3,3,308359,308359,308362,0,3,0
88345,3,1,308362,308362,308363,0,1,0
88346,6,1,308368,308368,308369,0,1,5
88347,2,1,308370,308370,308371,0,1,1
88348,3,3,308373,308373,308376,0,3,2
88349,6,3,308379,308379,308382,0,3,3
88350,1,1,308380,308382,308383,2,3,0
88351,3,2,308383,308383,308385,0,2,0
88352,5,2,308388,308388,308390,0,2,3
88353,4,2,308392,308392,308394,0,2,2
88354,4,1,308396,308396,308397,0,1,2
88355,6,2,308402,308402,308404,0,2,5
88356,1,2,308403,308404,308406,1,3,0
88357,6,3,308409,308409,308412,0,3,3
88358,3,3,308412,308412,308415,0,3,0
88359,2,3,308414,308415,308418,1,4,0
88360,3,3,308417,308418,308421,1,4,0
88361,2,1,308419,308421,308422,2,3,0
88362,6,3,308425,308425,308428,0,3,3
88363,1,1,308426,308428,308429,2,3,0
88364,2,2,308428,308429,308431,1,3,0
88365,6,3,308434,308434,308437,0,3,3
88366,1,2,308435,308437,308439,2,4,0
88367,1,3,308436,308439,308442,3,6,0
88368,6,3,308442,308442,308445,0,3,0
88369,5,1,308447,308447,308448,0,1,2
88370,1,3,308448,308448,308451,0,3,0
88371,3,2,308451,308451,308453,0,2,0
88372,6,1,308457,308457,308458,0,1,4
88373,3,1,308460,308460,308461,0,1,2
88374,4,1,308464,308464,308465,0,1,3
88375,2,3,308466,308466,308469,0,3,1
88376,3,2,308469,308469,308471,0,2,0
88377,3,3,308472,308472,308475,0,3,1
88378,1,1,308473,308475,308476,2,3,0
88379,6,1,308479,308479,308480,0,1,3
88380,4,1,308483,308483,308484,0,1,3
88381,6,2,308489,308489,308491,0,2,5
88382,4,1,308493,308493,308494,0,1,2
88383,4,2,308497,308497,308499,0,2,3
88384,1,3,308498,308499,308502,1,4,0
88385,5,2,308503,308503,308505,0,2,1
88386,1,3,308504,308505,308508,1,4,0
88387,5,2,308509,308509,308511,0,2,1
88388,1,2,308510,308511,308513,1,3,0
88389,3,3,308513,308513,308516,0,3,0
88390,4,2,308517,308517,308519,0,2,1
88391,5,2,308522,308522,308524,0,2,3
88392,5,2,308527,308527,308529,0,2,3
88393,6,2,308533,308533,308535,0,2,4
88394,1,1,308534,308535,308536,1,2,0
88395,5,2,308539,308539,308541,0,2,3
88396,6,2,308545,308545,308547,0,2,4
88397,5,3,308550,308550,308553,0,3,3
88398,5,1,308555,308555,308556,0,1,2
88399,4,2,308559,308559,308561,0,2,3
88400,3,3,308562,308562,308565,0,3,1
88401,4,3,308566,308566,308569,0,3,1
88402,2,1,308568,308569,308570,1,2,0
88403,5,1,308573,308573,308574,0,1,3
88404,5,2,308578,308578,308580,0,2,4
88405,3,2,308581,308581,308583,0,2,1
88406,1,1,308582,308583,308584,1,2,0
88407,3,3,308585,308585,308588,0,3,1
88408,6,3,308591,308591,308594,0,3,3
88409,6,2,308597,308597,308599,0,2,3
88410,5,1,308602,308602,308603,0,1,3
88411,4,1,308606,308606,308607,0,1,3
88412,6,1,308612,308612,308613,0,1,5
88413,3,1,308615,308615,308616,0,1,2
88414,3,1,308618,308618,308619,0,1,2
88415,5,1,308623,308623,308624,0,1,4
88416,3,3,308626,308626,308629,0,3,2
88417,6,3,308632,308632,308635,0,3,3
88418,3,3,308635,308635,308638,0,3,0
88419,6,1,308641,308641,308642,0,1,3
88420,6,2,308647,308647,308649,0,2,5
88421,2,1,308649,308649,308650,0,1,0
88422,1,2,308650,308650,308652,0,2,0
88423,6,1,308656,308656,308657,0,1,4
88424,1,2,308657,308657,308659,0,2,0
88425,1,1,308658,308659,308660,1,2,0
88426,5,2,308663,308663,308665,0,2,3
88427,1,2,308664,308665,308667,1,3,0
88428,2,3,308666,308667,308670,1,4,0
88429,3,3,308669,308670,308673,1,4,0
88430,2,2,308671,308673,308675,2,4,0
88431,1,1,308672,308675,308676,3,4,0
88432,6,1,308678,308678,308679,0,1,2
88433,1,3,308679,308679,308682,0,3,0
88434,1,3,308680,308682,308685,2,5,0
88435,3,3,308683,308685,308688,2,5,0
88436,2,2,308685,308688,308690,3,5,0
88437,6,3,308691,308691,308694,0,3,1
88438,3,3,308694,308694,308697,0,3,0
88439,2,3,308696,308697,308700,1,4,0
88440,3,2,308699,308700,308702,1,3,0
88441,4,1,308703,308703,308704,0,1,1
88442,1,2,308704,308704,308706,0,2,0
88443,1,1,308705,308706,308707,1,2,0
88444,4,1,308709,308709,308710,0,1,2
88445,6,1,308715,308715,308716,0,1,5
88446,5,2,308720,308720,308722,0,2,4
88447,1,3,308721,308722,308725,1,4,0
88448,3,1,308724,308725,308726,1,2,0
88449,2,3,308726,308726,308729,0,3,0
88450,4,3,308730,308730,308733,0,3,1
88451,5,1,308735,308735,308736,0,1,2
88452,6,2,308741,308741,308743,0,2,5
88453,1,1,308742,308743,308744,1,2,0
88454,1,1,308743,308744,308745,1,2,0
88455,1,2,308744,308745,308747,1,3,0
88456,4,3,308748,308748,308751,0,3,1
88457,2,2,308750,308751,308753,1,3,0
88458,6,2,308756,308756,308758,0,2,3
88459,1,2,308757,308758,308760,1,3,0
88460,6,2,308763,308763,308765,0,2,3
88461,1,3,308764,308765,308768,1,4,0
88462,2,3,308766,308768,308771,2,5,0
88463,6,3,308772,308772,308775,0,3,1
88464,1,2,308773,308775,308777,2,4,0
88465,2,2,308775,308777,308779,2,4,0
88466,3,3,308778,308779,308782,1,4,0
88467,6,3,308784,308784,308787,0,3,2
88468,1,3,308785,308787,308790,2,5,0
88469,5,1,308790,308790,308791,0,1,0
88470,2,2,308792,308792,308794,0,2,1
88471,5,1,308797,308797,308798,0,1,3
88472,5,3,308802,308802,308805,0,3,4
88473,3,1,308805,308805,308806,0,1,0
88474,3,3,308808,308808,308811,0,3,2
88475,5,2,308813,308813,308815,0,2,2
88476,2,3,308815,308815,308818,0,3,0
88477,2,2,308817,308818,308820,1,3,0
88478,4,2,308821,308821,308823,0,2,1
88479,5,1,308826,308826,308827,0,1,3
88480,1,1,308827,308827,308828,0,1,0
88481,5,2,308832,308832,308834,0,2,4
88482,5,2,308837,308837,308839,0,2,3
88483,4,1,308841,308841,308842,0,1,2
88484,2,2,308843,308843,308845,0,2,1
88485,3,2,308846,308846,308848,0,2,1
88486,2,1,308848,308848,308849,0,1,0
88487,1,3,308849,308849,308852,0,3,0
88488,4,3,308853,308853,308856,0,3,1
88489,1,1,308854,308856,308857,2,3,0
88490,2,1,308856,308857,308858,1,2,0
88491,4,1,308860,308860,308861,0,1,2
88492,1,2,308861,308861,308863,0,2,0
88493,5,3,308866,308866,308869,0,3,3
88494,4,1,308870,308870,308871,0,1,1
88495,2,3,308872,308872,308875,0,3,1
88496,6,1,308878,308878,308879,0,1,3
88497,5,1,308883,308883,308884,0,1,4
88498,4,3,308887,308887,308890,0,3,3
88499,5,2,308892,308892,308894,0,2,2
88500,3,3,308895,308895,308898,0,3,1
88501,5,2,308900,308900,308902,0,2,2
88502,4,2,308904,308904,308906,0,2,2
88503,3,2,308907,308907,308909,0,2,1
88504,5,3,308912,308912,308915,0,3,3
88505,1,2,308913,308915,308917,2,4,0
88506,5,3,308918,308918,308921,0,3,1
88507,1,1,308919,308921,308922,2,3,0
88508,5,2,308924,308924,308926,0,2,2
88509,4,2,308928,308928,308930,0,2,2
88510,6,2,308934,308934,308936,0,2,4
88511,2,1,308936,308936,308937,0,1,0
88512,2,3,308938,308938,308941,0,3,1
88513,4,1,308942,308942,308943,0,1,1
88514,3,2,308945,308945,308947,0,2,2
88515,3,1,308948,308948,308949,0,1,1
88516,5,3,308953,308953,308956,0,3,4
88517,2,1,308955,308956,308957,1,2,0
88518,1,3,308956,308957,308960,1,4,0
88519,4,1,308960,308960,308961,0,1,0
88520,4,3,308964,308964,308967,0,3,3
88521,4,2,308968,308968,308970,0,2,1
88522,3,2,308971,308971,308973,0,2,1
88523,5,3,308976,308976,308979,0,3,3
88524,6,3,308982,308982,308985,0,3,3
88525,6,3,308988,308988,308991,0,3,3
88526,3,2,308991,308991,308993,0,2,0
88527,3,2,308994,308994,308996,0,2,1
88528,5,3,308999,308999,309002,0,3,3
88529,4,1,309003,309003,309004,0,1,1
88530,4,1,309007,309007,309008,0,1,3
88531,5,3,309012,309012,309015,0,3,4
88532,3,1,309015,309015,309016,0,1,0
88533,2,2,309017,309017,309019,0,2,1
88534,6,1,309023,309023,309024,0,1,4
88535,5,1,309028,309028,309029,0,1,4
88536,2,1,309030,309030,309031,0,1,1
88537,6,3,309036,309036,309039,0,3,5
88538,5,3,309041,309041,309044,0,3,2
88539,5,2,309046,309046,309048,0,2,2
88540,1,3,309047,309048,309051,1,4,0
88541,2,1,309049,309051,309052,2,3,0
88542,1,1,309050,309052,309053,2,3,0
88543,5,2,309055,309055,309057,0,2,2
88544,5,2,309060,309060,309062,0,2,3
88545,6,3,309066,309066,309069,0,3,4
88546,3,3,309069,309069,309072,0,3,0
88547,2,3,309071,309072,309075,1,4,0
88548,6,3,309077,309077,309080,0,3,2
88549,5,1,309082,309082,309083,0,1,2
88550,4,2,309086,309086,309088,0,2,3
88551,5,2,309091,309091,309093,0,2,3
88552,4,2,309095,309095,309097,0,2,2
88553,2,2,309097,309097,309099,0,2,0
88554,3,1,309100,309100,309101,0,1,1
88555,6,2,309106,309106,309108,0,2,5
88556,2,1,309108,309108,309109,0,1,0
88557,6,2,309114,309114,309116,0,2,5
88558,3,2,309117,309117,309119,0,2,1
88559,6,1,309123,309123,309124,0,1,4
88560,6,3,309129,309129,309132,0,3,5
88561,2,1,309131,309132,309133,1,2,0
88562,5,3,309136,309136,309139,0,3,3
88563,2,3,309138,309139,309142,1,4,0
88564,4,2,309142,309142,309144,0,2,0
88565,1,2,309143,309144,309146,1,3,0
88566,5,3,309148,309148,309151,0,3,2
88567,2,3,309150,309151,309154,1,4,0
88568,6,3,309156,309156,309159,0,3,2
88569,5,1,309161,309161,309162,0,1,2
88570,5,3,309166,309166,309169,0,3,4
88571,1,1,309167,309169,309170,2,3,0
88572,4,2,309171,309171,309173,0,2,1
88573,3,2,309174,309174,309176,0,2,1
88574,3,2,309177,309177,309179,0,2,1
88575,2,3,309179,309179,309182,0,3,0
88576,1,2,309180,309182,309184,2,4,0
88577,3,2,309183,309184,309186,1,3,0
88578,1,1,309184,309186,309187,2,3,0
88579,4,3,309188,309188,309191,0,3,1
88580,4,2,309192,309192,309194,0,2,1
88581,1,1,309193,309194,309195,1,2,0
88582,4,1,309197,309197,309198,0,1,2
88583,5,1,309202,309202,309203,0,1,4
88584,4,1,309206,309206,309207,0,1,3
88585,2,3,309208,309208,309211,0,3,1
88586,2,3,309210,309211,309214,1,4,0
88587,4,2,309214,309214,309216,0,2,0
88588,2,3,309216,309216,309219,0,3,0
88589,4,2,309220,309220,309222,0,2,1
88590,5,2,309225,309225,309227,0,2,3
88591,2,2,309227,309227,309229,0,2,0
88592,2,2,309229,309229,309231,0,2,0
88593,1,1,309230,309231,309232,1,2,0
88594,3,1,309233,309233,309234,0,1,1
88595,5,3,309238,309238,309241,0,3,4
88596,5,1,309243,309243,309244,0,1,2
88597,5,2,309248,309248,309250,0,2,4
88598,4,3,309252,309252,309255,0,3,2
88599,3,1,309255,309255,309256,0,1,0
88600,5,3,309260,309260,309263,0,3,4
88601,6,1,309266,309266,309267,0,1,3
88602,5,3,309271,309271,309274,0,3,4
88603,6,3,309277,309277,309280,0,3,3
88604,1,3,309278,309280,309283,2,5,0
88605,3,3,309281,309283,309286,2,5,0
88606,3,2,309284,309286,309288,2,4,0
88607,4,2,309288,309288,309290,0,2,0
88608,3,3,309291,309291,309294,0,3,1
88609,5,2,309296,309296,309298,0,2,2
88610,4,1,309300,309300,309301,0,1,2
88611,2,3,309302,309302,309305,0,3,1
88612,3,3,309305,309305,309308,0,3,0
88613,6,2,309311,309311,309313,0,2,3
88614,1,2,309312,309313,309315,1,3,0
88615,6,2,309318,309318,309320,0,2,3
88616,2,2,309320,309320,309322,0,2,0
88617,3,3,309323,309323,309326,0,3,1
88618,3,2,309326,309326,309328,0,2,0
88619,6,1,309332,309332,309333,0,1,4
88620,6,1,309338,309338,309339,0,1,5
88621,5,2,309343,309343,309345,0,2,4
88622,2,3,309345,309345,309348,0,3,0
88623,4,3,309349,309349,309352,0,3,1
88624,4,2,309353,309353,309355,0,2,1
88625,6,3,309359,309359,309362,0,3,4
88626,4,1,309363,309363,309364,0,1,1
88627,4,2,309367,309367,309369,0,2,3
88628,5,1,309372,309372,309373,0,1,3
88629,5,1,309377,309377,309378,0,1,4
88630,1,2,309378,309378,309380,0,2,0
88631,1,1,309379,309380,309381,1,2,0
88632,4,3,309383,309383,309386,0,3,2
88633,4,3,309387,309387,309390,0,3,1
88634,3,1,309390,309390,309391,0,1,0
88635,3,3,309393,309393,309396,0,3,2
88636,4,1,309397,309397,309398,0,1,1
88637,6,3,309403,309403,309406,0,3,5
88638,5,3,309408,309408,309411,0,3,2
88639,1,3,309409,309411,309414,2,5,0
88640,1,2,309410,309414,309416,4,6,0
88641,1,3,309411,309416,309419,5,8,0
88642,1,2,309412,309419,309421,7,9,0
88643,2,1,309414,309421,309422,7,8,0
88644,3,3,309417,309422,309425,5,8,0
88645,1,2,309418,309425,309427,7,9,0
88646,3,2,309421,309427,309429,6,8,0
88647,2,2,309423,309429,309431,6,8,0
88648,3,1,309426,309431,309432,5,6,0
88649,4,3,309430,309432,309435,2,5,0
88650,6,2,309436,309436,309438,0,2,1
88651,1,1,309437,309438,309439,1,2,0
88652,4,1,309441,309441,309442,0,1,2
88653,6,3,309447,309447,309450,0,3,5
88654,1,1,309448,309450,309451,2,3,0
88655,6,2,309454,309454,309456,0,2,3
88656,1,2,309455,309456,309458,1,3,0
88657,2,3,309457,309458,309461,1,4,0
88658,3,1,309460,309461,309462,1,2,0
88659,5,3,309465,309465,309468,0,3,3
88660,3,2,309468,309468,309470,0,2,0
88661,3,2,309471,309471,309473,0,2,1
88662,6,1,309477,309477,309478,0,1,4
88663,3,2,309480,309480,309482,0,2,2
88664,2,2,309482,309482,309484,0,2,0
88665,6,2,309488,309488,309490,0,2,4
88666,4,1,309492,309492,309493,0,1,2
88667,1,3,309493,309493,309496,0,3,0
88668,2,2,309495,309496,309498,1,3,0
88669,6,3,309501,309501,309504,0,3,3
88670,6,1,309507,309507,309508,0,1,3
88671,1,1,309508,309508,309509,0,1,0
88672,5,3,309513,309513,309516,0,3,4
88673,3,2,309516,309516,309518,0,2,0
88674,3,2,309519,309519,309521,0,2,1
88675,4,1,309523,309523,309524,0,1,2
88676,1,1,309524,309524,309525,0,1,0
88677,6,3,309530,309530,309533,0,3,5
88678,3,3,309533,309533,309536,0,3,0
88679,6,1,309539,309539,309540,0,1,3
88680,2,2,309541,309541,309543,0,2,1
88681,5,3,309546,309546,309549,0,3,3
88682,6,3,309552,309552,309555,0,3,3
88683,6,1,309558,309558,309559,0,1,3
88684,4,1,309562,309562,309563,0,1,3
88685,2,3,309564,309564,309567,0,3,1
88686,2,3,309566,309567,309570,1,4,0
88687,5,1,309571,309571,309572,0,1,1
88688,4,1,309575,309575,309576,0,1,3
88689,1,2,309576,309576,309578,0,2,0
88690,1,1,309577,309578,309579,1,2,0
88691,6,1,309583,309583,309584,0,1,4
88692,5,1,309588,309588,309589,0,1,4
88693,5,2,309593,309593,309595,0,2,4
88694,6,2,309599,309599,309601,0,2,4
88695,2,1,309601,309601,309602,0,1,0
88696,6,2,309607,309607,309609,0,2,5
88697,4,2,309611,309611,309613,0,2,2
88698,2,2,309613,309613,309615,0,2,0
88699,1,3,309614,309615,309618,1,4,0
88700,6,2,309620,309620,309622,0,2,2
88701,5,2,309625,309625,309627,0,2,3
88702,4,1,309629,309629,309630,0,1,2
88703,1,1,309630,309630,309631,0,1,0
88704,3,1,309633,309633,309634,0,1,2
88705,4,1,309637,309637,309638,0,1,3
88706,5,1,309642,309642,309643,0,1,4
88707,2,2,309644,309644,309646,0,2,1
88708,4,2,309648,309648,309650,0,2,2
88709,3,2,309651,309651,309653,0,2,1
88710,6,1,309657,309657,309658,0,1,4
88711,2,3,309659,309659,309662,0,3,1
88712,2,1,309661,309662,309663,1,2,0
88713,3,2,309664,309664,309666,0,2,1
88714,3,2,309667,309667,309669,0,2,1
88715,5,3,309672,309672,309675,0,3,3
88716,3,1,309675,309675,309676,0,1,0
88717,5,1,309680,309680,309681,0,1,4
88718,4,1,309684,309684,309685,0,1,3
88719,6,3,309690,309690,309693,0,3,5
88720,5,3,309695,309695,309698,0,3,2
88721,5,3,309700,309700,309703,0,3,2
88722,3,3,309703,309703,309706,0,3,0
88723,5,3,309708,309708,309711,0,3,2
88724,2,2,309710,309711,309713,1,3,0
88725,2,3,309712,309713,309716,1,4,0
88726,1,2,309713,309716,309718,3,5,0
88727,3,2,309716,309718,309720,2,4,0
88728,4,2,309720,309720,309722,0,2,0
88729,4,1,309724,309724,309725,0,1,2
88730,1,2,309725,309725,309727,0,2,0
88731,2,1,309727,309727,309728,0,1,0
88732,6,1,309733,309733,309734,0,1,5
88733,3,2,309736,309736,309738,0,2,2
88734,4,2,309740,309740,309742,0,2,2
88735,6,2,309746,309746,309748,0,2,4
88736,1,3,309747,309748,309751,1,4,0
88737,3,1,309750,309751,309752,1,2,0
88738,6,3,309756,309756,309759,0,3,4
88739,3,2,309759,309759,309761,0,2,0
88740,1,2,309760,309761,309763,1,3,0
88741,2,3,309762,309763,309766,1,4,0
88742,2,2,309764,309766,309768,2,4,0
88743,6,3,309770,309770,309773,0,3,2
88744,3,1,309773,309773,309774,0,1,0
88745,2,2,309775,309775,309777,0,2,1
88746,5,2,309780,309780,309782,0,2,3
88747,6,1,309786,309786,309787,0,1,4
88748,6,2,309792,309792,309794,0,2,5
88749,6,1,309798,309798,309799,0,1,4
88750,5,2,309803,309803,309805,0,2,4
88751,6,3,309809,309809,309812,0,3,4
88752,3,1,309812,309812,309813,0,1,0
88753,6,2,309818,309818,309820,0,2,5
88754,3,2,309821,309821,309823,0,2,1
88755,5,2,309826,309826,309828,0,2,3
88756,1,2,309827,309828,309830,1,3,0
88757,1,1,309828,309830,309831,2,3,0
88758,2,1,309830,309831,309832,1,2,0
88759,4,3,309834,309834,309837,0,3,2
88760,3,2,309837,309837,309839,0,2,0
88761,3,2,309840,309840,309842,0,2,1
88762,1,3,309841,309842,309845,1,4,0
88763,2,2,309843,309845,309847,2,4,0
88764,5,2,309848,309848,309850,0,2,1
88765,5,2,309853,309853,309855,0,2,3
88766,2,1,309855,309855,309856,0,1,0
88767,1,2,309856,309856,309858,0,2,0
88768,3,2,309859,309859,309861,0,2,1
88769,1,3,309860,309861,309864,1,4,0
88770,4,1,309864,309864,309865,0,1,0
88771,4,2,309868,309868,309870,0,2,3
88772,5,1,309873,309873,309874,0,1,3
88773,4,1,309877,309877,309878,0,1,3
88774,3,1,309880,309880,309881,0,1,2
88775,5,3,309885,309885,309888,0,3,4
88776,2,2,309887,309888,309890,1,3,0
88777,5,3,309892,309892,309895,0,3,2
88778,4,2,309896,309896,309898,0,2,1
88779,3,1,309899,309899,309900,0,1,1
88780,6,2,309905,309905,309907,0,2,5
88781,3,1,309908,309908,309909,0,1,1
88782,2,1,309910,309910,309911,0,1,1
88783,2,3,309912,309912,309915,0,3,1
88784,6,3,309918,309918,309921,0,3,3
88785,4,3,309922,309922,309925,0,3,1
88786,2,1,309924,309925,309926,1,2,0
88787,4,3,309928,309928,309931,0,3,2
88788,5,3,309933,309933,309936,0,3,2
88789,2,2,309935,309936,309938,1,3,0
88790,2,3,309937,309938,309941,1,4,0
88791,1,2,309938,309941,309943,3,5,0
88792,5,2,309943,309943,309945,0,2,0
88793,1,2,309944,309945,309947,1,3,0
88794,2,1,309946,309947,309948,1,2,0
88795,4,1,309950,309950,309951,0,1,2
88796,2,2,309952,309952,309954,0,2,1
88797,3,1,309955,309955,309956,0,1,1
88798,6,2,309961,309961,309963,0,2,5
88799,3,1,309964,309964,309965,0,1,1
88800,1,1,309965,309965,309966,0,1,0
88801,2,3,309967,309967,309970,0,3,1
88802,3,2,309970,309970,309972,0,2,0
88803,4,1,309974,309974,309975,0,1,2
88804,5,2,309979,309979,309981,0,2,4
88805,4,3,309983,309983,309986,0,3,2
88806,2,2,309985,309986,309988,1,3,0
88807,2,1,309987,309988,309989,1,2,0
88808,1,1,309988,309989,309990,1,2,0
88809,3,2,309991,309991,309993,0,2,1
88810,2,2,309993,309993,309995,0,2,0
88811,1,3,309994,309995,309998,1,4,0
88812,6,3,310000,310000,310003,0,3,2
88813,1,2,310001,310003,310005,2,4,0
88814,6,3,310007,310007,310010,0,3,2
88815,4,1,310011,310011,310012,0,1,1
88816,3,1,310014,310014,310015,0,1,2
88817,3,3,310017,310017,310020,0,3,2
88818,4,3,310021,310021,310024,0,3,1
88819,6,3,310027,310027,310030,0,3,3
88820,1,1,310028,310030,310031,2,3,0
88821,1,1,310029,310031,310032,2,3,0
88822,2,3,310031,310032,310035,1,4,0
88823,1,1,310032,310035,310036,3,4,0
88824,5,1,310037,310037,310038,0,1,1
88825,6,3,310043,310043,310046,0,3,5
88826,6,1,310049,310049,310050,0,1,3
88827,4,3,310053,310053,310056,0,3,3
88828,3,3,310056,310056,310059,0,3,0
88829,2,3,310058,310059,310062,1,4,0
88830,2,1,310060,310062,310063,2,3,0
88831,6,2,310066,310066,310068,0,2,3
88832,4,3,310070,310070,310073,0,3,2
88833,5,3,310075,310075,310078,0,3,2
88834,4,3,310079,310079,310082,0,3,1
88835,6,1,310085,310085,310086,0,1,3
88836,2,3,310087,310087,310090,0,3,1
88837,5,3,310092,310092,310095,0,3,2
88838,6,3,310098,310098,310101,0,3,3
88839,6,3,310104,310104,310107,0,3,3
88840,3,3,310107,310107,310110,0,3,0
88841,6,2,310113,310113,310115,0,2,3
88842,4,3,310117,310117,310120,0,3,2
88843,4,1,310121,310121,310122,0,1,1
88844,3,3,310124,310124,310127,0,3,2
88845,5,3,310129,310129,310132,0,3,2
88846,4,1,310133,310133,310134,0,1,1
88847,2,3,310135,310135,310138,0,3,1
88848,3,1,310138,310138,310139,0,1,0
88849,3,3,310141,310141,310144,0,3,2
88850,2,1,310143,310144,310145,1,2,0
88851,5,1,310148,310148,310149,0,1,3
88852,6,3,310154,310154,310157,0,3,5
88853,4,1,310158,310158,310159,0,1,1
88854,5,2,310163,310163,310165,0,2,4
88855,2,1,310165,310165,310166,0,1,0
88856,5,3,310170,310170,310173,0,3,4
88857,5,2,310175,310175,310177,0,2,2
88858,5,1,310180,310180,310181,0,1,3
88859,4,3,310184,310184,310187,0,3,3
88860,5,1,310189,310189,310190,0,1,2
88861,5,3,310194,310194,310197,0,3,4
88862,5,2,310199,310199,310201,0,2,2
88863,3,2,310202,310202,310204,0,2,1
88864,2,1,310204,310204,310205,0,1,0
88865,3,2,310207,310207,310209,0,2,2
88866,4,3,310211,310211,310214,0,3,2
88867,5,1,310216,310216,310217,0,1,2
88868,3,1,310219,310219,310220,0,1,2
88869,2,3,310221,310221,310224,0,3,1
88870,5,2,310226,310226,310228,0,2,2
88871,5,1,310231,310231,310232,0,1,3
88872,6,2,310237,310237,310239,0,2,5
88873,2,3,310239,310239,310242,0,3,0
88874,4,3,310243,310243,310246,0,3,1
88875,3,2,310246,310246,310248,0,2,0
88876,3,1,310249,310249,310250,0,1,1
88877,2,1,310251,310251,310252,0,1,1
88878,2,3,310253,310253,310256,0,3,1
88879,1,1,310254,310256,310257,2,3,0
88880,5,2,310259,310259,310261,0,2,2
88881,3,3,310262,310262,310265,0,3,1
88882,5,2,310267,310267,310269,0,2,2
88883,6,3,310273,310273,310276,0,3,4
88884,5,2,310278,310278,310280,0,2,2
88885,1,2,310279,310280,310282,1,3,0
88886,1,1,310280,310282,310283,2,3,0
88887,3,1,310283,310283,310284,0,1,0
88888,1,3,310284,310284,310287,0,3,0
88889,2,2,310286,310287,310289,1,3,0
88890,4,1,310290,310290,310291,0,1,1
88891,2,3,310292,310292,310295,0,3,1
88892,5,1,310297,310297,310298,0,1,2
88893,3,3,310300,310300,310303,0,3,2
88894,1,3,310301,310303,310306,2,5,0
88895,6,1,310307,310307,310308,0,1,1
88896,1,3,310308,310308,310311,0,3,0
88897,6,2,310314,310314,310316,0,2,3
88898,2,3,310316,310316,310319,0,3,0
88899,6,1,310322,310322,310323,0,1,3
88900,4,2,310326,310326,310328,0,2,3
88901,3,3,310329,310329,310332,0,3,1
88902,5,1,310334,310334,310335,0,1,2
88903,3,2,310337,310337,310339,0,2,2
88904,3,1,310340,310340,310341,0,1,1
88905,6,2,310346,310346,310348,0,2,5
88906,3,2,310349,310349,310351,0,2,1
88907,6,2,310355,310355,310357,0,2,4
88908,1,2,310356,310357,310359,1,3,0
88909,2,2,310358,310359,310361,1,3,0
88910,1,3,310359,310361,310364,2,5,0
88911,1,3,310360,310364,310367,4,7,0
88912,4,2,310364,310367,310369,3,5,0
88913,6,2,310370,310370,310372,0,2,1
88914,4,2,310374,310374,310376,0,2,2
88915,5,2,310379,310379,310381,0,2,3
88916,3,2,310382,310382,310384,0,2,1
88917,5,1,310387,310387,310388,0,1,3
88918,2,2,310389,310389,310391,0,2,1
88919,1,1,310390,310391,310392,1,2,0
88920,1,1,310391,310392,310393,1,2,0
88921,6,1,310397,310397,310398,0,1,4
88922,3,1,310400,310400,310401,0,1,2
88923,4,1,310404,310404,310405,0,1,3
88924,6,3,310410,310410,310413,0,3,5
88925,4,3,310414,310414,310417,0,3,1
88926,6,3,310420,310420,310423,0,3,3
88927,3,3,310423,310423,310426,0,3,0
88928,2,3,310425,310426,310429,1,4,0
88929,5,3,310430,310430,310433,0,3,1
88930,6,1,310436,310436,310437,0,1,3
88931,5,3,310441,310441,310444,0,3,4
88932,1,3,310442,310444,310447,2,5,0
88933,2,2,310444,310447,310449,3,5,0
88934,4,3,310448,310449,310452,1,4,0
88935,5,2,310453,310453,310455,0,2,1
88936,4,3,310457,310457,310460,0,3,2
88937,1,1,310458,310460,310461,2,3,0
88938,3,3,310461,310461,310464,0,3,0
88939,4,2,310465,310465,310467,0,2,1
88940,3,2,310468,310468,310470,0,2,1
88941,2,1,310470,310470,310471,0,1,0
88942,1,2,310471,310471,310473,0,2,0
88943,6,1,310477,310477,310478,0,1,4
88944,5,2,310482,310482,310484,0,2,4
88945,5,1,310487,310487,310488,0,1,3
88946,5,2,310492,310492,310494,0,2,4
88947,3,3,310495,310495,310498,0,3,1
88948,2,2,310497,310498,310500,1,3,0
88949,1,1,310498,310500,310501,2,3,0
88950,4,2,310502,310502,310504,0,2,1
88951,3,2,310505,310505,310507,0,2,1
88952,6,1,310511,310511,310512,0,1,4
88953,3,3,310514,310514,310517,0,3,2
88954,6,2,310520,310520,310522,0,2,3
88955,6,1,310526,310526,310527,0,1,4
88956,5,3,310531,310531,310534,0,3,4
88957,3,3,310534,310534,310537,0,3,0
88958,6,1,310540,310540,310541,0,1,3
88959,6,2,310546,310546,310548,0,2,5
88960,2,3,310548,310548,310551,0,3,0
88961,2,3,310550,310551,310554,1,4,0
88962,6,1,310556,310556,310557,0,1,2
88963,3,3,310559,310559,310562,0,3,2
88964,3,1,310562,310562,310563,0,1,0
88965,5,2,310567,310567,310569,0,2,4
88966,1,2,310568,310569,310571,1,3,0
88967,2,1,310570,310571,310572,1,2,0
88968,1,1,310571,310572,310573,1,2,0
88969,1,1,310572,310573,310574,1,2,0
88970,3,2,310575,310575,310577,0,2,1
88971,6,1,310581,310581,310582,0,1,4
88972,4,1,310585,310585,310586,0,1,3
88973,6,3,310591,310591,310594,0,3,5
88974,1,1,310592,310594,310595,2,3,0
88975,2,1,310594,310595,310596,1,2,0
88976,2,2,310596,310596,310598,0,2,0
88977,6,1,310602,310602,310603,0,1,4
88978,3,2,310605,310605,310607,0,2,2
88979,4,2,310609,310609,310611,0,2,2
88980,2,3,310611,310611,310614,0,3,0
88981,6,2,310617,310617,310619,0,2,3
88982,3,3,310620,310620,310623,0,3,1
88983,4,2,310624,310624,310626,0,2,1
88984,4,1,310628,310628,310629,0,1,2
88985,5,3,310633,310633,310636,0,3,4
88986,1,2,310634,310636,310638,2,4,0
88987,4,1,310638,310638,310639,0,1,0
88988,4,3,310642,310642,310645,0,3,3
88989,6,2,310648,310648,310650,0,2,3
88990,1,2,310649,310650,310652,1,3,0
88991,2,1,310651,310652,310653,1,2,0
88992,2,3,310653,310653,310656,0,3,0
88993,2,2,310655,310656,310658,1,3,0
88994,5,3,310660,310660,310663,0,3,2
88995,3,2,310663,310663,310665,0,2,0
88996,4,2,310667,310667,310669,0,2,2
88997,1,3,310668,310669,310672,1,4,0
88998,6,3,310674,310674,310677,0,3,2
88999,6,3,310680,310680,310683,0,3,3
89000,3,3,310683,310683,310686,0,3,0
89001,1,1,310684,310686,310687,2,3,0
89002,3,3,310687,310687,310690,0,3,0
89003,3,2,310690,310690,310692,0,2,0
89004,6,2,310696,310696,310698,0,2,4
89005,3,1,310699,310699,310700,0,1,1
89006,3,2,310702,310702,310704,0,2,2
89007,1,3,310703,310704,310707,1,4,0
89008,5,3,310708,310708,310711,0,3,1
89009,4,3,310712,310712,310715,0,3,1
89010,6,1,310718,310718,310719,0,1,3
89011,1,2,310719,310719,310721,0,2,0
89012,5,3,310724,310724,310727,0,3,3
89013,1,1,310725,310727,310728,2,3,0
89014,4,3,310729,310729,310732,0,3,1
89015,6,2,310735,310735,310737,0,2,3
89016,4,3,310739,310739,310742,0,3,2
89017,4,2,310743,310743,310745,0,2,1
89018,3,2,310746,310746,310748,0,2,1
89019,3,3,310749,310749,310752,0,3,1
89020,1,2,310750,310752,310754,2,4,0
89021,6,3,310756,310756,310759,0,3,2
89022,5,3,310761,310761,310764,0,3,2
89023,5,2,310766,310766,310768,0,2,2
89024,1,3,310767,310768,310771,1,4,0
89025,4,2,310771,310771,310773,0,2,0
89026,4,3,310775,310775,310778,0,3,2
89027,3,3,310778,310778,310781,0,3,0
89028,1,3,310779,310781,310784,2,5,0
89029,4,2,310783,310784,310786,1,3,0
89030,1,2,310784,310786,310788,2,4,0
89031,6,2,310790,310790,310792,0,2,2
89032,5,3,310795,310795,310798,0,3,3
89033,1,3,310796,310798,310801,2,5,0
89034,5,1,310801,310801,310802,0,1,0
89035,3,1,310804,310804,310805,0,1,2
89036,2,1,310806,310806,310807,0,1,1
89037,6,2,310812,310812,310814,0,2,5
89038,3,1,310815,310815,310816,0,1,1
89039,4,3,310819,310819,310822,0,3,3
89040,1,2,310820,310822,310824,2,4,0
89041,6,1,310826,310826,310827,0,1,2
89042,6,3,310832,310832,310835,0,3,5
89043,2,3,310834,310835,310838,1,4,0
89044,6,3,310840,310840,310843,0,3,2
89045,4,2,310844,310844,310846,0,2,1
89046,1,1,310845,310846,310847,1,2,0
89047,1,2,310846,310847,310849,1,3,0
89048,6,3,310852,310852,310855,0,3,3
89049,1,2,310853,310855,310857,2,4,0
89050,4,3,310857,310857,310860,0,3,0
89051,2,3,310859,310860,310863,1,4,0
89052,1,1,310860,310863,310864,3,4,0
89053,5,3,310865,310865,310868,0,3,1
89054,3,1,310868,310868,310869,0,1,0
89055,3,2,310871,310871,310873,0,2,2
89056,4,3,310875,310875,310878,0,3,2
89057,5,3,310880,310880,310883,0,3,2
89058,3,3,310883,310883,310886,0,3,0
89059,5,2,310888,310888,310890,0,2,2
89060,4,1,310892,310892,310893,0,1,2
89061,2,1,310894,310894,310895,0,1,1
89062,1,3,310895,310895,310898,0,3,0
89063,5,2,310900,310900,310902,0,2,2
89064,2,2,310902,310902,310904,0,2,0
89065,1,2,310903,310904,310906,1,3,0
89066,1,3,310904,310906,310909,2,5,0
89067,5,3,310909,310909,310912,0,3,0
89068,5,2,310914,310914,310916,0,2,2
89069,3,3,310917,310917,310920,0,3,1
89070,3,1,310920,310920,310921,0,1,0
89071,3,2,310923,310923,310925,0,2,2
89072,5,2,310928,310928,310930,0,2,3
89073,1,1,310929,310930,310931,1,2,0
89074,4,3,310933,310933,310936,0,3,2
89075,2,2,310935,310936,310938,1,3,0
89076,4,1,310939,310939,310940,0,1,1
89077,4,1,310943,310943,310944,0,1,3
89078,2,1,310945,310945,310946,0,1,1
89079,2,2,310947,310947,310949,0,2,1
89080,6,2,310953,310953,310955,0,2,4
89081,5,3,310958,310958,310961,0,3,3
89082,2,2,310960,310961,310963,1,3,0
89083,6,3,310966,310966,310969,0,3,3
89084,2,3,310968,310969,310972,1,4,0
89085,5,3,310973,310973,310976,0,3,1
89086,3,2,310976,310976,310978,0,2,0
89087,6,3,310982,310982,310985,0,3,4
89088,3,2,310985,310985,310987,0,2,0
89089,2,1,310987,310987,310988,0,1,0
89090,3,3,310990,310990,310993,0,3,2
89091,3,2,310993,310993,310995,0,2,0
89092,2,2,310995,310995,310997,0,2,0
89093,2,3,310997,310997,311000,0,3,0
89094,3,1,311000,311000,311001,0,1,0
89095,2,3,311002,311002,311005,0,3,1
89096,3,2,311005,311005,311007,0,2,0
89097,1,2,311006,311007,311009,1,3,0
89098,3,2,311009,311009,311011,0,2,0
89099,6,1,311015,311015,311016,0,1,4
89100,4,3,311019,311019,311022,0,3,3
89101,3,1,311022,311022,311023,0,1,0
89102,5,2,311027,311027,311029,0,2,4
89103,5,1,311032,311032,311033,0,1,3
89104,4,3,311036,311036,311039,0,3,3
89105,6,1,311042,311042,311043,0,1,3
89106,6,3,311048,311048,311051,0,3,5
89107,5,3,311053,311053,311056,0,3,2
89108,2,2,311055,311056,311058,1,3,0
89109,6,1,311061,311061,311062,0,1,3
89110,1,1,311062,311062,311063,0,1,0
89111,5,3,311067,311067,311070,0,3,4
89112,3,3,311070,311070,311073,0,3,0
89113,4,3,311074,311074,311077,0,3,1
89114,3,1,311077,311077,311078,0,1,0
89115,4,2,311081,311081,311083,0,2,3
89116,2,2,311083,311083,311085,0,2,0
89117,4,1,311087,311087,311088,0,1,2
89118,5,1,311092,311092,311093,0,1,4
89119,2,2,311094,311094,311096,0,2,1
89120,5,1,311099,311099,311100,0,1,3
89121,6,3,311105,311105,311108,0,3,5
89122,4,1,311109,311109,311110,0,1,1
89123,1,1,311110,311110,311111,0,1,0
89124,5,2,311115,311115,311117,0,2,4
89125,1,2,311116,311117,311119,1,3,0
89126,2,2,311118,311119,311121,1,3,0
89127,2,1,311120,311121,311122,1,2,0
89128,5,3,311125,311125,311128,0,3,3
89129,5,3,311130,311130,311133,0,3,2
89130,6,1,311136,311136,311137,0,1,3
89131,2,2,311138,311138,311140,0,2,1
89132,5,1,311143,311143,311144,0,1,3
89133,2,1,311145,311145,311146,0,1,1
89134,6,3,311151,311151,311154,0,3,5
89135,2,3,311153,311154,311157,1,4,0
89136,1,3,311154,311157,311160,3,6,0
89137,6,3,311160,311160,311163,0,3,0
89138,5,2,311165,311165,311167,0,2,2
89139,6,2,311171,311171,311173,0,2,4
89140,1,1,311172,311173,311174,1,2,0
89141,1,1,311173,311174,311175,1,2,0
89142,2,1,311175,311175,311176,0,1,0
89143,3,1,311178,311178,311179,0,1,2
89144,5,2,311183,311183,311185,0,2,4
89145,4,1,311187,311187,311188,0,1,2
89146,1,2,311188,311188,311190,0,2,0
89147,2,2,311190,311190,311192,0,2,0
89148,6,3,311196,311196,311199,0,3,4
89149,4,2,311200,311200,311202,0,2,1
89150,3,3,311203,311203,311206,0,3,1
89151,4,2,311207,311207,311209,0,2,1
89152,5,3,311212,311212,311215,0,3,3
89153,6,2,311218,311218,311220,0,2,3
89154,6,1,311224,311224,311225,0,1,4
89155,1,3,311225,311225,311228,0,3,0
89156,1,1,311226,311228,311229,2,3,0
89157,6,2,311232,311232,311234,0,2,3
89158,2,3,311234,311234,311237,0,3,0
89159,4,2,311238,311238,311240,0,2,1
89160,4,2,311242,311242,311244,0,2,2
89161,1,1,311243,311244,311245,1,2,0
89162,5,3,311248,311248,311251,0,3,3
89163,6,1,311254,311254,311255,0,1,3
89164,2,2,311256,311256,311258,0,2,1
89165,3,3,311259,311259,311262,0,3,1
89166,1,3,311260,311262,311265,2,5,0
89167,2,2,311262,311265,311267,3,5,0
89168,4,2,311266,311267,311269,1,3,0
89169,3,1,311269,311269,311270,0,1,0
89170,5,3,311274,311274,311277,0,3,4
89171,4,1,311278,311278,311279,0,1,1
89172,6,2,311284,311284,311286,0,2,5
89173,5,1,311289,311289,311290,0,1,3
89174,4,3,311293,311293,311296,0,3,3
89175,1,3,311294,311296,311299,2,5,0
89176,6,1,311300,311300,311301,0,1,1
89177,1,2,311301,311301,311303,0,2,0
89178,2,1,311303,311303,311304,0,1,0
89179,5,3,311308,311308,311311,0,3,4
89180,1,2,311309,311311,311313,2,4,0
89181,4,1,311313,311313,311314,0,1,0
89182,2,2,311315,311315,311317,0,2,1
89183,1,2,311316,311317,311319,1,3,0
89184,5,2,311321,311321,311323,0,2,2
89185,5,2,311326,311326,311328,0,2,3
89186,2,2,311328,311328,311330,0,2,0
89187,2,1,311330,311330,311331,0,1,0
89188,1,1,311331,311331,311332,0,1,0
89189,4,2,311335,311335,311337,0,2,3
89190,1,2,311336,311337,311339,1,3,0
89191,1,2,311337,311339,311341,2,4,0
89192,5,3,311342,311342,311345,0,3,1
89193,6,2,311348,311348,311350,0,2,3
89194,4,1,311352,311352,311353,0,1,2
89195,2,1,311354,311354,311355,0,1,1
89196,1,1,311355,311355,311356,0,1,0
89197,4,2,311359,311359,311361,0,2,3
89198,1,3,311360,311361,311364,1,4,0
89199,2,1,311362,311364,311365,2,3,0
89200,6,3,311368,311368,311371,0,3,3
89201,6,2,311374,311374,311376,0,2,3
89202,2,3,311376,311376,311379,0,3,0
89203,1,3,311377,311379,311382,2,5,0
89204,5,3,311382,311382,311385,0,3,0
89205,3,3,311385,311385,311388,0,3,0
89206,5,3,311390,311390,311393,0,3,2
89207,2,2,311392,311393,311395,1,3,0
89208,2,2,311394,311395,311397,1,3,0
89209,4,2,311398,311398,311400,0,2,1
89210,5,3,311403,311403,311406,0,3,3
89211,6,1,311409,311409,311410,0,1,3
89212,3,3,311412,311412,311415,0,3,2
89213,6,2,311418,311418,311420,0,2,3
89214,5,1,311423,311423,311424,0,1,3
89215,2,2,311425,311425,311427,0,2,1
89216,4,1,311429,311429,311430,0,1,2
89217,5,2,311434,311434,311436,0,2,4
89218,3,2,311437,311437,311439,0,2,1
89219,5,1,311442,311442,311443,0,1,3
89220,5,3,311447,311447,311450,0,3,4
89221,5,1,311452,311452,311453,0,1,2
89222,1,2,311453,311453,311455,0,2,0
89223,2,1,311455,311455,311456,0,1,0
89224,3,1,311458,311458,311459,0,1,2
89225,5,1,311463,311463,311464,0,1,4
89226,5,1,311468,311468,311469,0,1,4
89227,4,3,311472,311472,311475,0,3,3
89228,6,1,311478,311478,311479,0,1,3
89229,4,1,311482,311482,311483,0,1,3
89230,5,2,311487,311487,311489,0,2,4
89231,2,3,311489,311489,311492,0,3,0
89232,4,1,311493,311493,311494,0,1,1
89233,1,1,311494,311494,311495,0,1,0
89234,3,2,311497,311497,311499,0,2,2
89235,6,3,311503,311503,311506,0,3,4
89236,3,2,311506,311506,311508,0,2,0
89237,4,3,311510,311510,311513,0,3,2
89238,1,1,311511,311513,311514,2,3,0
89239,1,3,311512,311514,311517,2,5,0
89240,6,1,311518,311518,311519,0,1,1
89241,6,1,311524,311524,311525,0,1,5
89242,6,3,311530,311530,311533,0,3,5
89243,3,1,311533,311533,311534,0,1,0
89244,4,1,311537,311537,311538,0,1,3
89245,3,3,311540,311540,311543,0,3,2
89246,6,3,311546,311546,311549,0,3,3
89247,1,2,311547,311549,311551,2,4,0
89248,1,3,311548,311551,311554,3,6,0
89249,1,2,311549,311554,311556,5,7,0
89250,4,3,311553,311556,311559,3,6,0
89251,3,1,311556,311559,311560,3,4,0
89252,5,1,311561,311561,311562,0,1,1
89253,1,3,311562,311562,311565,0,3,0
89254,4,3,311566,311566,311569,0,3,1
89255,4,1,311570,311570,311571,0,1,1
89256,5,3,311575,311575,311578,0,3,4
89257,2,3,311577,311578,311581,1,4,0
89258,3,2,311580,311581,311583,1,3,0
89259,2,3,311582,311583,311586,1,4,0
89260,4,1,311586,311586,311587,0,1,0
89261,5,3,311591,311591,311594,0,3,4
89262,6,1,311597,311597,311598,0,1,3
89263,1,1,311598,311598,311599,0,1,0
89264,6,3,311604,311604,311607,0,3,5
89265,5,2,311609,311609,311611,0,2,2
89266,3,3,311612,311612,311615,0,3,1
89267,1,3,311613,311615,311618,2,5,0
89268,2,3,311615,311618,311621,3,6,0
89269,1,2,311616,311621,311623,5,7,0
89270,6,2,311622,311623,311625,1,3,0
89271,5,2,311627,311627,311629,0,2,2
89272,6,2,311633,311633,311635,0,2,4
89273,4,2,311637,311637,311639,0,2,2
89274,6,2,311643,311643,311645,0,2,4
89275,6,1,311649,311649,311650,0,1,4
89276,3,2,311652,311652,311654,0,2,2
89277,5,1,311657,311657,311658,0,1,3
89278,5,3,311662,311662,311665,0,3,4
89279,3,2,311665,311665,311667,0,2,0
89280,4,1,311669,311669,311670,0,1,2
89281,3,1,311672,311672,311673,0,1,2
89282,6,2,311678,311678,311680,0,2,5
89283,2,1,311680,311680,311681,0,1,0
89284,5,2,311685,311685,311687,0,2,4
89285,2,3,311687,311687,311690,0,3,0
89286,1,2,311688,311690,311692,2,4,0
89287,4,3,311692,311692,311695,0,3,0
89288,3,1,311695,311695,311696,0,1,0
89289,3,3,311698,311698,311701,0,3,2
89290,3,1,311701,311701,311702,0,1,0
89291,3,1,311704,311704,311705,0,1,2
89292,6,1,311710,311710,311711,0,1,5
89293,4,3,311714,311714,311717,0,3,3
89294,5,1,311719,311719,311720,0,1,2
89295,3,2,311722,311722,311724,0,2,2
89296,1,1,311723,311724,311725,1,2,0
89297,2,1,311725,311725,311726,0,1,0
89298,6,1,311731,311731,311732,0,1,5
89299,3,3,311734,311734,311737,0,3,2
89300,1,2,311735,311737,311739,2,4,0
89301,6,3,311741,311741,311744,0,3,2
89302,3,1,311744,311744,311745,0,1,0
89303,1,1,311745,311745,311746,0,1,0
89304,3,2,311748,311748,311750,0,2,2
89305,2,2,311750,311750,311752,0,2,0
89306,4,2,311754,311754,311756,0,2,2
89307,3,3,311757,311757,311760,0,3,1
89308,2,3,311759,311760,311763,1,4,0
89309,4,2,311763,311763,311765,0,2,0
89310,5,2,311768,311768,311770,0,2,3
89311,3,2,311771,311771,311773,0,2,1
89312,1,2,311772,311773,311775,1,3,0
89313,4,1,311776,311776,311777,0,1,1
89314,1,1,311777,311777,311778,0,1,0
89315,1,2,311778,311778,311780,0,2,0
89316,4,2,311782,311782,311784,0,2,2
89317,1,1,311783,311784,311785,1,2,0
89318,3,2,311786,311786,311788,0,2,1
89319,6,2,311792,311792,311794,0,2,4
89320,2,3,311794,311794,311797,0,3,0
89321,6,1,311800,311800,311801,0,1,3
89322,2,2,311802,311802,311804,0,2,1
89323,4,2,311806,311806,311808,0,2,2
89324,4,3,311810,311810,311813,0,3,2
89325,2,1,311812,311813,311814,1,2,0
89326,6,3,311818,311818,311821,0,3,4
89327,3,2,311821,311821,311823,0,2,0
89328,3,2,311824,311824,311826,0,2,1
89329,6,1,311830,311830,311831,0,1,4
89330,2,1,311832,311832,311833,0,1,1
89331,1,1,311833,311833,311834,0,1,0
89332,3,1,311836,311836,311837,0,1,2
89333,5,2,311841,311841,311843,0,2,4
89334,1,2,311842,311843,311845,1,3,0
89335,4,3,311846,311846,311849,0,3,1
89336,4,2,311850,311850,311852,0,2,1
89337,5,3,311855,311855,311858,0,3,3
89338,3,3,311858,311858,311861,0,3,0
89339,4,2,311862,311862,311864,0,2,1
89340,2,1,311864,311864,311865,0,1,0
89341,3,2,311867,311867,311869,0,2,2
89342,2,1,311869,311869,311870,0,1,0
89343,2,3,311871,311871,311874,0,3,1
89344,4,2,311875,311875,311877,0,2,1
89345,1,3,311876,311877,311880,1,4,0
89346,1,1,311877,311880,311881,3,4,0
89347,1,3,311878,311881,311884,3,6,0
89348,4,3,311882,311884,311887,2,5,0
89349,3,3,311885,311887,311890,2,5,0
89350,4,3,311889,311890,311893,1,4,0
89351,1,1,311890,311893,311894,3,4,0
89352,4,2,311894,311894,311896,0,2,0
89353,6,1,311900,311900,311901,0,1,4
89354,5,3,311905,311905,311908,0,3,4
89355,2,3,311907,311908,311911,1,4,0
89356,6,3,311913,311913,311916,0,3,2
89357,6,3,311919,311919,311922,0,3,3
89358,4,3,311923,311923,311926,0,3,1
89359,6,1,311929,311929,311930,0,1,3
89360,3,1,311932,311932,311933,0,1,2
89361,2,2,311934,311934,311936,0,2,1
89362,5,3,311939,311939,311942,0,3,3
89363,4,3,311943,311943,311946,0,3,1
89364,1,1,311944,311946,311947,2,3,0
89365,4,3,311948,311948,311951,0,3,1
89366,4,3,311952,311952,311955,0,3,1
89367,6,1,311958,311958,311959,0,1,3
89368,1,2,311959,311959,311961,0,2,0
89369,5,1,311964,311964,311965,0,1,3
89370,3,1,311967,311967,311968,0,1,2
89371,2,2,311969,311969,311971,0,2,1
89372,4,2,311973,311973,311975,0,2,2
89373,5,2,311978,311978,311980,0,2,3
89374,1,2,311979,311980,311982,1,3,0
89375,6,2,311985,311985,311987,0,2,3
89376,5,2,311990,311990,311992,0,2,3
89377,5,1,311995,311995,311996,0,1,3
89378,1,1,311996,311996,311997,0,1,0
89379,5,3,312001,312001,312004,0,3,4
89380,3,1,312004,312004,312005,0,1,0
89381,5,3,312009,312009,312012,0,3,4
89382,1,3,312010,312012,312015,2,5,0
89383,4,3,312014,312015,312018,1,4,0
89384,2,3,312016,312018,312021,2,5,0
89385,2,2,312018,312021,312023,3,5,0
89386,4,3,312022,312023,312026,1,4,0
89387,6,1,312028,312028,312029,0,1,2
89388,3,1,312031,312031,312032,0,1,2
89389,6,2,312037,312037,312039,0,2,5
89390,5,2,312042,312042,312044,0,2,3
89391,5,1,312047,312047,312048,0,1,3
89392,5,1,312052,312052,312053,0,1,4
89393,1,1,312053,312053,312054,0,1,0
89394,4,3,312057,312057,312060,0,3,3
89395,6,3,312063,312063,312066,0,3,3
89396,3,1,312066,312066,312067,0,1,0
89397,5,1,312071,312071,312072,0,1,4
89398,3,1,312074,312074,312075,0,1,2
89399,6,1,312080,312080,312081,0,1,5
89400,3,1,312083,312083,312084,0,1,2
89401,6,3,312089,312089,312092,0,3,5
89402,6,1,312095,312095,312096,0,1,3
89403,2,2,312097,312097,312099,0,2,1
89404,2,3,312099,312099,312102,0,3,0
89405,3,2,312102,312102,312104,0,2,0
89406,3,1,312105,312105,312106,0,1,1
89407,6,1,312111,312111,312112,0,1,5
89408,4,2,312115,312115,312117,0,2,3
89409,1,2,312116,312117,312119,1,3,0
89410,3,2,312119,312119,312121,0,2,0
89411,1,1,312120,312121,312122,1,2,0
89412,4,2,312124,312124,312126,0,2,2
89413,3,1,312127,312127,312128,0,1,1
89414,4,2,312131,312131,312133,0,2,3
89415,3,1,312134,312134,312135,0,1,1
89416,4,3,312138,312138,312141,0,3,3
89417,6,1,312144,312144,312145,0,1,3
89418,1,2,312145,312145,312147,0,2,0
89419,1,3,312146,312147,312150,1,4,0
89420,4,1,312150,312150,312151,0,1,0
89421,4,3,312154,312154,312157,0,3,3
89422,6,1,312160,312160,312161,0,1,3
89423,4,2,312164,312164,312166,0,2,3
89424,1,2,312165,312166,312168,1,3,0
89425,1,1,312166,312168,312169,2,3,0
89426,1,2,312167,312169,312171,2,4,0
89427,2,1,312169,312171,312172,2,3,0
89428,1,3,312170,312172,312175,2,5,0
89429,4,3,312174,312175,312178,1,4,0
89430,2,2,312176,312178,312180,2,4,0
89431,1,2,312177,312180,312182,3,5,0
89432,1,3,312178,312182,312185,4,7,0
89433,4,1,312182,312185,312186,3,4,0
89434,6,3,312188,312188,312191,0,3,2
89435,3,2,312191,312191,312193,0,2,0
89436,5,3,312196,312196,312199,0,3,3
89437,1,1,312197,312199,312200,2,3,0
89438,6,3,312203,312203,312206,0,3,3
89439,1,1,312204,312206,312207,2,3,0
89440,6,3,312210,312210,312213,0,3,3
89441,2,1,312212,312213,312214,1,2,0
89442,6,1,312218,312218,312219,0,1,4
89443,5,1,312223,312223,312224,0,1,4
89444,4,3,312227,312227,312230,0,3,3
89445,2,2,312229,312230,312232,1,3,0
89446,3,1,312232,312232,312233,0,1,0
89447,4,1,312236,312236,312237,0,1,3
89448,3,1,312239,312239,312240,0,1,2
89449,2,3,312241,312241,312244,0,3,1
89450,3,2,312244,312244,312246,0,2,0
89451,1,2,312245,312246,312248,1,3,0
89452,4,3,312249,312249,312252,0,3,1
89453,6,1,312255,312255,312256,0,1,3
89454,4,2,312259,312259,312261,0,2,3
89455,1,1,312260,312261,312262,1,2,0
89456,4,2,312264,312264,312266,0,2,2
89457,5,2,312269,312269,312271,0,2,3
89458,5,3,312274,312274,312277,0,3,3
89459,5,1,312279,312279,312280,0,1,2
89460,1,2,312280,312280,312282,0,2,0
89461,3,1,312283,312283,312284,0,1,1
89462,1,3,312284,312284,312287,0,3,0
89463,6,2,312290,312290,312292,0,2,3
89464,5,2,312295,312295,312297,0,2,3
89465,2,1,312297,312297,312298,0,1,0
89466,1,1,312298,312298,312299,0,1,0
89467,4,3,312302,312302,312305,0,3,3
89468,2,1,312304,312305,312306,1,2,0
89469,3,2,312307,312307,312309,0,2,1
89470,4,2,312311,312311,312313,0,2,2
89471,5,1,312316,312316,312317,0,1,3
89472,5,3,312321,312321,312324,0,3,4
89473,4,1,312325,312325,312326,0,1,1
89474,5,2,312330,312330,312332,0,2,4
89475,2,3,312332,312332,312335,0,3,0
89476,3,2,312335,312335,312337,0,2,0
89477,5,3,312340,312340,312343,0,3,3
89478,1,3,312341,312343,312346,2,5,0
89479,1,1,312342,312346,312347,4,5,0
89480,3,2,312345,312347,312349,2,4,0
89481,1,3,312346,312349,312352,3,6,0
89482,5,2,312351,312352,312354,1,3,0
89483,5,1,312356,312356,312357,0,1,2
89484,1,2,312357,312357,312359,0,2,0
89485,4,3,312361,312361,312364,0,3,2
89486,3,2,312364,312364,312366,0,2,0
89487,4,1,312368,312368,312369,0,1,2
89488,2,2,312370,312370,312372,0,2,1
89489,4,3,312374,312374,312377,0,3,2
89490,1,1,312375,312377,312378,2,3,0
89491,2,2,312377,312378,312380,1,3,0
89492,1,1,312378,312380,312381,2,3,0
89493,1,1,312379,312381,312382,2,3,0
89494,2,2,312381,312382,312384,1,3,0
89495,5,1,312386,312386,312387,0,1,2
89496,2,3,312388,312388,312391,0,3,1
89497,2,3,312390,312391,312394,1,4,0
89498,1,3,312391,312394,312397,3,6,0
89499,2,1,312393,312397,312398,4,5,0
89500,5,3,312398,312398,312401,0,3,0
89501,5,1,312403,312403,312404,0,1,2
89502,3,2,312406,312406,312408,0,2,2
89503,2,3,312408,312408,312411,0,3,0
89504,2,1,312410,312411,312412,1,2,0
89505,1,3,312411,312412,312415,1,4,0
89506,1,2,312412,312415,312417,3,5,0
89507,2,1,312414,312417,312418,3,4,0
89508,6,1,312420,312420,312421,0,1,2
89509,1,2,312421,312421,312423,0,2,0
89510,4,1,312425,312425,312426,0,1,2
89511,6,2,312431,312431,312433,0,2,5
89512,4,1,312435,312435,312436,0,1,2
89513,2,2,312437,312437,312439,0,2,1
89514,4,2,312441,312441,312443,0,2,2
89515,4,2,312445,312445,312447,0,2,2
89516,2,2,312447,312447,312449,0,2,0
89517,5,1,312452,312452,312453,0,1,3
89518,5,3,312457,312457,312460,0,3,4
89519,6,3,312463,312463,312466,0,3,3
89520,3,3,312466,312466,312469,0,3,0
89521,2,2,312468,312469,312471,1,3,0
89522,6,2,312474,312474,312476,0,2,3
89523,4,1,312478,312478,312479,0,1,2
89524,2,3,312480,312480,312483,0,3,1
89525,3,1,312483,312483,312484,0,1,0
89526,3,3,312486,312486,312489,0,3,2
89527,1,1,312487,312489,312490,2,3,0
89528,1,1,312488,312490,312491,2,3,0
89529,2,1,312490,312491,312492,1,2,0
89530,4,1,312494,312494,312495,0,1,2
89531,1,3,312495,312495,312498,0,3,0
89532,1,3,312496,312498,312501,2,5,0
89533,6,3,312502,312502,312505,0,3,1
89534,3,3,312505,312505,312508,0,3,0
89535,5,3,312510,312510,312513,0,3,2
89536,1,2,312511,312513,312515,2,4,0
89537,4,1,312515,312515,312516,0,1,0
89538,2,3,312517,312517,312520,0,3,1
89539,2,3,312519,312520,312523,1,4,0
89540,6,2,312525,312525,312527,0,2,2
89541,4,1,312529,312529,312530,0,1,2
89542,2,1,312531,312531,312532,0,1,1
89543,3,3,312534,312534,312537,0,3,2
89544,5,1,312539,312539,312540,0,1,2
89545,6,2,312545,312545,312547,0,2,5
89546,6,2,312551,312551,312553,0,2,4
89547,5,1,312556,312556,312557,0,1,3
89548,5,2,312561,312561,312563,0,2,4
89549,3,3,312564,312564,312567,0,3,1
89550,3,3,312567,312567,312570,0,3,0
89551,3,3,312570,312570,312573,0,3,0
89552,6,1,312576,312576,312577,0,1,3
89553,1,2,312577,312577,312579,0,2,0
89554,4,1,312581,312581,312582,0,1,2
89555,5,1,312586,312586,312587,0,1,4
89556,5,3,312591,312591,312594,0,3,4
89557,1,1,312592,312594,312595,2,3,0
89558,1,3,312593,312595,312598,2,5,0
89559,3,2,312596,312598,312600,2,4,0
89560,1,3,312597,312600,312603,3,6,0
89561,3,1,312600,312603,312604,3,4,0
89562,3,1,312603,312604,312605,1,2,0
89563,1,3,312604,312605,312608,1,4,0
89564,5,3,312609,312609,312612,0,3,1
89565,3,1,312612,312612,312613,0,1,0
89566,2,3,312614,312614,312617,0,3,1
89567,6,3,312620,312620,312623,0,3,3
89568,5,2,312625,312625,312627,0,2,2
89569,1,1,312626,312627,312628,1,2,0
89570,1,3,312627,312628,312631,1,4,0
89571,2,3,312629,312631,312634,2,5,0
89572,1,2,312630,312634,312636,4,6,0
89573,3,3,312633,312636,312639,3,6,0
89574,1,1,312634,312639,312640,5,6,0
89575,3,3,312637,312640,312643,3,6,0
89576,2,3,312639,312643,312646,4,7,0
89577,6,2,312645,312646,312648,1,3,0
89578,1,3,312646,312648,312651,2,5,0
89579,2,1,312648,312651,312652,3,4,0
89580,4,3,312652,312652,312655,0,3,0
89581,6,2,312658,312658,312660,0,2,3
89582,3,1,312661,312661,312662,0,1,1
89583,3,2,312664,312664,312666,0,2,2
89584,4,2,312668,312668,312670,0,2,2
89585,6,2,312674,312674,312676,0,2,4
89586,3,2,312677,312677,312679,0,2,1
89587,4,3,312681,312681,312684,0,3,2
89588,6,1,312687,312687,312688,0,1,3
89589,4,1,312691,312691,312692,0,1,3
89590,2,1,312693,312693,312694,0,1,1
89591,2,3,312695,312695,312698,0,3,1
89592,5,1,312700,312700,312701,0,1,2
89593,6,2,312706,312706,312708,0,2,5
89594,6,1,312712,312712,312713,0,1,4
89595,4,2,312716,312716,312718,0,2,3
89596,2,2,312718,312718,312720,0,2,0
89597,3,3,312721,312721,312724,0,3,1
89598,6,2,312727,312727,312729,0,2,3
89599,4,3,312731,312731,312734,0,3,2
89600,5,3,312736,312736,312739,0,3,2
89601,1,2,312737,312739,312741,2,4,0
89602,4,1,312741,312741,312742,0,1,0
89603,2,2,312743,312743,312745,0,2,1
89604,4,1,312747,312747,312748,0,1,2
89605,1,2,312748,312748,312750,0,2,0
89606,2,2,312750,312750,312752,0,2,0
89607,6,3,312756,312756,312759,0,3,4
89608,1,1,312757,312759,312760,2,3,0
89609,6,1,312763,312763,312764,0,1,3
89610,2,1,312765,312765,312766,0,1,1
89611,6,2,312771,312771,312773,0,2,5
89612,6,1,312777,312777,312778,0,1,4
89613,4,2,312781,312781,312783,0,2,3
89614,5,3,312786,312786,312789,0,3,3
89615,2,1,312788,312789,312790,1,2,0
89616,1,3,312789,312790,312793,1,4,0
89617,3,1,312792,312793,312794,1,2,0
89618,5,1,312797,312797,312798,0,1,3
89619,1,1,312798,312798,312799,0,1,0
89620,3,3,312801,312801,312804,0,3,2
89621,2,2,312803,312804,312806,1,3,0
89622,2,3,312805,312806,312809,1,4,0
89623,1,1,312806,312809,312810,3,4,0
89624,2,2,312808,312810,312812,2,4,0
89625,1,2,312809,312812,312814,3,5,0
89626,1,2,312810,312814,312816,4,6,0
89627,3,1,312813,312816,312817,3,4,0
89628,4,1,312817,312817,312818,0,1,0
89629,2,3,312819,312819,312822,0,3,1
89630,3,2,312822,312822,312824,0,2,0
89631,4,3,312826,312826,312829,0,3,2
89632,1,1,312827,312829,312830,2,3,0
89633,1,1,312828,312830,312831,2,3,0
89634,1,2,312829,312831,312833,2,4,0
89635,5,3,312834,312834,312837,0,3,1
89636,4,2,312838,312838,312840,0,2,1
89637,6,1,312844,312844,312845,0,1,4
89638,3,1,312847,312847,312848,0,1,2
89639,6,3,312853,312853,312856,0,3,5
89640,4,1,312857,312857,312858,0,1,1
89641,6,3,312863,312863,312866,0,3,5
89642,5,2,312868,312868,312870,0,2,2
89643,5,2,312873,312873,312875,0,2,3
89644,4,1,312877,312877,312878,0,1,2
89645,6,3,312883,312883,312886,0,3,5
89646,6,3,312889,312889,312892,0,3,3
89647,2,1,312891,312892,312893,1,2,0
89648,1,1,312892,312893,312894,1,2,0
89649,5,1,312897,312897,312898,0,1,3
89650,6,1,312903,312903,312904,0,1,5
89651,1,2,312904,312904,312906,0,2,0
89652,3,1,312907,312907,312908,0,1,1
89653,4,1,312911,312911,312912,0,1,3
89654,4,1,312915,312915,312916,0,1,3
89655,3,2,312918,312918,312920,0,2,2
89656,4,2,312922,312922,312924,0,2,2
89657,2,3,312924,312924,312927,0,3,0
89658,4,2,312928,312928,312930,0,2,1
89659,4,1,312932,312932,312933,0,1,2
89660,5,2,312937,312937,312939,0,2,4
89661,2,1,312939,312939,312940,0,1,0
89662,1,1,312940,312940,312941,0,1,0
89663,4,3,312944,312944,312947,0,3,3
89664,2,2,312946,312947,312949,1,3,0
89665,4,2,312950,312950,312952,0,2,1
89666,1,1,312951,312952,312953,1,2,0
89667,3,2,312954,312954,312956,0,2,1
89668,6,1,312960,312960,312961,0,1,4
89669,2,2,312962,312962,312964,0,2,1
89670,6,1,312968,312968,312969,0,1,4
89671,6,1,312974,312974,312975,0,1,5
89672,2,2,312976,312976,312978,0,2,1
89673,4,2,312980,312980,312982,0,2,2
89674,1,2,312981,312982,312984,1,3,0
89675,1,2,312982,312984,312986,2,4,0
89676,4,1,312986,312986,312987,0,1,0
89677,2,1,312988,312988,312989,0,1,1
89678,1,3,312989,312989,312992,0,3,0
89679,2,3,312991,312992,312995,1,4,0
89680,6,3,312997,312997,313000,0,3,2
89681,4,1,313001,313001,313002,0,1,1
89682,6,3,313007,313007,313010,0,3,5
89683,6,3,313013,313013,313016,0,3,3
89684,3,2,313016,313016,313018,0,2,0
89685,5,1,313021,313021,313022,0,1,3
89686,5,2,313026,313026,313028,0,2,4
89687,4,1,313030,313030,313031,0,1,2
89688,3,1,313033,313033,313034,0,1,2
89689,3,2,313036,313036,313038,0,2,2
89690,3,1,313039,313039,313040,0,1,1
89691,6,2,313045,313045,313047,0,2,5
89692,2,3,313047,313047,313050,0,3,0
89693,2,2,313049,313050,313052,1,3,0
89694,3,2,313052,313052,313054,0,2,0
89695,4,3,313056,313056,313059,0,3,2
89696,5,1,313061,313061,313062,0,1,2
89697,3,2,313064,313064,313066,0,2,2
89698,4,1,313068,313068,313069,0,1,2
89699,5,1,313073,313073,313074,0,1,4
89700,3,3,313076,313076,313079,0,3,2
89701,2,2,313078,313079,313081,1,3,0
89702,1,2,313079,313081,313083,2,4,0
89703,5,3,313084,313084,313087,0,3,1
89704,4,1,313088,313088,313089,0,1,1
89705,6,1,313094,313094,313095,0,1,5
89706,3,3,313097,313097,313100,0,3,2
89707,5,3,313102,313102,313105,0,3,2
89708,5,2,313107,313107,313109,0,2,2
89709,6,3,313113,313113,313116,0,3,4
89710,5,1,313118,313118,313119,0,1,2
89711,2,2,313120,313120,313122,0,2,1
89712,2,2,313122,313122,313124,0,2,0
89713,6,1,313128,313128,313129,0,1,4
89714,1,1,313129,313129,313130,0,1,0
89715,4,2,313133,313133,313135,0,2,3
89716,1,3,313134,313135,313138,1,4,0
89717,4,3,313138,313138,313141,0,3,0
89718,6,3,313144,313144,313147,0,3,3
89719,6,3,313150,313150,313153,0,3,3
89720,5,1,313155,313155,313156,0,1,2
89721,1,1,313156,313156,313157,0,1,0
89722,2,1,313158,313158,313159,0,1,1
89723,2,2,313160,313160,313162,0,2,1
89724,3,3,313163,313163,313166,0,3,1
89725,1,3,313164,313166,313169,2,5,0
89726,2,1,313166,313169,313170,3,4,0
89727,4,1,313170,313170,313171,0,1,0
89728,2,2,313172,313172,313174,0,2,1
89729,6,2,313178,313178,313180,0,2,4
89730,3,3,313181,313181,313184,0,3,1
89731,6,3,313187,313187,313190,0,3,3
89732,6,1,313193,313193,313194,0,1,3
89733,1,3,313194,313194,313197,0,3,0
89734,5,2,313199,313199,313201,0,2,2
89735,3,3,313202,313202,313205,0,3,1
89736,1,2,313203,313205,313207,2,4,0
89737,1,3,313204,313207,313210,3,6,0
89738,4,1,313208,313210,313211,2,3,0
89739,5,2,313213,313213,313215,0,2,2
89740,2,3,313215,313215,313218,0,3,0
89741,1,1,313216,313218,313219,2,3,0
89742,1,3,313217,313219,313222,2,5,0
89743,5,1,313222,313222,313223,0,1,0
89744,5,2,313227,313227,313229,0,2,4
89745,2,2,313229,313229,313231,0,2,0
89746,6,3,313235,313235,313238,0,3,4
89747,1,2,313236,313238,313240,2,4,0
89748,5,1,313241,313241,313242,0,1,1
89749,2,1,313243,313243,313244,0,1,1
89750,6,2,313249,313249,313251,0,2,5
89751,5,2,313254,313254,313256,0,2,3
89752,2,2,313256,313256,313258,0,2,0
89753,6,3,313262,313262,313265,0,3,4
89754,4,1,313266,313266,313267,0,1,1
89755,3,2,313269,313269,313271,0,2,2
89756,6,1,313275,313275,313276,0,1,4
89757,6,1,313281,313281,313282,0,1,5
89758,4,3,313285,313285,313288,0,3,3
89759,5,2,313290,313290,313292,0,2,2
89760,1,3,313291,313292,313295,1,4,0
89761,4,1,313295,313295,313296,0,1,0
89762,1,1,313296,313296,313297,0,1,0
89763,6,1,313302,313302,313303,0,1,5
89764,6,2,313308,313308,313310,0,2,5
89765,5,2,313313,313313,313315,0,2,3
89766,6,2,313319,313319,313321,0,2,4
89767,5,3,313324,313324,313327,0,3,3
89768,3,1,313327,313327,313328,0,1,0
89769,5,2,313332,313332,313334,0,2,4
89770,5,3,313337,313337,313340,0,3,3
89771,4,1,313341,313341,313342,0,1,1
89772,3,1,313344,313344,313345,0,1,2
89773,3,3,313347,313347,313350,0,3,2
89774,6,1,313353,313353,313354,0,1,3
89775,3,3,313356,313356,313359,0,3,2
89776,1,3,313357,313359,313362,2,5,0
89777,3,2,313360,313362,313364,2,4,0
89778,2,3,313362,313364,313367,2,5,0
89779,6,1,313368,313368,313369,0,1,1
89780,3,3,313371,313371,313374,0,3,2
89781,2,2,313373,313374,313376,1,3,0
89782,4,2,313377,313377,313379,0,2,1
89783,3,1,313380,313380,313381,0,1,1
89784,5,3,313385,313385,313388,0,3,4
89785,2,3,313387,313388,313391,1,4,0
89786,3,1,313390,313391,313392,1,2,0
89787,2,1,313392,313392,313393,0,1,0
89788,6,3,313398,313398,313401,0,3,5
89789,3,3,313401,313401,313404,0,3,0
89790,6,3,313407,313407,313410,0,3,3
89791,1,3,313408,313410,313413,2,5,0
89792,6,2,313414,313414,313416,0,2,1
89793,6,2,313420,313420,313422,0,2,4
89794,3,1,313423,313423,313424,0,1,1
89795,3,3,313426,313426,313429,0,3,2
89796,5,1,313431,313431,313432,0,1,2
89797,3,3,313434,313434,313437,0,3,2
89798,1,3,313435,313437,313440,2,5,0
89799,6,1,313441,313441,313442,0,1,1
89800,4,3,313445,313445,313448,0,3,3
89801,4,3,313449,313449,313452,0,3,1
89802,3,2,313452,313452,313454,0,2,0
89803,3,2,313455,313455,313457,0,2,1
89804,5,3,313460,313460,313463,0,3,3
89805,6,2,313466,313466,313468,0,2,3
89806,2,3,313468,313468,313471,0,3,0
89807,5,2,313473,313473,313475,0,2,2
89808,6,1,313479,313479,313480,0,1,4
89809,2,1,313481,313481,313482,0,1,1
89810,2,1,313483,313483,313484,0,1,1
89811,4,1,313487,313487,313488,0,1,3
89812,4,3,313491,313491,313494,0,3,3
89813,5,3,313496,313496,313499,0,3,2
89814,2,2,313498,313499,313501,1,3,0
89815,5,1,313503,313503,313504,0,1,2
89816,6,2,313509,313509,313511,0,2,5
89817,6,1,313515,313515,313516,0,1,4
89818,4,1,313519,313519,313520,0,1,3
89819,6,1,313525,313525,313526,0,1,5
89820,2,2,313527,313527,313529,0,2,1
89821,4,2,313531,313531,313533,0,2,2
89822,2,3,313533,313533,313536,0,3,0
89823,3,3,313536,313536,313539,0,3,0
89824,3,2,313539,313539,313541,0,2,0
89825,4,1,313543,313543,313544,0,1,2
89826,5,2,313548,313548,313550,0,2,4
89827,1,1,313549,313550,313551,1,2,0
89828,4,3,313553,313553,313556,0,3,2
89829,1,3,313554,313556,313559,2,5,0
89830,5,2,313559,313559,313561,0,2,0
89831,3,1,313562,313562,313563,0,1,1
89832,1,2,313563,313563,313565,0,2,0
89833,5,2,313568,313568,313570,0,2,3
89834,3,2,313571,313571,313573,0,2,1
89835,1,2,313572,313573,313575,1,3,0
89836,2,3,313574,313575,313578,1,4,0
89837,3,3,313577,313578,313581,1,4,0
89838,2,2,313579,313581,313583,2,4,0
89839,3,3,313582,313583,313586,1,4,0
89840,1,1,313583,313586,313587,3,4,0
89841,2,2,313585,313587,313589,2,4,0
89842,5,1,313590,313590,313591,0,1,1
89843,5,3,313595,313595,313598,0,3,4
89844,6,3,313601,313601,313604,0,3,3
89845,4,2,313605,313605,313607,0,2,1
89846,4,3,313609,313609,313612,0,3,2
89847,5,3,313614,313614,313617,0,3,2
89848,3,2,313617,313617,313619,0,2,0
89849,2,2,313619,313619,313621,0,2,0
89850,4,2,313623,313623,313625,0,2,2
89851,4,3,313627,313627,313630,0,3,2
89852,1,2,313628,313630,313632,2,4,0
89853,5,2,313633,313633,313635,0,2,1
89854,4,2,313637,313637,313639,0,2,2
89855,3,2,313640,313640,313642,0,2,1
89856,6,3,313646,313646,313649,0,3,4
89857,5,1,313651,313651,313652,0,1,2
89858,6,1,313657,313657,313658,0,1,5
89859,2,1,313659,313659,313660,0,1,1
89860,3,3,313662,313662,313665,0,3,2
89861,1,2,313663,313665,313667,2,4,0
89862,3,2,313666,313667,313669,1,3,0
89863,1,2,313667,313669,313671,2,4,0
89864,1,1,313668,313671,313672,3,4,0
89865,4,2,313672,313672,313674,0,2,0
89866,1,3,313673,313674,313677,1,4,0
89867,5,2,313678,313678,313680,0,2,1
89868,1,1,313679,313680,313681,1,2,0
89869,6,3,313685,313685,313688,0,3,4
89870,1,3,313686,313688,313691,2,5,0
89871,3,3,313689,313691,313694,2,5,0
89872,3,1,313692,313694,313695,2,3,0
89873,2,1,313694,313695,313696,1,2,0
89874,5,2,313699,313699,313701,0,2,3
89875,3,2,313702,313702,313704,0,2,1
89876,4,3,313706,313706,313709,0,3,2
89877,4,1,313710,313710,313711,0,1,1
89878,3,2,313713,313713,313715,0,2,2
89879,5,1,313718,313718,313719,0,1,3
89880,5,3,313723,313723,313726,0,3,4
89881,1,1,313724,313726,313727,2,3,0
89882,3,2,313727,313727,313729,0,2,0
89883,2,1,313729,313729,313730,0,1,0
89884,3,3,313732,313732,313735,0,3,2
89885,1,2,313733,313735,313737,2,4,0
89886,4,3,313737,313737,313740,0,3,0
89887,3,1,313740,313740,313741,0,1,0
89888,4,2,313744,313744,313746,0,2,3
89889,5,3,313749,313749,313752,0,3,3
89890,5,2,313754,313754,313756,0,2,2
89891,1,1,313755,313756,313757,1,2,0
89892,4,1,313759,313759,313760,0,1,2
89893,3,2,313762,313762,313764,0,2,2
89894,5,1,313767,313767,313768,0,1,3
89895,4,2,313771,313771,313773,0,2,3
89896,3,2,313774,313774,313776,0,2,1
89897,5,3,313779,313779,313782,0,3,3
89898,4,3,313783,313783,313786,0,3,1
89899,3,2,313786,313786,313788,0,2,0
89900,3,1,313789,313789,313790,0,1,1
89901,3,2,313792,313792,313794,0,2,2
89902,2,3,313794,313794,313797,0,3,0
89903,1,2,313795,313797,313799,2,4,0
89904,6,2,313801,313801,313803,0,2,2
89905,4,3,313805,313805,313808,0,3,2
89906,4,2,313809,313809,313811,0,2,1
89907,5,1,313814,313814,313815,0,1,3
89908,2,3,313816,313816,313819,0,3,1
89909,4,3,313820,313820,313823,0,3,1
89910,2,3,313822,313823,313826,1,4,0
89911,3,1,313825,313826,313827,1,2,0
89912,3,3,313828,313828,313831,0,3,1
89913,2,2,313830,313831,313833,1,3,0
89914,4,3,313834,313834,313837,0,3,1
89915,1,1,313835,313837,313838,2,3,0
89916,5,1,313840,313840,313841,0,1,2
89917,4,2,313844,313844,313846,0,2,3
89918,1,3,313845,313846,313849,1,4,0
89919,5,1,313850,313850,313851,0,1,1
89920,2,2,313852,313852,313854,0,2,1
89921,4,3,313856,313856,313859,0,3,2
89922,5,1,313861,313861,313862,0,1,2
89923,1,3,313862,313862,313865,0,3,0
89924,3,3,313865,313865,313868,0,3,0
89925,2,1,313867,313868,313869,1,2,0
89926,2,1,313869,313869,313870,0,1,0
89927,3,2,313872,313872,313874,0,2,2
89928,2,3,313874,313874,313877,0,3,0
89929,6,2,313880,313880,313882,0,2,3
89930,5,2,313885,313885,313887,0,2,3
89931,4,3,313889,313889,313892,0,3,2
89932,4,3,313893,313893,313896,0,3,1
89933,4,1,313897,313897,313898,0,1,1
89934,2,3,313899,313899,313902,0,3,1
89935,4,1,313903,313903,313904,0,1,1
89936,5,3,313908,313908,313911,0,3,4
89937,6,2,313914,313914,313916,0,2,3
89938,3,1,313917,313917,313918,0,1,1
89939,3,3,313920,313920,313923,0,3,2
89940,4,2,313924,313924,313926,0,2,1
89941,5,2,313929,313929,313931,0,2,3
89942,6,1,313935,313935,313936,0,1,4
89943,3,1,313938,313938,313939,0,1,2
89944,2,1,313940,313940,313941,0,1,1
89945,4,2,313944,313944,313946,0,2,3
89946,4,3,313948,313948,313951,0,3,2
89947,3,1,313951,313951,313952,0,1,0
89948,4,1,313955,313955,313956,0,1,3
89949,3,1,313958,313958,313959,0,1,2
89950,1,2,313959,313959,313961,0,2,0
89951,4,1,313963,313963,313964,0,1,2
89952,2,1,313965,313965,313966,0,1,1
89953,5,2,313970,313970,313972,0,2,4
89954,5,3,313975,313975,313978,0,3,3
89955,6,3,313981,313981,313984,0,3,3
89956,2,1,313983,313984,313985,1,2,0
89957,2,1,313985,313985,313986,0,1,0
89958,2,1,313987,313987,313988,0,1,1
89959,5,1,313992,313992,313993,0,1,4
89960,5,3,313997,313997,314000,0,3,4
89961,5,3,314002,314002,314005,0,3,2
89962,4,3,314006,314006,314009,0,3,1
89963,1,3,314007,314009,314012,2,5,0
89964,1,2,314008,314012,314014,4,6,0
89965,6,2,314014,314014,314016,0,2,0
89966,5,1,314019,314019,314020,0,1,3
89967,3,1,314022,314022,314023,0,1,2
89968,5,1,314027,314027,314028,0,1,4
89969,3,3,314030,314030,314033,0,3,2
89970,1,2,314031,314033,314035,2,4,0
89971,5,2,314036,314036,314038,0,2,1
89972,1,2,314037,314038,314040,1,3,0
89973,6,3,314043,314043,314046,0,3,3
89974,2,1,314045,314046,314047,1,2,0
89975,6,3,314051,314051,314054,0,3,4
89976,5,3,314056,314056,314059,0,3,2
89977,5,3,314061,314061,314064,0,3,2
89978,6,2,314067,314067,314069,0,2,3
89979,2,3,314069,314069,314072,0,3,0
89980,6,2,314075,314075,314077,0,2,3
89981,4,2,314079,314079,314081,0,2,2
89982,1,1,314080,314081,314082,1,2,0
89983,4,3,314084,314084,314087,0,3,2
89984,5,3,314089,314089,314092,0,3,2
89985,5,1,314094,314094,314095,0,1,2
89986,5,1,314099,314099,314100,0,1,4
89987,4,2,314103,314103,314105,0,2,3
89988,6,3,314109,314109,314112,0,3,4
89989,1,3,314110,314112,314115,2,5,0
89990,5,3,314115,314115,314118,0,3,0
89991,1,1,314116,314118,314119,2,3,0
89992,1,2,314117,314119,314121,2,4,0
89993,3,3,314120,314121,314124,1,4,0
89994,6,1,314126,314126,314127,0,1,2
89995,6,1,314132,314132,314133,0,1,5
89996,4,1,314136,314136,314137,0,1,3
89997,5,3,314141,314141,314144,0,3,4
89998,4,2,314145,314145,314147,0,2,1
89999,1,3,314146,314147,314150,1,4,0
90000,4,2,314150,314150,314152,0,2,0
90001,6,3,314156,314156,314159,0,3,4
90002,2,2,314158,314159,314161,1,3,0
90003,5,2,314163,314163,314165,0,2,2
90004,1,1,314164,314165,314166,1,2,0
90005,1,1,314165,314166,314167,1,2,0
90006,3,3,314168,314168,314171,0,3,1
90007,1,3,314169,314171,314174,2,5,0
90008,3,3,314172,314174,314177,2,5,0
90009,4,2,314176,314177,314179,1,3,0
90010,4,1,314180,314180,314181,0,1,1
90011,1,1,314181,314181,314182,0,1,0
90012,5,1,314186,314186,314187,0,1,4
90013,3,1,314189,314189,314190,0,1,2
90014,5,3,314194,314194,314197,0,3,4
90015,3,1,314197,314197,314198,0,1,0
90016,1,3,314198,314198,314201,0,3,0
90017,6,1,314204,314204,314205,0,1,3
90018,1,2,314205,314205,314207,0,2,0
90019,2,3,314207,314207,314210,0,3,0
90020,4,3,314211,314211,314214,0,3,1
90021,6,2,314217,314217,314219,0,2,3
90022,2,2,314219,314219,314221,0,2,0
90023,4,3,314223,314223,314226,0,3,2
90024,1,2,314224,314226,314228,2,4,0
90025,3,2,314227,314228,314230,1,3,0
90026,5,2,314232,314232,314234,0,2,2
90027,2,1,314234,314234,314235,0,1,0
90028,6,2,314240,314240,314242,0,2,5
90029,2,1,314242,314242,314243,0,1,0
90030,2,2,314244,314244,314246,0,2,1
90031,2,1,314246,314246,314247,0,1,0
90032,6,2,314252,314252,314254,0,2,5
90033,6,3,314258,314258,314261,0,3,4
90034,1,1,314259,314261,314262,2,3,0
90035,4,3,314263,314263,314266,0,3,1
90036,3,3,314266,314266,314269,0,3,0
90037,1,2,314267,314269,314271,2,4,0
90038,5,2,314272,314272,314274,0,2,1
90039,1,1,314273,314274,314275,1,2,0
90040,4,2,314277,314277,314279,0,2,2
90041,1,2,314278,314279,314281,1,3,0
90042,6,3,314284,314284,314287,0,3,3
90043,3,1,314287,314287,314288,0,1,0
90044,3,3,314290,314290,314293,0,3,2
90045,3,2,314293,314293,314295,0,2,0
90046,3,1,314296,314296,314297,0,1,1
90047,1,1,314297,314297,314298,0,1,0
90048,1,2,314298,314298,314300,0,2,0
90049,1,2,314299,314300,314302,1,3,0
90050,3,2,314302,314302,314304,0,2,0
90051,2,2,314304,314304,314306,0,2,0
90052,6,2,314310,314310,314312,0,2,4
90053,1,1,314311,314312,314313,1,2,0
90054,4,2,314315,314315,314317,0,2,2
90055,6,1,314321,314321,314322,0,1,4
90056,6,3,314327,314327,314330,0,3,5
90057,2,1,314329,314330,314331,1,2,0
90058,6,1,314335,314335,314336,0,1,4
90059,4,3,314339,314339,314342,0,3,3
90060,6,2,314345,314345,314347,0,2,3
90061,2,3,314347,314347,314350,0,3,0
90062,2,1,314349,314350,314351,1,2,0
90063,1,3,314350,314351,314354,1,4,0
90064,3,2,314353,314354,314356,1,3,0
90065,4,3,314357,314357,314360,0,3,1
90066,2,3,314359,314360,314363,1,4,0
90067,4,3,314363,314363,314366,0,3,0
90068,5,2,314368,314368,314370,0,2,2
90069,2,3,314370,314370,314373,0,3,0
90070,4,3,314374,314374,314377,0,3,1
90071,4,2,314378,314378,314380,0,2,1
90072,4,1,314382,314382,314383,0,1,2
90073,4,1,314386,314386,314387,0,1,3
90074,1,1,314387,314387,314388,0,1,0
90075,4,2,314391,314391,314393,0,2,3
90076,2,3,314393,314393,314396,0,3,0
90077,5,3,314398,314398,314401,0,3,2
90078,2,1,314400,314401,314402,1,2,0
90079,6,2,314406,314406,314408,0,2,4
90080,1,3,314407,314408,314411,1,4,0
90081,4,3,314411,314411,314414,0,3,0
90082,1,2,314412,314414,314416,2,4,0
90083,4,2,314416,314416,314418,0,2,0
90084,5,3,314421,314421,314424,0,3,3
90085,2,1,314423,314424,314425,1,2,0
90086,1,3,314424,314425,314428,1,4,0
90087,4,2,314428,314428,314430,0,2,0
90088,1,1,314429,314430,314431,1,2,0
90089,2,1,314431,314431,314432,0,1,0
90090,6,2,314437,314437,314439,0,2,5
90091,6,3,314443,314443,314446,0,3,4
90092,4,1,314447,314447,314448,0,1,1
90093,1,1,314448,314448,314449,0,1,0
90094,2,1,314450,314450,314451,0,1,1
90095,4,3,314454,314454,314457,0,3,3
90096,4,2,314458,314458,314460,0,2,1
90097,5,2,314463,314463,314465,0,2,3
90098,3,2,314466,314466,314468,0,2,1
90099,2,2,314468,314468,314470,0,2,0
90100,5,3,314473,314473,314476,0,3,3
90101,4,3,314477,314477,314480,0,3,1
90102,3,3,314480,314480,314483,0,3,0
90103,1,1,314481,314483,314484,2,3,0
90104,6,1,314487,314487,314488,0,1,3
90105,4,1,314491,314491,314492,0,1,3
90106,3,1,314494,314494,314495,0,1,2
90107,2,1,314496,314496,314497,0,1,1
90108,6,1,314502,314502,314503,0,1,5
90109,5,1,314507,314507,314508,0,1,4
90110,1,2,314508,314508,314510,0,2,0
90111,2,1,314510,314510,314511,0,1,0
90112,6,2,314516,314516,314518,0,2,5
90113,5,1,314521,314521,314522,0,1,3
90114,5,2,314526,314526,314528,0,2,4
90115,3,3,314529,314529,314532,0,3,1
90116,2,3,314531,314532,314535,1,4,0
90117,6,1,314537,314537,314538,0,1,2
90118,1,3,314538,314538,314541,0,3,0
90119,6,3,314544,314544,314547,0,3,3
90120,3,1,314547,314547,314548,0,1,0
90121,6,2,314553,314553,314555,0,2,5
90122,2,3,314555,314555,314558,0,3,0
90123,6,3,314561,314561,314564,0,3,3
90124,6,2,314567,314567,314569,0,2,3
90125,5,2,314572,314572,314574,0,2,3
90126,5,3,314577,314577,314580,0,3,3
90127,2,3,314579,314580,314583,1,4,0
90128,2,3,314581,314583,314586,2,5,0
90129,3,2,314584,314586,314588,2,4,0
90130,1,3,314585,314588,314591,3,6,0
90131,3,1,314588,314591,314592,3,4,0
90132,5,3,314593,314593,314596,0,3,1
90133,2,3,314595,314596,314599,1,4,0
90134,6,1,314601,314601,314602,0,1,2
90135,4,2,314605,314605,314607,0,2,3
90136,2,2,314607,314607,314609,0,2,0
90137,1,2,314608,314609,314611,1,3,0
90138,2,3,314610,314611,314614,1,4,0
90139,6,1,314616,314616,314617,0,1,2
90140,3,3,314619,314619,314622,0,3,2
90141,1,3,314620,314622,314625,2,5,0
90142,6,3,314626,314626,314629,0,3,1
90143,4,1,314630,314630,314631,0,1,1
90144,1,3,314631,314631,314634,0,3,0
90145,3,1,314634,314634,314635,0,1,0
90146,5,1,314639,314639,314640,0,1,4
90147,4,2,314643,314643,314645,0,2,3
90148,5,1,314648,314648,314649,0,1,3
90149,4,3,314652,314652,314655,0,3,3
90150,4,1,314656,314656,314657,0,1,1
90151,1,2,314657,314657,314659,0,2,0
90152,5,3,314662,314662,314665,0,3,3
90153,4,1,314666,314666,314667,0,1,1
90154,6,1,314672,314672,314673,0,1,5
90155,6,3,314678,314678,314681,0,3,5
90156,5,1,314683,314683,314684,0,1,2
90157,2,1,314685,314685,314686,0,1,1
90158,6,2,314691,314691,314693,0,2,5
90159,1,3,314692,314693,314696,1,4,0
90160,1,3,314693,314696,314699,3,6,0
90161,2,3,314695,314699,314702,4,7,0
90162,3,3,314698,314702,314705,4,7,0
90163,2,3,314700,314705,314708,5,8,0
90164,5,1,314705,314708,314709,3,4,0
90165,2,1,314707,314709,314710,2,3,0
90166,1,2,314708,314710,314712,2,4,0
90167,3,2,314711,314712,314714,1,3,0
90168,3,3,314714,314714,314717,0,3,0
90169,1,3,314715,314717,314720,2,5,0
90170,3,2,314718,314720,314722,2,4,0
90171,6,1,314724,314724,314725,0,1,2
90172,6,1,314730,314730,314731,0,1,5
90173,1,2,314731,314731,314733,0,2,0
90174,6,2,314737,314737,314739,0,2,4
90175,6,2,314743,314743,314745,0,2,4
90176,3,3,314746,314746,314749,0,3,1
90177,5,2,314751,314751,314753,0,2,2
90178,1,1,314752,314753,314754,1,2,0
90179,5,2,314757,314757,314759,0,2,3
90180,6,2,314763,314763,314765,0,2,4
90181,2,3,314765,314765,314768,0,3,0
90182,3,1,314768,314768,314769,0,1,0
90183,1,1,314769,314769,314770,0,1,0
90184,1,2,314770,314770,314772,0,2,0
90185,1,3,314771,314772,314775,1,4,0
90186,6,1,314777,314777,314778,0,1,2
90187,6,1,314783,314783,314784,0,1,5
90188,6,3,314789,314789,314792,0,3,5
90189,6,2,314795,314795,314797,0,2,3
90190,3,1,314798,314798,314799,0,1,1
90191,4,3,314802,314802,314805,0,3,3
90192,1,3,314803,314805,314808,2,5,0
90193,5,3,314808,314808,314811,0,3,0
90194,1,2,314809,314811,314813,2,4,0
90195,4,3,314813,314813,314816,0,3,0
90196,4,3,314817,314817,314820,0,3,1
90197,5,2,314822,314822,314824,0,2,2
90198,6,1,314828,314828,314829,0,1,4
90199,2,1,314830,314830,314831,0,1,1
90200,3,3,314833,314833,314836,0,3,2
90201,2,3,314835,314836,314839,1,4,0
90202,4,2,314839,314839,314841,0,2,0
90203,4,1,314843,314843,314844,0,1,2
90204,6,2,314849,314849,314851,0,2,5
90205,5,1,314854,314854,314855,0,1,3
90206,5,1,314859,314859,314860,0,1,4
90207,4,2,314863,314863,314865,0,2,3
90208,1,3,314864,314865,314868,1,4,0
90209,3,3,314867,314868,314871,1,4,0
90210,6,3,314873,314873,314876,0,3,2
90211,4,3,314877,314877,314880,0,3,1
90212,3,1,314880,314880,314881,0,1,0
90213,1,2,314881,314881,314883,0,2,0
90214,4,2,314885,314885,314887,0,2,2
90215,4,3,314889,314889,314892,0,3,2
90216,5,2,314894,314894,314896,0,2,2
90217,5,1,314899,314899,314900,0,1,3
90218,4,1,314903,314903,314904,0,1,3
90219,6,3,314909,314909,314912,0,3,5
90220,5,2,314914,314914,314916,0,2,2
90221,2,3,314916,314916,314919,0,3,0
90222,6,3,314922,314922,314925,0,3,3
90223,4,3,314926,314926,314929,0,3,1
90224,3,1,314929,314929,314930,0,1,0
90225,1,1,314930,314930,314931,0,1,0
90226,5,1,314935,314935,314936,0,1,4
90227,6,1,314941,314941,314942,0,1,5
90228,1,2,314942,314942,314944,0,2,0
90229,2,3,314944,314944,314947,0,3,0
90230,3,1,314947,314947,314948,0,1,0
90231,4,1,314951,314951,314952,0,1,3
90232,4,3,314955,314955,314958,0,3,3
90233,4,3,314959,314959,314962,0,3,1
90234,2,1,314961,314962,314963,1,2,0
90235,3,3,314964,314964,314967,0,3,1
90236,6,1,314970,314970,314971,0,1,3
90237,1,3,314971,314971,314974,0,3,0
90238,3,1,314974,314974,314975,0,1,0
90239,4,2,314978,314978,314980,0,2,3
90240,2,2,314980,314980,314982,0,2,0
90241,6,2,314986,314986,314988,0,2,4
90242,4,2,314990,314990,314992,0,2,2
90243,5,2,314995,314995,314997,0,2,3
90244,3,3,314998,314998,315001,0,3,1
90245,5,2,315003,315003,315005,0,2,2
90246,1,1,315004,315005,315006,1,2,0
90247,5,1,315009,315009,315010,0,1,3
90248,5,3,315014,315014,315017,0,3,4
90249,2,3,315016,315017,315020,1,4,0
90250,2,2,315018,315020,315022,2,4,0
90251,5,1,315023,315023,315024,0,1,1
90252,3,3,315026,315026,315029,0,3,2
90253,2,3,315028,315029,315032,1,4,0
90254,6,3,315034,315034,315037,0,3,2
90255,3,2,315037,315037,315039,0,2,0
90256,1,2,315038,315039,315041,1,3,0
90257,6,1,315044,315044,315045,0,1,3
90258,4,1,315048,315048,315049,0,1,3
90259,3,2,315051,315051,315053,0,2,2
90260,4,2,315055,315055,315057,0,2,2
90261,1,1,315056,315057,315058,1,2,0
90262,3,2,315059,315059,315061,0,2,1
90263,2,3,315061,315061,315064,0,3,0
90264,5,1,315066,315066,315067,0,1,2
90265,3,3,315069,315069,315072,0,3,2
90266,4,3,315073,315073,315076,0,3,1
90267,2,2,315075,315076,315078,1,3,0
90268,5,1,315080,315080,315081,0,1,2
90269,5,1,315085,315085,315086,0,1,4
90270,3,1,315088,315088,315089,0,1,2
90271,2,3,315090,315090,315093,0,3,1
90272,5,3,315095,315095,315098,0,3,2
90273,4,3,315099,315099,315102,0,3,1
90274,4,1,315103,315103,315104,0,1,1
90275,1,2,315104,315104,315106,0,2,0
90276,3,1,315107,315107,315108,0,1,1
90277,2,3,315109,315109,315112,0,3,1
90278,6,1,315115,315115,315116,0,1,3
90279,6,3,315121,315121,315124,0,3,5
90280,2,1,315123,315124,315125,1,2,0
90281,4,1,315127,315127,315128,0,1,2
90282,3,3,315130,315130,315133,0,3,2
90283,2,2,315132,315133,315135,1,3,0
90284,2,2,315134,315135,315137,1,3,0
90285,2,3,315136,315137,315140,1,4,0
90286,2,2,315138,315140,315142,2,4,0
90287,6,3,315144,315144,315147,0,3,2
90288,3,3,315147,315147,315150,0,3,0
90289,1,1,315148,315150,315151,2,3,0
90290,4,1,315152,315152,315153,0,1,1
90291,3,3,315155,315155,315158,0,3,2
90292,6,2,315161,315161,315163,0,2,3
90293,1,2,315162,315163,315165,1,3,0
90294,1,2,315163,315165,315167,2,4,0
90295,4,3,315167,315167,315170,0,3,0
90296,6,2,315173,315173,315175,0,2,3
90297,6,3,315179,315179,315182,0,3,4
90298,1,1,315180,315182,315183,2,3,0
90299,2,2,315182,315183,315185,1,3,0
90300,5,1,315187,315187,315188,0,1,2
90301,2,1,315189,315189,315190,0,1,1
90302,6,2,315195,315195,315197,0,2,5
90303,5,3,315200,315200,315203,0,3,3
90304,2,1,315202,315203,315204,1,2,0
90305,1,2,315203,315204,315206,1,3,0
90306,6,2,315209,315209,315211,0,2,3
90307,4,1,315213,315213,315214,0,1,2
90308,3,3,315216,315216,315219,0,3,2
90309,3,3,315219,315219,315222,0,3,0
90310,6,3,315225,315225,315228,0,3,3
90311,3,3,315228,315228,315231,0,3,0
90312,4,1,315232,315232,315233,0,1,1
90313,1,3,315233,315233,315236,0,3,0
90314,2,3,315235,315236,315239,1,4,0
90315,4,2,315239,315239,315241,0,2,0
90316,3,2,315242,315242,315244,0,2,1
90317,1,3,315243,315244,315247,1,4,0
90318,1,1,315244,315247,315248,3,4,0
90319,5,2,315249,315249,315251,0,2,1
90320,3,2,315252,315252,315254,0,2,1
90321,2,1,315254,315254,315255,0,1,0
90322,4,3,315258,315258,315261,0,3,3
90323,3,3,315261,315261,315264,0,3,0
90324,5,3,315266,315266,315269,0,3,2
90325,4,2,315270,315270,315272,0,2,1
90326,5,3,315275,315275,315278,0,3,3
90327,4,2,315279,315279,315281,0,2,1
90328,1,1,315280,315281,315282,1,2,0
90329,4,2,315284,315284,315286,0,2,2
90330,3,2,315287,315287,315289,0,2,1
90331,1,3,315288,315289,315292,1,4,0
90332,2,1,315290,315292,315293,2,3,0
90333,5,1,315295,315295,315296,0,1,2
90334,4,3,315299,315299,315302,0,3,3
90335,3,2,315302,315302,315304,0,2,0
90336,1,1,315303,315304,315305,1,2,0
90337,3,3,315306,315306,315309,0,3,1
90338,2,3,315308,315309,315312,1,4,0
90339,3,3,315311,315312,315315,1,4,0
90340,3,2,315314,315315,315317,1,3,0
90341,1,3,315315,315317,315320,2,5,0
90342,6,2,315321,315321,315323,0,2,1
90343,1,3,315322,315323,315326,1,4,0
90344,6,1,315328,315328,315329,0,1,2
90345,2,2,315330,315330,315332,0,2,1
90346,2,2,315332,315332,315334,0,2,0
90347,4,1,315336,315336,315337,0,1,2
90348,1,1,315337,315337,315338,0,1,0
90349,3,1,315340,315340,315341,0,1,2
90350,1,3,315341,315341,315344,0,3,0
90351,2,3,315343,315344,315347,1,4,0
90352,4,3,315347,315347,315350,0,3,0
90353,2,3,315349,315350,315353,1,4,0
90354,2,2,315351,315353,315355,2,4,0
90355,6,3,315357,315357,315360,0,3,2
90356,2,3,315359,315360,315363,1,4,0
90357,1,1,315360,315363,315364,3,4,0
90358,1,3,315361,315364,315367,3,6,0
90359,1,3,315362,315367,315370,5,8,0
90360,2,2,315364,315370,315372,6,8,0
90361,1,1,315365,315372,315373,7,8,0
90362,6,2,315371,315373,315375,2,4,0
90363,5,3,315376,315376,315379,0,3,1
90364,4,2,315380,315380,315382,0,2,1
90365,1,2,315381,315382,315384,1,3,0
90366,3,3,315384,315384,315387,0,3,0
90367,5,1,315389,315389,315390,0,1,2
90368,3,2,315392,315392,315394,0,2,2
90369,3,2,315395,315395,315397,0,2,1
90370,4,1,315399,315399,315400,0,1,2
90371,2,3,315401,315401,315404,0,3,1
90372,1,1,315402,315404,315405,2,3,0
90373,5,1,315407,315407,315408,0,1,2
90374,1,1,315408,315408,315409,0,1,0
90375,5,3,315413,315413,315416,0,3,4
90376,6,3,315419,315419,315422,0,3,3
90377,1,2,315420,315422,315424,2,4,0
90378,3,3,315423,315424,315427,1,4,0
90379,6,2,315429,315429,315431,0,2,2
90380,4,2,315433,315433,315435,0,2,2
90381,1,2,315434,315435,315437,1,3,0
90382,3,3,315437,315437,315440,0,3,0
90383,1,3,315438,315440,315443,2,5,0
90384,6,3,315444,315444,315447,0,3,1
90385,1,3,315445,315447,315450,2,5,0
90386,1,2,315446,315450,315452,4,6,0
90387,6,3,315452,315452,315455,0,3,0
90388,2,1,315454,315455,315456,1,2,0
90389,6,3,315460,315460,315463,0,3,4
90390,3,1,315463,315463,315464,0,1,0
90391,5,3,315468,315468,315471,0,3,4
90392,6,1,315474,315474,315475,0,1,3
90393,4,1,315478,315478,315479,0,1,3
90394,4,1,315482,315482,315483,0,1,3
90395,4,1,315486,315486,315487,0,1,3
90396,6,3,315492,315492,315495,0,3,5
90397,1,3,315493,315495,315498,2,5,0
90398,3,1,315496,315498,315499,2,3,0
90399,6,1,315502,315502,315503,0,1,3
90400,4,1,315506,315506,315507,0,1,3
90401,2,1,315508,315508,315509,0,1,1
90402,6,2,315514,315514,315516,0,2,5
90403,5,2,315519,315519,315521,0,2,3
90404,2,1,315521,315521,315522,0,1,0
90405,2,3,315523,315523,315526,0,3,1
90406,6,2,315529,315529,315531,0,2,3
90407,1,1,315530,315531,315532,1,2,0
90408,6,3,315536,315536,315539,0,3,4
90409,6,1,315542,315542,315543,0,1,3
90410,6,2,315548,315548,315550,0,2,5
90411,1,3,315549,315550,315553,1,4,0
90412,2,3,315551,315553,315556,2,5,0
90413,5,1,315556,315556,315557,0,1,0
90414,6,2,315562,315562,315564,0,2,5
90415,1,3,315563,315564,315567,1,4,0
90416,4,3,315567,315567,315570,0,3,0
90417,2,3,315569,315570,315573,1,4,0
90418,4,1,315573,315573,315574,0,1,0
90419,3,2,315576,315576,315578,0,2,2
90420,2,2,315578,315578,315580,0,2,0
90421,3,2,315581,315581,315583,0,2,1
90422,4,1,315585,315585,315586,0,1,2
90423,1,3,315586,315586,315589,0,3,0
90424,2,1,315588,315589,315590,1,2,0
90425,6,3,315594,315594,315597,0,3,4
90426,4,1,315598,315598,315599,0,1,1
90427,4,3,315602,315602,315605,0,3,3
90428,4,3,315606,315606,315609,0,3,1
90429,4,3,315610,315610,315613,0,3,1
90430,2,3,315612,315613,315616,1,4,0
90431,1,3,315613,315616,315619,3,6,0
90432,1,3,315614,315619,315622,5,8,0
90433,5,3,315619,315622,315625,3,6,0
90434,2,2,315621,315625,315627,4,6,0
90435,3,3,315624,315627,315630,3,6,0
90436,4,3,315628,315630,315633,2,5,0
90437,1,3,315629,315633,315636,4,7,0
90438,3,3,315632,315636,315639,4,7,0
90439,2,3,315634,315639,315642,5,8,0
90440,6,2,315640,315642,315644,2,4,0
90441,6,3,315646,315646,315649,0,3,2
90442,4,2,315650,315650,315652,0,2,1
90443,4,1,315654,315654,315655,0,1,2
90444,2,2,315656,315656,315658,0,2,1
90445,2,1,315658,315658,315659,0,1,0
90446,1,1,315659,315659,315660,0,1,0
90447,5,2,315664,315664,315666,0,2,4
90448,2,2,315666,315666,315668,0,2,0
90449,1,2,315667,315668,315670,1,3,0
90450,5,3,315672,315672,315675,0,3,2
90451,5,1,315677,315677,315678,0,1,2
90452,1,3,315678,315678,315681,0,3,0
90453,6,2,315684,315684,315686,0,2,3
90454,5,3,315689,315689,315692,0,3,3
90455,6,3,315695,315695,315698,0,3,3
90456,3,2,315698,315698,315700,0,2,0
90457,1,1,315699,315700,315701,1,2,0
90458,2,1,315701,315701,315702,0,1,0
90459,6,2,315707,315707,315709,0,2,5
90460,3,3,315710,315710,315713,0,3,1
90461,4,2,315714,315714,315716,0,2,1
90462,4,2,315718,315718,315720,0,2,2
90463,2,1,315720,315720,315721,0,1,0
90464,5,1,315725,315725,315726,0,1,4
90465,1,2,315726,315726,315728,0,2,0
90466,1,1,315727,315728,315729,1,2,0
90467,3,3,315730,315730,315733,0,3,1
90468,4,2,315734,315734,315736,0,2,1
90469,4,2,315738,315738,315740,0,2,2
90470,2,3,315740,315740,315743,0,3,0
90471,5,3,315745,315745,315748,0,3,2
90472,4,1,315749,315749,315750,0,1,1
90473,4,1,315753,315753,315754,0,1,3
90474,3,3,315756,315756,315759,0,3,2
90475,6,2,315762,315762,315764,0,2,3
90476,2,1,315764,315764,315765,0,1,0
90477,5,1,315769,315769,315770,0,1,4
90478,3,2,315772,315772,315774,0,2,2
90479,4,2,315776,315776,315778,0,2,2
90480,3,2,315779,315779,315781,0,2,1
90481,4,3,315783,315783,315786,0,3,2
90482,1,3,315784,315786,315789,2,5,0
90483,6,2,315790,315790,315792,0,2,1
90484,3,2,315793,315793,315795,0,2,1
90485,2,1,315795,315795,315796,0,1,0
90486,2,3,315797,315797,315800,0,3,1
90487,4,2,315801,315801,315803,0,2,1
90488,6,1,315807,315807,315808,0,1,4
90489,5,1,315812,315812,315813,0,1,4
90490,5,1,315817,315817,315818,0,1,4
90491,1,1,315818,315818,315819,0,1,0
90492,6,1,315824,315824,315825,0,1,5
90493,3,1,315827,315827,315828,0,1,2
90494,5,2,315832,315832,315834,0,2,4
90495,2,3,315834,315834,315837,0,3,0
90496,4,3,315838,315838,315841,0,3,1
90497,5,2,315843,315843,315845,0,2,2
90498,2,1,315845,315845,315846,0,1,0
90499,2,3,315847,315847,315850,0,3,1
90500,4,2,315851,315851,315853,0,2,1
90501,6,3,315857,315857,315860,0,3,4
90502,6,3,315863,315863,315866,0,3,3
90503,5,3,315868,315868,315871,0,3,2
90504,6,3,315874,315874,315877,0,3,3
90505,1,3,315875,315877,315880,2,5,0
90506,1,3,315876,315880,315883,4,7,0
90507,4,3,315880,315883,315886,3,6,0
90508,1,3,315881,315886,315889,5,8,0
90509,3,3,315884,315889,315892,5,8,0
90510,6,3,315890,315892,315895,2,5,0
90511,6,3,315896,315896,315899,0,3,1
90512,1,3,315897,315899,315902,2,5,0
90513,2,3,315899,315902,315905,3,6,0
90514,5,3,315904,315905,315908,1,4,0
90515,6,3,315910,315910,315913,0,3,2
90516,2,1,315912,315913,315914,1,2,0
90517,2,3,315914,315914,315917,0,3,0
90518,4,3,315918,315918,315921,0,3,1
90519,4,2,315922,315922,315924,0,2,1
90520,2,3,315924,315924,315927,0,3,0
90521,3,2,315927,315927,315929,0,2,0
90522,6,3,315933,315933,315936,0,3,4
90523,6,3,315939,315939,315942,0,3,3
90524,5,1,315944,315944,315945,0,1,2
90525,4,3,315948,315948,315951,0,3,3
90526,5,1,315953,315953,315954,0,1,2
90527,4,3,315957,315957,315960,0,3,3
90528,6,3,315963,315963,315966,0,3,3
90529,1,1,315964,315966,315967,2,3,0
90530,4,3,315968,315968,315971,0,3,1
90531,6,3,315974,315974,315977,0,3,3
90532,2,2,315976,315977,315979,1,3,0
90533,5,3,315981,315981,315984,0,3,2
90534,2,1,315983,315984,315985,1,2,0
90535,4,1,315987,315987,315988,0,1,2
90536,1,1,315988,315988,315989,0,1,0
90537,4,2,315992,315992,315994,0,2,3
90538,1,2,315993,315994,315996,1,3,0
90539,5,2,315998,315998,316000,0,2,2
90540,2,3,316000,316000,316003,0,3,0
90541,3,2,316003,316003,316005,0,2,0
90542,3,3,316006,316006,316009,0,3,1
90543,6,2,316012,316012,316014,0,2,3
90544,5,3,316017,316017,316020,0,3,3
90545,5,1,316022,316022,316023,0,1,2
90546,3,3,316025,316025,316028,0,3,2
90547,3,3,316028,316028,316031,0,3,0
90548,6,3,316034,316034,316037,0,3,3
90549,3,1,316037,316037,316038,0,1,0
90550,3,2,316040,316040,316042,0,2,2
90551,6,1,316046,316046,316047,0,1,4
90552,6,2,316052,316052,316054,0,2,5
90553,2,2,316054,316054,316056,0,2,0
90554,4,3,316058,316058,316061,0,3,2
90555,2,1,316060,316061,316062,1,2,0
90556,3,2,316063,316063,316065,0,2,1
90557,3,3,316066,316066,316069,0,3,1
90558,2,2,316068,316069,316071,1,3,0
90559,6,3,316074,316074,316077,0,3,3
90560,4,1,316078,316078,316079,0,1,1
90561,3,1,316081,316081,316082,0,1,2
90562,6,3,316087,316087,316090,0,3,5
90563,1,3,316088,316090,316093,2,5,0
90564,5,2,316093,316093,316095,0,2,0
90565,1,2,316094,316095,316097,1,3,0
90566,3,1,316097,316097,316098,0,1,0
90567,6,1,316103,316103,316104,0,1,5
90568,3,1,316106,316106,316107,0,1,2
90569,1,2,316107,316107,316109,0,2,0
90570,2,2,316109,316109,316111,0,2,0
90571,1,3,316110,316111,316114,1,4,0
90572,5,3,316115,316115,316118,0,3,1
90573,6,1,316121,316121,316122,0,1,3
90574,3,1,316124,316124,316125,0,1,2
90575,5,1,316129,316129,316130,0,1,4
90576,4,3,316133,316133,316136,0,3,3
90577,4,1,316137,316137,316138,0,1,1
90578,5,2,316142,316142,316144,0,2,4
90579,3,2,316145,316145,316147,0,2,1
90580,1,3,316146,316147,316150,1,4,0
90581,3,2,316149,316150,316152,1,3,0
90582,6,1,316155,316155,316156,0,1,3
90583,6,3,316161,316161,316164,0,3,5
90584,4,2,316165,316165,316167,0,2,1
90585,4,2,316169,316169,316171,0,2,2
90586,6,3,316175,316175,316178,0,3,4
90587,1,2,316176,316178,316180,2,4,0
90588,3,2,316179,316180,316182,1,3,0
90589,4,1,316183,316183,316184,0,1,1
90590,6,3,316189,316189,316192,0,3,5
90591,2,1,316191,316192,316193,1,2,0
90592,5,1,316196,316196,316197,0,1,3
90593,4,1,316200,316200,316201,0,1,3
90594,6,2,316206,316206,316208,0,2,5
90595,3,1,316209,316209,316210,0,1,1
90596,4,2,316213,316213,316215,0,2,3
90597,1,3,316214,316215,316218,1,4,0
90598,4,3,316218,316218,316221,0,3,0
90599,4,1,316222,316222,316223,0,1,1
90600,4,3,316226,316226,316229,0,3,3
90601,2,2,316228,316229,316231,1,3,0
90602,5,3,316233,316233,316236,0,3,2
90603,6,1,316239,316239,316240,0,1,3
90604,5,2,316244,316244,316246,0,2,4
90605,1,3,316245,316246,316249,1,4,0
90606,5,1,316250,316250,316251,0,1,1
90607,4,3,316254,316254,316257,0,3,3
90608,4,1,316258,316258,316259,0,1,1
90609,2,2,316260,316260,316262,0,2,1
90610,3,3,316263,316263,316266,0,3,1
90611,1,3,316264,316266,316269,2,5,0
90612,1,1,316265,316269,316270,4,5,0
90613,3,2,316268,316270,316272,2,4,0
90614,1,3,316269,316272,316275,3,6,0
90615,1,2,316270,316275,316277,5,7,0
90616,4,2,316274,316277,316279,3,5,0
90617,2,2,316276,316279,316281,3,5,0
90618,3,3,316279,316281,316284,2,5,0
90619,2,2,316281,316284,316286,3,5,0
90620,6,3,316287,316287,316290,0,3,1
90621,4,2,316291,316291,316293,0,2,1
90622,5,1,316296,316296,316297,0,1,3
90623,3,1,316299,316299,316300,0,1,2
90624,2,1,316301,316301,316302,0,1,1
90625,5,2,316306,316306,316308,0,2,4
90626,6,2,316312,316312,316314,0,2,4
90627,2,1,316314,316314,316315,0,1,0
90628,3,2,316317,316317,316319,0,2,2
90629,3,3,316320,316320,316323,0,3,1
90630,3,2,316323,316323,316325,0,2,0
90631,5,1,316328,316328,316329,0,1,3
90632,3,1,316331,316331,316332,0,1,2
90633,3,2,316334,316334,316336,0,2,2
90634,4,2,316338,316338,316340,0,2,2
90635,3,2,316341,316341,316343,0,2,1
90636,1,1,316342,316343,316344,1,2,0
90637,4,3,316346,316346,316349,0,3,2
90638,3,2,316349,316349,316351,0,2,0
90639,1,3,316350,316351,316354,1,4,0
90640,4,1,316354,316354,316355,0,1,0
90641,5,1,316359,316359,316360,0,1,4
90642,6,1,316365,316365,316366,0,1,5
90643,5,1,316370,316370,316371,0,1,4
90644,3,1,316373,316373,316374,0,1,2
90645,4,2,316377,316377,316379,0,2,3
90646,6,3,316383,316383,316386,0,3,4
90647,5,1,316388,316388,316389,0,1,2
90648,1,1,316389,316389,316390,0,1,0
90649,2,1,316391,316391,316392,0,1,1
90650,4,1,316395,316395,316396,0,1,3
90651,2,2,316397,316397,316399,0,2,1
90652,3,3,316400,316400,316403,0,3,1
90653,5,3,316405,316405,316408,0,3,2
90654,1,2,316406,316408,316410,2,4,0
90655,1,1,316407,316410,316411,3,4,0
90656,3,1,316410,316411,316412,1,2,0
90657,1,3,316411,316412,316415,1,4,0
90658,1,3,316412,316415,316418,3,6,0
90659,6,1,316418,316418,316419,0,1,0
90660,3,2,316421,316421,316423,0,2,2
90661,3,2,316424,316424,316426,0,2,1
90662,2,3,316426,316426,316429,0,3,0
90663,5,1,316431,316431,316432,0,1,2
90664,4,3,316435,316435,316438,0,3,3
90665,5,2,316440,316440,316442,0,2,2
90666,3,2,316443,316443,316445,0,2,1
90667,1,3,316444,316445,316448,1,4,0
90668,6,3,316450,316450,316453,0,3,2
90669,5,1,316455,316455,316456,0,1,2
90670,4,1,316459,316459,316460,0,1,3
90671,3,3,316462,316462,316465,0,3,2
90672,1,3,316463,316465,316468,2,5,0
90673,6,2,316469,316469,316471,0,2,1
90674,1,1,316470,316471,316472,1,2,0
90675,4,1,316474,316474,316475,0,1,2
90676,3,1,316477,316477,316478,0,1,2
90677,2,1,316479,316479,316480,0,1,1
90678,2,2,316481,316481,316483,0,2,1
90679,1,1,316482,316483,316484,1,2,0
90680,5,2,316487,316487,316489,0,2,3
90681,6,3,316493,316493,316496,0,3,4
90682,5,2,316498,316498,316500,0,2,2
90683,5,1,316503,316503,316504,0,1,3
90684,3,2,316506,316506,316508,0,2,2
90685,2,2,316508,316508,316510,0,2,0
90686,1,2,316509,316510,316512,1,3,0
90687,1,2,316510,316512,316514,2,4,0
90688,5,3,316515,316515,316518,0,3,1
90689,6,2,316521,316521,316523,0,2,3
90690,3,2,316524,316524,316526,0,2,1
90691,4,3,316528,316528,316531,0,3,2
90692,2,3,316530,316531,316534,1,4,0
90693,1,1,316531,316534,316535,3,4,0
90694,3,2,316534,316535,316537,1,3,0
90695,5,3,316539,316539,316542,0,3,2
90696,2,1,316541,316542,316543,1,2,0
90697,3,3,316544,316544,316547,0,3,1
90698,6,2,316550,316550,316552,0,2,3
90699,4,2,316554,316554,316556,0,2,2
90700,5,3,316559,316559,316562,0,3,3
90701,4,2,316563,316563,316565,0,2,1
90702,2,3,316565,316565,316568,0,3,0
90703,1,1,316566,316568,316569,2,3,0
90704,3,1,316569,316569,316570,0,1,0
90705,1,3,316570,316570,316573,0,3,0
90706,4,3,316574,316574,316577,0,3,1
90707,5,1,316579,316579,316580,0,1,2
90708,6,3,316585,316585,316588,0,3,5
90709,3,3,316588,316588,316591,0,3,0
90710,6,1,316594,316594,316595,0,1,3
90711,2,1,316596,316596,316597,0,1,1
90712,3,3,316599,316599,316602,0,3,2
90713,4,2,316603,316603,316605,0,2,1
90714,2,1,316605,316605,316606,0,1,0
90715,6,2,316611,316611,316613,0,2,5
90716,6,2,316617,316617,316619,0,2,4
90717,6,2,316623,316623,316625,0,2,4
90718,4,3,316627,316627,316630,0,3,2
90719,5,1,316632,316632,316633,0,1,2
90720,6,1,316638,316638,316639,0,1,5
90721,6,1,316644,316644,316645,0,1,5
90722,4,2,316648,316648,316650,0,2,3
90723,3,2,316651,316651,316653,0,2,1
90724,3,3,316654,316654,316657,0,3,1
90725,2,2,316656,316657,316659,1,3,0
90726,3,3,316659,316659,316662,0,3,0
90727,2,3,316661,316662,316665,1,4,0
90728,3,3,316664,316665,316668,1,4,0
90729,5,3,316669,316669,316672,0,3,1
90730,2,1,316671,316672,316673,1,2,0
90731,6,1,316677,316677,316678,0,1,4
90732,3,2,316680,316680,316682,0,2,2
90733,4,1,316684,316684,316685,0,1,2
90734,1,2,316685,316685,316687,0,2,0
90735,4,1,316689,316689,316690,0,1,2
90736,4,2,316693,316693,316695,0,2,3
90737,6,1,316699,316699,316700,0,1,4
90738,1,2,316700,316700,316702,0,2,0
90739,4,3,316704,316704,316707,0,3,2
90740,6,1,316710,316710,316711,0,1,3
90741,4,2,316714,316714,316716,0,2,3
90742,6,3,316720,316720,316723,0,3,4
90743,1,3,316721,316723,316726,2,5,0
90744,1,2,316722,316726,316728,4,6,0
90745,1,2,316723,316728,316730,5,7,0
90746,2,2,316725,316730,316732,5,7,0
90747,4,3,316729,316732,316735,3,6,0
90748,4,2,316733,316735,316737,2,4,0
90749,2,1,316735,316737,316738,2,3,0
90750,3,2,316738,316738,316740,0,2,0
90751,2,1,316740,316740,316741,0,1,0
90752,2,3,316742,316742,316745,0,3,1
90753,2,3,316744,316745,316748,1,4,0
90754,1,1,316745,316748,316749,3,4,0
90755,3,3,316748,316749,316752,1,4,0
90756,3,1,316751,316752,316753,1,2,0
90757,4,1,316755,316755,316756,0,1,2
90758,5,3,316760,316760,316763,0,3,4
90759,4,2,316764,316764,316766,0,2,1
90760,1,2,316765,316766,316768,1,3,0
90761,1,3,316766,316768,316771,2,5,0
90762,5,3,316771,316771,316774,0,3,0
90763,3,3,316774,316774,316777,0,3,0
90764,3,2,316777,316777,316779,0,2,0
90765,2,1,316779,316779,316780,0,1,0
90766,1,3,316780,316780,316783,0,3,0
90767,3,1,316783,316783,316784,0,1,0
90768,3,2,316786,316786,316788,0,2,2
90769,5,2,316791,316791,316793,0,2,3
90770,2,1,316793,316793,316794,0,1,0
90771,2,2,316795,316795,316797,0,2,1
90772,2,1,316797,316797,316798,0,1,0
90773,2,1,316799,316799,316800,0,1,1
90774,5,3,316804,316804,316807,0,3,4
90775,2,3,316806,316807,316810,1,4,0
90776,2,3,316808,316810,316813,2,5,0
90777,4,2,316812,316813,316815,1,3,0
90778,2,2,316814,316815,316817,1,3,0
90779,3,1,316817,316817,316818,0,1,0
90780,6,2,316823,316823,316825,0,2,5
90781,1,2,316824,316825,316827,1,3,0
90782,5,1,316829,316829,316830,0,1,2
90783,2,1,316831,316831,316832,0,1,1
90784,2,1,316833,316833,316834,0,1,1
90785,3,2,316836,316836,316838,0,2,2
90786,1,3,316837,316838,316841,1,4,0
90787,2,1,316839,316841,316842,2,3,0
90788,5,3,316844,316844,316847,0,3,2
90789,4,1,316848,316848,316849,0,1,1
90790,6,2,316854,316854,316856,0,2,5
90791,4,1,316858,316858,316859,0,1,2
90792,2,1,316860,316860,316861,0,1,1
90793,1,2,316861,316861,316863,0,2,0
90794,6,1,316867,316867,316868,0,1,4
90795,5,3,316872,316872,316875,0,3,4
90796,4,2,316876,316876,316878,0,2,1
90797,6,1,316882,316882,316883,0,1,4
90798,4,1,316886,316886,316887,0,1,3
90799,1,2,316887,316887,316889,0,2,0
90800,1,3,316888,316889,316892,1,4,0
90801,4,3,316892,316892,316895,0,3,0
90802,5,2,316897,316897,316899,0,2,2
90803,6,1,316903,316903,316904,0,1,4
90804,6,2,316909,316909,316911,0,2,5
90805,4,3,316913,316913,316916,0,3,2
90806,1,1,316914,316916,316917,2,3,0
90807,4,2,316918,316918,316920,0,2,1
90808,3,3,316921,316921,316924,0,3,1
90809,6,3,316927,316927,316930,0,3,3
90810,1,3,316928,316930,316933,2,5,0
90811,1,1,316929,316933,316934,4,5,0
90812,3,3,316932,316934,316937,2,5,0
90813,4,2,316936,316937,316939,1,3,0
90814,3,2,316939,316939,316941,0,2,0
90815,6,3,316945,316945,316948,0,3,4
90816,5,3,316950,316950,316953,0,3,2
90817,1,1,316951,316953,316954,2,3,0
90818,5,2,316956,316956,316958,0,2,2
90819,3,1,316959,316959,316960,0,1,1
90820,2,2,316961,316961,316963,0,2,1
90821,1,1,316962,316963,316964,1,2,0
90822,3,1,316965,316965,316966,0,1,1
90823,2,2,316967,316967,316969,0,2,1
90824,1,1,316968,316969,316970,1,2,0
90825,1,2,316969,316970,316972,1,3,0
90826,1,3,316970,316972,316975,2,5,0
90827,3,1,316973,316975,316976,2,3,0
90828,1,2,316974,316976,316978,2,4,0
90829,6,1,316980,316980,316981,0,1,2
90830,5,2,316985,316985,316987,0,2,4
90831,2,1,316987,316987,316988,0,1,0
90832,4,3,316991,316991,316994,0,3,3
90833,1,2,316992,316994,316996,2,4,0
90834,1,1,316993,316996,316997,3,4,0
90835,4,1,316997,316997,316998,0,1,0
90836,6,1,317003,317003,317004,0,1,5
90837,6,3,317009,317009,317012,0,3,5
90838,4,3,317013,317013,317016,0,3,1
90839,6,2,317019,317019,317021,0,2,3
90840,2,2,317021,317021,317023,0,2,0
90841,1,2,317022,317023,317025,1,3,0
90842,5,1,317027,317027,317028,0,1,2
90843,2,3,317029,317029,317032,0,3,1
90844,5,3,317034,317034,317037,0,3,2
90845,3,2,317037,317037,317039,0,2,0
90846,4,2,317041,317041,317043,0,2,2
90847,6,1,317047,317047,317048,0,1,4
90848,6,2,317053,317053,317055,0,2,5
90849,3,3,317056,317056,317059,0,3,1
90850,6,1,317062,317062,317063,0,1,3
90851,6,3,317068,317068,317071,0,3,5
90852,6,1,317074,317074,317075,0,1,3
90853,5,2,317079,317079,317081,0,2,4
90854,1,3,317080,317081,317084,1,4,0
90855,6,2,317086,317086,317088,0,2,2
90856,3,2,317089,317089,317091,0,2,1
90857,5,3,317094,317094,317097,0,3,3
90858,4,3,317098,317098,317101,0,3,1
90859,2,3,317100,317101,317104,1,4,0
90860,6,1,317106,317106,317107,0,1,2
90861,6,1,317112,317112,317113,0,1,5
90862,1,2,317113,317113,317115,0,2,0
90863,1,3,317114,317115,317118,1,4,0
90864,6,3,317120,317120,317123,0,3,2
90865,6,3,317126,317126,317129,0,3,3
90866,5,2,317131,317131,317133,0,2,2
90867,1,3,317132,317133,317136,1,4,0
90868,6,1,317138,317138,317139,0,1,2
90869,3,2,317141,317141,317143,0,2,2
90870,5,3,317146,317146,317149,0,3,3
90871,5,1,317151,317151,317152,0,1,2
90872,5,1,317156,317156,317157,0,1,4
90873,5,1,317161,317161,317162,0,1,4
90874,1,1,317162,317162,317163,0,1,0
90875,4,2,317166,317166,317168,0,2,3
90876,2,2,317168,317168,317170,0,2,0
90877,4,2,317172,317172,317174,0,2,2
90878,5,2,317177,317177,317179,0,2,3
90879,6,1,317183,317183,317184,0,1,4
90880,4,2,317187,317187,317189,0,2,3
90881,4,2,317191,317191,317193,0,2,2
90882,2,3,317193,317193,317196,0,3,0
90883,1,2,317194,317196,317198,2,4,0
90884,2,1,317196,317198,317199,2,3,0
90885,1,1,317197,317199,317200,2,3,0
90886,3,1,317200,317200,317201,0,1,0
90887,6,1,317206,317206,317207,0,1,5
90888,1,3,317207,317207,317210,0,3,0
90889,3,3,317210,317210,317213,0,3,0
90890,4,2,317214,317214,317216,0,2,1
90891,6,2,317220,317220,317222,0,2,4
90892,1,3,317221,317222,317225,1,4,0
90893,6,1,317227,317227,317228,0,1,2
90894,3,1,317230,317230,317231,0,1,2
90895,5,3,317235,317235,317238,0,3,4
90896,2,1,317237,317238,317239,1,2,0
90897,3,3,317240,317240,317243,0,3,1
90898,4,3,317244,317244,317247,0,3,1
90899,5,1,317249,317249,317250,0,1,2
90900,3,1,317252,317252,317253,0,1,2
90901,2,3,317254,317254,317257,0,3,1
90902,5,3,317259,317259,317262,0,3,2
90903,6,2,317265,317265,317267,0,2,3
90904,4,2,317269,317269,317271,0,2,2
90905,5,3,317274,317274,317277,0,3,3
90906,1,2,317275,317277,317279,2,4,0
90907,3,1,317278,317279,317280,1,2,0
90908,3,2,317281,317281,317283,0,2,1
90909,5,1,317286,317286,317287,0,1,3
90910,6,3,317292,317292,317295,0,3,5
90911,5,2,317297,317297,317299,0,2,2
90912,1,2,317298,317299,317301,1,3,0
90913,6,1,317304,317304,317305,0,1,3
90914,3,2,317307,317307,317309,0,2,2
90915,1,2,317308,317309,317311,1,3,0
90916,3,3,317311,317311,317314,0,3,0
90917,3,3,317314,317314,317317,0,3,0
90918,4,1,317318,317318,317319,0,1,1
90919,3,2,317321,317321,317323,0,2,2
90920,6,1,317327,317327,317328,0,1,4
90921,3,3,317330,317330,317333,0,3,2
90922,6,2,317336,317336,317338,0,2,3
90923,6,3,317342,317342,317345,0,3,4
90924,6,3,317348,317348,317351,0,3,3
90925,4,2,317352,317352,317354,0,2,1
90926,2,2,317354,317354,317356,0,2,0
90927,4,2,317358,317358,317360,0,2,2
90928,3,1,317361,317361,317362,0,1,1
90929,2,1,317363,317363,317364,0,1,1
90930,6,3,317369,317369,317372,0,3,5
90931,2,2,317371,317372,317374,1,3,0
90932,6,1,317377,317377,317378,0,1,3
90933,2,3,317379,317379,317382,0,3,1
90934,2,2,317381,317382,317384,1,3,0
90935,4,1,317385,317385,317386,0,1,1
90936,4,3,317389,317389,317392,0,3,3
90937,3,3,317392,317392,317395,0,3,0
90938,2,1,317394,317395,317396,1,2,0
90939,1,2,317395,317396,317398,1,3,0
90940,5,3,317400,317400,317403,0,3,2
90941,6,2,317406,317406,317408,0,2,3
90942,6,3,317412,317412,317415,0,3,4
90943,5,1,317417,317417,317418,0,1,2
90944,1,1,317418,317418,317419,0,1,0
90945,5,1,317423,317423,317424,0,1,4
90946,2,3,317425,317425,317428,0,3,1
90947,6,2,317431,317431,317433,0,2,3
90948,4,2,317435,317435,317437,0,2,2
90949,6,3,317441,317441,317444,0,3,4
90950,3,2,317444,317444,317446,0,2,0
90951,5,1,317449,317449,317450,0,1,3
90952,3,2,317452,317452,317454,0,2,2
90953,5,3,317457,317457,317460,0,3,3
90954,3,1,317460,317460,317461,0,1,0
90955,3,3,317463,317463,317466,0,3,2
90956,4,1,317467,317467,317468,0,1,1
90957,2,1,317469,317469,317470,0,1,1
90958,3,3,317472,317472,317475,0,3,2
90959,2,1,317474,317475,317476,1,2,0
90960,3,2,317477,317477,317479,0,2,1
90961,1,1,317478,317479,317480,1,2,0
90962,1,1,317479,317480,317481,1,2,0
90963,5,3,317484,317484,317487,0,3,3
90964,6,2,317490,317490,317492,0,2,3
90965,3,2,317493,317493,317495,0,2,1
90966,1,2,317494,317495,317497,1,3,0
90967,2,1,317496,317497,317498,1,2,0
90968,4,2,317500,317500,317502,0,2,2
90969,1,2,317501,317502,317504,1,3,0
90970,4,3,317505,317505,317508,0,3,1
90971,1,1,317506,317508,317509,2,3,0
90972,1,3,317507,317509,317512,2,5,0
90973,6,1,317513,317513,317514,0,1,1
90974,5,3,317518,317518,317521,0,3,4
90975,2,3,317520,317521,317524,1,4,0
90976,2,2,317522,317524,317526,2,4,0
90977,1,3,317523,317526,317529,3,6,0
90978,1,3,317524,317529,317532,5,8,0
90979,6,2,317530,317532,317534,2,4,0
90980,1,2,317531,317534,317536,3,5,0
90981,6,1,317537,317537,317538,0,1,1
90982,2,2,317539,317539,317541,0,2,1
90983,5,2,317544,317544,317546,0,2,3
90984,6,3,317550,317550,317553,0,3,4
90985,5,2,317555,317555,317557,0,2,2
90986,5,3,317560,317560,317563,0,3,3
90987,3,3,317563,317563,317566,0,3,0
90988,4,2,317567,317567,317569,0,2,1
90989,2,1,317569,317569,317570,0,1,0
90990,4,3,317573,317573,317576,0,3,3
90991,2,1,317575,317576,317577,1,2,0
90992,2,2,317577,317577,317579,0,2,0
90993,4,1,317581,317581,317582,0,1,2
90994,6,3,317587,317587,317590,0,3,5
90995,5,2,317592,317592,317594,0,2,2
90996,3,2,317595,317595,317597,0,2,1
90997,2,1,317597,317597,317598,0,1,0
90998,2,1,317599,317599,317600,0,1,1
90999,4,3,317603,317603,317606,0,3,3
91000,2,3,317605,317606,317609,1,4,0
91001,1,2,317606,317609,317611,3,5,0
91002,6,1,317612,317612,317613,0,1,1
91003,4,2,317616,317616,317618,0,2,3
91004,6,1,317622,317622,317623,0,1,4
91005,5,2,317627,317627,317629,0,2,4
91006,6,2,317633,317633,317635,0,2,4
91007,3,2,317636,317636,317638,0,2,1
91008,3,3,317639,317639,317642,0,3,1
91009,1,2,317640,317642,317644,2,4,0
91010,5,3,317645,317645,317648,0,3,1
91011,5,3,317650,317650,317653,0,3,2
91012,1,3,317651,317653,317656,2,5,0
91013,5,3,317656,317656,317659,0,3,0
91014,3,1,317659,317659,317660,0,1,0
91015,1,3,317660,317660,317663,0,3,0
91016,2,1,317662,317663,317664,1,2,0
91017,1,3,317663,317664,317667,1,4,0
91018,3,1,317666,317667,317668,1,2,0
91019,6,3,317672,317672,317675,0,3,4
91020,2,3,317674,317675,317678,1,4,0
91021,2,1,317676,317678,317679,2,3,0
91022,3,1,317679,317679,317680,0,1,0
91023,5,3,317684,317684,317687,0,3,4
91024,3,1,317687,317687,317688,0,1,0
91025,6,2,317693,317693,317695,0,2,5
91026,1,3,317694,317695,317698,1,4,0
91027,5,2,317699,317699,317701,0,2,1
91028,6,3,317705,317705,317708,0,3,4
91029,3,1,317708,317708,317709,0,1,0
91030,6,2,317714,317714,317716,0,2,5
91031,5,3,317719,317719,317722,0,3,3
91032,1,3,317720,317722,317725,2,5,0
91033,6,1,317726,317726,317727,0,1,1
91034,2,1,317728,317728,317729,0,1,1
91035,3,1,317731,317731,317732,0,1,2
91036,5,3,317736,317736,317739,0,3,4
91037,1,2,317737,317739,317741,2,4,0
91038,1,3,317738,317741,317744,3,6,0
91039,4,1,317742,317744,317745,2,3,0
91040,2,2,317744,317745,317747,1,3,0
91041,5,3,317749,317749,317752,0,3,2
91042,1,3,317750,317752,317755,2,5,0
91043,3,1,317753,317755,317756,2,3,0
91044,2,1,317755,317756,317757,1,2,0
91045,1,1,317756,317757,317758,1,2,0
91046,5,1,317761,317761,317762,0,1,3
91047,5,3,317766,317766,317769,0,3,4
91048,1,3,317767,317769,317772,2,5,0
91049,4,1,317771,317772,317773,1,2,0
91050,6,1,317777,317777,317778,0,1,4
91051,1,2,317778,317778,317780,0,2,0
91052,2,3,317780,317780,317783,0,3,0
91053,4,2,317784,317784,317786,0,2,1
91054,3,1,317787,317787,317788,0,1,1
91055,3,1,317790,317790,317791,0,1,2
91056,3,3,317793,317793,317796,0,3,2
91057,3,3,317796,317796,317799,0,3,0
91058,3,3,317799,317799,317802,0,3,0
91059,1,1,317800,317802,317803,2,3,0
91060,4,3,317804,317804,317807,0,3,1
91061,3,2,317807,317807,317809,0,2,0
91062,4,2,317811,317811,317813,0,2,2
91063,3,2,317814,317814,317816,0,2,1
91064,4,3,317818,317818,317821,0,3,2
91065,1,3,317819,317821,317824,2,5,0
91066,2,3,317821,317824,317827,3,6,0
91067,2,3,317823,317827,317830,4,7,0
91068,4,1,317827,317830,317831,3,4,0
91069,1,3,317828,317831,317834,3,6,0
91070,2,2,317830,317834,317836,4,6,0
91071,1,3,317831,317836,317839,5,8,0
91072,4,2,317835,317839,317841,4,6,0
91073,3,3,317838,317841,317844,3,6,0
91074,1,1,317839,317844,317845,5,6,0
91075,6,2,317845,317845,317847,0,2,0
91076,4,2,317849,317849,317851,0,2,2
91077,5,2,317854,317854,317856,0,2,3
91078,2,2,317856,317856,317858,0,2,0
91079,1,1,317857,317858,317859,1,2,0
91080,4,3,317861,317861,317864,0,3,2
91081,1,1,317862,317864,317865,2,3,0
91082,5,1,317867,317867,317868,0,1,2
91083,1,3,317868,317868,317871,0,3,0
91084,6,3,317874,317874,317877,0,3,3
91085,3,3,317877,317877,317880,0,3,0
91086,4,2,317881,317881,317883,0,2,1
91087,1,2,317882,317883,317885,1,3,0
91088,4,1,317886,317886,317887,0,1,1
91089,5,2,317891,317891,317893,0,2,4
91090,4,1,317895,317895,317896,0,1,2
91091,3,2,317898,317898,317900,0,2,2
91092,1,3,317899,317900,317903,1,4,0
91093,2,3,317901,317903,317906,2,5,0
91094,4,1,317905,317906,317907,1,2,0
91095,6,1,317911,317911,317912,0,1,4
91096,6,3,317917,317917,317920,0,3,5
91097,5,3,317922,317922,317925,0,3,2
91098,1,3,317923,317925,317928,2,5,0
91099,3,1,317926,317928,317929,2,3,0
91100,1,1,317927,317929,317930,2,3,0
91101,5,2,317932,317932,317934,0,2,2
91102,5,3,317937,317937,317940,0,3,3
91103,5,2,317942,317942,317944,0,2,2
91104,6,2,317948,317948,317950,0,2,4
91105,5,1,317953,317953,317954,0,1,3
91106,3,1,317956,317956,317957,0,1,2
91107,4,3,317960,317960,317963,0,3,3
91108,3,2,317963,317963,317965,0,2,0
91109,6,2,317969,317969,317971,0,2,4
91110,5,1,317974,317974,317975,0,1,3
91111,5,2,317979,317979,317981,0,2,4
91112,3,3,317982,317982,317985,0,3,1
91113,4,3,317986,317986,317989,0,3,1
91114,2,1,317988,317989,317990,1,2,0
91115,3,1,317991,317991,317992,0,1,1
91116,2,3,317993,317993,317996,0,3,1
91117,3,3,317996,317996,317999,0,3,0
91118,2,3,317998,317999,318002,1,4,0
91119,2,2,318000,318002,318004,2,4,0
91120,3,1,318003,318004,318005,1,2,0
91121,5,3,318008,318008,318011,0,3,3
91122,3,2,318011,318011,318013,0,2,0
91123,4,3,318015,318015,318018,0,3,2
91124,4,2,318019,318019,318021,0,2,1
91125,6,1,318025,318025,318026,0,1,4
91126,5,3,318030,318030,318033,0,3,4
91127,6,2,318036,318036,318038,0,2,3
91128,4,1,318040,318040,318041,0,1,2
91129,3,2,318043,318043,318045,0,2,2
91130,2,3,318045,318045,318048,0,3,0
91131,6,2,318051,318051,318053,0,2,3
91132,4,3,318055,318055,318058,0,3,2
91133,4,2,318059,318059,318061,0,2,1
91134,4,3,318063,318063,318066,0,3,2
91135,2,2,318065,318066,318068,1,3,0
91136,5,3,318070,318070,318073,0,3,2
91137,4,1,318074,318074,318075,0,1,1
91138,2,3,318076,318076,318079,0,3,1
91139,3,1,318079,318079,318080,0,1,0
91140,5,3,318084,318084,318087,0,3,4
91141,1,3,318085,318087,318090,2,5,0
91142,4,1,318089,318090,318091,1,2,0
91143,6,2,318095,318095,318097,0,2,4
91144,1,2,318096,318097,318099,1,3,0
91145,2,2,318098,318099,318101,1,3,0
91146,4,1,318102,318102,318103,0,1,1
91147,2,3,318104,318104,318107,0,3,1
91148,2,1,318106,318107,318108,1,2,0
91149,4,1,318110,318110,318111,0,1,2
91150,3,2,318113,318113,318115,0,2,2
91151,3,2,318116,318116,318118,0,2,1
91152,3,1,318119,318119,318120,0,1,1
91153,2,3,318121,318121,318124,0,3,1
91154,3,1,318124,318124,318125,0,1,0
91155,5,1,318129,318129,318130,0,1,4
91156,3,1,318132,318132,318133,0,1,2
91157,5,2,318137,318137,318139,0,2,4
91158,5,2,318142,318142,318144,0,2,3
91159,2,2,318144,318144,318146,0,2,0
91160,4,1,318148,318148,318149,0,1,2
91161,3,1,318151,318151,318152,0,1,2
91162,6,1,318157,318157,318158,0,1,5
91163,1,2,318158,318158,318160,0,2,0
91164,2,3,318160,318160,318163,0,3,0
91165,2,2,318162,318163,318165,1,3,0
91166,5,1,318167,318167,318168,0,1,2
91167,3,3,318170,318170,318173,0,3,2
91168,4,2,318174,318174,318176,0,2,1
91169,2,1,318176,318176,318177,0,1,0
91170,4,2,318180,318180,318182,0,2,3
91171,2,1,318182,318182,318183,0,1,0
91172,6,2,318188,318188,318190,0,2,5
91173,4,2,318192,318192,318194,0,2,2
91174,4,1,318196,318196,318197,0,1,2
91175,5,1,318201,318201,318202,0,1,4
91176,3,1,318204,318204,318205,0,1,2
91177,2,1,318206,318206,318207,0,1,1
91178,4,1,318210,318210,318211,0,1,3
91179,4,3,318214,318214,318217,0,3,3
91180,2,1,318216,318217,318218,1,2,0
91181,5,1,318221,318221,318222,0,1,3
91182,2,1,318223,318223,318224,0,1,1
91183,3,2,318226,318226,318228,0,2,2
91184,1,2,318227,318228,318230,1,3,0
91185,4,1,318231,318231,318232,0,1,1
91186,3,1,318234,318234,318235,0,1,2
91187,6,3,318240,318240,318243,0,3,5
91188,4,3,318244,318244,318247,0,3,1
91189,6,2,318250,318250,318252,0,2,3
91190,2,2,318252,318252,318254,0,2,0
91191,3,3,318255,318255,318258,0,3,1
91192,3,1,318258,318258,318259,0,1,0
91193,2,3,318260,318260,318263,0,3,1
91194,1,3,318261,318263,318266,2,5,0
91195,4,1,318265,318266,318267,1,2,0
91196,4,1,318269,318269,318270,0,1,2
91197,6,3,318275,318275,318278,0,3,5
91198,6,3,318281,318281,318284,0,3,3
91199,3,1,318284,318284,318285,0,1,0
91200,2,2,318286,318286,318288,0,2,1
91201,1,1,318287,318288,318289,1,2,0
91202,4,2,318291,318291,318293,0,2,2
91203,1,2,318292,318293,318295,1,3,0
91204,6,3,318298,318298,318301,0,3,3
91205,6,1,318304,318304,318305,0,1,3
91206,4,1,318308,318308,318309,0,1,3
91207,4,1,318312,318312,318313,0,1,3
91208,4,2,318316,318316,318318,0,2,3
91209,1,3,318317,318318,318321,1,4,0
91210,2,2,318319,318321,318323,2,4,0
91211,5,3,318324,318324,318327,0,3,1
91212,3,1,318327,318327,318328,0,1,0
91213,2,1,318329,318329,318330,0,1,1
91214,1,2,318330,318330,318332,0,2,0
91215,1,3,318331,318332,318335,1,4,0
91216,1,3,318332,318335,318338,3,6,0
91217,4,3,318336,318338,318341,2,5,0
91218,6,1,318342,318342,318343,0,1,1
91219,6,3,318348,318348,318351,0,3,5
91220,5,3,318353,318353,318356,0,3,2
91221,2,2,318355,318356,318358,1,3,0
91222,2,3,318357,318358,318361,1,4,0
91223,2,2,318359,318361,318363,2,4,0
91224,3,3,318362,318363,318366,1,4,0
91225,1,2,318363,318366,318368,3,5,0
91226,1,2,318364,318368,318370,4,6,0
91227,4,2,318368,318370,318372,2,4,0
91228,6,1,318374,318374,318375,0,1,2
91229,1,1,318375,318375,318376,0,1,0
91230,1,3,318376,318376,318379,0,3,0
91231,4,2,318380,318380,318382,0,2,1
91232,5,2,318385,318385,318387,0,2,3
91233,6,2,318391,318391,318393,0,2,4
91234,2,2,318393,318393,318395,0,2,0
91235,3,2,318396,318396,318398,0,2,1
91236,1,1,318397,318398,318399,1,2,0
91237,3,3,318400,318400,318403,0,3,1
91238,5,2,318405,318405,318407,0,2,2
91239,6,1,318411,318411,318412,0,1,4
91240,6,3,318417,318417,318420,0,3,5
91241,3,1,318420,318420,318421,0,1,0
91242,2,3,318422,318422,318425,0,3,1
91243,5,1,318427,318427,318428,0,1,2
91244,2,1,318429,318429,318430,0,1,1
91245,5,2,318434,318434,318436,0,2,4
91246,3,3,318437,318437,318440,0,3,1
91247,1,3,318438,318440,318443,2,5,0
91248,4,1,318442,318443,318444,1,2,0
91249,6,3,318448,318448,318451,0,3,4
91250,3,2,318451,318451,318453,0,2,0
91251,2,2,318453,318453,318455,0,2,0
91252,4,1,318457,318457,318458,0,1,2
91253,2,2,318459,318459,318461,0,2,1
91254,6,2,318465,318465,318467,0,2,4
91255,1,1,318466,318467,318468,1,2,0
91256,4,1,318470,318470,318471,0,1,2
91257,1,1,318471,318471,318472,0,1,0
91258,1,1,318472,318472,318473,0,1,0
91259,4,3,318476,318476,318479,0,3,3
91260,6,2,318482,318482,318484,0,2,3
91261,1,1,318483,318484,318485,1,2,0
91262,3,2,318486,318486,318488,0,2,1
91263,5,1,318491,318491,318492,0,1,3
91264,3,1,318494,318494,318495,0,1,2
91265,5,1,318499,318499,318500,0,1,4
91266,5,2,318504,318504,318506,0,2,4
91267,6,1,318510,318510,318511,0,1,4
91268,2,2,318512,318512,318514,0,2,1
91269,1,3,318513,318514,318517,1,4,0
91270,6,3,318519,318519,318522,0,3,2
91271,5,1,318524,318524,318525,0,1,2
91272,4,3,318528,318528,318531,0,3,3
91273,5,2,318533,318533,318535,0,2,2
91274,3,2,318536,318536,318538,0,2,1
91275,6,2,318542,318542,318544,0,2,4
91276,1,1,318543,318544,318545,1,2,0
91277,4,2,318547,318547,318549,0,2,2
91278,6,3,318553,318553,318556,0,3,4
91279,4,3,318557,318557,318560,0,3,1
91280,3,1,318560,318560,318561,0,1,0
91281,2,2,318562,318562,318564,0,2,1
91282,5,3,318567,318567,318570,0,3,3
91283,5,2,318572,318572,318574,0,2,2
91284,4,1,318576,318576,318577,0,1,2
91285,6,2,318582,318582,318584,0,2,5
91286,5,1,318587,318587,318588,0,1,3
91287,5,1,318592,318592,318593,0,1,4
91288,5,3,318597,318597,318600,0,3,4
91289,6,2,318603,318603,318605,0,2,3
91290,1,1,318604,318605,318606,1,2,0
91291,3,2,318607,318607,318609,0,2,1
91292,1,2,318608,318609,318611,1,3,0
91293,2,2,318610,318611,318613,1,3,0
91294,2,2,318612,318613,318615,1,3,0
91295,3,3,318615,318615,318618,0,3,0
91296,3,2,318618,318618,318620,0,2,0
91297,6,1,318624,318624,318625,0,1,4
91298,1,2,318625,318625,318627,0,2,0
91299,5,1,318630,318630,318631,0,1,3
91300,5,3,318635,318635,318638,0,3,4
91301,2,2,318637,318638,318640,1,3,0
91302,2,1,318639,318640,318641,1,2,0
91303,4,2,318643,318643,318645,0,2,2
91304,2,1,318645,318645,318646,0,1,0
91305,2,2,318647,318647,318649,0,2,1
91306,3,2,318650,318650,318652,0,2,1
91307,3,1,318653,318653,318654,0,1,1
91308,1,2,318654,318654,318656,0,2,0
91309,6,3,318660,318660,318663,0,3,4
91310,4,1,318664,318664,318665,0,1,1
91311,2,1,318666,318666,318667,0,1,1
91312,2,3,318668,318668,318671,0,3,1
91313,3,1,318671,318671,318672,0,1,0
91314,6,2,318677,318677,318679,0,2,5
91315,3,1,318680,318680,318681,0,1,1
91316,4,1,318684,318684,318685,0,1,3
91317,1,1,318685,318685,318686,0,1,0
91318,5,3,318690,318690,318693,0,3,4
91319,2,3,318692,318693,318696,1,4,0
91320,2,3,318694,318696,318699,2,5,0
91321,2,2,318696,318699,318701,3,5,0
91322,6,1,318702,318702,318703,0,1,1
91323,6,3,318708,318708,318711,0,3,5
91324,2,1,318710,318711,318712,1,2,0
91325,4,1,318714,318714,318715,0,1,2
91326,6,1,318720,318720,318721,0,1,5
91327,1,3,318721,318721,318724,0,3,0
91328,3,2,318724,318724,318726,0,2,0
91329,2,1,318726,318726,318727,0,1,0
91330,2,3,318728,318728,318731,0,3,1
91331,6,1,318734,318734,318735,0,1,3
91332,4,2,318738,318738,318740,0,2,3
91333,4,1,318742,318742,318743,0,1,2
91334,4,1,318746,318746,318747,0,1,3
91335,1,2,318747,318747,318749,0,2,0
91336,2,3,318749,318749,318752,0,3,0
91337,4,1,318753,318753,318754,0,1,1
91338,6,2,318759,318759,318761,0,2,5
91339,1,2,318760,318761,318763,1,3,0
91340,3,1,318763,318763,318764,0,1,0
91341,2,1,318765,318765,318766,0,1,1
91342,4,2,318769,318769,318771,0,2,3
91343,3,1,318772,318772,318773,0,1,1
91344,3,2,318775,318775,318777,0,2,2
91345,4,3,318779,318779,318782,0,3,2
91346,6,3,318785,318785,318788,0,3,3
91347,4,2,318789,318789,318791,0,2,1
91348,2,3,318791,318791,318794,0,3,0
91349,6,1,318797,318797,318798,0,1,3
91350,4,3,318801,318801,318804,0,3,3
91351,1,2,318802,318804,318806,2,4,0
91352,6,1,318808,318808,318809,0,1,2
91353,2,3,318810,318810,318813,0,3,1
91354,5,3,318815,318815,318818,0,3,2
91355,4,2,318819,318819,318821,0,2,1
91356,3,1,318822,318822,318823,0,1,1
91357,6,3,318828,318828,318831,0,3,5
91358,3,3,318831,318831,318834,0,3,0
91359,4,2,318835,318835,318837,0,2,1
91360,4,1,318839,318839,318840,0,1,2
91361,1,3,318840,318840,318843,0,3,0
91362,5,1,318845,318845,318846,0,1,2
91363,2,1,318847,318847,318848,0,1,1
91364,1,2,318848,318848,318850,0,2,0
91365,5,3,318853,318853,318856,0,3,3
91366,6,1,318859,318859,318860,0,1,3
91367,1,2,318860,318860,318862,0,2,0
91368,1,3,318861,318862,318865,1,4,0
91369,3,3,318864,318865,318868,1,4,0
91370,2,1,318866,318868,318869,2,3,0
91371,3,3,318869,318869,318872,0,3,0
91372,1,2,318870,318872,318874,2,4,0
91373,1,2,318871,318874,318876,3,5,0
91374,2,2,318873,318876,318878,3,5,0
91375,4,3,318877,318878,318881,1,4,0
91376,3,3,318880,318881,318884,1,4,0
91377,2,1,318882,318884,318885,2,3,0
91378,2,2,318884,318885,318887,1,3,0
91379,4,3,318888,318888,318891,0,3,1
91380,6,1,318894,318894,318895,0,1,3
91381,6,3,318900,318900,318903,0,3,5
91382,6,3,318906,318906,318909,0,3,3
91383,5,2,318911,318911,318913,0,2,2
91384,4,1,318915,318915,318916,0,1,2
91385,1,1,318916,318916,318917,0,1,0
91386,1,2,318917,318917,318919,0,2,0
91387,4,1,318921,318921,318922,0,1,2
91388,6,1,318927,318927,318928,0,1,5
91389,5,2,318932,318932,318934,0,2,4
91390,3,2,318935,318935,318937,0,2,1
91391,4,2,318939,318939,318941,0,2,2
91392,5,3,318944,318944,318947,0,3,3
91393,5,2,318949,318949,318951,0,2,2
91394,6,1,318955,318955,318956,0,1,4
91395,4,3,318959,318959,318962,0,3,3
91396,3,1,318962,318962,318963,0,1,0
91397,3,2,318965,318965,318967,0,2,2
91398,3,3,318968,318968,318971,0,3,1
91399,2,3,318970,318971,318974,1,4,0
91400,3,2,318973,318974,318976,1,3,0
91401,3,3,318976,318976,318979,0,3,0
91402,3,2,318979,318979,318981,0,2,0
91403,5,3,318984,318984,318987,0,3,3
91404,2,1,318986,318987,318988,1,2,0
91405,4,2,318990,318990,318992,0,2,2
91406,5,3,318995,318995,318998,0,3,3
91407,1,3,318996,318998,319001,2,5,0
91408,3,2,318999,319001,319003,2,4,0
91409,5,2,319004,319004,319006,0,2,1
91410,3,1,319007,319007,319008,0,1,1
91411,6,2,319013,319013,319015,0,2,5
91412,5,3,319018,319018,319021,0,3,3
91413,6,3,319024,319024,319027,0,3,3
91414,6,3,319030,319030,319033,0,3,3
91415,6,2,319036,319036,319038,0,2,3
91416,5,1,319041,319041,319042,0,1,3
91417,1,2,319042,319042,319044,0,2,0
91418,3,2,319045,319045,319047,0,2,1
91419,5,1,319050,319050,319051,0,1,3
91420,6,3,319056,319056,319059,0,3,5
91421,4,1,319060,319060,319061,0,1,1
91422,1,2,319061,319061,319063,0,2,0
91423,6,3,319067,319067,319070,0,3,4
91424,5,1,319072,319072,319073,0,1,2
91425,6,3,319078,319078,319081,0,3,5
91426,4,2,319082,319082,319084,0,2,1
91427,1,1,319083,319084,319085,1,2,0
91428,5,3,319088,319088,319091,0,3,3
91429,2,2,319090,319091,319093,1,3,0
91430,6,3,319096,319096,319099,0,3,3
91431,4,2,319100,319100,319102,0,2,1
91432,5,2,319105,319105,319107,0,2,3
91433,5,1,319110,319110,319111,0,1,3
91434,6,1,319116,319116,319117,0,1,5
91435,4,3,319120,319120,319123,0,3,3
91436,3,3,319123,319123,319126,0,3,0
91437,2,1,319125,319126,319127,1,2,0
91438,1,2,319126,319127,319129,1,3,0
91439,3,1,319129,319129,319130,0,1,0
91440,4,3,319133,319133,319136,0,3,3
91441,5,2,319138,319138,319140,0,2,2
91442,4,2,319142,319142,319144,0,2,2
91443,3,2,319145,319145,319147,0,2,1
91444,5,1,319150,319150,319151,0,1,3
91445,5,2,319155,319155,319157,0,2,4
91446,6,3,319161,319161,319164,0,3,4
91447,4,2,319165,319165,319167,0,2,1
91448,3,3,319168,319168,319171,0,3,1
91449,3,2,319171,319171,319173,0,2,0
91450,3,1,319174,319174,319175,0,1,1
91451,1,1,319175,319175,319176,0,1,0
91452,4,2,319179,319179,319181,0,2,3
91453,6,2,319185,319185,319187,0,2,4
91454,1,2,319186,319187,319189,1,3,0
91455,3,2,319189,319189,319191,0,2,0
91456,2,3,319191,319191,319194,0,3,0
91457,3,3,319194,319194,319197,0,3,0
91458,1,1,319195,319197,319198,2,3,0
91459,6,2,319201,319201,319203,0,2,3
91460,4,1,319205,319205,319206,0,1,2
91461,5,3,319210,319210,319213,0,3,4
91462,6,3,319216,319216,319219,0,3,3
91463,5,3,319221,319221,319224,0,3,2
91464,6,3,319227,319227,319230,0,3,3
91465,1,1,319228,319230,319231,2,3,0
91466,3,3,319231,319231,319234,0,3,0
91467,5,2,319236,319236,319238,0,2,2
91468,3,1,319239,319239,319240,0,1,1
91469,3,2,319242,319242,319244,0,2,2
91470,6,1,319248,319248,319249,0,1,4
91471,5,1,319253,319253,319254,0,1,4
91472,3,3,319256,319256,319259,0,3,2
91473,6,3,319262,319262,319265,0,3,3
91474,1,2,319263,319265,319267,2,4,0
91475,6,1,319269,319269,319270,0,1,2
91476,5,1,319274,319274,319275,0,1,4
91477,6,3,319280,319280,319283,0,3,5
91478,2,2,319282,319283,319285,1,3,0
91479,5,2,319287,319287,319289,0,2,2
91480,5,1,319292,319292,319293,0,1,3
91481,4,1,319296,319296,319297,0,1,3
91482,4,1,319300,319300,319301,0,1,3
91483,4,2,319304,319304,319306,0,2,3
91484,3,2,319307,319307,319309,0,2,1
91485,1,1,319308,319309,319310,1,2,0
91486,4,1,319312,319312,319313,0,1,2
91487,4,3,319316,319316,319319,0,3,3
91488,2,3,319318,319319,319322,1,4,0
91489,5,1,319323,319323,319324,0,1,1
91490,3,1,319326,319326,319327,0,1,2
91491,6,2,319332,319332,319334,0,2,5
91492,5,2,319337,319337,319339,0,2,3
91493,1,2,319338,319339,319341,1,3,0
91494,4,3,319342,319342,319345,0,3,1
91495,1,1,319343,319345,319346,2,3,0
91496,6,2,319349,319349,319351,0,2,3
91497,4,1,319353,319353,319354,0,1,2
91498,2,1,319355,319355,319356,0,1,1
91499,1,3,319356,319356,319359,0,3,0
91500,4,1,319360,319360,319361,0,1,1
91501,4,3,319364,319364,319367,0,3,3
91502,4,3,319368,319368,319371,0,3,1
91503,4,1,319372,319372,319373,0,1,1
91504,4,1,319376,319376,319377,0,1,3
91505,6,2,319382,319382,319384,0,2,5
91506,5,2,319387,319387,319389,0,2,3
91507,4,3,319391,319391,319394,0,3,2
91508,5,2,319396,319396,319398,0,2,2
91509,4,2,319400,319400,319402,0,2,2
91510,5,1,319405,319405,319406,0,1,3
91511,5,1,319410,319410,319411,0,1,4
91512,3,3,319413,319413,319416,0,3,2
91513,5,3,319418,319418,319421,0,3,2
91514,4,2,319422,319422,319424,0,2,1
91515,4,1,319426,319426,319427,0,1,2
91516,2,3,319428,319428,319431,0,3,1
91517,6,1,319434,319434,319435,0,1,3
91518,6,2,319440,319440,319442,0,2,5
91519,1,1,319441,319442,319443,1,2,0
91520,6,3,319447,319447,319450,0,3,4
91521,5,2,319452,319452,319454,0,2,2
91522,4,2,319456,319456,319458,0,2,2
91523,6,3,319462,319462,319465,0,3,4
91524,4,3,319466,319466,319469,0,3,1
91525,6,3,319472,319472,319475,0,3,3
91526,6,3,319478,319478,319481,0,3,3
91527,2,2,319480,319481,319483,1,3,0
91528,1,2,319481,319483,319485,2,4,0
91529,2,3,319483,319485,319488,2,5,0
91530,1,1,319484,319488,319489,4,5,0
91531,6,2,319490,319490,319492,0,2,1
91532,4,3,319494,319494,319497,0,3,2
91533,5,2,319499,319499,319501,0,2,2
91534,6,1,319505,319505,319506,0,1,4
91535,3,2,319508,319508,319510,0,2,2
91536,4,3,319512,319512,319515,0,3,2
91537,1,2,319513,319515,319517,2,4,0
91538,1,3,319514,319517,319520,3,6,0
91539,4,1,319518,319520,319521,2,3,0
91540,5,2,319523,319523,319525,0,2,2
91541,6,2,319529,319529,319531,0,2,4
91542,3,3,319532,319532,319535,0,3,1
91543,3,3,319535,319535,319538,0,3,0
91544,1,1,319536,319538,319539,2,3,0
91545,6,1,319542,319542,319543,0,1,3
91546,1,2,319543,319543,319545,0,2,0
91547,1,3,319544,319545,319548,1,4,0
91548,5,1,319549,319549,319550,0,1,1
91549,2,1,319551,319551,319552,0,1,1
91550,4,2,319555,319555,319557,0,2,3
91551,5,3,319560,319560,319563,0,3,3
91552,4,2,319564,319564,319566,0,2,1
91553,2,1,319566,319566,319567,0,1,0
91554,1,3,319567,319567,319570,0,3,0
91555,6,3,319573,319573,319576,0,3,3
91556,1,1,319574,319576,319577,2,3,0
91557,4,1,319578,319578,319579,0,1,1
91558,6,3,319584,319584,319587,0,3,5
91559,6,3,319590,319590,319593,0,3,3
91560,2,2,319592,319593,319595,1,3,0
91561,2,1,319594,319595,319596,1,2,0
91562,1,1,319595,319596,319597,1,2,0
91563,4,2,319599,319599,319601,0,2,2
91564,6,3,319605,319605,319608,0,3,4
91565,5,3,319610,319610,319613,0,3,2
91566,6,3,319616,319616,319619,0,3,3
91567,6,3,319622,319622,319625,0,3,3
91568,2,1,319624,319625,319626,1,2,0
91569,1,3,319625,319626,319629,1,4,0
91570,2,2,319627,319629,319631,2,4,0
91571,6,3,319633,319633,319636,0,3,2
91572,2,2,319635,319636,319638,1,3,0
91573,1,2,319636,319638,319640,2,4,0
91574,6,2,319642,319642,319644,0,2,2
91575,5,2,319647,319647,319649,0,2,3
91576,2,3,319649,319649,319652,0,3,0
91577,3,3,319652,319652,319655,0,3,0
91578,2,3,319654,319655,319658,1,4,0
91579,3,1,319657,319658,319659,1,2,0
91580,6,1,319663,319663,319664,0,1,4
91581,4,1,319667,319667,319668,0,1,3
91582,3,2,319670,319670,319672,0,2,2
91583,5,1,319675,319675,319676,0,1,3
91584,6,1,319681,319681,319682,0,1,5
91585,6,2,319687,319687,319689,0,2,5
91586,5,2,319692,319692,319694,0,2,3
91587,3,3,319695,319695,319698,0,3,1
91588,3,3,319698,319698,319701,0,3,0
91589,1,1,319699,319701,319702,2,3,0
91590,2,3,319701,319702,319705,1,4,0
91591,1,1,319702,319705,319706,3,4,0
91592,3,1,319705,319706,319707,1,2,0
91593,3,1,319708,319708,319709,0,1,1
91594,3,3,319711,319711,319714,0,3,2
91595,1,2,319712,319714,319716,2,4,0
91596,4,1,319716,319716,319717,0,1,0
91597,4,2,319720,319720,319722,0,2,3
91598,6,2,319726,319726,319728,0,2,4
91599,1,1,319727,319728,319729,1,2,0
91600,3,1,319730,319730,319731,0,1,1
91601,5,2,319735,319735,319737,0,2,4
91602,1,3,319736,319737,319740,1,4,0
91603,3,1,319739,319740,319741,1,2,0
91604,3,2,319742,319742,319744,0,2,1
91605,6,3,319748,319748,319751,0,3,4
91606,1,1,319749,319751,319752,2,3,0
91607,1,3,319750,319752,319755,2,5,0
91608,3,1,319753,319755,319756,2,3,0
91609,4,2,319757,319757,319759,0,2,1
91610,2,3,319759,319759,319762,0,3,0
91611,1,2,319760,319762,319764,2,4,0
91612,6,1,319766,319766,319767,0,1,2
91613,6,2,319772,319772,319774,0,2,5
91614,3,3,319775,319775,319778,0,3,1
91615,6,1,319781,319781,319782,0,1,3
91616,3,1,319784,319784,319785,0,1,2
91617,1,2,319785,319785,319787,0,2,0
91618,3,3,319788,319788,319791,0,3,1
91619,4,2,319792,319792,319794,0,2,1
91620,2,1,319794,319794,319795,0,1,0
91621,2,1,319796,319796,319797,0,1,1
91622,6,3,319802,319802,319805,0,3,5
91623,2,2,319804,319805,319807,1,3,0
91624,5,3,319809,319809,319812,0,3,2
91625,5,3,319814,319814,319817,0,3,2
91626,6,3,319820,319820,319823,0,3,3
91627,2,2,319822,319823,319825,1,3,0
91628,6,2,319828,319828,319830,0,2,3
91629,3,1,319831,319831,319832,0,1,1
91630,2,1,319833,319833,319834,0,1,1
91631,1,1,319834,319834,319835,0,1,0
91632,1,3,319835,319835,319838,0,3,0
91633,6,2,319841,319841,319843,0,2,3
91634,3,2,319844,319844,319846,0,2,1
91635,2,3,319846,319846,319849,0,3,0
91636,4,3,319850,319850,319853,0,3,1
91637,4,3,319854,319854,319857,0,3,1
91638,3,2,319857,319857,319859,0,2,0
91639,5,1,319862,319862,319863,0,1,3
91640,4,2,319866,319866,319868,0,2,3
91641,4,3,319870,319870,319873,0,3,2
91642,6,3,319876,319876,319879,0,3,3
91643,1,3,319877,319879,319882,2,5,0
91644,5,3,319882,319882,319885,0,3,0
91645,5,3,319887,319887,319890,0,3,2
91646,3,3,319890,319890,319893,0,3,0
91647,1,3,319891,319893,319896,2,5,0
91648,3,3,319894,319896,319899,2,5,0
91649,3,3,319897,319899,319902,2,5,0
91650,1,2,319898,319902,319904,4,6,0
91651,1,1,319899,319904,319905,5,6,0
91652,4,3,319903,319905,319908,2,5,0
91653,1,1,319904,319908,319909,4,5,0
91654,3,1,319907,319909,319910,2,3,0
91655,2,2,319909,319910,319912,1,3,0
91656,2,2,319911,319912,319914,1,3,0
91657,3,2,319914,319914,319916,0,2,0
91658,1,3,319915,319916,319919,1,4,0
91659,1,1,319916,319919,319920,3,4,0
91660,3,2,319919,319920,319922,1,3,0
91661,1,2,319920,319922,319924,2,4,0
91662,5,3,319925,319925,319928,0,3,1
91663,4,1,319929,319929,319930,0,1,1
91664,4,2,319933,319933,319935,0,2,3
91665,5,2,319938,319938,319940,0,2,3
91666,6,1,319944,319944,319945,0,1,4
91667,4,1,319948,319948,319949,0,1,3
91668,3,3,319951,319951,319954,0,3,2
91669,2,3,319953,319954,319957,1,4,0
91670,2,3,319955,319957,319960,2,5,0
91671,4,2,319959,319960,319962,1,3,0
91672,2,2,319961,319962,319964,1,3,0
91673,2,2,319963,319964,319966,1,3,0
91674,2,1,319965,319966,319967,1,2,0
91675,5,1,319970,319970,319971,0,1,3
91676,6,3,319976,319976,319979,0,3,5
91677,5,1,319981,319981,319982,0,1,2
91678,1,3,319982,319982,319985,0,3,0
91679,1,1,319983,319985,319986,2,3,0
91680,6,2,319989,319989,319991,0,2,3
91681,3,1,319992,319992,319993,0,1,1
91682,2,3,319994,319994,319997,0,3,1
91683,1,2,319995,319997,319999,2,4,0
91684,6,3,320001,320001,320004,0,3,2
91685,6,3,320007,320007,320010,0,3,3
91686,1,3,320008,320010,320013,2,5,0
91687,3,3,320011,320013,320016,2,5,0
91688,1,3,320012,320016,320019,4,7,0
91689,6,1,320018,320019,320020,1,2,0
91690,1,2,320019,320020,320022,1,3,0
91691,1,2,320020,320022,320024,2,4,0
91692,6,3,320026,320026,320029,0,3,2
91693,5,1,320031,320031,320032,0,1,2
91694,5,3,320036,320036,320039,0,3,4
91695,2,2,320038,320039,320041,1,3,0
91696,1,2,320039,320041,320043,2,4,0
91697,6,1,320045,320045,320046,0,1,2
91698,4,3,320049,320049,320052,0,3,3
91699,1,2,320050,320052,320054,2,4,0
91700,3,2,320053,320054,320056,1,3,0
91701,1,3,320054,320056,320059,2,5,0
91702,4,3,320058,320059,320062,1,4,0
91703,4,3,320062,320062,320065,0,3,0
91704,3,3,320065,320065,320068,0,3,0
91705,6,1,320071,320071,320072,0,1,3
91706,4,2,320075,320075,320077,0,2,3
91707,1,3,320076,320077,320080,1,4,0
91708,6,3,320082,320082,320085,0,3,2
91709,6,2,320088,320088,320090,0,2,3
91710,5,1,320093,320093,320094,0,1,3
91711,4,2,320097,320097,320099,0,2,3
91712,3,1,320100,320100,320101,0,1,1
91713,3,3,320103,320103,320106,0,3,2
91714,2,1,320105,320106,320107,1,2,0
91715,3,2,320108,320108,320110,0,2,1
91716,2,1,320110,320110,320111,0,1,0
91717,2,3,320112,320112,320115,0,3,1
91718,4,1,320116,320116,320117,0,1,1
91719,5,1,320121,320121,320122,0,1,4
91720,3,2,320124,320124,320126,0,2,2
91721,4,3,320128,320128,320131,0,3,2
91722,1,1,320129,320131,320132,2,3,0
91723,5,2,320134,320134,320136,0,2,2
91724,1,3,320135,320136,320139,1,4,0
91725,2,1,320137,320139,320140,2,3,0
91726,1,2,320138,320140,320142,2,4,0
91727,3,3,320141,320142,320145,1,4,0
91728,4,1,320145,320145,320146,0,1,0
91729,4,3,320149,320149,320152,0,3,3
91730,3,2,320152,320152,320154,0,2,0
91731,5,2,320157,320157,320159,0,2,3
91732,5,2,320162,320162,320164,0,2,3
91733,2,1,320164,320164,320165,0,1,0
91734,3,2,320167,320167,320169,0,2,2
91735,3,2,320170,320170,320172,0,2,1
91736,6,3,320176,320176,320179,0,3,4
91737,6,1,320182,320182,320183,0,1,3
91738,6,1,320188,320188,320189,0,1,5
91739,2,1,320190,320190,320191,0,1,1
91740,3,1,320193,320193,320194,0,1,2
91741,4,3,320197,320197,320200,0,3,3
91742,6,2,320203,320203,320205,0,2,3
91743,6,2,320209,320209,320211,0,2,4
91744,1,3,320210,320211,320214,1,4,0
91745,3,2,320213,320214,320216,1,3,0
91746,1,3,320214,320216,320219,2,5,0
91747,4,1,320218,320219,320220,1,2,0
91748,4,2,320222,320222,320224,0,2,2
91749,3,1,320225,320225,320226,0,1,1
91750,4,2,320229,320229,320231,0,2,3
91751,6,3,320235,320235,320238,0,3,4
91752,2,1,320237,320238,320239,1,2,0
91753,3,2,320240,320240,320242,0,2,1
91754,6,1,320246,320246,320247,0,1,4
91755,4,2,320250,320250,320252,0,2,3
91756,6,1,320256,320256,320257,0,1,4
91757,2,1,320258,320258,320259,0,1,1
91758,3,2,320261,320261,320263,0,2,2
91759,3,2,320264,320264,320266,0,2,1
91760,5,3,320269,320269,320272,0,3,3
91761,5,3,320274,320274,320277,0,3,2
91762,3,3,320277,320277,320280,0,3,0
91763,3,1,320280,320280,320281,0,1,0
91764,4,2,320284,320284,320286,0,2,3
91765,6,3,320290,320290,320293,0,3,4
91766,1,1,320291,320293,320294,2,3,0
91767,5,3,320296,320296,320299,0,3,2
91768,4,2,320300,320300,320302,0,2,1
91769,5,3,320305,320305,320308,0,3,3
91770,5,1,320310,320310,320311,0,1,2
91771,3,1,320313,320313,320314,0,1,2
91772,1,2,320314,320314,320316,0,2,0
91773,2,3,320316,320316,320319,0,3,0
91774,4,3,320320,320320,320323,0,3,1
91775,5,1,320325,320325,320326,0,1,2
91776,3,1,320328,320328,320329,0,1,2
91777,2,1,320330,320330,320331,0,1,1
91778,2,2,320332,320332,320334,0,2,1
91779,2,2,320334,320334,320336,0,2,0
91780,6,2,320340,320340,320342,0,2,4
91781,5,2,320345,320345,320347,0,2,3
91782,2,2,320347,320347,320349,0,2,0
91783,2,3,320349,320349,320352,0,3,0
91784,3,2,320352,320352,320354,0,2,0
91785,5,2,320357,320357,320359,0,2,3
91786,1,3,320358,320359,320362,1,4,0
91787,3,2,320361,320362,320364,1,3,0
91788,6,3,320367,320367,320370,0,3,3
91789,4,1,320371,320371,320372,0,1,1
91790,2,1,320373,320373,320374,0,1,1
91791,3,1,320376,320376,320377,0,1,2
91792,6,2,320382,320382,320384,0,2,5
91793,4,3,320386,320386,320389,0,3,2
91794,4,2,320390,320390,320392,0,2,1
91795,5,2,320395,320395,320397,0,2,3
91796,2,1,320397,320397,320398,0,1,0
91797,2,1,320399,320399,320400,0,1,1
91798,3,3,320402,320402,320405,0,3,2
91799,3,3,320405,320405,320408,0,3,0
91800,6,1,320411,320411,320412,0,1,3
91801,6,3,320417,320417,320420,0,3,5
91802,3,2,320420,320420,320422,0,2,0
91803,2,1,320422,320422,320423,0,1,0
91804,5,3,320427,320427,320430,0,3,4
91805,3,2,320430,320430,320432,0,2,0
91806,2,1,320432,320432,320433,0,1,0
91807,5,1,320437,320437,320438,0,1,4
91808,5,2,320442,320442,320444,0,2,4
91809,3,3,320445,320445,320448,0,3,1
91810,2,3,320447,320448,320451,1,4,0
91811,5,3,320452,320452,320455,0,3,1
91812,3,1,320455,320455,320456,0,1,0
91813,2,2,320457,320457,320459,0,2,1
91814,3,3,320460,320460,320463,0,3,1
91815,4,1,320464,320464,320465,0,1,1
91816,4,3,320468,320468,320471,0,3,3
91817,3,2,320471,320471,320473,0,2,0
91818,4,3,320475,320475,320478,0,3,2
91819,5,2,320480,320480,320482,0,2,2
91820,3,2,320483,320483,320485,0,2,1
91821,4,1,320487,320487,320488,0,1,2
91822,4,3,320491,320491,320494,0,3,3
91823,5,3,320496,320496,320499,0,3,2
91824,5,3,320501,320501,320504,0,3,2
91825,5,2,320506,320506,320508,0,2,2
91826,6,1,320512,320512,320513,0,1,4
91827,3,1,320515,320515,320516,0,1,2
91828,6,3,320521,320521,320524,0,3,5
91829,2,2,320523,320524,320526,1,3,0
91830,6,2,320529,320529,320531,0,2,3
91831,1,1,320530,320531,320532,1,2,0
91832,5,2,320535,320535,320537,0,2,3
91833,2,3,320537,320537,320540,0,3,0
91834,2,1,320539,320540,320541,1,2,0
91835,3,2,320542,320542,320544,0,2,1
91836,2,1,320544,320544,320545,0,1,0
91837,6,1,320550,320550,320551,0,1,5
91838,6,2,320556,320556,320558,0,2,5
91839,2,3,320558,320558,320561,0,3,0
91840,3,1,320561,320561,320562,0,1,0
91841,1,3,320562,320562,320565,0,3,0
91842,2,2,320564,320565,320567,1,3,0
91843,3,1,320567,320567,320568,0,1,0
91844,3,1,320570,320570,320571,0,1,2
91845,3,1,320573,320573,320574,0,1,2
91846,2,1,320575,320575,320576,0,1,1
91847,3,1,320578,320578,320579,0,1,2
91848,5,3,320583,320583,320586,0,3,4
91849,4,2,320587,320587,320589,0,2,1
91850,5,1,320592,320592,320593,0,1,3
91851,6,3,320598,320598,320601,0,3,5
91852,2,2,320600,320601,320603,1,3,0
91853,6,1,320606,320606,320607,0,1,3
91854,2,3,320608,320608,320611,0,3,1
91855,4,3,320612,320612,320615,0,3,1
91856,4,3,320616,320616,320619,0,3,1
91857,5,2,320621,320621,320623,0,2,2
91858,2,1,320623,320623,320624,0,1,0
91859,6,2,320629,320629,320631,0,2,5
91860,5,2,320634,320634,320636,0,2,3
91861,5,3,320639,320639,320642,0,3,3
91862,5,2,320644,320644,320646,0,2,2
91863,2,2,320646,320646,320648,0,2,0
91864,1,3,320647,320648,320651,1,4,0
91865,3,2,320650,320651,320653,1,3,0
91866,5,3,320655,320655,320658,0,3,2
91867,5,1,320660,320660,320661,0,1,2
91868,3,1,320663,320663,320664,0,1,2
91869,2,2,320665,320665,320667,0,2,1
91870,1,3,320666,320667,320670,1,4,0
91871,6,3,320672,320672,320675,0,3,2
91872,5,1,320677,320677,320678,0,1,2
91873,6,3,320683,320683,320686,0,3,5
91874,6,3,320689,320689,320692,0,3,3
91875,5,2,320694,320694,320696,0,2,2
91876,5,1,320699,320699,320700,0,1,3
91877,1,1,320700,320700,320701,0,1,0
91878,2,2,320702,320702,320704,0,2,1
91879,5,2,320707,320707,320709,0,2,3
91880,4,3,320711,320711,320714,0,3,2
91881,6,3,320717,320717,320720,0,3,3
91882,3,2,320720,320720,320722,0,2,0
91883,4,3,320724,320724,320727,0,3,2
91884,4,1,320728,320728,320729,0,1,1
91885,6,2,320734,320734,320736,0,2,5
91886,1,2,320735,320736,320738,1,3,0
91887,3,3,320738,320738,320741,0,3,0
91888,4,3,320742,320742,320745,0,3,1
91889,6,3,320748,320748,320751,0,3,3
91890,4,1,320752,320752,320753,0,1,1
91891,4,2,320756,320756,320758,0,2,3
91892,6,1,320762,320762,320763,0,1,4
91893,2,3,320764,320764,320767,0,3,1
91894,6,3,320770,320770,320773,0,3,3
91895,6,1,320776,320776,320777,0,1,3
91896,2,1,320778,320778,320779,0,1,1
91897,4,3,320782,320782,320785,0,3,3
91898,6,1,320788,320788,320789,0,1,3
91899,2,1,320790,320790,320791,0,1,1
91900,3,3,320793,320793,320796,0,3,2
91901,5,1,320798,320798,320799,0,1,2
91902,4,3,320802,320802,320805,0,3,3
91903,4,2,320806,320806,320808,0,2,1
91904,5,1,320811,320811,320812,0,1,3
91905,3,3,320814,320814,320817,0,3,2
91906,4,1,320818,320818,320819,0,1,1
91907,5,3,320823,320823,320826,0,3,4
91908,5,2,320828,320828,320830,0,2,2
91909,6,1,320834,320834,320835,0,1,4
91910,3,3,320837,320837,320840,0,3,2
91911,4,3,320841,320841,320844,0,3,1
91912,3,2,320844,320844,320846,0,2,0
91913,3,3,320847,320847,320850,0,3,1
91914,2,3,320849,320850,320853,1,4,0
91915,1,3,320850,320853,320856,3,6,0
91916,4,2,320854,320856,320858,2,4,0
91917,6,1,320860,320860,320861,0,1,2
91918,3,3,320863,320863,320866,0,3,2
91919,3,1,320866,320866,320867,0,1,0
91920,5,1,320871,320871,320872,0,1,4
91921,5,3,320876,320876,320879,0,3,4
91922,4,1,320880,320880,320881,0,1,1
91923,2,2,320882,320882,320884,0,2,1
91924,3,1,320885,320885,320886,0,1,1
91925,2,2,320887,320887,320889,0,2,1
91926,4,3,320891,320891,320894,0,3,2
91927,4,1,320895,320895,320896,0,1,1
91928,2,2,320897,320897,320899,0,2,1
91929,4,1,320901,320901,320902,0,1,2
91930,2,2,320903,320903,320905,0,2,1
91931,2,3,320905,320905,320908,0,3,0
91932,4,1,320909,320909,320910,0,1,1
91933,2,2,320911,320911,320913,0,2,1
91934,5,1,320916,320916,320917,0,1,3
91935,5,1,320921,320921,320922,0,1,4
91936,5,3,320926,320926,320929,0,3,4
91937,4,3,320930,320930,320933,0,3,1
91938,6,1,320936,320936,320937,0,1,3
91939,5,2,320941,320941,320943,0,2,4
91940,2,3,320943,320943,320946,0,3,0
91941,4,1,320947,320947,320948,0,1,1
91942,2,3,320949,320949,320952,0,3,1
91943,2,2,320951,320952,320954,1,3,0
91944,1,1,320952,320954,320955,2,3,0
91945,4,2,320956,320956,320958,0,2,1
91946,4,3,320960,320960,320963,0,3,2
91947,1,1,320961,320963,320964,2,3,0
91948,3,2,320964,320964,320966,0,2,0
91949,3,2,320967,320967,320969,0,2,1
91950,5,3,320972,320972,320975,0,3,3
91951,4,2,320976,320976,320978,0,2,1
91952,4,3,320980,320980,320983,0,3,2
91953,5,2,320985,320985,320987,0,2,2
91954,1,2,320986,320987,320989,1,3,0
91955,4,3,320990,320990,320993,0,3,1
91956,6,3,320996,320996,320999,0,3,3
91957,4,2,321000,321000,321002,0,2,1
91958,6,2,321006,321006,321008,0,2,4
91959,5,2,321011,321011,321013,0,2,3
91960,4,1,321015,321015,321016,0,1,2
91961,3,2,321018,321018,321020,0,2,2
91962,2,1,321020,321020,321021,0,1,0
91963,4,2,321024,321024,321026,0,2,3
91964,6,2,321030,321030,321032,0,2,4
91965,3,2,321033,321033,321035,0,2,1
91966,4,1,321037,321037,321038,0,1,2
91967,6,1,321043,321043,321044,0,1,5
91968,4,2,321047,321047,321049,0,2,3
91969,4,3,321051,321051,321054,0,3,2
91970,4,1,321055,321055,321056,0,1,1
91971,5,2,321060,321060,321062,0,2,4
91972,4,2,321064,321064,321066,0,2,2
91973,1,1,321065,321066,321067,1,2,0
91974,4,3,321069,321069,321072,0,3,2
91975,5,3,321074,321074,321077,0,3,2
91976,4,1,321078,321078,321079,0,1,1
91977,2,2,321080,321080,321082,0,2,1
91978,3,3,321083,321083,321086,0,3,1
91979,5,3,321088,321088,321091,0,3,2
91980,4,3,321092,321092,321095,0,3,1
91981,5,2,321097,321097,321099,0,2,2
91982,2,3,321099,321099,321102,0,3,0
91983,1,3,321100,321102,321105,2,5,0
91984,5,3,321105,321105,321108,0,3,0
91985,6,3,321111,321111,321114,0,3,3
91986,3,3,321114,321114,321117,0,3,0
91987,5,3,321119,321119,321122,0,3,2
91988,4,1,321123,321123,321124,0,1,1
91989,3,2,321126,321126,321128,0,2,2
91990,3,2,321129,321129,321131,0,2,1
91991,2,1,321131,321131,321132,0,1,0
91992,2,3,321133,321133,321136,0,3,1
91993,6,3,321139,321139,321142,0,3,3
91994,1,2,321140,321142,321144,2,4,0
91995,3,2,321143,321144,321146,1,3,0
91996,4,3,321147,321147,321150,0,3,1
91997,4,3,321151,321151,321154,0,3,1
91998,1,2,321152,321154,321156,2,4,0
91999,3,3,321155,321156,321159,1,4,0
92000,3,3,321158,321159,321162,1,4,0
92001,6,1,321164,321164,321165,0,1,2
92002,4,3,321168,321168,321171,0,3,3
92003,6,2,321174,321174,321176,0,2,3
92004,4,1,321178,321178,321179,0,1,2
92005,6,3,321184,321184,321187,0,3,5
92006,4,3,321188,321188,321191,0,3,1
92007,1,1,321189,321191,321192,2,3,0
92008,6,1,321195,321195,321196,0,1,3
92009,2,1,321197,321197,321198,0,1,1
92010,2,2,321199,321199,321201,0,2,1
92011,3,3,321202,321202,321205,0,3,1
92012,2,1,321204,321205,321206,1,2,0
92013,6,1,321210,321210,321211,0,1,4
92014,2,3,321212,321212,321215,0,3,1
92015,2,1,321214,321215,321216,1,2,0
92016,4,2,321218,321218,321220,0,2,2
92017,6,1,321224,321224,321225,0,1,4
92018,1,2,321225,321225,321227,0,2,0
92019,3,2,321228,321228,321230,0,2,1
92020,2,3,321230,321230,321233,0,3,0
92021,1,2,321231,321233,321235,2,4,0
92022,6,1,321237,321237,321238,0,1,2
92023,5,2,321242,321242,321244,0,2,4
92024,5,2,321247,321247,321249,0,2,3
92025,2,1,321249,321249,321250,0,1,0
92026,4,1,321253,321253,321254,0,1,3
92027,1,3,321254,321254,321257,0,3,0
92028,6,1,321260,321260,321261,0,1,3
92029,1,1,321261,321261,321262,0,1,0
92030,1,1,321262,321262,321263,0,1,0
92031,6,1,321268,321268,321269,0,1,5
92032,4,1,321272,321272,321273,0,1,3
92033,4,3,321276,321276,321279,0,3,3
92034,6,1,321282,321282,321283,0,1,3
92035,2,2,321284,321284,321286,0,2,1
92036,5,2,321289,321289,321291,0,2,3
92037,1,2,321290,321291,321293,1,3,0
92038,6,3,321296,321296,321299,0,3,3
92039,4,1,321300,321300,321301,0,1,1
92040,6,2,321306,321306,321308,0,2,5
92041,1,1,321307,321308,321309,1,2,0
92042,4,2,321311,321311,321313,0,2,2
92043,4,3,321315,321315,321318,0,3,2
92044,5,1,321320,321320,321321,0,1,2
92045,4,3,321324,321324,321327,0,3,3
92046,6,1,321330,321330,321331,0,1,3
92047,3,3,321333,321333,321336,0,3,2
92048,3,3,321336,321336,321339,0,3,0
92049,6,2,321342,321342,321344,0,2,3
92050,4,2,321346,321346,321348,0,2,2
92051,2,2,321348,321348,321350,0,2,0
92052,6,3,321354,321354,321357,0,3,4
92053,2,3,321356,321357,321360,1,4,0
92054,3,2,321359,321360,321362,1,3,0
92055,1,2,321360,321362,321364,2,4,0
92056,2,2,321362,321364,321366,2,4,0
92057,3,1,321365,321366,321367,1,2,0
92058,5,2,321370,321370,321372,0,2,3
92059,5,2,321375,321375,321377,0,2,3
92060,3,3,321378,321378,321381,0,3,1
92061,3,1,321381,321381,321382,0,1,0
92062,6,1,321387,321387,321388,0,1,5
92063,1,3,321388,321388,321391,0,3,0
92064,6,2,321394,321394,321396,0,2,3
92065,5,3,321399,321399,321402,0,3,3
92066,5,3,321404,321404,321407,0,3,2
92067,4,1,321408,321408,321409,0,1,1
92068,4,2,321412,321412,321414,0,2,3
92069,3,3,321415,321415,321418,0,3,1
92070,1,3,321416,321418,321421,2,5,0
92071,6,2,321422,321422,321424,0,2,1
92072,3,1,321425,321425,321426,0,1,1
92073,3,2,321428,321428,321430,0,2,2
92074,1,1,321429,321430,321431,1,2,0
92075,1,1,321430,321431,321432,1,2,0
92076,2,2,321432,321432,321434,0,2,0
92077,1,1,321433,321434,321435,1,2,0
92078,3,2,321436,321436,321438,0,2,1
92079,3,2,321439,321439,321441,0,2,1
92080,4,1,321443,321443,321444,0,1,2
92081,6,1,321449,321449,321450,0,1,5
92082,2,1,321451,321451,321452,0,1,1
92083,6,3,321457,321457,321460,0,3,5
92084,1,1,321458,321460,321461,2,3,0
92085,6,2,321464,321464,321466,0,2,3
92086,6,3,321470,321470,321473,0,3,4
92087,1,1,321471,321473,321474,2,3,0
92088,5,2,321476,321476,321478,0,2,2
92089,4,1,321480,321480,321481,0,1,2
92090,5,1,321485,321485,321486,0,1,4
92091,5,3,321490,321490,321493,0,3,4
92092,5,1,321495,321495,321496,0,1,2
92093,5,2,321500,321500,321502,0,2,4
92094,6,1,321506,321506,321507,0,1,4
92095,2,1,321508,321508,321509,0,1,1
92096,3,3,321511,321511,321514,0,3,2
92097,2,3,321513,321514,321517,1,4,0
92098,4,2,321517,321517,321519,0,2,0
92099,4,3,321521,321521,321524,0,3,2
92100,5,1,321526,321526,321527,0,1,2
92101,1,2,321527,321527,321529,0,2,0
92102,6,1,321533,321533,321534,0,1,4
92103,3,3,321536,321536,321539,0,3,2
92104,3,1,321539,321539,321540,0,1,0
92105,1,2,321540,321540,321542,0,2,0
92106,4,1,321544,321544,321545,0,1,2
92107,1,3,321545,321545,321548,0,3,0
92108,4,2,321549,321549,321551,0,2,1
92109,1,1,321550,321551,321552,1,2,0
92110,6,3,321556,321556,321559,0,3,4
92111,3,2,321559,321559,321561,0,2,0
92112,3,2,321562,321562,321564,0,2,1
92113,5,2,321567,321567,321569,0,2,3
92114,3,2,321570,321570,321572,0,2,1
92115,5,3,321575,321575,321578,0,3,3
92116,3,1,321578,321578,321579,0,1,0
92117,5,2,321583,321583,321585,0,2,4
92118,3,3,321586,321586,321589,0,3,1
92119,1,1,321587,321589,321590,2,3,0
92120,5,2,321592,321592,321594,0,2,2
92121,2,2,321594,321594,321596,0,2,0
92122,3,3,321597,321597,321600,0,3,1
92123,4,1,321601,321601,321602,0,1,1
92124,6,3,321607,321607,321610,0,3,5
92125,5,2,321612,321612,321614,0,2,2
92126,6,3,321618,321618,321621,0,3,4
92127,5,3,321623,321623,321626,0,3,2
92128,1,1,321624,321626,321627,2,3,0
92129,6,1,321630,321630,321631,0,1,3
92130,5,2,321635,321635,321637,0,2,4
92131,4,3,321639,321639,321642,0,3,2
92132,1,1,321640,321642,321643,2,3,0
92133,4,2,321644,321644,321646,0,2,1
92134,1,2,321645,321646,321648,1,3,0
92135,3,2,321648,321648,321650,0,2,0
92136,5,1,321653,321653,321654,0,1,3
92137,5,2,321658,321658,321660,0,2,4
92138,3,1,321661,321661,321662,0,1,1
92139,6,2,321667,321667,321669,0,2,5
92140,1,2,321668,321669,321671,1,3,0
92141,1,2,321669,321671,321673,2,4,0
92142,1,3,321670,321673,321676,3,6,0
92143,2,1,321672,321676,321677,4,5,0
92144,5,3,321677,321677,321680,0,3,0
92145,4,3,321681,321681,321684,0,3,1
92146,4,3,321685,321685,321688,0,3,1
92147,1,3,321686,321688,321691,2,5,0
92148,4,1,321690,321691,321692,1,2,0
92149,1,3,321691,321692,321695,1,4,0
92150,6,2,321697,321697,321699,0,2,2
92151,6,2,321703,321703,321705,0,2,4
92152,1,2,321704,321705,321707,1,3,0
92153,1,1,321705,321707,321708,2,3,0
92154,2,2,321707,321708,321710,1,3,0
92155,1,1,321708,321710,321711,2,3,0
92156,4,2,321712,321712,321714,0,2,1
92157,3,3,321715,321715,321718,0,3,1
92158,3,1,321718,321718,321719,0,1,0
92159,2,3,321720,321720,321723,0,3,1
92160,4,1,321724,321724,321725,0,1,1
92161,6,3,321730,321730,321733,0,3,5
92162,2,3,321732,321733,321736,1,4,0
92163,1,3,321733,321736,321739,3,6,0
92164,4,1,321737,321739,321740,2,3,0
92165,6,1,321743,321743,321744,0,1,3
92166,4,2,321747,321747,321749,0,2,3
92167,4,1,321751,321751,321752,0,1,2
92168,2,3,321753,321753,321756,0,3,1
92169,6,1,321759,321759,321760,0,1,3
92170,2,3,321761,321761,321764,0,3,1
92171,6,3,321767,321767,321770,0,3,3
92172,5,3,321772,321772,321775,0,3,2
92173,6,3,321778,321778,321781,0,3,3
92174,6,3,321784,321784,321787,0,3,3
92175,5,3,321789,321789,321792,0,3,2
92176,2,1,321791,321792,321793,1,2,0
92177,6,1,321797,321797,321798,0,1,4
92178,2,2,321799,321799,321801,0,2,1
92179,1,2,321800,321801,321803,1,3,0
92180,3,1,321803,321803,321804,0,1,0
92181,2,2,321805,321805,321807,0,2,1
92182,4,2,321809,321809,321811,0,2,2
92183,2,2,321811,321811,321813,0,2,0
92184,3,3,321814,321814,321817,0,3,1
92185,4,2,321818,321818,321820,0,2,1
92186,2,2,321820,321820,321822,0,2,0
92187,5,3,321825,321825,321828,0,3,3
92188,2,3,321827,321828,321831,1,4,0
92189,2,1,321829,321831,321832,2,3,0
92190,2,3,321831,321832,321835,1,4,0
92191,4,2,321835,321835,321837,0,2,0
92192,1,3,321836,321837,321840,1,4,0
92193,4,3,321840,321840,321843,0,3,0
92194,2,3,321842,321843,321846,1,4,0
92195,6,2,321848,321848,321850,0,2,2
92196,3,3,321851,321851,321854,0,3,1
92197,6,2,321857,321857,321859,0,2,3
92198,5,1,321862,321862,321863,0,1,3
92199,2,1,321864,321864,321865,0,1,1
92200,1,2,321865,321865,321867,0,2,0
92201,4,2,321869,321869,321871,0,2,2
92202,5,1,321874,321874,321875,0,1,3
92203,6,3,321880,321880,321883,0,3,5
92204,2,3,321882,321883,321886,1,4,0
92205,4,3,321886,321886,321889,0,3,0
92206,2,1,321888,321889,321890,1,2,0
92207,4,2,321892,321892,321894,0,2,2
92208,5,2,321897,321897,321899,0,2,3
92209,1,1,321898,321899,321900,1,2,0
92210,6,1,321904,321904,321905,0,1,4
92211,3,2,321907,321907,321909,0,2,2
92212,3,3,321910,321910,321913,0,3,1
92213,4,3,321914,321914,321917,0,3,1
92214,2,3,321916,321917,321920,1,4,0
92215,3,2,321919,321920,321922,1,3,0
92216,1,1,321920,321922,321923,2,3,0
92217,6,3,321926,321926,321929,0,3,3
92218,4,1,321930,321930,321931,0,1,1
92219,6,1,321936,321936,321937,0,1,5
92220,2,2,321938,321938,321940,0,2,1
92221,4,2,321942,321942,321944,0,2,2
92222,5,3,321947,321947,321950,0,3,3
92223,1,3,321948,321950,321953,2,5,0
92224,5,1,321953,321953,321954,0,1,0
92225,4,2,321957,321957,321959,0,2,3
92226,5,3,321962,321962,321965,0,3,3
92227,3,1,321965,321965,321966,0,1,0
92228,1,3,321966,321966,321969,0,3,0
92229,2,2,321968,321969,321971,1,3,0
92230,6,3,321974,321974,321977,0,3,3
92231,2,2,321976,321977,321979,1,3,0
92232,5,3,321981,321981,321984,0,3,2
92233,5,2,321986,321986,321988,0,2,2
92234,6,1,321992,321992,321993,0,1,4
92235,5,3,321997,321997,322000,0,3,4
92236,2,2,321999,322000,322002,1,3,0
92237,1,1,322000,322002,322003,2,3,0
92238,6,2,322006,322006,322008,0,2,3
92239,2,2,322008,322008,322010,0,2,0
92240,6,1,322014,322014,322015,0,1,4
92241,6,2,322020,322020,322022,0,2,5
92242,3,3,322023,322023,322026,0,3,1
92243,5,3,322028,322028,322031,0,3,2
92244,1,2,322029,322031,322033,2,4,0
92245,5,2,322034,322034,322036,0,2,1
92246,1,2,322035,322036,322038,1,3,0
92247,2,2,322037,322038,322040,1,3,0
92248,3,1,322040,322040,322041,0,1,0
92249,5,3,322045,322045,322048,0,3,4
92250,5,3,322050,322050,322053,0,3,2
92251,5,1,322055,322055,322056,0,1,2
92252,2,3,322057,322057,322060,0,3,1
92253,3,1,322060,322060,322061,0,1,0
92254,2,2,322062,322062,322064,0,2,1
92255,3,3,322065,322065,322068,0,3,1
92256,3,3,322068,322068,322071,0,3,0
92257,1,2,322069,322071,322073,2,4,0
92258,6,2,322075,322075,322077,0,2,2
92259,1,3,322076,322077,322080,1,4,0
92260,2,3,322078,322080,322083,2,5,0
92261,6,2,322084,322084,322086,0,2,1
92262,3,1,322087,322087,322088,0,1,1
92263,6,1,322093,322093,322094,0,1,5
92264,5,2,322098,322098,322100,0,2,4
92265,5,2,322103,322103,322105,0,2,3
92266,1,3,322104,322105,322108,1,4,0
92267,4,2,322108,322108,322110,0,2,0
92268,1,1,322109,322110,322111,1,2,0
92269,3,3,322112,322112,322115,0,3,1
92270,5,2,322117,322117,322119,0,2,2
92271,4,3,322121,322121,322124,0,3,2
92272,3,3,322124,322124,322127,0,3,0
92273,1,3,322125,322127,322130,2,5,0
92274,2,3,322127,322130,322133,3,6,0
92275,4,1,322131,322133,322134,2,3,0
92276,4,3,322135,322135,322138,0,3,1
92277,6,1,322141,322141,322142,0,1,3
92278,3,3,322144,322144,322147,0,3,2
92279,3,3,322147,322147,322150,0,3,0
92280,5,3,322152,322152,322155,0,3,2
92281,1,1,322153,322155,322156,2,3,0
92282,6,2,322159,322159,322161,0,2,3
92283,5,2,322164,322164,322166,0,2,3
92284,3,2,322167,322167,322169,0,2,1
92285,5,2,322172,322172,322174,0,2,3
92286,2,3,322174,322174,322177,0,3,0
92287,5,3,322179,322179,322182,0,3,2
92288,6,1,322185,322185,322186,0,1,3
92289,6,1,322191,322191,322192,0,1,5
92290,6,2,322197,322197,322199,0,2,5
92291,4,2,322201,322201,322203,0,2,2
92292,1,2,322202,322203,322205,1,3,0
92293,1,1,322203,322205,322206,2,3,0
92294,3,1,322206,322206,322207,0,1,0
92295,1,1,322207,322207,322208,0,1,0
92296,2,2,322209,322209,322211,0,2,1
92297,3,3,322212,322212,322215,0,3,1
92298,5,1,322217,322217,322218,0,1,2
92299,5,1,322222,322222,322223,0,1,4
92300,2,3,322224,322224,322227,0,3,1
92301,5,3,322229,322229,322232,0,3,2
92302,1,3,322230,322232,322235,2,5,0
92303,1,3,322231,322235,322238,4,7,0
92304,1,2,322232,322238,322240,6,8,0
92305,6,2,322238,322240,322242,2,4,0
92306,4,1,322242,322242,322243,0,1,0
92307,2,3,322244,322244,322247,0,3,1
92308,3,1,322247,322247,322248,0,1,0
92309,4,3,322251,322251,322254,0,3,3
92310,3,3,322254,322254,322257,0,3,0
92311,6,1,322260,322260,322261,0,1,3
92312,1,1,322261,322261,322262,0,1,0
92313,1,3,322262,322262,322265,0,3,0
92314,6,1,322268,322268,322269,0,1,3
92315,2,2,322270,322270,322272,0,2,1
92316,3,2,322273,322273,322275,0,2,1
92317,3,3,322276,322276,322279,0,3,1
92318,3,3,322279,322279,322282,0,3,0
92319,5,1,322284,322284,322285,0,1,2
92320,6,1,322290,322290,322291,0,1,5
92321,3,1,322293,322293,322294,0,1,2
92322,2,1,322295,322295,322296,0,1,1
92323,4,1,322299,322299,322300,0,1,3
92324,5,2,322304,322304,322306,0,2,4
92325,2,3,322306,322306,322309,0,3,0
92326,4,1,322310,322310,322311,0,1,1
92327,6,1,322316,322316,322317,0,1,5
92328,3,1,322319,322319,322320,0,1,2
92329,5,3,322324,322324,322327,0,3,4
92330,1,2,322325,322327,322329,2,4,0
92331,4,1,322329,322329,322330,0,1,0
92332,4,2,322333,322333,322335,0,2,3
92333,4,1,322337,322337,322338,0,1,2
92334,4,3,322341,322341,322344,0,3,3
92335,3,2,322344,322344,322346,0,2,0
92336,3,3,322347,322347,322350,0,3,1
92337,3,3,322350,322350,322353,0,3,0
92338,5,2,322355,322355,322357,0,2,2
92339,2,3,322357,322357,322360,0,3,0
92340,5,2,322362,322362,322364,0,2,2
92341,1,3,322363,322364,322367,1,4,0
92342,1,1,322364,322367,322368,3,4,0
92343,4,1,322368,322368,322369,0,1,0
92344,1,1,322369,322369,322370,0,1,0
92345,2,3,322371,322371,322374,0,3,1
92346,5,1,322376,322376,322377,0,1,2
92347,1,2,322377,322377,322379,0,2,0
92348,3,2,322380,322380,322382,0,2,1
92349,3,3,322383,322383,322386,0,3,1
92350,6,2,322389,322389,322391,0,2,3
92351,2,3,322391,322391,322394,0,3,0
92352,6,2,322397,322397,322399,0,2,3
92353,2,1,322399,322399,322400,0,1,0
92354,5,3,322404,322404,322407,0,3,4
92355,3,3,322407,322407,322410,0,3,0
92356,1,1,322408,322410,322411,2,3,0
92357,5,3,322413,322413,322416,0,3,2
92358,6,1,322419,322419,322420,0,1,3
92359,2,3,322421,322421,322424,0,3,1
92360,4,2,322425,322425,322427,0,2,1
92361,4,1,322429,322429,322430,0,1,2
92362,4,1,322433,322433,322434,0,1,3
92363,3,3,322436,322436,322439,0,3,2
92364,2,3,322438,322439,322442,1,4,0
92365,6,2,322444,322444,322446,0,2,2
92366,1,2,322445,322446,322448,1,3,0
92367,4,1,322449,322449,322450,0,1,1
92368,5,1,322454,322454,322455,0,1,4
92369,2,2,322456,322456,322458,0,2,1
92370,5,2,322461,322461,322463,0,2,3
92371,6,2,322467,322467,322469,0,2,4
92372,3,1,322470,322470,322471,0,1,1
92373,5,2,322475,322475,322477,0,2,4
92374,1,2,322476,322477,322479,1,3,0
92375,6,3,322482,322482,322485,0,3,3
92376,4,3,322486,322486,322489,0,3,1
92377,6,1,322492,322492,322493,0,1,3
92378,4,2,322496,322496,322498,0,2,3
92379,4,1,322500,322500,322501,0,1,2
92380,1,1,322501,322501,322502,0,1,0
92381,4,1,322505,322505,322506,0,1,3
92382,6,1,322511,322511,322512,0,1,5
92383,2,2,322513,322513,322515,0,2,1
92384,6,2,322519,322519,322521,0,2,4
92385,6,1,322525,322525,322526,0,1,4
92386,1,2,322526,322526,322528,0,2,0
92387,6,1,322532,322532,322533,0,1,4
92388,5,1,322537,322537,322538,0,1,4
92389,4,1,322541,322541,322542,0,1,3
92390,3,3,322544,322544,322547,0,3,2
92391,1,2,322545,322547,322549,2,4,0
92392,1,2,322546,322549,322551,3,5,0
92393,6,3,322552,322552,322555,0,3,1
92394,1,1,322553,322555,322556,2,3,0
92395,2,1,322555,322556,322557,1,2,0
92396,5,2,322560,322560,322562,0,2,3
92397,3,2,322563,322563,322565,0,2,1
92398,4,3,322567,322567,322570,0,3,2
92399,4,2,322571,322571,322573,0,2,1
92400,4,2,322575,322575,322577,0,2,2
92401,3,3,322578,322578,322581,0,3,1
92402,1,3,322579,322581,322584,2,5,0
92403,4,1,322583,322584,322585,1,2,0
92404,5,2,322588,322588,322590,0,2,3
92405,4,1,322592,322592,322593,0,1,2
92406,2,3,322594,322594,322597,0,3,1
92407,3,3,322597,322597,322600,0,3,0
92408,5,1,322602,322602,322603,0,1,2
92409,4,1,322606,322606,322607,0,1,3
92410,3,3,322609,322609,322612,0,3,2
92411,2,2,322611,322612,322614,1,3,0
92412,1,1,322612,322614,322615,2,3,0
92413,4,1,322616,322616,322617,0,1,1
92414,2,3,322618,322618,322621,0,3,1
92415,4,1,322622,322622,322623,0,1,1
92416,4,2,322626,322626,322628,0,2,3
92417,4,2,322630,322630,322632,0,2,2
92418,2,2,322632,322632,322634,0,2,0
92419,2,1,322634,322634,322635,0,1,0
92420,3,3,322637,322637,322640,0,3,2
92421,3,3,322640,322640,322643,0,3,0
92422,1,2,322641,322643,322645,2,4,0
92423,5,3,322646,322646,322649,0,3,1
92424,4,2,322650,322650,322652,0,2,1
92425,4,1,322654,322654,322655,0,1,2
92426,4,2,322658,322658,322660,0,2,3
92427,6,1,322664,322664,322665,0,1,4
92428,4,3,322668,322668,322671,0,3,3
92429,6,2,322674,322674,322676,0,2,3
92430,2,3,322676,322676,322679,0,3,0
92431,6,1,322682,322682,322683,0,1,3
92432,5,3,322687,322687,322690,0,3,4
92433,5,1,322692,322692,322693,0,1,2
92434,6,1,322698,322698,322699,0,1,5
92435,1,2,322699,322699,322701,0,2,0
92436,6,2,322705,322705,322707,0,2,4
92437,5,1,322710,322710,322711,0,1,3
92438,6,2,322716,322716,322718,0,2,5
92439,3,1,322719,322719,322720,0,1,1
92440,4,1,322723,322723,322724,0,1,3
92441,3,2,322726,322726,322728,0,2,2
92442,5,2,322731,322731,322733,0,2,3
92443,4,3,322735,322735,322738,0,3,2
92444,3,2,322738,322738,322740,0,2,0
92445,5,3,322743,322743,322746,0,3,3
92446,5,2,322748,322748,322750,0,2,2
92447,2,2,322750,322750,322752,0,2,0
92448,2,3,322752,322752,322755,0,3,0
92449,6,3,322758,322758,322761,0,3,3
92450,2,1,322760,322761,322762,1,2,0
92451,3,2,322763,322763,322765,0,2,1
92452,4,3,322767,322767,322770,0,3,2
92453,5,1,322772,322772,322773,0,1,2
92454,1,1,322773,322773,322774,0,1,0
92455,3,2,322776,322776,322778,0,2,2
92456,5,2,322781,322781,322783,0,2,3
92457,3,2,322784,322784,322786,0,2,1
92458,5,3,322789,322789,322792,0,3,3
92459,4,3,322793,322793,322796,0,3,1
92460,5,2,322798,322798,322800,0,2,2
92461,1,3,322799,322800,322803,1,4,0
92462,1,2,322800,322803,322805,3,5,0
92463,1,3,322801,322805,322808,4,7,0
92464,6,1,322807,322808,322809,1,2,0
92465,3,2,322810,322810,322812,0,2,1
92466,4,1,322814,322814,322815,0,1,2
92467,5,3,322819,322819,322822,0,3,4
92468,4,2,322823,322823,322825,0,2,1
92469,5,3,322828,322828,322831,0,3,3
92470,4,2,322832,322832,322834,0,2,1
92471,2,1,322834,322834,322835,0,1,0
92472,2,2,322836,322836,322838,0,2,1
92473,2,1,322838,322838,322839,0,1,0
92474,4,1,322842,322842,322843,0,1,3
92475,3,1,322845,322845,322846,0,1,2
92476,5,3,322850,322850,322853,0,3,4
92477,6,2,322856,322856,322858,0,2,3
92478,3,1,322859,322859,322860,0,1,1
92479,5,2,322864,322864,322866,0,2,4
92480,1,1,322865,322866,322867,1,2,0
92481,1,2,322866,322867,322869,1,3,0
92482,6,1,322872,322872,322873,0,1,3
92483,6,3,322878,322878,322881,0,3,5
92484,1,1,322879,322881,322882,2,3,0
92485,4,1,322883,322883,322884,0,1,1
92486,5,3,322888,322888,322891,0,3,4
92487,5,3,322893,322893,322896,0,3,2
92488,1,1,322894,322896,322897,2,3,0
92489,5,3,322899,322899,322902,0,3,2
92490,6,3,322905,322905,322908,0,3,3
92491,3,2,322908,322908,322910,0,2,0
92492,2,2,322910,322910,322912,0,2,0
92493,2,3,322912,322912,322915,0,3,0
92494,1,3,322913,322915,322918,2,5,0
92495,3,2,322916,322918,322920,2,4,0
92496,6,1,322922,322922,322923,0,1,2
92497,6,1,322928,322928,322929,0,1,5
92498,6,3,322934,322934,322937,0,3,5
92499,6,1,322940,322940,322941,0,1,3
92500,1,1,322941,322941,322942,0,1,0
92501,3,2,322944,322944,322946,0,2,2
92502,1,3,322945,322946,322949,1,4,0
92503,1,2,322946,322949,322951,3,5,0
92504,1,3,322947,322951,322954,4,7,0
92505,3,1,322950,322954,322955,4,5,0
92506,6,2,322956,322956,322958,0,2,1
92507,5,3,322961,322961,322964,0,3,3
92508,2,2,322963,322964,322966,1,3,0
92509,3,3,322966,322966,322969,0,3,0
92510,5,1,322971,322971,322972,0,1,2
92511,1,2,322972,322972,322974,0,2,0
92512,4,2,322976,322976,322978,0,2,2
92513,6,2,322982,322982,322984,0,2,4
92514,5,3,322987,322987,322990,0,3,3
92515,4,2,322991,322991,322993,0,2,1
92516,4,3,322995,322995,322998,0,3,2
92517,6,3,323001,323001,323004,0,3,3
92518,4,2,323005,323005,323007,0,2,1
92519,4,3,323009,323009,323012,0,3,2
92520,1,3,323010,323012,323015,2,5,0
92521,5,1,323015,323015,323016,0,1,0
92522,3,2,323018,323018,323020,0,2,2
92523,2,1,323020,323020,323021,0,1,0
92524,2,2,323022,323022,323024,0,2,1
92525,2,1,323024,323024,323025,0,1,0
92526,3,2,323027,323027,323029,0,2,2
92527,3,2,323030,323030,323032,0,2,1
92528,6,1,323036,323036,323037,0,1,4
92529,2,3,323038,323038,323041,0,3,1
92530,6,1,323044,323044,323045,0,1,3
92531,1,2,323045,323045,323047,0,2,0
92532,1,3,323046,323047,323050,1,4,0
92533,4,2,323050,323050,323052,0,2,0
92534,6,1,323056,323056,323057,0,1,4
92535,4,3,323060,323060,323063,0,3,3
92536,1,2,323061,323063,323065,2,4,0
92537,5,1,323066,323066,323067,0,1,1
92538,2,1,323068,323068,323069,0,1,1
92539,6,1,323074,323074,323075,0,1,5
92540,5,3,323079,323079,323082,0,3,4
92541,4,1,323083,323083,323084,0,1,1
92542,5,2,323088,323088,323090,0,2,4
92543,4,3,323092,323092,323095,0,3,2
92544,3,2,323095,323095,323097,0,2,0
92545,3,3,323098,323098,323101,0,3,1
92546,6,2,323104,323104,323106,0,2,3
92547,6,2,323110,323110,323112,0,2,4
92548,6,3,323116,323116,323119,0,3,4
92549,1,3,323117,323119,323122,2,5,0
92550,1,2,323118,323122,323124,4,6,0
92551,6,3,323124,323124,323127,0,3,0
92552,6,2,323130,323130,323132,0,2,3
92553,6,3,323136,323136,323139,0,3,4
92554,5,1,323141,323141,323142,0,1,2
92555,6,3,323147,323147,323150,0,3,5
92556,1,1,323148,323150,323151,2,3,0
92557,1,1,323149,323151,323152,2,3,0
92558,1,1,323150,323152,323153,2,3,0
92559,2,1,323152,323153,323154,1,2,0
92560,2,2,323154,323154,323156,0,2,0
92561,2,1,323156,323156,323157,0,1,0
92562,5,2,323161,323161,323163,0,2,4
92563,2,1,323163,323163,323164,0,1,0
92564,5,1,323168,323168,323169,0,1,4
92565,6,1,323174,323174,323175,0,1,5
92566,1,1,323175,323175,323176,0,1,0
92567,1,2,323176,323176,323178,0,2,0
92568,4,1,323180,323180,323181,0,1,2
92569,4,1,323184,323184,323185,0,1,3
92570,1,1,323185,323185,323186,0,1,0
92571,5,3,323190,323190,323193,0,3,4
92572,3,1,323193,323193,323194,0,1,0
92573,3,2,323196,323196,323198,0,2,2
92574,5,3,323201,323201,323204,0,3,3
92575,4,2,323205,323205,323207,0,2,1
92576,2,2,323207,323207,323209,0,2,0
92577,2,2,323209,323209,323211,0,2,0
92578,3,3,323212,323212,323215,0,3,1
92579,1,1,323213,323215,323216,2,3,0
92580,6,3,323219,323219,323222,0,3,3
92581,5,1,323224,323224,323225,0,1,2
92582,5,3,323229,323229,323232,0,3,4
92583,5,3,323234,323234,323237,0,3,2
92584,2,1,323236,323237,323238,1,2,0
92585,4,2,323240,323240,323242,0,2,2
92586,5,1,323245,323245,323246,0,1,3
92587,2,3,323247,323247,323250,0,3,1
92588,4,1,323251,323251,323252,0,1,1
92589,3,3,323254,323254,323257,0,3,2
92590,3,2,323257,323257,323259,0,2,0
92591,5,3,323262,323262,323265,0,3,3
92592,6,1,323268,323268,323269,0,1,3
92593,1,1,323269,323269,323270,0,1,0
92594,4,2,323273,323273,323275,0,2,3
92595,6,1,323279,323279,323280,0,1,4
92596,5,1,323284,323284,323285,0,1,4
92597,6,2,323290,323290,323292,0,2,5
92598,1,1,323291,323292,323293,1,2,0
92599,1,1,323292,323293,323294,1,2,0
92600,3,1,323295,323295,323296,0,1,1
92601,3,1,323298,323298,323299,0,1,2
92602,5,3,323303,323303,323306,0,3,4
92603,3,3,323306,323306,323309,0,3,0
92604,3,2,323309,323309,323311,0,2,0
92605,2,1,323311,323311,323312,0,1,0
92606,1,2,323312,323312,323314,0,2,0
92607,4,2,323316,323316,323318,0,2,2
92608,6,1,323322,323322,323323,0,1,4
92609,4,1,323326,323326,323327,0,1,3
92610,3,2,323329,323329,323331,0,2,2
92611,6,1,323335,323335,323336,0,1,4
92612,4,1,323339,323339,323340,0,1,3
92613,2,3,323341,323341,323344,0,3,1
92614,5,2,323346,323346,323348,0,2,2
92615,2,3,323348,323348,323351,0,3,0
92616,4,2,323352,323352,323354,0,2,1
92617,2,3,323354,323354,323357,0,3,0
92618,3,3,323357,323357,323360,0,3,0
92619,2,2,323359,323360,323362,1,3,0
92620,4,2,323363,323363,323365,0,2,1
92621,1,3,323364,323365,323368,1,4,0
92622,1,1,323365,323368,323369,3,4,0
92623,5,3,323370,323370,323373,0,3,1
92624,2,1,323372,323373,323374,1,2,0
92625,1,3,323373,323374,323377,1,4,0
92626,4,3,323377,323377,323380,0,3,0
92627,3,2,323380,323380,323382,0,2,0
92628,3,2,323383,323383,323385,0,2,1
92629,6,2,323389,323389,323391,0,2,4
92630,4,3,323393,323393,323396,0,3,2
92631,2,2,323395,323396,323398,1,3,0
92632,6,2,323401,323401,323403,0,2,3
92633,2,1,323403,323403,323404,0,1,0
92634,4,2,323407,323407,323409,0,2,3
92635,1,2,323408,323409,323411,1,3,0
92636,1,3,323409,323411,323414,2,5,0
92637,2,3,323411,323414,323417,3,6,0
92638,3,1,323414,323417,323418,3,4,0
92639,5,1,323419,323419,323420,0,1,1
92640,6,1,323425,323425,323426,0,1,5
92641,6,2,323431,323431,323433,0,2,5
92642,4,1,323435,323435,323436,0,1,2
92643,2,1,323437,323437,323438,0,1,1
92644,4,3,323441,323441,323444,0,3,3
92645,6,3,323447,323447,323450,0,3,3
92646,1,2,323448,323450,323452,2,4,0
92647,5,2,323453,323453,323455,0,2,1
92648,2,2,323455,323455,323457,0,2,0
92649,4,1,323459,323459,323460,0,1,2
92650,6,3,323465,323465,323468,0,3,5
92651,5,1,323470,323470,323471,0,1,2
92652,2,3,323472,323472,323475,0,3,1
92653,1,1,323473,323475,323476,2,3,0
92654,6,1,323479,323479,323480,0,1,3
92655,6,2,323485,323485,323487,0,2,5
92656,3,3,323488,323488,323491,0,3,1
92657,2,1,323490,323491,323492,1,2,0
92658,2,2,323492,323492,323494,0,2,0
92659,2,3,323494,323494,323497,0,3,0
92660,1,2,323495,323497,323499,2,4,0
92661,2,2,323497,323499,323501,2,4,0
92662,3,3,323500,323501,323504,1,4,0
92663,2,3,323502,323504,323507,2,5,0
92664,3,3,323505,323507,323510,2,5,0
92665,3,2,323508,323510,323512,2,4,0
92666,1,2,323509,323512,323514,3,5,0
92667,3,3,323512,323514,323517,2,5,0
92668,5,2,323517,323517,323519,0,2,0
92669,5,2,323522,323522,323524,0,2,3
92670,3,3,323525,323525,323528,0,3,1
92671,1,1,323526,323528,323529,2,3,0
92672,4,2,323530,323530,323532,0,2,1
92673,3,1,323533,323533,323534,0,1,1
92674,1,3,323534,323534,323537,0,3,0
92675,2,2,323536,323537,323539,1,3,0
92676,4,2,323540,323540,323542,0,2,1
92677,2,1,323542,323542,323543,0,1,0
92678,2,1,323544,323544,323545,0,1,1
92679,6,2,323550,323550,323552,0,2,5
92680,1,1,323551,323552,323553,1,2,0
92681,2,3,323553,323553,323556,0,3,0
92682,6,3,323559,323559,323562,0,3,3
92683,1,2,323560,323562,323564,2,4,0
92684,1,2,323561,323564,323566,3,5,0
92685,2,3,323563,323566,323569,3,6,0
92686,3,3,323566,323569,323572,3,6,0
92687,1,2,323567,323572,323574,5,7,0
92688,5,1,323572,323574,323575,2,3,0
92689,4,3,323576,323576,323579,0,3,1
92690,2,2,323578,323579,323581,1,3,0
92691,2,1,323580,323581,323582,1,2,0
92692,2,1,323582,323582,323583,0,1,0
92693,6,3,323588,323588,323591,0,3,5
92694,4,3,323592,323592,323595,0,3,1
92695,3,1,323595,323595,323596,0,1,0
92696,2,3,323597,323597,323600,0,3,1
92697,6,1,323603,323603,323604,0,1,3
92698,1,3,323604,323604,323607,0,3,0
92699,3,2,323607,323607,323609,0,2,0
92700,2,1,323609,323609,323610,0,1,0
92701,2,1,323611,323611,323612,0,1,1
92702,2,1,323613,323613,323614,0,1,1
92703,3,2,323616,323616,323618,0,2,2
92704,2,3,323618,323618,323621,0,3,0
92705,2,3,323620,323621,323624,1,4,0
92706,6,1,323626,323626,323627,0,1,2
92707,6,1,323632,323632,323633,0,1,5
92708,5,3,323637,323637,323640,0,3,4
92709,3,3,323640,323640,323643,0,3,0
92710,4,3,323644,323644,323647,0,3,1
92711,5,1,323649,323649,323650,0,1,2
92712,4,1,323653,323653,323654,0,1,3
92713,4,2,323657,323657,323659,0,2,3
92714,3,2,323660,323660,323662,0,2,1
92715,6,3,323666,323666,323669,0,3,4
92716,5,2,323671,323671,323673,0,2,2
92717,2,1,323673,323673,323674,0,1,0
92718,3,2,323676,323676,323678,0,2,2
92719,5,3,323681,323681,323684,0,3,3
92720,6,2,323687,323687,323689,0,2,3
92721,5,1,323692,323692,323693,0,1,3
92722,5,1,323697,323697,323698,0,1,4
92723,3,1,323700,323700,323701,0,1,2
92724,1,3,323701,323701,323704,0,3,0
92725,4,1,323705,323705,323706,0,1,1
92726,3,2,323708,323708,323710,0,2,2
92727,3,2,323711,323711,323713,0,2,1
92728,1,1,323712,323713,323714,1,2,0
92729,2,1,323714,323714,323715,0,1,0
92730,4,1,323718,323718,323719,0,1,3
92731,2,3,323720,323720,323723,0,3,1
92732,3,3,323723,323723,323726,0,3,0
92733,3,1,323726,323726,323727,0,1,0
92734,3,3,323729,323729,323732,0,3,2
92735,5,2,323734,323734,323736,0,2,2
92736,4,2,323738,323738,323740,0,2,2
92737,3,1,323741,323741,323742,0,1,1
92738,1,1,323742,323742,323743,0,1,0
92739,2,2,323744,323744,323746,0,2,1
92740,6,3,323750,323750,323753,0,3,4
92741,1,3,323751,323753,323756,2,5,0
92742,4,2,323755,323756,323758,1,3,0
92743,1,3,323756,323758,323761,2,5,0
92744,2,1,323758,323761,323762,3,4,0
92745,3,3,323761,323762,323765,1,4,0
92746,3,1,323764,323765,323766,1,2,0
92747,1,3,323765,323766,323769,1,4,0
92748,3,2,323768,323769,323771,1,3,0
92749,3,1,323771,323771,323772,0,1,0
92750,1,3,323772,323772,323775,0,3,0
92751,2,1,323774,323775,323776,1,2,0
92752,6,2,323780,323780,323782,0,2,4
92753,4,3,323784,323784,323787,0,3,2
92754,2,2,323786,323787,323789,1,3,0
92755,1,2,323787,323789,323791,2,4,0
92756,5,2,323792,323792,323794,0,2,1
92757,4,3,323796,323796,323799,0,3,2
92758,2,1,323798,323799,323800,1,2,0
92759,3,1,323801,323801,323802,0,1,1
92760,5,3,323806,323806,323809,0,3,4
92761,1,1,323807,323809,323810,2,3,0
92762,1,1,323808,323810,323811,2,3,0
92763,5,1,323813,323813,323814,0,1,2
92764,5,3,323818,323818,323821,0,3,4
92765,4,1,323822,323822,323823,0,1,1
92766,6,2,323828,323828,323830,0,2,5
92767,4,2,323832,323832,323834,0,2,2
92768,5,3,323837,323837,323840,0,3,3
92769,3,3,323840,323840,323843,0,3,0
92770,6,2,323846,323846,323848,0,2,3
92771,6,3,323852,323852,323855,0,3,4
92772,6,3,323858,323858,323861,0,3,3
92773,3,2,323861,323861,323863,0,2,0
92774,1,2,323862,323863,323865,1,3,0
92775,2,2,323864,323865,323867,1,3,0
92776,6,1,323870,323870,323871,0,1,3
92777,2,3,323872,323872,323875,0,3,1
92778,4,1,323876,323876,323877,0,1,1
92779,5,3,323881,323881,323884,0,3,4
92780,4,1,323885,323885,323886,0,1,1
92781,3,1,323888,323888,323889,0,1,2
92782,1,2,323889,323889,323891,0,2,0
92783,6,2,323895,323895,323897,0,2,4
92784,1,2,323896,323897,323899,1,3,0
92785,4,3,323900,323900,323903,0,3,1
92786,5,1,323905,323905,323906,0,1,2
92787,3,3,323908,323908,323911,0,3,2
92788,6,1,323914,323914,323915,0,1,3
92789,2,2,323916,323916,323918,0,2,1
92790,3,1,323919,323919,323920,0,1,1
92791,1,2,323920,323920,323922,0,2,0
92792,2,2,323922,323922,323924,0,2,0
92793,5,1,323927,323927,323928,0,1,3
92794,5,3,323932,323932,323935,0,3,4
92795,3,2,323935,323935,323937,0,2,0
92796,4,3,323939,323939,323942,0,3,2
92797,6,3,323945,323945,323948,0,3,3
92798,5,1,323950,323950,323951,0,1,2
92799,2,1,323952,323952,323953,0,1,1
92800,3,1,323955,323955,323956,0,1,2
92801,2,3,323957,323957,323960,0,3,1
92802,2,1,323959,323960,323961,1,2,0
92803,1,3,323960,323961,323964,1,4,0
92804,6,2,323966,323966,323968,0,2,2
92805,4,2,323970,323970,323972,0,2,2
92806,6,2,323976,323976,323978,0,2,4
92807,4,2,323980,323980,323982,0,2,2
92808,5,2,323985,323985,323987,0,2,3
92809,5,3,323990,323990,323993,0,3,3
92810,1,1,323991,323993,323994,2,3,0
92811,1,3,323992,323994,323997,2,5,0
92812,1,2,323993,323997,323999,4,6,0
92813,1,3,323994,323999,324002,5,8,0
92814,1,2,323995,324002,324004,7,9,0
92815,6,3,324001,324004,324007,3,6,0
92816,4,1,324005,324007,324008,2,3,0
92817,2,2,324007,324008,324010,1,3,0
92818,1,1,324008,324010,324011,2,3,0
92819,2,2,324010,324011,324013,1,3,0
92820,6,3,324016,324016,324019,0,3,3
92821,3,1,324019,324019,324020,0,1,0
92822,4,3,324023,324023,324026,0,3,3
92823,3,2,324026,324026,324028,0,2,0
92824,6,2,324032,324032,324034,0,2,4
92825,6,1,324038,324038,324039,0,1,4
92826,5,3,324043,324043,324046,0,3,4
92827,4,2,324047,324047,324049,0,2,1
92828,6,1,324053,324053,324054,0,1,4
92829,2,2,324055,324055,324057,0,2,1
92830,6,1,324061,324061,324062,0,1,4
92831,2,2,324063,324063,324065,0,2,1
92832,6,2,324069,324069,324071,0,2,4
92833,3,3,324072,324072,324075,0,3,1
92834,4,3,324076,324076,324079,0,3,1
92835,3,3,324079,324079,324082,0,3,0
92836,6,1,324085,324085,324086,0,1,3
92837,6,3,324091,324091,324094,0,3,5
92838,5,2,324096,324096,324098,0,2,2
92839,3,2,324099,324099,324101,0,2,1
92840,5,2,324104,324104,324106,0,2,3
92841,2,3,324106,324106,324109,0,3,0
92842,5,1,324111,324111,324112,0,1,2
92843,5,1,324116,324116,324117,0,1,4
92844,2,1,324118,324118,324119,0,1,1
92845,6,1,324124,324124,324125,0,1,5
92846,1,1,324125,324125,324126,0,1,0
92847,5,3,324130,324130,324133,0,3,4
92848,2,1,324132,324133,324134,1,2,0
92849,1,1,324133,324134,324135,1,2,0
92850,1,3,324134,324135,324138,1,4,0
92851,6,2,324140,324140,324142,0,2,2
92852,3,3,324143,324143,324146,0,3,1
92853,2,3,324145,324146,324149,1,4,0
92854,3,2,324148,324149,324151,1,3,0
92855,3,3,324151,324151,324154,0,3,0
92856,1,3,324152,324154,324157,2,5,0
92857,3,3,324155,324157,324160,2,5,0
92858,4,3,324159,324160,324163,1,4,0
92859,6,3,324165,324165,324168,0,3,2
92860,2,3,324167,324168,324171,1,4,0
92861,3,3,324170,324171,324174,1,4,0
92862,1,1,324171,324174,324175,3,4,0
92863,1,3,324172,324175,324178,3,6,0
92864,4,2,324176,324178,324180,2,4,0
92865,5,1,324181,324181,324182,0,1,1
92866,4,3,324185,324185,324188,0,3,3
92867,1,3,324186,324188,324191,2,5,0
92868,3,3,324189,324191,324194,2,5,0
92869,1,3,324190,324194,324197,4,7,0
92870,2,2,324192,324197,324199,5,7,0
92871,4,2,324196,324199,324201,3,5,0
92872,4,3,324200,324201,324204,1,4,0
92873,4,3,324204,324204,324207,0,3,0
92874,1,1,324205,324207,324208,2,3,0
92875,1,2,324206,324208,324210,2,4,0
92876,6,3,324212,324212,324215,0,3,2
92877,2,2,324214,324215,324217,1,3,0
92878,1,1,324215,324217,324218,2,3,0
92879,1,1,324216,324218,324219,2,3,0
92880,3,2,324219,324219,324221,0,2,0
92881,5,3,324224,324224,324227,0,3,3
92882,1,3,324225,324227,324230,2,5,0
92883,4,1,324229,324230,324231,1,2,0
92884,4,3,324233,324233,324236,0,3,2
92885,2,3,324235,324236,324239,1,4,0
92886,3,3,324238,324239,324242,1,4,0
92887,4,3,324242,324242,324245,0,3,0
92888,5,2,324247,324247,324249,0,2,2
92889,1,2,324248,324249,324251,1,3,0
92890,5,1,324253,324253,324254,0,1,2
92891,2,1,324255,324255,324256,0,1,1
92892,4,3,324259,324259,324262,0,3,3
92893,6,1,324265,324265,324266,0,1,3
92894,3,3,324268,324268,324271,0,3,2
92895,5,3,324273,324273,324276,0,3,2
92896,6,3,324279,324279,324282,0,3,3
92897,3,3,324282,324282,324285,0,3,0
92898,4,1,324286,324286,324287,0,1,1
92899,2,1,324288,324288,324289,0,1,1
92900,4,3,324292,324292,324295,0,3,3
92901,1,1,324293,324295,324296,2,3,0
92902,1,1,324294,324296,324297,2,3,0
92903,2,3,324296,324297,324300,1,4,0
92904,2,3,324298,324300,324303,2,5,0
92905,4,2,324302,324303,324305,1,3,0
92906,2,3,324304,324305,324308,1,4,0
92907,6,2,324310,324310,324312,0,2,2
92908,6,3,324316,324316,324319,0,3,4
92909,6,1,324322,324322,324323,0,1,3
92910,3,1,324325,324325,324326,0,1,2
92911,5,2,324330,324330,324332,0,2,4
92912,1,2,324331,324332,324334,1,3,0
92913,3,2,324334,324334,324336,0,2,0
92914,4,2,324338,324338,324340,0,2,2
92915,2,1,324340,324340,324341,0,1,0
92916,4,3,324344,324344,324347,0,3,3
92917,4,1,324348,324348,324349,0,1,1
92918,3,2,324351,324351,324353,0,2,2
92919,2,2,324353,324353,324355,0,2,0
92920,6,1,324359,324359,324360,0,1,4
92921,6,3,324365,324365,324368,0,3,5
92922,6,1,324371,324371,324372,0,1,3
92923,4,2,324375,324375,324377,0,2,3
92924,3,1,324378,324378,324379,0,1,1
92925,1,1,324379,324379,324380,0,1,0
92926,5,3,324384,324384,324387,0,3,4
92927,5,3,324389,324389,324392,0,3,2
92928,5,2,324394,324394,324396,0,2,2
92929,6,3,324400,324400,324403,0,3,4
92930,2,2,324402,324403,324405,1,3,0
92931,2,1,324404,324405,324406,1,2,0
92932,3,1,324407,324407,324408,0,1,1
92933,3,3,324410,324410,324413,0,3,2
92934,1,1,324411,324413,324414,2,3,0
92935,3,3,324414,324414,324417,0,3,0
92936,4,3,324418,324418,324421,0,3,1
92937,2,1,324420,324421,324422,1,2,0
92938,5,2,324425,324425,324427,0,2,3
92939,6,1,324431,324431,324432,0,1,4
92940,4,3,324435,324435,324438,0,3,3
92941,3,2,324438,324438,324440,0,2,0
92942,3,2,324441,324441,324443,0,2,1
92943,5,1,324446,324446,324447,0,1,3
92944,3,2,324449,324449,324451,0,2,2
92945,3,1,324452,324452,324453,0,1,1
92946,6,2,324458,324458,324460,0,2,5
92947,2,1,324460,324460,324461,0,1,0
92948,4,3,324464,324464,324467,0,3,3
92949,5,3,324469,324469,324472,0,3,2
92950,5,2,324474,324474,324476,0,2,2
92951,4,2,324478,324478,324480,0,2,2
92952,6,3,324484,324484,324487,0,3,4
92953,4,2,324488,324488,324490,0,2,1
92954,2,1,324490,324490,324491,0,1,0
92955,4,2,324494,324494,324496,0,2,3
92956,4,1,324498,324498,324499,0,1,2
92957,4,1,324502,324502,324503,0,1,3
92958,3,1,324505,324505,324506,0,1,2
92959,1,3,324506,324506,324509,0,3,0
92960,6,3,324512,324512,324515,0,3,3
92961,4,1,324516,324516,324517,0,1,1
92962,1,2,324517,324517,324519,0,2,0
92963,3,2,324520,324520,324522,0,2,1
92964,2,2,324522,324522,324524,0,2,0
92965,2,1,324524,324524,324525,0,1,0
92966,4,1,324528,324528,324529,0,1,3
92967,5,1,324533,324533,324534,0,1,4
92968,1,2,324534,324534,324536,0,2,0
92969,4,1,324538,324538,324539,0,1,2
92970,4,1,324542,324542,324543,0,1,3
92971,1,3,324543,324543,324546,0,3,0
92972,5,2,324548,324548,324550,0,2,2
92973,5,2,324553,324553,324555,0,2,3
92974,6,3,324559,324559,324562,0,3,4
92975,1,3,324560,324562,324565,2,5,0
92976,2,2,324562,324565,324567,3,5,0
92977,3,1,324565,324567,324568,2,3,0
92978,5,3,324570,324570,324573,0,3,2
92979,4,2,324574,324574,324576,0,2,1
92980,2,3,324576,324576,324579,0,3,0
92981,5,2,324581,324581,324583,0,2,2
92982,6,2,324587,324587,324589,0,2,4
92983,1,1,324588,324589,324590,1,2,0
92984,4,2,324592,324592,324594,0,2,2
92985,2,3,324594,324594,324597,0,3,0
92986,4,2,324598,324598,324600,0,2,1
92987,3,2,324601,324601,324603,0,2,1
92988,6,3,324607,324607,324610,0,3,4
92989,4,3,324611,324611,324614,0,3,1
92990,3,3,324614,324614,324617,0,3,0
92991,2,2,324616,324617,324619,1,3,0
92992,4,1,324620,324620,324621,0,1,1
92993,4,3,324624,324624,324627,0,3,3
92994,4,3,324628,324628,324631,0,3,1
92995,4,3,324632,324632,324635,0,3,1
92996,3,3,324635,324635,324638,0,3,0
92997,3,2,324638,324638,324640,0,2,0
92998,1,1,324639,324640,324641,1,2,0
92999,4,2,324643,324643,324645,0,2,2
93000,4,3,324647,324647,324650,0,3,2
93001,3,3,324650,324650,324653,0,3,0
93002,6,1,324656,324656,324657,0,1,3
93003,5,3,324661,324661,324664,0,3,4
93004,2,3,324663,324664,324667,1,4,0
93005,4,3,324667,324667,324670,0,3,0
93006,2,2,324669,324670,324672,1,3,0
93007,1,3,324670,324672,324675,2,5,0
93008,6,3,324676,324676,324679,0,3,1
93009,3,2,324679,324679,324681,0,2,0
93010,1,2,324680,324681,324683,1,3,0
93011,1,2,324681,324683,324685,2,4,0
93012,1,1,324682,324685,324686,3,4,0
93013,2,2,324684,324686,324688,2,4,0
93014,1,1,324685,324688,324689,3,4,0
93015,1,2,324686,324689,324691,3,5,0
93016,4,1,324690,324691,324692,1,2,0
93017,2,3,324692,324692,324695,0,3,0
93018,6,3,324698,324698,324701,0,3,3
93019,5,2,324703,324703,324705,0,2,2
93020,5,3,324708,324708,324711,0,3,3
93021,5,2,324713,324713,324715,0,2,2
93022,1,1,324714,324715,324716,1,2,0
93023,6,1,324720,324720,324721,0,1,4
93024,2,2,324722,324722,324724,0,2,1
93025,1,2,324723,324724,324726,1,3,0
93026,3,1,324726,324726,324727,0,1,0
93027,1,3,324727,324727,324730,0,3,0
93028,2,3,324729,324730,324733,1,4,0
93029,2,1,324731,324733,324734,2,3,0
93030,3,3,324734,324734,324737,0,3,0
93031,1,1,324735,324737,324738,2,3,0
93032,4,1,324739,324739,324740,0,1,1
93033,6,1,324745,324745,324746,0,1,5
93034,4,1,324749,324749,324750,0,1,3
93035,5,2,324754,324754,324756,0,2,4
93036,5,3,324759,324759,324762,0,3,3
93037,5,1,324764,324764,324765,0,1,2
93038,2,2,324766,324766,324768,0,2,1
93039,6,2,324772,324772,324774,0,2,4
93040,1,3,324773,324774,324777,1,4,0
93041,6,3,324779,324779,324782,0,3,2
93042,3,3,324782,324782,324785,0,3,0
93043,5,2,324787,324787,324789,0,2,2
93044,5,1,324792,324792,324793,0,1,3
93045,5,2,324797,324797,324799,0,2,4
93046,5,3,324802,324802,324805,0,3,3
93047,5,1,324807,324807,324808,0,1,2
93048,5,1,324812,324812,324813,0,1,4
93049,6,3,324818,324818,324821,0,3,5
93050,4,2,324822,324822,324824,0,2,1
93051,1,2,324823,324824,324826,1,3,0
93052,2,3,324825,324826,324829,1,4,0
93053,1,3,324826,324829,324832,3,6,0
93054,2,2,324828,324832,324834,4,6,0
93055,3,1,324831,324834,324835,3,4,0
93056,4,2,324835,324835,324837,0,2,0
93057,2,3,324837,324837,324840,0,3,0
93058,4,2,324841,324841,324843,0,2,1
93059,2,3,324843,324843,324846,0,3,0
93060,5,2,324848,324848,324850,0,2,2
93061,1,1,324849,324850,324851,1,2,0
93062,3,2,324852,324852,324854,0,2,1
93063,5,1,324857,324857,324858,0,1,3
93064,5,2,324862,324862,324864,0,2,4
93065,5,2,324867,324867,324869,0,2,3
93066,4,2,324871,324871,324873,0,2,2
93067,1,2,324872,324873,324875,1,3,0
93068,1,1,324873,324875,324876,2,3,0
93069,1,1,324874,324876,324877,2,3,0
93070,4,2,324878,324878,324880,0,2,1
93071,1,2,324879,324880,324882,1,3,0
93072,2,2,324881,324882,324884,1,3,0
93073,3,3,324884,324884,324887,0,3,0
93074,2,3,324886,324887,324890,1,4,0
93075,2,1,324888,324890,324891,2,3,0
93076,5,3,324893,324893,324896,0,3,2
93077,1,3,324894,324896,324899,2,5,0
93078,1,1,324895,324899,324900,4,5,0
93079,2,2,324897,324900,324902,3,5,0
93080,4,1,324901,324902,324903,1,2,0
93081,4,2,324905,324905,324907,0,2,2
93082,3,1,324908,324908,324909,0,1,1
93083,4,2,324912,324912,324914,0,2,3
93084,6,1,324918,324918,324919,0,1,4
93085,4,2,324922,324922,324924,0,2,3
93086,5,1,324927,324927,324928,0,1,3
93087,1,1,324928,324928,324929,0,1,0
93088,4,1,324932,324932,324933,0,1,3
93089,5,2,324937,324937,324939,0,2,4
93090,5,2,324942,324942,324944,0,2,3
93091,3,2,324945,324945,324947,0,2,1
93092,3,3,324948,324948,324951,0,3,1
93093,2,1,324950,324951,324952,1,2,0
93094,3,1,324953,324953,324954,0,1,1
93095,3,3,324956,324956,324959,0,3,2
93096,3,1,324959,324959,324960,0,1,0
93097,3,3,324962,324962,324965,0,3,2
93098,5,2,324967,324967,324969,0,2,2
93099,1,3,324968,324969,324972,1,4,0
93100,1,2,324969,324972,324974,3,5,0
93101,4,3,324973,324974,324977,1,4,0
93102,5,2,324978,324978,324980,0,2,1
93103,1,3,324979,324980,324983,1,4,0
93104,2,2,324981,324983,324985,2,4,0
93105,4,1,324985,324985,324986,0,1,0
93106,1,3,324986,324986,324989,0,3,0
93107,4,2,324990,324990,324992,0,2,1
93108,5,1,324995,324995,324996,0,1,3
93109,3,2,324998,324998,325000,0,2,2
93110,3,3,325001,325001,325004,0,3,1
93111,4,2,325005,325005,325007,0,2,1
93112,1,2,325006,325007,325009,1,3,0
93113,2,3,325008,325009,325012,1,4,0
93114,4,1,325012,325012,325013,0,1,0
93115,4,1,325016,325016,325017,0,1,3
93116,2,3,325018,325018,325021,0,3,1
93117,5,2,325023,325023,325025,0,2,2
93118,6,1,325029,325029,325030,0,1,4
93119,1,3,325030,325030,325033,0,3,0
93120,2,2,325032,325033,325035,1,3,0
93121,2,1,325034,325035,325036,1,2,0
93122,4,3,325038,325038,325041,0,3,2
93123,4,3,325042,325042,325045,0,3,1
93124,5,2,325047,325047,325049,0,2,2
93125,3,2,325050,325050,325052,0,2,1
93126,1,2,325051,325052,325054,1,3,0
93127,2,2,325053,325054,325056,1,3,0
93128,3,1,325056,325056,325057,0,1,0
93129,1,2,325057,325057,325059,0,2,0
93130,6,2,325063,325063,325065,0,2,4
93131,1,1,325064,325065,325066,1,2,0
93132,1,1,325065,325066,325067,1,2,0
93133,1,3,325066,325067,325070,1,4,0
93134,1,2,325067,325070,325072,3,5,0
93135,1,3,325068,325072,325075,4,7,0
93136,6,2,325074,325075,325077,1,3,0
93137,5,1,325079,325079,325080,0,1,2
93138,5,3,325084,325084,325087,0,3,4
93139,4,2,325088,325088,325090,0,2,1
93140,4,1,325092,325092,325093,0,1,2
93141,1,3,325093,325093,325096,0,3,0
93142,5,2,325098,325098,325100,0,2,2
93143,2,1,325100,325100,325101,0,1,0
93144,4,3,325104,325104,325107,0,3,3
93145,1,1,325105,325107,325108,2,3,0
93146,3,3,325108,325108,325111,0,3,0
93147,4,3,325112,325112,325115,0,3,1
93148,1,3,325113,325115,325118,2,5,0
93149,4,1,325117,325118,325119,1,2,0
93150,6,1,325123,325123,325124,0,1,4
93151,4,1,325127,325127,325128,0,1,3
93152,3,1,325130,325130,325131,0,1,2
93153,4,3,325134,325134,325137,0,3,3
93154,4,2,325138,325138,325140,0,2,1
93155,2,3,325140,325140,325143,0,3,0
93156,2,2,325142,325143,325145,1,3,0
93157,1,1,325143,325145,325146,2,3,0
93158,3,1,325146,325146,325147,0,1,0
93159,2,1,325148,325148,325149,0,1,1
93160,5,1,325153,325153,325154,0,1,4
93161,4,2,325157,325157,325159,0,2,3
93162,4,2,325161,325161,325163,0,2,2
93163,6,3,325167,325167,325170,0,3,4
93164,2,3,325169,325170,325173,1,4,0
93165,4,3,325173,325173,325176,0,3,0
93166,1,2,325174,325176,325178,2,4,0
93167,4,3,325178,325178,325181,0,3,0
93168,3,3,325181,325181,325184,0,3,0
93169,1,2,325182,325184,325186,2,4,0
93170,4,2,325186,325186,325188,0,2,0
93171,1,1,325187,325188,325189,1,2,0
93172,6,3,325193,325193,325196,0,3,4
93173,2,1,325195,325196,325197,1,2,0
93174,5,2,325200,325200,325202,0,2,3
93175,3,2,325203,325203,325205,0,2,1
93176,5,3,325208,325208,325211,0,3,3
93177,2,2,325210,325211,325213,1,3,0
93178,3,3,325213,325213,325216,0,3,0
93179,6,3,325219,325219,325222,0,3,3
93180,1,3,325220,325222,325225,2,5,0
93181,2,3,325222,325225,325228,3,6,0
93182,6,2,325228,325228,325230,0,2,0
93183,3,1,325231,325231,325232,0,1,1
93184,5,3,325236,325236,325239,0,3,4
93185,6,2,325242,325242,325244,0,2,3
93186,4,1,325246,325246,325247,0,1,2
93187,3,3,325249,325249,325252,0,3,2
93188,6,1,325255,325255,325256,0,1,3
93189,2,1,325257,325257,325258,0,1,1
93190,4,3,325261,325261,325264,0,3,3
93191,6,3,325267,325267,325270,0,3,3
93192,2,2,325269,325270,325272,1,3,0
93193,2,2,325271,325272,325274,1,3,0
93194,3,3,325274,325274,325277,0,3,0
93195,1,2,325275,325277,325279,2,4,0
93196,1,2,325276,325279,325281,3,5,0
93197,4,2,325280,325281,325283,1,3,0
93198,6,1,325286,325286,325287,0,1,3
93199,3,3,325289,325289,325292,0,3,2
93200,2,1,325291,325292,325293,1,2,0
93201,2,1,325293,325293,325294,0,1,0
93202,1,2,325294,325294,325296,0,2,0
93203,5,1,325299,325299,325300,0,1,3
93204,2,1,325301,325301,325302,0,1,1
93205,4,3,325305,325305,325308,0,3,3
93206,2,3,325307,325308,325311,1,4,0
93207,5,2,325312,325312,325314,0,2,1
93208,6,2,325318,325318,325320,0,2,4
93209,3,1,325321,325321,325322,0,1,1
93210,6,2,325327,325327,325329,0,2,5
93211,4,1,325331,325331,325332,0,1,2
93212,2,1,325333,325333,325334,0,1,1
93213,2,1,325335,325335,325336,0,1,1
93214,2,2,325337,325337,325339,0,2,1
93215,2,2,325339,325339,325341,0,2,0
93216,3,2,325342,325342,325344,0,2,1
93217,2,1,325344,325344,325345,0,1,0
93218,1,2,325345,325345,325347,0,2,0
93219,1,2,325346,325347,325349,1,3,0
93220,6,1,325352,325352,325353,0,1,3
93221,6,1,325358,325358,325359,0,1,5
93222,5,2,325363,325363,325365,0,2,4
93223,5,2,325368,325368,325370,0,2,3
93224,1,3,325369,325370,325373,1,4,0
93225,5,1,325374,325374,325375,0,1,1
93226,5,1,325379,325379,325380,0,1,4
93227,4,2,325383,325383,325385,0,2,3
93228,1,1,325384,325385,325386,1,2,0
93229,6,1,325390,325390,325391,0,1,4
93230,5,1,325395,325395,325396,0,1,4
93231,4,2,325399,325399,325401,0,2,3
93232,1,2,325400,325401,325403,1,3,0
93233,6,1,325406,325406,325407,0,1,3
93234,1,2,325407,325407,325409,0,2,0
93235,5,3,325412,325412,325415,0,3,3
93236,1,3,325413,325415,325418,2,5,0
93237,4,1,325417,325418,325419,1,2,0
93238,2,3,325419,325419,325422,0,3,0
93239,2,3,325421,325422,325425,1,4,0
93240,2,1,325423,325425,325426,2,3,0
93241,2,2,325425,325426,325428,1,3,0
93242,6,3,325431,325431,325434,0,3,3
93243,2,2,325433,325434,325436,1,3,0
93244,5,3,325438,325438,325441,0,3,2
93245,1,1,325439,325441,325442,2,3,0
93246,6,2,325445,325445,325447,0,2,3
93247,6,3,325451,325451,325454,0,3,4
93248,1,3,325452,325454,325457,2,5,0
93249,2,1,325454,325457,325458,3,4,0
93250,3,2,325457,325458,325460,1,3,0
93251,3,3,325460,325460,325463,0,3,0
93252,4,2,325464,325464,325466,0,2,1
93253,1,3,325465,325466,325469,1,4,0
93254,5,2,325470,325470,325472,0,2,1
93255,2,1,325472,325472,325473,0,1,0
93256,5,1,325477,325477,325478,0,1,4
93257,2,1,325479,325479,325480,0,1,1
93258,2,1,325481,325481,325482,0,1,1
93259,4,3,325485,325485,325488,0,3,3
93260,5,3,325490,325490,325493,0,3,2
93261,4,2,325494,325494,325496,0,2,1
93262,4,1,325498,325498,325499,0,1,2
93263,3,2,325501,325501,325503,0,2,2
93264,1,2,325502,325503,325505,1,3,0
93265,1,1,325503,325505,325506,2,3,0
93266,3,1,325506,325506,325507,0,1,0
93267,1,3,325507,325507,325510,0,3,0
93268,6,1,325513,325513,325514,0,1,3
93269,1,3,325514,325514,325517,0,3,0
93270,5,2,325519,325519,325521,0,2,2
93271,6,3,325525,325525,325528,0,3,4
93272,2,2,325527,325528,325530,1,3,0
93273,1,1,325528,325530,325531,2,3,0
93274,4,3,325532,325532,325535,0,3,1
93275,5,1,325537,325537,325538,0,1,2
93276,4,1,325541,325541,325542,0,1,3
93277,3,1,325544,325544,325545,0,1,2
93278,3,1,325547,325547,325548,0,1,2
93279,1,3,325548,325548,325551,0,3,0
93280,5,2,325553,325553,325555,0,2,2
93281,3,2,325556,325556,325558,0,2,1
93282,4,3,325560,325560,325563,0,3,2
93283,6,1,325566,325566,325567,0,1,3
93284,5,1,325571,325571,325572,0,1,4
93285,3,1,325574,325574,325575,0,1,2
93286,6,1,325580,325580,325581,0,1,5
93287,6,1,325586,325586,325587,0,1,5
93288,6,1,325592,325592,325593,0,1,5
93289,2,2,325594,325594,325596,0,2,1
93290,5,3,325599,325599,325602,0,3,3
93291,6,2,325605,325605,325607,0,2,3
93292,4,1,325609,325609,325610,0,1,2
93293,2,1,325611,325611,325612,0,1,1
93294,2,1,325613,325613,325614,0,1,1
93295,4,1,325617,325617,325618,0,1,3
93296,1,1,325618,325618,325619,0,1,0
93297,4,1,325622,325622,325623,0,1,3
93298,1,3,325623,325623,325626,0,3,0
93299,3,3,325626,325626,325629,0,3,0
93300,2,2,325628,325629,325631,1,3,0
93301,6,3,325634,325634,325637,0,3,3
93302,1,1,325635,325637,325638,2,3,0
93303,3,1,325638,325638,325639,0,1,0
93304,6,1,325644,325644,325645,0,1,5
93305,5,2,325649,325649,325651,0,2,4
93306,2,1,325651,325651,325652,0,1,0
93307,4,1,325655,325655,325656,0,1,3
93308,3,2,325658,325658,325660,0,2,2
93309,4,2,325662,325662,325664,0,2,2
93310,4,2,325666,325666,325668,0,2,2
93311,6,1,325672,325672,325673,0,1,4
93312,2,3,325674,325674,325677,0,3,1
93313,6,1,325680,325680,325681,0,1,3
93314,5,1,325685,325685,325686,0,1,4
93315,4,1,325689,325689,325690,0,1,3
93316,6,2,325695,325695,325697,0,2,5
93317,5,1,325700,325700,325701,0,1,3
93318,5,2,325705,325705,325707,0,2,4
93319,2,2,325707,325707,325709,0,2,0
93320,1,1,325708,325709,325710,1,2,0
93321,3,1,325711,325711,325712,0,1,1
93322,5,1,325716,325716,325717,0,1,4
93323,6,2,325722,325722,325724,0,2,5
93324,4,3,325726,325726,325729,0,3,2
93325,6,3,325732,325732,325735,0,3,3
93326,6,3,325738,325738,325741,0,3,3
93327,6,2,325744,325744,325746,0,2,3
93328,6,3,325750,325750,325753,0,3,4
93329,1,3,325751,325753,325756,2,5,0
93330,4,3,325755,325756,325759,1,4,0
93331,4,2,325759,325759,325761,0,2,0
93332,6,3,325765,325765,325768,0,3,4
93333,3,1,325768,325768,325769,0,1,0
93334,3,2,325771,325771,325773,0,2,2
93335,1,2,325772,325773,325775,1,3,0
93336,4,3,325776,325776,325779,0,3,1
93337,3,1,325779,325779,325780,0,1,0
93338,1,2,325780,325780,325782,0,2,0
93339,4,3,325784,325784,325787,0,3,2
93340,3,3,325787,325787,325790,0,3,0
93341,5,3,325792,325792,325795,0,3,2
93342,1,2,325793,325795,325797,2,4,0
93343,4,1,325797,325797,325798,0,1,0
93344,1,1,325798,325798,325799,0,1,0
93345,4,1,325802,325802,325803,0,1,3
93346,2,2,325804,325804,325806,0,2,1
93347,5,3,325809,325809,325812,0,3,3
93348,3,2,325812,325812,325814,0,2,0
93349,1,2,325813,325814,325816,1,3,0
93350,5,3,325818,325818,325821,0,3,2
93351,4,3,325822,325822,325825,0,3,1
93352,3,3,325825,325825,325828,0,3,0
93353,2,2,325827,325828,325830,1,3,0
93354,5,1,325832,325832,325833,0,1,2
93355,1,3,325833,325833,325836,0,3,0
93356,3,3,325836,325836,325839,0,3,0
93357,2,1,325838,325839,325840,1,2,0
93358,6,2,325844,325844,325846,0,2,4
93359,6,1,325850,325850,325851,0,1,4
93360,4,2,325854,325854,325856,0,2,3
93361,5,2,325859,325859,325861,0,2,3
93362,5,1,325864,325864,325865,0,1,3
93363,1,3,325865,325865,325868,0,3,0
93364,2,1,325867,325868,325869,1,2,0
93365,4,1,325871,325871,325872,0,1,2
93366,5,1,325876,325876,325877,0,1,4
93367,5,2,325881,325881,325883,0,2,4
93368,5,1,325886,325886,325887,0,1,3
93369,4,3,325890,325890,325893,0,3,3
93370,3,1,325893,325893,325894,0,1,0
93371,4,2,325897,325897,325899,0,2,3
93372,3,3,325900,325900,325903,0,3,1
93373,6,2,325906,325906,325908,0,2,3
93374,5,2,325911,325911,325913,0,2,3
93375,1,2,325912,325913,325915,1,3,0
93376,4,2,325916,325916,325918,0,2,1
93377,6,3,325922,325922,325925,0,3,4
93378,4,2,325926,325926,325928,0,2,1
93379,5,1,325931,325931,325932,0,1,3
93380,3,3,325934,325934,325937,0,3,2
93381,2,3,325936,325937,325940,1,4,0
93382,3,3,325939,325940,325943,1,4,0
93383,6,2,325945,325945,325947,0,2,2
93384,2,2,325947,325947,325949,0,2,0
93385,2,1,325949,325949,325950,0,1,0
93386,2,1,325951,325951,325952,0,1,1
93387,3,3,325954,325954,325957,0,3,2
93388,1,2,325955,325957,325959,2,4,0
93389,4,1,325959,325959,325960,0,1,0
93390,5,3,325964,325964,325967,0,3,4
93391,2,3,325966,325967,325970,1,4,0
93392,6,2,325972,325972,325974,0,2,2
93393,1,2,325973,325974,325976,1,3,0
93394,1,1,325974,325976,325977,2,3,0
93395,1,2,325975,325977,325979,2,4,0
93396,3,3,325978,325979,325982,1,4,0
93397,1,2,325979,325982,325984,3,5,0
93398,6,2,325985,325985,325987,0,2,1
93399,3,1,325988,325988,325989,0,1,1
93400,2,3,325990,325990,325993,0,3,1
93401,6,2,325996,325996,325998,0,2,3
93402,1,2,325997,325998,326000,1,3,0
93403,4,1,326001,326001,326002,0,1,1
93404,2,3,326003,326003,326006,0,3,1
93405,1,2,326004,326006,326008,2,4,0
93406,6,1,326010,326010,326011,0,1,2
93407,6,1,326016,326016,326017,0,1,5
93408,4,3,326020,326020,326023,0,3,3
93409,6,3,326026,326026,326029,0,3,3
93410,5,3,326031,326031,326034,0,3,2
93411,2,2,326033,326034,326036,1,3,0
93412,5,2,326038,326038,326040,0,2,2
93413,2,1,326040,326040,326041,0,1,0
93414,5,3,326045,326045,326048,0,3,4
93415,6,2,326051,326051,326053,0,2,3
93416,6,2,326057,326057,326059,0,2,4
93417,4,1,326061,326061,326062,0,1,2
93418,1,3,326062,326062,326065,0,3,0
93419,6,3,326068,326068,326071,0,3,3
93420,2,2,326070,326071,326073,1,3,0
93421,6,2,326076,326076,326078,0,2,3
93422,4,1,326080,326080,326081,0,1,2
93423,4,1,326084,326084,326085,0,1,3
93424,3,2,326087,326087,326089,0,2,2
93425,4,3,326091,326091,326094,0,3,2
93426,5,2,326096,326096,326098,0,2,2
93427,1,3,326097,326098,326101,1,4,0
93428,6,3,326103,326103,326106,0,3,2
93429,4,3,326107,326107,326110,0,3,1
93430,4,1,326111,326111,326112,0,1,1
93431,2,1,326113,326113,326114,0,1,1
93432,6,1,326119,326119,326120,0,1,5
93433,4,1,326123,326123,326124,0,1,3
93434,4,2,326127,326127,326129,0,2,3
93435,3,2,326130,326130,326132,0,2,1
93436,5,1,326135,326135,326136,0,1,3
93437,6,1,326141,326141,326142,0,1,5
93438,2,1,326143,326143,326144,0,1,1
93439,4,1,326147,326147,326148,0,1,3
93440,2,2,326149,326149,326151,0,2,1
93441,2,2,326151,326151,326153,0,2,0
93442,5,3,326156,326156,326159,0,3,3
93443,1,1,326157,326159,326160,2,3,0
93444,1,2,326158,326160,326162,2,4,0
93445,4,3,326162,326162,326165,0,3,0
93446,5,3,326167,326167,326170,0,3,2
93447,2,2,326169,326170,326172,1,3,0
93448,6,3,326175,326175,326178,0,3,3
93449,6,3,326181,326181,326184,0,3,3
93450,3,3,326184,326184,326187,0,3,0
93451,4,3,326188,326188,326191,0,3,1
93452,4,2,326192,326192,326194,0,2,1
93453,1,2,326193,326194,326196,1,3,0
93454,2,3,326195,326196,326199,1,4,0
93455,1,2,326196,326199,326201,3,5,0
93456,1,3,326197,326201,326204,4,7,0
93457,1,1,326198,326204,326205,6,7,0
93458,2,1,326200,326205,326206,5,6,0
93459,4,3,326204,326206,326209,2,5,0
93460,2,2,326206,326209,326211,3,5,0
93461,4,3,326210,326211,326214,1,4,0
93462,1,2,326211,326214,326216,3,5,0
93463,2,2,326213,326216,326218,3,5,0
93464,3,1,326216,326218,326219,2,3,0
93465,5,1,326221,326221,326222,0,1,2
93466,5,2,326226,326226,326228,0,2,4
93467,2,2,326228,326228,326230,0,2,0
93468,3,3,326231,326231,326234,0,3,1
93469,4,1,326235,326235,326236,0,1,1
93470,1,1,326236,326236,326237,0,1,0
93471,5,3,326241,326241,326244,0,3,4
93472,1,2,326242,326244,326246,2,4,0
93473,4,1,326246,326246,326247,0,1,0
93474,1,2,326247,326247,326249,0,2,0
93475,2,3,326249,326249,326252,0,3,0
93476,1,1,326250,326252,326253,2,3,0
93477,5,1,326255,326255,326256,0,1,2
93478,5,3,326260,326260,326263,0,3,4
93479,1,2,326261,326263,326265,2,4,0
93480,6,2,326267,326267,326269,0,2,2
93481,3,3,326270,326270,326273,0,3,1
93482,4,3,326274,326274,326277,0,3,1
93483,6,3,326280,326280,326283,0,3,3
93484,1,2,326281,326283,326285,2,4,0
93485,6,2,326287,326287,326289,0,2,2
93486,2,1,326289,326289,326290,0,1,0
93487,1,3,326290,326290,326293,0,3,0
93488,2,3,326292,326293,326296,1,4,0
93489,1,2,326293,326296,326298,3,5,0
93490,3,2,326296,326298,326300,2,4,0
93491,5,2,326301,326301,326303,0,2,1
93492,3,1,326304,326304,326305,0,1,1
93493,2,2,326306,326306,326308,0,2,1
93494,1,3,326307,326308,326311,1,4,0
93495,3,2,326310,326311,326313,1,3,0
93496,6,3,326316,326316,326319,0,3,3
93497,5,1,326321,326321,326322,0,1,2
93498,6,3,326327,326327,326330,0,3,5
93499,5,1,326332,326332,326333,0,1,2
93500,3,3,326335,326335,326338,0,3,2
93501,4,2,326339,326339,326341,0,2,1
93502,6,3,326345,326345,326348,0,3,4
93503,6,3,326351,326351,326354,0,3,3
93504,4,1,326355,326355,326356,0,1,1
93505,1,2,326356,326356,326358,0,2,0
93506,2,2,326358,326358,326360,0,2,0
93507,6,2,326364,326364,326366,0,2,4
93508,6,3,326370,326370,326373,0,3,4
93509,3,1,326373,326373,326374,0,1,0
93510,5,2,326378,326378,326380,0,2,4
93511,5,2,326383,326383,326385,0,2,3
93512,4,3,326387,326387,326390,0,3,2
93513,3,3,326390,326390,326393,0,3,0
93514,3,3,326393,326393,326396,0,3,0
93515,4,2,326397,326397,326399,0,2,1
93516,3,2,326400,326400,326402,0,2,1
93517,6,1,326406,326406,326407,0,1,4
93518,3,1,326409,326409,326410,0,1,2
93519,4,3,326413,326413,326416,0,3,3
93520,3,1,326416,326416,326417,0,1,0
93521,3,2,326419,326419,326421,0,2,2
93522,4,3,326423,326423,326426,0,3,2
93523,1,2,326424,326426,326428,2,4,0
93524,5,3,326429,326429,326432,0,3,1
93525,1,2,326430,326432,326434,2,4,0
93526,6,1,326436,326436,326437,0,1,2
93527,6,2,326442,326442,326444,0,2,5
93528,1,3,326443,326444,326447,1,4,0
93529,1,2,326444,326447,326449,3,5,0
93530,1,3,326445,326449,326452,4,7,0
93531,5,2,326450,326452,326454,2,4,0
93532,6,3,326456,326456,326459,0,3,2
93533,4,3,326460,326460,326463,0,3,1
93534,4,2,326464,326464,326466,0,2,1
93535,5,2,326469,326469,326471,0,2,3
93536,2,2,326471,326471,326473,0,2,0
93537,6,3,326477,326477,326480,0,3,4
93538,6,1,326483,326483,326484,0,1,3
93539,5,3,326488,326488,326491,0,3,4
93540,3,3,326491,326491,326494,0,3,0
93541,3,3,326494,326494,326497,0,3,0
93542,6,2,326500,326500,326502,0,2,3
93543,5,1,326505,326505,326506,0,1,3
93544,1,3,326506,326506,326509,0,3,0
93545,2,3,326508,326509,326512,1,4,0
93546,4,1,326512,326512,326513,0,1,0
93547,2,2,326514,326514,326516,0,2,1
93548,4,2,326518,326518,326520,0,2,2
93549,4,3,326522,326522,326525,0,3,2
93550,6,3,326528,326528,326531,0,3,3
93551,2,2,326530,326531,326533,1,3,0
93552,4,3,326534,326534,326537,0,3,1
93553,1,2,326535,326537,326539,2,4,0
93554,6,3,326541,326541,326544,0,3,2
93555,3,2,326544,326544,326546,0,2,0
93556,1,1,326545,326546,326547,1,2,0
93557,5,2,326550,326550,326552,0,2,3
93558,6,2,326556,326556,326558,0,2,4
93559,4,3,326560,326560,326563,0,3,2
93560,5,2,326565,326565,326567,0,2,2
93561,3,1,326568,326568,326569,0,1,1
93562,4,2,326572,326572,326574,0,2,3
93563,2,2,326574,326574,326576,0,2,0
93564,1,1,326575,326576,326577,1,2,0
93565,6,1,326581,326581,326582,0,1,4
93566,5,2,326586,326586,326588,0,2,4
93567,5,2,326591,326591,326593,0,2,3
93568,3,2,326594,326594,326596,0,2,1
93569,5,1,326599,326599,326600,0,1,3
93570,3,3,326602,326602,326605,0,3,2
93571,6,2,326608,326608,326610,0,2,3
93572,2,2,326610,326610,326612,0,2,0
93573,1,1,326611,326612,326613,1,2,0
93574,2,1,326613,326613,326614,0,1,0
93575,4,1,326617,326617,326618,0,1,3
93576,1,1,326618,326618,326619,0,1,0
93577,5,2,326623,326623,326625,0,2,4
93578,1,1,326624,326625,326626,1,2,0
93579,2,3,326626,326626,326629,0,3,0
93580,3,1,326629,326629,326630,0,1,0
93581,1,2,326630,326630,326632,0,2,0
93582,1,1,326631,326632,326633,1,2,0
93583,5,1,326636,326636,326637,0,1,3
93584,3,2,326639,326639,326641,0,2,2
93585,3,3,326642,326642,326645,0,3,1
93586,3,1,326645,326645,326646,0,1,0
93587,5,1,326650,326650,326651,0,1,4
93588,3,2,326653,326653,326655,0,2,2
93589,4,1,326657,326657,326658,0,1,2
93590,1,3,326658,326658,326661,0,3,0
93591,2,1,326660,326661,326662,1,2,0
93592,3,3,326663,326663,326666,0,3,1
93593,1,1,326664,326666,326667,2,3,0
93594,3,1,326667,326667,326668,0,1,0
93595,3,3,326670,326670,326673,0,3,2
93596,6,3,326676,326676,326679,0,3,3
93597,6,3,326682,326682,326685,0,3,3
93598,5,2,326687,326687,326689,0,2,2
93599,2,1,326689,326689,326690,0,1,0
93600,4,1,326693,326693,326694,0,1,3
93601,4,3,326697,326697,326700,0,3,3
93602,4,3,326701,326701,326704,0,3,1
93603,3,1,326704,326704,326705,0,1,0
93604,2,1,326706,326706,326707,0,1,1
93605,2,1,326708,326708,326709,0,1,1
93606,5,1,326713,326713,326714,0,1,4
93607,2,2,326715,326715,326717,0,2,1
93608,6,1,326721,326721,326722,0,1,4
93609,4,1,326725,326725,326726,0,1,3
93610,6,1,326731,326731,326732,0,1,5
93611,1,3,326732,326732,326735,0,3,0
93612,3,1,326735,326735,326736,0,1,0
93613,6,1,326741,326741,326742,0,1,5
93614,4,1,326745,326745,326746,0,1,3
93615,6,3,326751,326751,326754,0,3,5
93616,3,3,326754,326754,326757,0,3,0
93617,5,2,326759,326759,326761,0,2,2
93618,5,2,326764,326764,326766,0,2,3
93619,1,2,326765,326766,326768,1,3,0
93620,2,1,326767,326768,326769,1,2,0
93621,6,3,326773,326773,326776,0,3,4
93622,1,3,326774,326776,326779,2,5,0
93623,2,2,326776,326779,326781,3,5,0
93624,4,1,326780,326781,326782,1,2,0
93625,6,2,326786,326786,326788,0,2,4
93626,3,3,326789,326789,326792,0,3,1
93627,5,2,326794,326794,326796,0,2,2
93628,4,3,326798,326798,326801,0,3,2
93629,6,3,326804,326804,326807,0,3,3
93630,6,3,326810,326810,326813,0,3,3
93631,2,3,326812,326813,326816,1,4,0
93632,5,2,326817,326817,326819,0,2,1
93633,4,2,326821,326821,326823,0,2,2
93634,3,2,326824,326824,326826,0,2,1
93635,3,3,326827,326827,326830,0,3,1
93636,2,3,326829,326830,326833,1,4,0
93637,6,1,326835,326835,326836,0,1,2
93638,3,2,326838,326838,326840,0,2,2
93639,3,3,326841,326841,326844,0,3,1
93640,6,1,326847,326847,326848,0,1,3
93641,4,2,326851,326851,326853,0,2,3
93642,2,3,326853,326853,326856,0,3,0
93643,1,1,326854,326856,326857,2,3,0
93644,4,2,326858,326858,326860,0,2,1
93645,5,2,326863,326863,326865,0,2,3
93646,2,1,326865,326865,326866,0,1,0
93647,4,2,326869,326869,326871,0,2,3
93648,3,1,326872,326872,326873,0,1,1
93649,2,2,326874,326874,326876,0,2,1
93650,2,1,326876,326876,326877,0,1,0
93651,3,2,326879,326879,326881,0,2,2
93652,2,3,326881,326881,326884,0,3,0
93653,6,1,326887,326887,326888,0,1,3
93654,5,2,326892,326892,326894,0,2,4
93655,5,2,326897,326897,326899,0,2,3
93656,1,2,326898,326899,326901,1,3,0
93657,4,1,326902,326902,326903,0,1,1
93658,3,3,326905,326905,326908,0,3,2
93659,6,2,326911,326911,326913,0,2,3
93660,1,1,326912,326913,326914,1,2,0
93661,2,1,326914,326914,326915,0,1,0
93662,1,1,326915,326915,326916,0,1,0
93663,6,1,326921,326921,326922,0,1,5
93664,5,1,326926,326926,326927,0,1,4
93665,6,1,326932,326932,326933,0,1,5
93666,4,1,326936,326936,326937,0,1,3
93667,2,3,326938,326938,326941,0,3,1
93668,5,3,326943,326943,326946,0,3,2
93669,3,1,326946,326946,326947,0,1,0
93670,2,2,326948,326948,326950,0,2,1
93671,3,2,326951,326951,326953,0,2,1
93672,4,2,326955,326955,326957,0,2,2
93673,1,1,326956,326957,326958,1,2,0
93674,3,3,326959,326959,326962,0,3,1
93675,5,2,326964,326964,326966,0,2,2
93676,1,1,326965,326966,326967,1,2,0
93677,1,3,326966,326967,326970,1,4,0
93678,1,2,326967,326970,326972,3,5,0
93679,4,1,326971,326972,326973,1,2,0
93680,2,3,326973,326973,326976,0,3,0
93681,4,2,326977,326977,326979,0,2,1
93682,5,2,326982,326982,326984,0,2,3
93683,5,1,326987,326987,326988,0,1,3
93684,1,2,326988,326988,326990,0,2,0
93685,1,3,326989,326990,326993,1,4,0
93686,3,2,326992,326993,326995,1,3,0
93687,5,3,326997,326997,327000,0,3,2
93688,5,1,327002,327002,327003,0,1,2
93689,1,3,327003,327003,327006,0,3,0
93690,5,3,327008,327008,327011,0,3,2
93691,5,1,327013,327013,327014,0,1,2
93692,5,3,327018,327018,327021,0,3,4
93693,2,3,327020,327021,327024,1,4,0
93694,6,3,327026,327026,327029,0,3,2
93695,4,2,327030,327030,327032,0,2,1
93696,5,2,327035,327035,327037,0,2,3
93697,6,1,327041,327041,327042,0,1,4
93698,5,2,327046,327046,327048,0,2,4
93699,6,1,327052,327052,327053,0,1,4
93700,3,3,327055,327055,327058,0,3,2
93701,1,3,327056,327058,327061,2,5,0
93702,1,2,327057,327061,327063,4,6,0
93703,6,1,327063,327063,327064,0,1,0
93704,3,3,327066,327066,327069,0,3,2
93705,6,1,327072,327072,327073,0,1,3
93706,4,2,327076,327076,327078,0,2,3
93707,3,1,327079,327079,327080,0,1,1
93708,3,2,327082,327082,327084,0,2,2
93709,1,1,327083,327084,327085,1,2,0
93710,1,3,327084,327085,327088,1,4,0
93711,5,3,327089,327089,327092,0,3,1
93712,5,2,327094,327094,327096,0,2,2
93713,4,2,327098,327098,327100,0,2,2
93714,2,3,327100,327100,327103,0,3,0
93715,5,3,327105,327105,327108,0,3,2
93716,2,2,327107,327108,327110,1,3,0
93717,2,1,327109,327110,327111,1,2,0
93718,1,3,327110,327111,327114,1,4,0
93719,2,1,327112,327114,327115,2,3,0
93720,2,1,327114,327115,327116,1,2,0
93721,5,2,327119,327119,327121,0,2,3
93722,2,3,327121,327121,327124,0,3,0
93723,4,3,327125,327125,327128,0,3,1
93724,5,2,327130,327130,327132,0,2,2
93725,1,1,327131,327132,327133,1,2,0
93726,6,3,327137,327137,327140,0,3,4
93727,4,1,327141,327141,327142,0,1,1
93728,3,3,327144,327144,327147,0,3,2
93729,6,3,327150,327150,327153,0,3,3
93730,2,2,327152,327153,327155,1,3,0
93731,4,3,327156,327156,327159,0,3,1
93732,5,1,327161,327161,327162,0,1,2
93733,4,1,327165,327165,327166,0,1,3
93734,6,1,327171,327171,327172,0,1,5
93735,4,3,327175,327175,327178,0,3,3
93736,3,2,327178,327178,327180,0,2,0
93737,3,2,327181,327181,327183,0,2,1
93738,1,1,327182,327183,327184,1,2,0
93739,1,1,327183,327184,327185,1,2,0
93740,1,1,327184,327185,327186,1,2,0
93741,1,2,327185,327186,327188,1,3,0
93742,1,3,327186,327188,327191,2,5,0
93743,5,1,327191,327191,327192,0,1,0
93744,5,3,327196,327196,327199,0,3,4
93745,2,1,327198,327199,327200,1,2,0
93746,4,3,327202,327202,327205,0,3,2
93747,1,1,327203,327205,327206,2,3,0
93748,1,2,327204,327206,327208,2,4,0
93749,3,1,327207,327208,327209,1,2,0
93750,3,3,327210,327210,327213,0,3,1
93751,4,1,327214,327214,327215,0,1,1
93752,4,3,327218,327218,327221,0,3,3
93753,6,2,327224,327224,327226,0,2,3
93754,2,3,327226,327226,327229,0,3,0
93755,3,1,327229,327229,327230,0,1,0
93756,6,3,327235,327235,327238,0,3,5
93757,1,1,327236,327238,327239,2,3,0
93758,4,2,327240,327240,327242,0,2,1
93759,4,3,327244,327244,327247,0,3,2
93760,1,3,327245,327247,327250,2,5,0
93761,5,1,327250,327250,327251,0,1,0
93762,4,3,327254,327254,327257,0,3,3
93763,3,3,327257,327257,327260,0,3,0
93764,6,2,327263,327263,327265,0,2,3
93765,3,3,327266,327266,327269,0,3,1
93766,4,1,327270,327270,327271,0,1,1
93767,1,3,327271,327271,327274,0,3,0
93768,3,2,327274,327274,327276,0,2,0
93769,1,3,327275,327276,327279,1,4,0
93770,2,3,327277,327279,327282,2,5,0
93771,4,3,327281,327282,327285,1,4,0
93772,5,1,327286,327286,327287,0,1,1
93773,4,1,327290,327290,327291,0,1,3
93774,3,3,327293,327293,327296,0,3,2
93775,5,1,327298,327298,327299,0,1,2
93776,2,3,327300,327300,327303,0,3,1
93777,1,2,327301,327303,327305,2,4,0
93778,1,2,327302,327305,327307,3,5,0
93779,2,1,327304,327307,327308,3,4,0
93780,1,1,327305,327308,327309,3,4,0
93781,2,1,327307,327309,327310,2,3,0
93782,1,2,327308,327310,327312,2,4,0
93783,2,3,327310,327312,327315,2,5,0
93784,6,1,327316,327316,327317,0,1,1
93785,2,1,327318,327318,327319,0,1,1
93786,4,3,327322,327322,327325,0,3,3
93787,3,3,327325,327325,327328,0,3,0
93788,4,1,327329,327329,327330,0,1,1
93789,5,1,327334,327334,327335,0,1,4
93790,4,3,327338,327338,327341,0,3,3
93791,1,1,327339,327341,327342,2,3,0
93792,3,3,327342,327342,327345,0,3,0
93793,5,2,327347,327347,327349,0,2,2
93794,5,1,327352,327352,327353,0,1,3
93795,4,2,327356,327356,327358,0,2,3
93796,1,1,327357,327358,327359,1,2,0
93797,4,2,327361,327361,327363,0,2,2
93798,2,3,327363,327363,327366,0,3,0
93799,3,1,327366,327366,327367,0,1,0
93800,1,1,327367,327367,327368,0,1,0
93801,3,2,327370,327370,327372,0,2,2
93802,1,2,327371,327372,327374,1,3,0
93803,6,1,327377,327377,327378,0,1,3
93804,6,1,327383,327383,327384,0,1,5
93805,4,2,327387,327387,327389,0,2,3
93806,6,2,327393,327393,327395,0,2,4
93807,3,3,327396,327396,327399,0,3,1
93808,6,1,327402,327402,327403,0,1,3
93809,3,1,327405,327405,327406,0,1,2
93810,4,3,327409,327409,327412,0,3,3
93811,5,2,327414,327414,327416,0,2,2
93812,4,1,327418,327418,327419,0,1,2
93813,1,3,327419,327419,327422,0,3,0
93814,6,2,327425,327425,327427,0,2,3
93815,2,1,327427,327427,327428,0,1,0
93816,2,2,327429,327429,327431,0,2,1
93817,4,2,327433,327433,327435,0,2,2
93818,1,1,327434,327435,327436,1,2,0
93819,5,3,327439,327439,327442,0,3,3
93820,3,2,327442,327442,327444,0,2,0
93821,3,3,327445,327445,327448,0,3,1
93822,4,1,327449,327449,327450,0,1,1
93823,3,1,327452,327452,327453,0,1,2
93824,5,3,327457,327457,327460,0,3,4
93825,1,2,327458,327460,327462,2,4,0
93826,4,3,327462,327462,327465,0,3,0
93827,4,1,327466,327466,327467,0,1,1
93828,4,3,327470,327470,327473,0,3,3
93829,3,2,327473,327473,327475,0,2,0
93830,6,1,327479,327479,327480,0,1,4
93831,3,2,327482,327482,327484,0,2,2
93832,6,1,327488,327488,327489,0,1,4
93833,2,3,327490,327490,327493,0,3,1
93834,5,2,327495,327495,327497,0,2,2
93835,2,2,327497,327497,327499,0,2,0
93836,6,2,327503,327503,327505,0,2,4
93837,6,2,327509,327509,327511,0,2,4
93838,1,3,327510,327511,327514,1,4,0
93839,2,1,327512,327514,327515,2,3,0
93840,5,1,327517,327517,327518,0,1,2
93841,2,1,327519,327519,327520,0,1,1
93842,6,1,327525,327525,327526,0,1,5
93843,6,2,327531,327531,327533,0,2,5
93844,5,3,327536,327536,327539,0,3,3
93845,5,1,327541,327541,327542,0,1,2
93846,1,1,327542,327542,327543,0,1,0
93847,3,1,327545,327545,327546,0,1,2
93848,5,2,327550,327550,327552,0,2,4
93849,4,2,327554,327554,327556,0,2,2
93850,1,1,327555,327556,327557,1,2,0
93851,4,3,327559,327559,327562,0,3,2
93852,1,2,327560,327562,327564,2,4,0
93853,4,1,327564,327564,327565,0,1,0
93854,3,2,327567,327567,327569,0,2,2
93855,5,3,327572,327572,327575,0,3,3
93856,5,3,327577,327577,327580,0,3,2
93857,3,1,327580,327580,327581,0,1,0
93858,1,3,327581,327581,327584,0,3,0
93859,3,3,327584,327584,327587,0,3,0
93860,4,3,327588,327588,327591,0,3,1
93861,4,1,327592,327592,327593,0,1,1
93862,5,2,327597,327597,327599,0,2,4
93863,1,1,327598,327599,327600,1,2,0
93864,5,3,327603,327603,327606,0,3,3
93865,3,1,327606,327606,327607,0,1,0
93866,4,2,327610,327610,327612,0,2,3
93867,3,3,327613,327613,327616,0,3,1
93868,4,1,327617,327617,327618,0,1,1
93869,5,2,327622,327622,327624,0,2,4
93870,1,2,327623,327624,327626,1,3,0
93871,3,1,327626,327626,327627,0,1,0
93872,2,3,327628,327628,327631,0,3,1
93873,5,1,327633,327633,327634,0,1,2
93874,3,3,327636,327636,327639,0,3,2
93875,3,1,327639,327639,327640,0,1,0
93876,4,2,327643,327643,327645,0,2,3
93877,5,2,327648,327648,327650,0,2,3
93878,1,1,327649,327650,327651,1,2,0
93879,2,1,327651,327651,327652,0,1,0
93880,6,3,327657,327657,327660,0,3,5
93881,3,1,327660,327660,327661,0,1,0
93882,6,1,327666,327666,327667,0,1,5
93883,6,2,327672,327672,327674,0,2,5
93884,1,3,327673,327674,327677,1,4,0
93885,1,2,327674,327677,327679,3,5,0
93886,3,3,327677,327679,327682,2,5,0
93887,5,2,327682,327682,327684,0,2,0
93888,3,1,327685,327685,327686,0,1,1
93889,6,3,327691,327691,327694,0,3,5
93890,5,1,327696,327696,327697,0,1,2
93891,1,3,327697,327697,327700,0,3,0
93892,4,3,327701,327701,327704,0,3,1
93893,3,1,327704,327704,327705,0,1,0
93894,2,3,327706,327706,327709,0,3,1
93895,6,2,327712,327712,327714,0,2,3
93896,6,3,327718,327718,327721,0,3,4
93897,2,1,327720,327721,327722,1,2,0
93898,1,3,327721,327722,327725,1,4,0
93899,2,1,327723,327725,327726,2,3,0
93900,2,3,327725,327726,327729,1,4,0
93901,4,1,327729,327729,327730,0,1,0
93902,5,3,327734,327734,327737,0,3,4
93903,3,2,327737,327737,327739,0,2,0
93904,4,1,327741,327741,327742,0,1,2
93905,2,2,327743,327743,327745,0,2,1
93906,6,2,327749,327749,327751,0,2,4
93907,1,2,327750,327751,327753,1,3,0
93908,6,1,327756,327756,327757,0,1,3
93909,3,1,327759,327759,327760,0,1,2
93910,3,2,327762,327762,327764,0,2,2
93911,5,3,327767,327767,327770,0,3,3
93912,6,2,327773,327773,327775,0,2,3
93913,3,2,327776,327776,327778,0,2,1
93914,1,1,327777,327778,327779,1,2,0
93915,5,3,327782,327782,327785,0,3,3
93916,3,2,327785,327785,327787,0,2,0
93917,6,2,327791,327791,327793,0,2,4
93918,5,3,327796,327796,327799,0,3,3
93919,4,3,327800,327800,327803,0,3,1
93920,1,1,327801,327803,327804,2,3,0
93921,3,3,327804,327804,327807,0,3,0
93922,3,3,327807,327807,327810,0,3,0
93923,2,3,327809,327810,327813,1,4,0
93924,1,2,327810,327813,327815,3,5,0
93925,6,1,327816,327816,327817,0,1,1
93926,1,1,327817,327817,327818,0,1,0
93927,5,1,327822,327822,327823,0,1,4
93928,5,2,327827,327827,327829,0,2,4
93929,2,3,327829,327829,327832,0,3,0
93930,2,1,327831,327832,327833,1,2,0
93931,6,1,327837,327837,327838,0,1,4
93932,1,1,327838,327838,327839,0,1,0
93933,2,2,327840,327840,327842,0,2,1
93934,3,3,327843,327843,327846,0,3,1
93935,4,2,327847,327847,327849,0,2,1
93936,6,2,327853,327853,327855,0,2,4
93937,3,3,327856,327856,327859,0,3,1
93938,2,1,327858,327859,327860,1,2,0
93939,2,1,327860,327860,327861,0,1,0
93940,4,1,327864,327864,327865,0,1,3
93941,2,1,327866,327866,327867,0,1,1
93942,2,3,327868,327868,327871,0,3,1
93943,2,2,327870,327871,327873,1,3,0
93944,2,1,327872,327873,327874,1,2,0
93945,3,1,327875,327875,327876,0,1,1
93946,5,1,327880,327880,327881,0,1,4
93947,6,1,327886,327886,327887,0,1,5
93948,5,2,327891,327891,327893,0,2,4
93949,6,2,327897,327897,327899,0,2,4
93950,1,2,327898,327899,327901,1,3,0
93951,2,2,327900,327901,327903,1,3,0
93952,2,2,327902,327903,327905,1,3,0
93953,2,3,327904,327905,327908,1,4,0
93954,1,2,327905,327908,327910,3,5,0
93955,6,2,327911,327911,327913,0,2,1
93956,6,2,327917,327917,327919,0,2,4
93957,1,2,327918,327919,327921,1,3,0
93958,4,3,327922,327922,327925,0,3,1
93959,6,1,327928,327928,327929,0,1,3
93960,4,2,327932,327932,327934,0,2,3
93961,3,1,327935,327935,327936,0,1,1
93962,6,1,327941,327941,327942,0,1,5
93963,1,3,327942,327942,327945,0,3,0
93964,2,3,327944,327945,327948,1,4,0
93965,4,3,327948,327948,327951,0,3,0
93966,3,3,327951,327951,327954,0,3,0
93967,2,1,327953,327954,327955,1,2,0
93968,6,2,327959,327959,327961,0,2,4
93969,1,2,327960,327961,327963,1,3,0
93970,6,2,327966,327966,327968,0,2,3
93971,5,1,327971,327971,327972,0,1,3
93972,3,1,327974,327974,327975,0,1,2
93973,4,1,327978,327978,327979,0,1,3
93974,4,2,327982,327982,327984,0,2,3
93975,2,1,327984,327984,327985,0,1,0
93976,4,2,327988,327988,327990,0,2,3
93977,3,3,327991,327991,327994,0,3,1
93978,2,1,327993,327994,327995,1,2,0
93979,5,3,327998,327998,328001,0,3,3
93980,6,3,328004,328004,328007,0,3,3
93981,6,2,328010,328010,328012,0,2,3
93982,5,2,328015,328015,328017,0,2,3
93983,6,1,328021,328021,328022,0,1,4
93984,4,1,328025,328025,328026,0,1,3
93985,6,2,328031,328031,328033,0,2,5
93986,3,3,328034,328034,328037,0,3,1
93987,5,3,328039,328039,328042,0,3,2
93988,3,1,328042,328042,328043,0,1,0
93989,6,3,328048,328048,328051,0,3,5
93990,2,1,328050,328051,328052,1,2,0
93991,4,1,328054,328054,328055,0,1,2
93992,3,1,328057,328057,328058,0,1,2
93993,2,1,328059,328059,328060,0,1,1
93994,5,3,328064,328064,328067,0,3,4
93995,6,3,328070,328070,328073,0,3,3
93996,2,1,328072,328073,328074,1,2,0
93997,4,3,328076,328076,328079,0,3,2
93998,6,1,328082,328082,328083,0,1,3
93999,3,1,328085,328085,328086,0,1,2
94000,4,2,328089,328089,328091,0,2,3
94001,4,3,328093,328093,328096,0,3,2
94002,1,3,328094,328096,328099,2,5,0
94003,5,3,328099,328099,328102,0,3,0
94004,2,1,328101,328102,328103,1,2,0
94005,2,1,328103,328103,328104,0,1,0
94006,6,1,328109,328109,328110,0,1,5
94007,2,3,328111,328111,328114,0,3,1
94008,2,2,328113,328114,328116,1,3,0
94009,1,3,328114,328116,328119,2,5,0
94010,2,3,328116,328119,328122,3,6,0
94011,6,3,328122,328122,328125,0,3,0
94012,6,2,328128,328128,328130,0,2,3
94013,2,1,328130,328130,328131,0,1,0
94014,4,2,328134,328134,328136,0,2,3
94015,5,1,328139,328139,328140,0,1,3
94016,1,1,328140,328140,328141,0,1,0
94017,6,1,328146,328146,328147,0,1,5
94018,2,1,328148,328148,328149,0,1,1
94019,3,1,328151,328151,328152,0,1,2
94020,6,3,328157,328157,328160,0,3,5
94021,4,1,328161,328161,328162,0,1,1
94022,4,3,328165,328165,328168,0,3,3
94023,3,1,328168,328168,328169,0,1,0
94024,5,2,328173,328173,328175,0,2,4
94025,4,1,328177,328177,328178,0,1,2
94026,3,2,328180,328180,328182,0,2,2
94027,5,3,328185,328185,328188,0,3,3
94028,6,2,328191,328191,328193,0,2,3
94029,4,1,328195,328195,328196,0,1,2
94030,1,1,328196,328196,328197,0,1,0
94031,2,1,328198,328198,328199,0,1,1
94032,5,1,328203,328203,328204,0,1,4
94033,2,1,328205,328205,328206,0,1,1
94034,6,3,328211,328211,328214,0,3,5
94035,5,2,328216,328216,328218,0,2,2
94036,6,1,328222,328222,328223,0,1,4
94037,6,3,328228,328228,328231,0,3,5
94038,5,1,328233,328233,328234,0,1,2
94039,5,2,328238,328238,328240,0,2,4
94040,4,1,328242,328242,328243,0,1,2
94041,4,2,328246,328246,328248,0,2,3
94042,1,1,328247,328248,328249,1,2,0
94043,6,1,328253,328253,328254,0,1,4
94044,6,2,328259,328259,328261,0,2,5
94045,3,3,328262,328262,328265,0,3,1
94046,2,2,328264,328265,328267,1,3,0
94047,6,2,328270,328270,328272,0,2,3
94048,2,2,328272,328272,328274,0,2,0
94049,5,3,328277,328277,328280,0,3,3
94050,2,2,328279,328280,328282,1,3,0
94051,2,1,328281,328282,328283,1,2,0
94052,6,1,328287,328287,328288,0,1,4
94053,1,2,328288,328288,328290,0,2,0
94054,2,1,328290,328290,328291,0,1,0
94055,6,1,328296,328296,328297,0,1,5
94056,6,1,328302,328302,328303,0,1,5
94057,4,1,328306,328306,328307,0,1,3
94058,3,2,328309,328309,328311,0,2,2
94059,2,1,328311,328311,328312,0,1,0
94060,3,1,328314,328314,328315,0,1,2
94061,5,3,328319,328319,328322,0,3,4
94062,6,2,328325,328325,328327,0,2,3
94063,4,2,328329,328329,328331,0,2,2
94064,4,3,328333,328333,328336,0,3,2
94065,6,3,328339,328339,328342,0,3,3
94066,1,1,328340,328342,328343,2,3,0
94067,6,2,328346,328346,328348,0,2,3
94068,2,2,328348,328348,328350,0,2,0
94069,1,3,328349,328350,328353,1,4,0
94070,3,2,328352,328353,328355,1,3,0
94071,4,3,328356,328356,328359,0,3,1
94072,6,3,328362,328362,328365,0,3,3
94073,3,1,328365,328365,328366,0,1,0
94074,4,2,328369,328369,328371,0,2,3
94075,4,1,328373,328373,328374,0,1,2
94076,6,2,328379,328379,328381,0,2,5
94077,3,1,328382,328382,328383,0,1,1
94078,1,2,328383,328383,328385,0,2,0
94079,2,3,328385,328385,328388,0,3,0
94080,6,2,328391,328391,328393,0,2,3
94081,2,1,328393,328393,328394,0,1,0
94082,2,3,328395,328395,328398,0,3,1
94083,5,2,328400,328400,328402,0,2,2
94084,6,2,328406,328406,328408,0,2,4
94085,3,2,328409,328409,328411,0,2,1
94086,1,3,328410,328411,328414,1,4,0
94087,4,3,328414,328414,328417,0,3,0
94088,3,1,328417,328417,328418,0,1,0
94089,6,2,328423,328423,328425,0,2,5
94090,5,3,328428,328428,328431,0,3,3
94091,5,2,328433,328433,328435,0,2,2
94092,1,2,328434,328435,328437,1,3,0
94093,4,2,328438,328438,328440,0,2,1
94094,6,1,328444,328444,328445,0,1,4
94095,5,2,328449,328449,328451,0,2,4
94096,1,3,328450,328451,328454,1,4,0
94097,4,3,328454,328454,328457,0,3,0
94098,3,1,328457,328457,328458,0,1,0
94099,4,3,328461,328461,328464,0,3,3
94100,3,3,328464,328464,328467,0,3,0
94101,6,1,328470,328470,328471,0,1,3
94102,6,3,328476,328476,328479,0,3,5
94103,2,2,328478,328479,328481,1,3,0
94104,2,1,328480,328481,328482,1,2,0
94105,5,1,328485,328485,328486,0,1,3
94106,4,2,328489,328489,328491,0,2,3
94107,3,1,328492,328492,328493,0,1,1
94108,2,2,328494,328494,328496,0,2,1
94109,4,3,328498,328498,328501,0,3,2
94110,6,2,328504,328504,328506,0,2,3
94111,5,2,328509,328509,328511,0,2,3
94112,5,2,328514,328514,328516,0,2,3
94113,1,3,328515,328516,328519,1,4,0
94114,6,2,328521,328521,328523,0,2,2
94115,4,2,328525,328525,328527,0,2,2
94116,4,2,328529,328529,328531,0,2,2
94117,5,3,328534,328534,328537,0,3,3
94118,5,1,328539,328539,328540,0,1,2
94119,2,3,328541,328541,328544,0,3,1
94120,1,2,328542,328544,328546,2,4,0
94121,5,3,328547,328547,328550,0,3,1
94122,6,2,328553,328553,328555,0,2,3
94123,2,1,328555,328555,328556,0,1,0
94124,2,2,328557,328557,328559,0,2,1
94125,2,3,328559,328559,328562,0,3,0
94126,6,3,328565,328565,328568,0,3,3
94127,3,2,328568,328568,328570,0,2,0
94128,5,3,328573,328573,328576,0,3,3
94129,2,3,328575,328576,328579,1,4,0
94130,2,3,328577,328579,328582,2,5,0
94131,4,1,328581,328582,328583,1,2,0
94132,1,3,328582,328583,328586,1,4,0
94133,5,1,328587,328587,328588,0,1,1
94134,6,3,328593,328593,328596,0,3,5
94135,3,3,328596,328596,328599,0,3,0
94136,2,3,328598,328599,328602,1,4,0
94137,5,1,328603,328603,328604,0,1,1
94138,3,2,328606,328606,328608,0,2,2
94139,3,2,328609,328609,328611,0,2,1
94140,5,1,328614,328614,328615,0,1,3
94141,2,1,328616,328616,328617,0,1,1
94142,4,1,328620,328620,328621,0,1,3
94143,4,3,328624,328624,328627,0,3,3
94144,5,3,328629,328629,328632,0,3,2
94145,4,2,328633,328633,328635,0,2,1
94146,3,3,328636,328636,328639,0,3,1
94147,1,2,328637,328639,328641,2,4,0
94148,5,1,328642,328642,328643,0,1,1
94149,4,2,328646,328646,328648,0,2,3
94150,1,3,328647,328648,328651,1,4,0
94151,6,2,328653,328653,328655,0,2,2
94152,3,1,328656,328656,328657,0,1,1
94153,1,1,328657,328657,328658,0,1,0
94154,2,2,328659,328659,328661,0,2,1
94155,5,2,328664,328664,328666,0,2,3
94156,3,2,328667,328667,328669,0,2,1
94157,6,2,328673,328673,328675,0,2,4
94158,3,2,328676,328676,328678,0,2,1
94159,2,3,328678,328678,328681,0,3,0
94160,2,1,328680,328681,328682,1,2,0
94161,1,1,328681,328682,328683,1,2,0
94162,6,1,328687,328687,328688,0,1,4
94163,2,1,328689,328689,328690,0,1,1
94164,2,1,328691,328691,328692,0,1,1
94165,1,2,328692,328692,328694,0,2,0
94166,2,3,328694,328694,328697,0,3,0
94167,3,1,328697,328697,328698,0,1,0
94168,5,3,328702,328702,328705,0,3,4
94169,4,3,328706,328706,328709,0,3,1
94170,3,3,328709,328709,328712,0,3,0
94171,2,3,328711,328712,328715,1,4,0
94172,1,1,328712,328715,328716,3,4,0
94173,2,2,328714,328716,328718,2,4,0
94174,4,3,328718,328718,328721,0,3,0
94175,4,3,328722,328722,328725,0,3,1
94176,4,2,328726,328726,328728,0,2,1
94177,6,2,328732,328732,328734,0,2,4
94178,4,3,328736,328736,328739,0,3,2
94179,2,2,328738,328739,328741,1,3,0
94180,1,2,328739,328741,328743,2,4,0
94181,4,3,328743,328743,328746,0,3,0
94182,4,3,328747,328747,328750,0,3,1
94183,4,3,328751,328751,328754,0,3,1
94184,4,1,328755,328755,328756,0,1,1
94185,5,3,328760,328760,328763,0,3,4
94186,6,1,328766,328766,328767,0,1,3
94187,4,3,328770,328770,328773,0,3,3
94188,1,1,328771,328773,328774,2,3,0
94189,2,2,328773,328774,328776,1,3,0
94190,5,3,328778,328778,328781,0,3,2
94191,6,3,328784,328784,328787,0,3,3
94192,5,3,328789,328789,328792,0,3,2
94193,4,3,328793,328793,328796,0,3,1
94194,2,1,328795,328796,328797,1,2,0
94195,4,2,328799,328799,328801,0,2,2
94196,6,2,328805,328805,328807,0,2,4
94197,6,2,328811,328811,328813,0,2,4
94198,2,1,328813,328813,328814,0,1,0
94199,3,1,328816,328816,328817,0,1,2
94200,3,2,328819,328819,328821,0,2,2
94201,6,3,328825,328825,328828,0,3,4
94202,6,1,328831,328831,328832,0,1,3
94203,5,3,328836,328836,328839,0,3,4
94204,2,2,328838,328839,328841,1,3,0
94205,3,1,328841,328841,328842,0,1,0
94206,1,2,328842,328842,328844,0,2,0
94207,2,1,328844,328844,328845,0,1,0
94208,2,2,328846,328846,328848,0,2,1
94209,1,1,328847,328848,328849,1,2,0
94210,5,3,328852,328852,328855,0,3,3
94211,4,1,328856,328856,328857,0,1,1
94212,6,3,328862,328862,328865,0,3,5
94213,3,3,328865,328865,328868,0,3,0
94214,3,2,328868,328868,328870,0,2,0
94215,2,1,328870,328870,328871,0,1,0
94216,5,3,328875,328875,328878,0,3,4
94217,6,1,328881,328881,328882,0,1,3
94218,1,2,328882,328882,328884,0,2,0
94219,1,2,328883,328884,328886,1,3,0
94220,4,2,328887,328887,328889,0,2,1
94221,5,3,328892,328892,328895,0,3,3
94222,1,3,328893,328895,328898,2,5,0
94223,4,2,328897,328898,328900,1,3,0
94224,1,3,328898,328900,328903,2,5,0
94225,2,1,328900,328903,328904,3,4,0
94226,3,1,328903,328904,328905,1,2,0
94227,4,1,328907,328907,328908,0,1,2
94228,5,1,328912,328912,328913,0,1,4
94229,3,1,328915,328915,328916,0,1,2
94230,5,2,328920,328920,328922,0,2,4
94231,5,1,328925,328925,328926,0,1,3
94232,1,2,328926,328926,328928,0,2,0
94233,3,2,328929,328929,328931,0,2,1
94234,3,2,328932,328932,328934,0,2,1
94235,6,3,328938,328938,328941,0,3,4
94236,1,2,328939,328941,328943,2,4,0
94237,5,2,328944,328944,328946,0,2,1
94238,3,3,328947,328947,328950,0,3,1
94239,1,2,328948,328950,328952,2,4,0
94240,5,1,328953,328953,328954,0,1,1
94241,6,3,328959,328959,328962,0,3,5
94242,1,2,328960,328962,328964,2,4,0
94243,5,1,328965,328965,328966,0,1,1
94244,5,1,328970,328970,328971,0,1,4
94245,2,3,328972,328972,328975,0,3,1
94246,3,2,328975,328975,328977,0,2,0
94247,2,1,328977,328977,328978,0,1,0
94248,3,3,328980,328980,328983,0,3,2
94249,4,3,328984,328984,328987,0,3,1
94250,3,1,328987,328987,328988,0,1,0
94251,2,1,328989,328989,328990,0,1,1
94252,5,1,328994,328994,328995,0,1,4
94253,1,2,328995,328995,328997,0,2,0
94254,3,1,328998,328998,328999,0,1,1
94255,6,2,329004,329004,329006,0,2,5
94256,6,1,329010,329010,329011,0,1,4
94257,1,2,329011,329011,329013,0,2,0
94258,1,1,329012,329013,329014,1,2,0
94259,1,2,329013,329014,329016,1,3,0
94260,6,2,329019,329019,329021,0,2,3
94261,2,2,329021,329021,329023,0,2,0
94262,2,3,329023,329023,329026,0,3,0
94263,4,2,329027,329027,329029,0,2,1
94264,2,2,329029,329029,329031,0,2,0
94265,4,3,329033,329033,329036,0,3,2
94266,5,2,329038,329038,329040,0,2,2
94267,6,1,329044,329044,329045,0,1,4
94268,2,2,329046,329046,329048,0,2,1
94269,3,2,329049,329049,329051,0,2,1
94270,3,3,329052,329052,329055,0,3,1
94271,2,2,329054,329055,329057,1,3,0
94272,4,2,329058,329058,329060,0,2,1
94273,3,1,329061,329061,329062,0,1,1
94274,3,1,329064,329064,329065,0,1,2
94275,6,3,329070,329070,329073,0,3,5
94276,1,1,329071,329073,329074,2,3,0
94277,1,2,329072,329074,329076,2,4,0
94278,4,3,329076,329076,329079,0,3,0
94279,4,2,329080,329080,329082,0,2,1
94280,5,3,329085,329085,329088,0,3,3
94281,3,1,329088,329088,329089,0,1,0
94282,2,1,329090,329090,329091,0,1,1
94283,2,2,329092,329092,329094,0,2,1
94284,3,1,329095,329095,329096,0,1,1
94285,4,1,329099,329099,329100,0,1,3
94286,5,2,329104,329104,329106,0,2,4
94287,6,3,329110,329110,329113,0,3,4
94288,6,2,329116,329116,329118,0,2,3
94289,2,1,329118,329118,329119,0,1,0
94290,1,3,329119,329119,329122,0,3,0
94291,6,2,329125,329125,329127,0,2,3
94292,5,1,329130,329130,329131,0,1,3
94293,4,2,329134,329134,329136,0,2,3
94294,2,2,329136,329136,329138,0,2,0
94295,2,3,329138,329138,329141,0,3,0
94296,5,1,329143,329143,329144,0,1,2
94297,3,3,329146,329146,329149,0,3,2
94298,6,2,329152,329152,329154,0,2,3
94299,3,2,329155,329155,329157,0,2,1
94300,5,3,329160,329160,329163,0,3,3
94301,4,3,329164,329164,329167,0,3,1
94302,4,2,329168,329168,329170,0,2,1
94303,6,2,329174,329174,329176,0,2,4
94304,5,2,329179,329179,329181,0,2,3
94305,5,1,329184,329184,329185,0,1,3
94306,3,1,329187,329187,329188,0,1,2
94307,3,1,329190,329190,329191,0,1,2
94308,3,1,329193,329193,329194,0,1,2
94309,4,2,329197,329197,329199,0,2,3
94310,5,3,329202,329202,329205,0,3,3
94311,6,3,329208,329208,329211,0,3,3
94312,6,2,329214,329214,329216,0,2,3
94313,5,2,329219,329219,329221,0,2,3
94314,2,2,329221,329221,329223,0,2,0
94315,4,3,329225,329225,329228,0,3,2
94316,1,3,329226,329228,329231,2,5,0
94317,5,2,329231,329231,329233,0,2,0
94318,5,3,329236,329236,329239,0,3,3
94319,4,1,329240,329240,329241,0,1,1
94320,5,3,329245,329245,329248,0,3,4
94321,3,2,329248,329248,329250,0,2,0
94322,3,1,329251,329251,329252,0,1,1
94323,2,2,329253,329253,329255,0,2,1
94324,6,2,329259,329259,329261,0,2,4
94325,3,2,329262,329262,329264,0,2,1
94326,1,3,329263,329264,329267,1,4,0
94327,5,2,329268,329268,329270,0,2,1
94328,4,1,329272,329272,329273,0,1,2
94329,5,2,329277,329277,329279,0,2,4
94330,1,1,329278,329279,329280,1,2,0
94331,3,2,329281,329281,329283,0,2,1
94332,4,3,329285,329285,329288,0,3,2
94333,2,1,329287,329288,329289,1,2,0
94334,4,2,329291,329291,329293,0,2,2
94335,6,2,329297,329297,329299,0,2,4
94336,4,2,329301,329301,329303,0,2,2
94337,2,2,329303,329303,329305,0,2,0
94338,4,2,329307,329307,329309,0,2,2
94339,2,1,329309,329309,329310,0,1,0
94340,3,1,329312,329312,329313,0,1,2
94341,4,2,329316,329316,329318,0,2,3
94342,2,3,329318,329318,329321,0,3,0
94343,4,3,329322,329322,329325,0,3,1
94344,2,1,329324,329325,329326,1,2,0
94345,3,2,329327,329327,329329,0,2,1
94346,3,2,329330,329330,329332,0,2,1
94347,4,3,329334,329334,329337,0,3,2
94348,2,3,329336,329337,329340,1,4,0
94349,3,3,329339,329340,329343,1,4,0
94350,5,1,329344,329344,329345,0,1,1
94351,2,2,329346,329346,329348,0,2,1
94352,1,3,329347,329348,329351,1,4,0
94353,6,3,329353,329353,329356,0,3,2
94354,5,1,329358,329358,329359,0,1,2
94355,3,1,329361,329361,329362,0,1,2
94356,5,3,329366,329366,329369,0,3,4
94357,2,2,329368,329369,329371,1,3,0
94358,2,2,329370,329371,329373,1,3,0
94359,2,2,329372,329373,329375,1,3,0
94360,5,1,329377,329377,329378,0,1,2
94361,5,3,329382,329382,329385,0,3,4
94362,5,3,329387,329387,329390,0,3,2
94363,4,2,329391,329391,329393,0,2,1
94364,1,2,329392,329393,329395,1,3,0
94365,2,2,329394,329395,329397,1,3,0
94366,3,1,329397,329397,329398,0,1,0
94367,6,1,329403,329403,329404,0,1,5
94368,1,2,329404,329404,329406,0,2,0
94369,1,2,329405,329406,329408,1,3,0
94370,6,3,329411,329411,329414,0,3,3
94371,1,2,329412,329414,329416,2,4,0
94372,5,2,329417,329417,329419,0,2,1
94373,1,1,329418,329419,329420,1,2,0
94374,1,1,329419,329420,329421,1,2,0
94375,4,3,329423,329423,329426,0,3,2
94376,2,2,329425,329426,329428,1,3,0
94377,1,2,329426,329428,329430,2,4,0
94378,2,1,329428,329430,329431,2,3,0
94379,6,1,329434,329434,329435,0,1,3
94380,4,1,329438,329438,329439,0,1,3
94381,4,1,329442,329442,329443,0,1,3
94382,5,2,329447,329447,329449,0,2,4
94383,6,2,329453,329453,329455,0,2,4
94384,6,1,329459,329459,329460,0,1,4
94385,6,3,329465,329465,329468,0,3,5
94386,4,1,329469,329469,329470,0,1,1
94387,4,3,329473,329473,329476,0,3,3
94388,2,1,329475,329476,329477,1,2,0
94389,5,2,329480,329480,329482,0,2,3
94390,1,1,329481,329482,329483,1,2,0
94391,2,1,329483,329483,329484,0,1,0
94392,3,1,329486,329486,329487,0,1,2
94393,6,3,329492,329492,329495,0,3,5
94394,4,2,329496,329496,329498,0,2,1
94395,3,2,329499,329499,329501,0,2,1
94396,3,1,329502,329502,329503,0,1,1
94397,4,2,329506,329506,329508,0,2,3
94398,5,1,329511,329511,329512,0,1,3
94399,1,3,329512,329512,329515,0,3,0
94400,1,3,329513,329515,329518,2,5,0
94401,6,1,329519,329519,329520,0,1,1
94402,4,3,329523,329523,329526,0,3,3
94403,1,1,329524,329526,329527,2,3,0
94404,1,2,329525,329527,329529,2,4,0
94405,1,2,329526,329529,329531,3,5,0
94406,1,1,329527,329531,329532,4,5,0
94407,1,1,329528,329532,329533,4,5,0
94408,6,1,329534,329534,329535,0,1,1
94409,4,3,329538,329538,329541,0,3,3
94410,5,3,329543,329543,329546,0,3,2
94411,3,2,329546,329546,329548,0,2,0
94412,4,3,329550,329550,329553,0,3,2
94413,6,2,329556,329556,329558,0,2,3
94414,5,2,329561,329561,329563,0,2,3
94415,4,2,329565,329565,329567,0,2,2
94416,4,3,329569,329569,329572,0,3,2
94417,3,1,329572,329572,329573,0,1,0
94418,5,2,329577,329577,329579,0,2,4
94419,4,1,329581,329581,329582,0,1,2
94420,5,3,329586,329586,329589,0,3,4
94421,3,3,329589,329589,329592,0,3,0
94422,2,3,329591,329592,329595,1,4,0
94423,6,2,329597,329597,329599,0,2,2
94424,1,1,329598,329599,329600,1,2,0
94425,2,1,329600,329600,329601,0,1,0
94426,4,3,329604,329604,329607,0,3,3
94427,4,3,329608,329608,329611,0,3,1
94428,1,3,329609,329611,329614,2,5,0
94429,3,2,329612,329614,329616,2,4,0
94430,3,2,329615,329616,329618,1,3,0
94431,2,3,329617,329618,329621,1,4,0
94432,1,2,329618,329621,329623,3,5,0
94433,5,2,329623,329623,329625,0,2,0
94434,2,3,329625,329625,329628,0,3,0
94435,4,1,329629,329629,329630,0,1,1
94436,5,3,329634,329634,329637,0,3,4
94437,2,3,329636,329637,329640,1,4,0
94438,5,3,329641,329641,329644,0,3,1
94439,2,1,329643,329644,329645,1,2,0
94440,5,2,329648,329648,329650,0,2,3
94441,2,1,329650,329650,329651,0,1,0
94442,1,1,329651,329651,329652,0,1,0
94443,5,3,329656,329656,329659,0,3,4
94444,5,2,329661,329661,329663,0,2,2
94445,5,3,329666,329666,329669,0,3,3
94446,5,1,329671,329671,329672,0,1,2
94447,3,3,329674,329674,329677,0,3,2
94448,6,2,329680,329680,329682,0,2,3
94449,5,2,329685,329685,329687,0,2,3
94450,4,3,329689,329689,329692,0,3,2
94451,1,2,329690,329692,329694,2,4,0
94452,6,2,329696,329696,329698,0,2,2
94453,3,1,329699,329699,329700,0,1,1
94454,1,1,329700,329700,329701,0,1,0
94455,3,2,329703,329703,329705,0,2,2
94456,1,2,329704,329705,329707,1,3,0
94457,2,2,329706,329707,329709,1,3,0
94458,3,2,329709,329709,329711,0,2,0
94459,5,2,329714,329714,329716,0,2,3
94460,2,2,329716,329716,329718,0,2,0
94461,6,3,329722,329722,329725,0,3,4
94462,3,2,329725,329725,329727,0,2,0
94463,4,1,329729,329729,329730,0,1,2
94464,6,1,329735,329735,329736,0,1,5
94465,4,3,329739,329739,329742,0,3,3
94466,6,3,329745,329745,329748,0,3,3
94467,6,3,329751,329751,329754,0,3,3
94468,4,2,329755,329755,329757,0,2,1
94469,5,1,329760,329760,329761,0,1,3
94470,2,3,329762,329762,329765,0,3,1
94471,3,1,329765,329765,329766,0,1,0
94472,6,1,329771,329771,329772,0,1,5
94473,3,1,329774,329774,329775,0,1,2
94474,6,1,329780,329780,329781,0,1,5
94475,6,3,329786,329786,329789,0,3,5
94476,4,3,329790,329790,329793,0,3,1
94477,5,3,329795,329795,329798,0,3,2
94478,2,1,329797,329798,329799,1,2,0
94479,6,2,329803,329803,329805,0,2,4
94480,5,1,329808,329808,329809,0,1,3
94481,5,1,329813,329813,329814,0,1,4
94482,1,3,329814,329814,329817,0,3,0
94483,1,3,329815,329817,329820,2,5,0
94484,4,2,329819,329820,329822,1,3,0
94485,2,3,329821,329822,329825,1,4,0
94486,4,3,329825,329825,329828,0,3,0
94487,4,1,329829,329829,329830,0,1,1
94488,2,2,329831,329831,329833,0,2,1
94489,3,2,329834,329834,329836,0,2,1
94490,1,3,329835,329836,329839,1,4,0
94491,3,2,329838,329839,329841,1,3,0
94492,2,1,329840,329841,329842,1,2,0
94493,4,3,329844,329844,329847,0,3,2
94494,4,3,329848,329848,329851,0,3,1
94495,3,3,329851,329851,329854,0,3,0
94496,1,3,329852,329854,329857,2,5,0
94497,2,1,329854,329857,329858,3,4,0
94498,4,3,329858,329858,329861,0,3,0
94499,1,3,329859,329861,329864,2,5,0
94500,3,1,329862,329864,329865,2,3,0
94501,3,3,329865,329865,329868,0,3,0
94502,5,3,329870,329870,329873,0,3,2
94503,1,3,329871,329873,329876,2,5,0
94504,5,3,329876,329876,329879,0,3,0
94505,6,2,329882,329882,329884,0,2,3
94506,4,1,329886,329886,329887,0,1,2
94507,2,3,329888,329888,329891,0,3,1
94508,4,1,329892,329892,329893,0,1,1
94509,5,2,329897,329897,329899,0,2,4
94510,1,3,329898,329899,329902,1,4,0
94511,1,3,329899,329902,329905,3,6,0
94512,2,2,329901,329905,329907,4,6,0
94513,1,2,329902,329907,329909,5,7,0
94514,3,2,329905,329909,329911,4,6,0
94515,1,1,329906,329911,329912,5,6,0
94516,6,1,329912,329912,329913,0,1,0
94517,2,2,329914,329914,329916,0,2,1
94518,1,1,329915,329916,329917,1,2,0
94519,2,1,329917,329917,329918,0,1,0
94520,1,1,329918,329918,329919,0,1,0
94521,5,2,329923,329923,329925,0,2,4
94522,1,3,329924,329925,329928,1,4,0
94523,1,2,329925,329928,329930,3,5,0
94524,3,3,329928,329930,329933,2,5,0
94525,1,2,329929,329933,329935,4,6,0
94526,3,2,329932,329935,329937,3,5,0
94527,1,2,329933,329937,329939,4,6,0
94528,2,2,329935,329939,329941,4,6,0
94529,4,2,329939,329941,329943,2,4,0
94530,5,1,329944,329944,329945,0,1,1
94531,3,3,329947,329947,329950,0,3,2
94532,4,3,329951,329951,329954,0,3,1
94533,4,3,329955,329955,329958,0,3,1
94534,3,2,329958,329958,329960,0,2,0
94535,4,3,329962,329962,329965,0,3,2
94536,3,1,329965,329965,329966,0,1,0
94537,1,2,329966,329966,329968,0,2,0
94538,4,2,329970,329970,329972,0,2,2
94539,1,2,329971,329972,329974,1,3,0
94540,4,2,329975,329975,329977,0,2,1
94541,3,2,329978,329978,329980,0,2,1
94542,4,3,329982,329982,329985,0,3,2
94543,1,2,329983,329985,329987,2,4,0
94544,6,2,329989,329989,329991,0,2,2
94545,6,1,329995,329995,329996,0,1,4
94546,1,3,329996,329996,329999,0,3,0
94547,1,3,329997,329999,330002,2,5,0
94548,3,1,330000,330002,330003,2,3,0
94549,2,3,330002,330003,330006,1,4,0
94550,2,3,330004,330006,330009,2,5,0
94551,4,3,330008,330009,330012,1,4,0
94552,6,3,330014,330014,330017,0,3,2
94553,6,3,330020,330020,330023,0,3,3
94554,3,1,330023,330023,330024,0,1,0
94555,1,1,330024,330024,330025,0,1,0
94556,5,2,330029,330029,330031,0,2,4
94557,4,3,330033,330033,330036,0,3,2
94558,6,3,330039,330039,330042,0,3,3
94559,3,2,330042,330042,330044,0,2,0
94560,2,2,330044,330044,330046,0,2,0
94561,2,1,330046,330046,330047,0,1,0
94562,1,1,330047,330047,330048,0,1,0
94563,3,3,330050,330050,330053,0,3,2
94564,6,2,330056,330056,330058,0,2,3
94565,4,2,330060,330060,330062,0,2,2
94566,4,2,330064,330064,330066,0,2,2
94567,3,1,330067,330067,330068,0,1,1
94568,2,2,330069,330069,330071,0,2,1
94569,6,2,330075,330075,330077,0,2,4
94570,6,3,330081,330081,330084,0,3,4
94571,3,1,330084,330084,330085,0,1,0
94572,1,1,330085,330085,330086,0,1,0
94573,1,3,330086,330086,330089,0,3,0
94574,6,3,330092,330092,330095,0,3,3
94575,5,3,330097,330097,330100,0,3,2
94576,5,2,330102,330102,330104,0,2,2
94577,1,1,330103,330104,330105,1,2,0
94578,4,3,330107,330107,330110,0,3,2
94579,3,2,330110,330110,330112,0,2,0
94580,6,2,330116,330116,330118,0,2,4
94581,1,3,330117,330118,330121,1,4,0
94582,5,3,330122,330122,330125,0,3,1
94583,3,3,330125,330125,330128,0,3,0
94584,3,1,330128,330128,330129,0,1,0
94585,4,2,330132,330132,330134,0,2,3
94586,4,2,330136,330136,330138,0,2,2
94587,3,2,330139,330139,330141,0,2,1
94588,2,3,330141,330141,330144,0,3,0
94589,5,1,330146,330146,330147,0,1,2
94590,5,2,330151,330151,330153,0,2,4
94591,2,1,330153,330153,330154,0,1,0
94592,3,1,330156,330156,330157,0,1,2
94593,6,3,330162,330162,330165,0,3,5
94594,6,2,330168,330168,330170,0,2,3
94595,3,2,330171,330171,330173,0,2,1
94596,5,2,330176,330176,330178,0,2,3
94597,2,3,330178,330178,330181,0,3,0
94598,1,1,330179,330181,330182,2,3,0
94599,2,2,330181,330182,330184,1,3,0
94600,6,3,330187,330187,330190,0,3,3
94601,6,2,330193,330193,330195,0,2,3
94602,6,1,330199,330199,330200,0,1,4
94603,5,3,330204,330204,330207,0,3,4
94604,4,2,330208,330208,330210,0,2,1
94605,6,3,330214,330214,330217,0,3,4
94606,3,3,330217,330217,330220,0,3,0
94607,1,2,330218,330220,330222,2,4,0
94608,4,1,330222,330222,330223,0,1,0
94609,6,3,330228,330228,330231,0,3,5
94610,5,2,330233,330233,330235,0,2,2
94611,2,2,330235,330235,330237,0,2,0
94612,4,2,330239,330239,330241,0,2,2
94613,6,2,330245,330245,330247,0,2,4
94614,2,3,330247,330247,330250,0,3,0
94615,6,3,330253,330253,330256,0,3,3
94616,5,3,330258,330258,330261,0,3,2
94617,5,2,330263,330263,330265,0,2,2
94618,3,2,330266,330266,330268,0,2,1
94619,6,2,330272,330272,330274,0,2,4
94620,4,3,330276,330276,330279,0,3,2
94621,1,1,330277,330279,330280,2,3,0
94622,1,3,330278,330280,330283,2,5,0
94623,2,2,330280,330283,330285,3,5,0
94624,4,2,330284,330285,330287,1,3,0
94625,4,1,330288,330288,330289,0,1,1
94626,4,2,330292,330292,330294,0,2,3
94627,3,1,330295,330295,330296,0,1,1
94628,2,2,330297,330297,330299,0,2,1
94629,6,3,330303,330303,330306,0,3,4
94630,4,2,330307,330307,330309,0,2,1
94631,6,1,330313,330313,330314,0,1,4
94632,3,2,330316,330316,330318,0,2,2
94633,1,2,330317,330318,330320,1,3,0
94634,5,3,330322,330322,330325,0,3,2
94635,2,1,330324,330325,330326,1,2,0
94636,6,2,330330,330330,330332,0,2,4
94637,6,3,330336,330336,330339,0,3,4
94638,4,3,330340,330340,330343,0,3,1
94639,2,3,330342,330343,330346,1,4,0
94640,4,3,330346,330346,330349,0,3,0
94641,3,1,330349,330349,330350,0,1,0
94642,3,3,330352,330352,330355,0,3,2
94643,1,3,330353,330355,330358,2,5,0
94644,4,3,330357,330358,330361,1,4,0
94645,6,1,330363,330363,330364,0,1,2
94646,1,1,330364,330364,330365,0,1,0
94647,4,1,330368,330368,330369,0,1,3
94648,4,3,330372,330372,330375,0,3,3
94649,6,1,330378,330378,330379,0,1,3
94650,6,3,330384,330384,330387,0,3,5
94651,2,3,330386,330387,330390,1,4,0
94652,4,3,330390,330390,330393,0,3,0
94653,4,1,330394,330394,330395,0,1,1
94654,5,3,330399,330399,330402,0,3,4
94655,2,2,330401,330402,330404,1,3,0
94656,5,1,330406,330406,330407,0,1,2
94657,4,2,330410,330410,330412,0,2,3
94658,5,2,330415,330415,330417,0,2,3
94659,6,2,330421,330421,330423,0,2,4
94660,5,1,330426,330426,330427,0,1,3
94661,6,1,330432,330432,330433,0,1,5
94662,1,3,330433,330433,330436,0,3,0
94663,5,1,330438,330438,330439,0,1,2
94664,6,1,330444,330444,330445,0,1,5
94665,5,1,330449,330449,330450,0,1,4
94666,2,2,330451,330451,330453,0,2,1
94667,5,2,330456,330456,330458,0,2,3
94668,5,1,330461,330461,330462,0,1,3
94669,3,1,330464,330464,330465,0,1,2
94670,6,1,330470,330470,330471,0,1,5
94671,4,2,330474,330474,330476,0,2,3
94672,5,2,330479,330479,330481,0,2,3
94673,2,3,330481,330481,330484,0,3,0
94674,6,1,330487,330487,330488,0,1,3
94675,1,3,330488,330488,330491,0,3,0
94676,6,3,330494,330494,330497,0,3,3
94677,4,2,330498,330498,330500,0,2,1
94678,1,3,330499,330500,330503,1,4,0
94679,5,1,330504,330504,330505,0,1,1
94680,5,3,330509,330509,330512,0,3,4
94681,5,3,330514,330514,330517,0,3,2
94682,6,2,330520,330520,330522,0,2,3
94683,1,3,330521,330522,330525,1,4,0
94684,3,2,330524,330525,330527,1,3,0
94685,5,3,330529,330529,330532,0,3,2
94686,3,3,330532,330532,330535,0,3,0
94687,4,3,330536,330536,330539,0,3,1
94688,1,2,330537,330539,330541,2,4,0
94689,3,1,330540,330541,330542,1,2,0
94690,1,2,330541,330542,330544,1,3,0
94691,2,3,330543,330544,330547,1,4,0
94692,3,3,330546,330547,330550,1,4,0
94693,3,1,330549,330550,330551,1,2,0
94694,5,3,330554,330554,330557,0,3,3
94695,2,2,330556,330557,330559,1,3,0
94696,2,3,330558,330559,330562,1,4,0
94697,5,1,330563,330563,330564,0,1,1
94698,4,2,330567,330567,330569,0,2,3
94699,6,1,330573,330573,330574,0,1,4
94700,1,1,330574,330574,330575,0,1,0
94701,4,3,330578,330578,330581,0,3,3
94702,1,1,330579,330581,330582,2,3,0
94703,3,1,330582,330582,330583,0,1,0
94704,3,2,330585,330585,330587,0,2,2
94705,3,3,330588,330588,330591,0,3,1
94706,6,1,330594,330594,330595,0,1,3
94707,5,3,330599,330599,330602,0,3,4
94708,5,3,330604,330604,330607,0,3,2
94709,5,1,330609,330609,330610,0,1,2
94710,6,3,330615,330615,330618,0,3,5
94711,1,2,330616,330618,330620,2,4,0
94712,5,1,330621,330621,330622,0,1,1
94713,1,1,330622,330622,330623,0,1,0
94714,5,2,330627,330627,330629,0,2,4
94715,4,1,330631,330631,330632,0,1,2
94716,5,2,330636,330636,330638,0,2,4
94717,1,2,330637,330638,330640,1,3,0
94718,2,1,330639,330640,330641,1,2,0
94719,3,1,330642,330642,330643,0,1,1
94720,5,3,330647,330647,330650,0,3,4
94721,3,3,330650,330650,330653,0,3,0
94722,6,1,330656,330656,330657,0,1,3
94723,6,2,330662,330662,330664,0,2,5
94724,1,1,330663,330664,330665,1,2,0
94725,6,3,330669,330669,330672,0,3,4
94726,2,3,330671,330672,330675,1,4,0
94727,4,3,330675,330675,330678,0,3,0
94728,2,2,330677,330678,330680,1,3,0
94729,5,3,330682,330682,330685,0,3,2
94730,3,3,330685,330685,330688,0,3,0
94731,2,3,330687,330688,330691,1,4,0
94732,3,2,330690,330691,330693,1,3,0
94733,2,2,330692,330693,330695,1,3,0
94734,5,2,330697,330697,330699,0,2,2
94735,1,3,330698,330699,330702,1,4,0
94736,3,3,330701,330702,330705,1,4,0
94737,1,2,330702,330705,330707,3,5,0
94738,1,3,330703,330707,330710,4,7,0
94739,2,1,330705,330710,330711,5,6,0
94740,1,3,330706,330711,330714,5,8,0
94741,3,3,330709,330714,330717,5,8,0
94742,3,1,330712,330717,330718,5,6,0
94743,5,2,330717,330718,330720,1,3,0
94744,1,1,330718,330720,330721,2,3,0
94745,3,2,330721,330721,330723,0,2,0
94746,4,2,330725,330725,330727,0,2,2
94747,4,2,330729,330729,330731,0,2,2
94748,6,2,330735,330735,330737,0,2,4
94749,6,2,330741,330741,330743,0,2,4
94750,4,2,330745,330745,330747,0,2,2
94751,5,3,330750,330750,330753,0,3,3
94752,6,2,330756,330756,330758,0,2,3
94753,2,3,330758,330758,330761,0,3,0
94754,2,2,330760,330761,330763,1,3,0
94755,1,2,330761,330763,330765,2,4,0
94756,3,1,330764,330765,330766,1,2,0
94757,1,2,330765,330766,330768,1,3,0
94758,6,1,330771,330771,330772,0,1,3
94759,6,3,330777,330777,330780,0,3,5
94760,4,3,330781,330781,330784,0,3,1
94761,2,1,330783,330784,330785,1,2,0
94762,5,1,330788,330788,330789,0,1,3
94763,5,2,330793,330793,330795,0,2,4
94764,3,1,330796,330796,330797,0,1,1
94765,5,3,330801,330801,330804,0,3,4
94766,5,3,330806,330806,330809,0,3,2
94767,6,2,330812,330812,330814,0,2,3
94768,5,2,330817,330817,330819,0,2,3
94769,4,2,330821,330821,330823,0,2,2
94770,2,1,330823,330823,330824,0,1,0
94771,4,1,330827,330827,330828,0,1,3
94772,1,3,330828,330828,330831,0,3,0
94773,4,2,330832,330832,330834,0,2,1
94774,6,1,330838,330838,330839,0,1,4
94775,2,1,330840,330840,330841,0,1,1
94776,6,3,330846,330846,330849,0,3,5
94777,3,3,330849,330849,330852,0,3,0
94778,2,2,330851,330852,330854,1,3,0
94779,3,2,330854,330854,330856,0,2,0
94780,5,3,330859,330859,330862,0,3,3
94781,2,1,330861,330862,330863,1,2,0
94782,4,1,330865,330865,330866,0,1,2
94783,1,3,330866,330866,330869,0,3,0
94784,3,1,330869,330869,330870,0,1,0
94785,1,1,330870,330870,330871,0,1,0
94786,1,1,330871,330871,330872,0,1,0
94787,3,3,330874,330874,330877,0,3,2
94788,2,1,330876,330877,330878,1,2,0
94789,5,2,330881,330881,330883,0,2,3
94790,5,3,330886,330886,330889,0,3,3
94791,1,1,330887,330889,330890,2,3,0
94792,3,1,330890,330890,330891,0,1,0
94793,5,2,330895,330895,330897,0,2,4
94794,3,2,330898,330898,330900,0,2,1
94795,4,3,330902,330902,330905,0,3,2
94796,3,3,330905,330905,330908,0,3,0
94797,6,1,330911,330911,330912,0,1,3
94798,6,2,330917,330917,330919,0,2,5
94799,6,3,330923,330923,330926,0,3,4
94800,6,3,330929,330929,330932,0,3,3
94801,2,1,330931,330932,330933,1,2,0
94802,3,1,330934,330934,330935,0,1,1
94803,1,2,330935,330935,330937,0,2,0
94804,3,2,330938,330938,330940,0,2,1
94805,4,1,330942,330942,330943,0,1,2
94806,2,2,330944,330944,330946,0,2,1
94807,2,2,330946,330946,330948,0,2,0
94808,1,2,330947,330948,330950,1,3,0
94809,4,2,330951,330951,330953,0,2,1
94810,5,2,330956,330956,330958,0,2,3
94811,3,3,330959,330959,330962,0,3,1
94812,6,2,330965,330965,330967,0,2,3
94813,5,1,330970,330970,330971,0,1,3
94814,6,3,330976,330976,330979,0,3,5
94815,5,3,330981,330981,330984,0,3,2
94816,3,2,330984,330984,330986,0,2,0
94817,1,1,330985,330986,330987,1,2,0
94818,4,1,330989,330989,330990,0,1,2
94819,4,2,330993,330993,330995,0,2,3
94820,1,1,330994,330995,330996,1,2,0
94821,3,1,330997,330997,330998,0,1,1
94822,6,1,331003,331003,331004,0,1,5
94823,2,3,331005,331005,331008,0,3,1
94824,4,3,331009,331009,331012,0,3,1
94825,1,3,331010,331012,331015,2,5,0
94826,5,2,331015,331015,331017,0,2,0
94827,6,2,331021,331021,331023,0,2,4
94828,6,3,331027,331027,331030,0,3,4
94829,4,2,331031,331031,331033,0,2,1
94830,4,2,331035,331035,331037,0,2,2
94831,3,2,331038,331038,331040,0,2,1
94832,2,2,331040,331040,331042,0,2,0
94833,6,2,331046,331046,331048,0,2,4
94834,6,1,331052,331052,331053,0,1,4
94835,1,1,331053,331053,331054,0,1,0
94836,3,1,331056,331056,331057,0,1,2
94837,2,1,331058,331058,331059,0,1,1
94838,5,1,331063,331063,331064,0,1,4
94839,3,3,331066,331066,331069,0,3,2
94840,1,1,331067,331069,331070,2,3,0
94841,6,2,331073,331073,331075,0,2,3
94842,5,2,331078,331078,331080,0,2,3
94843,1,2,331079,331080,331082,1,3,0
94844,4,2,331083,331083,331085,0,2,1
94845,3,1,331086,331086,331087,0,1,1
94846,1,3,331087,331087,331090,0,3,0
94847,2,3,331089,331090,331093,1,4,0
94848,1,2,331090,331093,331095,3,5,0
94849,6,2,331096,331096,331098,0,2,1
94850,1,3,331097,331098,331101,1,4,0
94851,4,2,331101,331101,331103,0,2,0
94852,1,1,331102,331103,331104,1,2,0
94853,2,3,331104,331104,331107,0,3,0
94854,1,1,331105,331107,331108,2,3,0
94855,6,3,331111,331111,331114,0,3,3
94856,6,2,331117,331117,331119,0,2,3
94857,1,3,331118,331119,331122,1,4,0
94858,4,1,331122,331122,331123,0,1,0
94859,2,3,331124,331124,331127,0,3,1
94860,6,3,331130,331130,331133,0,3,3
94861,4,1,331134,331134,331135,0,1,1
94862,6,2,331140,331140,331142,0,2,5
94863,1,2,331141,331142,331144,1,3,0
94864,4,2,331145,331145,331147,0,2,1
94865,5,1,331150,331150,331151,0,1,3
94866,2,2,331152,331152,331154,0,2,1
94867,5,1,331157,331157,331158,0,1,3
94868,1,1,331158,331158,331159,0,1,0
94869,4,2,331162,331162,331164,0,2,3
94870,3,2,331165,331165,331167,0,2,1
94871,1,1,331166,331167,331168,1,2,0
94872,6,1,331172,331172,331173,0,1,4
94873,4,2,331176,331176,331178,0,2,3
94874,4,2,331180,331180,331182,0,2,2
94875,4,2,331184,331184,331186,0,2,2
94876,3,3,331187,331187,331190,0,3,1
94877,6,2,331193,331193,331195,0,2,3
94878,5,2,331198,331198,331200,0,2,3
94879,5,1,331203,331203,331204,0,1,3
94880,1,1,331204,331204,331205,0,1,0
94881,3,1,331207,331207,331208,0,1,2
94882,4,2,331211,331211,331213,0,2,3
94883,5,3,331216,331216,331219,0,3,3
94884,6,1,331222,331222,331223,0,1,3
94885,2,1,331224,331224,331225,0,1,1
94886,1,3,331225,331225,331228,0,3,0
94887,6,1,331231,331231,331232,0,1,3
94888,4,3,331235,331235,331238,0,3,3
94889,1,3,331236,331238,331241,2,5,0
94890,5,3,331241,331241,331244,0,3,0
94891,6,3,331247,331247,331250,0,3,3
94892,5,2,331252,331252,331254,0,2,2
94893,5,2,331257,331257,331259,0,2,3
94894,5,1,331262,331262,331263,0,1,3
94895,4,1,331266,331266,331267,0,1,3
94896,1,3,331267,331267,331270,0,3,0
94897,4,3,331271,331271,331274,0,3,1
94898,2,2,331273,331274,331276,1,3,0
94899,2,2,331275,331276,331278,1,3,0
94900,3,1,331278,331278,331279,0,1,0
94901,1,2,331279,331279,331281,0,2,0
94902,6,1,331285,331285,331286,0,1,4
94903,5,3,331290,331290,331293,0,3,4
94904,2,1,331292,331293,331294,1,2,0
94905,6,2,331298,331298,331300,0,2,4
94906,3,3,331301,331301,331304,0,3,1
94907,4,3,331305,331305,331308,0,3,1
94908,5,2,331310,331310,331312,0,2,2
94909,1,3,331311,331312,331315,1,4,0
94910,2,1,331313,331315,331316,2,3,0
94911,3,1,331316,331316,331317,0,1,0
94912,1,1,331317,331317,331318,0,1,0
94913,1,3,331318,331318,331321,0,3,0
94914,6,1,331324,331324,331325,0,1,3
94915,5,1,331329,331329,331330,0,1,4
94916,4,1,331333,331333,331334,0,1,3
94917,3,3,331336,331336,331339,0,3,2
94918,4,1,331340,331340,331341,0,1,1
94919,3,3,331343,331343,331346,0,3,2
94920,5,3,331348,331348,331351,0,3,2
94921,2,3,331350,331351,331354,1,4,0
94922,6,2,331356,331356,331358,0,2,2
94923,5,2,331361,331361,331363,0,2,3
94924,5,1,331366,331366,331367,0,1,3
94925,3,2,331369,331369,331371,0,2,2
94926,1,1,331370,331371,331372,1,2,0
94927,6,2,331376,331376,331378,0,2,4
94928,3,3,331379,331379,331382,0,3,1
94929,1,2,331380,331382,331384,2,4,0
94930,2,3,331382,331384,331387,2,5,0
94931,2,3,331384,331387,331390,3,6,0
94932,5,1,331389,331390,331391,1,2,0
94933,1,3,331390,331391,331394,1,4,0
94934,5,1,331395,331395,331396,0,1,1
94935,2,1,331397,331397,331398,0,1,1
94936,2,2,331399,331399,331401,0,2,1
94937,3,1,331402,331402,331403,0,1,1
94938,6,2,331408,331408,331410,0,2,5
94939,1,1,331409,331410,331411,1,2,0
94940,1,1,331410,331411,331412,1,2,0
94941,6,1,331416,331416,331417,0,1,4
94942,6,1,331422,331422,331423,0,1,5
94943,1,2,331423,331423,331425,0,2,0
94944,3,3,331426,331426,331429,0,3,1
94945,5,3,331431,331431,331434,0,3,2
94946,6,3,331437,331437,331440,0,3,3
94947,4,2,331441,331441,331443,0,2,1
94948,2,1,331443,331443,331444,0,1,0
94949,4,3,331447,331447,331450,0,3,3
94950,5,3,331452,331452,331455,0,3,2
94951,4,3,331456,331456,331459,0,3,1
94952,1,2,331457,331459,331461,2,4,0
94953,1,3,331458,331461,331464,3,6,0
94954,6,1,331464,331464,331465,0,1,0
94955,5,3,331469,331469,331472,0,3,4
94956,4,1,331473,331473,331474,0,1,1
94957,1,3,331474,331474,331477,0,3,0
94958,2,3,331476,331477,331480,1,4,0
94959,4,2,331480,331480,331482,0,2,0
94960,1,2,331481,331482,331484,1,3,0
94961,6,2,331487,331487,331489,0,2,3
94962,5,2,331492,331492,331494,0,2,3
94963,4,1,331496,331496,331497,0,1,2
94964,1,2,331497,331497,331499,0,2,0
94965,5,2,331502,331502,331504,0,2,3
94966,1,1,331503,331504,331505,1,2,0
94967,6,2,331509,331509,331511,0,2,4
94968,4,3,331513,331513,331516,0,3,2
94969,6,1,331519,331519,331520,0,1,3
94970,3,1,331522,331522,331523,0,1,2
94971,5,1,331527,331527,331528,0,1,4
94972,4,2,331531,331531,331533,0,2,3
94973,2,2,331533,331533,331535,0,2,0
94974,1,1,331534,331535,331536,1,2,0
94975,2,3,331536,331536,331539,0,3,0
94976,2,3,331538,331539,331542,1,4,0
94977,4,1,331542,331542,331543,0,1,0
94978,4,1,331546,331546,331547,0,1,3
94979,2,1,331548,331548,331549,0,1,1
94980,4,1,331552,331552,331553,0,1,3
94981,6,3,331558,331558,331561,0,3,5
94982,2,3,331560,331561,331564,1,4,0
94983,4,2,331564,331564,331566,0,2,0
94984,1,2,331565,331566,331568,1,3,0
94985,4,1,331569,331569,331570,0,1,1
94986,4,1,331573,331573,331574,0,1,3
94987,4,3,331577,331577,331580,0,3,3
94988,5,3,331582,331582,331585,0,3,2
94989,5,2,331587,331587,331589,0,2,2
94990,2,3,331589,331589,331592,0,3,0
94991,3,3,331592,331592,331595,0,3,0
94992,2,3,331594,331595,331598,1,4,0
94993,6,2,331600,331600,331602,0,2,2
94994,4,3,331604,331604,331607,0,3,2
94995,4,3,331608,331608,331611,0,3,1
94996,6,2,331614,331614,331616,0,2,3
94997,3,3,331617,331617,331620,0,3,1
94998,4,3,331621,331621,331624,0,3,1
94999,5,3,331626,331626,331629,0,3,2
95000,4,1,331630,331630,331631,0,1,1
95001,3,1,331633,331633,331634,0,1,2
95002,3,3,331636,331636,331639,0,3,2
95003,3,1,331639,331639,331640,0,1,0
95004,4,3,331643,331643,331646,0,3,3
95005,1,3,331644,331646,331649,2,5,0
95006,4,2,331648,331649,331651,1,3,0
95007,5,3,331653,331653,331656,0,3,2
95008,2,3,331655,331656,331659,1,4,0
95009,3,3,331658,331659,331662,1,4,0
95010,1,2,331659,331662,331664,3,5,0
95011,5,3,331664,331664,331667,0,3,0
95012,2,3,331666,331667,331670,1,4,0
95013,2,1,331668,331670,331671,2,3,0
95014,4,2,331672,331672,331674,0,2,1
95015,5,1,331677,331677,331678,0,1,3
95016,3,2,331680,331680,331682,0,2,2
95017,1,2,331681,331682,331684,1,3,0
95018,2,2,331683,331684,331686,1,3,0
95019,5,2,331688,331688,331690,0,2,2
95020,5,3,331693,331693,331696,0,3,3
95021,3,1,331696,331696,331697,0,1,0
95022,1,3,331697,331697,331700,0,3,0
95023,2,2,331699,331700,331702,1,3,0
95024,3,3,331702,331702,331705,0,3,0
95025,1,2,331703,331705,331707,2,4,0
95026,1,3,331704,331707,331710,3,6,0
95027,5,1,331709,331710,331711,1,2,0
95028,4,3,331713,331713,331716,0,3,2
95029,2,3,331715,331716,331719,1,4,0
95030,1,3,331716,331719,331722,3,6,0
95031,5,1,331721,331722,331723,1,2,0
95032,6,1,331727,331727,331728,0,1,4
95033,3,2,331730,331730,331732,0,2,2
95034,3,2,331733,331733,331735,0,2,1
95035,5,3,331738,331738,331741,0,3,3
95036,4,3,331742,331742,331745,0,3,1
95037,1,2,331743,331745,331747,2,4,0
95038,3,1,331746,331747,331748,1,2,0
95039,4,2,331750,331750,331752,0,2,2
95040,6,2,331756,331756,331758,0,2,4
95041,2,2,331758,331758,331760,0,2,0
95042,4,1,331762,331762,331763,0,1,2
95043,3,2,331765,331765,331767,0,2,2
95044,2,1,331767,331767,331768,0,1,0
95045,5,2,331772,331772,331774,0,2,4
95046,6,1,331778,331778,331779,0,1,4
95047,1,2,331779,331779,331781,0,2,0
95048,2,3,331781,331781,331784,0,3,0
95049,1,1,331782,331784,331785,2,3,0
95050,3,2,331785,331785,331787,0,2,0
95051,6,1,331791,331791,331792,0,1,4
95052,3,2,331794,331794,331796,0,2,2
95053,3,2,331797,331797,331799,0,2,1
95054,5,3,331802,331802,331805,0,3,3
95055,4,2,331806,331806,331808,0,2,1
95056,5,2,331811,331811,331813,0,2,3
95057,3,3,331814,331814,331817,0,3,1
95058,4,1,331818,331818,331819,0,1,1
95059,2,1,331820,331820,331821,0,1,1
95060,1,2,331821,331821,331823,0,2,0
95061,4,1,331825,331825,331826,0,1,2
95062,2,2,331827,331827,331829,0,2,1
95063,2,2,331829,331829,331831,0,2,0
95064,5,1,331834,331834,331835,0,1,3
95065,1,1,331835,331835,331836,0,1,0
95066,2,1,331837,331837,331838,0,1,1
95067,2,1,331839,331839,331840,0,1,1
95068,5,2,331844,331844,331846,0,2,4
95069,4,1,331848,331848,331849,0,1,2
95070,6,1,331854,331854,331855,0,1,5
95071,6,3,331860,331860,331863,0,3,5
95072,5,3,331865,331865,331868,0,3,2
95073,1,1,331866,331868,331869,2,3,0
95074,6,1,331872,331872,331873,0,1,3
95075,3,2,331875,331875,331877,0,2,2
95076,4,1,331879,331879,331880,0,1,2
95077,1,3,331880,331880,331883,0,3,0
95078,2,1,331882,331883,331884,1,2,0
95079,1,1,331883,331884,331885,1,2,0
95080,3,2,331886,331886,331888,0,2,1
95081,2,2,331888,331888,331890,0,2,0
95082,3,2,331891,331891,331893,0,2,1
95083,3,1,331894,331894,331895,0,1,1
95084,2,2,331896,331896,331898,0,2,1
95085,1,1,331897,331898,331899,1,2,0
95086,6,3,331903,331903,331906,0,3,4
95087,3,3,331906,331906,331909,0,3,0
95088,1,1,331907,331909,331910,2,3,0
95089,2,2,331909,331910,331912,1,3,0
95090,5,1,331914,331914,331915,0,1,2
95091,6,2,331920,331920,331922,0,2,5
95092,3,2,331923,331923,331925,0,2,1
95093,6,1,331929,331929,331930,0,1,4
95094,3,2,331932,331932,331934,0,2,2
95095,2,1,331934,331934,331935,0,1,0
95096,6,3,331940,331940,331943,0,3,5
95097,5,1,331945,331945,331946,0,1,2
95098,2,2,331947,331947,331949,0,2,1
95099,1,2,331948,331949,331951,1,3,0
95100,5,3,331953,331953,331956,0,3,2
95101,5,3,331958,331958,331961,0,3,2
95102,4,2,331962,331962,331964,0,2,1
95103,1,1,331963,331964,331965,1,2,0
95104,5,2,331968,331968,331970,0,2,3
95105,4,2,331972,331972,331974,0,2,2
95106,5,3,331977,331977,331980,0,3,3
95107,2,3,331979,331980,331983,1,4,0
95108,5,3,331984,331984,331987,0,3,1
95109,1,3,331985,331987,331990,2,5,0
95110,5,2,331990,331990,331992,0,2,0
95111,5,3,331995,331995,331998,0,3,3
95112,6,1,332001,332001,332002,0,1,3
95113,4,1,332005,332005,332006,0,1,3
95114,5,3,332010,332010,332013,0,3,4
95115,2,2,332012,332013,332015,1,3,0
95116,4,1,332016,332016,332017,0,1,1
95117,2,1,332018,332018,332019,0,1,1
95118,5,3,332023,332023,332026,0,3,4
95119,2,3,332025,332026,332029,1,4,0
95120,4,3,332029,332029,332032,0,3,0
95121,6,1,332035,332035,332036,0,1,3
95122,2,2,332037,332037,332039,0,2,1
95123,5,2,332042,332042,332044,0,2,3
95124,3,2,332045,332045,332047,0,2,1
95125,5,2,332050,332050,332052,0,2,3
95126,2,2,332052,332052,332054,0,2,0
95127,1,1,332053,332054,332055,1,2,0
95128,4,2,332057,332057,332059,0,2,2
95129,3,3,332060,332060,332063,0,3,1
95130,6,2,332066,332066,332068,0,2,3
95131,6,3,332072,332072,332075,0,3,4
95132,6,3,332078,332078,332081,0,3,3
95133,5,3,332083,332083,332086,0,3,2
95134,4,3,332087,332087,332090,0,3,1
95135,3,1,332090,332090,332091,0,1,0
95136,1,2,332091,332091,332093,0,2,0
95137,1,3,332092,332093,332096,1,4,0
95138,2,1,332094,332096,332097,2,3,0
95139,5,3,332099,332099,332102,0,3,2
95140,2,2,332101,332102,332104,1,3,0
95141,1,3,332102,332104,332107,2,5,0
95142,5,1,332107,332107,332108,0,1,0
95143,5,1,332112,332112,332113,0,1,4
95144,2,3,332114,332114,332117,0,3,1
95145,4,2,332118,332118,332120,0,2,1
95146,1,2,332119,332120,332122,1,3,0
95147,2,2,332121,332122,332124,1,3,0
95148,5,2,332126,332126,332128,0,2,2
95149,4,1,332130,332130,332131,0,1,2
95150,4,2,332134,332134,332136,0,2,3
95151,5,2,332139,332139,332141,0,2,3
95152,4,3,332143,332143,332146,0,3,2
95153,1,3,332144,332146,332149,2,5,0
95154,1,3,332145,332149,332152,4,7,0
95155,2,3,332147,332152,332155,5,8,0
95156,2,2,332149,332155,332157,6,8,0
95157,6,1,332155,332157,332158,2,3,0
95158,2,2,332157,332158,332160,1,3,0
95159,4,3,332161,332161,332164,0,3,1
95160,1,1,332162,332164,332165,2,3,0
95161,5,1,332167,332167,332168,0,1,2
95162,6,1,332173,332173,332174,0,1,5
95163,4,1,332177,332177,332178,0,1,3
95164,3,1,332180,332180,332181,0,1,2
95165,5,3,332185,332185,332188,0,3,4
95166,5,2,332190,332190,332192,0,2,2
95167,1,1,332191,332192,332193,1,2,0
95168,5,3,332196,332196,332199,0,3,3
95169,4,1,332200,332200,332201,0,1,1
95170,2,3,332202,332202,332205,0,3,1
95171,5,3,332207,332207,332210,0,3,2
95172,4,2,332211,332211,332213,0,2,1
95173,4,1,332215,332215,332216,0,1,2
95174,1,2,332216,332216,332218,0,2,0
95175,6,3,332222,332222,332225,0,3,4
95176,3,3,332225,332225,332228,0,3,0
95177,5,3,332230,332230,332233,0,3,2
95178,4,2,332234,332234,332236,0,2,1
95179,1,1,332235,332236,332237,1,2,0
95180,6,2,332241,332241,332243,0,2,4
95181,1,1,332242,332243,332244,1,2,0
95182,5,1,332247,332247,332248,0,1,3
95183,1,1,332248,332248,332249,0,1,0
95184,2,1,332250,332250,332251,0,1,1
95185,3,2,332253,332253,332255,0,2,2
95186,2,2,332255,332255,332257,0,2,0
95187,3,2,332258,332258,332260,0,2,1
95188,1,1,332259,332260,332261,1,2,0
95189,3,1,332262,332262,332263,0,1,1
95190,2,1,332264,332264,332265,0,1,1
95191,3,2,332267,332267,332269,0,2,2
95192,6,3,332273,332273,332276,0,3,4
95193,4,2,332277,332277,332279,0,2,1
95194,3,1,332280,332280,332281,0,1,1
95195,6,3,332286,332286,332289,0,3,5
95196,5,3,332291,332291,332294,0,3,2
95197,6,3,332297,332297,332300,0,3,3
95198,1,1,332298,332300,332301,2,3,0
95199,5,2,332303,332303,332305,0,2,2
95200,2,3,332305,332305,332308,0,3,0
95201,4,1,332309,332309,332310,0,1,1
95202,4,3,332313,332313,332316,0,3,3
95203,1,1,332314,332316,332317,2,3,0
95204,5,3,332319,332319,332322,0,3,2
95205,2,1,332321,332322,332323,1,2,0
95206,4,3,332325,332325,332328,0,3,2
95207,5,3,332330,332330,332333,0,3,2
95208,1,1,332331,332333,332334,2,3,0
95209,4,2,332335,332335,332337,0,2,1
95210,2,2,332337,332337,332339,0,2,0
95211,2,1,332339,332339,332340,0,1,0
95212,1,3,332340,332340,332343,0,3,0
95213,5,2,332345,332345,332347,0,2,2
95214,2,1,332347,332347,332348,0,1,0
95215,4,1,332351,332351,332352,0,1,3
95216,5,1,332356,332356,332357,0,1,4
95217,6,2,332362,332362,332364,0,2,5
95218,2,3,332364,332364,332367,0,3,0
95219,5,3,332369,332369,332372,0,3,2
95220,3,2,332372,332372,332374,0,2,0
95221,2,1,332374,332374,332375,0,1,0
95222,1,2,332375,332375,332377,0,2,0
95223,2,2,332377,332377,332379,0,2,0
95224,1,1,332378,332379,332380,1,2,0
95225,5,2,332383,332383,332385,0,2,3
95226,2,1,332385,332385,332386,0,1,0
95227,4,2,332389,332389,332391,0,2,3
95228,2,2,332391,332391,332393,0,2,0
95229,3,1,332394,332394,332395,0,1,1
95230,6,3,332400,332400,332403,0,3,5
95231,3,2,332403,332403,332405,0,2,0
95232,5,1,332408,332408,332409,0,1,3
95233,6,2,332414,332414,332416,0,2,5
95234,3,1,332417,332417,332418,0,1,1
95235,3,2,332420,332420,332422,0,2,2
95236,6,3,332426,332426,332429,0,3,4
95237,4,2,332430,332430,332432,0,2,1
95238,6,3,332436,332436,332439,0,3,4
95239,5,1,332441,332441,332442,0,1,2
95240,5,3,332446,332446,332449,0,3,4
95241,1,2,332447,332449,332451,2,4,0
95242,5,1,332452,332452,332453,0,1,1
95243,1,1,332453,332453,332454,0,1,0
95244,3,2,332456,332456,332458,0,2,2
95245,5,2,332461,332461,332463,0,2,3
95246,4,3,332465,332465,332468,0,3,2
95247,2,1,332467,332468,332469,1,2,0
95248,5,1,332472,332472,332473,0,1,3
95249,4,3,332476,332476,332479,0,3,3
95250,1,2,332477,332479,332481,2,4,0
95251,2,3,332479,332481,332484,2,5,0
95252,4,2,332483,332484,332486,1,3,0
95253,3,1,332486,332486,332487,0,1,0
95254,1,1,332487,332487,332488,0,1,0
95255,3,2,332490,332490,332492,0,2,2
95256,5,3,332495,332495,332498,0,3,3
95257,4,2,332499,332499,332501,0,2,1
95258,6,3,332505,332505,332508,0,3,4
95259,6,2,332511,332511,332513,0,2,3
95260,4,1,332515,332515,332516,0,1,2
95261,1,1,332516,332516,332517,0,1,0
95262,4,1,332520,332520,332521,0,1,3
95263,1,1,332521,332521,332522,0,1,0
95264,5,1,332526,332526,332527,0,1,4
95265,2,3,332528,332528,332531,0,3,1
95266,6,2,332534,332534,332536,0,2,3
95267,4,1,332538,332538,332539,0,1,2
95268,6,3,332544,332544,332547,0,3,5
95269,3,3,332547,332547,332550,0,3,0
95270,1,2,332548,332550,332552,2,4,0
95271,5,2,332553,332553,332555,0,2,1
95272,5,1,332558,332558,332559,0,1,3
95273,1,3,332559,332559,332562,0,3,0
95274,2,2,332561,332562,332564,1,3,0
95275,6,2,332567,332567,332569,0,2,3
95276,1,3,332568,332569,332572,1,4,0
95277,3,1,332571,332572,332573,1,2,0
95278,6,3,332577,332577,332580,0,3,4
95279,3,3,332580,332580,332583,0,3,0
95280,6,1,332586,332586,332587,0,1,3
95281,5,1,332591,332591,332592,0,1,4
95282,1,2,332592,332592,332594,0,2,0
95283,3,3,332595,332595,332598,0,3,1
95284,1,3,332596,332598,332601,2,5,0
95285,3,3,332599,332601,332604,2,5,0
95286,1,2,332600,332604,332606,4,6,0
95287,5,2,332605,332606,332608,1,3,0
95288,6,2,332611,332611,332613,0,2,3
95289,1,3,332612,332613,332616,1,4,0
95290,2,1,332614,332616,332617,2,3,0
95291,2,3,332616,332617,332620,1,4,0
95292,5,2,332621,332621,332623,0,2,1
95293,3,2,332624,332624,332626,0,2,1
95294,5,3,332629,332629,332632,0,3,3
95295,6,1,332635,332635,332636,0,1,3
95296,5,2,332640,332640,332642,0,2,4
95297,6,3,332646,332646,332649,0,3,4
95298,2,2,332648,332649,332651,1,3,0
95299,6,2,332654,332654,332656,0,2,3
95300,5,1,332659,332659,332660,0,1,3
95301,2,2,332661,332661,332663,0,2,1
95302,3,1,332664,332664,332665,0,1,1
95303,1,2,332665,332665,332667,0,2,0
95304,2,2,332667,332667,332669,0,2,0
95305,1,1,332668,332669,332670,1,2,0
95306,2,1,332670,332670,332671,0,1,0
95307,2,1,332672,332672,332673,0,1,1
95308,4,1,332676,332676,332677,0,1,3
95309,2,2,332678,332678,332680,0,2,1
95310,3,1,332681,332681,332682,0,1,1
95311,2,2,332683,332683,332685,0,2,1
95312,1,3,332684,332685,332688,1,4,0
95313,2,1,332686,332688,332689,2,3,0
95314,5,3,332691,332691,332694,0,3,2
95315,3,1,332694,332694,332695,0,1,0
95316,6,3,332700,332700,332703,0,3,5
95317,3,3,332703,332703,332706,0,3,0
95318,2,2,332705,332706,332708,1,3,0
95319,3,3,332708,332708,332711,0,3,0
95320,2,1,332710,332711,332712,1,2,0
95321,6,1,332716,332716,332717,0,1,4
95322,5,3,332721,332721,332724,0,3,4
95323,4,2,332725,332725,332727,0,2,1
95324,6,2,332731,332731,332733,0,2,4
95325,3,2,332734,332734,332736,0,2,1
95326,2,1,332736,332736,332737,0,1,0
95327,3,1,332739,332739,332740,0,1,2
95328,3,1,332742,332742,332743,0,1,2
95329,1,1,332743,332743,332744,0,1,0
95330,2,3,332745,332745,332748,0,3,1
95331,6,2,332751,332751,332753,0,2,3
95332,5,1,332756,332756,332757,0,1,3
95333,1,3,332757,332757,332760,0,3,0
95334,2,2,332759,332760,332762,1,3,0
95335,4,1,332763,332763,332764,0,1,1
95336,3,3,332766,332766,332769,0,3,2
95337,4,1,332770,332770,332771,0,1,1
95338,3,1,332773,332773,332774,0,1,2
95339,6,1,332779,332779,332780,0,1,5
95340,5,1,332784,332784,332785,0,1,4
95341,5,2,332789,332789,332791,0,2,4
95342,6,1,332795,332795,332796,0,1,4
95343,1,2,332796,332796,332798,0,2,0
95344,3,2,332799,332799,332801,0,2,1
95345,1,3,332800,332801,332804,1,4,0
95346,5,1,332805,332805,332806,0,1,1
95347,6,3,332811,332811,332814,0,3,5
95348,4,1,332815,332815,332816,0,1,1
95349,2,2,332817,332817,332819,0,2,1
95350,3,3,332820,332820,332823,0,3,1
95351,5,3,332825,332825,332828,0,3,2
95352,2,1,332827,332828,332829,1,2,0
95353,1,1,332828,332829,332830,1,2,0
95354,3,3,332831,332831,332834,0,3,1
95355,6,2,332837,332837,332839,0,2,3
95356,2,3,332839,332839,332842,0,3,0
95357,2,2,332841,332842,332844,1,3,0
95358,6,2,332847,332847,332849,0,2,3
95359,3,1,332850,332850,332851,0,1,1
95360,2,1,332852,332852,332853,0,1,1
95361,2,1,332854,332854,332855,0,1,1
95362,2,1,332856,332856,332857,0,1,1
95363,1,1,332857,332857,332858,0,1,0
95364,2,2,332859,332859,332861,0,2,1
95365,2,1,332861,332861,332862,0,1,0
95366,3,3,332864,332864,332867,0,3,2
95367,3,3,332867,332867,332870,0,3,0
95368,3,3,332870,332870,332873,0,3,0
95369,1,1,332871,332873,332874,2,3,0
95370,3,2,332874,332874,332876,0,2,0
95371,1,2,332875,332876,332878,1,3,0
95372,1,2,332876,332878,332880,2,4,0
95373,6,1,332882,332882,332883,0,1,2
95374,1,1,332883,332883,332884,0,1,0
95375,4,3,332887,332887,332890,0,3,3
95376,5,2,332892,332892,332894,0,2,2
95377,6,1,332898,332898,332899,0,1,4
95378,6,3,332904,332904,332907,0,3,5
95379,2,1,332906,332907,332908,1,2,0
95380,3,2,332909,332909,332911,0,2,1
95381,5,1,332914,332914,332915,0,1,3
95382,4,2,332918,332918,332920,0,2,3
95383,2,2,332920,332920,332922,0,2,0
95384,6,2,332926,332926,332928,0,2,4
95385,4,1,332930,332930,332931,0,1,2
95386,1,1,332931,332931,332932,0,1,0
95387,5,1,332936,332936,332937,0,1,4
95388,2,3,332938,332938,332941,0,3,1
95389,1,3,332939,332941,332944,2,5,0
95390,2,2,332941,332944,332946,3,5,0
95391,3,2,332944,332946,332948,2,4,0
95392,3,1,332947,332948,332949,1,2,0
95393,4,3,332951,332951,332954,0,3,2
95394,1,1,332952,332954,332955,2,3,0
95395,4,1,332956,332956,332957,0,1,1
95396,5,3,332961,332961,332964,0,3,4
95397,1,1,332962,332964,332965,2,3,0
95398,5,1,332967,332967,332968,0,1,2
95399,4,2,332971,332971,332973,0,2,3
95400,6,3,332977,332977,332980,0,3,4
95401,5,1,332982,332982,332983,0,1,2
95402,3,3,332985,332985,332988,0,3,2
95403,3,3,332988,332988,332991,0,3,0
95404,4,3,332992,332992,332995,0,3,1
95405,6,2,332998,332998,333000,0,2,3
95406,6,1,333004,333004,333005,0,1,4
95407,2,1,333006,333006,333007,0,1,1
95408,6,3,333012,333012,333015,0,3,5
95409,2,3,333014,333015,333018,1,4,0
95410,6,1,333020,333020,333021,0,1,2
95411,5,2,333025,333025,333027,0,2,4
95412,3,2,333028,333028,333030,0,2,1
95413,1,3,333029,333030,333033,1,4,0
95414,1,1,333030,333033,333034,3,4,0
95415,2,2,333032,333034,333036,2,4,0
95416,1,3,333033,333036,333039,3,6,0
95417,5,1,333038,333039,333040,1,2,0
95418,5,3,333043,333043,333046,0,3,3
95419,5,3,333048,333048,333051,0,3,2
95420,6,2,333054,333054,333056,0,2,3
95421,1,1,333055,333056,333057,1,2,0
95422,5,3,333060,333060,333063,0,3,3
95423,1,3,333061,333063,333066,2,5,0
95424,4,3,333065,333066,333069,1,4,0
95425,4,3,333069,333069,333072,0,3,0
95426,2,2,333071,333072,333074,1,3,0
95427,1,2,333072,333074,333076,2,4,0
95428,3,2,333075,333076,333078,1,3,0
95429,5,2,333080,333080,333082,0,2,2
95430,2,2,333082,333082,333084,0,2,0
95431,6,3,333088,333088,333091,0,3,4
95432,6,2,333094,333094,333096,0,2,3
95433,5,3,333099,333099,333102,0,3,3
95434,2,2,333101,333102,333104,1,3,0
95435,2,3,333103,333104,333107,1,4,0
95436,4,3,333107,333107,333110,0,3,0
95437,1,1,333108,333110,333111,2,3,0
95438,2,3,333110,333111,333114,1,4,0
95439,6,2,333116,333116,333118,0,2,2
95440,3,2,333119,333119,333121,0,2,1
95441,6,2,333125,333125,333127,0,2,4
95442,1,3,333126,333127,333130,1,4,0
95443,3,1,333129,333130,333131,1,2,0
95444,1,1,333130,333131,333132,1,2,0
95445,1,3,333131,333132,333135,1,4,0
95446,4,3,333135,333135,333138,0,3,0
95447,6,3,333141,333141,333144,0,3,3
95448,2,2,333143,333144,333146,1,3,0
95449,4,1,333147,333147,333148,0,1,1
95450,3,2,333150,333150,333152,0,2,2
95451,1,3,333151,333152,333155,1,4,0
95452,2,2,333153,333155,333157,2,4,0
95453,5,1,333158,333158,333159,0,1,1
95454,3,3,333161,333161,333164,0,3,2
95455,6,3,333167,333167,333170,0,3,3
95456,4,3,333171,333171,333174,0,3,1
95457,3,3,333174,333174,333177,0,3,0
95458,3,2,333177,333177,333179,0,2,0
95459,4,2,333181,333181,333183,0,2,2
95460,4,1,333185,333185,333186,0,1,2
95461,5,3,333190,333190,333193,0,3,4
95462,1,2,333191,333193,333195,2,4,0
95463,4,3,333195,333195,333198,0,3,0
95464,5,2,333200,333200,333202,0,2,2
95465,1,1,333201,333202,333203,1,2,0
95466,5,2,333206,333206,333208,0,2,3
95467,3,2,333209,333209,333211,0,2,1
95468,2,1,333211,333211,333212,0,1,0
95469,3,1,333214,333214,333215,0,1,2
95470,3,3,333217,333217,333220,0,3,2
95471,2,1,333219,333220,333221,1,2,0
95472,4,2,333223,333223,333225,0,2,2
95473,3,3,333226,333226,333229,0,3,1
95474,6,3,333232,333232,333235,0,3,3
95475,3,2,333235,333235,333237,0,2,0
95476,5,1,333240,333240,333241,0,1,3
95477,5,3,333245,333245,333248,0,3,4
95478,2,2,333247,333248,333250,1,3,0
95479,5,2,333252,333252,333254,0,2,2
95480,5,3,333257,333257,333260,0,3,3
95481,4,1,333261,333261,333262,0,1,1
95482,3,1,333264,333264,333265,0,1,2
95483,1,3,333265,333265,333268,0,3,0
95484,5,2,333270,333270,333272,0,2,2
95485,6,1,333276,333276,333277,0,1,4
95486,5,1,333281,333281,333282,0,1,4
95487,5,2,333286,333286,333288,0,2,4
95488,3,2,333289,333289,333291,0,2,1
95489,1,2,333290,333291,333293,1,3,0
95490,2,2,333292,333293,333295,1,3,0
95491,2,1,333294,333295,333296,1,2,0
95492,1,2,333295,333296,333298,1,3,0
95493,6,3,333301,333301,333304,0,3,3
95494,6,3,333307,333307,333310,0,3,3
95495,6,2,333313,333313,333315,0,2,3
95496,4,1,333317,333317,333318,0,1,2
95497,6,2,333323,333323,333325,0,2,5
95498,2,2,333325,333325,333327,0,2,0
95499,1,2,333326,333327,333329,1,3,0
95500,4,3,333330,333330,333333,0,3,1
95501,3,1,333333,333333,333334,0,1,0
95502,3,3,333336,333336,333339,0,3,2
95503,3,2,333339,333339,333341,0,2,0
95504,6,3,333345,333345,333348,0,3,4
95505,1,1,333346,333348,333349,2,3,0
95506,6,1,333352,333352,333353,0,1,3
95507,2,2,333354,333354,333356,0,2,1
95508,6,3,333360,333360,333363,0,3,4
95509,3,3,333363,333363,333366,0,3,0
95510,4,3,333367,333367,333370,0,3,1
95511,4,1,333371,333371,333372,0,1,1
95512,4,3,333375,333375,333378,0,3,3
95513,3,1,333378,333378,333379,0,1,0
95514,5,1,333383,333383,333384,0,1,4
95515,1,3,333384,333384,333387,0,3,0
95516,5,2,333389,333389,333391,0,2,2
95517,2,1,333391,333391,333392,0,1,0
95518,4,2,333395,333395,333397,0,2,3
95519,5,3,333400,333400,333403,0,3,3
95520,5,1,333405,333405,333406,0,1,2
95521,5,3,333410,333410,333413,0,3,4
95522,5,1,333415,333415,333416,0,1,2
95523,3,1,333418,333418,333419,0,1,2
95524,5,1,333423,333423,333424,0,1,4
95525,3,3,333426,333426,333429,0,3,2
95526,2,2,333428,333429,333431,1,3,0
95527,4,3,333432,333432,333435,0,3,1
95528,1,2,333433,333435,333437,2,4,0
95529,1,1,333434,333437,333438,3,4,0
95530,6,2,333440,333440,333442,0,2,2
95531,6,3,333446,333446,333449,0,3,4
95532,3,2,333449,333449,333451,0,2,0
95533,5,1,333454,333454,333455,0,1,3
95534,5,3,333459,333459,333462,0,3,4
95535,6,1,333465,333465,333466,0,1,3
95536,3,2,333468,333468,333470,0,2,2
95537,4,3,333472,333472,333475,0,3,2
95538,3,1,333475,333475,333476,0,1,0
95539,5,3,333480,333480,333483,0,3,4
95540,6,3,333486,333486,333489,0,3,3
95541,6,3,333492,333492,333495,0,3,3
95542,6,3,333498,333498,333501,0,3,3
95543,1,2,333499,333501,333503,2,4,0
95544,2,1,333501,333503,333504,2,3,0
95545,3,3,333504,333504,333507,0,3,0
95546,1,2,333505,333507,333509,2,4,0
95547,4,1,333509,333509,333510,0,1,0
95548,2,2,333511,333511,333513,0,2,1
95549,3,2,333514,333514,333516,0,2,1
95550,2,2,333516,333516,333518,0,2,0
95551,3,2,333519,333519,333521,0,2,1
95552,3,1,333522,333522,333523,0,1,1
95553,5,2,333527,333527,333529,0,2,4
95554,4,3,333531,333531,333534,0,3,2
95555,5,2,333536,333536,333538,0,2,2
95556,3,1,333539,333539,333540,0,1,1
95557,2,2,333541,333541,333543,0,2,1
95558,4,2,333545,333545,333547,0,2,2
95559,4,3,333549,333549,333552,0,3,2
95560,3,2,333552,333552,333554,0,2,0
95561,4,3,333556,333556,333559,0,3,2
95562,3,2,333559,333559,333561,0,2,0
95563,1,3,333560,333561,333564,1,4,0
95564,6,3,333566,333566,333569,0,3,2
95565,4,3,333570,333570,333573,0,3,1
95566,4,3,333574,333574,333577,0,3,1
95567,5,3,333579,333579,333582,0,3,2
95568,2,2,333581,333582,333584,1,3,0
95569,6,2,333587,333587,333589,0,2,3
95570,3,3,333590,333590,333593,0,3,1
95571,6,3,333596,333596,333599,0,3,3
95572,2,3,333598,333599,333602,1,4,0
95573,6,3,333604,333604,333607,0,3,2
95574,6,2,333610,333610,333612,0,2,3
95575,5,2,333615,333615,333617,0,2,3
95576,6,2,333621,333621,333623,0,2,4
95577,6,3,333627,333627,333630,0,3,4
95578,6,2,333633,333633,333635,0,2,3
95579,6,1,333639,333639,333640,0,1,4
95580,1,1,333640,333640,333641,0,1,0
95581,2,1,333642,333642,333643,0,1,1
95582,5,3,333647,333647,333650,0,3,4
95583,2,3,333649,333650,333653,1,4,0
95584,4,2,333653,333653,333655,0,2,0
95585,5,3,333658,333658,333661,0,3,3
95586,4,3,333662,333662,333665,0,3,1
95587,3,1,333665,333665,333666,0,1,0
95588,3,3,333668,333668,333671,0,3,2
95589,6,2,333674,333674,333676,0,2,3
95590,2,3,333676,333676,333679,0,3,0
95591,5,2,333681,333681,333683,0,2,2
95592,6,1,333687,333687,333688,0,1,4
95593,4,1,333691,333691,333692,0,1,3
95594,4,3,333695,333695,333698,0,3,3
95595,5,2,333700,333700,333702,0,2,2
95596,5,1,333705,333705,333706,0,1,3
95597,4,3,333709,333709,333712,0,3,3
95598,3,1,333712,333712,333713,0,1,0
95599,5,2,333717,333717,333719,0,2,4
95600,2,2,333719,333719,333721,0,2,0
95601,2,2,333721,333721,333723,0,2,0
95602,6,3,333727,333727,333730,0,3,4
95603,1,1,333728,333730,333731,2,3,0
95604,4,3,333732,333732,333735,0,3,1
95605,2,2,333734,333735,333737,1,3,0
95606,2,3,333736,333737,333740,1,4,0
95607,4,3,333740,333740,333743,0,3,0
95608,2,3,333742,333743,333746,1,4,0
95609,3,1,333745,333746,333747,1,2,0
95610,6,2,333751,333751,333753,0,2,4
95611,2,3,333753,333753,333756,0,3,0
95612,3,3,333756,333756,333759,0,3,0
95613,1,3,333757,333759,333762,2,5,0
95614,6,2,333763,333763,333765,0,2,1
95615,2,1,333765,333765,333766,0,1,0
95616,3,3,333768,333768,333771,0,3,2
95617,1,1,333769,333771,333772,2,3,0
95618,3,3,333772,333772,333775,0,3,0
95619,3,2,333775,333775,333777,0,2,0
95620,3,3,333778,333778,333781,0,3,1
95621,6,2,333784,333784,333786,0,2,3
95622,2,2,333786,333786,333788,0,2,0
95623,5,1,333791,333791,333792,0,1,3
95624,3,1,333794,333794,333795,0,1,2
95625,6,2,333800,333800,333802,0,2,5
95626,2,1,333802,333802,333803,0,1,0
95627,5,3,333807,333807,333810,0,3,4
95628,6,3,333813,333813,333816,0,3,3
95629,1,1,333814,333816,333817,2,3,0
95630,5,2,333819,333819,333821,0,2,2
95631,5,3,333824,333824,333827,0,3,3
95632,2,3,333826,333827,333830,1,4,0
95633,1,1,333827,333830,333831,3,4,0
95634,2,2,333829,333831,333833,2,4,0
95635,2,1,333831,333833,333834,2,3,0
95636,1,1,333832,333834,333835,2,3,0
95637,4,1,333836,333836,333837,0,1,1
95638,2,2,333838,333838,333840,0,2,1
95639,2,2,333840,333840,333842,0,2,0
95640,2,3,333842,333842,333845,0,3,0
95641,6,2,333848,333848,333850,0,2,3
95642,1,3,333849,333850,333853,1,4,0
95643,5,1,333854,333854,333855,0,1,1
95644,1,3,333855,333855,333858,0,3,0
95645,2,2,333857,333858,333860,1,3,0
95646,2,1,333859,333860,333861,1,2,0
95647,6,1,333865,333865,333866,0,1,4
95648,5,3,333870,333870,333873,0,3,4
95649,4,1,333874,333874,333875,0,1,1
95650,5,1,333879,333879,333880,0,1,4
95651,2,2,333881,333881,333883,0,2,1
95652,1,3,333882,333883,333886,1,4,0
95653,4,3,333886,333886,333889,0,3,0
95654,1,2,333887,333889,333891,2,4,0
95655,2,2,333889,333891,333893,2,4,0
95656,1,2,333890,333893,333895,3,5,0
95657,3,1,333893,333895,333896,2,3,0
95658,6,2,333899,333899,333901,0,2,3
95659,5,2,333904,333904,333906,0,2,3
95660,5,1,333909,333909,333910,0,1,3
95661,1,1,333910,333910,333911,0,1,0
95662,1,2,333911,333911,333913,0,2,0
95663,4,1,333915,333915,333916,0,1,2
95664,5,3,333920,333920,333923,0,3,4
95665,2,1,333922,333923,333924,1,2,0
95666,4,1,333926,333926,333927,0,1,2
95667,2,1,333928,333928,333929,0,1,1
95668,6,1,333934,333934,333935,0,1,5
95669,4,2,333938,333938,333940,0,2,3
95670,4,3,333942,333942,333945,0,3,2
95671,3,1,333945,333945,333946,0,1,0
95672,4,2,333949,333949,333951,0,2,3
95673,2,3,333951,333951,333954,0,3,0
95674,1,2,333952,333954,333956,2,4,0
95675,2,2,333954,333956,333958,2,4,0
95676,5,2,333959,333959,333961,0,2,1
95677,4,1,333963,333963,333964,0,1,2
95678,1,2,333964,333964,333966,0,2,0
95679,5,1,333969,333969,333970,0,1,3
95680,1,3,333970,333970,333973,0,3,0
95681,4,3,333974,333974,333977,0,3,1
95682,5,3,333979,333979,333982,0,3,2
95683,6,3,333985,333985,333988,0,3,3
95684,2,2,333987,333988,333990,1,3,0
95685,6,3,333993,333993,333996,0,3,3
95686,5,3,333998,333998,334001,0,3,2
95687,4,1,334002,334002,334003,0,1,1
95688,2,1,334004,334004,334005,0,1,1
95689,2,1,334006,334006,334007,0,1,1
95690,5,2,334011,334011,334013,0,2,4
95691,1,3,334012,334013,334016,1,4,0
95692,5,1,334017,334017,334018,0,1,1
95693,4,1,334021,334021,334022,0,1,3
95694,5,2,334026,334026,334028,0,2,4
95695,2,2,334028,334028,334030,0,2,0
95696,1,1,334029,334030,334031,1,2,0
95697,2,3,334031,334031,334034,0,3,0
95698,3,2,334034,334034,334036,0,2,0
95699,3,1,334037,334037,334038,0,1,1
95700,1,2,334038,334038,334040,0,2,0
95701,5,3,334043,334043,334046,0,3,3
95702,2,2,334045,334046,334048,1,3,0
95703,2,1,334047,334048,334049,1,2,0
95704,1,3,334048,334049,334052,1,4,0
95705,6,3,334054,334054,334057,0,3,2
95706,2,2,334056,334057,334059,1,3,0
95707,6,2,334062,334062,334064,0,2,3
95708,3,1,334065,334065,334066,0,1,1
95709,3,3,334068,334068,334071,0,3,2
95710,6,2,334074,334074,334076,0,2,3
95711,4,1,334078,334078,334079,0,1,2
95712,2,3,334080,334080,334083,0,3,1
95713,5,1,334085,334085,334086,0,1,2
95714,6,1,334091,334091,334092,0,1,5
95715,3,2,334094,334094,334096,0,2,2
95716,2,2,334096,334096,334098,0,2,0
95717,3,3,334099,334099,334102,0,3,1
95718,3,3,334102,334102,334105,0,3,0
95719,3,2,334105,334105,334107,0,2,0
95720,2,1,334107,334107,334108,0,1,0
95721,5,2,334112,334112,334114,0,2,4
95722,6,2,334118,334118,334120,0,2,4
95723,5,2,334123,334123,334125,0,2,3
95724,5,1,334128,334128,334129,0,1,3
95725,2,1,334130,334130,334131,0,1,1
95726,2,2,334132,334132,334134,0,2,1
95727,3,3,334135,334135,334138,0,3,1
95728,3,3,334138,334138,334141,0,3,0
95729,5,1,334143,334143,334144,0,1,2
95730,5,1,334148,334148,334149,0,1,4
95731,4,1,334152,334152,334153,0,1,3
95732,6,3,334158,334158,334161,0,3,5
95733,2,1,334160,334161,334162,1,2,0
95734,1,1,334161,334162,334163,1,2,0
95735,2,2,334163,334163,334165,0,2,0
95736,1,1,334164,334165,334166,1,2,0
95737,1,3,334165,334166,334169,1,4,0
95738,6,3,334171,334171,334174,0,3,2
95739,2,1,334173,334174,334175,1,2,0
95740,1,3,334174,334175,334178,1,4,0
95741,4,2,334178,334178,334180,0,2,0
95742,3,1,334181,334181,334182,0,1,1
95743,1,3,334182,334182,334185,0,3,0
95744,1,3,334183,334185,334188,2,5,0
95745,6,3,334189,334189,334192,0,3,1
95746,4,3,334193,334193,334196,0,3,1
95747,4,3,334197,334197,334200,0,3,1
95748,4,1,334201,334201,334202,0,1,1
95749,5,2,334206,334206,334208,0,2,4
95750,5,2,334211,334211,334213,0,2,3
95751,1,2,334212,334213,334215,1,3,0
95752,6,1,334218,334218,334219,0,1,3
95753,1,2,334219,334219,334221,0,2,0
95754,1,1,334220,334221,334222,1,2,0
95755,1,3,334221,334222,334225,1,4,0
95756,3,3,334224,334225,334228,1,4,0
95757,5,1,334229,334229,334230,0,1,1
95758,3,1,334232,334232,334233,0,1,2
95759,2,2,334234,334234,334236,0,2,1
95760,1,1,334235,334236,334237,1,2,0
95761,6,2,334241,334241,334243,0,2,4
95762,2,3,334243,334243,334246,0,3,0
95763,2,1,334245,334246,334247,1,2,0
95764,2,2,334247,334247,334249,0,2,0
95765,5,2,334252,334252,334254,0,2,3
95766,4,3,334256,334256,334259,0,3,2
95767,3,3,334259,334259,334262,0,3,0
95768,3,2,334262,334262,334264,0,2,0
95769,6,2,334268,334268,334270,0,2,4
95770,3,2,334271,334271,334273,0,2,1
95771,3,1,334274,334274,334275,0,1,1
95772,3,2,334277,334277,334279,0,2,2
95773,5,3,334282,334282,334285,0,3,3
95774,5,1,334287,334287,334288,0,1,2
95775,6,3,334293,334293,334296,0,3,5
95776,2,1,334295,334296,334297,1,2,0
95777,6,2,334301,334301,334303,0,2,4
95778,4,1,334305,334305,334306,0,1,2
95779,4,2,334309,334309,334311,0,2,3
95780,4,3,334313,334313,334316,0,3,2
95781,2,3,334315,334316,334319,1,4,0
95782,4,1,334319,334319,334320,0,1,0
95783,1,2,334320,334320,334322,0,2,0
95784,3,2,334323,334323,334325,0,2,1
95785,5,1,334328,334328,334329,0,1,3
95786,6,3,334334,334334,334337,0,3,5
95787,2,2,334336,334337,334339,1,3,0
95788,5,2,334341,334341,334343,0,2,2
95789,1,2,334342,334343,334345,1,3,0
95790,6,1,334348,334348,334349,0,1,3
95791,5,3,334353,334353,334356,0,3,4
95792,2,2,334355,334356,334358,1,3,0
95793,4,3,334359,334359,334362,0,3,1
95794,4,2,334363,334363,334365,0,2,1
95795,1,3,334364,334365,334368,1,4,0
95796,2,3,334366,334368,334371,2,5,0
95797,5,2,334371,334371,334373,0,2,0
95798,4,1,334375,334375,334376,0,1,2
95799,2,1,334377,334377,334378,0,1,1
95800,3,3,334380,334380,334383,0,3,2
95801,6,1,334386,334386,334387,0,1,3
95802,4,3,334390,334390,334393,0,3,3
95803,3,1,334393,334393,334394,0,1,0
95804,4,1,334397,334397,334398,0,1,3
95805,2,3,334399,334399,334402,0,3,1
95806,1,3,334400,334402,334405,2,5,0
95807,6,2,334406,334406,334408,0,2,1
95808,6,3,334412,334412,334415,0,3,4
95809,5,1,334417,334417,334418,0,1,2
95810,1,1,334418,334418,334419,0,1,0
95811,3,3,334421,334421,334424,0,3,2
95812,3,3,334424,334424,334427,0,3,0
95813,3,3,334427,334427,334430,0,3,0
95814,1,1,334428,334430,334431,2,3,0
95815,4,1,334432,334432,334433,0,1,1
95816,4,3,334436,334436,334439,0,3,3
95817,2,2,334438,334439,334441,1,3,0
95818,1,1,334439,334441,334442,2,3,0
95819,4,1,334443,334443,334444,0,1,1
95820,6,2,334449,334449,334451,0,2,5
95821,5,2,334454,334454,334456,0,2,3
95822,5,3,334459,334459,334462,0,3,3
95823,2,3,334461,334462,334465,1,4,0
95824,4,3,334465,334465,334468,0,3,0
95825,1,1,334466,334468,334469,2,3,0
95826,3,3,334469,334469,334472,0,3,0
95827,2,2,334471,334472,334474,1,3,0
95828,1,2,334472,334474,334476,2,4,0
95829,3,1,334475,334476,334477,1,2,0
95830,1,2,334476,334477,334479,1,3,0
95831,2,3,334478,334479,334482,1,4,0
95832,4,2,334482,334482,334484,0,2,0
95833,6,1,334488,334488,334489,0,1,4
95834,2,3,334490,334490,334493,0,3,1
95835,4,2,334494,334494,334496,0,2,1
95836,5,1,334499,334499,334500,0,1,3
95837,4,2,334503,334503,334505,0,2,3
95838,1,1,334504,334505,334506,1,2,0
95839,5,3,334509,334509,334512,0,3,3
95840,3,3,334512,334512,334515,0,3,0
95841,5,2,334517,334517,334519,0,2,2
95842,5,3,334522,334522,334525,0,3,3
95843,5,2,334527,334527,334529,0,2,2
95844,6,2,334533,334533,334535,0,2,4
95845,2,3,334535,334535,334538,0,3,0
95846,1,3,334536,334538,334541,2,5,0
95847,3,1,334539,334541,334542,2,3,0
95848,3,2,334542,334542,334544,0,2,0
95849,4,2,334546,334546,334548,0,2,2
95850,2,1,334548,334548,334549,0,1,0
95851,4,3,334552,334552,334555,0,3,3
95852,5,2,334557,334557,334559,0,2,2
95853,6,1,334563,334563,334564,0,1,4
95854,4,1,334567,334567,334568,0,1,3
95855,6,3,334573,334573,334576,0,3,5
95856,6,2,334579,334579,334581,0,2,3
95857,1,2,334580,334581,334583,1,3,0
95858,4,3,334584,334584,334587,0,3,1
95859,2,1,334586,334587,334588,1,2,0
95860,3,2,334589,334589,334591,0,2,1
95861,2,2,334591,334591,334593,0,2,0
95862,3,1,334594,334594,334595,0,1,1
95863,5,2,334599,334599,334601,0,2,4
95864,5,1,334604,334604,334605,0,1,3
95865,5,1,334609,334609,334610,0,1,4
95866,2,2,334611,334611,334613,0,2,1
95867,5,1,334616,334616,334617,0,1,3
95868,3,2,334619,334619,334621,0,2,2
95869,1,2,334620,334621,334623,1,3,0
95870,1,2,334621,334623,334625,2,4,0
95871,3,3,334624,334625,334628,1,4,0
95872,1,2,334625,334628,334630,3,5,0
95873,6,2,334631,334631,334633,0,2,1
95874,1,2,334632,334633,334635,1,3,0
95875,6,2,334638,334638,334640,0,2,3
95876,1,1,334639,334640,334641,1,2,0
95877,6,1,334645,334645,334646,0,1,4
95878,6,2,334651,334651,334653,0,2,5
95879,2,3,334653,334653,334656,0,3,0
95880,3,1,334656,334656,334657,0,1,0
95881,2,3,334658,334658,334661,0,3,1
95882,3,1,334661,334661,334662,0,1,0
95883,1,3,334662,334662,334665,0,3,0
95884,5,2,334667,334667,334669,0,2,2
95885,5,3,334672,334672,334675,0,3,3
95886,6,2,334678,334678,334680,0,2,3
95887,1,3,334679,334680,334683,1,4,0
95888,3,2,334682,334683,334685,1,3,0
95889,4,3,334686,334686,334689,0,3,1
95890,2,3,334688,334689,334692,1,4,0
95891,3,2,334691,334692,334694,1,3,0
95892,6,3,334697,334697,334700,0,3,3
95893,4,3,334701,334701,334704,0,3,1
95894,2,2,334703,334704,334706,1,3,0
95895,5,2,334708,334708,334710,0,2,2
95896,4,3,334712,334712,334715,0,3,2
95897,1,1,334713,334715,334716,2,3,0
95898,1,1,334714,334716,334717,2,3,0
95899,6,1,334720,334720,334721,0,1,3
95900,4,2,334724,334724,334726,0,2,3
95901,3,3,334727,334727,334730,0,3,1
95902,6,2,334733,334733,334735,0,2,3
95903,5,3,334738,334738,334741,0,3,3
95904,3,3,334741,334741,334744,0,3,0
95905,6,1,334747,334747,334748,0,1,3
95906,2,2,334749,334749,334751,0,2,1
95907,5,2,334754,334754,334756,0,2,3
95908,4,2,334758,334758,334760,0,2,2
95909,2,3,334760,334760,334763,0,3,0
95910,1,3,334761,334763,334766,2,5,0
95911,2,1,334763,334766,334767,3,4,0
95912,2,2,334765,334767,334769,2,4,0
95913,3,2,334768,334769,334771,1,3,0
95914,4,1,334772,334772,334773,0,1,1
95915,5,1,334777,334777,334778,0,1,4
95916,6,1,334783,334783,334784,0,1,5
95917,2,2,334785,334785,334787,0,2,1
95918,3,1,334788,334788,334789,0,1,1
95919,5,3,334793,334793,334796,0,3,4
95920,1,3,334794,334796,334799,2,5,0
95921,2,1,334796,334799,334800,3,4,0
95922,3,1,334799,334800,334801,1,2,0
95923,4,2,334803,334803,334805,0,2,2
95924,1,2,334804,334805,334807,1,3,0
95925,5,2,334809,334809,334811,0,2,2
95926,3,3,334812,334812,334815,0,3,1
95927,3,2,334815,334815,334817,0,2,0
95928,3,3,334818,334818,334821,0,3,1
95929,1,3,334819,334821,334824,2,5,0
95930,4,1,334823,334824,334825,1,2,0
95931,5,3,334828,334828,334831,0,3,3
95932,1,1,334829,334831,334832,2,3,0
95933,1,2,334830,334832,334834,2,4,0
95934,6,3,334836,334836,334839,0,3,2
95935,2,3,334838,334839,334842,1,4,0
95936,5,1,334843,334843,334844,0,1,1
95937,2,2,334845,334845,334847,0,2,1
95938,5,1,334850,334850,334851,0,1,3
95939,4,2,334854,334854,334856,0,2,3
95940,5,1,334859,334859,334860,0,1,3
95941,1,2,334860,334860,334862,0,2,0
95942,1,2,334861,334862,334864,1,3,0
95943,4,2,334865,334865,334867,0,2,1
95944,5,3,334870,334870,334873,0,3,3
95945,1,2,334871,334873,334875,2,4,0
95946,5,2,334876,334876,334878,0,2,1
95947,6,2,334882,334882,334884,0,2,4
95948,5,3,334887,334887,334890,0,3,3
95949,5,3,334892,334892,334895,0,3,2
95950,3,2,334895,334895,334897,0,2,0
95951,4,1,334899,334899,334900,0,1,2
95952,2,2,334901,334901,334903,0,2,1
95953,1,2,334902,334903,334905,1,3,0
95954,3,3,334905,334905,334908,0,3,0
95955,4,2,334909,334909,334911,0,2,1
95956,5,1,334914,334914,334915,0,1,3
95957,5,1,334919,334919,334920,0,1,4
95958,1,2,334920,334920,334922,0,2,0
95959,2,2,334922,334922,334924,0,2,0
95960,2,3,334924,334924,334927,0,3,0
95961,5,2,334929,334929,334931,0,2,2
95962,6,1,334935,334935,334936,0,1,4
95963,3,2,334938,334938,334940,0,2,2
95964,6,3,334944,334944,334947,0,3,4
95965,4,1,334948,334948,334949,0,1,1
95966,5,1,334953,334953,334954,0,1,4
95967,4,3,334957,334957,334960,0,3,3
95968,2,1,334959,334960,334961,1,2,0
95969,4,1,334963,334963,334964,0,1,2
95970,2,3,334965,334965,334968,0,3,1
95971,5,1,334970,334970,334971,0,1,2
95972,6,2,334976,334976,334978,0,2,5
95973,6,2,334982,334982,334984,0,2,4
95974,3,3,334985,334985,334988,0,3,1
95975,2,3,334987,334988,334991,1,4,0
95976,2,1,334989,334991,334992,2,3,0
95977,4,2,334993,334993,334995,0,2,1
95978,6,2,334999,334999,335001,0,2,4
95979,3,3,335002,335002,335005,0,3,1
95980,2,1,335004,335005,335006,1,2,0
95981,2,3,335006,335006,335009,0,3,0
95982,4,1,335010,335010,335011,0,1,1
95983,1,2,335011,335011,335013,0,2,0
95984,4,2,335015,335015,335017,0,2,2
95985,5,3,335020,335020,335023,0,3,3
95986,2,1,335022,335023,335024,1,2,0
95987,3,2,335025,335025,335027,0,2,1
95988,5,2,335030,335030,335032,0,2,3
95989,5,1,335035,335035,335036,0,1,3
95990,6,3,335041,335041,335044,0,3,5
95991,6,2,335047,335047,335049,0,2,3
95992,2,1,335049,335049,335050,0,1,0
95993,1,2,335050,335050,335052,0,2,0
95994,6,2,335056,335056,335058,0,2,4
95995,2,2,335058,335058,335060,0,2,0
95996,3,2,335061,335061,335063,0,2,1
95997,5,2,335066,335066,335068,0,2,3
95998,2,3,335068,335068,335071,0,3,0
95999,4,3,335072,335072,335075,0,3,1
96000,3,3,335075,335075,335078,0,3,0
96001,3,2,335078,335078,335080,0,2,0
96002,3,3,335081,335081,335084,0,3,1
96003,1,3,335082,335084,335087,2,5,0
96004,2,1,335084,335087,335088,3,4,0
96005,2,3,335086,335088,335091,2,5,0
96006,5,3,335091,335091,335094,0,3,0
96007,5,2,335096,335096,335098,0,2,2
96008,1,2,335097,335098,335100,1,3,0
96009,6,1,335103,335103,335104,0,1,3
96010,4,3,335107,335107,335110,0,3,3
96011,1,3,335108,335110,335113,2,5,0
96012,1,2,335109,335113,335115,4,6,0
96013,3,2,335112,335115,335117,3,5,0
96014,3,3,335115,335117,335120,2,5,0
96015,5,3,335120,335120,335123,0,3,0
96016,2,2,335122,335123,335125,1,3,0
96017,6,3,335128,335128,335131,0,3,3
96018,2,3,335130,335131,335134,1,4,0
96019,1,2,335131,335134,335136,3,5,0
96020,2,2,335133,335136,335138,3,5,0
96021,5,3,335138,335138,335141,0,3,0
96022,5,2,335143,335143,335145,0,2,2
96023,3,2,335146,335146,335148,0,2,1
96024,3,1,335149,335149,335150,0,1,1
96025,3,2,335152,335152,335154,0,2,2
96026,3,3,335155,335155,335158,0,3,1
96027,3,3,335158,335158,335161,0,3,0
96028,4,3,335162,335162,335165,0,3,1
96029,6,1,335168,335168,335169,0,1,3
96030,5,3,335173,335173,335176,0,3,4
96031,4,3,335177,335177,335180,0,3,1
96032,1,1,335178,335180,335181,2,3,0
96033,5,1,335183,335183,335184,0,1,2
96034,5,3,335188,335188,335191,0,3,4
96035,5,2,335193,335193,335195,0,2,2
96036,3,3,335196,335196,335199,0,3,1
96037,5,3,335201,335201,335204,0,3,2
96038,4,2,335205,335205,335207,0,2,1
96039,1,3,335206,335207,335210,1,4,0
96040,4,3,335210,335210,335213,0,3,0
96041,3,1,335213,335213,335214,0,1,0
96042,6,3,335219,335219,335222,0,3,5
96043,6,3,335225,335225,335228,0,3,3
96044,2,3,335227,335228,335231,1,4,0
96045,1,1,335228,335231,335232,3,4,0
96046,6,2,335234,335234,335236,0,2,2
96047,1,2,335235,335236,335238,1,3,0
96048,1,1,335236,335238,335239,2,3,0
96049,6,2,335242,335242,335244,0,2,3
96050,3,2,335245,335245,335247,0,2,1
96051,5,3,335250,335250,335253,0,3,3
96052,5,2,335255,335255,335257,0,2,2
96053,5,1,335260,335260,335261,0,1,3
96054,3,1,335263,335263,335264,0,1,2
96055,5,3,335268,335268,335271,0,3,4
96056,1,1,335269,335271,335272,2,3,0
96057,1,2,335270,335272,335274,2,4,0
96058,2,3,335272,335274,335277,2,5,0
96059,1,2,335273,335277,335279,4,6,0
96060,2,2,335275,335279,335281,4,6,0
96061,5,3,335280,335281,335284,1,4,0
96062,1,3,335281,335284,335287,3,6,0
96063,1,2,335282,335287,335289,5,7,0
96064,6,2,335288,335289,335291,1,3,0
96065,5,1,335293,335293,335294,0,1,2
96066,1,1,335294,335294,335295,0,1,0
96067,1,1,335295,335295,335296,0,1,0
96068,4,3,335299,335299,335302,0,3,3
96069,3,1,335302,335302,335303,0,1,0
96070,4,2,335306,335306,335308,0,2,3
96071,2,2,335308,335308,335310,0,2,0
96072,6,2,335314,335314,335316,0,2,4
96073,4,3,335318,335318,335321,0,3,2
96074,3,2,335321,335321,335323,0,2,0
96075,2,1,335323,335323,335324,0,1,0
96076,5,2,335328,335328,335330,0,2,4
96077,5,2,335333,335333,335335,0,2,3
96078,3,2,335336,335336,335338,0,2,1
96079,3,1,335339,335339,335340,0,1,1
96080,1,2,335340,335340,335342,0,2,0
96081,3,1,335343,335343,335344,0,1,1
96082,1,1,335344,335344,335345,0,1,0
96083,2,1,335346,335346,335347,0,1,1
96084,2,3,335348,335348,335351,0,3,1
96085,1,1,335349,335351,335352,2,3,0
96086,3,3,335352,335352,335355,0,3,0
96087,5,2,335357,335357,335359,0,2,2
96088,6,2,335363,335363,335365,0,2,4
96089,1,2,335364,335365,335367,1,3,0
96090,1,1,335365,335367,335368,2,3,0
96091,2,2,335367,335368,335370,1,3,0
96092,6,3,335373,335373,335376,0,3,3
96093,3,1,335376,335376,335377,0,1,0
96094,4,1,335380,335380,335381,0,1,3
96095,1,3,335381,335381,335384,0,3,0
96096,5,1,335386,335386,335387,0,1,2
96097,2,1,335388,335388,335389,0,1,1
96098,3,3,335391,335391,335394,0,3,2
96099,3,1,335394,335394,335395,0,1,0
96100,1,1,335395,335395,335396,0,1,0
96101,4,2,335399,335399,335401,0,2,3
96102,5,1,335404,335404,335405,0,1,3
96103,5,1,335409,335409,335410,0,1,4
96104,1,3,335410,335410,335413,0,3,0
96105,4,1,335414,335414,335415,0,1,1
96106,6,3,335420,335420,335423,0,3,5
96107,4,3,335424,335424,335427,0,3,1
96108,6,2,335430,335430,335432,0,2,3
96109,4,2,335434,335434,335436,0,2,2
96110,5,1,335439,335439,335440,0,1,3
96111,4,1,335443,335443,335444,0,1,3
96112,2,2,335445,335445,335447,0,2,1
96113,2,1,335447,335447,335448,0,1,0
96114,4,2,335451,335451,335453,0,2,3
96115,5,3,335456,335456,335459,0,3,3
96116,5,3,335461,335461,335464,0,3,2
96117,1,3,335462,335464,335467,2,5,0
96118,1,2,335463,335467,335469,4,6,0
96119,5,3,335468,335469,335472,1,4,0
96120,4,3,335472,335472,335475,0,3,0
96121,5,2,335477,335477,335479,0,2,2
96122,5,2,335482,335482,335484,0,2,3
96123,3,1,335485,335485,335486,0,1,1
96124,3,3,335488,335488,335491,0,3,2
96125,4,1,335492,335492,335493,0,1,1
96126,2,1,335494,335494,335495,0,1,1
96127,4,1,335498,335498,335499,0,1,3
96128,6,2,335504,335504,335506,0,2,5
96129,6,1,335510,335510,335511,0,1,4
96130,4,1,335514,335514,335515,0,1,3
96131,6,1,335520,335520,335521,0,1,5
96132,2,2,335522,335522,335524,0,2,1
96133,1,3,335523,335524,335527,1,4,0
96134,5,1,335528,335528,335529,0,1,1
96135,1,2,335529,335529,335531,0,2,0
96136,3,1,335532,335532,335533,0,1,1
96137,1,1,335533,335533,335534,0,1,0
96138,4,2,335537,335537,335539,0,2,3
96139,2,3,335539,335539,335542,0,3,0
96140,6,1,335545,335545,335546,0,1,3
96141,2,1,335547,335547,335548,0,1,1
96142,3,1,335550,335550,335551,0,1,2
96143,4,2,335554,335554,335556,0,2,3
96144,4,3,335558,335558,335561,0,3,2
96145,4,2,335562,335562,335564,0,2,1
96146,3,3,335565,335565,335568,0,3,1
96147,2,2,335567,335568,335570,1,3,0
96148,1,3,335568,335570,335573,2,5,0
96149,5,2,335573,335573,335575,0,2,0
96150,4,3,335577,335577,335580,0,3,2
96151,3,1,335580,335580,335581,0,1,0
96152,6,3,335586,335586,335589,0,3,5
96153,6,2,335592,335592,335594,0,2,3
96154,2,3,335594,335594,335597,0,3,0
96155,6,1,335600,335600,335601,0,1,3
96156,5,1,335605,335605,335606,0,1,4
96157,5,1,335610,335610,335611,0,1,4
96158,3,2,335613,335613,335615,0,2,2
96159,2,3,335615,335615,335618,0,3,0
96160,6,3,335621,335621,335624,0,3,3
96161,3,2,335624,335624,335626,0,2,0
96162,5,3,335629,335629,335632,0,3,3
96163,2,1,335631,335632,335633,1,2,0
96164,6,2,335637,335637,335639,0,2,4
96165,3,2,335640,335640,335642,0,2,1
96166,1,1,335641,335642,335643,1,2,0
96167,3,2,335644,335644,335646,0,2,1
96168,5,1,335649,335649,335650,0,1,3
96169,6,1,335655,335655,335656,0,1,5
96170,4,1,335659,335659,335660,0,1,3
96171,4,3,335663,335663,335666,0,3,3
96172,2,1,335665,335666,335667,1,2,0
96173,2,1,335667,335667,335668,0,1,0
96174,3,2,335670,335670,335672,0,2,2
96175,6,2,335676,335676,335678,0,2,4
96176,5,3,335681,335681,335684,0,3,3
96177,6,1,335687,335687,335688,0,1,3
96178,2,1,335689,335689,335690,0,1,1
96179,5,2,335694,335694,335696,0,2,4
96180,3,2,335697,335697,335699,0,2,1
96181,4,2,335701,335701,335703,0,2,2
96182,5,1,335706,335706,335707,0,1,3
96183,5,2,335711,335711,335713,0,2,4
96184,2,1,335713,335713,335714,0,1,0
96185,5,1,335718,335718,335719,0,1,4
96186,4,1,335722,335722,335723,0,1,3
96187,6,3,335728,335728,335731,0,3,5
96188,6,1,335734,335734,335735,0,1,3
96189,2,2,335736,335736,335738,0,2,1
96190,6,1,335742,335742,335743,0,1,4
96191,6,2,335748,335748,335750,0,2,5
96192,2,3,335750,335750,335753,0,3,0
96193,1,3,335751,335753,335756,2,5,0
96194,4,3,335755,335756,335759,1,4,0
96195,5,2,335760,335760,335762,0,2,1
96196,3,3,335763,335763,335766,0,3,1
96197,4,3,335767,335767,335770,0,3,1
96198,1,1,335768,335770,335771,2,3,0
96199,1,2,335769,335771,335773,2,4,0
96200,1,3,335770,335773,335776,3,6,0
96201,2,1,335772,335776,335777,4,5,0
96202,4,3,335776,335777,335780,1,4,0
96203,2,2,335778,335780,335782,2,4,0
96204,1,1,335779,335782,335783,3,4,0
96205,6,3,335785,335785,335788,0,3,2
96206,6,1,335791,335791,335792,0,1,3
96207,2,3,335793,335793,335796,0,3,1
96208,2,3,335795,335796,335799,1,4,0
96209,1,3,335796,335799,335802,3,6,0
96210,2,1,335798,335802,335803,4,5,0
96211,4,2,335802,335803,335805,1,3,0
96212,3,2,335805,335805,335807,0,2,0
96213,2,1,335807,335807,335808,0,1,0
96214,6,2,335813,335813,335815,0,2,5
96215,3,1,335816,335816,335817,0,1,1
96216,3,2,335819,335819,335821,0,2,2
96217,2,1,335821,335821,335822,0,1,0
96218,3,3,335824,335824,335827,0,3,2
96219,2,1,335826,335827,335828,1,2,0
96220,4,3,335830,335830,335833,0,3,2
96221,6,1,335836,335836,335837,0,1,3
96222,1,1,335837,335837,335838,0,1,0
96223,6,3,335843,335843,335846,0,3,5
96224,5,1,335848,335848,335849,0,1,2
96225,2,2,335850,335850,335852,0,2,1
96226,4,3,335854,335854,335857,0,3,2
96227,6,2,335860,335860,335862,0,2,3
96228,5,3,335865,335865,335868,0,3,3
96229,6,3,335871,335871,335874,0,3,3
96230,3,3,335874,335874,335877,0,3,0
96231,4,1,335878,335878,335879,0,1,1
96232,5,3,335883,335883,335886,0,3,4
96233,3,1,335886,335886,335887,0,1,0
96234,4,2,335890,335890,335892,0,2,3
96235,3,1,335893,335893,335894,0,1,1
96236,5,1,335898,335898,335899,0,1,4
96237,4,3,335902,335902,335905,0,3,3
96238,1,2,335903,335905,335907,2,4,0
96239,4,1,335907,335907,335908,0,1,0
96240,2,3,335909,335909,335912,0,3,1
96241,3,3,335912,335912,335915,0,3,0
96242,5,3,335917,335917,335920,0,3,2
96243,4,1,335921,335921,335922,0,1,1
96244,4,3,335925,335925,335928,0,3,3
96245,6,2,335931,335931,335933,0,2,3
96246,4,1,335935,335935,335936,0,1,2
96247,4,3,335939,335939,335942,0,3,3
96248,5,2,335944,335944,335946,0,2,2
96249,6,2,335950,335950,335952,0,2,4
96250,5,1,335955,335955,335956,0,1,3
96251,2,3,335957,335957,335960,0,3,1
96252,5,3,335962,335962,335965,0,3,2
96253,4,1,335966,335966,335967,0,1,1
96254,1,2,335967,335967,335969,0,2,0
96255,4,1,335971,335971,335972,0,1,2
96256,5,2,335976,335976,335978,0,2,4
96257,6,3,335982,335982,335985,0,3,4
96258,5,2,335987,335987,335989,0,2,2
96259,5,2,335992,335992,335994,0,2,3
96260,5,1,335997,335997,335998,0,1,3
96261,2,3,335999,335999,336002,0,3,1
96262,4,1,336003,336003,336004,0,1,1
96263,5,2,336008,336008,336010,0,2,4
96264,2,3,336010,336010,336013,0,3,0
96265,4,1,336014,336014,336015,0,1,1
96266,6,3,336020,336020,336023,0,3,5
96267,6,1,336026,336026,336027,0,1,3
96268,2,2,336028,336028,336030,0,2,1
96269,3,1,336031,336031,336032,0,1,1
96270,3,2,336034,336034,336036,0,2,2
96271,1,1,336035,336036,336037,1,2,0
96272,4,2,336039,336039,336041,0,2,2
96273,2,1,336041,336041,336042,0,1,0
96274,5,3,336046,336046,336049,0,3,4
96275,4,3,336050,336050,336053,0,3,1
96276,6,1,336056,336056,336057,0,1,3
96277,4,2,336060,336060,336062,0,2,3
96278,2,3,336062,336062,336065,0,3,0
96279,1,2,336063,336065,336067,2,4,0
96280,5,2,336068,336068,336070,0,2,1
96281,2,1,336070,336070,336071,0,1,0
96282,4,2,336074,336074,336076,0,2,3
96283,4,1,336078,336078,336079,0,1,2
96284,1,3,336079,336079,336082,0,3,0
96285,6,1,336085,336085,336086,0,1,3
96286,5,2,336090,336090,336092,0,2,4
96287,4,2,336094,336094,336096,0,2,2
96288,3,3,336097,336097,336100,0,3,1
96289,3,3,336100,336100,336103,0,3,0
96290,1,1,336101,336103,336104,2,3,0
96291,6,3,336107,336107,336110,0,3,3
96292,5,3,336112,336112,336115,0,3,2
96293,6,1,336118,336118,336119,0,1,3
96294,5,3,336123,336123,336126,0,3,4
96295,1,2,336124,336126,336128,2,4,0
96296,5,1,336129,336129,336130,0,1,1
96297,6,1,336135,336135,336136,0,1,5
96298,1,2,336136,336136,336138,0,2,0
96299,5,3,336141,336141,336144,0,3,3
96300,1,3,336142,336144,336147,2,5,0
96301,5,3,336147,336147,336150,0,3,0
96302,1,3,336148,336150,336153,2,5,0
96303,3,2,336151,336153,336155,2,4,0
96304,6,1,336157,336157,336158,0,1,2
96305,1,3,336158,336158,336161,0,3,0
96306,4,1,336162,336162,336163,0,1,1
96307,2,1,336164,336164,336165,0,1,1
96308,3,1,336167,336167,336168,0,1,2
96309,1,3,336168,336168,336171,0,3,0
96310,4,3,336172,336172,336175,0,3,1
96311,1,1,336173,336175,336176,2,3,0
96312,1,3,336174,336176,336179,2,5,0
96313,1,3,336175,336179,336182,4,7,0
96314,2,1,336177,336182,336183,5,6,0
96315,3,3,336180,336183,336186,3,6,0
96316,4,1,336184,336186,336187,2,3,0
96317,1,2,336185,336187,336189,2,4,0
96318,6,2,336191,336191,336193,0,2,2
96319,4,2,336195,336195,336197,0,2,2
96320,3,3,336198,336198,336201,0,3,1
96321,5,1,336203,336203,336204,0,1,2
96322,5,3,336208,336208,336211,0,3,4
96323,3,1,336211,336211,336212,0,1,0
96324,3,1,336214,336214,336215,0,1,2
96325,5,3,336219,336219,336222,0,3,4
96326,1,1,336220,336222,336223,2,3,0
96327,5,1,336225,336225,336226,0,1,2
96328,6,1,336231,336231,336232,0,1,5
96329,4,3,336235,336235,336238,0,3,3
96330,3,3,336238,336238,336241,0,3,0
96331,3,3,336241,336241,336244,0,3,0
96332,2,2,336243,336244,336246,1,3,0
96333,1,3,336244,336246,336249,2,5,0
96334,6,3,336250,336250,336253,0,3,1
96335,5,1,336255,336255,336256,0,1,2
96336,6,3,336261,336261,336264,0,3,5
96337,1,3,336262,336264,336267,2,5,0
96338,4,2,336266,336267,336269,1,3,0
96339,4,2,336270,336270,336272,0,2,1
96340,3,2,336273,336273,336275,0,2,1
96341,2,3,336275,336275,336278,0,3,0
96342,1,3,336276,336278,336281,2,5,0
96343,3,3,336279,336281,336284,2,5,0
96344,1,1,336280,336284,336285,4,5,0
96345,4,3,336284,336285,336288,1,4,0
96346,6,2,336290,336290,336292,0,2,2
96347,4,1,336294,336294,336295,0,1,2
96348,6,2,336300,336300,336302,0,2,5
96349,3,1,336303,336303,336304,0,1,1
96350,4,2,336307,336307,336309,0,2,3
96351,3,2,336310,336310,336312,0,2,1
96352,1,1,336311,336312,336313,1,2,0
96353,3,2,336314,336314,336316,0,2,1
96354,5,1,336319,336319,336320,0,1,3
96355,4,1,336323,336323,336324,0,1,3
96356,4,3,336327,336327,336330,0,3,3
96357,2,1,336329,336330,336331,1,2,0
96358,6,1,336335,336335,336336,0,1,4
96359,1,1,336336,336336,336337,0,1,0
96360,1,1,336337,336337,336338,0,1,0
96361,2,3,336339,336339,336342,0,3,1
96362,4,1,336343,336343,336344,0,1,1
96363,6,3,336349,336349,336352,0,3,5
96364,1,2,336350,336352,336354,2,4,0
96365,2,3,336352,336354,336357,2,5,0
96366,2,3,336354,336357,336360,3,6,0
96367,6,1,336360,336360,336361,0,1,0
96368,5,3,336365,336365,336368,0,3,4
96369,1,3,336366,336368,336371,2,5,0
96370,1,3,336367,336371,336374,4,7,0
96371,6,2,336373,336374,336376,1,3,0
96372,4,2,336377,336377,336379,0,2,1
96373,1,2,336378,336379,336381,1,3,0
96374,6,1,336384,336384,336385,0,1,3
96375,1,1,336385,336385,336386,0,1,0
96376,5,3,336390,336390,336393,0,3,4
96377,3,2,336393,336393,336395,0,2,0
96378,2,2,336395,336395,336397,0,2,0
96379,6,3,336401,336401,336404,0,3,4
96380,6,1,336407,336407,336408,0,1,3
96381,5,2,336412,336412,336414,0,2,4
96382,4,3,336416,336416,336419,0,3,2
96383,1,3,336417,336419,336422,2,5,0
96384,5,2,336422,336422,336424,0,2,0
96385,1,3,336423,336424,336427,1,4,0
96386,4,3,336427,336427,336430,0,3,0
96387,3,3,336430,336430,336433,0,3,0
96388,2,1,336432,336433,336434,1,2,0
96389,6,1,336438,336438,336439,0,1,4
96390,3,3,336441,336441,336444,0,3,2
96391,2,2,336443,336444,336446,1,3,0
96392,4,1,336447,336447,336448,0,1,1
96393,5,3,336452,336452,336455,0,3,4
96394,1,3,336453,336455,336458,2,5,0
96395,3,2,336456,336458,336460,2,4,0
96396,6,2,336462,336462,336464,0,2,2
96397,5,3,336467,336467,336470,0,3,3
96398,4,2,336471,336471,336473,0,2,1
96399,5,3,336476,336476,336479,0,3,3
96400,3,2,336479,336479,336481,0,2,0
96401,5,1,336484,336484,336485,0,1,3
96402,5,3,336489,336489,336492,0,3,4
96403,5,2,336494,336494,336496,0,2,2
96404,6,1,336500,336500,336501,0,1,4
96405,5,1,336505,336505,336506,0,1,4
96406,4,3,336509,336509,336512,0,3,3
96407,4,3,336513,336513,336516,0,3,1
96408,5,2,336518,336518,336520,0,2,2
96409,2,1,336520,336520,336521,0,1,0
96410,1,1,336521,336521,336522,0,1,0
96411,5,1,336526,336526,336527,0,1,4
96412,6,2,336532,336532,336534,0,2,5
96413,6,2,336538,336538,336540,0,2,4
96414,4,1,336542,336542,336543,0,1,2
96415,5,1,336547,336547,336548,0,1,4
96416,2,1,336549,336549,336550,0,1,1
96417,2,3,336551,336551,336554,0,3,1
96418,1,3,336552,336554,336557,2,5,0
96419,6,2,336558,336558,336560,0,2,1
96420,2,1,336560,336560,336561,0,1,0
96421,3,3,336563,336563,336566,0,3,2
96422,1,1,336564,336566,336567,2,3,0
96423,2,1,336566,336567,336568,1,2,0
96424,2,1,336568,336568,336569,0,1,0
96425,5,3,336573,336573,336576,0,3,4
96426,4,2,336577,336577,336579,0,2,1
96427,2,2,336579,336579,336581,0,2,0
96428,4,1,336583,336583,336584,0,1,2
96429,6,2,336589,336589,336591,0,2,5
96430,4,1,336593,336593,336594,0,1,2
96431,1,1,336594,336594,336595,0,1,0
96432,1,1,336595,336595,336596,0,1,0
96433,1,2,336596,336596,336598,0,2,0
96434,1,1,336597,336598,336599,1,2,0
96435,1,1,336598,336599,336600,1,2,0
96436,2,2,336600,336600,336602,0,2,0
96437,2,1,336602,336602,336603,0,1,0
96438,5,1,336607,336607,336608,0,1,4
96439,4,3,336611,336611,336614,0,3,3
96440,2,2,336613,336614,336616,1,3,0
96441,3,1,336616,336616,336617,0,1,0
96442,4,3,336620,336620,336623,0,3,3
96443,4,1,336624,336624,336625,0,1,1
96444,4,1,336628,336628,336629,0,1,3
96445,1,2,336629,336629,336631,0,2,0
96446,4,3,336633,336633,336636,0,3,2
96447,2,2,336635,336636,336638,1,3,0
96448,6,2,336641,336641,336643,0,2,3
96449,3,3,336644,336644,336647,0,3,1
96450,1,3,336645,336647,336650,2,5,0
96451,4,3,336649,336650,336653,1,4,0
96452,2,3,336651,336653,336656,2,5,0
96453,6,3,336657,336657,336660,0,3,1
96454,1,2,336658,336660,336662,2,4,0
96455,1,2,336659,336662,336664,3,5,0
96456,4,2,336663,336664,336666,1,3,0
96457,3,3,336666,336666,336669,0,3,0
96458,5,2,336671,336671,336673,0,2,2
96459,1,2,336672,336673,336675,1,3,0
96460,6,3,336678,336678,336681,0,3,3
96461,1,1,336679,336681,336682,2,3,0
96462,5,2,336684,336684,336686,0,2,2
96463,4,1,336688,336688,336689,0,1,2
96464,2,3,336690,336690,336693,0,3,1
96465,6,3,336696,336696,336699,0,3,3
96466,6,3,336702,336702,336705,0,3,3
96467,1,3,336703,336705,336708,2,5,0
96468,3,2,336706,336708,336710,2,4,0
96469,4,1,336710,336710,336711,0,1,0
96470,5,2,336715,336715,336717,0,2,4
96471,4,2,336719,336719,336721,0,2,2
96472,3,1,336722,336722,336723,0,1,1
96473,1,2,336723,336723,336725,0,2,0
96474,2,2,336725,336725,336727,0,2,0
96475,3,1,336728,336728,336729,0,1,1
96476,2,3,336730,336730,336733,0,3,1
96477,1,1,336731,336733,336734,2,3,0
96478,3,2,336734,336734,336736,0,2,0
96479,1,3,336735,336736,336739,1,4,0
96480,3,1,336738,336739,336740,1,2,0
96481,2,2,336740,336740,336742,0,2,0
96482,1,1,336741,336742,336743,1,2,0
96483,1,2,336742,336743,336745,1,3,0
96484,2,1,336744,336745,336746,1,2,0
96485,1,3,336745,336746,336749,1,4,0
96486,6,3,336751,336751,336754,0,3,2
96487,3,3,336754,336754,336757,0,3,0
96488,2,1,336756,336757,336758,1,2,0
96489,3,2,336759,336759,336761,0,2,1
96490,3,2,336762,336762,336764,0,2,1
96491,4,3,336766,336766,336769,0,3,2
96492,1,1,336767,336769,336770,2,3,0
96493,2,1,336769,336770,336771,1,2,0
96494,2,3,336771,336771,336774,0,3,0
96495,4,3,336775,336775,336778,0,3,1
96496,4,2,336779,336779,336781,0,2,1
96497,3,1,336782,336782,336783,0,1,1
96498,3,1,336785,336785,336786,0,1,2
96499,4,1,336789,336789,336790,0,1,3
96500,5,1,336794,336794,336795,0,1,4
96501,6,1,336800,336800,336801,0,1,5
96502,6,2,336806,336806,336808,0,2,5
96503,2,3,336808,336808,336811,0,3,0
96504,4,1,336812,336812,336813,0,1,1
96505,5,3,336817,336817,336820,0,3,4
96506,4,1,336821,336821,336822,0,1,1
96507,3,3,336824,336824,336827,0,3,2
96508,4,1,336828,336828,336829,0,1,1
96509,5,3,336833,336833,336836,0,3,4
96510,4,3,336837,336837,336840,0,3,1
96511,5,1,336842,336842,336843,0,1,2
96512,6,2,336848,336848,336850,0,2,5
96513,4,3,336852,336852,336855,0,3,2
96514,6,3,336858,336858,336861,0,3,3
96515,6,2,336864,336864,336866,0,2,3
96516,3,1,336867,336867,336868,0,1,1
96517,4,2,336871,336871,336873,0,2,3
96518,1,1,336872,336873,336874,1,2,0
96519,6,2,336878,336878,336880,0,2,4
96520,6,2,336884,336884,336886,0,2,4
96521,6,2,336890,336890,336892,0,2,4
96522,5,1,336895,336895,336896,0,1,3
96523,5,2,336900,336900,336902,0,2,4
96524,1,1,336901,336902,336903,1,2,0
96525,6,3,336907,336907,336910,0,3,4
96526,3,1,336910,336910,336911,0,1,0
96527,3,3,336913,336913,336916,0,3,2
96528,6,1,336919,336919,336920,0,1,3
96529,4,1,336923,336923,336924,0,1,3
96530,5,1,336928,336928,336929,0,1,4
96531,5,3,336933,336933,336936,0,3,4
96532,1,1,336934,336936,336937,2,3,0
96533,1,1,336935,336937,336938,2,3,0
96534,5,2,336940,336940,336942,0,2,2
96535,6,1,336946,336946,336947,0,1,4
96536,2,1,336948,336948,336949,0,1,1
96537,6,3,336954,336954,336957,0,3,5
96538,3,1,336957,336957,336958,0,1,0
96539,6,3,336963,336963,336966,0,3,5
96540,6,2,336969,336969,336971,0,2,3
96541,4,3,336973,336973,336976,0,3,2
96542,5,3,336978,336978,336981,0,3,2
96543,1,3,336979,336981,336984,2,5,0
96544,6,1,336985,336985,336986,0,1,1
96545,1,2,336986,336986,336988,0,2,0
96546,6,2,336992,336992,336994,0,2,4
96547,4,2,336996,336996,336998,0,2,2
96548,3,2,336999,336999,337001,0,2,1
96549,2,3,337001,337001,337004,0,3,0
96550,5,2,337006,337006,337008,0,2,2
96551,3,1,337009,337009,337010,0,1,1
96552,6,2,337015,337015,337017,0,2,5
96553,6,3,337021,337021,337024,0,3,4
96554,5,3,337026,337026,337029,0,3,2
96555,6,2,337032,337032,337034,0,2,3
96556,4,2,337036,337036,337038,0,2,2
96557,3,1,337039,337039,337040,0,1,1
96558,5,1,337044,337044,337045,0,1,4
96559,3,3,337047,337047,337050,0,3,2
96560,3,3,337050,337050,337053,0,3,0
96561,2,1,337052,337053,337054,1,2,0
96562,4,3,337056,337056,337059,0,3,2
96563,2,1,337058,337059,337060,1,2,0
96564,2,2,337060,337060,337062,0,2,0
96565,5,2,337065,337065,337067,0,2,3
96566,5,2,337070,337070,337072,0,2,3
96567,5,2,337075,337075,337077,0,2,3
96568,3,1,337078,337078,337079,0,1,1
96569,4,3,337082,337082,337085,0,3,3
96570,2,1,337084,337085,337086,1,2,0
96571,5,1,337089,337089,337090,0,1,3
96572,6,1,337095,337095,337096,0,1,5
96573,1,3,337096,337096,337099,0,3,0
96574,3,1,337099,337099,337100,0,1,0
96575,6,2,337105,337105,337107,0,2,5
96576,4,2,337109,337109,337111,0,2,2
96577,2,3,337111,337111,337114,0,3,0
96578,2,2,337113,337114,337116,1,3,0
96579,5,2,337118,337118,337120,0,2,2
96580,5,2,337123,337123,337125,0,2,3
96581,3,2,337126,337126,337128,0,2,1
96582,2,1,337128,337128,337129,0,1,0
96583,6,1,337134,337134,337135,0,1,5
96584,5,1,337139,337139,337140,0,1,4
96585,3,1,337142,337142,337143,0,1,2
96586,4,2,337146,337146,337148,0,2,3
96587,5,3,337151,337151,337154,0,3,3
96588,3,1,337154,337154,337155,0,1,0
96589,1,2,337155,337155,337157,0,2,0
96590,2,1,337157,337157,337158,0,1,0
96591,6,2,337163,337163,337165,0,2,5
96592,3,1,337166,337166,337167,0,1,1
96593,6,3,337172,337172,337175,0,3,5
96594,6,2,337178,337178,337180,0,2,3
96595,4,3,337182,337182,337185,0,3,2
96596,4,3,337186,337186,337189,0,3,1
96597,3,3,337189,337189,337192,0,3,0
96598,5,1,337194,337194,337195,0,1,2
96599,6,1,337200,337200,337201,0,1,5
96600,5,1,337205,337205,337206,0,1,4
96601,3,2,337208,337208,337210,0,2,2
96602,4,3,337212,337212,337215,0,3,2
96603,4,1,337216,337216,337217,0,1,1
96604,6,3,337222,337222,337225,0,3,5
96605,1,2,337223,337225,337227,2,4,0
96606,3,1,337226,337227,337228,1,2,0
96607,1,3,337227,337228,337231,1,4,0
96608,6,1,337233,337233,337234,0,1,2
96609,6,3,337239,337239,337242,0,3,5
96610,1,1,337240,337242,337243,2,3,0
96611,4,1,337244,337244,337245,0,1,1
96612,4,3,337248,337248,337251,0,3,3
96613,4,3,337252,337252,337255,0,3,1
96614,4,2,337256,337256,337258,0,2,1
96615,2,1,337258,337258,337259,0,1,0
96616,6,3,337264,337264,337267,0,3,5
96617,2,2,337266,337267,337269,1,3,0
96618,1,1,337267,337269,337270,2,3,0
96619,1,1,337268,337270,337271,2,3,0
96620,2,1,337270,337271,337272,1,2,0
96621,4,1,337274,337274,337275,0,1,2
96622,5,1,337279,337279,337280,0,1,4
96623,6,1,337285,337285,337286,0,1,5
96624,4,2,337289,337289,337291,0,2,3
96625,6,3,337295,337295,337298,0,3,4
96626,5,1,337300,337300,337301,0,1,2
96627,3,2,337303,337303,337305,0,2,2
96628,3,1,337306,337306,337307,0,1,1
96629,4,3,337310,337310,337313,0,3,3
96630,1,1,337311,337313,337314,2,3,0
96631,3,1,337314,337314,337315,0,1,0
96632,4,3,337318,337318,337321,0,3,3
96633,1,1,337319,337321,337322,2,3,0
96634,3,1,337322,337322,337323,0,1,0
96635,1,2,337323,337323,337325,0,2,0
96636,3,3,337326,337326,337329,0,3,1
96637,6,2,337332,337332,337334,0,2,3
96638,2,3,337334,337334,337337,0,3,0
96639,6,2,337340,337340,337342,0,2,3
96640,3,3,337343,337343,337346,0,3,1
96641,1,2,337344,337346,337348,2,4,0
96642,1,2,337345,337348,337350,3,5,0
96643,1,2,337346,337350,337352,4,6,0
96644,6,2,337352,337352,337354,0,2,0
96645,2,3,337354,337354,337357,0,3,0
96646,3,1,337357,337357,337358,0,1,0
96647,1,1,337358,337358,337359,0,1,0
96648,3,1,337361,337361,337362,0,1,2
96649,2,2,337363,337363,337365,0,2,1
96650,2,2,337365,337365,337367,0,2,0
96651,6,3,337371,337371,337374,0,3,4
96652,5,1,337376,337376,337377,0,1,2
96653,6,2,337382,337382,337384,0,2,5
96654,5,3,337387,337387,337390,0,3,3
96655,1,1,337388,337390,337391,2,3,0
96656,6,3,337394,337394,337397,0,3,3
96657,4,1,337398,337398,337399,0,1,1
96658,4,2,337402,337402,337404,0,2,3
96659,6,2,337408,337408,337410,0,2,4
96660,2,2,337410,337410,337412,0,2,0
96661,6,2,337416,337416,337418,0,2,4
96662,6,1,337422,337422,337423,0,1,4
96663,3,2,337425,337425,337427,0,2,2
96664,3,3,337428,337428,337431,0,3,1
96665,3,3,337431,337431,337434,0,3,0
96666,5,3,337436,337436,337439,0,3,2
96667,4,3,337440,337440,337443,0,3,1
96668,1,1,337441,337443,337444,2,3,0
96669,5,3,337446,337446,337449,0,3,2
96670,6,1,337452,337452,337453,0,1,3
96671,3,1,337455,337455,337456,0,1,2
96672,5,3,337460,337460,337463,0,3,4
96673,6,2,337466,337466,337468,0,2,3
96674,3,2,337469,337469,337471,0,2,1
96675,6,1,337475,337475,337476,0,1,4
96676,2,3,337477,337477,337480,0,3,1
96677,4,3,337481,337481,337484,0,3,1
96678,1,2,337482,337484,337486,2,4,0
96679,3,2,337485,337486,337488,1,3,0
96680,2,3,337487,337488,337491,1,4,0
96681,6,3,337493,337493,337496,0,3,2
96682,6,3,337499,337499,337502,0,3,3
96683,1,2,337500,337502,337504,2,4,0
96684,3,3,337503,337504,337507,1,4,0
96685,1,2,337504,337507,337509,3,5,0
96686,4,2,337508,337509,337511,1,3,0
96687,1,2,337509,337511,337513,2,4,0
96688,2,2,337511,337513,337515,2,4,0
96689,4,2,337515,337515,337517,0,2,0
96690,4,3,337519,337519,337522,0,3,2
96691,1,1,337520,337522,337523,2,3,0
96692,6,2,337526,337526,337528,0,2,3
96693,2,1,337528,337528,337529,0,1,0
96694,4,2,337532,337532,337534,0,2,3
96695,2,1,337534,337534,337535,0,1,0
96696,5,1,337539,337539,337540,0,1,4
96697,3,1,337542,337542,337543,0,1,2
96698,5,3,337547,337547,337550,0,3,4
96699,4,2,337551,337551,337553,0,2,1
96700,2,3,337553,337553,337556,0,3,0
96701,1,2,337554,337556,337558,2,4,0
96702,4,2,337558,337558,337560,0,2,0
96703,1,2,337559,337560,337562,1,3,0
96704,3,1,337562,337562,337563,0,1,0
96705,1,2,337563,337563,337565,0,2,0
96706,2,2,337565,337565,337567,0,2,0
96707,5,1,337570,337570,337571,0,1,3
96708,4,1,337574,337574,337575,0,1,3
96709,2,2,337576,337576,337578,0,2,1
96710,2,2,337578,337578,337580,0,2,0
96711,4,1,337582,337582,337583,0,1,2
96712,3,3,337585,337585,337588,0,3,2
96713,3,1,337588,337588,337589,0,1,0
96714,5,3,337593,337593,337596,0,3,4
96715,2,3,337595,337596,337599,1,4,0
96716,4,1,337599,337599,337600,0,1,0
96717,4,1,337603,337603,337604,0,1,3
96718,6,3,337609,337609,337612,0,3,5
96719,2,3,337611,337612,337615,1,4,0
96720,1,2,337612,337615,337617,3,5,0
96721,3,1,337615,337617,337618,2,3,0
96722,2,3,337617,337618,337621,1,4,0
96723,4,2,337621,337621,337623,0,2,0
96724,1,2,337622,337623,337625,1,3,0
96725,5,2,337627,337627,337629,0,2,2
96726,2,2,337629,337629,337631,0,2,0
96727,6,2,337635,337635,337637,0,2,4
96728,3,3,337638,337638,337641,0,3,1
96729,2,1,337640,337641,337642,1,2,0
96730,5,2,337645,337645,337647,0,2,3
96731,3,1,337648,337648,337649,0,1,1
96732,1,2,337649,337649,337651,0,2,0
96733,1,3,337650,337651,337654,1,4,0
96734,6,3,337656,337656,337659,0,3,2
96735,6,1,337662,337662,337663,0,1,3
96736,6,2,337668,337668,337670,0,2,5
96737,3,1,337671,337671,337672,0,1,1
96738,2,2,337673,337673,337675,0,2,1
96739,1,2,337674,337675,337677,1,3,0
96740,2,2,337676,337677,337679,1,3,0
96741,1,1,337677,337679,337680,2,3,0
96742,5,3,337682,337682,337685,0,3,2
96743,6,3,337688,337688,337691,0,3,3
96744,6,2,337694,337694,337696,0,2,3
96745,3,2,337697,337697,337699,0,2,1
96746,5,3,337702,337702,337705,0,3,3
96747,6,1,337708,337708,337709,0,1,3
96748,5,1,337713,337713,337714,0,1,4
96749,3,2,337716,337716,337718,0,2,2
96750,6,2,337722,337722,337724,0,2,4
96751,5,2,337727,337727,337729,0,2,3
96752,1,1,337728,337729,337730,1,2,0
96753,4,3,337732,337732,337735,0,3,2
96754,5,3,337737,337737,337740,0,3,2
96755,1,2,337738,337740,337742,2,4,0
96756,3,1,337741,337742,337743,1,2,0
96757,5,1,337746,337746,337747,0,1,3
96758,3,3,337749,337749,337752,0,3,2
96759,4,2,337753,337753,337755,0,2,1
96760,4,3,337757,337757,337760,0,3,2
96761,6,1,337763,337763,337764,0,1,3
96762,1,3,337764,337764,337767,0,3,0
96763,3,1,337767,337767,337768,0,1,0
96764,6,3,337773,337773,337776,0,3,5
96765,5,2,337778,337778,337780,0,2,2
96766,5,3,337783,337783,337786,0,3,3
96767,1,1,337784,337786,337787,2,3,0
96768,5,2,337789,337789,337791,0,2,2
96769,6,1,337795,337795,337796,0,1,4
96770,5,2,337800,337800,337802,0,2,4
96771,3,1,337803,337803,337804,0,1,1
96772,4,2,337807,337807,337809,0,2,3
96773,3,1,337810,337810,337811,0,1,1
96774,6,1,337816,337816,337817,0,1,5
96775,1,3,337817,337817,337820,0,3,0
96776,4,1,337821,337821,337822,0,1,1
96777,1,1,337822,337822,337823,0,1,0
96778,3,2,337825,337825,337827,0,2,2
96779,6,1,337831,337831,337832,0,1,4
96780,2,3,337833,337833,337836,0,3,1
96781,6,2,337839,337839,337841,0,2,3
96782,5,1,337844,337844,337845,0,1,3
96783,4,2,337848,337848,337850,0,2,3
96784,4,2,337852,337852,337854,0,2,2
96785,6,3,337858,337858,337861,0,3,4
96786,6,1,337864,337864,337865,0,1,3
96787,2,3,337866,337866,337869,0,3,1
96788,6,3,337872,337872,337875,0,3,3
96789,2,1,337874,337875,337876,1,2,0
96790,5,3,337879,337879,337882,0,3,3
96791,2,3,337881,337882,337885,1,4,0
96792,5,1,337886,337886,337887,0,1,1
96793,1,2,337887,337887,337889,0,2,0
96794,5,2,337892,337892,337894,0,2,3
96795,2,1,337894,337894,337895,0,1,0
96796,3,1,337897,337897,337898,0,1,2
96797,5,1,337902,337902,337903,0,1,4
96798,4,1,337906,337906,337907,0,1,3
96799,4,2,337910,337910,337912,0,2,3
96800,2,3,337912,337912,337915,0,3,0
96801,2,3,337914,337915,337918,1,4,0
96802,4,3,337918,337918,337921,0,3,0
96803,1,1,337919,337921,337922,2,3,0
96804,4,1,337923,337923,337924,0,1,1
96805,6,1,337929,337929,337930,0,1,5
96806,6,1,337935,337935,337936,0,1,5
96807,4,2,337939,337939,337941,0,2,3
96808,1,3,337940,337941,337944,1,4,0
96809,5,2,337945,337945,337947,0,2,1
96810,5,2,337950,337950,337952,0,2,3
96811,6,2,337956,337956,337958,0,2,4
96812,6,3,337962,337962,337965,0,3,4
96813,4,1,337966,337966,337967,0,1,1
96814,4,1,337970,337970,337971,0,1,3
96815,2,2,337972,337972,337974,0,2,1
96816,6,1,337978,337978,337979,0,1,4
96817,3,3,337981,337981,337984,0,3,2
96818,5,3,337986,337986,337989,0,3,2
96819,4,1,337990,337990,337991,0,1,1
96820,1,3,337991,337991,337994,0,3,0
96821,2,1,337993,337994,337995,1,2,0
96822,4,3,337997,337997,338000,0,3,2
96823,2,3,337999,338000,338003,1,4,0
96824,5,2,338004,338004,338006,0,2,1
96825,3,2,338007,338007,338009,0,2,1
96826,3,2,338010,338010,338012,0,2,1
96827,4,1,338014,338014,338015,0,1,2
96828,3,1,338017,338017,338018,0,1,2
96829,3,2,338020,338020,338022,0,2,2
96830,6,1,338026,338026,338027,0,1,4
96831,3,3,338029,338029,338032,0,3,2
96832,1,2,338030,338032,338034,2,4,0
96833,1,2,338031,338034,338036,3,5,0
96834,5,3,338036,338036,338039,0,3,0
96835,3,1,338039,338039,338040,0,1,0
96836,1,3,338040,338040,338043,0,3,0
96837,5,1,338045,338045,338046,0,1,2
96838,6,2,338051,338051,338053,0,2,5
96839,1,2,338052,338053,338055,1,3,0
96840,3,2,338055,338055,338057,0,2,0
96841,3,1,338058,338058,338059,0,1,1
96842,3,3,338061,338061,338064,0,3,2
96843,3,2,338064,338064,338066,0,2,0
96844,3,2,338067,338067,338069,0,2,1
96845,2,1,338069,338069,338070,0,1,0
96846,5,3,338074,338074,338077,0,3,4
96847,5,1,338079,338079,338080,0,1,2
96848,6,3,338085,338085,338088,0,3,5
96849,1,2,338086,338088,338090,2,4,0
96850,2,1,338088,338090,338091,2,3,0
96851,3,3,338091,338091,338094,0,3,0
96852,2,1,338093,338094,338095,1,2,0
96853,1,2,338094,338095,338097,1,3,0
96854,4,1,338098,338098,338099,0,1,1
96855,3,2,338101,338101,338103,0,2,2
96856,3,3,338104,338104,338107,0,3,1
96857,4,2,338108,338108,338110,0,2,1
96858,3,1,338111,338111,338112,0,1,1
96859,4,3,338115,338115,338118,0,3,3
96860,5,3,338120,338120,338123,0,3,2
96861,3,2,338123,338123,338125,0,2,0
96862,1,1,338124,338125,338126,1,2,0
96863,2,1,338126,338126,338127,0,1,0
96864,1,2,338127,338127,338129,0,2,0
96865,1,3,338128,338129,338132,1,4,0
96866,3,2,338131,338132,338134,1,3,0
96867,2,3,338133,338134,338137,1,4,0
96868,4,1,338137,338137,338138,0,1,0
96869,3,1,338140,338140,338141,0,1,2
96870,3,1,338143,338143,338144,0,1,2
96871,3,3,338146,338146,338149,0,3,2
96872,4,3,338150,338150,338153,0,3,1
96873,2,3,338152,338153,338156,1,4,0
96874,6,2,338158,338158,338160,0,2,2
96875,2,2,338160,338160,338162,0,2,0
96876,5,3,338165,338165,338168,0,3,3
96877,6,3,338171,338171,338174,0,3,3
96878,6,1,338177,338177,338178,0,1,3
96879,5,1,338182,338182,338183,0,1,4
96880,5,3,338187,338187,338190,0,3,4
96881,5,1,338192,338192,338193,0,1,2
96882,5,3,338197,338197,338200,0,3,4
96883,6,3,338203,338203,338206,0,3,3
96884,3,2,338206,338206,338208,0,2,0
96885,4,1,338210,338210,338211,0,1,2
96886,4,2,338214,338214,338216,0,2,3
96887,4,3,338218,338218,338221,0,3,2
96888,5,3,338223,338223,338226,0,3,2
96889,6,1,338229,338229,338230,0,1,3
96890,1,1,338230,338230,338231,0,1,0
96891,1,1,338231,338231,338232,0,1,0
96892,5,1,338236,338236,338237,0,1,4
96893,1,3,338237,338237,338240,0,3,0
96894,5,1,338242,338242,338243,0,1,2
96895,2,2,338244,338244,338246,0,2,1
96896,6,3,338250,338250,338253,0,3,4
96897,1,2,338251,338253,338255,2,4,0
96898,5,3,338256,338256,338259,0,3,1
96899,5,2,338261,338261,338263,0,2,2
96900,2,1,338263,338263,338264,0,1,0
96901,1,2,338264,338264,338266,0,2,0
96902,2,2,338266,338266,338268,0,2,0
96903,5,2,338271,338271,338273,0,2,3
96904,6,1,338277,338277,338278,0,1,4
96905,6,2,338283,338283,338285,0,2,5
96906,3,2,338286,338286,338288,0,2,1
96907,1,1,338287,338288,338289,1,2,0
96908,3,3,338290,338290,338293,0,3,1
96909,3,2,338293,338293,338295,0,2,0
96910,6,1,338299,338299,338300,0,1,4
96911,1,3,338300,338300,338303,0,3,0
96912,3,2,338303,338303,338305,0,2,0
96913,6,1,338309,338309,338310,0,1,4
96914,5,3,338314,338314,338317,0,3,4
96915,2,1,338316,338317,338318,1,2,0
96916,1,3,338317,338318,338321,1,4,0
96917,6,2,338323,338323,338325,0,2,2
96918,4,1,338327,338327,338328,0,1,2
96919,2,3,338329,338329,338332,0,3,1
96920,5,3,338334,338334,338337,0,3,2
96921,4,1,338338,338338,338339,0,1,1
96922,2,1,338340,338340,338341,0,1,1
96923,5,3,338345,338345,338348,0,3,4
96924,1,3,338346,338348,338351,2,5,0
96925,1,1,338347,338351,338352,4,5,0
96926,2,1,338349,338352,338353,3,4,0
96927,5,2,338354,338354,338356,0,2,1
96928,4,2,338358,338358,338360,0,2,2
96929,5,1,338363,338363,338364,0,1,3
96930,3,3,338366,338366,338369,0,3,2
96931,3,3,338369,338369,338372,0,3,0
96932,4,2,338373,338373,338375,0,2,1
96933,2,3,338375,338375,338378,0,3,0
96934,4,2,338379,338379,338381,0,2,1
96935,5,2,338384,338384,338386,0,2,3
96936,5,2,338389,338389,338391,0,2,3
96937,5,2,338394,338394,338396,0,2,3
96938,4,2,338398,338398,338400,0,2,2
96939,1,1,338399,338400,338401,1,2,0
96940,5,2,338404,338404,338406,0,2,3
96941,1,3,338405,338406,338409,1,4,0
96942,4,1,338409,338409,338410,0,1,0
96943,4,1,338413,338413,338414,0,1,3
96944,2,1,338415,338415,338416,0,1,1
96945,2,2,338417,338417,338419,0,2,1
96946,6,3,338423,338423,338426,0,3,4
96947,4,1,338427,338427,338428,0,1,1
96948,3,1,338430,338430,338431,0,1,2
96949,1,3,338431,338431,338434,0,3,0
96950,5,3,338436,338436,338439,0,3,2
96951,3,1,338439,338439,338440,0,1,0
96952,1,1,338440,338440,338441,0,1,0
96953,4,3,338444,338444,338447,0,3,3
96954,6,1,338450,338450,338451,0,1,3
96955,3,3,338453,338453,338456,0,3,2
96956,3,3,338456,338456,338459,0,3,0
96957,1,1,338457,338459,338460,2,3,0
96958,4,3,338461,338461,338464,0,3,1
96959,6,2,338467,338467,338469,0,2,3
96960,4,1,338471,338471,338472,0,1,2
96961,4,1,338475,338475,338476,0,1,3
96962,5,1,338480,338480,338481,0,1,4
96963,3,2,338483,338483,338485,0,2,2
96964,6,3,338489,338489,338492,0,3,4
96965,2,2,338491,338492,338494,1,3,0
96966,2,2,338493,338494,338496,1,3,0
96967,6,3,338499,338499,338502,0,3,3
96968,2,2,338501,338502,338504,1,3,0
96969,3,3,338504,338504,338507,0,3,0
96970,6,2,338510,338510,338512,0,2,3
96971,1,3,338511,338512,338515,1,4,0
96972,3,1,338514,338515,338516,1,2,0
96973,5,1,338519,338519,338520,0,1,3
96974,4,2,338523,338523,338525,0,2,3
96975,3,3,338526,338526,338529,0,3,1
96976,5,1,338531,338531,338532,0,1,2
96977,1,3,338532,338532,338535,0,3,0
96978,2,1,338534,338535,338536,1,2,0
96979,4,1,338538,338538,338539,0,1,2
96980,1,2,338539,338539,338541,0,2,0
96981,2,2,338541,338541,338543,0,2,0
96982,4,1,338545,338545,338546,0,1,2
96983,3,2,338548,338548,338550,0,2,2
96984,1,2,338549,338550,338552,1,3,0
96985,6,2,338555,338555,338557,0,2,3
96986,4,3,338559,338559,338562,0,3,2
96987,2,2,338561,338562,338564,1,3,0
96988,2,3,338563,338564,338567,1,4,0
96989,5,3,338568,338568,338571,0,3,1
96990,4,1,338572,338572,338573,0,1,1
96991,1,3,338573,338573,338576,0,3,0
96992,1,2,338574,338576,338578,2,4,0
96993,4,2,338578,338578,338580,0,2,0
96994,2,1,338580,338580,338581,0,1,0
96995,2,3,338582,338582,338585,0,3,1
96996,5,3,338587,338587,338590,0,3,2
96997,6,2,338593,338593,338595,0,2,3
96998,6,1,338599,338599,338600,0,1,4
96999,5,2,338604,338604,338606,0,2,4
97000,6,3,338610,338610,338613,0,3,4
97001,5,2,338615,338615,338617,0,2,2
97002,5,3,338620,338620,338623,0,3,3
97003,2,3,338622,338623,338626,1,4,0
97004,1,1,338623,338626,338627,3,4,0
97005,1,2,338624,338627,338629,3,5,0
97006,6,2,338630,338630,338632,0,2,1
97007,3,2,338633,338633,338635,0,2,1
97008,5,3,338638,338638,338641,0,3,3
97009,4,1,338642,338642,338643,0,1,1
97010,1,1,338643,338643,338644,0,1,0
97011,1,2,338644,338644,338646,0,2,0
97012,6,1,338650,338650,338651,0,1,4
97013,2,2,338652,338652,338654,0,2,1
97014,2,2,338654,338654,338656,0,2,0
97015,1,3,338655,338656,338659,1,4,0
97016,6,1,338661,338661,338662,0,1,2
97017,1,2,338662,338662,338664,0,2,0
97018,1,1,338663,338664,338665,1,2,0
97019,4,3,338667,338667,338670,0,3,2
97020,3,2,338670,338670,338672,0,2,0
97021,5,1,338675,338675,338676,0,1,3
97022,2,3,338677,338677,338680,0,3,1
97023,2,3,338679,338680,338683,1,4,0
97024,2,2,338681,338683,338685,2,4,0
97025,1,1,338682,338685,338686,3,4,0
97026,3,1,338685,338686,338687,1,2,0
97027,1,1,338686,338687,338688,1,2,0
97028,2,1,338688,338688,338689,0,1,0
97029,2,2,338690,338690,338692,0,2,1
97030,3,1,338693,338693,338694,0,1,1
97031,4,3,338697,338697,338700,0,3,3
97032,5,3,338702,338702,338705,0,3,2
97033,2,1,338704,338705,338706,1,2,0
97034,4,1,338708,338708,338709,0,1,2
97035,5,2,338713,338713,338715,0,2,4
97036,1,3,338714,338715,338718,1,4,0
97037,5,2,338719,338719,338721,0,2,1
97038,6,1,338725,338725,338726,0,1,4
97039,5,2,338730,338730,338732,0,2,4
97040,4,1,338734,338734,338735,0,1,2
97041,4,3,338738,338738,338741,0,3,3
97042,2,2,338740,338741,338743,1,3,0
97043,2,2,338742,338743,338745,1,3,0
97044,6,2,338748,338748,338750,0,2,3
97045,4,1,338752,338752,338753,0,1,2
97046,4,3,338756,338756,338759,0,3,3
97047,1,1,338757,338759,338760,2,3,0
97048,5,2,338762,338762,338764,0,2,2
97049,1,1,338763,338764,338765,1,2,0
97050,6,2,338769,338769,338771,0,2,4
97051,6,1,338775,338775,338776,0,1,4
97052,5,1,338780,338780,338781,0,1,4
97053,3,3,338783,338783,338786,0,3,2
97054,4,3,338787,338787,338790,0,3,1
97055,1,3,338788,338790,338793,2,5,0
97056,1,2,338789,338793,338795,4,6,0
97057,1,3,338790,338795,338798,5,8,0
97058,5,1,338795,338798,338799,3,4,0
97059,2,1,338797,338799,338800,2,3,0
97060,2,3,338799,338800,338803,1,4,0
97061,5,1,338804,338804,338805,0,1,1
97062,6,1,338810,338810,338811,0,1,5
97063,5,3,338815,338815,338818,0,3,4
97064,3,2,338818,338818,338820,0,2,0
97065,1,3,338819,338820,338823,1,4,0
97066,4,3,338823,338823,338826,0,3,0
97067,5,3,338828,338828,338831,0,3,2
97068,4,3,338832,338832,338835,0,3,1
97069,6,3,338838,338838,338841,0,3,3
97070,2,2,338840,338841,338843,1,3,0
97071,5,2,338845,338845,338847,0,2,2
97072,1,3,338846,338847,338850,1,4,0
97073,4,2,338850,338850,338852,0,2,0
97074,3,1,338853,338853,338854,0,1,1
97075,2,1,338855,338855,338856,0,1,1
97076,5,2,338860,338860,338862,0,2,4
97077,4,1,338864,338864,338865,0,1,2
97078,3,1,338867,338867,338868,0,1,2
97079,4,3,338871,338871,338874,0,3,3
97080,3,2,338874,338874,338876,0,2,0
97081,3,2,338877,338877,338879,0,2,1
97082,6,2,338883,338883,338885,0,2,4
97083,6,1,338889,338889,338890,0,1,4
97084,6,3,338895,338895,338898,0,3,5
97085,3,3,338898,338898,338901,0,3,0
97086,4,2,338902,338902,338904,0,2,1
97087,5,2,338907,338907,338909,0,2,3
97088,1,1,338908,338909,338910,1,2,0
97089,1,1,338909,338910,338911,1,2,0
97090,2,2,338911,338911,338913,0,2,0
97091,3,1,338914,338914,338915,0,1,1
97092,2,2,338916,338916,338918,0,2,1
97093,2,1,338918,338918,338919,0,1,0
97094,1,2,338919,338919,338921,0,2,0
97095,6,1,338925,338925,338926,0,1,4
97096,3,2,338928,338928,338930,0,2,2
97097,5,1,338933,338933,338934,0,1,3
97098,4,2,338937,338937,338939,0,2,3
97099,3,2,338940,338940,338942,0,2,1
97100,3,2,338943,338943,338945,0,2,1
97101,1,2,338944,338945,338947,1,3,0
97102,1,2,338945,338947,338949,2,4,0
97103,6,2,338951,338951,338953,0,2,2
97104,2,3,338953,338953,338956,0,3,0
97105,5,2,338958,338958,338960,0,2,2
97106,5,2,338963,338963,338965,0,2,3
97107,1,3,338964,338965,338968,1,4,0
97108,6,3,338970,338970,338973,0,3,2
97109,3,2,338973,338973,338975,0,2,0
97110,3,1,338976,338976,338977,0,1,1
97111,1,1,338977,338977,338978,0,1,0
97112,2,3,338979,338979,338982,0,3,1
97113,6,1,338985,338985,338986,0,1,3
97114,6,1,338991,338991,338992,0,1,5
97115,2,2,338993,338993,338995,0,2,1
97116,6,2,338999,338999,339001,0,2,4
97117,3,3,339002,339002,339005,0,3,1
97118,1,1,339003,339005,339006,2,3,0
97119,1,3,339004,339006,339009,2,5,0
97120,1,2,339005,339009,339011,4,6,0
97121,5,1,339010,339011,339012,1,2,0
97122,6,3,339016,339016,339019,0,3,4
97123,5,3,339021,339021,339024,0,3,2
97124,3,1,339024,339024,339025,0,1,0
97125,4,3,339028,339028,339031,0,3,3
97126,6,2,339034,339034,339036,0,2,3
97127,1,1,339035,339036,339037,1,2,0
97128,3,2,339038,339038,339040,0,2,1
97129,1,1,339039,339040,339041,1,2,0
97130,2,1,339041,339041,339042,0,1,0
97131,4,3,339045,339045,339048,0,3,3
97132,4,2,339049,339049,339051,0,2,1
97133,4,2,339053,339053,339055,0,2,2
97134,5,3,339058,339058,339061,0,3,3
97135,4,1,339062,339062,339063,0,1,1
97136,6,3,339068,339068,339071,0,3,5
97137,6,2,339074,339074,339076,0,2,3
97138,4,3,339078,339078,339081,0,3,2
97139,1,3,339079,339081,339084,2,5,0
97140,6,1,339085,339085,339086,0,1,1
97141,6,1,339091,339091,339092,0,1,5
97142,4,1,339095,339095,339096,0,1,3
97143,2,1,339097,339097,339098,0,1,1
97144,4,2,339101,339101,339103,0,2,3
97145,1,3,339102,339103,339106,1,4,0
97146,5,1,339107,339107,339108,0,1,1
97147,3,3,339110,339110,339113,0,3,2
97148,1,1,339111,339113,339114,2,3,0
97149,3,1,339114,339114,339115,0,1,0
97150,6,1,339120,339120,339121,0,1,5
97151,3,2,339123,339123,339125,0,2,2
97152,4,2,339127,339127,339129,0,2,2
97153,5,2,339132,339132,339134,0,2,3
97154,5,2,339137,339137,339139,0,2,3
97155,2,3,339139,339139,339142,0,3,0
97156,2,1,339141,339142,339143,1,2,0
97157,2,3,339143,339143,339146,0,3,0
97158,3,3,339146,339146,339149,0,3,0
97159,5,2,339151,339151,339153,0,2,2
97160,6,2,339157,339157,339159,0,2,4
97161,4,3,339161,339161,339164,0,3,2
97162,2,1,339163,339164,339165,1,2,0
97163,4,1,339167,339167,339168,0,1,2
97164,1,2,339168,339168,339170,0,2,0
97165,2,2,339170,339170,339172,0,2,0
97166,6,1,339176,339176,339177,0,1,4
97167,5,3,339181,339181,339184,0,3,4
97168,6,2,339187,339187,339189,0,2,3
97169,6,3,339193,339193,339196,0,3,4
97170,4,3,339197,339197,339200,0,3,1
97171,2,2,339199,339200,339202,1,3,0
97172,6,3,339205,339205,339208,0,3,3
97173,1,2,339206,339208,339210,2,4,0
97174,2,2,339208,339210,339212,2,4,0
97175,6,1,339214,339214,339215,0,1,2
97176,1,3,339215,339215,339218,0,3,0
97177,3,1,339218,339218,339219,0,1,0
97178,1,3,339219,339219,339222,0,3,0
97179,5,2,339224,339224,339226,0,2,2
97180,1,2,339225,339226,339228,1,3,0
97181,1,1,339226,339228,339229,2,3,0
97182,1,2,339227,339229,339231,2,4,0
97183,3,3,339230,339231,339234,1,4,0
97184,5,1,339235,339235,339236,0,1,1
97185,4,3,339239,339239,339242,0,3,3
97186,5,3,339244,339244,339247,0,3,2
97187,1,3,339245,339247,339250,2,5,0
97188,6,2,339251,339251,339253,0,2,1
97189,5,1,339256,339256,339257,0,1,3
97190,3,2,339259,339259,339261,0,2,2
97191,5,3,339264,339264,339267,0,3,3
97192,6,2,339270,339270,339272,0,2,3
97193,4,3,339274,339274,339277,0,3,2
97194,1,2,339275,339277,339279,2,4,0
97195,6,1,339281,339281,339282,0,1,2
97196,5,2,339286,339286,339288,0,2,4
97197,4,1,339290,339290,339291,0,1,2
97198,4,1,339294,339294,339295,0,1,3
97199,6,3,339300,339300,339303,0,3,5
97200,1,2,339301,339303,339305,2,4,0
97201,1,1,339302,339305,339306,3,4,0
97202,5,3,339307,339307,339310,0,3,1
97203,6,1,339313,339313,339314,0,1,3
97204,6,1,339319,339319,339320,0,1,5
97205,2,1,339321,339321,339322,0,1,1
97206,5,2,339326,339326,339328,0,2,4
97207,6,2,339332,339332,339334,0,2,4
97208,2,3,339334,339334,339337,0,3,0
97209,3,2,339337,339337,339339,0,2,0
97210,1,2,339338,339339,339341,1,3,0
97211,1,1,339339,339341,339342,2,3,0
97212,5,1,339344,339344,339345,0,1,2
97213,2,1,339346,339346,339347,0,1,1
97214,6,3,339352,339352,339355,0,3,5
97215,5,3,339357,339357,339360,0,3,2
97216,3,2,339360,339360,339362,0,2,0
97217,2,1,339362,339362,339363,0,1,0
97218,6,3,339368,339368,339371,0,3,5
97219,4,2,339372,339372,339374,0,2,1
97220,6,2,339378,339378,339380,0,2,4
97221,5,2,339383,339383,339385,0,2,3
97222,6,3,339389,339389,339392,0,3,4
97223,1,1,339390,339392,339393,2,3,0
97224,4,2,339394,339394,339396,0,2,1
97225,6,3,339400,339400,339403,0,3,4
97226,3,2,339403,339403,339405,0,2,0
97227,4,3,339407,339407,339410,0,3,2
97228,3,1,339410,339410,339411,0,1,0
97229,2,3,339412,339412,339415,0,3,1
97230,2,1,339414,339415,339416,1,2,0
97231,2,2,339416,339416,339418,0,2,0
97232,2,1,339418,339418,339419,0,1,0
97233,5,2,339423,339423,339425,0,2,4
97234,4,3,339427,339427,339430,0,3,2
97235,3,2,339430,339430,339432,0,2,0
97236,6,2,339436,339436,339438,0,2,4
97237,5,3,339441,339441,339444,0,3,3
97238,5,2,339446,339446,339448,0,2,2
97239,2,3,339448,339448,339451,0,3,0
97240,4,3,339452,339452,339455,0,3,1
97241,1,3,339453,339455,339458,2,5,0
97242,6,3,339459,339459,339462,0,3,1
97243,6,2,339465,339465,339467,0,2,3
97244,1,3,339466,339467,339470,1,4,0
97245,4,2,339470,339470,339472,0,2,0
97246,6,1,339476,339476,339477,0,1,4
97247,5,3,339481,339481,339484,0,3,4
97248,5,1,339486,339486,339487,0,1,2
97249,4,1,339490,339490,339491,0,1,3
97250,5,1,339495,339495,339496,0,1,4
97251,3,3,339498,339498,339501,0,3,2
97252,6,2,339504,339504,339506,0,2,3
97253,6,3,339510,339510,339513,0,3,4
97254,3,1,339513,339513,339514,0,1,0
97255,2,2,339515,339515,339517,0,2,1
97256,3,1,339518,339518,339519,0,1,1
97257,5,2,339523,339523,339525,0,2,4
97258,4,3,339527,339527,339530,0,3,2
97259,3,1,339530,339530,339531,0,1,0
97260,4,2,339534,339534,339536,0,2,3
97261,5,2,339539,339539,339541,0,2,3
97262,5,1,339544,339544,339545,0,1,3
97263,3,2,339547,339547,339549,0,2,2
97264,1,2,339548,339549,339551,1,3,0
97265,3,2,339551,339551,339553,0,2,0
97266,1,1,339552,339553,339554,1,2,0
97267,1,2,339553,339554,339556,1,3,0
97268,1,1,339554,339556,339557,2,3,0
97269,2,2,339556,339557,339559,1,3,0
97270,4,1,339560,339560,339561,0,1,1
97271,6,3,339566,339566,339569,0,3,5
97272,6,3,339572,339572,339575,0,3,3
97273,6,1,339578,339578,339579,0,1,3
97274,1,2,339579,339579,339581,0,2,0
97275,4,2,339583,339583,339585,0,2,2
97276,4,2,339587,339587,339589,0,2,2
97277,2,1,339589,339589,339590,0,1,0
97278,6,2,339595,339595,339597,0,2,5
97279,3,3,339598,339598,339601,0,3,1
97280,3,2,339601,339601,339603,0,2,0
97281,1,1,339602,339603,339604,1,2,0
97282,6,1,339608,339608,339609,0,1,4
97283,2,3,339610,339610,339613,0,3,1
97284,6,1,339616,339616,339617,0,1,3
97285,1,2,339617,339617,339619,0,2,0
97286,1,1,339618,339619,339620,1,2,0
97287,5,1,339623,339623,339624,0,1,3
97288,6,2,339629,339629,339631,0,2,5
97289,2,1,339631,339631,339632,0,1,0
97290,3,2,339634,339634,339636,0,2,2
97291,6,2,339640,339640,339642,0,2,4
97292,6,3,339646,339646,339649,0,3,4
97293,2,3,339648,339649,339652,1,4,0
97294,2,2,339650,339652,339654,2,4,0
97295,4,3,339654,339654,339657,0,3,0
97296,3,3,339657,339657,339660,0,3,0
97297,2,2,339659,339660,339662,1,3,0
97298,2,3,339661,339662,339665,1,4,0
97299,1,3,339662,339665,339668,3,6,0
97300,4,3,339666,339668,339671,2,5,0
97301,6,3,339672,339672,339675,0,3,1
97302,6,2,339678,339678,339680,0,2,3
97303,1,2,339679,339680,339682,1,3,0
97304,6,3,339685,339685,339688,0,3,3
97305,6,1,339691,339691,339692,0,1,3
97306,1,2,339692,339692,339694,0,2,0
97307,4,2,339696,339696,339698,0,2,2
97308,1,2,339697,339698,339700,1,3,0
97309,2,1,339699,339700,339701,1,2,0
97310,5,2,339704,339704,339706,0,2,3
97311,5,1,339709,339709,339710,0,1,3
97312,1,2,339710,339710,339712,0,2,0
97313,3,2,339713,339713,339715,0,2,1
97314,5,3,339718,339718,339721,0,3,3
97315,4,2,339722,339722,339724,0,2,1
97316,6,1,339728,339728,339729,0,1,4
97317,3,3,339731,339731,339734,0,3,2
97318,4,3,339735,339735,339738,0,3,1
97319,2,1,339737,339738,339739,1,2,0
97320,2,1,339739,339739,339740,0,1,0
97321,2,3,339741,339741,339744,0,3,1
97322,5,1,339746,339746,339747,0,1,2
97323,2,3,339748,339748,339751,0,3,1
97324,5,2,339753,339753,339755,0,2,2
97325,2,2,339755,339755,339757,0,2,0
97326,5,3,339760,339760,339763,0,3,3
97327,3,2,339763,339763,339765,0,2,0
97328,5,2,339768,339768,339770,0,2,3
97329,2,2,339770,339770,339772,0,2,0
97330,6,1,339776,339776,339777,0,1,4
97331,5,2,339781,339781,339783,0,2,4
97332,3,2,339784,339784,339786,0,2,1
97333,4,2,339788,339788,339790,0,2,2
97334,6,3,339794,339794,339797,0,3,4
97335,1,3,339795,339797,339800,2,5,0
97336,6,1,339801,339801,339802,0,1,1
97337,4,3,339805,339805,339808,0,3,3
97338,2,3,339807,339808,339811,1,4,0
97339,4,1,339811,339811,339812,0,1,0
97340,1,2,339812,339812,339814,0,2,0
97341,5,2,339817,339817,339819,0,2,3
97342,1,3,339818,339819,339822,1,4,0
97343,4,2,339822,339822,339824,0,2,0
97344,1,1,339823,339824,339825,1,2,0
97345,5,2,339828,339828,339830,0,2,3
97346,4,2,339832,339832,339834,0,2,2
97347,6,3,339838,339838,339841,0,3,4
97348,6,3,339844,339844,339847,0,3,3
97349,6,2,339850,339850,339852,0,2,3
97350,1,3,339851,339852,339855,1,4,0
97351,1,3,339852,339855,339858,3,6,0
97352,5,3,339857,339858,339861,1,4,0
97353,1,3,339858,339861,339864,3,6,0
97354,3,3,339861,339864,339867,3,6,0
97355,3,1,339864,339867,339868,3,4,0
97356,2,1,339866,339868,339869,2,3,0
97357,3,2,339869,339869,339871,0,2,0
97358,2,2,339871,339871,339873,0,2,0
97359,2,3,339873,339873,339876,0,3,0
97360,6,1,339879,339879,339880,0,1,3
97361,5,1,339884,339884,339885,0,1,4
97362,2,1,339886,339886,339887,0,1,1
97363,4,1,339890,339890,339891,0,1,3
97364,2,1,339892,339892,339893,0,1,1
97365,4,3,339896,339896,339899,0,3,3
97366,5,2,339901,339901,339903,0,2,2
97367,4,3,339905,339905,339908,0,3,2
97368,2,3,339907,339908,339911,1,4,0
97369,5,2,339912,339912,339914,0,2,1
97370,3,2,339915,339915,339917,0,2,1
97371,2,1,339917,339917,339918,0,1,0
97372,5,3,339922,339922,339925,0,3,4
97373,6,1,339928,339928,339929,0,1,3
97374,6,1,339934,339934,339935,0,1,5
97375,2,1,339936,339936,339937,0,1,1
97376,5,2,339941,339941,339943,0,2,4
97377,1,3,339942,339943,339946,1,4,0
97378,4,3,339946,339946,339949,0,3,0
97379,3,1,339949,339949,339950,0,1,0
97380,5,1,339954,339954,339955,0,1,4
97381,1,2,339955,339955,339957,0,2,0
97382,5,2,339960,339960,339962,0,2,3
97383,3,3,339963,339963,339966,0,3,1
97384,4,2,339967,339967,339969,0,2,1
97385,6,1,339973,339973,339974,0,1,4
97386,3,1,339976,339976,339977,0,1,2
97387,3,3,339979,339979,339982,0,3,2
97388,1,3,339980,339982,339985,2,5,0
97389,6,2,339986,339986,339988,0,2,1
97390,3,3,339989,339989,339992,0,3,1
97391,2,1,339991,339992,339993,1,2,0
97392,3,1,339994,339994,339995,0,1,1
97393,4,3,339998,339998,340001,0,3,3
97394,2,3,340000,340001,340004,1,4,0
97395,6,1,340006,340006,340007,0,1,2
97396,5,2,340011,340011,340013,0,2,4
97397,4,3,340015,340015,340018,0,3,2
97398,6,1,340021,340021,340022,0,1,3
97399,6,3,340027,340027,340030,0,3,5
97400,6,3,340033,340033,340036,0,3,3
97401,5,2,340038,340038,340040,0,2,2
97402,6,3,340044,340044,340047,0,3,4
97403,6,2,340050,340050,340052,0,2,3
97404,4,1,340054,340054,340055,0,1,2
97405,2,2,340056,340056,340058,0,2,1
97406,1,1,340057,340058,340059,1,2,0
97407,6,1,340063,340063,340064,0,1,4
97408,4,1,340067,340067,340068,0,1,3
97409,5,1,340072,340072,340073,0,1,4
97410,1,1,340073,340073,340074,0,1,0
97411,4,2,340077,340077,340079,0,2,3
97412,6,1,340083,340083,340084,0,1,4
97413,5,2,340088,340088,340090,0,2,4
97414,2,1,340090,340090,340091,0,1,0
97415,2,1,340092,340092,340093,0,1,1
97416,1,3,340093,340093,340096,0,3,0
97417,2,3,340095,340096,340099,1,4,0
97418,3,1,340098,340099,340100,1,2,0
97419,6,3,340104,340104,340107,0,3,4
97420,6,1,340110,340110,340111,0,1,3
97421,5,2,340115,340115,340117,0,2,4
97422,3,1,340118,340118,340119,0,1,1
97423,6,1,340124,340124,340125,0,1,5
97424,1,1,340125,340125,340126,0,1,0
97425,6,2,340131,340131,340133,0,2,5
97426,2,1,340133,340133,340134,0,1,0
97427,4,1,340137,340137,340138,0,1,3
97428,1,2,340138,340138,340140,0,2,0
97429,6,3,340144,340144,340147,0,3,4
97430,5,2,340149,340149,340151,0,2,2
97431,1,3,340150,340151,340154,1,4,0
97432,3,1,340153,340154,340155,1,2,0
97433,4,3,340157,340157,340160,0,3,2
97434,1,1,340158,340160,340161,2,3,0
97435,5,1,340163,340163,340164,0,1,2
97436,3,3,340166,340166,340169,0,3,2
97437,6,1,340172,340172,340173,0,1,3
97438,5,1,340177,340177,340178,0,1,4
97439,3,1,340180,340180,340181,0,1,2
97440,3,1,340183,340183,340184,0,1,2
97441,5,2,340188,340188,340190,0,2,4
97442,1,2,340189,340190,340192,1,3,0
97443,2,1,340191,340192,340193,1,2,0
97444,3,1,340194,340194,340195,0,1,1
97445,6,2,340200,340200,340202,0,2,5
97446,6,3,340206,340206,340209,0,3,4
97447,4,1,340210,340210,340211,0,1,1
97448,2,3,340212,340212,340215,0,3,1
97449,3,3,340215,340215,340218,0,3,0
97450,3,3,340218,340218,340221,0,3,0
97451,3,2,340221,340221,340223,0,2,0
97452,4,2,340225,340225,340227,0,2,2
97453,1,1,340226,340227,340228,1,2,0
97454,5,3,340231,340231,340234,0,3,3
97455,6,3,340237,340237,340240,0,3,3
97456,5,1,340242,340242,340243,0,1,2
97457,2,3,340244,340244,340247,0,3,1
97458,3,3,340247,340247,340250,0,3,0
97459,6,2,340253,340253,340255,0,2,3
97460,2,3,340255,340255,340258,0,3,0
97461,1,3,340256,340258,340261,2,5,0
97462,2,1,340258,340261,340262,3,4,0
97463,3,1,340261,340262,340263,1,2,0
97464,3,2,340264,340264,340266,0,2,1
97465,4,2,340268,340268,340270,0,2,2
97466,4,1,340272,340272,340273,0,1,2
97467,5,3,340277,340277,340280,0,3,4
97468,4,1,340281,340281,340282,0,1,1
97469,5,1,340286,340286,340287,0,1,4
97470,3,1,340289,340289,340290,0,1,2
97471,5,1,340294,340294,340295,0,1,4
97472,5,3,340299,340299,340302,0,3,4
97473,5,3,340304,340304,340307,0,3,2
97474,1,3,340305,340307,340310,2,5,0
97475,2,3,340307,340310,340313,3,6,0
97476,6,2,340313,340313,340315,0,2,0
97477,4,1,340317,340317,340318,0,1,2
97478,5,2,340322,340322,340324,0,2,4
97479,6,3,340328,340328,340331,0,3,4
97480,5,3,340333,340333,340336,0,3,2
97481,1,3,340334,340336,340339,2,5,0
97482,1,2,340335,340339,340341,4,6,0
97483,4,2,340339,340341,340343,2,4,0
97484,3,3,340342,340343,340346,1,4,0
97485,1,1,340343,340346,340347,3,4,0
97486,4,1,340347,340347,340348,0,1,0
97487,6,1,340353,340353,340354,0,1,5
97488,3,1,340356,340356,340357,0,1,2
97489,4,2,340360,340360,340362,0,2,3
97490,6,2,340366,340366,340368,0,2,4
97491,2,2,340368,340368,340370,0,2,0
97492,1,2,340369,340370,340372,1,3,0
97493,6,3,340375,340375,340378,0,3,3
97494,6,2,340381,340381,340383,0,2,3
97495,6,3,340387,340387,340390,0,3,4
97496,3,2,340390,340390,340392,0,2,0
97497,4,3,340394,340394,340397,0,3,2
97498,2,3,340396,340397,340400,1,4,0
97499,6,1,340402,340402,340403,0,1,2
97500,3,1,340405,340405,340406,0,1,2
97501,1,2,340406,340406,340408,0,2,0
97502,6,3,340412,340412,340415,0,3,4
97503,1,3,340413,340415,340418,2,5,0
97504,4,1,340417,340418,340419,1,2,0
97505,2,1,340419,340419,340420,0,1,0
97506,6,1,340425,340425,340426,0,1,5
97507,1,3,340426,340426,340429,0,3,0
97508,2,2,340428,340429,340431,1,3,0
97509,2,1,340430,340431,340432,1,2,0
97510,2,3,340432,340432,340435,0,3,0
97511,3,2,340435,340435,340437,0,2,0
97512,1,3,340436,340437,340440,1,4,0
97513,2,1,340438,340440,340441,2,3,0
97514,6,1,340444,340444,340445,0,1,3
97515,6,2,340450,340450,340452,0,2,5
97516,1,3,340451,340452,340455,1,4,0
97517,1,1,340452,340455,340456,3,4,0
97518,1,2,340453,340456,340458,3,5,0
97519,4,2,340457,340458,340460,1,3,0
97520,2,3,340459,340460,340463,1,4,0
97521,1,3,340460,340463,340466,3,6,0
97522,6,1,340466,340466,340467,0,1,0
97523,1,2,340467,340467,340469,0,2,0
97524,3,1,340470,340470,340471,0,1,1
97525,6,3,340476,340476,340479,0,3,5
97526,1,1,340477,340479,340480,2,3,0
97527,3,3,340480,340480,340483,0,3,0
97528,6,3,340486,340486,340489,0,3,3
97529,3,1,340489,340489,340490,0,1,0
97530,1,2,340490,340490,340492,0,2,0
97531,1,1,340491,340492,340493,1,2,0
97532,2,3,340493,340493,340496,0,3,0
97533,1,1,340494,340496,340497,2,3,0
97534,2,3,340496,340497,340500,1,4,0
97535,5,1,340501,340501,340502,0,1,1
97536,3,3,340504,340504,340507,0,3,2
97537,2,2,340506,340507,340509,1,3,0
97538,2,1,340508,340509,340510,1,2,0
97539,5,3,340513,340513,340516,0,3,3
97540,1,2,340514,340516,340518,2,4,0
97541,1,3,340515,340518,340521,3,6,0
97542,2,1,340517,340521,340522,4,5,0
97543,3,3,340520,340522,340525,2,5,0
97544,1,1,340521,340525,340526,4,5,0
97545,1,1,340522,340526,340527,4,5,0
97546,2,3,340524,340527,340530,3,6,0
97547,6,2,340530,340530,340532,0,2,0
97548,2,3,340532,340532,340535,0,3,0
97549,1,3,340533,340535,340538,2,5,0
97550,4,3,340537,340538,340541,1,4,0
97551,2,1,340539,340541,340542,2,3,0
97552,5,2,340544,340544,340546,0,2,2
97553,3,1,340547,340547,340548,0,1,1
97554,6,1,340553,340553,340554,0,1,5
97555,2,3,340555,340555,340558,0,3,1
97556,3,1,340558,340558,340559,0,1,0
97557,2,2,340560,340560,340562,0,2,1
97558,2,3,340562,340562,340565,0,3,0
97559,3,1,340565,340565,340566,0,1,0
97560,2,3,340567,340567,340570,0,3,1
97561,2,3,340569,340570,340573,1,4,0
97562,3,3,340572,340573,340576,1,4,0
97563,1,2,340573,340576,340578,3,5,0
97564,5,3,340578,340578,340581,0,3,0
97565,3,2,340581,340581,340583,0,2,0
97566,1,3,340582,340583,340586,1,4,0
97567,6,3,340588,340588,340591,0,3,2
97568,4,3,340592,340592,340595,0,3,1
97569,4,3,340596,340596,340599,0,3,1
97570,4,1,340600,340600,340601,0,1,1
97571,4,1,340604,340604,340605,0,1,3
97572,2,2,340606,340606,340608,0,2,1
97573,2,2,340608,340608,340610,0,2,0
97574,6,3,340614,340614,340617,0,3,4
97575,6,3,340620,340620,340623,0,3,3
97576,6,1,340626,340626,340627,0,1,3
97577,6,1,340632,340632,340633,0,1,5
97578,4,3,340636,340636,340639,0,3,3
97579,1,1,340637,340639,340640,2,3,0
97580,5,1,340642,340642,340643,0,1,2
97581,4,1,340646,340646,340647,0,1,3
97582,5,3,340651,340651,340654,0,3,4
97583,4,3,340655,340655,340658,0,3,1
97584,3,3,340658,340658,340661,0,3,0
97585,5,2,340663,340663,340665,0,2,2
97586,3,1,340666,340666,340667,0,1,1
97587,5,1,340671,340671,340672,0,1,4
97588,3,3,340674,340674,340677,0,3,2
97589,6,1,340680,340680,340681,0,1,3
97590,3,1,340683,340683,340684,0,1,2
97591,6,2,340689,340689,340691,0,2,5
97592,5,1,340694,340694,340695,0,1,3
97593,2,2,340696,340696,340698,0,2,1
97594,4,3,340700,340700,340703,0,3,2
97595,3,1,340703,340703,340704,0,1,0
97596,3,3,340706,340706,340709,0,3,2
97597,2,1,340708,340709,340710,1,2,0
97598,1,2,340709,340710,340712,1,3,0
97599,1,2,340710,340712,340714,2,4,0
97600,3,3,340713,340714,340717,1,4,0
97601,6,3,340719,340719,340722,0,3,2
97602,2,3,340721,340722,340725,1,4,0
97603,5,2,340726,340726,340728,0,2,1
97604,1,2,340727,340728,340730,1,3,0
97605,3,1,340730,340730,340731,0,1,0
97606,2,3,340732,340732,340735,0,3,1
97607,2,1,340734,340735,340736,1,2,0
97608,6,3,340740,340740,340743,0,3,4
97609,5,2,340745,340745,340747,0,2,2
97610,3,2,340748,340748,340750,0,2,1
97611,1,3,340749,340750,340753,1,4,0
97612,6,1,340755,340755,340756,0,1,2
97613,4,2,340759,340759,340761,0,2,3
97614,4,3,340763,340763,340766,0,3,2
97615,1,2,340764,340766,340768,2,4,0
97616,2,3,340766,340768,340771,2,5,0
97617,4,3,340770,340771,340774,1,4,0
97618,6,2,340776,340776,340778,0,2,2
97619,5,1,340781,340781,340782,0,1,3
97620,3,3,340784,340784,340787,0,3,2
97621,6,2,340790,340790,340792,0,2,3
97622,4,2,340794,340794,340796,0,2,2
97623,4,3,340798,340798,340801,0,3,2
97624,4,2,340802,340802,340804,0,2,1
97625,6,1,340808,340808,340809,0,1,4
97626,5,1,340813,340813,340814,0,1,4
97627,2,2,340815,340815,340817,0,2,1
97628,1,2,340816,340817,340819,1,3,0
97629,4,2,340820,340820,340822,0,2,1
97630,3,3,340823,340823,340826,0,3,1
97631,2,2,340825,340826,340828,1,3,0
97632,3,2,340828,340828,340830,0,2,0
97633,1,3,340829,340830,340833,1,4,0
97634,3,3,340832,340833,340836,1,4,0
97635,4,1,340836,340836,340837,0,1,0
97636,5,2,340841,340841,340843,0,2,4
97637,2,1,340843,340843,340844,0,1,0
97638,1,2,340844,340844,340846,0,2,0
97639,3,1,340847,340847,340848,0,1,1
97640,1,3,340848,340848,340851,0,3,0
97641,6,1,340854,340854,340855,0,1,3
97642,4,3,340858,340858,340861,0,3,3
97643,3,1,340861,340861,340862,0,1,0
97644,1,3,340862,340862,340865,0,3,0
97645,1,1,340863,340865,340866,2,3,0
97646,3,2,340866,340866,340868,0,2,0
97647,5,3,340871,340871,340874,0,3,3
97648,1,1,340872,340874,340875,2,3,0
97649,2,3,340874,340875,340878,1,4,0
97650,3,2,340877,340878,340880,1,3,0
97651,1,1,340878,340880,340881,2,3,0
97652,1,1,340879,340881,340882,2,3,0
97653,4,2,340883,340883,340885,0,2,1
97654,2,2,340885,340885,340887,0,2,0
97655,1,3,340886,340887,340890,1,4,0
97656,1,3,340887,340890,340893,3,6,0
97657,3,2,340890,340893,340895,3,5,0
97658,3,3,340893,340895,340898,2,5,0
97659,2,3,340895,340898,340901,3,6,0
97660,4,3,340899,340901,340904,2,5,0
97661,1,1,340900,340904,340905,4,5,0
97662,1,1,340901,340905,340906,4,5,0
97663,2,3,340903,340906,340909,3,6,0
97664,1,2,340904,340909,340911,5,7,0
97665,3,2,340907,340911,340913,4,6,0
97666,3,3,340910,340913,340916,3,6,0
97667,2,2,340912,340916,340918,4,6,0
97668,6,1,340918,340918,340919,0,1,0
97669,1,1,340919,340919,340920,0,1,0
97670,5,2,340924,340924,340926,0,2,4
97671,6,2,340930,340930,340932,0,2,4
97672,5,1,340935,340935,340936,0,1,3
97673,5,1,340940,340940,340941,0,1,4
97674,4,3,340944,340944,340947,0,3,3
97675,3,2,340947,340947,340949,0,2,0
97676,5,1,340952,340952,340953,0,1,3
97677,2,3,340954,340954,340957,0,3,1
97678,5,1,340959,340959,340960,0,1,2
97679,5,1,340964,340964,340965,0,1,4
97680,6,3,340970,340970,340973,0,3,5
97681,3,1,340973,340973,340974,0,1,0
97682,1,2,340974,340974,340976,0,2,0
97683,5,3,340979,340979,340982,0,3,3
97684,5,1,340984,340984,340985,0,1,2
97685,3,3,340987,340987,340990,0,3,2
97686,4,3,340991,340991,340994,0,3,1
97687,3,1,340994,340994,340995,0,1,0
97688,1,3,340995,340995,340998,0,3,0
97689,3,1,340998,340998,340999,0,1,0
97690,6,1,341004,341004,341005,0,1,5
97691,4,3,341008,341008,341011,0,3,3
97692,3,2,341011,341011,341013,0,2,0
97693,6,1,341017,341017,341018,0,1,4
97694,5,3,341022,341022,341025,0,3,4
97695,4,2,341026,341026,341028,0,2,1
97696,6,1,341032,341032,341033,0,1,4
97697,4,1,341036,341036,341037,0,1,3
97698,1,3,341037,341037,341040,0,3,0
97699,2,1,341039,341040,341041,1,2,0
97700,3,3,341042,341042,341045,0,3,1
97701,5,2,341047,341047,341049,0,2,2
97702,3,2,341050,341050,341052,0,2,1
97703,5,3,341055,341055,341058,0,3,3
97704,5,2,341060,341060,341062,0,2,2
97705,2,3,341062,341062,341065,0,3,0
97706,5,3,341067,341067,341070,0,3,2
97707,3,3,341070,341070,341073,0,3,0
97708,6,2,341076,341076,341078,0,2,3
97709,3,2,341079,341079,341081,0,2,1
97710,1,1,341080,341081,341082,1,2,0
97711,2,2,341082,341082,341084,0,2,0
97712,2,3,341084,341084,341087,0,3,0
97713,6,1,341090,341090,341091,0,1,3
97714,5,1,341095,341095,341096,0,1,4
97715,3,2,341098,341098,341100,0,2,2
97716,1,3,341099,341100,341103,1,4,0
97717,2,2,341101,341103,341105,2,4,0
97718,5,2,341106,341106,341108,0,2,1
97719,4,1,341110,341110,341111,0,1,2
97720,2,3,341112,341112,341115,0,3,1
97721,3,1,341115,341115,341116,0,1,0
97722,2,2,341117,341117,341119,0,2,1
97723,3,2,341120,341120,341122,0,2,1
97724,1,1,341121,341122,341123,1,2,0
97725,4,2,341125,341125,341127,0,2,2
97726,3,1,341128,341128,341129,0,1,1
97727,4,1,341132,341132,341133,0,1,3
97728,1,3,341133,341133,341136,0,3,0
97729,2,3,341135,341136,341139,1,4,0
97730,4,1,341139,341139,341140,0,1,0
97731,1,3,341140,341140,341143,0,3,0
97732,5,3,341145,341145,341148,0,3,2
97733,3,1,341148,341148,341149,0,1,0
97734,6,3,341154,341154,341157,0,3,5
97735,6,1,341160,341160,341161,0,1,3
97736,4,2,341164,341164,341166,0,2,3
97737,4,2,341168,341168,341170,0,2,2
97738,4,3,341172,341172,341175,0,3,2
97739,4,1,341176,341176,341177,0,1,1
97740,2,3,341178,341178,341181,0,3,1
97741,4,2,341182,341182,341184,0,2,1
97742,2,2,341184,341184,341186,0,2,0
97743,2,1,341186,341186,341187,0,1,0
97744,5,1,341191,341191,341192,0,1,4
97745,4,2,341195,341195,341197,0,2,3
97746,6,2,341201,341201,341203,0,2,4
97747,3,1,341204,341204,341205,0,1,1
97748,4,1,341208,341208,341209,0,1,3
97749,4,2,341212,341212,341214,0,2,3
97750,2,2,341214,341214,341216,0,2,0
97751,4,3,341218,341218,341221,0,3,2
97752,3,3,341221,341221,341224,0,3,0
97753,6,2,341227,341227,341229,0,2,3
97754,2,3,341229,341229,341232,0,3,0
97755,3,3,341232,341232,341235,0,3,0
97756,2,1,341234,341235,341236,1,2,0
97757,1,1,341235,341236,341237,1,2,0
97758,3,2,341238,341238,341240,0,2,1
97759,4,1,341242,341242,341243,0,1,2
97760,1,3,341243,341243,341246,0,3,0
97761,4,2,341247,341247,341249,0,2,1
97762,4,1,341251,341251,341252,0,1,2
97763,1,3,341252,341252,341255,0,3,0
97764,5,3,341257,341257,341260,0,3,2
97765,4,1,341261,341261,341262,0,1,1
97766,4,3,341265,341265,341268,0,3,3
97767,1,3,341266,341268,341271,2,5,0
97768,6,1,341272,341272,341273,0,1,1
97769,2,2,341274,341274,341276,0,2,1
97770,2,2,341276,341276,341278,0,2,0
97771,6,1,341282,341282,341283,0,1,4
97772,3,3,341285,341285,341288,0,3,2
97773,5,3,341290,341290,341293,0,3,2
97774,4,2,341294,341294,341296,0,2,1
97775,6,1,341300,341300,341301,0,1,4
97776,1,2,341301,341301,341303,0,2,0
97777,5,3,341306,341306,341309,0,3,3
97778,2,2,341308,341309,341311,1,3,0
97779,4,1,341312,341312,341313,0,1,1
97780,4,3,341316,341316,341319,0,3,3
97781,5,3,341321,341321,341324,0,3,2
97782,1,1,341322,341324,341325,2,3,0
97783,4,1,341326,341326,341327,0,1,1
97784,4,3,341330,341330,341333,0,3,3
97785,3,3,341333,341333,341336,0,3,0
97786,4,3,341337,341337,341340,0,3,1
97787,1,2,341338,341340,341342,2,4,0
97788,4,2,341342,341342,341344,0,2,0
97789,1,3,341343,341344,341347,1,4,0
97790,5,3,341348,341348,341351,0,3,1
97791,6,3,341354,341354,341357,0,3,3
97792,6,1,341360,341360,341361,0,1,3
97793,1,3,341361,341361,341364,0,3,0
97794,1,2,341362,341364,341366,2,4,0
97795,2,1,341364,341366,341367,2,3,0
97796,4,1,341368,341368,341369,0,1,1
97797,6,1,341374,341374,341375,0,1,5
97798,4,2,341378,341378,341380,0,2,3
97799,3,3,341381,341381,341384,0,3,1
97800,3,3,341384,341384,341387,0,3,0
97801,1,2,341385,341387,341389,2,4,0
97802,1,1,341386,341389,341390,3,4,0
97803,3,3,341389,341390,341393,1,4,0
97804,2,1,341391,341393,341394,2,3,0
97805,1,1,341392,341394,341395,2,3,0
97806,6,2,341398,341398,341400,0,2,3
97807,5,1,341403,341403,341404,0,1,3
97808,2,2,341405,341405,341407,0,2,1
97809,4,3,341409,341409,341412,0,3,2
97810,3,3,341412,341412,341415,0,3,0
97811,5,3,341417,341417,341420,0,3,2
97812,6,3,341423,341423,341426,0,3,3
97813,4,3,341427,341427,341430,0,3,1
97814,1,2,341428,341430,341432,2,4,0
97815,5,3,341433,341433,341436,0,3,1
97816,5,1,341438,341438,341439,0,1,2
97817,4,3,341442,341442,341445,0,3,3
97818,5,2,341447,341447,341449,0,2,2
97819,2,2,341449,341449,341451,0,2,0
97820,4,3,341453,341453,341456,0,3,2
97821,1,2,341454,341456,341458,2,4,0
97822,2,2,341456,341458,341460,2,4,0
97823,6,2,341462,341462,341464,0,2,2
97824,4,2,341466,341466,341468,0,2,2
97825,3,3,341469,341469,341472,0,3,1
97826,4,1,341473,341473,341474,0,1,1
97827,5,1,341478,341478,341479,0,1,4
97828,3,2,341481,341481,341483,0,2,2
97829,5,2,341486,341486,341488,0,2,3
97830,6,2,341492,341492,341494,0,2,4
97831,5,1,341497,341497,341498,0,1,3
97832,2,3,341499,341499,341502,0,3,1
97833,3,2,341502,341502,341504,0,2,0
97834,6,3,341508,341508,341511,0,3,4
97835,2,3,341510,341511,341514,1,4,0
97836,2,1,341512,341514,341515,2,3,0
97837,3,1,341515,341515,341516,0,1,0
97838,5,2,341520,341520,341522,0,2,4
97839,2,1,341522,341522,341523,0,1,0
97840,2,2,341524,341524,341526,0,2,1
97841,3,2,341527,341527,341529,0,2,1
97842,2,2,341529,341529,341531,0,2,0
97843,6,1,341535,341535,341536,0,1,4
97844,1,3,341536,341536,341539,0,3,0
97845,2,1,341538,341539,341540,1,2,0
97846,5,2,341543,341543,341545,0,2,3
97847,5,2,341548,341548,341550,0,2,3
97848,3,2,341551,341551,341553,0,2,1
97849,1,2,341552,341553,341555,1,3,0
97850,4,3,341556,341556,341559,0,3,1
97851,2,3,341558,341559,341562,1,4,0
97852,1,3,341559,341562,341565,3,6,0
97853,2,3,341561,341565,341568,4,7,0
97854,4,3,341565,341568,341571,3,6,0
97855,6,3,341571,341571,341574,0,3,0
97856,1,3,341572,341574,341577,2,5,0
97857,5,2,341577,341577,341579,0,2,0
97858,1,1,341578,341579,341580,1,2,0
97859,3,2,341581,341581,341583,0,2,1
97860,6,1,341587,341587,341588,0,1,4
97861,5,2,341592,341592,341594,0,2,4
97862,2,3,341594,341594,341597,0,3,0
97863,1,2,341595,341597,341599,2,4,0
97864,2,2,341597,341599,341601,2,4,0
97865,5,3,341602,341602,341605,0,3,1
97866,6,1,341608,341608,341609,0,1,3
97867,5,2,341613,341613,341615,0,2,4
97868,2,1,341615,341615,341616,0,1,0
97869,6,1,341621,341621,341622,0,1,5
97870,1,3,341622,341622,341625,0,3,0
97871,3,2,341625,341625,341627,0,2,0
97872,2,1,341627,341627,341628,0,1,0
97873,6,2,341633,341633,341635,0,2,5
97874,1,1,341634,341635,341636,1,2,0
97875,2,3,341636,341636,341639,0,3,0
97876,6,3,341642,341642,341645,0,3,3
97877,4,2,341646,341646,341648,0,2,1
97878,5,2,341651,341651,341653,0,2,3
97879,4,2,341655,341655,341657,0,2,2
97880,2,3,341657,341657,341660,0,3,0
97881,2,1,341659,341660,341661,1,2,0
97882,4,3,341663,341663,341666,0,3,2
97883,5,1,341668,341668,341669,0,1,2
97884,4,2,341672,341672,341674,0,2,3
97885,1,2,341673,341674,341676,1,3,0
97886,3,2,341676,341676,341678,0,2,0
97887,4,2,341680,341680,341682,0,2,2
97888,3,1,341683,341683,341684,0,1,1
97889,3,1,341686,341686,341687,0,1,2
97890,1,3,341687,341687,341690,0,3,0
97891,3,3,341690,341690,341693,0,3,0
97892,1,1,341691,341693,341694,2,3,0
97893,6,1,341697,341697,341698,0,1,3
97894,5,2,341702,341702,341704,0,2,4
97895,4,3,341706,341706,341709,0,3,2
97896,5,2,341711,341711,341713,0,2,2
97897,1,2,341712,341713,341715,1,3,0
97898,1,3,341713,341715,341718,2,5,0
97899,2,2,341715,341718,341720,3,5,0
97900,5,3,341720,341720,341723,0,3,0
97901,2,3,341722,341723,341726,1,4,0
97902,1,1,341723,341726,341727,3,4,0
97903,3,2,341726,341727,341729,1,3,0
97904,6,3,341732,341732,341735,0,3,3
97905,4,2,341736,341736,341738,0,2,1
97906,3,2,341739,341739,341741,0,2,1
97907,1,3,341740,341741,341744,1,4,0
97908,1,2,341741,341744,341746,3,5,0
97909,6,1,341747,341747,341748,0,1,1
97910,6,1,341753,341753,341754,0,1,5
97911,1,3,341754,341754,341757,0,3,0
97912,2,3,341756,341757,341760,1,4,0
97913,6,1,341762,341762,341763,0,1,2
97914,3,1,341765,341765,341766,0,1,2
97915,5,2,341770,341770,341772,0,2,4
97916,3,1,341773,341773,341774,0,1,1
97917,4,3,341777,341777,341780,0,3,3
97918,6,3,341783,341783,341786,0,3,3
97919,6,2,341789,341789,341791,0,2,3
97920,6,1,341795,341795,341796,0,1,4
97921,3,2,341798,341798,341800,0,2,2
97922,4,2,341802,341802,341804,0,2,2
97923,3,2,341805,341805,341807,0,2,1
97924,1,1,341806,341807,341808,1,2,0
97925,5,2,341811,341811,341813,0,2,3
97926,4,3,341815,341815,341818,0,3,2
97927,6,3,341821,341821,341824,0,3,3
97928,6,3,341827,341827,341830,0,3,3
97929,5,2,341832,341832,341834,0,2,2
97930,4,2,341836,341836,341838,0,2,2
97931,2,3,341838,341838,341841,0,3,0
97932,4,1,341842,341842,341843,0,1,1
97933,4,3,341846,341846,341849,0,3,3
97934,3,2,341849,341849,341851,0,2,0
97935,4,1,341853,341853,341854,0,1,2
97936,6,3,341859,341859,341862,0,3,5
97937,6,2,341865,341865,341867,0,2,3
97938,4,1,341869,341869,341870,0,1,2
97939,5,2,341874,341874,341876,0,2,4
97940,4,2,341878,341878,341880,0,2,2
97941,3,1,341881,341881,341882,0,1,1
97942,1,2,341882,341882,341884,0,2,0
97943,4,2,341886,341886,341888,0,2,2
97944,4,2,341890,341890,341892,0,2,2
97945,6,3,341896,341896,341899,0,3,4
97946,2,2,341898,341899,341901,1,3,0
97947,4,1,341902,341902,341903,0,1,1
97948,3,3,341905,341905,341908,0,3,2
97949,4,1,341909,341909,341910,0,1,1
97950,3,2,341912,341912,341914,0,2,2
97951,1,2,341913,341914,341916,1,3,0
97952,4,3,341917,341917,341920,0,3,1
97953,3,1,341920,341920,341921,0,1,0
97954,2,2,341922,341922,341924,0,2,1
97955,6,3,341928,341928,341931,0,3,4
97956,3,2,341931,341931,341933,0,2,0
97957,3,3,341934,341934,341937,0,3,1
97958,2,2,341936,341937,341939,1,3,0
97959,5,2,341941,341941,341943,0,2,2
97960,6,2,341947,341947,341949,0,2,4
97961,3,1,341950,341950,341951,0,1,1
97962,4,1,341954,341954,341955,0,1,3
97963,4,2,341958,341958,341960,0,2,3
97964,2,2,341960,341960,341962,0,2,0
97965,4,3,341964,341964,341967,0,3,2
97966,4,1,341968,341968,341969,0,1,1
97967,2,2,341970,341970,341972,0,2,1
97968,3,2,341973,341973,341975,0,2,1
97969,1,1,341974,341975,341976,1,2,0
97970,1,2,341975,341976,341978,1,3,0
97971,6,3,341981,341981,341984,0,3,3
97972,5,3,341986,341986,341989,0,3,2
97973,6,3,341992,341992,341995,0,3,3
97974,6,2,341998,341998,342000,0,2,3
97975,2,2,342000,342000,342002,0,2,0
97976,3,2,342003,342003,342005,0,2,1
97977,6,1,342009,342009,342010,0,1,4
97978,6,3,342015,342015,342018,0,3,5
97979,3,2,342018,342018,342020,0,2,0
97980,1,1,342019,342020,342021,1,2,0
97981,5,1,342024,342024,342025,0,1,3
97982,2,1,342026,342026,342027,0,1,1
97983,1,3,342027,342027,342030,0,3,0
97984,2,3,342029,342030,342033,1,4,0
97985,3,2,342032,342033,342035,1,3,0
97986,3,2,342035,342035,342037,0,2,0
97987,4,2,342039,342039,342041,0,2,2
97988,1,1,342040,342041,342042,1,2,0
97989,3,3,342043,342043,342046,0,3,1
97990,1,2,342044,342046,342048,2,4,0
97991,3,1,342047,342048,342049,1,2,0
97992,3,3,342050,342050,342053,0,3,1
97993,3,1,342053,342053,342054,0,1,0
97994,4,3,342057,342057,342060,0,3,3
97995,4,1,342061,342061,342062,0,1,1
97996,6,3,342067,342067,342070,0,3,5
97997,6,2,342073,342073,342075,0,2,3
97998,4,3,342077,342077,342080,0,3,2
97999,6,3,342083,342083,342086,0,3,3
98000,6,3,342089,342089,342092,0,3,3
98001,6,1,342095,342095,342096,0,1,3
98002,3,1,342098,342098,342099,0,1,2
98003,5,2,342103,342103,342105,0,2,4
98004,1,3,342104,342105,342108,1,4,0
98005,2,1,342106,342108,342109,2,3,0
98006,4,2,342110,342110,342112,0,2,1
98007,1,1,342111,342112,342113,1,2,0
98008,1,2,342112,342113,342115,1,3,0
98009,5,2,342117,342117,342119,0,2,2
98010,6,3,342123,342123,342126,0,3,4
98011,3,1,342126,342126,342127,0,1,0
98012,2,1,342128,342128,342129,0,1,1
98013,3,2,342131,342131,342133,0,2,2
98014,4,3,342135,342135,342138,0,3,2
98015,1,1,342136,342138,342139,2,3,0
98016,1,3,342137,342139,342142,2,5,0
98017,3,2,342140,342142,342144,2,4,0
98018,1,1,342141,342144,342145,3,4,0
98019,3,1,342144,342145,342146,1,2,0
98020,4,3,342148,342148,342151,0,3,2
98021,5,3,342153,342153,342156,0,3,2
98022,2,2,342155,342156,342158,1,3,0
98023,2,1,342157,342158,342159,1,2,0
98024,6,1,342163,342163,342164,0,1,4
98025,6,3,342169,342169,342172,0,3,5
98026,2,3,342171,342172,342175,1,4,0
98027,6,1,342177,342177,342178,0,1,2
98028,6,3,342183,342183,342186,0,3,5
98029,6,1,342189,342189,342190,0,1,3
98030,2,3,342191,342191,342194,0,3,1
98031,6,2,342197,342197,342199,0,2,3
98032,1,2,342198,342199,342201,1,3,0
98033,6,1,342204,342204,342205,0,1,3
98034,1,2,342205,342205,342207,0,2,0
98035,4,3,342209,342209,342212,0,3,2
98036,4,3,342213,342213,342216,0,3,1
98037,6,1,342219,342219,342220,0,1,3
98038,5,3,342224,342224,342227,0,3,4
98039,2,1,342226,342227,342228,1,2,0
98040,2,2,342228,342228,342230,0,2,0
98041,2,1,342230,342230,342231,0,1,0
98042,2,1,342232,342232,342233,0,1,1
98043,3,2,342235,342235,342237,0,2,2
98044,1,1,342236,342237,342238,1,2,0
98045,2,3,342238,342238,342241,0,3,0
98046,4,1,342242,342242,342243,0,1,1
98047,3,3,342245,342245,342248,0,3,2
98048,5,3,342250,342250,342253,0,3,2
98049,6,2,342256,342256,342258,0,2,3
98050,4,2,342260,342260,342262,0,2,2
98051,1,2,342261,342262,342264,1,3,0
98052,3,3,342264,342264,342267,0,3,0
98053,6,1,342270,342270,342271,0,1,3
98054,5,2,342275,342275,342277,0,2,4
98055,6,1,342281,342281,342282,0,1,4
98056,6,1,342287,342287,342288,0,1,5
98057,3,1,342290,342290,342291,0,1,2
98058,1,1,342291,342291,342292,0,1,0
98059,1,3,342292,342292,342295,0,3,0
98060,1,2,342293,342295,342297,2,4,0
98061,3,2,342296,342297,342299,1,3,0
98062,6,2,342302,342302,342304,0,2,3
98063,4,3,342306,342306,342309,0,3,2
98064,1,3,342307,342309,342312,2,5,0
98065,5,1,342312,342312,342313,0,1,0
98066,3,2,342315,342315,342317,0,2,2
98067,4,3,342319,342319,342322,0,3,2
98068,1,2,342320,342322,342324,2,4,0
98069,2,2,342322,342324,342326,2,4,0
98070,6,3,342328,342328,342331,0,3,2
98071,1,2,342329,342331,342333,2,4,0
98072,5,1,342334,342334,342335,0,1,1
98073,2,1,342336,342336,342337,0,1,1
98074,3,2,342339,342339,342341,0,2,2
98075,5,2,342344,342344,342346,0,2,3
98076,5,2,342349,342349,342351,0,2,3
98077,6,1,342355,342355,342356,0,1,4
98078,5,1,342360,342360,342361,0,1,4
98079,4,3,342364,342364,342367,0,3,3
98080,5,1,342369,342369,342370,0,1,2
98081,1,1,342370,342370,342371,0,1,0
98082,4,3,342374,342374,342377,0,3,3
98083,5,3,342379,342379,342382,0,3,2
98084,5,1,342384,342384,342385,0,1,2
98085,4,1,342388,342388,342389,0,1,3
98086,4,2,342392,342392,342394,0,2,3
98087,3,3,342395,342395,342398,0,3,1
98088,6,3,342401,342401,342404,0,3,3
98089,6,1,342407,342407,342408,0,1,3
98090,3,3,342410,342410,342413,0,3,2
98091,6,1,342416,342416,342417,0,1,3
98092,5,2,342421,342421,342423,0,2,4
98093,1,1,342422,342423,342424,1,2,0
98094,5,2,342427,342427,342429,0,2,3
98095,5,2,342432,342432,342434,0,2,3
98096,6,1,342438,342438,342439,0,1,4
98097,4,3,342442,342442,342445,0,3,3
98098,5,2,342447,342447,342449,0,2,2
98099,4,2,342451,342451,342453,0,2,2
98100,3,3,342454,342454,342457,0,3,1
98101,6,3,342460,342460,342463,0,3,3
98102,4,3,342464,342464,342467,0,3,1
98103,3,3,342467,342467,342470,0,3,0
98104,3,1,342470,342470,342471,0,1,0
98105,4,3,342474,342474,342477,0,3,3
98106,6,1,342480,342480,342481,0,1,3
98107,2,2,342482,342482,342484,0,2,1
98108,4,2,342486,342486,342488,0,2,2
98109,3,3,342489,342489,342492,0,3,1
98110,4,2,342493,342493,342495,0,2,1
98111,6,2,342499,342499,342501,0,2,4
98112,4,2,342503,342503,342505,0,2,2
98113,6,2,342509,342509,342511,0,2,4
98114,4,1,342513,342513,342514,0,1,2
98115,4,1,342517,342517,342518,0,1,3
98116,4,3,342521,342521,342524,0,3,3
98117,5,2,342526,342526,342528,0,2,2
98118,2,1,342528,342528,342529,0,1,0
98119,1,3,342529,342529,342532,0,3,0
98120,3,3,342532,342532,342535,0,3,0
98121,3,3,342535,342535,342538,0,3,0
98122,5,3,342540,342540,342543,0,3,2
98123,3,2,342543,342543,342545,0,2,0
98124,5,2,342548,342548,342550,0,2,3
98125,3,3,342551,342551,342554,0,3,1
98126,6,3,342557,342557,342560,0,3,3
98127,5,1,342562,342562,342563,0,1,2
98128,6,2,342568,342568,342570,0,2,5
98129,1,3,342569,342570,342573,1,4,0
98130,5,3,342574,342574,342577,0,3,1
98131,5,3,342579,342579,342582,0,3,2
98132,3,3,342582,342582,342585,0,3,0
98133,3,3,342585,342585,342588,0,3,0
98134,5,2,342590,342590,342592,0,2,2
98135,3,3,342593,342593,342596,0,3,1
98136,4,3,342597,342597,342600,0,3,1
98137,5,3,342602,342602,342605,0,3,2
98138,2,2,342604,342605,342607,1,3,0
98139,6,3,342610,342610,342613,0,3,3
98140,3,1,342613,342613,342614,0,1,0
98141,2,2,342615,342615,342617,0,2,1
98142,3,1,342618,342618,342619,0,1,1
98143,2,3,342620,342620,342623,0,3,1
98144,1,1,342621,342623,342624,2,3,0
98145,4,3,342625,342625,342628,0,3,1
98146,6,1,342631,342631,342632,0,1,3
98147,1,1,342632,342632,342633,0,1,0
98148,3,3,342635,342635,342638,0,3,2
98149,4,3,342639,342639,342642,0,3,1
98150,4,2,342643,342643,342645,0,2,1
98151,5,1,342648,342648,342649,0,1,3
98152,4,3,342652,342652,342655,0,3,3
98153,2,1,342654,342655,342656,1,2,0
98154,5,3,342659,342659,342662,0,3,3
98155,5,2,342664,342664,342666,0,2,2
98156,6,2,342670,342670,342672,0,2,4
98157,5,3,342675,342675,342678,0,3,3
98158,2,2,342677,342678,342680,1,3,0
98159,3,3,342680,342680,342683,0,3,0
98160,3,2,342683,342683,342685,0,2,0
98161,1,3,342684,342685,342688,1,4,0
98162,2,3,342686,342688,342691,2,5,0
98163,6,2,342692,342692,342694,0,2,1
98164,6,3,342698,342698,342701,0,3,4
98165,3,2,342701,342701,342703,0,2,0
98166,5,2,342706,342706,342708,0,2,3
98167,6,2,342712,342712,342714,0,2,4
98168,1,1,342713,342714,342715,1,2,0
98169,1,2,342714,342715,342717,1,3,0
98170,2,1,342716,342717,342718,1,2,0
98171,1,1,342717,342718,342719,1,2,0
98172,6,3,342723,342723,342726,0,3,4
98173,3,1,342726,342726,342727,0,1,0
98174,4,1,342730,342730,342731,0,1,3
98175,3,2,342733,342733,342735,0,2,2
98176,1,2,342734,342735,342737,1,3,0
98177,6,3,342740,342740,342743,0,3,3
98178,1,2,342741,342743,342745,2,4,0
98179,4,1,342745,342745,342746,0,1,0
98180,4,2,342749,342749,342751,0,2,3
98181,4,1,342753,342753,342754,0,1,2
98182,3,2,342756,342756,342758,0,2,2
98183,2,2,342758,342758,342760,0,2,0
98184,3,3,342761,342761,342764,0,3,1
98185,2,1,342763,342764,342765,1,2,0
98186,5,2,342768,342768,342770,0,2,3
98187,3,3,342771,342771,342774,0,3,1
98188,2,1,342773,342774,342775,1,2,0
98189,4,1,342777,342777,342778,0,1,2
98190,5,3,342782,342782,342785,0,3,4
98191,2,1,342784,342785,342786,1,2,0
98192,1,2,342785,342786,342788,1,3,0
98193,5,2,342790,342790,342792,0,2,2
98194,5,1,342795,342795,342796,0,1,3
98195,1,2,342796,342796,342798,0,2,0
98196,1,3,342797,342798,342801,1,4,0
98197,3,2,342800,342801,342803,1,3,0
98198,2,1,342802,342803,342804,1,2,0
98199,2,3,342804,342804,342807,0,3,0
98200,2,3,342806,342807,342810,1,4,0
98201,4,3,342810,342810,342813,0,3,0
98202,5,1,342815,342815,342816,0,1,2
98203,4,3,342819,342819,342822,0,3,3
98204,5,2,342824,342824,342826,0,2,2
98205,6,2,342830,342830,342832,0,2,4
98206,1,2,342831,342832,342834,1,3,0
98207,5,1,342836,342836,342837,0,1,2
98208,2,2,342838,342838,342840,0,2,1
98209,4,3,342842,342842,342845,0,3,2
98210,3,2,342845,342845,342847,0,2,0
98211,2,2,342847,342847,342849,0,2,0
98212,6,2,342853,342853,342855,0,2,4
98213,2,2,342855,342855,342857,0,2,0
98214,2,1,342857,342857,342858,0,1,0
98215,5,3,342862,342862,342865,0,3,4
98216,3,1,342865,342865,342866,0,1,0
98217,3,2,342868,342868,342870,0,2,2
98218,3,2,342871,342871,342873,0,2,1
98219,2,3,342873,342873,342876,0,3,0
98220,6,1,342879,342879,342880,0,1,3
98221,2,1,342881,342881,342882,0,1,1
98222,5,2,342886,342886,342888,0,2,4
98223,2,3,342888,342888,342891,0,3,0
98224,1,3,342889,342891,342894,2,5,0
98225,4,1,342893,342894,342895,1,2,0
98226,1,2,342894,342895,342897,1,3,0
98227,4,1,342898,342898,342899,0,1,1
98228,5,3,342903,342903,342906,0,3,4
98229,5,2,342908,342908,342910,0,2,2
98230,4,3,342912,342912,342915,0,3,2
98231,4,1,342916,342916,342917,0,1,1
98232,1,2,342917,342917,342919,0,2,0
98233,1,2,342918,342919,342921,1,3,0
98234,5,3,342923,342923,342926,0,3,2
98235,2,1,342925,342926,342927,1,2,0
98236,5,2,342930,342930,342932,0,2,3
98237,2,1,342932,342932,342933,0,1,0
98238,5,3,342937,342937,342940,0,3,4
98239,3,3,342940,342940,342943,0,3,0
98240,4,3,342944,342944,342947,0,3,1
98241,6,1,342950,342950,342951,0,1,3
98242,2,2,342952,342952,342954,0,2,1
98243,4,2,342956,342956,342958,0,2,2
98244,4,2,342960,342960,342962,0,2,2
98245,1,1,342961,342962,342963,1,2,0
98246,5,1,342966,342966,342967,0,1,3
98247,1,2,342967,342967,342969,0,2,0
98248,4,3,342971,342971,342974,0,3,2
98249,2,2,342973,342974,342976,1,3,0
98250,1,1,342974,342976,342977,2,3,0
98251,4,2,342978,342978,342980,0,2,1
98252,6,2,342984,342984,342986,0,2,4
98253,5,2,342989,342989,342991,0,2,3
98254,2,3,342991,342991,342994,0,3,0
98255,2,3,342993,342994,342997,1,4,0
98256,2,3,342995,342997,343000,2,5,0
98257,2,1,342997,343000,343001,3,4,0
98258,6,2,343003,343003,343005,0,2,2
98259,2,3,343005,343005,343008,0,3,0
98260,6,1,343011,343011,343012,0,1,3
98261,1,3,343012,343012,343015,0,3,0
98262,4,3,343016,343016,343019,0,3,1
98263,5,2,343021,343021,343023,0,2,2
98264,4,1,343025,343025,343026,0,1,2
98265,1,1,343026,343026,343027,0,1,0
98266,3,1,343029,343029,343030,0,1,2
98267,5,1,343034,343034,343035,0,1,4
98268,4,3,343038,343038,343041,0,3,3
98269,1,3,343039,343041,343044,2,5,0
98270,3,1,343042,343044,343045,2,3,0
98271,4,3,343046,343046,343049,0,3,1
98272,1,2,343047,343049,343051,2,4,0
98273,6,1,343053,343053,343054,0,1,2
98274,5,3,343058,343058,343061,0,3,4
98275,5,2,343063,343063,343065,0,2,2
98276,3,1,343066,343066,343067,0,1,1
98277,2,3,343068,343068,343071,0,3,1
98278,5,2,343073,343073,343075,0,2,2
98279,4,1,343077,343077,343078,0,1,2
98280,4,2,343081,343081,343083,0,2,3
98281,4,3,343085,343085,343088,0,3,2
98282,4,2,343089,343089,343091,0,2,1
98283,6,1,343095,343095,343096,0,1,4
98284,3,3,343098,343098,343101,0,3,2
98285,6,3,343104,343104,343107,0,3,3
98286,6,3,343110,343110,343113,0,3,3
98287,3,1,343113,343113,343114,0,1,0
98288,5,2,343118,343118,343120,0,2,4
98289,2,1,343120,343120,343121,0,1,0
98290,5,2,343125,343125,343127,0,2,4
98291,4,1,343129,343129,343130,0,1,2
98292,1,2,343130,343130,343132,0,2,0
98293,1,3,343131,343132,343135,1,4,0
98294,5,2,343136,343136,343138,0,2,1
98295,6,3,343142,343142,343145,0,3,4
98296,2,1,343144,343145,343146,1,2,0
98297,4,3,343148,343148,343151,0,3,2
98298,2,1,343150,343151,343152,1,2,0
98299,3,3,343153,343153,343156,0,3,1
98300,6,2,343159,343159,343161,0,2,3
98301,2,3,343161,343161,343164,0,3,0
98302,1,1,343162,343164,343165,2,3,0
98303,5,3,343167,343167,343170,0,3,2
98304,4,1,343171,343171,343172,0,1,1
98305,3,2,343174,343174,343176,0,2,2
98306,2,1,343176,343176,343177,0,1,0
98307,4,3,343180,343180,343183,0,3,3
98308,6,3,343186,343186,343189,0,3,3
98309,3,1,343189,343189,343190,0,1,0
98310,5,2,343194,343194,343196,0,2,4
98311,4,2,343198,343198,343200,0,2,2
98312,4,3,343202,343202,343205,0,3,2
98313,6,1,343208,343208,343209,0,1,3
98314,5,2,343213,343213,343215,0,2,4
98315,4,1,343217,343217,343218,0,1,2
98316,5,1,343222,343222,343223,0,1,4
98317,3,1,343225,343225,343226,0,1,2
98318,5,1,343230,343230,343231,0,1,4
98319,5,2,343235,343235,343237,0,2,4
98320,2,1,343237,343237,343238,0,1,0
98321,6,1,343243,343243,343244,0,1,5
98322,6,1,343249,343249,343250,0,1,5
98323,5,2,343254,343254,343256,0,2,4
98324,4,3,343258,343258,343261,0,3,2
98325,6,1,343264,343264,343265,0,1,3
98326,4,1,343268,343268,343269,0,1,3
98327,6,3,343274,343274,343277,0,3,5
98328,5,3,343279,343279,343282,0,3,2
98329,5,3,343284,343284,343287,0,3,2
98330,1,2,343285,343287,343289,2,4,0
98331,2,1,343287,343289,343290,2,3,0
98332,5,3,343292,343292,343295,0,3,2
98333,5,3,343297,343297,343300,0,3,2
98334,4,1,343301,343301,343302,0,1,1
98335,1,2,343302,343302,343304,0,2,0
98336,5,2,343307,343307,343309,0,2,3
98337,6,3,343313,343313,343316,0,3,4
98338,6,3,343319,343319,343322,0,3,3
98339,4,3,343323,343323,343326,0,3,1
98340,2,1,343325,343326,343327,1,2,0
98341,5,2,343330,343330,343332,0,2,3
98342,1,2,343331,343332,343334,1,3,0
98343,4,1,343335,343335,343336,0,1,1
98344,1,2,343336,343336,343338,0,2,0
98345,5,2,343341,343341,343343,0,2,3
98346,1,1,343342,343343,343344,1,2,0
98347,2,1,343344,343344,343345,0,1,0
98348,2,1,343346,343346,343347,0,1,1
98349,5,1,343351,343351,343352,0,1,4
98350,3,2,343354,343354,343356,0,2,2
98351,4,2,343358,343358,343360,0,2,2
98352,2,1,343360,343360,343361,0,1,0
98353,2,3,343362,343362,343365,0,3,1
98354,6,2,343368,343368,343370,0,2,3
98355,2,3,343370,343370,343373,0,3,0
98356,2,3,343372,343373,343376,1,4,0
98357,6,2,343378,343378,343380,0,2,2
98358,4,2,343382,343382,343384,0,2,2
98359,1,1,343383,343384,343385,1,2,0
98360,1,3,343384,343385,343388,1,4,0
98361,5,1,343389,343389,343390,0,1,1
98362,1,2,343390,343390,343392,0,2,0
98363,6,2,343396,343396,343398,0,2,4
98364,2,2,343398,343398,343400,0,2,0
98365,5,1,343403,343403,343404,0,1,3
98366,6,2,343409,343409,343411,0,2,5
98367,3,2,343412,343412,343414,0,2,1
98368,6,1,343418,343418,343419,0,1,4
98369,2,1,343420,343420,343421,0,1,1
98370,6,1,343426,343426,343427,0,1,5
98371,5,3,343431,343431,343434,0,3,4
98372,6,3,343437,343437,343440,0,3,3
98373,1,3,343438,343440,343443,2,5,0
98374,3,3,343441,343443,343446,2,5,0
98375,6,2,343447,343447,343449,0,2,1
98376,2,2,343449,343449,343451,0,2,0
98377,4,1,343453,343453,343454,0,1,2
98378,1,2,343454,343454,343456,0,2,0
98379,1,3,343455,343456,343459,1,4,0
98380,2,2,343457,343459,343461,2,4,0
98381,3,3,343460,343461,343464,1,4,0
98382,2,3,343462,343464,343467,2,5,0
98383,4,1,343466,343467,343468,1,2,0
98384,2,2,343468,343468,343470,0,2,0
98385,4,1,343472,343472,343473,0,1,2
98386,3,1,343475,343475,343476,0,1,2
98387,2,2,343477,343477,343479,0,2,1
98388,3,3,343480,343480,343483,0,3,1
98389,5,2,343485,343485,343487,0,2,2
98390,2,2,343487,343487,343489,0,2,0
98391,3,2,343490,343490,343492,0,2,1
98392,6,3,343496,343496,343499,0,3,4
98393,5,1,343501,343501,343502,0,1,2
98394,5,3,343506,343506,343509,0,3,4
98395,6,3,343512,343512,343515,0,3,3
98396,5,2,343517,343517,343519,0,2,2
98397,6,2,343523,343523,343525,0,2,4
98398,5,2,343528,343528,343530,0,2,3
98399,2,1,343530,343530,343531,0,1,0
98400,5,2,343535,343535,343537,0,2,4
98401,2,3,343537,343537,343540,0,3,0
98402,4,2,343541,343541,343543,0,2,1
98403,6,2,343547,343547,343549,0,2,4
98404,2,2,343549,343549,343551,0,2,0
98405,1,2,343550,343551,343553,1,3,0
98406,1,1,343551,343553,343554,2,3,0
98407,5,2,343556,343556,343558,0,2,2
98408,3,3,343559,343559,343562,0,3,1
98409,6,3,343565,343565,343568,0,3,3
98410,5,2,343570,343570,343572,0,2,2
98411,3,3,343573,343573,343576,0,3,1
98412,6,1,343579,343579,343580,0,1,3
98413,1,1,343580,343580,343581,0,1,0
98414,3,2,343583,343583,343585,0,2,2
98415,2,1,343585,343585,343586,0,1,0
98416,1,3,343586,343586,343589,0,3,0
98417,6,3,343592,343592,343595,0,3,3
98418,1,2,343593,343595,343597,2,4,0
98419,5,3,343598,343598,343601,0,3,1
98420,5,2,343603,343603,343605,0,2,2
98421,3,2,343606,343606,343608,0,2,1
98422,5,1,343611,343611,343612,0,1,3
98423,6,2,343617,343617,343619,0,2,5
98424,4,1,343621,343621,343622,0,1,2
98425,6,3,343627,343627,343630,0,3,5
98426,3,2,343630,343630,343632,0,2,0
98427,1,3,343631,343632,343635,1,4,0
98428,5,2,343636,343636,343638,0,2,1
98429,1,2,343637,343638,343640,1,3,0
98430,3,3,343640,343640,343643,0,3,0
98431,5,2,343645,343645,343647,0,2,2
98432,1,2,343646,343647,343649,1,3,0
98433,6,3,343652,343652,343655,0,3,3
98434,4,3,343656,343656,343659,0,3,1
98435,2,2,343658,343659,343661,1,3,0
98436,2,1,343660,343661,343662,1,2,0
98437,6,2,343666,343666,343668,0,2,4
98438,1,1,343667,343668,343669,1,2,0
98439,5,3,343672,343672,343675,0,3,3
98440,5,2,343677,343677,343679,0,2,2
98441,6,2,343683,343683,343685,0,2,4
98442,2,2,343685,343685,343687,0,2,0
98443,1,1,343686,343687,343688,1,2,0
98444,2,2,343688,343688,343690,0,2,0
98445,3,3,343691,343691,343694,0,3,1
98446,1,3,343692,343694,343697,2,5,0
98447,2,1,343694,343697,343698,3,4,0
98448,6,3,343700,343700,343703,0,3,2
98449,4,1,343704,343704,343705,0,1,1
98450,6,2,343710,343710,343712,0,2,5
98451,5,2,343715,343715,343717,0,2,3
98452,4,1,343719,343719,343720,0,1,2
98453,5,3,343724,343724,343727,0,3,4
98454,3,1,343727,343727,343728,0,1,0
98455,2,2,343729,343729,343731,0,2,1
98456,4,1,343733,343733,343734,0,1,2
98457,3,3,343736,343736,343739,0,3,2
98458,5,3,343741,343741,343744,0,3,2
98459,3,2,343744,343744,343746,0,2,0
98460,6,3,343750,343750,343753,0,3,4
98461,6,3,343756,343756,343759,0,3,3
98462,3,3,343759,343759,343762,0,3,0
98463,1,2,343760,343762,343764,2,4,0
98464,3,2,343763,343764,343766,1,3,0
98465,2,1,343765,343766,343767,1,2,0
98466,1,3,343766,343767,343770,1,4,0
98467,2,3,343768,343770,343773,2,5,0
98468,1,2,343769,343773,343775,4,6,0
98469,3,2,343772,343775,343777,3,5,0
98470,1,2,343773,343777,343779,4,6,0
98471,4,1,343777,343779,343780,2,3,0
98472,3,2,343780,343780,343782,0,2,0
98473,5,3,343785,343785,343788,0,3,3
98474,2,1,343787,343788,343789,1,2,0
98475,5,3,343792,343792,343795,0,3,3
98476,6,2,343798,343798,343800,0,2,3
98477,4,1,343802,343802,343803,0,1,2
98478,3,3,343805,343805,343808,0,3,2
98479,3,2,343808,343808,343810,0,2,0
98480,3,1,343811,343811,343812,0,1,1
98481,1,1,343812,343812,343813,0,1,0
98482,4,3,343816,343816,343819,0,3,3
98483,3,1,343819,343819,343820,0,1,0
98484,3,3,343822,343822,343825,0,3,2
98485,2,3,343824,343825,343828,1,4,0
98486,3,2,343827,343828,343830,1,3,0
98487,6,3,343833,343833,343836,0,3,3
98488,2,3,343835,343836,343839,1,4,0
98489,2,1,343837,343839,343840,2,3,0
98490,5,1,343842,343842,343843,0,1,2
98491,6,2,343848,343848,343850,0,2,5
98492,2,1,343850,343850,343851,0,1,0
98493,5,2,343855,343855,343857,0,2,4
98494,5,3,343860,343860,343863,0,3,3
98495,1,3,343861,343863,343866,2,5,0
98496,3,2,343864,343866,343868,2,4,0
98497,3,3,343867,343868,343871,1,4,0
98498,1,3,343868,343871,343874,3,6,0
98499,3,3,343871,343874,343877,3,6,0
98500,4,1,343875,343877,343878,2,3,0
98501,3,3,343878,343878,343881,0,3,0
98502,6,2,343884,343884,343886,0,2,3
98503,3,2,343887,343887,343889,0,2,1
98504,3,3,343890,343890,343893,0,3,1
98505,6,3,343896,343896,343899,0,3,3
98506,5,2,343901,343901,343903,0,2,2
98507,5,3,343906,343906,343909,0,3,3
98508,3,1,343909,343909,343910,0,1,0
98509,1,3,343910,343910,343913,0,3,0
98510,2,3,343912,343913,343916,1,4,0
98511,3,2,343915,343916,343918,1,3,0
98512,3,2,343918,343918,343920,0,2,0
98513,1,1,343919,343920,343921,1,2,0
98514,2,3,343921,343921,343924,0,3,0
98515,5,3,343926,343926,343929,0,3,2
98516,3,2,343929,343929,343931,0,2,0
98517,3,3,343932,343932,343935,0,3,1
98518,3,2,343935,343935,343937,0,2,0
98519,5,2,343940,343940,343942,0,2,3
98520,1,2,343941,343942,343944,1,3,0
98521,5,1,343946,343946,343947,0,1,2
98522,3,1,343949,343949,343950,0,1,2
98523,5,2,343954,343954,343956,0,2,4
98524,5,3,343959,343959,343962,0,3,3
98525,1,3,343960,343962,343965,2,5,0
98526,5,3,343965,343965,343968,0,3,0
98527,2,2,343967,343968,343970,1,3,0
98528,5,3,343972,343972,343975,0,3,2
98529,5,3,343977,343977,343980,0,3,2
98530,3,1,343980,343980,343981,0,1,0
98531,1,1,343981,343981,343982,0,1,0
98532,2,1,343983,343983,343984,0,1,1
98533,1,1,343984,343984,343985,0,1,0
98534,1,1,343985,343985,343986,0,1,0
98535,5,2,343990,343990,343992,0,2,4
98536,4,1,343994,343994,343995,0,1,2
98537,3,2,343997,343997,343999,0,2,2
98538,3,2,344000,344000,344002,0,2,1
98539,1,3,344001,344002,344005,1,4,0
98540,2,1,344003,344005,344006,2,3,0
98541,3,1,344006,344006,344007,0,1,0
98542,6,2,344012,344012,344014,0,2,5
98543,6,1,344018,344018,344019,0,1,4
98544,6,1,344024,344024,344025,0,1,5
98545,4,2,344028,344028,344030,0,2,3
98546,4,2,344032,344032,344034,0,2,2
98547,6,1,344038,344038,344039,0,1,4
98548,5,2,344043,344043,344045,0,2,4
98549,2,2,344045,344045,344047,0,2,0
98550,6,3,344051,344051,344054,0,3,4
98551,1,1,344052,344054,344055,2,3,0
98552,2,1,344054,344055,344056,1,2,0
98553,3,2,344057,344057,344059,0,2,1
98554,2,2,344059,344059,344061,0,2,0
98555,1,2,344060,344061,344063,1,3,0
98556,4,2,344064,344064,344066,0,2,1
98557,6,2,344070,344070,344072,0,2,4
98558,5,3,344075,344075,344078,0,3,3
98559,2,3,344077,344078,344081,1,4,0
98560,3,3,344080,344081,344084,1,4,0
98561,5,1,344085,344085,344086,0,1,1
98562,2,1,344087,344087,344088,0,1,1
98563,6,1,344093,344093,344094,0,1,5
98564,3,1,344096,344096,344097,0,1,2
98565,3,2,344099,344099,344101,0,2,2
98566,1,3,344100,344101,344104,1,4,0
98567,4,1,344104,344104,344105,0,1,0
98568,5,3,344109,344109,344112,0,3,4
98569,3,1,344112,344112,344113,0,1,0
98570,3,3,344115,344115,344118,0,3,2
98571,2,1,344117,344118,344119,1,2,0
98572,1,3,344118,344119,344122,1,4,0
98573,4,2,344122,344122,344124,0,2,0
98574,6,3,344128,344128,344131,0,3,4
98575,1,1,344129,344131,344132,2,3,0
98576,2,3,344131,344132,344135,1,4,0
98577,1,1,344132,344135,344136,3,4,0
98578,6,2,344138,344138,344140,0,2,2
98579,3,3,344141,344141,344144,0,3,1
98580,4,2,344145,344145,344147,0,2,1
98581,3,2,344148,344148,344150,0,2,1
98582,1,1,344149,344150,344151,1,2,0
98583,4,2,344153,344153,344155,0,2,2
98584,5,1,344158,344158,344159,0,1,3
98585,4,1,344162,344162,344163,0,1,3
98586,6,2,344168,344168,344170,0,2,5
98587,2,3,344170,344170,344173,0,3,0
98588,2,2,344172,344173,344175,1,3,0
98589,2,3,344174,344175,344178,1,4,0
98590,4,1,344178,344178,344179,0,1,0
98591,2,3,344180,344180,344183,0,3,1
98592,1,1,344181,344183,344184,2,3,0
98593,2,2,344183,344184,344186,1,3,0
98594,5,1,344188,344188,344189,0,1,2
98595,6,3,344194,344194,344197,0,3,5
98596,4,2,344198,344198,344200,0,2,1
98597,4,2,344202,344202,344204,0,2,2
98598,5,2,344207,344207,344209,0,2,3
98599,5,2,344212,344212,344214,0,2,3
98600,6,1,344218,344218,344219,0,1,4
98601,3,2,344221,344221,344223,0,2,2
98602,5,2,344226,344226,344228,0,2,3
98603,4,3,344230,344230,344233,0,3,2
98604,6,1,344236,344236,344237,0,1,3
98605,5,2,344241,344241,344243,0,2,4
98606,2,2,344243,344243,344245,0,2,0
98607,4,3,344247,344247,344250,0,3,2
98608,4,3,344251,344251,344254,0,3,1
98609,3,2,344254,344254,344256,0,2,0
98610,5,3,344259,344259,344262,0,3,3
98611,4,3,344263,344263,344266,0,3,1
98612,3,3,344266,344266,344269,0,3,0
98613,6,1,344272,344272,344273,0,1,3
98614,1,3,344273,344273,344276,0,3,0
98615,3,1,344276,344276,344277,0,1,0
98616,5,2,344281,344281,344283,0,2,4
98617,4,3,344285,344285,344288,0,3,2
98618,3,1,344288,344288,344289,0,1,0
98619,4,2,344292,344292,344294,0,2,3
98620,4,3,344296,344296,344299,0,3,2
98621,5,2,344301,344301,344303,0,2,2
98622,6,3,344307,344307,344310,0,3,4
98623,6,3,344313,344313,344316,0,3,3
98624,4,1,344317,344317,344318,0,1,1
98625,4,3,344321,344321,344324,0,3,3
98626,2,1,344323,344324,344325,1,2,0
98627,4,3,344327,344327,344330,0,3,2
98628,5,2,344332,344332,344334,0,2,2
98629,1,2,344333,344334,344336,1,3,0
98630,5,1,344338,344338,344339,0,1,2
98631,4,2,344342,344342,344344,0,2,3
98632,3,1,344345,344345,344346,0,1,1
98633,4,1,344349,344349,344350,0,1,3
98634,5,1,344354,344354,344355,0,1,4
98635,2,1,344356,344356,344357,0,1,1
98636,1,2,344357,344357,344359,0,2,0
98637,5,3,344362,344362,344365,0,3,3
98638,3,1,344365,344365,344366,0,1,0
98639,5,3,344370,344370,344373,0,3,4
98640,2,2,344372,344373,344375,1,3,0
98641,1,2,344373,344375,344377,2,4,0
98642,3,3,344376,344377,344380,1,4,0
98643,3,3,344379,344380,344383,1,4,0
98644,2,2,344381,344383,344385,2,4,0
98645,5,2,344386,344386,344388,0,2,1
98646,3,3,344389,344389,344392,0,3,1
98647,5,2,344394,344394,344396,0,2,2
98648,3,3,344397,344397,344400,0,3,1
98649,3,3,344400,344400,344403,0,3,0
98650,2,2,344402,344403,344405,1,3,0
98651,5,3,344407,344407,344410,0,3,2
98652,1,2,344408,344410,344412,2,4,0
98653,6,2,344414,344414,344416,0,2,2
98654,1,2,344415,344416,344418,1,3,0
98655,2,1,344417,344418,344419,1,2,0
98656,3,1,344420,344420,344421,0,1,1
98657,6,1,344426,344426,344427,0,1,5
98658,2,1,344428,344428,344429,0,1,1
98659,2,1,344430,344430,344431,0,1,1
98660,3,1,344433,344433,344434,0,1,2
98661,5,3,344438,344438,344441,0,3,4
98662,3,2,344441,344441,344443,0,2,0
98663,5,3,344446,344446,344449,0,3,3
98664,2,3,344448,344449,344452,1,4,0
98665,6,3,344454,344454,344457,0,3,2
98666,3,1,344457,344457,344458,0,1,0
98667,3,3,344460,344460,344463,0,3,2
98668,5,2,344465,344465,344467,0,2,2
98669,5,2,344470,344470,344472,0,2,3
98670,1,3,344471,344472,344475,1,4,0
98671,6,2,344477,344477,344479,0,2,2
98672,5,3,344482,344482,344485,0,3,3
98673,6,2,344488,344488,344490,0,2,3
98674,4,2,344492,344492,344494,0,2,2
98675,1,3,344493,344494,344497,1,4,0
98676,5,2,344498,344498,344500,0,2,1
98677,1,1,344499,344500,344501,1,2,0
98678,2,2,344501,344501,344503,0,2,0
98679,2,3,344503,344503,344506,0,3,0
98680,1,3,344504,344506,344509,2,5,0
98681,1,1,344505,344509,344510,4,5,0
98682,6,2,344511,344511,344513,0,2,1
98683,6,1,344517,344517,344518,0,1,4
98684,1,1,344518,344518,344519,0,1,0
98685,4,2,344522,344522,344524,0,2,3
98686,1,3,344523,344524,344527,1,4,0
98687,3,1,344526,344527,344528,1,2,0
98688,3,3,344529,344529,344532,0,3,1
98689,4,2,344533,344533,344535,0,2,1
98690,6,3,344539,344539,344542,0,3,4
98691,3,2,344542,344542,344544,0,2,0
98692,3,3,344545,344545,344548,0,3,1
98693,4,1,344549,344549,344550,0,1,1
98694,5,2,344554,344554,344556,0,2,4
98695,6,1,344560,344560,344561,0,1,4
98696,5,1,344565,344565,344566,0,1,4
98697,1,3,344566,344566,344569,0,3,0
98698,6,3,344572,344572,344575,0,3,3
98699,6,2,344578,344578,344580,0,2,3
98700,5,1,344583,344583,344584,0,1,3
98701,4,3,344587,344587,344590,0,3,3
98702,6,1,344593,344593,344594,0,1,3
98703,5,1,344598,344598,344599,0,1,4
98704,3,1,344601,344601,344602,0,1,2
98705,5,1,344606,344606,344607,0,1,4
98706,1,3,344607,344607,344610,0,3,0
98707,6,1,344613,344613,344614,0,1,3
98708,3,2,344616,344616,344618,0,2,2
98709,4,1,344620,344620,344621,0,1,2
98710,6,2,344626,344626,344628,0,2,5
98711,6,3,344632,344632,344635,0,3,4
98712,5,2,344637,344637,344639,0,2,2
98713,1,3,344638,344639,344642,1,4,0
98714,3,1,344641,344642,344643,1,2,0
98715,5,3,344646,344646,344649,0,3,3
98716,6,2,344652,344652,344654,0,2,3
98717,5,1,344657,344657,344658,0,1,3
98718,1,2,344658,344658,344660,0,2,0
98719,2,3,344660,344660,344663,0,3,0
98720,1,2,344661,344663,344665,2,4,0
98721,4,3,344665,344665,344668,0,3,0
98722,6,3,344671,344671,344674,0,3,3
98723,2,3,344673,344674,344677,1,4,0
98724,1,1,344674,344677,344678,3,4,0
98725,5,2,344679,344679,344681,0,2,1
98726,3,1,344682,344682,344683,0,1,1
98727,5,2,344687,344687,344689,0,2,4
98728,4,2,344691,344691,344693,0,2,2
98729,1,3,344692,344693,344696,1,4,0
98730,5,3,344697,344697,344700,0,3,1
98731,5,2,344702,344702,344704,0,2,2
98732,3,2,344705,344705,344707,0,2,1
98733,1,1,344706,344707,344708,1,2,0
98734,3,1,344709,344709,344710,0,1,1
98735,2,1,344711,344711,344712,0,1,1
98736,4,3,344715,344715,344718,0,3,3
98737,2,2,344717,344718,344720,1,3,0
98738,4,1,344721,344721,344722,0,1,1
98739,2,1,344723,344723,344724,0,1,1
98740,6,1,344729,344729,344730,0,1,5
98741,1,3,344730,344730,344733,0,3,0
98742,3,1,344733,344733,344734,0,1,0
98743,1,2,344734,344734,344736,0,2,0
98744,3,1,344737,344737,344738,0,1,1
98745,2,3,344739,344739,344742,0,3,1
98746,4,3,344743,344743,344746,0,3,1
98747,5,3,344748,344748,344751,0,3,2
98748,4,3,344752,344752,344755,0,3,1
98749,5,2,344757,344757,344759,0,2,2
98750,6,3,344763,344763,344766,0,3,4
98751,5,3,344768,344768,344771,0,3,2
98752,2,1,344770,344771,344772,1,2,0
98753,2,3,344772,344772,344775,0,3,0
98754,5,2,344777,344777,344779,0,2,2
98755,2,3,344779,344779,344782,0,3,0
98756,3,1,344782,344782,344783,0,1,0
98757,6,1,344788,344788,344789,0,1,5
98758,5,3,344793,344793,344796,0,3,4
98759,6,1,344799,344799,344800,0,1,3
98760,2,1,344801,344801,344802,0,1,1
98761,1,1,344802,344802,344803,0,1,0
98762,3,2,344805,344805,344807,0,2,2
98763,6,2,344811,344811,344813,0,2,4
98764,1,1,344812,344813,344814,1,2,0
98765,6,3,344818,344818,344821,0,3,4
98766,4,3,344822,344822,344825,0,3,1
98767,4,1,344826,344826,344827,0,1,1
98768,2,2,344828,344828,344830,0,2,1
98769,3,1,344831,344831,344832,0,1,1
98770,2,2,344833,344833,344835,0,2,1
98771,1,1,344834,344835,344836,1,2,0
98772,2,1,344836,344836,344837,0,1,0
98773,3,3,344839,344839,344842,0,3,2
98774,2,3,344841,344842,344845,1,4,0
98775,3,2,344844,344845,344847,1,3,0
98776,3,3,344847,344847,344850,0,3,0
98777,3,3,344850,344850,344853,0,3,0
98778,3,1,344853,344853,344854,0,1,0
98779,6,3,344859,344859,344862,0,3,5
98780,4,2,344863,344863,344865,0,2,1
98781,5,1,344868,344868,344869,0,1,3
98782,2,1,344870,344870,344871,0,1,1
98783,6,3,344876,344876,344879,0,3,5
98784,3,2,344879,344879,344881,0,2,0
98785,4,2,344883,344883,344885,0,2,2
98786,4,3,344887,344887,344890,0,3,2
98787,4,2,344891,344891,344893,0,2,1
98788,4,2,344895,344895,344897,0,2,2
98789,4,3,344899,344899,344902,0,3,2
98790,5,2,344904,344904,344906,0,2,2
98791,1,2,344905,344906,344908,1,3,0
98792,5,3,344910,344910,344913,0,3,2
98793,2,2,344912,344913,344915,1,3,0
98794,5,3,344917,344917,344920,0,3,2
98795,4,2,344921,344921,344923,0,2,1
98796,2,3,344923,344923,344926,0,3,0
98797,6,2,344929,344929,344931,0,2,3
98798,5,1,344934,344934,344935,0,1,3
98799,3,1,344937,344937,344938,0,1,2
98800,2,2,344939,344939,344941,0,2,1
98801,4,1,344943,344943,344944,0,1,2
98802,2,2,344945,344945,344947,0,2,1
98803,3,3,344948,344948,344951,0,3,1
98804,5,2,344953,344953,344955,0,2,2
98805,2,2,344955,344955,344957,0,2,0
98806,6,3,344961,344961,344964,0,3,4
98807,6,2,344967,344967,344969,0,2,3
98808,3,3,344970,344970,344973,0,3,1
98809,5,2,344975,344975,344977,0,2,2
98810,6,3,344981,344981,344984,0,3,4
98811,2,1,344983,344984,344985,1,2,0
98812,6,2,344989,344989,344991,0,2,4
98813,2,2,344991,344991,344993,0,2,0
98814,1,1,344992,344993,344994,1,2,0
98815,2,1,344994,344994,344995,0,1,0
98816,6,1,345000,345000,345001,0,1,5
98817,1,3,345001,345001,345004,0,3,0
98818,5,1,345006,345006,345007,0,1,2
98819,3,1,345009,345009,345010,0,1,2
98820,4,3,345013,345013,345016,0,3,3
98821,3,3,345016,345016,345019,0,3,0
98822,1,2,345017,345019,345021,2,4,0
98823,3,3,345020,345021,345024,1,4,0
98824,2,1,345022,345024,345025,2,3,0
98825,3,2,345025,345025,345027,0,2,0
98826,6,3,345031,345031,345034,0,3,4
98827,1,2,345032,345034,345036,2,4,0
98828,4,1,345036,345036,345037,0,1,0
98829,6,3,345042,345042,345045,0,3,5
98830,1,3,345043,345045,345048,2,5,0
98831,3,3,345046,345048,345051,2,5,0
98832,2,3,345048,345051,345054,3,6,0
98833,3,2,345051,345054,345056,3,5,0
98834,6,3,345057,345057,345060,0,3,1
98835,5,2,345062,345062,345064,0,2,2
98836,1,3,345063,345064,345067,1,4,0
98837,4,3,345067,345067,345070,0,3,0
98838,5,2,345072,345072,345074,0,2,2
98839,4,2,345076,345076,345078,0,2,2
98840,1,2,345077,345078,345080,1,3,0
98841,1,2,345078,345080,345082,2,4,0
98842,3,1,345081,345082,345083,1,2,0
98843,3,2,345084,345084,345086,0,2,1
98844,5,1,345089,345089,345090,0,1,3
98845,6,2,345095,345095,345097,0,2,5
98846,2,1,345097,345097,345098,0,1,0
98847,6,3,345103,345103,345106,0,3,5
98848,6,2,345109,345109,345111,0,2,3
98849,1,1,345110,345111,345112,1,2,0
98850,2,1,345112,345112,345113,0,1,0
98851,1,2,345113,345113,345115,0,2,0
98852,6,2,345119,345119,345121,0,2,4
98853,6,1,345125,345125,345126,0,1,4
98854,4,1,345129,345129,345130,0,1,3
98855,2,2,345131,345131,345133,0,2,1
98856,6,1,345137,345137,345138,0,1,4
98857,1,3,345138,345138,345141,0,3,0
98858,1,2,345139,345141,345143,2,4,0
98859,5,1,345144,345144,345145,0,1,1
98860,6,3,345150,345150,345153,0,3,5
98861,2,2,345152,345153,345155,1,3,0
98862,5,2,345157,345157,345159,0,2,2
98863,5,1,345162,345162,345163,0,1,3
98864,6,3,345168,345168,345171,0,3,5
98865,6,3,345174,345174,345177,0,3,3
98866,4,3,345178,345178,345181,0,3,1
98867,3,1,345181,345181,345182,0,1,0
98868,2,3,345183,345183,345186,0,3,1
98869,4,2,345187,345187,345189,0,2,1
98870,2,3,345189,345189,345192,0,3,0
98871,3,2,345192,345192,345194,0,2,0
98872,2,3,345194,345194,345197,0,3,0
98873,1,1,345195,345197,345198,2,3,0
98874,4,2,345199,345199,345201,0,2,1
98875,3,1,345202,345202,345203,0,1,1
98876,2,2,345204,345204,345206,0,2,1
98877,3,3,345207,345207,345210,0,3,1
98878,1,3,345208,345210,345213,2,5,0
98879,5,3,345213,345213,345216,0,3,0
98880,6,1,345219,345219,345220,0,1,3
98881,2,3,345221,345221,345224,0,3,1
98882,5,1,345226,345226,345227,0,1,2
98883,1,3,345227,345227,345230,0,3,0
98884,6,2,345233,345233,345235,0,2,3
98885,4,3,345237,345237,345240,0,3,2
98886,2,2,345239,345240,345242,1,3,0
98887,2,3,345241,345242,345245,1,4,0
98888,1,1,345242,345245,345246,3,4,0
98889,2,2,345244,345246,345248,2,4,0
98890,4,2,345248,345248,345250,0,2,0
98891,2,1,345250,345250,345251,0,1,0
98892,4,2,345254,345254,345256,0,2,3
98893,2,1,345256,345256,345257,0,1,0
98894,4,2,345260,345260,345262,0,2,3
98895,3,2,345263,345263,345265,0,2,1
98896,2,2,345265,345265,345267,0,2,0
98897,3,2,345268,345268,345270,0,2,1
98898,5,3,345273,345273,345276,0,3,3
98899,1,1,345274,345276,345277,2,3,0
98900,5,3,345279,345279,345282,0,3,2
98901,2,3,345281,345282,345285,1,4,0
98902,6,3,345287,345287,345290,0,3,2
98903,2,2,345289,345290,345292,1,3,0
98904,3,2,345292,345292,345294,0,2,0
98905,6,1,345298,345298,345299,0,1,4
98906,3,3,345301,345301,345304,0,3,2
98907,3,2,345304,345304,345306,0,2,0
98908,4,1,345308,345308,345309,0,1,2
98909,2,1,345310,345310,345311,0,1,1
98910,4,2,345314,345314,345316,0,2,3
98911,2,3,345316,345316,345319,0,3,0
98912,1,3,345317,345319,345322,2,5,0
98913,5,2,345322,345322,345324,0,2,0
98914,5,2,345327,345327,345329,0,2,3
98915,1,3,345328,345329,345332,1,4,0
98916,2,2,345330,345332,345334,2,4,0
98917,5,2,345335,345335,345337,0,2,1
98918,4,3,345339,345339,345342,0,3,2
98919,3,2,345342,345342,345344,0,2,0
98920,1,2,345343,345344,345346,1,3,0
98921,3,3,345346,345346,345349,0,3,0
98922,3,2,345349,345349,345351,0,2,0
98923,4,3,345353,345353,345356,0,3,2
98924,1,3,345354,345356,345359,2,5,0
98925,2,1,345356,345359,345360,3,4,0
98926,3,2,345359,345360,345362,1,3,0
98927,6,2,345365,345365,345367,0,2,3
98928,4,1,345369,345369,345370,0,1,2
98929,1,3,345370,345370,345373,0,3,0
98930,2,1,345372,345373,345374,1,2,0
98931,1,3,345373,345374,345377,1,4,0
98932,1,2,345374,345377,345379,3,5,0
98933,2,3,345376,345379,345382,3,6,0
98934,5,3,345381,345382,345385,1,4,0
98935,5,2,345386,345386,345388,0,2,1
98936,5,1,345391,345391,345392,0,1,3
98937,5,1,345396,345396,345397,0,1,4
98938,5,3,345401,345401,345404,0,3,4
98939,3,1,345404,345404,345405,0,1,0
98940,5,1,345409,345409,345410,0,1,4
98941,3,1,345412,345412,345413,0,1,2
98942,6,3,345418,345418,345421,0,3,5
98943,1,1,345419,345421,345422,2,3,0
98944,3,3,345422,345422,345425,0,3,0
98945,3,1,345425,345425,345426,0,1,0
98946,1,2,345426,345426,345428,0,2,0
98947,1,2,345427,345428,345430,1,3,0
98948,3,1,345430,345430,345431,0,1,0
98949,3,2,345433,345433,345435,0,2,2
98950,1,3,345434,345435,345438,1,4,0
98951,4,1,345438,345438,345439,0,1,0
98952,6,1,345444,345444,345445,0,1,5
98953,3,2,345447,345447,345449,0,2,2
98954,4,3,345451,345451,345454,0,3,2
98955,2,2,345453,345454,345456,1,3,0
98956,4,3,345457,345457,345460,0,3,1
98957,1,3,345458,345460,345463,2,5,0
98958,1,1,345459,345463,345464,4,5,0
98959,5,3,345464,345464,345467,0,3,0
98960,6,3,345470,345470,345473,0,3,3
98961,2,3,345472,345473,345476,1,4,0
98962,5,1,345477,345477,345478,0,1,1
98963,3,2,345480,345480,345482,0,2,2
98964,2,1,345482,345482,345483,0,1,0
98965,4,2,345486,345486,345488,0,2,3
98966,3,1,345489,345489,345490,0,1,1
98967,6,3,345495,345495,345498,0,3,5
98968,5,3,345500,345500,345503,0,3,2
98969,5,2,345505,345505,345507,0,2,2
98970,1,2,345506,345507,345509,1,3,0
98971,5,2,345511,345511,345513,0,2,2
98972,6,1,345517,345517,345518,0,1,4
98973,1,3,345518,345518,345521,0,3,0
98974,6,3,345524,345524,345527,0,3,3
98975,2,1,345526,345527,345528,1,2,0
98976,1,3,345527,345528,345531,1,4,0
98977,4,1,345531,345531,345532,0,1,0
98978,1,1,345532,345532,345533,0,1,0
98979,2,2,345534,345534,345536,0,2,1
98980,1,2,345535,345536,345538,1,3,0
98981,2,2,345537,345538,345540,1,3,0
98982,5,2,345542,345542,345544,0,2,2
98983,5,3,345547,345547,345550,0,3,3
98984,3,3,345550,345550,345553,0,3,0
98985,6,3,345556,345556,345559,0,3,3
98986,5,1,345561,345561,345562,0,1,2
98987,2,3,345563,345563,345566,0,3,1
98988,6,1,345569,345569,345570,0,1,3
98989,2,2,345571,345571,345573,0,2,1
98990,3,3,345574,345574,345577,0,3,1
98991,5,1,345579,345579,345580,0,1,2
98992,4,2,345583,345583,345585,0,2,3
98993,6,3,345589,345589,345592,0,3,4
98994,1,2,345590,345592,345594,2,4,0
98995,2,3,345592,345594,345597,2,5,0
98996,2,2,345594,345597,345599,3,5,0
98997,4,3,345598,345599,345602,1,4,0
98998,4,2,345602,345602,345604,0,2,0
98999,1,3,345603,345604,345607,1,4,0
99000,5,3,345608,345608,345611,0,3,1
99001,3,1,345611,345611,345612,0,1,0
99002,5,2,345616,345616,345618,0,2,4
99003,3,2,345619,345619,345621,0,2,1
99004,2,1,345621,345621,345622,0,1,0
99005,6,2,345627,345627,345629,0,2,5
99006,6,1,345633,345633,345634,0,1,4
99007,1,2,345634,345634,345636,0,2,0
99008,2,2,345636,345636,345638,0,2,0
99009,1,2,345637,345638,345640,1,3,0
99010,4,3,345641,345641,345644,0,3,1
99011,2,3,345643,345644,345647,1,4,0
99012,6,3,345649,345649,345652,0,3,2
99013,3,3,345652,345652,345655,0,3,0
99014,4,3,345656,345656,345659,0,3,1
99015,2,3,345658,345659,345662,1,4,0
99016,4,2,345662,345662,345664,0,2,0
99017,3,1,345665,345665,345666,0,1,1
99018,3,2,345668,345668,345670,0,2,2
99019,6,2,345674,345674,345676,0,2,4
99020,2,3,345676,345676,345679,0,3,0
99021,6,3,345682,345682,345685,0,3,3
99022,5,1,345687,345687,345688,0,1,2
99023,2,2,345689,345689,345691,0,2,1
99024,5,2,345694,345694,345696,0,2,3
99025,4,1,345698,345698,345699,0,1,2
99026,2,2,345700,345700,345702,0,2,1
99027,1,2,345701,345702,345704,1,3,0
99028,3,1,345704,345704,345705,0,1,0
99029,5,1,345709,345709,345710,0,1,4
99030,2,1,345711,345711,345712,0,1,1
99031,3,3,345714,345714,345717,0,3,2
99032,1,1,345715,345717,345718,2,3,0
99033,2,2,345717,345718,345720,1,3,0
99034,5,1,345722,345722,345723,0,1,2
99035,4,1,345726,345726,345727,0,1,3
99036,3,2,345729,345729,345731,0,2,2
99037,5,1,345734,345734,345735,0,1,3
99038,5,2,345739,345739,345741,0,2,4
99039,1,2,345740,345741,345743,1,3,0
99040,6,1,345746,345746,345747,0,1,3
99041,2,2,345748,345748,345750,0,2,1
99042,6,2,345754,345754,345756,0,2,4
99043,2,1,345756,345756,345757,0,1,0
99044,1,1,345757,345757,345758,0,1,0
99045,3,2,345760,345760,345762,0,2,2
99046,5,2,345765,345765,345767,0,2,3
99047,5,2,345770,345770,345772,0,2,3
99048,5,3,345775,345775,345778,0,3,3
99049,1,1,345776,345778,345779,2,3,0
99050,6,1,345782,345782,345783,0,1,3
99051,4,2,345786,345786,345788,0,2,3
99052,1,2,345787,345788,345790,1,3,0
99053,2,1,345789,345790,345791,1,2,0
99054,5,2,345794,345794,345796,0,2,3
99055,5,3,345799,345799,345802,0,3,3
99056,4,1,345803,345803,345804,0,1,1
99057,2,2,345805,345805,345807,0,2,1
99058,2,3,345807,345807,345810,0,3,0
99059,2,3,345809,345810,345813,1,4,0
99060,2,1,345811,345813,345814,2,3,0
99061,4,2,345815,345815,345817,0,2,1
99062,3,1,345818,345818,345819,0,1,1
99063,3,1,345821,345821,345822,0,1,2
99064,3,2,345824,345824,345826,0,2,2
99065,3,2,345827,345827,345829,0,2,1
99066,3,3,345830,345830,345833,0,3,1
99067,1,3,345831,345833,345836,2,5,0
99068,6,2,345837,345837,345839,0,2,1
99069,6,3,345843,345843,345846,0,3,4
99070,6,3,345849,345849,345852,0,3,3
99071,4,2,345853,345853,345855,0,2,1
99072,2,1,345855,345855,345856,0,1,0
99073,4,1,345859,345859,345860,0,1,3
99074,2,1,345861,345861,345862,0,1,1
99075,5,2,345866,345866,345868,0,2,4
99076,4,3,345870,345870,345873,0,3,2
99077,2,2,345872,345873,345875,1,3,0
99078,3,1,345875,345875,345876,0,1,0
99079,2,2,345877,345877,345879,0,2,1
99080,2,1,345879,345879,345880,0,1,0
99081,1,1,345880,345880,345881,0,1,0
99082,6,2,345886,345886,345888,0,2,5
99083,6,2,345892,345892,345894,0,2,4
99084,1,2,345893,345894,345896,1,3,0
99085,2,3,345895,345896,345899,1,4,0
99086,6,1,345901,345901,345902,0,1,2
99087,5,3,345906,345906,345909,0,3,4
99088,4,3,345910,345910,345913,0,3,1
99089,3,1,345913,345913,345914,0,1,0
99090,5,1,345918,345918,345919,0,1,4
99091,3,1,345921,345921,345922,0,1,2
99092,1,2,345922,345922,345924,0,2,0
99093,1,3,345923,345924,345927,1,4,0
99094,3,1,345926,345927,345928,1,2,0
99095,4,3,345930,345930,345933,0,3,2
99096,2,1,345932,345933,345934,1,2,0
99097,2,3,345934,345934,345937,0,3,0
99098,4,3,345938,345938,345941,0,3,1
99099,4,2,345942,345942,345944,0,2,1
99100,5,3,345947,345947,345950,0,3,3
99101,5,3,345952,345952,345955,0,3,2
99102,3,1,345955,345955,345956,0,1,0
99103,4,1,345959,345959,345960,0,1,3
99104,2,3,345961,345961,345964,0,3,1
99105,2,3,345963,345964,345967,1,4,0
99106,6,3,345969,345969,345972,0,3,2
99107,1,1,345970,345972,345973,2,3,0
99108,4,3,345974,345974,345977,0,3,1
99109,2,3,345976,345977,345980,1,4,0
99110,6,2,345982,345982,345984,0,2,2
99111,6,2,345988,345988,345990,0,2,4
99112,4,3,345992,345992,345995,0,3,2
99113,5,3,345997,345997,346000,0,3,2
99114,5,1,346002,346002,346003,0,1,2
99115,1,1,346003,346003,346004,0,1,0
99116,6,3,346009,346009,346012,0,3,5
99117,6,2,346015,346015,346017,0,2,3
99118,2,3,346017,346017,346020,0,3,0
99119,2,2,346019,346020,346022,1,3,0
99120,2,1,346021,346022,346023,1,2,0
99121,1,3,346022,346023,346026,1,4,0
99122,5,1,346027,346027,346028,0,1,1
99123,2,1,346029,346029,346030,0,1,1
99124,2,2,346031,346031,346033,0,2,1
99125,4,1,346035,346035,346036,0,1,2
99126,2,3,346037,346037,346040,0,3,1
99127,3,3,346040,346040,346043,0,3,0
99128,4,2,346044,346044,346046,0,2,1
99129,6,2,346050,346050,346052,0,2,4
99130,6,2,346056,346056,346058,0,2,4
99131,5,2,346061,346061,346063,0,2,3
99132,5,2,346066,346066,346068,0,2,3
99133,1,3,346067,346068,346071,1,4,0
99134,6,1,346073,346073,346074,0,1,2
99135,1,1,346074,346074,346075,0,1,0
99136,1,3,346075,346075,346078,0,3,0
99137,1,3,346076,346078,346081,2,5,0
99138,3,1,346079,346081,346082,2,3,0
99139,1,1,346080,346082,346083,2,3,0
99140,1,3,346081,346083,346086,2,5,0
99141,3,3,346084,346086,346089,2,5,0
99142,1,1,346085,346089,346090,4,5,0
99143,5,1,346090,346090,346091,0,1,0
99144,5,2,346095,346095,346097,0,2,4
99145,4,2,346099,346099,346101,0,2,2
99146,1,3,346100,346101,346104,1,4,0
99147,4,3,346104,346104,346107,0,3,0
99148,5,1,346109,346109,346110,0,1,2
99149,2,2,346111,346111,346113,0,2,1
99150,4,1,346115,346115,346116,0,1,2
99151,1,1,346116,346116,346117,0,1,0
99152,3,2,346119,346119,346121,0,2,2
99153,4,2,346123,346123,346125,0,2,2
99154,3,1,346126,346126,346127,0,1,1
99155,4,1,346130,346130,346131,0,1,3
99156,4,3,346134,346134,346137,0,3,3
99157,3,2,346137,346137,346139,0,2,0
99158,6,2,346143,346143,346145,0,2,4
99159,2,2,346145,346145,346147,0,2,0
99160,4,3,346149,346149,346152,0,3,2
99161,1,2,346150,346152,346154,2,4,0
99162,5,3,346155,346155,346158,0,3,1
99163,6,1,346161,346161,346162,0,1,3
99164,3,3,346164,346164,346167,0,3,2
99165,2,1,346166,346167,346168,1,2,0
99166,5,3,346171,346171,346174,0,3,3
99167,5,1,346176,346176,346177,0,1,2
99168,4,1,346180,346180,346181,0,1,3
99169,5,3,346185,346185,346188,0,3,4
99170,2,3,346187,346188,346191,1,4,0
99171,6,1,346193,346193,346194,0,1,2
99172,3,3,346196,346196,346199,0,3,2
99173,3,1,346199,346199,346200,0,1,0
99174,3,1,346202,346202,346203,0,1,2
99175,3,1,346205,346205,346206,0,1,2
99176,4,3,346209,346209,346212,0,3,3
99177,1,2,346210,346212,346214,2,4,0
99178,5,3,346215,346215,346218,0,3,1
99179,5,2,346220,346220,346222,0,2,2
99180,2,3,346222,346222,346225,0,3,0
99181,3,1,346225,346225,346226,0,1,0
99182,1,1,346226,346226,346227,0,1,0
99183,5,1,346231,346231,346232,0,1,4
99184,1,1,346232,346232,346233,0,1,0
99185,1,1,346233,346233,346234,0,1,0
99186,1,3,346234,346234,346237,0,3,0
99187,3,2,346237,346237,346239,0,2,0
99188,5,3,346242,346242,346245,0,3,3
99189,5,2,346247,346247,346249,0,2,2
99190,4,2,346251,346251,346253,0,2,2
99191,2,2,346253,346253,346255,0,2,0
99192,1,3,346254,346255,346258,1,4,0
99193,1,1,346255,346258,346259,3,4,0
99194,4,1,346259,346259,346260,0,1,0
99195,5,3,346264,346264,346267,0,3,4
99196,1,1,346265,346267,346268,2,3,0
99197,2,3,346267,346268,346271,1,4,0
99198,3,2,346270,346271,346273,1,3,0
99199,6,2,346276,346276,346278,0,2,3
99200,3,1,346279,346279,346280,0,1,1
99201,5,1,346284,346284,346285,0,1,4
99202,4,3,346288,346288,346291,0,3,3
99203,2,3,346290,346291,346294,1,4,0
99204,6,2,346296,346296,346298,0,2,2
99205,3,1,346299,346299,346300,0,1,1
99206,1,3,346300,346300,346303,0,3,0
99207,1,1,346301,346303,346304,2,3,0
99208,3,2,346304,346304,346306,0,2,0
99209,1,2,346305,346306,346308,1,3,0
99210,1,1,346306,346308,346309,2,3,0
99211,5,2,346311,346311,346313,0,2,2
99212,5,2,346316,346316,346318,0,2,3
99213,5,1,346321,346321,346322,0,1,3
99214,3,1,346324,346324,346325,0,1,2
99215,6,3,346330,346330,346333,0,3,5
99216,4,2,346334,346334,346336,0,2,1
99217,6,2,346340,346340,346342,0,2,4
99218,4,3,346344,346344,346347,0,3,2
99219,4,3,346348,346348,346351,0,3,1
99220,5,3,346353,346353,346356,0,3,2
99221,3,3,346356,346356,346359,0,3,0
99222,3,2,346359,346359,346361,0,2,0
99223,1,2,346360,346361,346363,1,3,0
99224,1,2,346361,346363,346365,2,4,0
99225,1,2,346362,346365,346367,3,5,0
99226,3,2,346365,346367,346369,2,4,0
99227,3,1,346368,346369,346370,1,2,0
99228,4,1,346372,346372,346373,0,1,2
99229,2,2,346374,346374,346376,0,2,1
99230,2,2,346376,346376,346378,0,2,0
99231,4,1,346380,346380,346381,0,1,2
99232,5,1,346385,346385,346386,0,1,4
99233,4,1,346389,346389,346390,0,1,3
99234,1,3,346390,346390,346393,0,3,0
99235,6,1,346396,346396,346397,0,1,3
99236,6,2,346402,346402,346404,0,2,5
99237,3,2,346405,346405,346407,0,2,1
99238,3,2,346408,346408,346410,0,2,1
99239,4,1,346412,346412,346413,0,1,2
99240,2,2,346414,346414,346416,0,2,1
99241,2,1,346416,346416,346417,0,1,0
99242,6,3,346422,346422,346425,0,3,5
99243,1,1,346423,346425,346426,2,3,0
99244,6,1,346429,346429,346430,0,1,3
99245,2,3,346431,346431,346434,0,3,1
99246,2,2,346433,346434,346436,1,3,0
99247,6,2,346439,346439,346441,0,2,3
99248,2,2,346441,346441,346443,0,2,0
99249,1,1,346442,346443,346444,1,2,0
99250,2,1,346444,346444,346445,0,1,0
99251,3,3,346447,346447,346450,0,3,2
99252,3,1,346450,346450,346451,0,1,0
99253,6,1,346456,346456,346457,0,1,5
99254,1,1,346457,346457,346458,0,1,0
99255,3,1,346460,346460,346461,0,1,2
99256,5,3,346465,346465,346468,0,3,4
99257,2,2,346467,346468,346470,1,3,0
99258,1,1,346468,346470,346471,2,3,0
99259,5,1,346473,346473,346474,0,1,2
99260,5,1,346478,346478,346479,0,1,4
99261,3,2,346481,346481,346483,0,2,2
99262,5,1,346486,346486,346487,0,1,3
99263,3,2,346489,346489,346491,0,2,2
99264,3,3,346492,346492,346495,0,3,1
99265,5,1,346497,346497,346498,0,1,2
99266,2,2,346499,346499,346501,0,2,1
99267,1,1,346500,346501,346502,1,2,0
99268,3,3,346503,346503,346506,0,3,1
99269,1,1,346504,346506,346507,2,3,0
99270,3,2,346507,346507,346509,0,2,0
99271,1,1,346508,346509,346510,1,2,0
99272,3,2,346511,346511,346513,0,2,1
99273,2,1,346513,346513,346514,0,1,0
99274,6,3,346519,346519,346522,0,3,5
99275,5,1,346524,346524,346525,0,1,2
99276,3,3,346527,346527,346530,0,3,2
99277,2,1,346529,346530,346531,1,2,0
99278,5,1,346534,346534,346535,0,1,3
99279,1,3,346535,346535,346538,0,3,0
99280,1,1,346536,346538,346539,2,3,0
99281,5,1,346541,346541,346542,0,1,2
99282,3,2,346544,346544,346546,0,2,2
99283,1,3,346545,346546,346549,1,4,0
99284,1,2,346546,346549,346551,3,5,0
99285,5,2,346551,346551,346553,0,2,0
99286,3,2,346554,346554,346556,0,2,1
99287,3,2,346557,346557,346559,0,2,1
99288,4,2,346561,346561,346563,0,2,2
99289,6,3,346567,346567,346570,0,3,4
99290,4,1,346571,346571,346572,0,1,1
99291,6,1,346577,346577,346578,0,1,5
99292,2,2,346579,346579,346581,0,2,1
99293,3,2,346582,346582,346584,0,2,1
99294,4,3,346586,346586,346589,0,3,2
99295,2,2,346588,346589,346591,1,3,0
99296,1,2,346589,346591,346593,2,4,0
99297,2,1,346591,346593,346594,2,3,0
99298,5,2,346596,346596,346598,0,2,2
99299,4,1,346600,346600,346601,0,1,2
99300,2,3,346602,346602,346605,0,3,1
99301,3,2,346605,346605,346607,0,2,0
99302,6,3,346611,346611,346614,0,3,4
99303,2,1,346613,346614,346615,1,2,0
99304,6,1,346619,346619,346620,0,1,4
99305,6,1,346625,346625,346626,0,1,5
99306,4,2,346629,346629,346631,0,2,3
99307,1,1,346630,346631,346632,1,2,0
99308,2,1,346632,346632,346633,0,1,0
99309,6,3,346638,346638,346641,0,3,5
99310,4,2,346642,346642,346644,0,2,1
99311,5,3,346647,346647,346650,0,3,3
99312,3,1,346650,346650,346651,0,1,0
99313,1,2,346651,346651,346653,0,2,0
99314,1,3,346652,346653,346656,1,4,0
99315,6,1,346658,346658,346659,0,1,2
99316,1,3,346659,346659,346662,0,3,0
99317,3,3,346662,346662,346665,0,3,0
99318,6,1,346668,346668,346669,0,1,3
99319,6,2,346674,346674,346676,0,2,5
99320,4,2,346678,346678,346680,0,2,2
99321,4,2,346682,346682,346684,0,2,2
99322,5,3,346687,346687,346690,0,3,3
99323,6,2,346693,346693,346695,0,2,3
99324,1,3,346694,346695,346698,1,4,0
99325,3,2,346697,346698,346700,1,3,0
99326,6,3,346703,346703,346706,0,3,3
99327,2,1,346705,346706,346707,1,2,0
99328,1,2,346706,346707,346709,1,3,0
99329,4,3,346710,346710,346713,0,3,1
99330,4,1,346714,346714,346715,0,1,1
99331,4,3,346718,346718,346721,0,3,3
99332,3,3,346721,346721,346724,0,3,0
99333,5,3,346726,346726,346729,0,3,2
99334,4,2,346730,346730,346732,0,2,1
99335,5,1,346735,346735,346736,0,1,3
99336,1,1,346736,346736,346737,0,1,0
99337,6,2,346742,346742,346744,0,2,5
99338,6,2,346748,346748,346750,0,2,4
99339,6,1,346754,346754,346755,0,1,4
99340,6,3,346760,346760,346763,0,3,5
99341,4,1,346764,346764,346765,0,1,1
99342,6,1,346770,346770,346771,0,1,5
99343,3,2,346773,346773,346775,0,2,2
99344,5,3,346778,346778,346781,0,3,3
99345,5,2,346783,346783,346785,0,2,2
99346,1,3,346784,346785,346788,1,4,0
99347,4,1,346788,346788,346789,0,1,0
99348,4,2,346792,346792,346794,0,2,3
99349,5,3,346797,346797,346800,0,3,3
99350,3,1,346800,346800,346801,0,1,0
99351,2,1,346802,346802,346803,0,1,1
99352,2,2,346804,346804,346806,0,2,1
99353,4,1,346808,346808,346809,0,1,2
99354,6,1,346814,346814,346815,0,1,5
99355,1,2,346815,346815,346817,0,2,0
99356,5,3,346820,346820,346823,0,3,3
99357,3,1,346823,346823,346824,0,1,0
99358,1,3,346824,346824,346827,0,3,0
99359,5,1,346829,346829,346830,0,1,2
99360,5,3,346834,346834,346837,0,3,4
99361,1,3,346835,346837,346840,2,5,0
99362,6,2,346841,346841,346843,0,2,1
99363,5,2,346846,346846,346848,0,2,3
99364,1,2,346847,346848,346850,1,3,0
99365,1,2,346848,346850,346852,2,4,0
99366,3,3,346851,346852,346855,1,4,0
99367,5,1,346856,346856,346857,0,1,1
99368,4,1,346860,346860,346861,0,1,3
99369,2,2,346862,346862,346864,0,2,1
99370,4,1,346866,346866,346867,0,1,2
99371,1,1,346867,346867,346868,0,1,0
99372,2,3,346869,346869,346872,0,3,1
99373,6,2,346875,346875,346877,0,2,3
99374,5,3,346880,346880,346883,0,3,3
99375,3,2,346883,346883,346885,0,2,0
99376,3,3,346886,346886,346889,0,3,1
99377,4,1,346890,346890,346891,0,1,1
99378,3,2,346893,346893,346895,0,2,2
99379,4,2,346897,346897,346899,0,2,2
99380,6,1,346903,346903,346904,0,1,4
99381,2,3,346905,346905,346908,0,3,1
99382,2,3,346907,346908,346911,1,4,0
99383,2,2,346909,346911,346913,2,4,0
99384,3,3,346912,346913,346916,1,4,0
99385,6,3,346918,346918,346921,0,3,2
99386,3,3,346921,346921,346924,0,3,0
99387,6,1,346927,346927,346928,0,1,3
99388,4,1,346931,346931,346932,0,1,3
99389,3,1,346934,346934,346935,0,1,2
99390,5,1,346939,346939,346940,0,1,4
99391,3,2,346942,346942,346944,0,2,2
99392,4,3,346946,346946,346949,0,3,2
99393,1,1,346947,346949,346950,2,3,0
99394,5,2,346952,346952,346954,0,2,2
99395,5,2,346957,346957,346959,0,2,3
99396,5,1,346962,346962,346963,0,1,3
99397,1,1,346963,346963,346964,0,1,0
99398,2,2,346965,346965,346967,0,2,1
99399,5,3,346970,346970,346973,0,3,3
99400,3,2,346973,346973,346975,0,2,0
99401,2,3,346975,346975,346978,0,3,0
99402,2,3,346977,346978,346981,1,4,0
99403,6,1,346983,346983,346984,0,1,2
99404,2,3,346985,346985,346988,0,3,1
99405,2,2,346987,346988,346990,1,3,0
99406,1,2,346988,346990,346992,2,4,0
99407,1,1,346989,346992,346993,3,4,0
99408,3,2,346992,346993,346995,1,3,0
99409,4,3,346996,346996,346999,0,3,1
99410,1,1,346997,346999,347000,2,3,0
99411,3,2,347000,347000,347002,0,2,0
99412,4,3,347004,347004,347007,0,3,2
99413,4,2,347008,347008,347010,0,2,1
99414,2,1,347010,347010,347011,0,1,0
99415,6,3,347016,347016,347019,0,3,5
99416,4,2,347020,347020,347022,0,2,1
99417,1,1,347021,347022,347023,1,2,0
99418,1,3,347022,347023,347026,1,4,0
99419,2,2,347024,347026,347028,2,4,0
99420,1,1,347025,347028,347029,3,4,0
99421,1,1,347026,347029,347030,3,4,0
99422,1,2,347027,347030,347032,3,5,0
99423,5,1,347032,347032,347033,0,1,0
99424,1,3,347033,347033,347036,0,3,0
99425,6,3,347039,347039,347042,0,3,3
99426,1,1,347040,347042,347043,2,3,0
99427,6,1,347046,347046,347047,0,1,3
99428,5,1,347051,347051,347052,0,1,4
99429,6,2,347057,347057,347059,0,2,5
99430,2,2,347059,347059,347061,0,2,0
99431,5,2,347064,347064,347066,0,2,3
99432,4,1,347068,347068,347069,0,1,2
99433,4,1,347072,347072,347073,0,1,3
99434,4,2,347076,347076,347078,0,2,3
99435,5,3,347081,347081,347084,0,3,3
99436,2,3,347083,347084,347087,1,4,0
99437,5,1,347088,347088,347089,0,1,1
99438,3,2,347091,347091,347093,0,2,2
99439,4,1,347095,347095,347096,0,1,2
99440,3,1,347098,347098,347099,0,1,2
99441,3,3,347101,347101,347104,0,3,2
99442,5,2,347106,347106,347108,0,2,2
99443,4,2,347110,347110,347112,0,2,2
99444,3,3,347113,347113,347116,0,3,1
99445,2,3,347115,347116,347119,1,4,0
99446,2,2,347117,347119,347121,2,4,0
99447,1,1,347118,347121,347122,3,4,0
99448,5,1,347123,347123,347124,0,1,1
99449,4,3,347127,347127,347130,0,3,3
99450,1,3,347128,347130,347133,2,5,0
99451,6,1,347134,347134,347135,0,1,1
99452,5,1,347139,347139,347140,0,1,4
99453,4,3,347143,347143,347146,0,3,3
99454,5,1,347148,347148,347149,0,1,2
99455,1,3,347149,347149,347152,0,3,0
99456,4,1,347153,347153,347154,0,1,1
99457,4,3,347157,347157,347160,0,3,3
99458,3,2,347160,347160,347162,0,2,0
99459,4,3,347164,347164,347167,0,3,2
99460,4,2,347168,347168,347170,0,2,1
99461,5,3,347173,347173,347176,0,3,3
99462,5,3,347178,347178,347181,0,3,2
99463,5,2,347183,347183,347185,0,2,2
99464,2,3,347185,347185,347188,0,3,0
99465,3,1,347188,347188,347189,0,1,0
99466,5,1,347193,347193,347194,0,1,4
99467,4,1,347197,347197,347198,0,1,3
99468,2,3,347199,347199,347202,0,3,1
99469,2,2,347201,347202,347204,1,3,0
99470,3,1,347204,347204,347205,0,1,0
99471,6,1,347210,347210,347211,0,1,5
99472,6,1,347216,347216,347217,0,1,5
99473,6,1,347222,347222,347223,0,1,5
99474,3,2,347225,347225,347227,0,2,2
99475,5,2,347230,347230,347232,0,2,3
99476,6,3,347236,347236,347239,0,3,4
99477,5,3,347241,347241,347244,0,3,2
99478,3,2,347244,347244,347246,0,2,0
99479,3,2,347247,347247,347249,0,2,1
99480,1,2,347248,347249,347251,1,3,0
99481,2,1,347250,347251,347252,1,2,0
99482,5,2,347255,347255,347257,0,2,3
99483,4,2,347259,347259,347261,0,2,2
99484,4,1,347263,347263,347264,0,1,2
99485,2,3,347265,347265,347268,0,3,1
99486,4,3,347269,347269,347272,0,3,1
99487,2,3,347271,347272,347275,1,4,0
99488,5,1,347276,347276,347277,0,1,1
99489,1,3,347277,347277,347280,0,3,0
99490,3,1,347280,347280,347281,0,1,0
99491,5,3,347285,347285,347288,0,3,4
99492,5,3,347290,347290,347293,0,3,2
99493,1,2,347291,347293,347295,2,4,0
99494,6,2,347297,347297,347299,0,2,2
99495,1,1,347298,347299,347300,1,2,0
99496,4,2,347302,347302,347304,0,2,2
99497,3,2,347305,347305,347307,0,2,1
99498,1,2,347306,347307,347309,1,3,0
99499,1,1,347307,347309,347310,2,3,0
99500,5,2,347312,347312,347314,0,2,2
99501,4,1,347316,347316,347317,0,1,2
99502,4,3,347320,347320,347323,0,3,3
99503,3,2,347323,347323,347325,0,2,0
99504,6,2,347329,347329,347331,0,2,4
99505,5,1,347334,347334,347335,0,1,3
99506,2,3,347336,347336,347339,0,3,1
99507,2,3,347338,347339,347342,1,4,0
99508,2,2,347340,347342,347344,2,4,0
99509,3,1,347343,347344,347345,1,2,0
99510,3,1,347346,347346,347347,0,1,1
99511,6,3,347352,347352,347355,0,3,5
99512,2,3,347354,347355,347358,1,4,0
99513,2,3,347356,347358,347361,2,5,0
99514,5,2,347361,347361,347363,0,2,0
99515,6,1,347367,347367,347368,0,1,4
99516,4,3,347371,347371,347374,0,3,3
99517,3,1,347374,347374,347375,0,1,0
99518,4,2,347378,347378,347380,0,2,3
99519,4,1,347382,347382,347383,0,1,2
99520,1,1,347383,347383,347384,0,1,0
99521,6,1,347389,347389,347390,0,1,5
99522,3,2,347392,347392,347394,0,2,2
99523,5,2,347397,347397,347399,0,2,3
99524,1,3,347398,347399,347402,1,4,0
99525,6,2,347404,347404,347406,0,2,2
99526,2,3,347406,347406,347409,0,3,0
99527,6,3,347412,347412,347415,0,3,3
99528,1,2,347413,347415,347417,2,4,0
99529,2,1,347415,347417,347418,2,3,0
99530,1,1,347416,347418,347419,2,3,0
99531,2,1,347418,347419,347420,1,2,0
99532,5,2,347423,347423,347425,0,2,3
99533,4,3,347427,347427,347430,0,3,2
99534,2,3,347429,347430,347433,1,4,0
99535,6,1,347435,347435,347436,0,1,2
99536,3,1,347438,347438,347439,0,1,2
99537,3,1,347441,347441,347442,0,1,2
99538,2,3,347443,347443,347446,0,3,1
99539,4,2,347447,347447,347449,0,2,1
99540,6,3,347453,347453,347456,0,3,4
99541,3,2,347456,347456,347458,0,2,0
99542,3,1,347459,347459,347460,0,1,1
99543,2,1,347461,347461,347462,0,1,1
99544,3,3,347464,347464,347467,0,3,2
99545,3,2,347467,347467,347469,0,2,0
99546,2,1,347469,347469,347470,0,1,0
99547,3,3,347472,347472,347475,0,3,2
99548,1,1,347473,347475,347476,2,3,0
99549,4,2,347477,347477,347479,0,2,1
99550,3,1,347480,347480,347481,0,1,1
99551,5,2,347485,347485,347487,0,2,4
99552,2,3,347487,347487,347490,0,3,0
99553,1,3,347488,347490,347493,2,5,0
99554,1,2,347489,347493,347495,4,6,0
99555,1,1,347490,347495,347496,5,6,0
99556,2,3,347492,347496,347499,4,7,0
99557,4,2,347496,347499,347501,3,5,0
99558,3,3,347499,347501,347504,2,5,0
99559,6,2,347505,347505,347507,0,2,1
99560,3,3,347508,347508,347511,0,3,1
99561,3,2,347511,347511,347513,0,2,0
99562,1,1,347512,347513,347514,1,2,0
99563,3,2,347515,347515,347517,0,2,1
99564,2,1,347517,347517,347518,0,1,0
99565,3,3,347520,347520,347523,0,3,2
99566,1,1,347521,347523,347524,2,3,0
99567,1,3,347522,347524,347527,2,5,0
99568,2,3,347524,347527,347530,3,6,0
99569,2,2,347526,347530,347532,4,6,0
99570,5,2,347531,347532,347534,1,3,0
99571,4,3,347535,347535,347538,0,3,1
99572,3,1,347538,347538,347539,0,1,0
99573,1,2,347539,347539,347541,0,2,0
99574,6,2,347545,347545,347547,0,2,4
99575,4,2,347549,347549,347551,0,2,2
99576,4,1,347553,347553,347554,0,1,2
99577,6,2,347559,347559,347561,0,2,5
99578,3,1,347562,347562,347563,0,1,1
99579,4,3,347566,347566,347569,0,3,3
99580,6,3,347572,347572,347575,0,3,3
99581,5,3,347577,347577,347580,0,3,2
99582,5,3,347582,347582,347585,0,3,2
99583,1,3,347583,347585,347588,2,5,0
99584,1,3,347584,347588,347591,4,7,0
99585,4,1,347588,347591,347592,3,4,0
99586,5,2,347593,347593,347595,0,2,1
99587,1,3,347594,347595,347598,1,4,0
99588,3,2,347597,347598,347600,1,3,0
99589,2,1,347599,347600,347601,1,2,0
99590,2,3,347601,347601,347604,0,3,0
99591,3,3,347604,347604,347607,0,3,0
99592,4,3,347608,347608,347611,0,3,1
99593,4,1,347612,347612,347613,0,1,1
99594,1,2,347613,347613,347615,0,2,0
99595,3,3,347616,347616,347619,0,3,1
99596,3,2,347619,347619,347621,0,2,0
99597,3,3,347622,347622,347625,0,3,1
99598,2,3,347624,347625,347628,1,4,0
99599,2,1,347626,347628,347629,2,3,0
99600,1,3,347627,347629,347632,2,5,0
99601,6,3,347633,347633,347636,0,3,1
99602,4,2,347637,347637,347639,0,2,1
99603,2,1,347639,347639,347640,0,1,0
99604,4,1,347643,347643,347644,0,1,3
99605,5,1,347648,347648,347649,0,1,4
99606,4,2,347652,347652,347654,0,2,3
99607,3,2,347655,347655,347657,0,2,1
99608,4,2,347659,347659,347661,0,2,2
99609,1,3,347660,347661,347664,1,4,0
99610,1,2,347661,347664,347666,3,5,0
99611,5,3,347666,347666,347669,0,3,0
99612,2,1,347668,347669,347670,1,2,0
99613,6,3,347674,347674,347677,0,3,4
99614,3,2,347677,347677,347679,0,2,0
99615,6,1,347683,347683,347684,0,1,4
99616,2,1,347685,347685,347686,0,1,1
99617,5,2,347690,347690,347692,0,2,4
99618,1,1,347691,347692,347693,1,2,0
99619,4,2,347695,347695,347697,0,2,2
99620,1,1,347696,347697,347698,1,2,0
99621,3,1,347699,347699,347700,0,1,1
99622,1,3,347700,347700,347703,0,3,0
99623,6,3,347706,347706,347709,0,3,3
99624,4,3,347710,347710,347713,0,3,1
99625,6,2,347716,347716,347718,0,2,3
99626,3,3,347719,347719,347722,0,3,1
99627,1,1,347720,347722,347723,2,3,0
99628,5,1,347725,347725,347726,0,1,2
99629,5,2,347730,347730,347732,0,2,4
99630,5,3,347735,347735,347738,0,3,3
99631,3,3,347738,347738,347741,0,3,0
99632,4,3,347742,347742,347745,0,3,1
99633,3,3,347745,347745,347748,0,3,0
99634,1,3,347746,347748,347751,2,5,0
99635,1,1,347747,347751,347752,4,5,0
99636,1,3,347748,347752,347755,4,7,0
99637,3,3,347751,347755,347758,4,7,0
99638,3,3,347754,347758,347761,4,7,0
99639,3,1,347757,347761,347762,4,5,0
99640,3,2,347760,347762,347764,2,4,0
99641,4,3,347764,347764,347767,0,3,0
99642,6,3,347770,347770,347773,0,3,3
99643,1,3,347771,347773,347776,2,5,0
99644,6,2,347777,347777,347779,0,2,1
99645,6,2,347783,347783,347785,0,2,4
99646,5,2,347788,347788,347790,0,2,3
99647,1,2,347789,347790,347792,1,3,0
99648,3,1,347792,347792,347793,0,1,0
99649,3,2,347795,347795,347797,0,2,2
99650,4,1,347799,347799,347800,0,1,2
99651,2,2,347801,347801,347803,0,2,1
99652,4,3,347805,347805,347808,0,3,2
99653,4,3,347809,347809,347812,0,3,1
99654,2,1,347811,347812,347813,1,2,0
99655,6,1,347817,347817,347818,0,1,4
99656,2,3,347819,347819,347822,0,3,1
99657,2,1,347821,347822,347823,1,2,0
99658,1,1,347822,347823,347824,1,2,0
99659,5,3,347827,347827,347830,0,3,3
99660,1,1,347828,347830,347831,2,3,0
99661,2,1,347830,347831,347832,1,2,0
99662,1,2,347831,347832,347834,1,3,0
99663,5,1,347836,347836,347837,0,1,2
99664,3,1,347839,347839,347840,0,1,2
99665,2,1,347841,347841,347842,0,1,1
99666,1,2,347842,347842,347844,0,2,0
99667,5,3,347847,347847,347850,0,3,3
99668,1,1,347848,347850,347851,2,3,0
99669,4,2,347852,347852,347854,0,2,1
99670,3,1,347855,347855,347856,0,1,1
99671,6,1,347861,347861,347862,0,1,5
99672,2,2,347863,347863,347865,0,2,1
99673,6,2,347869,347869,347871,0,2,4
99674,1,3,347870,347871,347874,1,4,0
99675,1,3,347871,347874,347877,3,6,0
99676,6,3,347877,347877,347880,0,3,0
99677,2,1,347879,347880,347881,1,2,0
99678,1,2,347880,347881,347883,1,3,0
99679,3,2,347883,347883,347885,0,2,0
99680,1,3,347884,347885,347888,1,4,0
99681,2,2,347886,347888,347890,2,4,0
99682,3,3,347889,347890,347893,1,4,0
99683,5,2,347894,347894,347896,0,2,1
99684,3,2,347897,347897,347899,0,2,1
99685,5,2,347902,347902,347904,0,2,3
99686,5,1,347907,347907,347908,0,1,3
99687,6,1,347913,347913,347914,0,1,5
99688,3,1,347916,347916,347917,0,1,2
99689,5,2,347921,347921,347923,0,2,4
99690,4,2,347925,347925,347927,0,2,2
99691,6,2,347931,347931,347933,0,2,4
99692,1,2,347932,347933,347935,1,3,0
99693,6,1,347938,347938,347939,0,1,3
99694,5,1,347943,347943,347944,0,1,4
99695,4,3,347947,347947,347950,0,3,3
99696,2,3,347949,347950,347953,1,4,0
99697,6,1,347955,347955,347956,0,1,2
99698,5,2,347960,347960,347962,0,2,4
99699,6,1,347966,347966,347967,0,1,4
99700,3,1,347969,347969,347970,0,1,2
99701,1,3,347970,347970,347973,0,3,0
99702,6,3,347976,347976,347979,0,3,3
99703,1,2,347977,347979,347981,2,4,0
99704,1,1,347978,347981,347982,3,4,0
99705,6,3,347984,347984,347987,0,3,2
99706,5,3,347989,347989,347992,0,3,2
99707,1,1,347990,347992,347993,2,3,0
99708,2,3,347992,347993,347996,1,4,0
99709,1,2,347993,347996,347998,3,5,0
99710,4,3,347997,347998,348001,1,4,0
99711,1,1,347998,348001,348002,3,4,0
99712,5,2,348003,348003,348005,0,2,1
99713,2,2,348005,348005,348007,0,2,0
99714,1,1,348006,348007,348008,1,2,0
99715,3,1,348009,348009,348010,0,1,1
99716,2,1,348011,348011,348012,0,1,1
99717,5,3,348016,348016,348019,0,3,4
99718,2,3,348018,348019,348022,1,4,0
99719,4,1,348022,348022,348023,0,1,0
99720,2,1,348024,348024,348025,0,1,1
99721,5,3,348029,348029,348032,0,3,4
99722,6,2,348035,348035,348037,0,2,3
99723,4,2,348039,348039,348041,0,2,2
99724,4,1,348043,348043,348044,0,1,2
99725,4,3,348047,348047,348050,0,3,3
99726,3,3,348050,348050,348053,0,3,0
99727,1,3,348051,348053,348056,2,5,0
99728,5,3,348056,348056,348059,0,3,0
99729,6,2,348062,348062,348064,0,2,3
99730,4,3,348066,348066,348069,0,3,2
99731,1,3,348067,348069,348072,2,5,0
99732,3,3,348070,348072,348075,2,5,0
99733,1,1,348071,348075,348076,4,5,0
99734,3,1,348074,348076,348077,2,3,0
99735,3,1,348077,348077,348078,0,1,0
99736,3,1,348080,348080,348081,0,1,2
99737,1,1,348081,348081,348082,0,1,0
99738,5,1,348086,348086,348087,0,1,4
99739,2,1,348088,348088,348089,0,1,1
99740,1,2,348089,348089,348091,0,2,0
99741,5,1,348094,348094,348095,0,1,3
99742,5,1,348099,348099,348100,0,1,4
99743,1,2,348100,348100,348102,0,2,0
99744,5,1,348105,348105,348106,0,1,3
99745,5,1,348110,348110,348111,0,1,4
99746,1,3,348111,348111,348114,0,3,0
99747,6,1,348117,348117,348118,0,1,3
99748,2,1,348119,348119,348120,0,1,1
99749,6,3,348125,348125,348128,0,3,5
99750,5,2,348130,348130,348132,0,2,2
99751,1,1,348131,348132,348133,1,2,0
99752,5,1,348136,348136,348137,0,1,3
99753,6,1,348142,348142,348143,0,1,5
99754,4,2,348146,348146,348148,0,2,3
99755,6,1,348152,348152,348153,0,1,4
99756,4,3,348156,348156,348159,0,3,3
99757,4,2,348160,348160,348162,0,2,1
99758,3,2,348163,348163,348165,0,2,1
99759,5,1,348168,348168,348169,0,1,3
99760,1,1,348169,348169,348170,0,1,0
99761,3,3,348172,348172,348175,0,3,2
99762,2,3,348174,348175,348178,1,4,0
99763,6,3,348180,348180,348183,0,3,2
99764,1,2,348181,348183,348185,2,4,0
99765,6,2,348187,348187,348189,0,2,2
99766,2,3,348189,348189,348192,0,3,0
99767,3,2,348192,348192,348194,0,2,0
99768,3,1,348195,348195,348196,0,1,1
99769,3,1,348198,348198,348199,0,1,2
99770,3,3,348201,348201,348204,0,3,2
99771,3,3,348204,348204,348207,0,3,0
99772,6,1,348210,348210,348211,0,1,3
99773,6,3,348216,348216,348219,0,3,5
99774,5,2,348221,348221,348223,0,2,2
99775,6,2,348227,348227,348229,0,2,4
99776,2,2,348229,348229,348231,0,2,0
99777,5,1,348234,348234,348235,0,1,3
99778,3,1,348237,348237,348238,0,1,2
99779,4,1,348241,348241,348242,0,1,3
99780,2,1,348243,348243,348244,0,1,1
99781,3,1,348246,348246,348247,0,1,2
99782,3,2,348249,348249,348251,0,2,2
99783,5,2,348254,348254,348256,0,2,3
99784,3,1,348257,348257,348258,0,1,1
99785,5,2,348262,348262,348264,0,2,4
99786,2,1,348264,348264,348265,0,1,0
99787,6,1,348270,348270,348271,0,1,5
99788,1,1,348271,348271,348272,0,1,0
99789,4,1,348275,348275,348276,0,1,3
99790,1,1,348276,348276,348277,0,1,0
99791,3,1,348279,348279,348280,0,1,2
99792,2,3,348281,348281,348284,0,3,1
99793,3,3,348284,348284,348287,0,3,0
99794,1,1,348285,348287,348288,2,3,0
99795,1,1,348286,348288,348289,2,3,0
99796,1,3,348287,348289,348292,2,5,0
99797,5,1,348292,348292,348293,0,1,0
99798,4,1,348296,348296,348297,0,1,3
99799,6,2,348302,348302,348304,0,2,5
99800,2,3,348304,348304,348307,0,3,0
99801,3,2,348307,348307,348309,0,2,0
99802,4,3,348311,348311,348314,0,3,2
99803,6,2,348317,348317,348319,0,2,3
99804,6,3,348323,348323,348326,0,3,4
99805,5,2,348328,348328,348330,0,2,2
99806,4,3,348332,348332,348335,0,3,2
99807,3,1,348335,348335,348336,0,1,0
99808,3,3,348338,348338,348341,0,3,2
99809,6,3,348344,348344,348347,0,3,3
99810,6,1,348350,348350,348351,0,1,3
99811,5,1,348355,348355,348356,0,1,4
99812,3,3,348358,348358,348361,0,3,2
99813,5,1,348363,348363,348364,0,1,2
99814,4,2,348367,348367,348369,0,2,3
99815,3,2,348370,348370,348372,0,2,1
99816,1,2,348371,348372,348374,1,3,0
99817,6,3,348377,348377,348380,0,3,3
99818,2,3,348379,348380,348383,1,4,0
99819,5,3,348384,348384,348387,0,3,1
99820,3,1,348387,348387,348388,0,1,0
99821,5,2,348392,348392,348394,0,2,4
99822,4,3,348396,348396,348399,0,3,2
99823,4,1,348400,348400,348401,0,1,1
99824,1,2,348401,348401,348403,0,2,0
99825,5,3,348406,348406,348409,0,3,3
99826,1,3,348407,348409,348412,2,5,0
99827,2,1,348409,348412,348413,3,4,0
99828,2,1,348411,348413,348414,2,3,0
99829,3,1,348414,348414,348415,0,1,0
99830,4,2,348418,348418,348420,0,2,3
99831,2,2,348420,348420,348422,0,2,0
99832,1,1,348421,348422,348423,1,2,0
99833,2,3,348423,348423,348426,0,3,0
99834,2,3,348425,348426,348429,1,4,0
99835,2,2,348427,348429,348431,2,4,0
99836,2,3,348429,348431,348434,2,5,0
99837,2,1,348431,348434,348435,3,4,0
99838,2,1,348433,348435,348436,2,3,0
99839,6,1,348439,348439,348440,0,1,3
99840,1,2,348440,348440,348442,0,2,0
99841,3,2,348443,348443,348445,0,2,1
99842,6,3,348449,348449,348452,0,3,4
99843,1,3,348450,348452,348455,2,5,0
99844,5,2,348455,348455,348457,0,2,0
99845,4,2,348459,348459,348461,0,2,2
99846,3,2,348462,348462,348464,0,2,1
99847,5,1,348467,348467,348468,0,1,3
99848,1,3,348468,348468,348471,0,3,0
99849,1,2,348469,348471,348473,2,4,0
99850,4,2,348473,348473,348475,0,2,0
99851,3,3,348476,348476,348479,0,3,1
99852,4,1,348480,348480,348481,0,1,1
99853,2,1,348482,348482,348483,0,1,1
99854,4,1,348486,348486,348487,0,1,3
99855,6,1,348492,348492,348493,0,1,5
99856,2,2,348494,348494,348496,0,2,1
99857,5,3,348499,348499,348502,0,3,3
99858,3,3,348502,348502,348505,0,3,0
99859,2,2,348504,348505,348507,1,3,0
99860,5,3,348509,348509,348512,0,3,2
99861,5,3,348514,348514,348517,0,3,2
99862,2,2,348516,348517,348519,1,3,0
99863,5,3,348521,348521,348524,0,3,2
99864,2,1,348523,348524,348525,1,2,0
99865,5,2,348528,348528,348530,0,2,3
99866,2,2,348530,348530,348532,0,2,0
99867,6,3,348536,348536,348539,0,3,4
99868,5,1,348541,348541,348542,0,1,2
99869,2,3,348543,348543,348546,0,3,1
99870,6,2,348549,348549,348551,0,2,3
99871,2,1,348551,348551,348552,0,1,0
99872,6,1,348557,348557,348558,0,1,5
99873,3,1,348560,348560,348561,0,1,2
99874,5,3,348565,348565,348568,0,3,4
99875,5,3,348570,348570,348573,0,3,2
99876,4,3,348574,348574,348577,0,3,1
99877,1,2,348575,348577,348579,2,4,0
99878,4,2,348579,348579,348581,0,2,0
99879,4,3,348583,348583,348586,0,3,2
99880,4,3,348587,348587,348590,0,3,1
99881,6,2,348593,348593,348595,0,2,3
99882,6,3,348599,348599,348602,0,3,4
99883,1,2,348600,348602,348604,2,4,0
99884,1,1,348601,348604,348605,3,4,0
99885,1,3,348602,348605,348608,3,6,0
99886,2,2,348604,348608,348610,4,6,0
99887,3,3,348607,348610,348613,3,6,0
99888,3,2,348610,348613,348615,3,5,0
99889,5,1,348615,348615,348616,0,1,0
99890,2,1,348617,348617,348618,0,1,1
99891,1,2,348618,348618,348620,0,2,0
99892,4,2,348622,348622,348624,0,2,2
99893,2,3,348624,348624,348627,0,3,0
99894,2,2,348626,348627,348629,1,3,0
99895,5,2,348631,348631,348633,0,2,2
99896,1,1,348632,348633,348634,1,2,0
99897,1,3,348633,348634,348637,1,4,0
99898,5,3,348638,348638,348641,0,3,1
99899,4,3,348642,348642,348645,0,3,1
99900,3,2,348645,348645,348647,0,2,0
99901,6,1,348651,348651,348652,0,1,4
99902,6,3,348657,348657,348660,0,3,5
99903,2,1,348659,348660,348661,1,2,0
99904,3,2,348662,348662,348664,0,2,1
99905,5,1,348667,348667,348668,0,1,3
99906,4,2,348671,348671,348673,0,2,3
99907,2,2,348673,348673,348675,0,2,0
99908,2,1,348675,348675,348676,0,1,0
99909,6,3,348681,348681,348684,0,3,5
99910,4,2,348685,348685,348687,0,2,1
99911,4,2,348689,348689,348691,0,2,2
99912,4,3,348693,348693,348696,0,3,2
99913,1,2,348694,348696,348698,2,4,0
99914,4,3,348698,348698,348701,0,3,0
99915,5,1,348703,348703,348704,0,1,2
99916,3,3,348706,348706,348709,0,3,2
99917,1,2,348707,348709,348711,2,4,0
99918,5,1,348712,348712,348713,0,1,1
99919,1,2,348713,348713,348715,0,2,0
99920,4,3,348717,348717,348720,0,3,2
99921,2,3,348719,348720,348723,1,4,0
99922,2,1,348721,348723,348724,2,3,0
99923,2,2,348723,348724,348726,1,3,0
99924,2,1,348725,348726,348727,1,2,0
99925,1,3,348726,348727,348730,1,4,0
99926,2,2,348728,348730,348732,2,4,0
99927,6,1,348734,348734,348735,0,1,2
99928,5,1,348739,348739,348740,0,1,4
99929,1,3,348740,348740,348743,0,3,0
99930,2,2,348742,348743,348745,1,3,0
99931,6,1,348748,348748,348749,0,1,3
99932,4,1,348752,348752,348753,0,1,3
99933,4,2,348756,348756,348758,0,2,3
99934,4,1,348760,348760,348761,0,1,2
99935,5,1,348765,348765,348766,0,1,4
99936,3,3,348768,348768,348771,0,3,2
99937,3,2,348771,348771,348773,0,2,0
99938,5,1,348776,348776,348777,0,1,3
99939,1,3,348777,348777,348780,0,3,0
99940,6,2,348783,348783,348785,0,2,3
99941,2,1,348785,348785,348786,0,1,0
99942,6,1,348791,348791,348792,0,1,5
99943,1,1,348792,348792,348793,0,1,0
99944,4,3,348796,348796,348799,0,3,3
99945,1,2,348797,348799,348801,2,4,0
99946,5,3,348802,348802,348805,0,3,1
99947,5,3,348807,348807,348810,0,3,2
99948,6,2,348813,348813,348815,0,2,3
99949,2,3,348815,348815,348818,0,3,0
99950,2,3,348817,348818,348821,1,4,0
99951,1,1,348818,348821,348822,3,4,0
99952,1,3,348819,348822,348825,3,6,0
99953,1,3,348820,348825,348828,5,8,0
99954,2,1,348822,348828,348829,6,7,0
99955,3,3,348825,348829,348832,4,7,0
99956,1,2,348826,348832,348834,6,8,0
99957,4,1,348830,348834,348835,4,5,0
99958,5,2,348835,348835,348837,0,2,0
99959,5,1,348840,348840,348841,0,1,3
99960,1,3,348841,348841,348844,0,3,0
99961,4,1,348845,348845,348846,0,1,1
99962,3,3,348848,348848,348851,0,3,2
99963,6,1,348854,348854,348855,0,1,3
99964,5,3,348859,348859,348862,0,3,4
99965,4,2,348863,348863,348865,0,2,1
99966,1,2,348864,348865,348867,1,3,0
99967,5,3,348869,348869,348872,0,3,2
99968,3,3,348872,348872,348875,0,3,0
99969,1,1,348873,348875,348876,2,3,0
99970,6,1,348879,348879,348880,0,1,3
99971,3,3,348882,348882,348885,0,3,2
99972,3,1,348885,348885,348886,0,1,0
99973,2,3,348887,348887,348890,0,3,1
99974,1,1,348888,348890,348891,2,3,0
99975,4,3,348892,348892,348895,0,3,1
99976,1,2,348893,348895,348897,2,4,0
99977,1,1,348894,348897,348898,3,4,0
99978,3,1,348897,348898,348899,1,2,0
99979,1,2,348898,348899,348901,1,3,0
99980,5,3,348903,348903,348906,0,3,2
99981,2,2,348905,348906,348908,1,3,0
99982,3,1,348908,348908,348909,0,1,0
99983,1,1,348909,348909,348910,0,1,0
99984,3,2,348912,348912,348914,0,2,2
99985,4,2,348916,348916,348918,0,2,2
99986,1,2,348917,348918,348920,1,3,0
99987,6,3,348923,348923,348926,0,3,3
99988,3,2,348926,348926,348928,0,2,0
99989,6,2,348932,348932,348934,0,2,4
99990,2,2,348934,348934,348936,0,2,0
99991,5,1,348939,348939,348940,0,1,3
99992,3,3,348942,348942,348945,0,3,2
99993,1,2,348943,348945,348947,2,4,0
99994,1,2,348944,348947,348949,3,5,0
99995,3,3,348947,348949,348952,2,5,0
99996,2,3,348949,348952,348955,3,6,0
99997,5,3,348954,348955,348958,1,4,0
99998,2,2,348956,348958,348960,2,4,0
99999,4,2,348960,348960,348962,0,2,0
