,time_between,service_time,arrival_time,start_time,end_time,wait_time,system_time,idle_time
0,0,3,0,0,3,0,3,0
1,1,1,1,3,4,2,3,0
2,3,1,4,4,5,0,1,0
3,5,2,9,9,11,0,2,4
4,2,3,11,11,14,0,3,0
5,5,3,16,16,19,0,3,2
6,3,1,19,19,20,0,1,0
7,6,2,25,25,27,0,2,5
8,2,1,27,27,28,0,1,0
9,4,2,31,31,33,0,2,3
10,2,3,33,33,36,0,3,0
11,4,1,37,37,38,0,1,1
12,4,2,41,41,43,0,2,3
13,4,2,45,45,47,0,2,2
14,3,3,48,48,51,0,3,1
15,1,2,49,51,53,2,4,0
16,5,2,54,54,56,0,2,1
17,5,3,59,59,62,0,3,3
18,3,3,62,62,65,0,3,0
19,1,2,63,65,67,2,4,0
20,3,3,66,67,70,1,4,0
21,1,3,67,70,73,3,6,0
22,5,1,72,73,74,1,2,0
23,1,1,73,74,75,1,2,0
24,6,1,79,79,80,0,1,4
25,3,2,82,82,84,0,2,2
26,1,3,83,84,87,1,4,0
27,6,3,89,89,92,0,3,2
28,6,1,95,95,96,0,1,3
29,3,3,98,98,101,0,3,2
30,6,3,104,104,107,0,3,3
31,3,2,107,107,109,0,2,0
32,3,2,110,110,112,0,2,1
33,6,3,116,116,119,0,3,4
34,5,2,121,121,123,0,2,2
35,2,2,123,123,125,0,2,0
36,6,3,129,129,132,0,3,4
37,4,1,133,133,134,0,1,1
38,5,1,138,138,139,0,1,4
39,3,1,141,141,142,0,1,2
40,3,2,144,144,146,0,2,2
41,2,2,146,146,148,0,2,0
42,2,2,148,148,150,0,2,0
43,3,1,151,151,152,0,1,1
44,3,1,154,154,155,0,1,2
45,6,2,160,160,162,0,2,5
46,5,1,165,165,166,0,1,3
47,6,2,171,171,173,0,2,5
48,1,2,172,173,175,1,3,0
49,3,3,175,175,178,0,3,0
50,5,1,180,180,181,0,1,2
51,5,2,185,185,187,0,2,4
52,5,3,190,190,193,0,3,3
53,6,3,196,196,199,0,3,3
54,5,2,201,201,203,0,2,2
55,2,3,203,203,206,0,3,0
56,4,3,207,207,210,0,3,1
57,4,2,211,211,213,0,2,1
58,3,1,214,214,215,0,1,1
59,5,2,219,219,221,0,2,4
60,3,1,222,222,223,0,1,1
61,6,2,228,228,230,0,2,5
62,1,3,229,230,233,1,4,0
63,4,2,233,233,235,0,2,0
64,5,2,238,238,240,0,2,3
65,2,1,240,240,241,0,1,0
66,5,1,245,245,246,0,1,4
67,4,2,249,249,251,0,2,3
68,3,2,252,252,254,0,2,1
69,5,2,257,257,259,0,2,3
70,1,3,258,259,262,1,4,0
71,4,3,262,262,265,0,3,0
72,4,2,266,266,268,0,2,1
73,1,1,267,268,269,1,2,0
74,6,2,273,273,275,0,2,4
75,6,2,279,279,281,0,2,4
76,4,2,283,283,285,0,2,2
77,4,1,287,287,288,0,1,2
78,4,2,291,291,293,0,2,3
79,1,3,292,293,296,1,4,0
80,6,2,298,298,300,0,2,2
81,1,2,299,300,302,1,3,0
82,1,1,300,302,303,2,3,0
83,1,1,301,303,304,2,3,0
84,3,3,304,304,307,0,3,0
85,6,3,310,310,313,0,3,3
86,5,1,315,315,316,0,1,2
87,4,1,319,319,320,0,1,3
88,3,2,322,322,324,0,2,2
89,4,1,326,326,327,0,1,2
90,1,3,327,327,330,0,3,0
91,5,3,332,332,335,0,3,2
92,2,1,334,335,336,1,2,0
93,1,2,335,336,338,1,3,0
94,1,2,336,338,340,2,4,0
95,2,2,338,340,342,2,4,0
96,1,1,339,342,343,3,4,0
97,5,2,344,344,346,0,2,1
98,4,1,348,348,349,0,1,2
99,4,1,352,352,353,0,1,3
100,3,1,355,355,356,0,1,2
101,1,1,356,356,357,0,1,0
102,4,2,360,360,362,0,2,3
103,2,2,362,362,364,0,2,0
104,4,2,366,366,368,0,2,2
105,6,3,372,372,375,0,3,4
106,6,2,378,378,380,0,2,3
107,5,3,383,383,386,0,3,3
108,5,1,388,388,389,0,1,2
109,4,2,392,392,394,0,2,3
110,5,2,397,397,399,0,2,3
111,1,3,398,399,402,1,4,0
112,6,1,404,404,405,0,1,2
113,2,1,406,406,407,0,1,1
114,1,2,407,407,409,0,2,0
115,2,2,409,409,411,0,2,0
116,6,3,415,415,418,0,3,4
117,6,3,421,421,424,0,3,3
118,6,1,427,427,428,0,1,3
119,3,2,430,430,432,0,2,2
120,1,3,431,432,435,1,4,0
121,5,1,436,436,437,0,1,1
122,3,1,439,439,440,0,1,2
123,6,2,445,445,447,0,2,5
124,3,2,448,448,450,0,2,1
125,4,3,452,452,455,0,3,2
126,2,2,454,455,457,1,3,0
127,5,3,459,459,462,0,3,2
128,2,3,461,462,465,1,4,0
129,3,1,464,465,466,1,2,0
130,2,3,466,466,469,0,3,0
131,4,1,470,470,471,0,1,1
132,4,3,474,474,477,0,3,3
133,5,3,479,479,482,0,3,2
134,4,2,483,483,485,0,2,1
135,4,3,487,487,490,0,3,2
136,1,1,488,490,491,2,3,0
137,5,1,493,493,494,0,1,2
138,5,3,498,498,501,0,3,4
139,1,1,499,501,502,2,3,0
140,5,1,504,504,505,0,1,2
141,4,2,508,508,510,0,2,3
142,3,2,511,511,513,0,2,1
143,2,1,513,513,514,0,1,0
144,5,3,518,518,521,0,3,4
145,5,2,523,523,525,0,2,2
146,5,2,528,528,530,0,2,3
147,4,3,532,532,535,0,3,2
148,5,1,537,537,538,0,1,2
149,5,2,542,542,544,0,2,4
150,5,1,547,547,548,0,1,3
151,3,3,550,550,553,0,3,2
152,1,2,551,553,555,2,4,0
153,4,2,555,555,557,0,2,0
154,1,1,556,557,558,1,2,0
155,5,3,561,561,564,0,3,3
156,1,1,562,564,565,2,3,0
157,4,2,566,566,568,0,2,1
158,5,3,571,571,574,0,3,3
159,4,3,575,575,578,0,3,1
160,4,1,579,579,580,0,1,1
161,2,1,581,581,582,0,1,1
162,5,2,586,586,588,0,2,4
163,6,2,592,592,594,0,2,4
164,2,1,594,594,595,0,1,0
165,1,3,595,595,598,0,3,0
166,4,2,599,599,601,0,2,1
167,4,3,603,603,606,0,3,2
168,1,1,604,606,607,2,3,0
169,4,1,608,608,609,0,1,1
170,6,3,614,614,617,0,3,5
171,4,1,618,618,619,0,1,1
172,2,2,620,620,622,0,2,1
173,6,1,626,626,627,0,1,4
174,6,1,632,632,633,0,1,5
175,1,3,633,633,636,0,3,0
176,6,3,639,639,642,0,3,3
177,6,1,645,645,646,0,1,3
178,2,1,647,647,648,0,1,1
179,2,2,649,649,651,0,2,1
180,5,1,654,654,655,0,1,3
181,3,2,657,657,659,0,2,2
182,3,2,660,660,662,0,2,1
183,1,2,661,662,664,1,3,0
184,3,2,664,664,666,0,2,0
185,4,2,668,668,670,0,2,2
186,6,2,674,674,676,0,2,4
187,2,1,676,676,677,0,1,0
188,1,1,677,677,678,0,1,0
189,4,3,681,681,684,0,3,3
190,6,2,687,687,689,0,2,3
191,1,1,688,689,690,1,2,0
192,1,2,689,690,692,1,3,0
193,2,3,691,692,695,1,4,0
194,6,1,697,697,698,0,1,2
195,5,3,702,702,705,0,3,4
196,3,2,705,705,707,0,2,0
197,3,3,708,708,711,0,3,1
198,6,1,714,714,715,0,1,3
199,6,3,720,720,723,0,3,5
200,6,2,726,726,728,0,2,3
201,2,3,728,728,731,0,3,0
202,6,3,734,734,737,0,3,3
203,2,1,736,737,738,1,2,0
204,6,3,742,742,745,0,3,4
205,2,3,744,745,748,1,4,0
206,2,3,746,748,751,2,5,0
207,2,1,748,751,752,3,4,0
208,5,1,753,753,754,0,1,1
209,2,2,755,755,757,0,2,1
210,5,1,760,760,761,0,1,3
211,6,3,766,766,769,0,3,5
212,2,1,768,769,770,1,2,0
213,5,3,773,773,776,0,3,3
214,3,2,776,776,778,0,2,0
215,4,3,780,780,783,0,3,2
216,1,1,781,783,784,2,3,0
217,1,1,782,784,785,2,3,0
218,5,2,787,787,789,0,2,2
219,6,2,793,793,795,0,2,4
220,4,3,797,797,800,0,3,2
221,4,1,801,801,802,0,1,1
222,5,2,806,806,808,0,2,4
223,2,2,808,808,810,0,2,0
224,1,2,809,810,812,1,3,0
225,6,1,815,815,816,0,1,3
226,2,3,817,817,820,0,3,1
227,4,3,821,821,824,0,3,1
228,5,3,826,826,829,0,3,2
229,5,3,831,831,834,0,3,2
230,4,2,835,835,837,0,2,1
231,5,2,840,840,842,0,2,3
232,4,3,844,844,847,0,3,2
233,3,3,847,847,850,0,3,0
234,2,1,849,850,851,1,2,0
235,2,3,851,851,854,0,3,0
236,3,1,854,854,855,0,1,0
237,1,2,855,855,857,0,2,0
238,3,2,858,858,860,0,2,1
239,1,2,859,860,862,1,3,0
240,5,1,864,864,865,0,1,2
241,1,3,865,865,868,0,3,0
242,1,3,866,868,871,2,5,0
243,4,1,870,871,872,1,2,0
244,4,3,874,874,877,0,3,2
245,2,3,876,877,880,1,4,0
246,5,3,881,881,884,0,3,1
247,1,3,882,884,887,2,5,0
248,4,1,886,887,888,1,2,0
249,2,3,888,888,891,0,3,0
250,5,2,893,893,895,0,2,2
251,6,1,899,899,900,0,1,4
252,3,1,902,902,903,0,1,2
253,1,2,903,903,905,0,2,0
254,1,2,904,905,907,1,3,0
255,3,3,907,907,910,0,3,0
256,6,1,913,913,914,0,1,3
257,4,3,917,917,920,0,3,3
258,6,1,923,923,924,0,1,3
259,6,1,929,929,930,0,1,5
260,6,3,935,935,938,0,3,5
261,5,3,940,940,943,0,3,2
262,1,1,941,943,944,2,3,0
263,2,2,943,944,946,1,3,0
264,5,1,948,948,949,0,1,2
265,1,3,949,949,952,0,3,0
266,6,1,955,955,956,0,1,3
267,4,3,959,959,962,0,3,3
268,6,2,965,965,967,0,2,3
269,5,3,970,970,973,0,3,3
270,5,1,975,975,976,0,1,2
271,6,1,981,981,982,0,1,5
272,3,2,984,984,986,0,2,2
273,6,3,990,990,993,0,3,4
274,3,2,993,993,995,0,2,0
275,6,1,999,999,1000,0,1,4
276,6,3,1005,1005,1008,0,3,5
277,4,2,1009,1009,1011,0,2,1
278,4,2,1013,1013,1015,0,2,2
279,4,3,1017,1017,1020,0,3,2
280,5,1,1022,1022,1023,0,1,2
281,4,1,1026,1026,1027,0,1,3
282,6,1,1032,1032,1033,0,1,5
283,5,1,1037,1037,1038,0,1,4
284,1,2,1038,1038,1040,0,2,0
285,3,1,1041,1041,1042,0,1,1
286,6,1,1047,1047,1048,0,1,5
287,1,1,1048,1048,1049,0,1,0
288,3,1,1051,1051,1052,0,1,2
289,5,3,1056,1056,1059,0,3,4
290,2,3,1058,1059,1062,1,4,0
291,6,1,1064,1064,1065,0,1,2
292,5,2,1069,1069,1071,0,2,4
293,6,3,1075,1075,1078,0,3,4
294,1,1,1076,1078,1079,2,3,0
295,5,3,1081,1081,1084,0,3,2
296,5,2,1086,1086,1088,0,2,2
297,4,2,1090,1090,1092,0,2,2
298,5,2,1095,1095,1097,0,2,3
299,3,1,1098,1098,1099,0,1,1
300,5,2,1103,1103,1105,0,2,4
301,4,3,1107,1107,1110,0,3,2
302,3,1,1110,1110,1111,0,1,0
303,3,2,1113,1113,1115,0,2,2
304,4,1,1117,1117,1118,0,1,2
305,6,3,1123,1123,1126,0,3,5
306,3,1,1126,1126,1127,0,1,0
307,3,3,1129,1129,1132,0,3,2
308,1,2,1130,1132,1134,2,4,0
309,1,3,1131,1134,1137,3,6,0
310,4,2,1135,1137,1139,2,4,0
311,5,3,1140,1140,1143,0,3,1
312,6,3,1146,1146,1149,0,3,3
313,3,1,1149,1149,1150,0,1,0
314,4,2,1153,1153,1155,0,2,3
315,1,3,1154,1155,1158,1,4,0
316,2,2,1156,1158,1160,2,4,0
317,5,1,1161,1161,1162,0,1,1
318,5,1,1166,1166,1167,0,1,4
319,4,2,1170,1170,1172,0,2,3
320,3,1,1173,1173,1174,0,1,1
321,1,2,1174,1174,1176,0,2,0
322,2,1,1176,1176,1177,0,1,0
323,1,2,1177,1177,1179,0,2,0
324,1,1,1178,1179,1180,1,2,0
325,2,1,1180,1180,1181,0,1,0
326,1,3,1181,1181,1184,0,3,0
327,1,3,1182,1184,1187,2,5,0
328,3,1,1185,1187,1188,2,3,0
329,2,1,1187,1188,1189,1,2,0
330,1,3,1188,1189,1192,1,4,0
331,2,3,1190,1192,1195,2,5,0
332,5,1,1195,1195,1196,0,1,0
333,4,1,1199,1199,1200,0,1,3
334,6,2,1205,1205,1207,0,2,5
335,3,3,1208,1208,1211,0,3,1
336,4,3,1212,1212,1215,0,3,1
337,2,3,1214,1215,1218,1,4,0
338,3,1,1217,1218,1219,1,2,0
339,3,1,1220,1220,1221,0,1,1
340,4,3,1224,1224,1227,0,3,3
341,6,2,1230,1230,1232,0,2,3
342,4,1,1234,1234,1235,0,1,2
343,5,2,1239,1239,1241,0,2,4
344,4,3,1243,1243,1246,0,3,2
345,4,3,1247,1247,1250,0,3,1
346,1,2,1248,1250,1252,2,4,0
347,2,3,1250,1252,1255,2,5,0
348,2,3,1252,1255,1258,3,6,0
349,4,3,1256,1258,1261,2,5,0
350,3,2,1259,1261,1263,2,4,0
351,6,1,1265,1265,1266,0,1,2
352,1,3,1266,1266,1269,0,3,0
353,5,1,1271,1271,1272,0,1,2
354,2,3,1273,1273,1276,0,3,1
355,3,2,1276,1276,1278,0,2,0
356,3,3,1279,1279,1282,0,3,1
357,3,2,1282,1282,1284,0,2,0
358,6,1,1288,1288,1289,0,1,4
359,3,2,1291,1291,1293,0,2,2
360,6,3,1297,1297,1300,0,3,4
361,4,2,1301,1301,1303,0,2,1
362,3,2,1304,1304,1306,0,2,1
363,1,2,1305,1306,1308,1,3,0
364,4,3,1309,1309,1312,0,3,1
365,4,2,1313,1313,1315,0,2,1
366,6,2,1319,1319,1321,0,2,4
367,4,1,1323,1323,1324,0,1,2
368,1,2,1324,1324,1326,0,2,0
369,4,3,1328,1328,1331,0,3,2
370,5,3,1333,1333,1336,0,3,2
371,5,3,1338,1338,1341,0,3,2
372,4,3,1342,1342,1345,0,3,1
373,4,3,1346,1346,1349,0,3,1
374,4,2,1350,1350,1352,0,2,1
375,3,3,1353,1353,1356,0,3,1
376,2,3,1355,1356,1359,1,4,0
377,5,2,1360,1360,1362,0,2,1
378,5,3,1365,1365,1368,0,3,3
379,3,3,1368,1368,1371,0,3,0
380,5,2,1373,1373,1375,0,2,2
381,2,3,1375,1375,1378,0,3,0
382,5,3,1380,1380,1383,0,3,2
383,1,2,1381,1383,1385,2,4,0
384,2,3,1383,1385,1388,2,5,0
385,2,2,1385,1388,1390,3,5,0
386,2,3,1387,1390,1393,3,6,0
387,5,1,1392,1393,1394,1,2,0
388,6,2,1398,1398,1400,0,2,4
389,4,2,1402,1402,1404,0,2,2
390,2,3,1404,1404,1407,0,3,0
391,5,3,1409,1409,1412,0,3,2
392,2,3,1411,1412,1415,1,4,0
393,2,3,1413,1415,1418,2,5,0
394,6,3,1419,1419,1422,0,3,1
395,6,1,1425,1425,1426,0,1,3
396,6,2,1431,1431,1433,0,2,5
397,6,2,1437,1437,1439,0,2,4
398,5,1,1442,1442,1443,0,1,3
399,1,1,1443,1443,1444,0,1,0
400,4,1,1447,1447,1448,0,1,3
401,5,1,1452,1452,1453,0,1,4
402,4,2,1456,1456,1458,0,2,3
403,2,3,1458,1458,1461,0,3,0
404,4,3,1462,1462,1465,0,3,1
405,5,1,1467,1467,1468,0,1,2
406,4,2,1471,1471,1473,0,2,3
407,1,1,1472,1473,1474,1,2,0
408,1,3,1473,1474,1477,1,4,0
409,1,3,1474,1477,1480,3,6,0
410,5,2,1479,1480,1482,1,3,0
411,5,1,1484,1484,1485,0,1,2
412,5,3,1489,1489,1492,0,3,4
413,1,1,1490,1492,1493,2,3,0
414,1,1,1491,1493,1494,2,3,0
415,6,1,1497,1497,1498,0,1,3
416,1,2,1498,1498,1500,0,2,0
417,5,3,1503,1503,1506,0,3,3
418,1,2,1504,1506,1508,2,4,0
419,5,3,1509,1509,1512,0,3,1
420,4,3,1513,1513,1516,0,3,1
421,1,3,1514,1516,1519,2,5,0
422,5,2,1519,1519,1521,0,2,0
423,1,1,1520,1521,1522,1,2,0
424,3,3,1523,1523,1526,0,3,1
425,2,1,1525,1526,1527,1,2,0
426,6,2,1531,1531,1533,0,2,4
427,5,2,1536,1536,1538,0,2,3
428,3,2,1539,1539,1541,0,2,1
429,4,2,1543,1543,1545,0,2,2
430,5,2,1548,1548,1550,0,2,3
431,6,1,1554,1554,1555,0,1,4
432,1,1,1555,1555,1556,0,1,0
433,1,2,1556,1556,1558,0,2,0
434,6,3,1562,1562,1565,0,3,4
435,4,3,1566,1566,1569,0,3,1
436,6,3,1572,1572,1575,0,3,3
437,3,1,1575,1575,1576,0,1,0
438,2,2,1577,1577,1579,0,2,1
439,4,1,1581,1581,1582,0,1,2
440,5,3,1586,1586,1589,0,3,4
441,6,1,1592,1592,1593,0,1,3
442,1,1,1593,1593,1594,0,1,0
443,2,3,1595,1595,1598,0,3,1
444,6,2,1601,1601,1603,0,2,3
445,4,2,1605,1605,1607,0,2,2
446,1,2,1606,1607,1609,1,3,0
447,4,1,1610,1610,1611,0,1,1
448,2,2,1612,1612,1614,0,2,1
449,2,2,1614,1614,1616,0,2,0
450,2,2,1616,1616,1618,0,2,0
451,2,2,1618,1618,1620,0,2,0
452,6,3,1624,1624,1627,0,3,4
453,1,3,1625,1627,1630,2,5,0
454,1,3,1626,1630,1633,4,7,0
455,2,1,1628,1633,1634,5,6,0
456,4,1,1632,1634,1635,2,3,0
457,1,3,1633,1635,1638,2,5,0
458,4,3,1637,1638,1641,1,4,0
459,5,3,1642,1642,1645,0,3,1
460,6,3,1648,1648,1651,0,3,3
461,1,1,1649,1651,1652,2,3,0
462,1,1,1650,1652,1653,2,3,0
463,6,2,1656,1656,1658,0,2,3
464,5,1,1661,1661,1662,0,1,3
465,4,1,1665,1665,1666,0,1,3
466,6,3,1671,1671,1674,0,3,5
467,6,1,1677,1677,1678,0,1,3
468,2,2,1679,1679,1681,0,2,1
469,6,1,1685,1685,1686,0,1,4
470,3,1,1688,1688,1689,0,1,2
471,4,2,1692,1692,1694,0,2,3
472,5,3,1697,1697,1700,0,3,3
473,5,3,1702,1702,1705,0,3,2
474,6,2,1708,1708,1710,0,2,3
475,3,1,1711,1711,1712,0,1,1
476,6,3,1717,1717,1720,0,3,5
477,6,2,1723,1723,1725,0,2,3
478,5,1,1728,1728,1729,0,1,3
479,3,3,1731,1731,1734,0,3,2
480,3,2,1734,1734,1736,0,2,0
481,3,1,1737,1737,1738,0,1,1
482,6,3,1743,1743,1746,0,3,5
483,4,1,1747,1747,1748,0,1,1
484,2,2,1749,1749,1751,0,2,1
485,5,2,1754,1754,1756,0,2,3
486,4,3,1758,1758,1761,0,3,2
487,3,1,1761,1761,1762,0,1,0
488,3,3,1764,1764,1767,0,3,2
489,4,2,1768,1768,1770,0,2,1
490,3,2,1771,1771,1773,0,2,1
491,5,2,1776,1776,1778,0,2,3
492,3,1,1779,1779,1780,0,1,1
493,5,1,1784,1784,1785,0,1,4
494,2,3,1786,1786,1789,0,3,1
495,6,3,1792,1792,1795,0,3,3
496,3,1,1795,1795,1796,0,1,0
497,4,1,1799,1799,1800,0,1,3
498,6,3,1805,1805,1808,0,3,5
499,4,2,1809,1809,1811,0,2,1
500,5,1,1814,1814,1815,0,1,3
501,1,3,1815,1815,1818,0,3,0
502,4,3,1819,1819,1822,0,3,1
503,4,2,1823,1823,1825,0,2,1
504,2,1,1825,1825,1826,0,1,0
505,4,2,1829,1829,1831,0,2,3
506,2,1,1831,1831,1832,0,1,0
507,5,3,1836,1836,1839,0,3,4
508,5,3,1841,1841,1844,0,3,2
509,4,3,1845,1845,1848,0,3,1
510,5,1,1850,1850,1851,0,1,2
511,2,3,1852,1852,1855,0,3,1
512,2,2,1854,1855,1857,1,3,0
513,1,2,1855,1857,1859,2,4,0
514,1,3,1856,1859,1862,3,6,0
515,6,3,1862,1862,1865,0,3,0
516,5,3,1867,1867,1870,0,3,2
517,3,3,1870,1870,1873,0,3,0
518,6,2,1876,1876,1878,0,2,3
519,5,2,1881,1881,1883,0,2,3
520,3,1,1884,1884,1885,0,1,1
521,1,2,1885,1885,1887,0,2,0
522,2,2,1887,1887,1889,0,2,0
523,3,1,1890,1890,1891,0,1,1
524,1,1,1891,1891,1892,0,1,0
525,5,2,1896,1896,1898,0,2,4
526,2,2,1898,1898,1900,0,2,0
527,1,3,1899,1900,1903,1,4,0
528,4,3,1903,1903,1906,0,3,0
529,6,2,1909,1909,1911,0,2,3
530,1,2,1910,1911,1913,1,3,0
531,2,2,1912,1913,1915,1,3,0
532,3,3,1915,1915,1918,0,3,0
533,6,3,1921,1921,1924,0,3,3
534,6,2,1927,1927,1929,0,2,3
535,5,1,1932,1932,1933,0,1,3
536,2,2,1934,1934,1936,0,2,1
537,1,2,1935,1936,1938,1,3,0
538,1,3,1936,1938,1941,2,5,0
539,4,2,1940,1941,1943,1,3,0
540,1,2,1941,1943,1945,2,4,0
541,4,3,1945,1945,1948,0,3,0
542,6,2,1951,1951,1953,0,2,3
543,3,1,1954,1954,1955,0,1,1
544,2,2,1956,1956,1958,0,2,1
545,6,2,1962,1962,1964,0,2,4
546,5,2,1967,1967,1969,0,2,3
547,4,2,1971,1971,1973,0,2,2
548,2,3,1973,1973,1976,0,3,0
549,6,2,1979,1979,1981,0,2,3
550,1,3,1980,1981,1984,1,4,0
551,4,3,1984,1984,1987,0,3,0
552,5,3,1989,1989,1992,0,3,2
553,5,3,1994,1994,1997,0,3,2
554,4,1,1998,1998,1999,0,1,1
555,3,3,2001,2001,2004,0,3,2
556,3,3,2004,2004,2007,0,3,0
557,4,3,2008,2008,2011,0,3,1
558,1,1,2009,2011,2012,2,3,0
559,4,2,2013,2013,2015,0,2,1
560,2,3,2015,2015,2018,0,3,0
561,5,1,2020,2020,2021,0,1,2
562,1,2,2021,2021,2023,0,2,0
563,1,2,2022,2023,2025,1,3,0
564,6,1,2028,2028,2029,0,1,3
565,5,3,2033,2033,2036,0,3,4
566,4,3,2037,2037,2040,0,3,1
567,6,1,2043,2043,2044,0,1,3
568,6,1,2049,2049,2050,0,1,5
569,3,3,2052,2052,2055,0,3,2
570,4,3,2056,2056,2059,0,3,1
571,2,2,2058,2059,2061,1,3,0
572,6,2,2064,2064,2066,0,2,3
573,5,1,2069,2069,2070,0,1,3
574,3,1,2072,2072,2073,0,1,2
575,4,3,2076,2076,2079,0,3,3
576,4,2,2080,2080,2082,0,2,1
577,6,2,2086,2086,2088,0,2,4
578,1,2,2087,2088,2090,1,3,0
579,3,1,2090,2090,2091,0,1,0
580,2,3,2092,2092,2095,0,3,1
581,4,3,2096,2096,2099,0,3,1
582,4,3,2100,2100,2103,0,3,1
583,5,1,2105,2105,2106,0,1,2
584,5,3,2110,2110,2113,0,3,4
585,4,2,2114,2114,2116,0,2,1
586,4,2,2118,2118,2120,0,2,2
587,2,2,2120,2120,2122,0,2,0
588,1,1,2121,2122,2123,1,2,0
589,3,2,2124,2124,2126,0,2,1
590,4,2,2128,2128,2130,0,2,2
591,6,1,2134,2134,2135,0,1,4
592,2,2,2136,2136,2138,0,2,1
593,1,3,2137,2138,2141,1,4,0
594,3,3,2140,2141,2144,1,4,0
595,6,3,2146,2146,2149,0,3,2
596,1,2,2147,2149,2151,2,4,0
597,4,1,2151,2151,2152,0,1,0
598,5,1,2156,2156,2157,0,1,4
599,4,2,2160,2160,2162,0,2,3
600,3,3,2163,2163,2166,0,3,1
601,3,1,2166,2166,2167,0,1,0
602,3,2,2169,2169,2171,0,2,2
603,5,2,2174,2174,2176,0,2,3
604,5,3,2179,2179,2182,0,3,3
605,1,3,2180,2182,2185,2,5,0
606,4,3,2184,2185,2188,1,4,0
607,5,2,2189,2189,2191,0,2,1
608,2,2,2191,2191,2193,0,2,0
609,4,3,2195,2195,2198,0,3,2
610,3,2,2198,2198,2200,0,2,0
611,2,1,2200,2200,2201,0,1,0
612,6,1,2206,2206,2207,0,1,5
613,4,1,2210,2210,2211,0,1,3
614,4,1,2214,2214,2215,0,1,3
615,6,1,2220,2220,2221,0,1,5
616,2,1,2222,2222,2223,0,1,1
617,3,1,2225,2225,2226,0,1,2
618,2,3,2227,2227,2230,0,3,1
619,1,1,2228,2230,2231,2,3,0
620,1,1,2229,2231,2232,2,3,0
621,2,2,2231,2232,2234,1,3,0
622,2,1,2233,2234,2235,1,2,0
623,3,1,2236,2236,2237,0,1,1
624,5,2,2241,2241,2243,0,2,4
625,5,1,2246,2246,2247,0,1,3
626,1,1,2247,2247,2248,0,1,0
627,3,3,2250,2250,2253,0,3,2
628,2,2,2252,2253,2255,1,3,0
629,6,3,2258,2258,2261,0,3,3
630,2,2,2260,2261,2263,1,3,0
631,6,3,2266,2266,2269,0,3,3
632,5,1,2271,2271,2272,0,1,2
633,2,1,2273,2273,2274,0,1,1
634,4,2,2277,2277,2279,0,2,3
635,1,2,2278,2279,2281,1,3,0
636,2,3,2280,2281,2284,1,4,0
637,2,3,2282,2284,2287,2,5,0
638,5,1,2287,2287,2288,0,1,0
639,1,2,2288,2288,2290,0,2,0
640,4,3,2292,2292,2295,0,3,2
641,3,1,2295,2295,2296,0,1,0
642,5,2,2300,2300,2302,0,2,4
643,3,3,2303,2303,2306,0,3,1
644,2,3,2305,2306,2309,1,4,0
645,2,2,2307,2309,2311,2,4,0
646,2,3,2309,2311,2314,2,5,0
647,6,1,2315,2315,2316,0,1,1
648,2,1,2317,2317,2318,0,1,1
649,1,3,2318,2318,2321,0,3,0
650,1,2,2319,2321,2323,2,4,0
651,1,1,2320,2323,2324,3,4,0
652,1,1,2321,2324,2325,3,4,0
653,1,1,2322,2325,2326,3,4,0
654,5,2,2327,2327,2329,0,2,1
655,5,2,2332,2332,2334,0,2,3
656,1,3,2333,2334,2337,1,4,0
657,2,1,2335,2337,2338,2,3,0
658,1,2,2336,2338,2340,2,4,0
659,4,2,2340,2340,2342,0,2,0
660,4,2,2344,2344,2346,0,2,2
661,3,2,2347,2347,2349,0,2,1
662,1,1,2348,2349,2350,1,2,0
663,4,2,2352,2352,2354,0,2,2
664,5,2,2357,2357,2359,0,2,3
665,4,1,2361,2361,2362,0,1,2
666,1,1,2362,2362,2363,0,1,0
667,2,2,2364,2364,2366,0,2,1
668,1,3,2365,2366,2369,1,4,0
669,3,2,2368,2369,2371,1,3,0
670,6,3,2374,2374,2377,0,3,3
671,1,3,2375,2377,2380,2,5,0
672,6,3,2381,2381,2384,0,3,1
673,3,3,2384,2384,2387,0,3,0
674,2,3,2386,2387,2390,1,4,0
675,5,2,2391,2391,2393,0,2,1
676,2,2,2393,2393,2395,0,2,0
677,4,3,2397,2397,2400,0,3,2
678,3,2,2400,2400,2402,0,2,0
679,6,3,2406,2406,2409,0,3,4
680,3,2,2409,2409,2411,0,2,0
681,1,1,2410,2411,2412,1,2,0
682,1,1,2411,2412,2413,1,2,0
683,2,2,2413,2413,2415,0,2,0
684,4,3,2417,2417,2420,0,3,2
685,2,2,2419,2420,2422,1,3,0
686,2,3,2421,2422,2425,1,4,0
687,6,2,2427,2427,2429,0,2,2
688,3,3,2430,2430,2433,0,3,1
689,4,3,2434,2434,2437,0,3,1
690,3,1,2437,2437,2438,0,1,0
691,5,2,2442,2442,2444,0,2,4
692,1,1,2443,2444,2445,1,2,0
693,3,1,2446,2446,2447,0,1,1
694,1,3,2447,2447,2450,0,3,0
695,1,3,2448,2450,2453,2,5,0
696,3,2,2451,2453,2455,2,4,0
697,6,1,2457,2457,2458,0,1,2
698,1,3,2458,2458,2461,0,3,0
699,3,1,2461,2461,2462,0,1,0
700,3,3,2464,2464,2467,0,3,2
701,5,1,2469,2469,2470,0,1,2
702,4,3,2473,2473,2476,0,3,3
703,6,3,2479,2479,2482,0,3,3
704,1,1,2480,2482,2483,2,3,0
705,6,2,2486,2486,2488,0,2,3
706,4,3,2490,2490,2493,0,3,2
707,4,1,2494,2494,2495,0,1,1
708,1,1,2495,2495,2496,0,1,0
709,2,3,2497,2497,2500,0,3,1
710,4,1,2501,2501,2502,0,1,1
711,2,1,2503,2503,2504,0,1,1
712,5,3,2508,2508,2511,0,3,4
713,5,2,2513,2513,2515,0,2,2
714,3,3,2516,2516,2519,0,3,1
715,4,1,2520,2520,2521,0,1,1
716,3,1,2523,2523,2524,0,1,2
717,4,1,2527,2527,2528,0,1,3
718,1,3,2528,2528,2531,0,3,0
719,1,1,2529,2531,2532,2,3,0
720,1,2,2530,2532,2534,2,4,0
721,1,1,2531,2534,2535,3,4,0
722,6,3,2537,2537,2540,0,3,2
723,1,1,2538,2540,2541,2,3,0
724,3,3,2541,2541,2544,0,3,0
725,4,3,2545,2545,2548,0,3,1
726,1,3,2546,2548,2551,2,5,0
727,3,3,2549,2551,2554,2,5,0
728,4,2,2553,2554,2556,1,3,0
729,2,3,2555,2556,2559,1,4,0
730,1,1,2556,2559,2560,3,4,0
731,5,3,2561,2561,2564,0,3,1
732,5,1,2566,2566,2567,0,1,2
733,5,2,2571,2571,2573,0,2,4
734,6,3,2577,2577,2580,0,3,4
735,4,1,2581,2581,2582,0,1,1
736,4,1,2585,2585,2586,0,1,3
737,4,1,2589,2589,2590,0,1,3
738,6,1,2595,2595,2596,0,1,5
739,4,1,2599,2599,2600,0,1,3
740,6,1,2605,2605,2606,0,1,5
741,5,3,2610,2610,2613,0,3,4
742,2,3,2612,2613,2616,1,4,0
743,4,3,2616,2616,2619,0,3,0
744,5,3,2621,2621,2624,0,3,2
745,5,3,2626,2626,2629,0,3,2
746,6,2,2632,2632,2634,0,2,3
747,4,1,2636,2636,2637,0,1,2
748,6,1,2642,2642,2643,0,1,5
749,6,2,2648,2648,2650,0,2,5
750,3,3,2651,2651,2654,0,3,1
751,2,1,2653,2654,2655,1,2,0
752,5,2,2658,2658,2660,0,2,3
753,5,3,2663,2663,2666,0,3,3
754,3,1,2666,2666,2667,0,1,0
755,2,3,2668,2668,2671,0,3,1
756,2,2,2670,2671,2673,1,3,0
757,6,2,2676,2676,2678,0,2,3
758,1,1,2677,2678,2679,1,2,0
759,4,1,2681,2681,2682,0,1,2
760,4,1,2685,2685,2686,0,1,3
761,3,1,2688,2688,2689,0,1,2
762,4,1,2692,2692,2693,0,1,3
763,1,1,2693,2693,2694,0,1,0
764,6,2,2699,2699,2701,0,2,5
765,5,1,2704,2704,2705,0,1,3
766,1,2,2705,2705,2707,0,2,0
767,6,3,2711,2711,2714,0,3,4
768,2,3,2713,2714,2717,1,4,0
769,5,3,2718,2718,2721,0,3,1
770,1,1,2719,2721,2722,2,3,0
771,6,1,2725,2725,2726,0,1,3
772,3,3,2728,2728,2731,0,3,2
773,4,3,2732,2732,2735,0,3,1
774,4,3,2736,2736,2739,0,3,1
775,5,3,2741,2741,2744,0,3,2
776,5,3,2746,2746,2749,0,3,2
777,4,2,2750,2750,2752,0,2,1
778,6,2,2756,2756,2758,0,2,4
779,1,2,2757,2758,2760,1,3,0
780,6,2,2763,2763,2765,0,2,3
781,1,2,2764,2765,2767,1,3,0
782,6,1,2770,2770,2771,0,1,3
783,4,2,2774,2774,2776,0,2,3
784,1,3,2775,2776,2779,1,4,0
785,4,3,2779,2779,2782,0,3,0
786,2,3,2781,2782,2785,1,4,0
787,4,3,2785,2785,2788,0,3,0
788,2,1,2787,2788,2789,1,2,0
789,6,1,2793,2793,2794,0,1,4
790,3,1,2796,2796,2797,0,1,2
791,1,3,2797,2797,2800,0,3,0
792,6,2,2803,2803,2805,0,2,3
793,2,3,2805,2805,2808,0,3,0
794,5,3,2810,2810,2813,0,3,2
795,1,1,2811,2813,2814,2,3,0
796,5,1,2816,2816,2817,0,1,2
797,3,1,2819,2819,2820,0,1,2
798,4,1,2823,2823,2824,0,1,3
799,6,1,2829,2829,2830,0,1,5
800,3,3,2832,2832,2835,0,3,2
801,1,2,2833,2835,2837,2,4,0
802,2,2,2835,2837,2839,2,4,0
803,2,3,2837,2839,2842,2,5,0
804,5,2,2842,2842,2844,0,2,0
805,1,1,2843,2844,2845,1,2,0
806,2,3,2845,2845,2848,0,3,0
807,1,2,2846,2848,2850,2,4,0
808,4,3,2850,2850,2853,0,3,0
809,5,3,2855,2855,2858,0,3,2
810,4,1,2859,2859,2860,0,1,1
811,2,2,2861,2861,2863,0,2,1
812,5,3,2866,2866,2869,0,3,3
813,1,3,2867,2869,2872,2,5,0
814,4,3,2871,2872,2875,1,4,0
815,4,3,2875,2875,2878,0,3,0
816,1,3,2876,2878,2881,2,5,0
817,4,2,2880,2881,2883,1,3,0
818,1,2,2881,2883,2885,2,4,0
819,5,1,2886,2886,2887,0,1,1
820,5,1,2891,2891,2892,0,1,4
821,1,2,2892,2892,2894,0,2,0
822,3,3,2895,2895,2898,0,3,1
823,6,3,2901,2901,2904,0,3,3
824,4,2,2905,2905,2907,0,2,1
825,4,3,2909,2909,2912,0,3,2
826,1,3,2910,2912,2915,2,5,0
827,6,2,2916,2916,2918,0,2,1
828,4,3,2920,2920,2923,0,3,2
829,6,1,2926,2926,2927,0,1,3
830,6,2,2932,2932,2934,0,2,5
831,2,1,2934,2934,2935,0,1,0
832,3,1,2937,2937,2938,0,1,2
833,4,3,2941,2941,2944,0,3,3
834,2,1,2943,2944,2945,1,2,0
835,1,2,2944,2945,2947,1,3,0
836,2,1,2946,2947,2948,1,2,0
837,1,1,2947,2948,2949,1,2,0
838,3,3,2950,2950,2953,0,3,1
839,3,3,2953,2953,2956,0,3,0
840,2,2,2955,2956,2958,1,3,0
841,6,2,2961,2961,2963,0,2,3
842,1,1,2962,2963,2964,1,2,0
843,4,3,2966,2966,2969,0,3,2
844,4,1,2970,2970,2971,0,1,1
845,1,3,2971,2971,2974,0,3,0
846,6,1,2977,2977,2978,0,1,3
847,3,3,2980,2980,2983,0,3,2
848,4,1,2984,2984,2985,0,1,1
849,3,1,2987,2987,2988,0,1,2
850,5,3,2992,2992,2995,0,3,4
851,6,1,2998,2998,2999,0,1,3
852,6,1,3004,3004,3005,0,1,5
853,6,2,3010,3010,3012,0,2,5
854,2,2,3012,3012,3014,0,2,0
855,3,1,3015,3015,3016,0,1,1
856,6,1,3021,3021,3022,0,1,5
857,6,3,3027,3027,3030,0,3,5
858,2,2,3029,3030,3032,1,3,0
859,6,3,3035,3035,3038,0,3,3
860,2,1,3037,3038,3039,1,2,0
861,4,3,3041,3041,3044,0,3,2
862,5,3,3046,3046,3049,0,3,2
863,1,1,3047,3049,3050,2,3,0
864,2,1,3049,3050,3051,1,2,0
865,6,2,3055,3055,3057,0,2,4
866,1,1,3056,3057,3058,1,2,0
867,5,2,3061,3061,3063,0,2,3
868,1,3,3062,3063,3066,1,4,0
869,6,2,3068,3068,3070,0,2,2
870,5,1,3073,3073,3074,0,1,3
871,1,2,3074,3074,3076,0,2,0
872,1,2,3075,3076,3078,1,3,0
873,3,1,3078,3078,3079,0,1,0
874,6,3,3084,3084,3087,0,3,5
875,5,2,3089,3089,3091,0,2,2
876,4,3,3093,3093,3096,0,3,2
877,4,3,3097,3097,3100,0,3,1
878,2,1,3099,3100,3101,1,2,0
879,2,1,3101,3101,3102,0,1,0
880,5,2,3106,3106,3108,0,2,4
881,1,3,3107,3108,3111,1,4,0
882,6,1,3113,3113,3114,0,1,2
883,2,1,3115,3115,3116,0,1,1
884,3,2,3118,3118,3120,0,2,2
885,1,1,3119,3120,3121,1,2,0
886,5,2,3124,3124,3126,0,2,3
887,1,2,3125,3126,3128,1,3,0
888,2,2,3127,3128,3130,1,3,0
889,5,3,3132,3132,3135,0,3,2
890,1,1,3133,3135,3136,2,3,0
891,2,1,3135,3136,3137,1,2,0
892,3,3,3138,3138,3141,0,3,1
893,2,2,3140,3141,3143,1,3,0
894,5,2,3145,3145,3147,0,2,2
895,3,1,3148,3148,3149,0,1,1
896,5,3,3153,3153,3156,0,3,4
897,6,2,3159,3159,3161,0,2,3
898,5,2,3164,3164,3166,0,2,3
899,4,1,3168,3168,3169,0,1,2
900,5,1,3173,3173,3174,0,1,4
901,4,2,3177,3177,3179,0,2,3
902,5,1,3182,3182,3183,0,1,3
903,1,3,3183,3183,3186,0,3,0
904,1,3,3184,3186,3189,2,5,0
905,5,3,3189,3189,3192,0,3,0
906,3,2,3192,3192,3194,0,2,0
907,3,2,3195,3195,3197,0,2,1
908,5,2,3200,3200,3202,0,2,3
909,3,1,3203,3203,3204,0,1,1
910,1,3,3204,3204,3207,0,3,0
911,4,3,3208,3208,3211,0,3,1
912,6,2,3214,3214,3216,0,2,3
913,6,3,3220,3220,3223,0,3,4
914,3,2,3223,3223,3225,0,2,0
915,4,2,3227,3227,3229,0,2,2
916,4,2,3231,3231,3233,0,2,2
917,1,3,3232,3233,3236,1,4,0
918,5,3,3237,3237,3240,0,3,1
919,3,3,3240,3240,3243,0,3,0
920,2,1,3242,3243,3244,1,2,0
921,5,2,3247,3247,3249,0,2,3
922,5,3,3252,3252,3255,0,3,3
923,5,2,3257,3257,3259,0,2,2
924,6,1,3263,3263,3264,0,1,4
925,5,3,3268,3268,3271,0,3,4
926,2,3,3270,3271,3274,1,4,0
927,1,3,3271,3274,3277,3,6,0
928,1,1,3272,3277,3278,5,6,0
929,6,3,3278,3278,3281,0,3,0
930,6,1,3284,3284,3285,0,1,3
931,5,3,3289,3289,3292,0,3,4
932,6,1,3295,3295,3296,0,1,3
933,4,2,3299,3299,3301,0,2,3
934,2,1,3301,3301,3302,0,1,0
935,6,2,3307,3307,3309,0,2,5
936,5,2,3312,3312,3314,0,2,3
937,5,2,3317,3317,3319,0,2,3
938,6,3,3323,3323,3326,0,3,4
939,6,3,3329,3329,3332,0,3,3
940,4,3,3333,3333,3336,0,3,1
941,3,2,3336,3336,3338,0,2,0
942,1,2,3337,3338,3340,1,3,0
943,5,3,3342,3342,3345,0,3,2
944,2,2,3344,3345,3347,1,3,0
945,4,2,3348,3348,3350,0,2,1
946,4,1,3352,3352,3353,0,1,2
947,4,1,3356,3356,3357,0,1,3
948,4,3,3360,3360,3363,0,3,3
949,3,2,3363,3363,3365,0,2,0
950,1,2,3364,3365,3367,1,3,0
951,5,3,3369,3369,3372,0,3,2
952,1,3,3370,3372,3375,2,5,0
953,5,2,3375,3375,3377,0,2,0
954,2,2,3377,3377,3379,0,2,0
955,3,1,3380,3380,3381,0,1,1
956,3,2,3383,3383,3385,0,2,2
957,4,1,3387,3387,3388,0,1,2
958,6,3,3393,3393,3396,0,3,5
959,4,3,3397,3397,3400,0,3,1
960,2,3,3399,3400,3403,1,4,0
961,2,1,3401,3403,3404,2,3,0
962,3,1,3404,3404,3405,0,1,0
963,2,1,3406,3406,3407,0,1,1
964,1,1,3407,3407,3408,0,1,0
965,1,3,3408,3408,3411,0,3,0
966,5,1,3413,3413,3414,0,1,2
967,2,3,3415,3415,3418,0,3,1
968,6,3,3421,3421,3424,0,3,3
969,2,1,3423,3424,3425,1,2,0
970,6,3,3429,3429,3432,0,3,4
971,2,2,3431,3432,3434,1,3,0
972,6,2,3437,3437,3439,0,2,3
973,2,1,3439,3439,3440,0,1,0
974,5,1,3444,3444,3445,0,1,4
975,1,3,3445,3445,3448,0,3,0
976,1,1,3446,3448,3449,2,3,0
977,1,3,3447,3449,3452,2,5,0
978,5,3,3452,3452,3455,0,3,0
979,1,3,3453,3455,3458,2,5,0
980,4,1,3457,3458,3459,1,2,0
981,4,2,3461,3461,3463,0,2,2
982,4,1,3465,3465,3466,0,1,2
983,2,3,3467,3467,3470,0,3,1
984,3,2,3470,3470,3472,0,2,0
985,1,2,3471,3472,3474,1,3,0
986,3,3,3474,3474,3477,0,3,0
987,1,1,3475,3477,3478,2,3,0
988,2,3,3477,3478,3481,1,4,0
989,3,1,3480,3481,3482,1,2,0
990,3,2,3483,3483,3485,0,2,1
991,4,1,3487,3487,3488,0,1,2
992,2,3,3489,3489,3492,0,3,1
993,3,1,3492,3492,3493,0,1,0
994,6,2,3498,3498,3500,0,2,5
995,3,1,3501,3501,3502,0,1,1
996,4,1,3505,3505,3506,0,1,3
997,1,3,3506,3506,3509,0,3,0
998,1,2,3507,3509,3511,2,4,0
999,3,2,3510,3511,3513,1,3,0
1000,1,1,3511,3513,3514,2,3,0
1001,5,2,3516,3516,3518,0,2,2
1002,3,1,3519,3519,3520,0,1,1
1003,4,3,3523,3523,3526,0,3,3
1004,4,2,3527,3527,3529,0,2,1
1005,2,1,3529,3529,3530,0,1,0
1006,5,3,3534,3534,3537,0,3,4
1007,3,2,3537,3537,3539,0,2,0
1008,6,3,3543,3543,3546,0,3,4
1009,3,2,3546,3546,3548,0,2,0
1010,5,3,3551,3551,3554,0,3,3
1011,1,3,3552,3554,3557,2,5,0
1012,6,1,3558,3558,3559,0,1,1
1013,3,2,3561,3561,3563,0,2,2
1014,3,3,3564,3564,3567,0,3,1
1015,4,2,3568,3568,3570,0,2,1
1016,2,1,3570,3570,3571,0,1,0
1017,5,2,3575,3575,3577,0,2,4
1018,2,2,3577,3577,3579,0,2,0
1019,3,1,3580,3580,3581,0,1,1
1020,1,3,3581,3581,3584,0,3,0
1021,2,3,3583,3584,3587,1,4,0
1022,2,2,3585,3587,3589,2,4,0
1023,2,3,3587,3589,3592,2,5,0
1024,4,2,3591,3592,3594,1,3,0
1025,1,2,3592,3594,3596,2,4,0
1026,3,3,3595,3596,3599,1,4,0
1027,2,2,3597,3599,3601,2,4,0
1028,6,1,3603,3603,3604,0,1,2
1029,5,3,3608,3608,3611,0,3,4
1030,6,3,3614,3614,3617,0,3,3
1031,1,2,3615,3617,3619,2,4,0
1032,4,2,3619,3619,3621,0,2,0
1033,2,3,3621,3621,3624,0,3,0
1034,5,1,3626,3626,3627,0,1,2
1035,6,3,3632,3632,3635,0,3,5
1036,1,2,3633,3635,3637,2,4,0
1037,5,1,3638,3638,3639,0,1,1
1038,4,1,3642,3642,3643,0,1,3
1039,3,3,3645,3645,3648,0,3,2
1040,5,3,3650,3650,3653,0,3,2
1041,6,2,3656,3656,3658,0,2,3
1042,5,3,3661,3661,3664,0,3,3
1043,5,1,3666,3666,3667,0,1,2
1044,1,3,3667,3667,3670,0,3,0
1045,3,1,3670,3670,3671,0,1,0
1046,1,2,3671,3671,3673,0,2,0
1047,4,1,3675,3675,3676,0,1,2
1048,2,1,3677,3677,3678,0,1,1
1049,5,2,3682,3682,3684,0,2,4
1050,6,3,3688,3688,3691,0,3,4
1051,6,2,3694,3694,3696,0,2,3
1052,6,1,3700,3700,3701,0,1,4
1053,1,2,3701,3701,3703,0,2,0
1054,6,1,3707,3707,3708,0,1,4
1055,6,2,3713,3713,3715,0,2,5
1056,6,2,3719,3719,3721,0,2,4
1057,5,2,3724,3724,3726,0,2,3
1058,3,2,3727,3727,3729,0,2,1
1059,6,3,3733,3733,3736,0,3,4
1060,3,1,3736,3736,3737,0,1,0
1061,6,2,3742,3742,3744,0,2,5
1062,3,1,3745,3745,3746,0,1,1
1063,6,3,3751,3751,3754,0,3,5
1064,3,3,3754,3754,3757,0,3,0
1065,2,2,3756,3757,3759,1,3,0
1066,1,1,3757,3759,3760,2,3,0
1067,4,2,3761,3761,3763,0,2,1
1068,5,2,3766,3766,3768,0,2,3
1069,5,1,3771,3771,3772,0,1,3
1070,4,3,3775,3775,3778,0,3,3
1071,3,2,3778,3778,3780,0,2,0
1072,5,1,3783,3783,3784,0,1,3
1073,5,1,3788,3788,3789,0,1,4
1074,5,2,3793,3793,3795,0,2,4
1075,2,3,3795,3795,3798,0,3,0
1076,2,1,3797,3798,3799,1,2,0
1077,6,1,3803,3803,3804,0,1,4
1078,4,1,3807,3807,3808,0,1,3
1079,3,3,3810,3810,3813,0,3,2
1080,1,2,3811,3813,3815,2,4,0
1081,6,3,3817,3817,3820,0,3,2
1082,2,2,3819,3820,3822,1,3,0
1083,1,3,3820,3822,3825,2,5,0
1084,2,3,3822,3825,3828,3,6,0
1085,4,3,3826,3828,3831,2,5,0
1086,2,1,3828,3831,3832,3,4,0
1087,2,2,3830,3832,3834,2,4,0
1088,1,3,3831,3834,3837,3,6,0
1089,4,3,3835,3837,3840,2,5,0
1090,2,2,3837,3840,3842,3,5,0
1091,4,1,3841,3842,3843,1,2,0
1092,1,3,3842,3843,3846,1,4,0
1093,5,3,3847,3847,3850,0,3,1
1094,1,3,3848,3850,3853,2,5,0
1095,3,2,3851,3853,3855,2,4,0
1096,2,1,3853,3855,3856,2,3,0
1097,2,3,3855,3856,3859,1,4,0
1098,3,1,3858,3859,3860,1,2,0
1099,6,3,3864,3864,3867,0,3,4
1100,1,3,3865,3867,3870,2,5,0
1101,3,1,3868,3870,3871,2,3,0
1102,6,3,3874,3874,3877,0,3,3
1103,4,1,3878,3878,3879,0,1,1
1104,1,1,3879,3879,3880,0,1,0
1105,1,1,3880,3880,3881,0,1,0
1106,6,2,3886,3886,3888,0,2,5
1107,2,2,3888,3888,3890,0,2,0
1108,1,3,3889,3890,3893,1,4,0
1109,1,3,3890,3893,3896,3,6,0
1110,6,2,3896,3896,3898,0,2,0
1111,3,1,3899,3899,3900,0,1,1
1112,6,3,3905,3905,3908,0,3,5
1113,4,1,3909,3909,3910,0,1,1
1114,3,2,3912,3912,3914,0,2,2
1115,6,2,3918,3918,3920,0,2,4
1116,1,1,3919,3920,3921,1,2,0
1117,4,2,3923,3923,3925,0,2,2
1118,6,2,3929,3929,3931,0,2,4
1119,5,1,3934,3934,3935,0,1,3
1120,4,1,3938,3938,3939,0,1,3
1121,5,1,3943,3943,3944,0,1,4
1122,1,1,3944,3944,3945,0,1,0
1123,3,1,3947,3947,3948,0,1,2
1124,2,1,3949,3949,3950,0,1,1
1125,3,2,3952,3952,3954,0,2,2
1126,2,3,3954,3954,3957,0,3,0
1127,1,2,3955,3957,3959,2,4,0
1128,5,2,3960,3960,3962,0,2,1
1129,6,2,3966,3966,3968,0,2,4
1130,2,2,3968,3968,3970,0,2,0
1131,1,1,3969,3970,3971,1,2,0
1132,2,1,3971,3971,3972,0,1,0
1133,6,3,3977,3977,3980,0,3,5
1134,3,2,3980,3980,3982,0,2,0
1135,3,2,3983,3983,3985,0,2,1
1136,2,2,3985,3985,3987,0,2,0
1137,2,2,3987,3987,3989,0,2,0
1138,5,2,3992,3992,3994,0,2,3
1139,2,2,3994,3994,3996,0,2,0
1140,2,3,3996,3996,3999,0,3,0
1141,3,2,3999,3999,4001,0,2,0
1142,4,1,4003,4003,4004,0,1,2
1143,6,2,4009,4009,4011,0,2,5
1144,4,3,4013,4013,4016,0,3,2
1145,2,2,4015,4016,4018,1,3,0
1146,5,2,4020,4020,4022,0,2,2
1147,5,3,4025,4025,4028,0,3,3
1148,6,2,4031,4031,4033,0,2,3
1149,1,2,4032,4033,4035,1,3,0
1150,5,2,4037,4037,4039,0,2,2
1151,2,3,4039,4039,4042,0,3,0
1152,3,1,4042,4042,4043,0,1,0
1153,6,2,4048,4048,4050,0,2,5
1154,4,1,4052,4052,4053,0,1,2
1155,5,3,4057,4057,4060,0,3,4
1156,5,1,4062,4062,4063,0,1,2
1157,5,3,4067,4067,4070,0,3,4
1158,3,1,4070,4070,4071,0,1,0
1159,6,2,4076,4076,4078,0,2,5
1160,6,1,4082,4082,4083,0,1,4
1161,1,1,4083,4083,4084,0,1,0
1162,3,1,4086,4086,4087,0,1,2
1163,2,2,4088,4088,4090,0,2,1
1164,6,3,4094,4094,4097,0,3,4
1165,3,1,4097,4097,4098,0,1,0
1166,6,1,4103,4103,4104,0,1,5
1167,4,2,4107,4107,4109,0,2,3
1168,6,2,4113,4113,4115,0,2,4
1169,1,2,4114,4115,4117,1,3,0
1170,3,3,4117,4117,4120,0,3,0
1171,5,3,4122,4122,4125,0,3,2
1172,1,3,4123,4125,4128,2,5,0
1173,2,1,4125,4128,4129,3,4,0
1174,4,1,4129,4129,4130,0,1,0
1175,4,3,4133,4133,4136,0,3,3
1176,4,2,4137,4137,4139,0,2,1
1177,4,3,4141,4141,4144,0,3,2
1178,1,1,4142,4144,4145,2,3,0
1179,1,3,4143,4145,4148,2,5,0
1180,5,1,4148,4148,4149,0,1,0
1181,1,3,4149,4149,4152,0,3,0
1182,4,1,4153,4153,4154,0,1,1
1183,4,1,4157,4157,4158,0,1,3
1184,1,1,4158,4158,4159,0,1,0
1185,1,3,4159,4159,4162,0,3,0
1186,4,3,4163,4163,4166,0,3,1
1187,4,2,4167,4167,4169,0,2,1
1188,2,2,4169,4169,4171,0,2,0
1189,4,3,4173,4173,4176,0,3,2
1190,3,2,4176,4176,4178,0,2,0
1191,6,1,4182,4182,4183,0,1,4
1192,5,2,4187,4187,4189,0,2,4
1193,1,3,4188,4189,4192,1,4,0
1194,3,3,4191,4192,4195,1,4,0
1195,2,2,4193,4195,4197,2,4,0
1196,4,1,4197,4197,4198,0,1,0
1197,6,2,4203,4203,4205,0,2,5
1198,3,3,4206,4206,4209,0,3,1
1199,3,1,4209,4209,4210,0,1,0
1200,6,2,4215,4215,4217,0,2,5
1201,6,2,4221,4221,4223,0,2,4
1202,1,1,4222,4223,4224,1,2,0
1203,6,3,4228,4228,4231,0,3,4
1204,1,2,4229,4231,4233,2,4,0
1205,4,1,4233,4233,4234,0,1,0
1206,5,2,4238,4238,4240,0,2,4
1207,3,2,4241,4241,4243,0,2,1
1208,5,1,4246,4246,4247,0,1,3
1209,6,2,4252,4252,4254,0,2,5
1210,4,1,4256,4256,4257,0,1,2
1211,4,3,4260,4260,4263,0,3,3
1212,1,1,4261,4263,4264,2,3,0
1213,5,1,4266,4266,4267,0,1,2
1214,1,1,4267,4267,4268,0,1,0
1215,2,3,4269,4269,4272,0,3,1
1216,6,1,4275,4275,4276,0,1,3
1217,1,3,4276,4276,4279,0,3,0
1218,1,1,4277,4279,4280,2,3,0
1219,3,1,4280,4280,4281,0,1,0
1220,2,2,4282,4282,4284,0,2,1
1221,4,3,4286,4286,4289,0,3,2
1222,2,1,4288,4289,4290,1,2,0
1223,4,2,4292,4292,4294,0,2,2
1224,1,3,4293,4294,4297,1,4,0
1225,1,1,4294,4297,4298,3,4,0
1226,5,1,4299,4299,4300,0,1,1
1227,3,1,4302,4302,4303,0,1,2
1228,3,2,4305,4305,4307,0,2,2
1229,4,1,4309,4309,4310,0,1,2
1230,4,2,4313,4313,4315,0,2,3
1231,6,3,4319,4319,4322,0,3,4
1232,5,1,4324,4324,4325,0,1,2
1233,5,1,4329,4329,4330,0,1,4
1234,5,1,4334,4334,4335,0,1,4
1235,2,2,4336,4336,4338,0,2,1
1236,5,3,4341,4341,4344,0,3,3
1237,4,3,4345,4345,4348,0,3,1
1238,5,2,4350,4350,4352,0,2,2
1239,6,2,4356,4356,4358,0,2,4
1240,4,1,4360,4360,4361,0,1,2
1241,5,3,4365,4365,4368,0,3,4
1242,2,2,4367,4368,4370,1,3,0
1243,5,2,4372,4372,4374,0,2,2
1244,2,1,4374,4374,4375,0,1,0
1245,3,1,4377,4377,4378,0,1,2
1246,2,1,4379,4379,4380,0,1,1
1247,4,2,4383,4383,4385,0,2,3
1248,5,1,4388,4388,4389,0,1,3
1249,4,2,4392,4392,4394,0,2,3
1250,5,2,4397,4397,4399,0,2,3
1251,6,2,4403,4403,4405,0,2,4
1252,5,2,4408,4408,4410,0,2,3
1253,5,1,4413,4413,4414,0,1,3
1254,5,3,4418,4418,4421,0,3,4
1255,3,2,4421,4421,4423,0,2,0
1256,1,3,4422,4423,4426,1,4,0
1257,4,3,4426,4426,4429,0,3,0
1258,3,3,4429,4429,4432,0,3,0
1259,2,2,4431,4432,4434,1,3,0
1260,1,3,4432,4434,4437,2,5,0
1261,4,2,4436,4437,4439,1,3,0
1262,3,2,4439,4439,4441,0,2,0
1263,5,1,4444,4444,4445,0,1,3
1264,3,1,4447,4447,4448,0,1,2
1265,6,1,4453,4453,4454,0,1,5
1266,5,3,4458,4458,4461,0,3,4
1267,1,2,4459,4461,4463,2,4,0
1268,2,3,4461,4463,4466,2,5,0
1269,1,1,4462,4466,4467,4,5,0
1270,2,2,4464,4467,4469,3,5,0
1271,5,2,4469,4469,4471,0,2,0
1272,6,1,4475,4475,4476,0,1,4
1273,1,3,4476,4476,4479,0,3,0
1274,6,3,4482,4482,4485,0,3,3
1275,3,3,4485,4485,4488,0,3,0
1276,5,2,4490,4490,4492,0,2,2
1277,4,2,4494,4494,4496,0,2,2
1278,6,1,4500,4500,4501,0,1,4
1279,5,2,4505,4505,4507,0,2,4
1280,4,1,4509,4509,4510,0,1,2
1281,3,2,4512,4512,4514,0,2,2
1282,4,1,4516,4516,4517,0,1,2
1283,2,2,4518,4518,4520,0,2,1
1284,4,2,4522,4522,4524,0,2,2
1285,1,2,4523,4524,4526,1,3,0
1286,2,1,4525,4526,4527,1,2,0
1287,2,3,4527,4527,4530,0,3,0
1288,6,1,4533,4533,4534,0,1,3
1289,5,1,4538,4538,4539,0,1,4
1290,5,1,4543,4543,4544,0,1,4
1291,5,1,4548,4548,4549,0,1,4
1292,1,1,4549,4549,4550,0,1,0
1293,6,1,4555,4555,4556,0,1,5
1294,5,2,4560,4560,4562,0,2,4
1295,1,1,4561,4562,4563,1,2,0
1296,1,3,4562,4563,4566,1,4,0
1297,4,3,4566,4566,4569,0,3,0
1298,3,1,4569,4569,4570,0,1,0
1299,4,3,4573,4573,4576,0,3,3
1300,3,1,4576,4576,4577,0,1,0
1301,1,1,4577,4577,4578,0,1,0
1302,6,1,4583,4583,4584,0,1,5
1303,2,3,4585,4585,4588,0,3,1
1304,1,2,4586,4588,4590,2,4,0
1305,2,1,4588,4590,4591,2,3,0
1306,3,3,4591,4591,4594,0,3,0
1307,6,1,4597,4597,4598,0,1,3
1308,5,1,4602,4602,4603,0,1,4
1309,1,3,4603,4603,4606,0,3,0
1310,1,3,4604,4606,4609,2,5,0
1311,6,1,4610,4610,4611,0,1,1
1312,3,3,4613,4613,4616,0,3,2
1313,2,2,4615,4616,4618,1,3,0
1314,5,3,4620,4620,4623,0,3,2
1315,3,1,4623,4623,4624,0,1,0
1316,2,3,4625,4625,4628,0,3,1
1317,4,1,4629,4629,4630,0,1,1
1318,6,1,4635,4635,4636,0,1,5
1319,1,2,4636,4636,4638,0,2,0
1320,2,2,4638,4638,4640,0,2,0
1321,5,1,4643,4643,4644,0,1,3
1322,5,1,4648,4648,4649,0,1,4
1323,1,2,4649,4649,4651,0,2,0
1324,1,1,4650,4651,4652,1,2,0
1325,1,1,4651,4652,4653,1,2,0
1326,6,3,4657,4657,4660,0,3,4
1327,4,3,4661,4661,4664,0,3,1
1328,5,1,4666,4666,4667,0,1,2
1329,5,1,4671,4671,4672,0,1,4
1330,5,3,4676,4676,4679,0,3,4
1331,6,2,4682,4682,4684,0,2,3
1332,5,2,4687,4687,4689,0,2,3
1333,4,3,4691,4691,4694,0,3,2
1334,5,2,4696,4696,4698,0,2,2
1335,4,1,4700,4700,4701,0,1,2
1336,1,2,4701,4701,4703,0,2,0
1337,4,2,4705,4705,4707,0,2,2
1338,4,2,4709,4709,4711,0,2,2
1339,2,2,4711,4711,4713,0,2,0
1340,5,1,4716,4716,4717,0,1,3
1341,3,2,4719,4719,4721,0,2,2
1342,1,1,4720,4721,4722,1,2,0
1343,6,3,4726,4726,4729,0,3,4
1344,6,2,4732,4732,4734,0,2,3
1345,6,3,4738,4738,4741,0,3,4
1346,1,1,4739,4741,4742,2,3,0
1347,6,1,4745,4745,4746,0,1,3
1348,6,3,4751,4751,4754,0,3,5
1349,3,1,4754,4754,4755,0,1,0
1350,4,3,4758,4758,4761,0,3,3
1351,3,1,4761,4761,4762,0,1,0
1352,3,2,4764,4764,4766,0,2,2
1353,4,1,4768,4768,4769,0,1,2
1354,5,1,4773,4773,4774,0,1,4
1355,2,2,4775,4775,4777,0,2,1
1356,1,3,4776,4777,4780,1,4,0
1357,1,1,4777,4780,4781,3,4,0
1358,1,3,4778,4781,4784,3,6,0
1359,2,1,4780,4784,4785,4,5,0
1360,2,3,4782,4785,4788,3,6,0
1361,4,2,4786,4788,4790,2,4,0
1362,4,3,4790,4790,4793,0,3,0
1363,3,3,4793,4793,4796,0,3,0
1364,3,3,4796,4796,4799,0,3,0
1365,5,2,4801,4801,4803,0,2,2
1366,1,1,4802,4803,4804,1,2,0
1367,3,2,4805,4805,4807,0,2,1
1368,3,1,4808,4808,4809,0,1,1
1369,6,2,4814,4814,4816,0,2,5
1370,1,2,4815,4816,4818,1,3,0
1371,1,3,4816,4818,4821,2,5,0
1372,6,1,4822,4822,4823,0,1,1
1373,2,2,4824,4824,4826,0,2,1
1374,1,3,4825,4826,4829,1,4,0
1375,6,3,4831,4831,4834,0,3,2
1376,3,2,4834,4834,4836,0,2,0
1377,1,1,4835,4836,4837,1,2,0
1378,2,1,4837,4837,4838,0,1,0
1379,4,1,4841,4841,4842,0,1,3
1380,4,3,4845,4845,4848,0,3,3
1381,6,2,4851,4851,4853,0,2,3
1382,1,2,4852,4853,4855,1,3,0
1383,4,2,4856,4856,4858,0,2,1
1384,3,3,4859,4859,4862,0,3,1
1385,5,3,4864,4864,4867,0,3,2
1386,4,1,4868,4868,4869,0,1,1
1387,3,3,4871,4871,4874,0,3,2
1388,2,3,4873,4874,4877,1,4,0
1389,2,2,4875,4877,4879,2,4,0
1390,6,3,4881,4881,4884,0,3,2
1391,4,2,4885,4885,4887,0,2,1
1392,4,2,4889,4889,4891,0,2,2
1393,6,1,4895,4895,4896,0,1,4
1394,4,2,4899,4899,4901,0,2,3
1395,4,3,4903,4903,4906,0,3,2
1396,6,3,4909,4909,4912,0,3,3
1397,5,3,4914,4914,4917,0,3,2
1398,2,1,4916,4917,4918,1,2,0
1399,1,3,4917,4918,4921,1,4,0
1400,4,2,4921,4921,4923,0,2,0
1401,1,1,4922,4923,4924,1,2,0
1402,6,1,4928,4928,4929,0,1,4
1403,2,1,4930,4930,4931,0,1,1
1404,5,1,4935,4935,4936,0,1,4
1405,3,3,4938,4938,4941,0,3,2
1406,5,1,4943,4943,4944,0,1,2
1407,2,2,4945,4945,4947,0,2,1
1408,2,1,4947,4947,4948,0,1,0
1409,1,2,4948,4948,4950,0,2,0
1410,5,1,4953,4953,4954,0,1,3
1411,2,1,4955,4955,4956,0,1,1
1412,2,1,4957,4957,4958,0,1,1
1413,1,1,4958,4958,4959,0,1,0
1414,5,1,4963,4963,4964,0,1,4
1415,2,1,4965,4965,4966,0,1,1
1416,3,2,4968,4968,4970,0,2,2
1417,5,1,4973,4973,4974,0,1,3
1418,4,1,4977,4977,4978,0,1,3
1419,2,2,4979,4979,4981,0,2,1
1420,3,2,4982,4982,4984,0,2,1
1421,4,1,4986,4986,4987,0,1,2
1422,6,3,4992,4992,4995,0,3,5
1423,6,3,4998,4998,5001,0,3,3
1424,5,2,5003,5003,5005,0,2,2
1425,4,1,5007,5007,5008,0,1,2
1426,6,1,5013,5013,5014,0,1,5
1427,6,1,5019,5019,5020,0,1,5
1428,5,3,5024,5024,5027,0,3,4
1429,3,3,5027,5027,5030,0,3,0
1430,2,1,5029,5030,5031,1,2,0
1431,5,3,5034,5034,5037,0,3,3
1432,4,2,5038,5038,5040,0,2,1
1433,5,3,5043,5043,5046,0,3,3
1434,5,2,5048,5048,5050,0,2,2
1435,5,2,5053,5053,5055,0,2,3
1436,5,1,5058,5058,5059,0,1,3
1437,4,3,5062,5062,5065,0,3,3
1438,1,2,5063,5065,5067,2,4,0
1439,6,3,5069,5069,5072,0,3,2
1440,6,2,5075,5075,5077,0,2,3
1441,5,2,5080,5080,5082,0,2,3
1442,2,2,5082,5082,5084,0,2,0
1443,4,3,5086,5086,5089,0,3,2
1444,1,3,5087,5089,5092,2,5,0
1445,6,1,5093,5093,5094,0,1,1
1446,1,1,5094,5094,5095,0,1,0
1447,2,3,5096,5096,5099,0,3,1
1448,3,2,5099,5099,5101,0,2,0
1449,6,2,5105,5105,5107,0,2,4
1450,2,2,5107,5107,5109,0,2,0
1451,4,2,5111,5111,5113,0,2,2
1452,4,3,5115,5115,5118,0,3,2
1453,1,1,5116,5118,5119,2,3,0
1454,3,3,5119,5119,5122,0,3,0
1455,4,3,5123,5123,5126,0,3,1
1456,5,3,5128,5128,5131,0,3,2
1457,3,2,5131,5131,5133,0,2,0
1458,2,2,5133,5133,5135,0,2,0
1459,4,3,5137,5137,5140,0,3,2
1460,1,3,5138,5140,5143,2,5,0
1461,3,2,5141,5143,5145,2,4,0
1462,4,3,5145,5145,5148,0,3,0
1463,2,2,5147,5148,5150,1,3,0
1464,5,1,5152,5152,5153,0,1,2
1465,3,2,5155,5155,5157,0,2,2
1466,3,1,5158,5158,5159,0,1,1
1467,6,3,5164,5164,5167,0,3,5
1468,5,3,5169,5169,5172,0,3,2
1469,4,1,5173,5173,5174,0,1,1
1470,4,2,5177,5177,5179,0,2,3
1471,6,1,5183,5183,5184,0,1,4
1472,6,3,5189,5189,5192,0,3,5
1473,5,2,5194,5194,5196,0,2,2
1474,2,1,5196,5196,5197,0,1,0
1475,3,2,5199,5199,5201,0,2,2
1476,6,2,5205,5205,5207,0,2,4
1477,6,3,5211,5211,5214,0,3,4
1478,2,1,5213,5214,5215,1,2,0
1479,1,1,5214,5215,5216,1,2,0
1480,3,2,5217,5217,5219,0,2,1
1481,1,2,5218,5219,5221,1,3,0
1482,6,3,5224,5224,5227,0,3,3
1483,6,2,5230,5230,5232,0,2,3
1484,5,2,5235,5235,5237,0,2,3
1485,4,1,5239,5239,5240,0,1,2
1486,4,3,5243,5243,5246,0,3,3
1487,4,1,5247,5247,5248,0,1,1
1488,3,2,5250,5250,5252,0,2,2
1489,3,3,5253,5253,5256,0,3,1
1490,3,3,5256,5256,5259,0,3,0
1491,3,2,5259,5259,5261,0,2,0
1492,4,2,5263,5263,5265,0,2,2
1493,4,2,5267,5267,5269,0,2,2
1494,3,2,5270,5270,5272,0,2,1
1495,1,3,5271,5272,5275,1,4,0
1496,1,2,5272,5275,5277,3,5,0
1497,6,3,5278,5278,5281,0,3,1
1498,3,1,5281,5281,5282,0,1,0
1499,1,1,5282,5282,5283,0,1,0
1500,2,1,5284,5284,5285,0,1,1
1501,4,1,5288,5288,5289,0,1,3
1502,3,3,5291,5291,5294,0,3,2
1503,4,2,5295,5295,5297,0,2,1
1504,4,1,5299,5299,5300,0,1,2
1505,2,2,5301,5301,5303,0,2,1
1506,4,1,5305,5305,5306,0,1,2
1507,6,3,5311,5311,5314,0,3,5
1508,6,2,5317,5317,5319,0,2,3
1509,1,3,5318,5319,5322,1,4,0
1510,5,3,5323,5323,5326,0,3,1
1511,5,3,5328,5328,5331,0,3,2
1512,6,2,5334,5334,5336,0,2,3
1513,5,1,5339,5339,5340,0,1,3
1514,3,3,5342,5342,5345,0,3,2
1515,6,1,5348,5348,5349,0,1,3
1516,6,2,5354,5354,5356,0,2,5
1517,6,2,5360,5360,5362,0,2,4
1518,2,1,5362,5362,5363,0,1,0
1519,4,3,5366,5366,5369,0,3,3
1520,1,2,5367,5369,5371,2,4,0
1521,3,3,5370,5371,5374,1,4,0
1522,3,3,5373,5374,5377,1,4,0
1523,1,3,5374,5377,5380,3,6,0
1524,3,2,5377,5380,5382,3,5,0
1525,5,2,5382,5382,5384,0,2,0
1526,4,1,5386,5386,5387,0,1,2
1527,4,1,5390,5390,5391,0,1,3
1528,1,1,5391,5391,5392,0,1,0
1529,3,3,5394,5394,5397,0,3,2
1530,5,1,5399,5399,5400,0,1,2
1531,6,2,5405,5405,5407,0,2,5
1532,5,3,5410,5410,5413,0,3,3
1533,4,3,5414,5414,5417,0,3,1
1534,4,3,5418,5418,5421,0,3,1
1535,4,2,5422,5422,5424,0,2,1
1536,4,1,5426,5426,5427,0,1,2
1537,1,2,5427,5427,5429,0,2,0
1538,3,2,5430,5430,5432,0,2,1
1539,5,3,5435,5435,5438,0,3,3
1540,3,2,5438,5438,5440,0,2,0
1541,6,3,5444,5444,5447,0,3,4
1542,6,1,5450,5450,5451,0,1,3
1543,2,3,5452,5452,5455,0,3,1
1544,4,3,5456,5456,5459,0,3,1
1545,4,1,5460,5460,5461,0,1,1
1546,5,3,5465,5465,5468,0,3,4
1547,5,1,5470,5470,5471,0,1,2
1548,4,3,5474,5474,5477,0,3,3
1549,4,1,5478,5478,5479,0,1,1
1550,4,3,5482,5482,5485,0,3,3
1551,4,2,5486,5486,5488,0,2,1
1552,1,3,5487,5488,5491,1,4,0
1553,3,3,5490,5491,5494,1,4,0
1554,2,1,5492,5494,5495,2,3,0
1555,3,2,5495,5495,5497,0,2,0
1556,3,1,5498,5498,5499,0,1,1
1557,5,2,5503,5503,5505,0,2,4
1558,3,1,5506,5506,5507,0,1,1
1559,3,1,5509,5509,5510,0,1,2
1560,3,1,5512,5512,5513,0,1,2
1561,6,1,5518,5518,5519,0,1,5
1562,1,3,5519,5519,5522,0,3,0
1563,5,3,5524,5524,5527,0,3,2
1564,6,1,5530,5530,5531,0,1,3
1565,1,2,5531,5531,5533,0,2,0
1566,2,3,5533,5533,5536,0,3,0
1567,2,3,5535,5536,5539,1,4,0
1568,5,1,5540,5540,5541,0,1,1
1569,3,3,5543,5543,5546,0,3,2
1570,1,1,5544,5546,5547,2,3,0
1571,6,1,5550,5550,5551,0,1,3
1572,2,3,5552,5552,5555,0,3,1
1573,1,1,5553,5555,5556,2,3,0
1574,1,3,5554,5556,5559,2,5,0
1575,5,1,5559,5559,5560,0,1,0
1576,1,3,5560,5560,5563,0,3,0
1577,2,3,5562,5563,5566,1,4,0
1578,3,3,5565,5566,5569,1,4,0
1579,1,3,5566,5569,5572,3,6,0
1580,2,3,5568,5572,5575,4,7,0
1581,2,2,5570,5575,5577,5,7,0
1582,1,2,5571,5577,5579,6,8,0
1583,5,3,5576,5579,5582,3,6,0
1584,1,2,5577,5582,5584,5,7,0
1585,4,2,5581,5584,5586,3,5,0
1586,4,2,5585,5586,5588,1,3,0
1587,5,2,5590,5590,5592,0,2,2
1588,1,1,5591,5592,5593,1,2,0
1589,1,2,5592,5593,5595,1,3,0
1590,6,3,5598,5598,5601,0,3,3
1591,4,1,5602,5602,5603,0,1,1
1592,2,3,5604,5604,5607,0,3,1
1593,2,3,5606,5607,5610,1,4,0
1594,5,1,5611,5611,5612,0,1,1
1595,6,1,5617,5617,5618,0,1,5
1596,1,2,5618,5618,5620,0,2,0
1597,2,3,5620,5620,5623,0,3,0
1598,2,2,5622,5623,5625,1,3,0
1599,6,1,5628,5628,5629,0,1,3
1600,2,3,5630,5630,5633,0,3,1
1601,3,1,5633,5633,5634,0,1,0
1602,6,2,5639,5639,5641,0,2,5
1603,4,3,5643,5643,5646,0,3,2
1604,1,2,5644,5646,5648,2,4,0
1605,3,2,5647,5648,5650,1,3,0
1606,2,2,5649,5650,5652,1,3,0
1607,3,1,5652,5652,5653,0,1,0
1608,6,2,5658,5658,5660,0,2,5
1609,5,3,5663,5663,5666,0,3,3
1610,1,3,5664,5666,5669,2,5,0
1611,4,1,5668,5669,5670,1,2,0
1612,4,1,5672,5672,5673,0,1,2
1613,1,3,5673,5673,5676,0,3,0
1614,6,2,5679,5679,5681,0,2,3
1615,6,2,5685,5685,5687,0,2,4
1616,1,1,5686,5687,5688,1,2,0
1617,4,2,5690,5690,5692,0,2,2
1618,6,2,5696,5696,5698,0,2,4
1619,2,2,5698,5698,5700,0,2,0
1620,3,3,5701,5701,5704,0,3,1
1621,6,1,5707,5707,5708,0,1,3
1622,6,3,5713,5713,5716,0,3,5
1623,4,1,5717,5717,5718,0,1,1
1624,3,2,5720,5720,5722,0,2,2
1625,1,1,5721,5722,5723,1,2,0
1626,3,1,5724,5724,5725,0,1,1
1627,3,1,5727,5727,5728,0,1,2
1628,5,3,5732,5732,5735,0,3,4
1629,4,3,5736,5736,5739,0,3,1
1630,1,1,5737,5739,5740,2,3,0
1631,4,1,5741,5741,5742,0,1,1
1632,5,1,5746,5746,5747,0,1,4
1633,2,1,5748,5748,5749,0,1,1
1634,5,2,5753,5753,5755,0,2,4
1635,1,1,5754,5755,5756,1,2,0
1636,2,2,5756,5756,5758,0,2,0
1637,2,1,5758,5758,5759,0,1,0
1638,1,2,5759,5759,5761,0,2,0
1639,4,2,5763,5763,5765,0,2,2
1640,4,3,5767,5767,5770,0,3,2
1641,1,3,5768,5770,5773,2,5,0
1642,5,1,5773,5773,5774,0,1,0
1643,3,2,5776,5776,5778,0,2,2
1644,5,1,5781,5781,5782,0,1,3
1645,3,1,5784,5784,5785,0,1,2
1646,2,3,5786,5786,5789,0,3,1
1647,4,1,5790,5790,5791,0,1,1
1648,4,1,5794,5794,5795,0,1,3
1649,3,2,5797,5797,5799,0,2,2
1650,2,1,5799,5799,5800,0,1,0
1651,6,3,5805,5805,5808,0,3,5
1652,4,3,5809,5809,5812,0,3,1
1653,4,1,5813,5813,5814,0,1,1
1654,1,1,5814,5814,5815,0,1,0
1655,6,1,5820,5820,5821,0,1,5
1656,5,3,5825,5825,5828,0,3,4
1657,5,3,5830,5830,5833,0,3,2
1658,6,2,5836,5836,5838,0,2,3
1659,1,1,5837,5838,5839,1,2,0
1660,1,1,5838,5839,5840,1,2,0
1661,1,1,5839,5840,5841,1,2,0
1662,5,1,5844,5844,5845,0,1,3
1663,2,2,5846,5846,5848,0,2,1
1664,4,1,5850,5850,5851,0,1,2
1665,2,2,5852,5852,5854,0,2,1
1666,1,2,5853,5854,5856,1,3,0
1667,5,3,5858,5858,5861,0,3,2
1668,4,2,5862,5862,5864,0,2,1
1669,2,3,5864,5864,5867,0,3,0
1670,1,2,5865,5867,5869,2,4,0
1671,6,1,5871,5871,5872,0,1,2
1672,3,1,5874,5874,5875,0,1,2
1673,4,3,5878,5878,5881,0,3,3
1674,5,1,5883,5883,5884,0,1,2
1675,3,3,5886,5886,5889,0,3,2
1676,4,2,5890,5890,5892,0,2,1
1677,4,2,5894,5894,5896,0,2,2
1678,1,3,5895,5896,5899,1,4,0
1679,5,1,5900,5900,5901,0,1,1
1680,3,1,5903,5903,5904,0,1,2
1681,3,3,5906,5906,5909,0,3,2
1682,2,2,5908,5909,5911,1,3,0
1683,6,1,5914,5914,5915,0,1,3
1684,6,1,5920,5920,5921,0,1,5
1685,6,1,5926,5926,5927,0,1,5
1686,3,2,5929,5929,5931,0,2,2
1687,2,3,5931,5931,5934,0,3,0
1688,2,2,5933,5934,5936,1,3,0
1689,3,3,5936,5936,5939,0,3,0
1690,3,1,5939,5939,5940,0,1,0
1691,5,2,5944,5944,5946,0,2,4
1692,5,2,5949,5949,5951,0,2,3
1693,6,2,5955,5955,5957,0,2,4
1694,4,1,5959,5959,5960,0,1,2
1695,3,3,5962,5962,5965,0,3,2
1696,1,1,5963,5965,5966,2,3,0
1697,4,2,5967,5967,5969,0,2,1
1698,4,2,5971,5971,5973,0,2,2
1699,3,3,5974,5974,5977,0,3,1
1700,6,1,5980,5980,5981,0,1,3
1701,1,2,5981,5981,5983,0,2,0
1702,5,1,5986,5986,5987,0,1,3
1703,4,2,5990,5990,5992,0,2,3
1704,2,1,5992,5992,5993,0,1,0
1705,4,3,5996,5996,5999,0,3,3
1706,1,1,5997,5999,6000,2,3,0
1707,5,2,6002,6002,6004,0,2,2
1708,1,3,6003,6004,6007,1,4,0
1709,1,2,6004,6007,6009,3,5,0
1710,1,3,6005,6009,6012,4,7,0
1711,6,3,6011,6012,6015,1,4,0
1712,6,1,6017,6017,6018,0,1,2
1713,1,3,6018,6018,6021,0,3,0
1714,5,2,6023,6023,6025,0,2,2
1715,4,1,6027,6027,6028,0,1,2
1716,4,1,6031,6031,6032,0,1,3
1717,4,2,6035,6035,6037,0,2,3
1718,2,2,6037,6037,6039,0,2,0
1719,5,3,6042,6042,6045,0,3,3
1720,1,3,6043,6045,6048,2,5,0
1721,1,1,6044,6048,6049,4,5,0
1722,2,3,6046,6049,6052,3,6,0
1723,2,3,6048,6052,6055,4,7,0
1724,2,1,6050,6055,6056,5,6,0
1725,1,3,6051,6056,6059,5,8,0
1726,5,3,6056,6059,6062,3,6,0
1727,2,2,6058,6062,6064,4,6,0
1728,5,1,6063,6064,6065,1,2,0
1729,1,2,6064,6065,6067,1,3,0
1730,4,1,6068,6068,6069,0,1,1
1731,4,2,6072,6072,6074,0,2,3
1732,3,1,6075,6075,6076,0,1,1
1733,4,2,6079,6079,6081,0,2,3
1734,1,2,6080,6081,6083,1,3,0
1735,6,3,6086,6086,6089,0,3,3
1736,3,1,6089,6089,6090,0,1,0
1737,3,2,6092,6092,6094,0,2,2
1738,4,1,6096,6096,6097,0,1,2
1739,2,1,6098,6098,6099,0,1,1
1740,1,2,6099,6099,6101,0,2,0
1741,4,3,6103,6103,6106,0,3,2
1742,4,3,6107,6107,6110,0,3,1
1743,2,1,6109,6110,6111,1,2,0
1744,3,3,6112,6112,6115,0,3,1
1745,1,1,6113,6115,6116,2,3,0
1746,5,1,6118,6118,6119,0,1,2
1747,3,2,6121,6121,6123,0,2,2
1748,5,3,6126,6126,6129,0,3,3
1749,3,1,6129,6129,6130,0,1,0
1750,1,3,6130,6130,6133,0,3,0
1751,4,1,6134,6134,6135,0,1,1
1752,1,2,6135,6135,6137,0,2,0
1753,6,2,6141,6141,6143,0,2,4
1754,2,3,6143,6143,6146,0,3,0
1755,5,2,6148,6148,6150,0,2,2
1756,3,3,6151,6151,6154,0,3,1
1757,5,3,6156,6156,6159,0,3,2
1758,1,3,6157,6159,6162,2,5,0
1759,6,1,6163,6163,6164,0,1,1
1760,1,2,6164,6164,6166,0,2,0
1761,6,2,6170,6170,6172,0,2,4
1762,2,1,6172,6172,6173,0,1,0
1763,4,2,6176,6176,6178,0,2,3
1764,1,3,6177,6178,6181,1,4,0
1765,3,3,6180,6181,6184,1,4,0
1766,1,2,6181,6184,6186,3,5,0
1767,4,3,6185,6186,6189,1,4,0
1768,2,1,6187,6189,6190,2,3,0
1769,3,2,6190,6190,6192,0,2,0
1770,3,2,6193,6193,6195,0,2,1
1771,3,1,6196,6196,6197,0,1,1
1772,6,2,6202,6202,6204,0,2,5
1773,3,3,6205,6205,6208,0,3,1
1774,4,1,6209,6209,6210,0,1,1
1775,4,3,6213,6213,6216,0,3,3
1776,6,3,6219,6219,6222,0,3,3
1777,2,1,6221,6222,6223,1,2,0
1778,2,1,6223,6223,6224,0,1,0
1779,1,3,6224,6224,6227,0,3,0
1780,2,3,6226,6227,6230,1,4,0
1781,3,1,6229,6230,6231,1,2,0
1782,1,3,6230,6231,6234,1,4,0
1783,5,2,6235,6235,6237,0,2,1
1784,6,3,6241,6241,6244,0,3,4
1785,4,1,6245,6245,6246,0,1,1
1786,2,3,6247,6247,6250,0,3,1
1787,6,1,6253,6253,6254,0,1,3
1788,5,1,6258,6258,6259,0,1,4
1789,4,1,6262,6262,6263,0,1,3
1790,4,3,6266,6266,6269,0,3,3
1791,3,2,6269,6269,6271,0,2,0
1792,6,3,6275,6275,6278,0,3,4
1793,4,1,6279,6279,6280,0,1,1
1794,2,2,6281,6281,6283,0,2,1
1795,3,2,6284,6284,6286,0,2,1
1796,2,3,6286,6286,6289,0,3,0
1797,1,1,6287,6289,6290,2,3,0
1798,3,2,6290,6290,6292,0,2,0
1799,4,1,6294,6294,6295,0,1,2
1800,3,3,6297,6297,6300,0,3,2
1801,4,1,6301,6301,6302,0,1,1
1802,6,3,6307,6307,6310,0,3,5
1803,5,3,6312,6312,6315,0,3,2
1804,5,3,6317,6317,6320,0,3,2
1805,5,3,6322,6322,6325,0,3,2
1806,1,3,6323,6325,6328,2,5,0
1807,5,3,6328,6328,6331,0,3,0
1808,6,1,6334,6334,6335,0,1,3
1809,6,2,6340,6340,6342,0,2,5
1810,5,3,6345,6345,6348,0,3,3
1811,5,2,6350,6350,6352,0,2,2
1812,3,3,6353,6353,6356,0,3,1
1813,6,3,6359,6359,6362,0,3,3
1814,1,2,6360,6362,6364,2,4,0
1815,4,3,6364,6364,6367,0,3,0
1816,3,1,6367,6367,6368,0,1,0
1817,2,3,6369,6369,6372,0,3,1
1818,3,2,6372,6372,6374,0,2,0
1819,5,1,6377,6377,6378,0,1,3
1820,4,3,6381,6381,6384,0,3,3
1821,4,3,6385,6385,6388,0,3,1
1822,5,3,6390,6390,6393,0,3,2
1823,5,1,6395,6395,6396,0,1,2
1824,4,2,6399,6399,6401,0,2,3
1825,2,3,6401,6401,6404,0,3,0
1826,2,3,6403,6404,6407,1,4,0
1827,1,2,6404,6407,6409,3,5,0
1828,5,1,6409,6409,6410,0,1,0
1829,1,2,6410,6410,6412,0,2,0
1830,2,3,6412,6412,6415,0,3,0
1831,3,2,6415,6415,6417,0,2,0
1832,1,3,6416,6417,6420,1,4,0
1833,2,2,6418,6420,6422,2,4,0
1834,1,1,6419,6422,6423,3,4,0
1835,5,2,6424,6424,6426,0,2,1
1836,3,1,6427,6427,6428,0,1,1
1837,3,3,6430,6430,6433,0,3,2
1838,2,3,6432,6433,6436,1,4,0
1839,4,2,6436,6436,6438,0,2,0
1840,2,3,6438,6438,6441,0,3,0
1841,4,2,6442,6442,6444,0,2,1
1842,2,2,6444,6444,6446,0,2,0
1843,1,1,6445,6446,6447,1,2,0
1844,1,3,6446,6447,6450,1,4,0
1845,4,1,6450,6450,6451,0,1,0
1846,6,3,6456,6456,6459,0,3,5
1847,3,2,6459,6459,6461,0,2,0
1848,4,1,6463,6463,6464,0,1,2
1849,3,2,6466,6466,6468,0,2,2
1850,3,1,6469,6469,6470,0,1,1
1851,6,2,6475,6475,6477,0,2,5
1852,1,1,6476,6477,6478,1,2,0
1853,1,2,6477,6478,6480,1,3,0
1854,3,1,6480,6480,6481,0,1,0
1855,6,2,6486,6486,6488,0,2,5
1856,3,1,6489,6489,6490,0,1,1
1857,2,2,6491,6491,6493,0,2,1
1858,2,2,6493,6493,6495,0,2,0
1859,4,1,6497,6497,6498,0,1,2
1860,1,2,6498,6498,6500,0,2,0
1861,5,3,6503,6503,6506,0,3,3
1862,3,1,6506,6506,6507,0,1,0
1863,4,3,6510,6510,6513,0,3,3
1864,2,3,6512,6513,6516,1,4,0
1865,6,2,6518,6518,6520,0,2,2
1866,4,1,6522,6522,6523,0,1,2
1867,4,1,6526,6526,6527,0,1,3
1868,3,1,6529,6529,6530,0,1,2
1869,1,3,6530,6530,6533,0,3,0
1870,2,1,6532,6533,6534,1,2,0
1871,5,1,6537,6537,6538,0,1,3
1872,3,1,6540,6540,6541,0,1,2
1873,4,3,6544,6544,6547,0,3,3
1874,5,3,6549,6549,6552,0,3,2
1875,4,2,6553,6553,6555,0,2,1
1876,3,2,6556,6556,6558,0,2,1
1877,1,3,6557,6558,6561,1,4,0
1878,1,2,6558,6561,6563,3,5,0
1879,5,3,6563,6563,6566,0,3,0
1880,4,1,6567,6567,6568,0,1,1
1881,4,3,6571,6571,6574,0,3,3
1882,5,3,6576,6576,6579,0,3,2
1883,5,1,6581,6581,6582,0,1,2
1884,1,3,6582,6582,6585,0,3,0
1885,6,2,6588,6588,6590,0,2,3
1886,6,1,6594,6594,6595,0,1,4
1887,2,3,6596,6596,6599,0,3,1
1888,1,2,6597,6599,6601,2,4,0
1889,2,3,6599,6601,6604,2,5,0
1890,2,2,6601,6604,6606,3,5,0
1891,6,2,6607,6607,6609,0,2,1
1892,2,1,6609,6609,6610,0,1,0
1893,2,2,6611,6611,6613,0,2,1
1894,2,2,6613,6613,6615,0,2,0
1895,3,2,6616,6616,6618,0,2,1
1896,5,1,6621,6621,6622,0,1,3
1897,3,1,6624,6624,6625,0,1,2
1898,1,3,6625,6625,6628,0,3,0
1899,5,3,6630,6630,6633,0,3,2
1900,3,1,6633,6633,6634,0,1,0
1901,1,1,6634,6634,6635,0,1,0
1902,3,2,6637,6637,6639,0,2,2
1903,6,2,6643,6643,6645,0,2,4
1904,1,1,6644,6645,6646,1,2,0
1905,4,2,6648,6648,6650,0,2,2
1906,6,3,6654,6654,6657,0,3,4
1907,5,1,6659,6659,6660,0,1,2
1908,5,2,6664,6664,6666,0,2,4
1909,5,2,6669,6669,6671,0,2,3
1910,6,1,6675,6675,6676,0,1,4
1911,1,1,6676,6676,6677,0,1,0
1912,2,3,6678,6678,6681,0,3,1
1913,6,1,6684,6684,6685,0,1,3
1914,1,3,6685,6685,6688,0,3,0
1915,4,3,6689,6689,6692,0,3,1
1916,1,2,6690,6692,6694,2,4,0
1917,1,3,6691,6694,6697,3,6,0
1918,4,2,6695,6697,6699,2,4,0
1919,6,3,6701,6701,6704,0,3,2
1920,2,2,6703,6704,6706,1,3,0
1921,6,3,6709,6709,6712,0,3,3
1922,1,1,6710,6712,6713,2,3,0
1923,5,1,6715,6715,6716,0,1,2
1924,4,2,6719,6719,6721,0,2,3
1925,2,1,6721,6721,6722,0,1,0
1926,5,2,6726,6726,6728,0,2,4
1927,3,1,6729,6729,6730,0,1,1
1928,4,2,6733,6733,6735,0,2,3
1929,6,1,6739,6739,6740,0,1,4
1930,6,2,6745,6745,6747,0,2,5
1931,1,1,6746,6747,6748,1,2,0
1932,5,2,6751,6751,6753,0,2,3
1933,5,1,6756,6756,6757,0,1,3
1934,2,3,6758,6758,6761,0,3,1
1935,5,1,6763,6763,6764,0,1,2
1936,6,3,6769,6769,6772,0,3,5
1937,4,3,6773,6773,6776,0,3,1
1938,5,3,6778,6778,6781,0,3,2
1939,4,3,6782,6782,6785,0,3,1
1940,5,2,6787,6787,6789,0,2,2
1941,6,3,6793,6793,6796,0,3,4
1942,4,1,6797,6797,6798,0,1,1
1943,4,3,6801,6801,6804,0,3,3
1944,2,2,6803,6804,6806,1,3,0
1945,2,3,6805,6806,6809,1,4,0
1946,6,3,6811,6811,6814,0,3,2
1947,2,3,6813,6814,6817,1,4,0
1948,2,2,6815,6817,6819,2,4,0
1949,2,1,6817,6819,6820,2,3,0
1950,1,2,6818,6820,6822,2,4,0
1951,2,1,6820,6822,6823,2,3,0
1952,3,3,6823,6823,6826,0,3,0
1953,3,3,6826,6826,6829,0,3,0
1954,3,2,6829,6829,6831,0,2,0
1955,1,2,6830,6831,6833,1,3,0
1956,1,2,6831,6833,6835,2,4,0
1957,1,1,6832,6835,6836,3,4,0
1958,2,1,6834,6836,6837,2,3,0
1959,4,2,6838,6838,6840,0,2,1
1960,4,2,6842,6842,6844,0,2,2
1961,3,1,6845,6845,6846,0,1,1
1962,5,2,6850,6850,6852,0,2,4
1963,1,1,6851,6852,6853,1,2,0
1964,3,2,6854,6854,6856,0,2,1
1965,5,1,6859,6859,6860,0,1,3
1966,5,2,6864,6864,6866,0,2,4
1967,1,3,6865,6866,6869,1,4,0
1968,4,2,6869,6869,6871,0,2,0
1969,4,3,6873,6873,6876,0,3,2
1970,2,1,6875,6876,6877,1,2,0
1971,5,3,6880,6880,6883,0,3,3
1972,4,2,6884,6884,6886,0,2,1
1973,4,3,6888,6888,6891,0,3,2
1974,4,1,6892,6892,6893,0,1,1
1975,6,3,6898,6898,6901,0,3,5
1976,2,2,6900,6901,6903,1,3,0
1977,3,3,6903,6903,6906,0,3,0
1978,5,3,6908,6908,6911,0,3,2
1979,4,2,6912,6912,6914,0,2,1
1980,3,2,6915,6915,6917,0,2,1
1981,4,3,6919,6919,6922,0,3,2
1982,6,2,6925,6925,6927,0,2,3
1983,6,3,6931,6931,6934,0,3,4
1984,5,3,6936,6936,6939,0,3,2
1985,5,2,6941,6941,6943,0,2,2
1986,4,2,6945,6945,6947,0,2,2
1987,6,1,6951,6951,6952,0,1,4
1988,1,1,6952,6952,6953,0,1,0
1989,4,3,6956,6956,6959,0,3,3
1990,4,1,6960,6960,6961,0,1,1
1991,1,1,6961,6961,6962,0,1,0
1992,1,3,6962,6962,6965,0,3,0
1993,6,1,6968,6968,6969,0,1,3
1994,4,2,6972,6972,6974,0,2,3
1995,2,2,6974,6974,6976,0,2,0
1996,3,1,6977,6977,6978,0,1,1
1997,3,3,6980,6980,6983,0,3,2
1998,1,3,6981,6983,6986,2,5,0
1999,2,2,6983,6986,6988,3,5,0
2000,6,3,6989,6989,6992,0,3,1
2001,6,1,6995,6995,6996,0,1,3
2002,5,1,7000,7000,7001,0,1,4
2003,6,2,7006,7006,7008,0,2,5
2004,5,3,7011,7011,7014,0,3,3
2005,6,2,7017,7017,7019,0,2,3
2006,6,1,7023,7023,7024,0,1,4
2007,6,3,7029,7029,7032,0,3,5
2008,1,2,7030,7032,7034,2,4,0
2009,3,2,7033,7034,7036,1,3,0
2010,2,2,7035,7036,7038,1,3,0
2011,1,1,7036,7038,7039,2,3,0
2012,3,2,7039,7039,7041,0,2,0
2013,5,1,7044,7044,7045,0,1,3
2014,2,3,7046,7046,7049,0,3,1
2015,1,3,7047,7049,7052,2,5,0
2016,5,2,7052,7052,7054,0,2,0
2017,5,2,7057,7057,7059,0,2,3
2018,6,2,7063,7063,7065,0,2,4
2019,1,1,7064,7065,7066,1,2,0
2020,2,3,7066,7066,7069,0,3,0
2021,2,1,7068,7069,7070,1,2,0
2022,6,3,7074,7074,7077,0,3,4
2023,5,2,7079,7079,7081,0,2,2
2024,3,3,7082,7082,7085,0,3,1
2025,4,3,7086,7086,7089,0,3,1
2026,2,2,7088,7089,7091,1,3,0
2027,4,3,7092,7092,7095,0,3,1
2028,2,2,7094,7095,7097,1,3,0
2029,6,2,7100,7100,7102,0,2,3
2030,5,1,7105,7105,7106,0,1,3
2031,4,1,7109,7109,7110,0,1,3
2032,5,2,7114,7114,7116,0,2,4
2033,4,3,7118,7118,7121,0,3,2
2034,6,2,7124,7124,7126,0,2,3
2035,4,1,7128,7128,7129,0,1,2
2036,1,3,7129,7129,7132,0,3,0
2037,3,1,7132,7132,7133,0,1,0
2038,2,1,7134,7134,7135,0,1,1
2039,5,2,7139,7139,7141,0,2,4
2040,4,3,7143,7143,7146,0,3,2
2041,2,3,7145,7146,7149,1,4,0
2042,1,3,7146,7149,7152,3,6,0
2043,3,3,7149,7152,7155,3,6,0
2044,2,1,7151,7155,7156,4,5,0
2045,1,3,7152,7156,7159,4,7,0
2046,5,3,7157,7159,7162,2,5,0
2047,2,1,7159,7162,7163,3,4,0
2048,1,3,7160,7163,7166,3,6,0
2049,1,2,7161,7166,7168,5,7,0
2050,1,1,7162,7168,7169,6,7,0
2051,2,1,7164,7169,7170,5,6,0
2052,3,3,7167,7170,7173,3,6,0
2053,2,2,7169,7173,7175,4,6,0
2054,3,2,7172,7175,7177,3,5,0
2055,3,2,7175,7177,7179,2,4,0
2056,1,1,7176,7179,7180,3,4,0
2057,6,1,7182,7182,7183,0,1,2
2058,1,3,7183,7183,7186,0,3,0
2059,1,3,7184,7186,7189,2,5,0
2060,3,3,7187,7189,7192,2,5,0
2061,4,3,7191,7192,7195,1,4,0
2062,3,2,7194,7195,7197,1,3,0
2063,4,2,7198,7198,7200,0,2,1
2064,4,3,7202,7202,7205,0,3,2
2065,4,1,7206,7206,7207,0,1,1
2066,3,1,7209,7209,7210,0,1,2
2067,4,1,7213,7213,7214,0,1,3
2068,3,3,7216,7216,7219,0,3,2
2069,4,1,7220,7220,7221,0,1,1
2070,1,1,7221,7221,7222,0,1,0
2071,1,2,7222,7222,7224,0,2,0
2072,4,1,7226,7226,7227,0,1,2
2073,3,1,7229,7229,7230,0,1,2
2074,6,2,7235,7235,7237,0,2,5
2075,6,2,7241,7241,7243,0,2,4
2076,4,3,7245,7245,7248,0,3,2
2077,3,3,7248,7248,7251,0,3,0
2078,6,1,7254,7254,7255,0,1,3
2079,5,2,7259,7259,7261,0,2,4
2080,2,2,7261,7261,7263,0,2,0
2081,5,2,7266,7266,7268,0,2,3
2082,4,3,7270,7270,7273,0,3,2
2083,6,1,7276,7276,7277,0,1,3
2084,6,1,7282,7282,7283,0,1,5
2085,5,3,7287,7287,7290,0,3,4
2086,3,3,7290,7290,7293,0,3,0
2087,2,3,7292,7293,7296,1,4,0
2088,6,1,7298,7298,7299,0,1,2
2089,6,1,7304,7304,7305,0,1,5
2090,5,2,7309,7309,7311,0,2,4
2091,6,2,7315,7315,7317,0,2,4
2092,5,1,7320,7320,7321,0,1,3
2093,1,2,7321,7321,7323,0,2,0
2094,2,3,7323,7323,7326,0,3,0
2095,1,3,7324,7326,7329,2,5,0
2096,3,2,7327,7329,7331,2,4,0
2097,1,1,7328,7331,7332,3,4,0
2098,1,3,7329,7332,7335,3,6,0
2099,3,2,7332,7335,7337,3,5,0
2100,6,2,7338,7338,7340,0,2,1
2101,1,1,7339,7340,7341,1,2,0
2102,3,2,7342,7342,7344,0,2,1
2103,3,1,7345,7345,7346,0,1,1
2104,4,1,7349,7349,7350,0,1,3
2105,2,3,7351,7351,7354,0,3,1
2106,1,3,7352,7354,7357,2,5,0
2107,4,3,7356,7357,7360,1,4,0
2108,3,2,7359,7360,7362,1,3,0
2109,4,2,7363,7363,7365,0,2,1
2110,3,1,7366,7366,7367,0,1,1
2111,6,1,7372,7372,7373,0,1,5
2112,5,2,7377,7377,7379,0,2,4
2113,4,1,7381,7381,7382,0,1,2
2114,3,2,7384,7384,7386,0,2,2
2115,4,1,7388,7388,7389,0,1,2
2116,3,1,7391,7391,7392,0,1,2
2117,2,2,7393,7393,7395,0,2,1
2118,2,1,7395,7395,7396,0,1,0
2119,3,1,7398,7398,7399,0,1,2
2120,5,2,7403,7403,7405,0,2,4
2121,6,2,7409,7409,7411,0,2,4
2122,2,3,7411,7411,7414,0,3,0
2123,2,1,7413,7414,7415,1,2,0
2124,6,1,7419,7419,7420,0,1,4
2125,6,3,7425,7425,7428,0,3,5
2126,3,2,7428,7428,7430,0,2,0
2127,2,1,7430,7430,7431,0,1,0
2128,2,2,7432,7432,7434,0,2,1
2129,1,2,7433,7434,7436,1,3,0
2130,1,3,7434,7436,7439,2,5,0
2131,3,1,7437,7439,7440,2,3,0
2132,1,3,7438,7440,7443,2,5,0
2133,1,3,7439,7443,7446,4,7,0
2134,2,2,7441,7446,7448,5,7,0
2135,2,2,7443,7448,7450,5,7,0
2136,4,2,7447,7450,7452,3,5,0
2137,1,3,7448,7452,7455,4,7,0
2138,2,3,7450,7455,7458,5,8,0
2139,2,2,7452,7458,7460,6,8,0
2140,3,3,7455,7460,7463,5,8,0
2141,4,2,7459,7463,7465,4,6,0
2142,3,3,7462,7465,7468,3,6,0
2143,3,2,7465,7468,7470,3,5,0
2144,5,2,7470,7470,7472,0,2,0
2145,2,2,7472,7472,7474,0,2,0
2146,6,3,7478,7478,7481,0,3,4
2147,4,3,7482,7482,7485,0,3,1
2148,6,3,7488,7488,7491,0,3,3
2149,1,2,7489,7491,7493,2,4,0
2150,5,2,7494,7494,7496,0,2,1
2151,5,2,7499,7499,7501,0,2,3
2152,1,2,7500,7501,7503,1,3,0
2153,4,1,7504,7504,7505,0,1,1
2154,5,2,7509,7509,7511,0,2,4
2155,4,1,7513,7513,7514,0,1,2
2156,1,1,7514,7514,7515,0,1,0
2157,5,2,7519,7519,7521,0,2,4
2158,1,3,7520,7521,7524,1,4,0
2159,5,2,7525,7525,7527,0,2,1
2160,5,1,7530,7530,7531,0,1,3
2161,1,3,7531,7531,7534,0,3,0
2162,1,2,7532,7534,7536,2,4,0
2163,3,2,7535,7536,7538,1,3,0
2164,1,1,7536,7538,7539,2,3,0
2165,5,1,7541,7541,7542,0,1,2
2166,1,1,7542,7542,7543,0,1,0
2167,1,1,7543,7543,7544,0,1,0
2168,6,3,7549,7549,7552,0,3,5
2169,6,2,7555,7555,7557,0,2,3
2170,6,3,7561,7561,7564,0,3,4
2171,4,1,7565,7565,7566,0,1,1
2172,1,1,7566,7566,7567,0,1,0
2173,4,2,7570,7570,7572,0,2,3
2174,6,1,7576,7576,7577,0,1,4
2175,4,3,7580,7580,7583,0,3,3
2176,5,3,7585,7585,7588,0,3,2
2177,2,3,7587,7588,7591,1,4,0
2178,3,3,7590,7591,7594,1,4,0
2179,3,3,7593,7594,7597,1,4,0
2180,1,3,7594,7597,7600,3,6,0
2181,4,3,7598,7600,7603,2,5,0
2182,5,3,7603,7603,7606,0,3,0
2183,6,3,7609,7609,7612,0,3,3
2184,1,3,7610,7612,7615,2,5,0
2185,5,1,7615,7615,7616,0,1,0
2186,4,1,7619,7619,7620,0,1,3
2187,1,2,7620,7620,7622,0,2,0
2188,4,1,7624,7624,7625,0,1,2
2189,3,2,7627,7627,7629,0,2,2
2190,2,1,7629,7629,7630,0,1,0
2191,4,3,7633,7633,7636,0,3,3
2192,3,3,7636,7636,7639,0,3,0
2193,2,2,7638,7639,7641,1,3,0
2194,2,1,7640,7641,7642,1,2,0
2195,3,2,7643,7643,7645,0,2,1
2196,6,2,7649,7649,7651,0,2,4
2197,6,2,7655,7655,7657,0,2,4
2198,3,3,7658,7658,7661,0,3,1
2199,6,1,7664,7664,7665,0,1,3
2200,5,1,7669,7669,7670,0,1,4
2201,2,1,7671,7671,7672,0,1,1
2202,5,3,7676,7676,7679,0,3,4
2203,6,3,7682,7682,7685,0,3,3
2204,5,3,7687,7687,7690,0,3,2
2205,2,1,7689,7690,7691,1,2,0
2206,3,3,7692,7692,7695,0,3,1
2207,6,2,7698,7698,7700,0,2,3
2208,3,2,7701,7701,7703,0,2,1
2209,5,3,7706,7706,7709,0,3,3
2210,3,1,7709,7709,7710,0,1,0
2211,3,2,7712,7712,7714,0,2,2
2212,5,2,7717,7717,7719,0,2,3
2213,6,3,7723,7723,7726,0,3,4
2214,3,3,7726,7726,7729,0,3,0
2215,1,2,7727,7729,7731,2,4,0
2216,4,3,7731,7731,7734,0,3,0
2217,5,2,7736,7736,7738,0,2,2
2218,5,3,7741,7741,7744,0,3,3
2219,5,2,7746,7746,7748,0,2,2
2220,3,3,7749,7749,7752,0,3,1
2221,2,2,7751,7752,7754,1,3,0
2222,3,2,7754,7754,7756,0,2,0
2223,6,3,7760,7760,7763,0,3,4
2224,3,3,7763,7763,7766,0,3,0
2225,4,1,7767,7767,7768,0,1,1
2226,3,1,7770,7770,7771,0,1,2
2227,5,3,7775,7775,7778,0,3,4
2228,6,3,7781,7781,7784,0,3,3
2229,5,3,7786,7786,7789,0,3,2
2230,2,3,7788,7789,7792,1,4,0
2231,5,2,7793,7793,7795,0,2,1
2232,6,3,7799,7799,7802,0,3,4
2233,6,3,7805,7805,7808,0,3,3
2234,4,3,7809,7809,7812,0,3,1
2235,2,3,7811,7812,7815,1,4,0
2236,3,3,7814,7815,7818,1,4,0
2237,5,1,7819,7819,7820,0,1,1
2238,3,2,7822,7822,7824,0,2,2
2239,2,1,7824,7824,7825,0,1,0
2240,1,3,7825,7825,7828,0,3,0
2241,4,2,7829,7829,7831,0,2,1
2242,1,2,7830,7831,7833,1,3,0
2243,5,2,7835,7835,7837,0,2,2
2244,2,3,7837,7837,7840,0,3,0
2245,4,2,7841,7841,7843,0,2,1
2246,3,3,7844,7844,7847,0,3,1
2247,6,1,7850,7850,7851,0,1,3
2248,3,2,7853,7853,7855,0,2,2
2249,3,1,7856,7856,7857,0,1,1
2250,2,2,7858,7858,7860,0,2,1
2251,5,3,7863,7863,7866,0,3,3
2252,5,3,7868,7868,7871,0,3,2
2253,5,2,7873,7873,7875,0,2,2
2254,5,1,7878,7878,7879,0,1,3
2255,5,1,7883,7883,7884,0,1,4
2256,3,2,7886,7886,7888,0,2,2
2257,2,1,7888,7888,7889,0,1,0
2258,6,1,7894,7894,7895,0,1,5
2259,4,2,7898,7898,7900,0,2,3
2260,5,1,7903,7903,7904,0,1,3
2261,2,3,7905,7905,7908,0,3,1
2262,6,2,7911,7911,7913,0,2,3
2263,4,1,7915,7915,7916,0,1,2
2264,4,2,7919,7919,7921,0,2,3
2265,3,3,7922,7922,7925,0,3,1
2266,3,3,7925,7925,7928,0,3,0
2267,5,3,7930,7930,7933,0,3,2
2268,5,2,7935,7935,7937,0,2,2
2269,1,3,7936,7937,7940,1,4,0
2270,5,1,7941,7941,7942,0,1,1
2271,4,3,7945,7945,7948,0,3,3
2272,3,1,7948,7948,7949,0,1,0
2273,5,1,7953,7953,7954,0,1,4
2274,2,3,7955,7955,7958,0,3,1
2275,6,2,7961,7961,7963,0,2,3
2276,4,2,7965,7965,7967,0,2,2
2277,2,3,7967,7967,7970,0,3,0
2278,5,2,7972,7972,7974,0,2,2
2279,6,2,7978,7978,7980,0,2,4
2280,5,2,7983,7983,7985,0,2,3
2281,3,1,7986,7986,7987,0,1,1
2282,2,3,7988,7988,7991,0,3,1
2283,4,2,7992,7992,7994,0,2,1
2284,2,1,7994,7994,7995,0,1,0
2285,6,3,8000,8000,8003,0,3,5
2286,3,2,8003,8003,8005,0,2,0
2287,6,1,8009,8009,8010,0,1,4
2288,5,3,8014,8014,8017,0,3,4
2289,5,3,8019,8019,8022,0,3,2
2290,3,3,8022,8022,8025,0,3,0
2291,4,3,8026,8026,8029,0,3,1
2292,5,1,8031,8031,8032,0,1,2
2293,5,2,8036,8036,8038,0,2,4
2294,2,1,8038,8038,8039,0,1,0
2295,6,1,8044,8044,8045,0,1,5
2296,5,2,8049,8049,8051,0,2,4
2297,6,2,8055,8055,8057,0,2,4
2298,2,3,8057,8057,8060,0,3,0
2299,2,1,8059,8060,8061,1,2,0
2300,6,1,8065,8065,8066,0,1,4
2301,1,1,8066,8066,8067,0,1,0
2302,1,2,8067,8067,8069,0,2,0
2303,5,2,8072,8072,8074,0,2,3
2304,1,2,8073,8074,8076,1,3,0
2305,1,1,8074,8076,8077,2,3,0
2306,5,3,8079,8079,8082,0,3,2
2307,6,3,8085,8085,8088,0,3,3
2308,1,1,8086,8088,8089,2,3,0
2309,5,3,8091,8091,8094,0,3,2
2310,5,3,8096,8096,8099,0,3,2
2311,2,3,8098,8099,8102,1,4,0
2312,1,2,8099,8102,8104,3,5,0
2313,3,3,8102,8104,8107,2,5,0
2314,5,1,8107,8107,8108,0,1,0
2315,5,2,8112,8112,8114,0,2,4
2316,6,3,8118,8118,8121,0,3,4
2317,1,3,8119,8121,8124,2,5,0
2318,1,1,8120,8124,8125,4,5,0
2319,3,1,8123,8125,8126,2,3,0
2320,5,2,8128,8128,8130,0,2,2
2321,5,1,8133,8133,8134,0,1,3
2322,1,3,8134,8134,8137,0,3,0
2323,4,2,8138,8138,8140,0,2,1
2324,4,3,8142,8142,8145,0,3,2
2325,5,1,8147,8147,8148,0,1,2
2326,1,3,8148,8148,8151,0,3,0
2327,4,3,8152,8152,8155,0,3,1
2328,3,3,8155,8155,8158,0,3,0
2329,3,3,8158,8158,8161,0,3,0
2330,4,3,8162,8162,8165,0,3,1
2331,2,3,8164,8165,8168,1,4,0
2332,4,2,8168,8168,8170,0,2,0
2333,4,1,8172,8172,8173,0,1,2
2334,2,2,8174,8174,8176,0,2,1
2335,6,2,8180,8180,8182,0,2,4
2336,1,3,8181,8182,8185,1,4,0
2337,3,3,8184,8185,8188,1,4,0
2338,6,1,8190,8190,8191,0,1,2
2339,4,3,8194,8194,8197,0,3,3
2340,6,3,8200,8200,8203,0,3,3
2341,4,3,8204,8204,8207,0,3,1
2342,3,2,8207,8207,8209,0,2,0
2343,4,2,8211,8211,8213,0,2,2
2344,2,3,8213,8213,8216,0,3,0
2345,5,1,8218,8218,8219,0,1,2
2346,1,1,8219,8219,8220,0,1,0
2347,2,1,8221,8221,8222,0,1,1
2348,1,1,8222,8222,8223,0,1,0
2349,3,3,8225,8225,8228,0,3,2
2350,6,2,8231,8231,8233,0,2,3
2351,1,1,8232,8233,8234,1,2,0
2352,6,1,8238,8238,8239,0,1,4
2353,4,3,8242,8242,8245,0,3,3
2354,6,3,8248,8248,8251,0,3,3
2355,2,2,8250,8251,8253,1,3,0
2356,3,2,8253,8253,8255,0,2,0
2357,6,2,8259,8259,8261,0,2,4
2358,2,1,8261,8261,8262,0,1,0
2359,3,3,8264,8264,8267,0,3,2
2360,2,3,8266,8267,8270,1,4,0
2361,2,2,8268,8270,8272,2,4,0
2362,6,2,8274,8274,8276,0,2,2
2363,4,3,8278,8278,8281,0,3,2
2364,3,2,8281,8281,8283,0,2,0
2365,4,1,8285,8285,8286,0,1,2
2366,5,3,8290,8290,8293,0,3,4
2367,3,2,8293,8293,8295,0,2,0
2368,5,2,8298,8298,8300,0,2,3
2369,3,2,8301,8301,8303,0,2,1
2370,3,1,8304,8304,8305,0,1,1
2371,4,2,8308,8308,8310,0,2,3
2372,6,1,8314,8314,8315,0,1,4
2373,5,2,8319,8319,8321,0,2,4
2374,3,2,8322,8322,8324,0,2,1
2375,3,2,8325,8325,8327,0,2,1
2376,3,1,8328,8328,8329,0,1,1
2377,6,1,8334,8334,8335,0,1,5
2378,5,2,8339,8339,8341,0,2,4
2379,6,2,8345,8345,8347,0,2,4
2380,5,1,8350,8350,8351,0,1,3
2381,1,2,8351,8351,8353,0,2,0
2382,6,1,8357,8357,8358,0,1,4
2383,3,1,8360,8360,8361,0,1,2
2384,5,2,8365,8365,8367,0,2,4
2385,1,1,8366,8367,8368,1,2,0
2386,1,1,8367,8368,8369,1,2,0
2387,3,3,8370,8370,8373,0,3,1
2388,6,3,8376,8376,8379,0,3,3
2389,2,2,8378,8379,8381,1,3,0
2390,2,3,8380,8381,8384,1,4,0
2391,2,2,8382,8384,8386,2,4,0
2392,1,3,8383,8386,8389,3,6,0
2393,3,1,8386,8389,8390,3,4,0
2394,4,1,8390,8390,8391,0,1,0
2395,1,1,8391,8391,8392,0,1,0
2396,6,3,8397,8397,8400,0,3,5
2397,4,1,8401,8401,8402,0,1,1
2398,1,1,8402,8402,8403,0,1,0
2399,1,3,8403,8403,8406,0,3,0
2400,3,2,8406,8406,8408,0,2,0
2401,5,2,8411,8411,8413,0,2,3
2402,3,2,8414,8414,8416,0,2,1
2403,3,3,8417,8417,8420,0,3,1
2404,5,2,8422,8422,8424,0,2,2
2405,6,1,8428,8428,8429,0,1,4
2406,2,3,8430,8430,8433,0,3,1
2407,4,3,8434,8434,8437,0,3,1
2408,2,3,8436,8437,8440,1,4,0
2409,5,3,8441,8441,8444,0,3,1
2410,3,2,8444,8444,8446,0,2,0
2411,6,3,8450,8450,8453,0,3,4
2412,6,2,8456,8456,8458,0,2,3
2413,6,1,8462,8462,8463,0,1,4
2414,1,3,8463,8463,8466,0,3,0
2415,4,1,8467,8467,8468,0,1,1
2416,3,1,8470,8470,8471,0,1,2
2417,2,3,8472,8472,8475,0,3,1
2418,5,1,8477,8477,8478,0,1,2
2419,5,2,8482,8482,8484,0,2,4
2420,4,2,8486,8486,8488,0,2,2
2421,2,2,8488,8488,8490,0,2,0
2422,4,1,8492,8492,8493,0,1,2
2423,2,2,8494,8494,8496,0,2,1
2424,5,2,8499,8499,8501,0,2,3
2425,1,3,8500,8501,8504,1,4,0
2426,1,2,8501,8504,8506,3,5,0
2427,1,1,8502,8506,8507,4,5,0
2428,4,2,8506,8507,8509,1,3,0
2429,3,1,8509,8509,8510,0,1,0
2430,2,2,8511,8511,8513,0,2,1
2431,1,2,8512,8513,8515,1,3,0
2432,1,3,8513,8515,8518,2,5,0
2433,3,3,8516,8518,8521,2,5,0
2434,1,3,8517,8521,8524,4,7,0
2435,3,3,8520,8524,8527,4,7,0
2436,3,2,8523,8527,8529,4,6,0
2437,2,3,8525,8529,8532,4,7,0
2438,3,3,8528,8532,8535,4,7,0
2439,4,1,8532,8535,8536,3,4,0
2440,4,2,8536,8536,8538,0,2,0
2441,3,1,8539,8539,8540,0,1,1
2442,6,1,8545,8545,8546,0,1,5
2443,5,2,8550,8550,8552,0,2,4
2444,4,3,8554,8554,8557,0,3,2
2445,4,2,8558,8558,8560,0,2,1
2446,1,1,8559,8560,8561,1,2,0
2447,4,3,8563,8563,8566,0,3,2
2448,2,2,8565,8566,8568,1,3,0
2449,5,2,8570,8570,8572,0,2,2
2450,2,1,8572,8572,8573,0,1,0
2451,1,1,8573,8573,8574,0,1,0
2452,4,2,8577,8577,8579,0,2,3
2453,6,3,8583,8583,8586,0,3,4
2454,5,2,8588,8588,8590,0,2,2
2455,3,3,8591,8591,8594,0,3,1
2456,6,1,8597,8597,8598,0,1,3
2457,4,2,8601,8601,8603,0,2,3
2458,4,2,8605,8605,8607,0,2,2
2459,2,3,8607,8607,8610,0,3,0
2460,1,3,8608,8610,8613,2,5,0
2461,6,2,8614,8614,8616,0,2,1
2462,5,2,8619,8619,8621,0,2,3
2463,6,1,8625,8625,8626,0,1,4
2464,6,1,8631,8631,8632,0,1,5
2465,2,3,8633,8633,8636,0,3,1
2466,5,1,8638,8638,8639,0,1,2
2467,6,3,8644,8644,8647,0,3,5
2468,1,3,8645,8647,8650,2,5,0
2469,4,2,8649,8650,8652,1,3,0
2470,2,3,8651,8652,8655,1,4,0
2471,5,3,8656,8656,8659,0,3,1
2472,2,1,8658,8659,8660,1,2,0
2473,3,2,8661,8661,8663,0,2,1
2474,6,2,8667,8667,8669,0,2,4
2475,2,1,8669,8669,8670,0,1,0
2476,4,3,8673,8673,8676,0,3,3
2477,1,1,8674,8676,8677,2,3,0
2478,4,2,8678,8678,8680,0,2,1
2479,4,3,8682,8682,8685,0,3,2
2480,5,3,8687,8687,8690,0,3,2
2481,2,3,8689,8690,8693,1,4,0
2482,4,2,8693,8693,8695,0,2,0
2483,1,3,8694,8695,8698,1,4,0
2484,2,3,8696,8698,8701,2,5,0
2485,5,3,8701,8701,8704,0,3,0
2486,1,2,8702,8704,8706,2,4,0
2487,4,3,8706,8706,8709,0,3,0
2488,5,1,8711,8711,8712,0,1,2
2489,3,1,8714,8714,8715,0,1,2
2490,2,3,8716,8716,8719,0,3,1
2491,5,3,8721,8721,8724,0,3,2
2492,1,2,8722,8724,8726,2,4,0
2493,1,1,8723,8726,8727,3,4,0
2494,5,2,8728,8728,8730,0,2,1
2495,2,1,8730,8730,8731,0,1,0
2496,1,2,8731,8731,8733,0,2,0
2497,5,3,8736,8736,8739,0,3,3
2498,5,1,8741,8741,8742,0,1,2
2499,3,2,8744,8744,8746,0,2,2
2500,5,2,8749,8749,8751,0,2,3
2501,2,3,8751,8751,8754,0,3,0
2502,2,2,8753,8754,8756,1,3,0
2503,6,1,8759,8759,8760,0,1,3
2504,6,3,8765,8765,8768,0,3,5
2505,2,1,8767,8768,8769,1,2,0
2506,4,2,8771,8771,8773,0,2,2
2507,1,2,8772,8773,8775,1,3,0
2508,6,3,8778,8778,8781,0,3,3
2509,1,3,8779,8781,8784,2,5,0
2510,6,3,8785,8785,8788,0,3,1
2511,3,3,8788,8788,8791,0,3,0
2512,4,2,8792,8792,8794,0,2,1
2513,5,1,8797,8797,8798,0,1,3
2514,4,3,8801,8801,8804,0,3,3
2515,6,3,8807,8807,8810,0,3,3
2516,1,2,8808,8810,8812,2,4,0
2517,4,1,8812,8812,8813,0,1,0
2518,2,3,8814,8814,8817,0,3,1
2519,5,2,8819,8819,8821,0,2,2
2520,2,1,8821,8821,8822,0,1,0
2521,3,3,8824,8824,8827,0,3,2
2522,3,2,8827,8827,8829,0,2,0
2523,6,2,8833,8833,8835,0,2,4
2524,3,3,8836,8836,8839,0,3,1
2525,3,3,8839,8839,8842,0,3,0
2526,2,2,8841,8842,8844,1,3,0
2527,6,3,8847,8847,8850,0,3,3
2528,5,3,8852,8852,8855,0,3,2
2529,2,1,8854,8855,8856,1,2,0
2530,4,2,8858,8858,8860,0,2,2
2531,3,1,8861,8861,8862,0,1,1
2532,2,3,8863,8863,8866,0,3,1
2533,4,1,8867,8867,8868,0,1,1
2534,6,1,8873,8873,8874,0,1,5
2535,5,1,8878,8878,8879,0,1,4
2536,5,1,8883,8883,8884,0,1,4
2537,2,2,8885,8885,8887,0,2,1
2538,5,3,8890,8890,8893,0,3,3
2539,4,3,8894,8894,8897,0,3,1
2540,1,2,8895,8897,8899,2,4,0
2541,4,3,8899,8899,8902,0,3,0
2542,5,3,8904,8904,8907,0,3,2
2543,3,2,8907,8907,8909,0,2,0
2544,4,3,8911,8911,8914,0,3,2
2545,3,3,8914,8914,8917,0,3,0
2546,4,2,8918,8918,8920,0,2,1
2547,5,2,8923,8923,8925,0,2,3
2548,5,1,8928,8928,8929,0,1,3
2549,1,3,8929,8929,8932,0,3,0
2550,1,1,8930,8932,8933,2,3,0
2551,2,1,8932,8933,8934,1,2,0
2552,2,2,8934,8934,8936,0,2,0
2553,6,3,8940,8940,8943,0,3,4
2554,4,2,8944,8944,8946,0,2,1
2555,4,2,8948,8948,8950,0,2,2
2556,3,3,8951,8951,8954,0,3,1
2557,3,1,8954,8954,8955,0,1,0
2558,6,2,8960,8960,8962,0,2,5
2559,5,3,8965,8965,8968,0,3,3
2560,1,2,8966,8968,8970,2,4,0
2561,6,1,8972,8972,8973,0,1,2
2562,4,3,8976,8976,8979,0,3,3
2563,3,1,8979,8979,8980,0,1,0
2564,6,1,8985,8985,8986,0,1,5
2565,5,3,8990,8990,8993,0,3,4
2566,3,3,8993,8993,8996,0,3,0
2567,2,1,8995,8996,8997,1,2,0
2568,1,2,8996,8997,8999,1,3,0
2569,3,3,8999,8999,9002,0,3,0
2570,4,3,9003,9003,9006,0,3,1
2571,2,1,9005,9006,9007,1,2,0
2572,6,2,9011,9011,9013,0,2,4
2573,1,3,9012,9013,9016,1,4,0
2574,2,1,9014,9016,9017,2,3,0
2575,5,2,9019,9019,9021,0,2,2
2576,3,1,9022,9022,9023,0,1,1
2577,4,2,9026,9026,9028,0,2,3
2578,3,1,9029,9029,9030,0,1,1
2579,4,3,9033,9033,9036,0,3,3
2580,1,1,9034,9036,9037,2,3,0
2581,6,1,9040,9040,9041,0,1,3
2582,4,3,9044,9044,9047,0,3,3
2583,1,2,9045,9047,9049,2,4,0
2584,1,1,9046,9049,9050,3,4,0
2585,6,1,9052,9052,9053,0,1,2
2586,1,2,9053,9053,9055,0,2,0
2587,1,3,9054,9055,9058,1,4,0
2588,2,3,9056,9058,9061,2,5,0
2589,6,3,9062,9062,9065,0,3,1
2590,5,2,9067,9067,9069,0,2,2
2591,5,2,9072,9072,9074,0,2,3
2592,6,1,9078,9078,9079,0,1,4
2593,5,3,9083,9083,9086,0,3,4
2594,1,3,9084,9086,9089,2,5,0
2595,4,1,9088,9089,9090,1,2,0
2596,4,3,9092,9092,9095,0,3,2
2597,6,1,9098,9098,9099,0,1,3
2598,4,1,9102,9102,9103,0,1,3
2599,2,3,9104,9104,9107,0,3,1
2600,4,2,9108,9108,9110,0,2,1
2601,1,2,9109,9110,9112,1,3,0
2602,6,3,9115,9115,9118,0,3,3
2603,1,3,9116,9118,9121,2,5,0
2604,5,1,9121,9121,9122,0,1,0
2605,3,1,9124,9124,9125,0,1,2
2606,6,2,9130,9130,9132,0,2,5
2607,6,3,9136,9136,9139,0,3,4
2608,4,2,9140,9140,9142,0,2,1
2609,4,1,9144,9144,9145,0,1,2
2610,1,3,9145,9145,9148,0,3,0
2611,2,2,9147,9148,9150,1,3,0
2612,5,3,9152,9152,9155,0,3,2
2613,3,1,9155,9155,9156,0,1,0
2614,5,3,9160,9160,9163,0,3,4
2615,6,2,9166,9166,9168,0,2,3
2616,5,2,9171,9171,9173,0,2,3
2617,2,1,9173,9173,9174,0,1,0
2618,4,1,9177,9177,9178,0,1,3
2619,3,1,9180,9180,9181,0,1,2
2620,6,2,9186,9186,9188,0,2,5
2621,4,2,9190,9190,9192,0,2,2
2622,5,1,9195,9195,9196,0,1,3
2623,5,1,9200,9200,9201,0,1,4
2624,3,3,9203,9203,9206,0,3,2
2625,1,2,9204,9206,9208,2,4,0
2626,5,1,9209,9209,9210,0,1,1
2627,2,3,9211,9211,9214,0,3,1
2628,2,1,9213,9214,9215,1,2,0
2629,3,2,9216,9216,9218,0,2,1
2630,4,1,9220,9220,9221,0,1,2
2631,6,3,9226,9226,9229,0,3,5
2632,1,1,9227,9229,9230,2,3,0
2633,4,1,9231,9231,9232,0,1,1
2634,1,3,9232,9232,9235,0,3,0
2635,6,2,9238,9238,9240,0,2,3
2636,2,1,9240,9240,9241,0,1,0
2637,3,3,9243,9243,9246,0,3,2
2638,4,2,9247,9247,9249,0,2,1
2639,4,1,9251,9251,9252,0,1,2
2640,3,2,9254,9254,9256,0,2,2
2641,1,3,9255,9256,9259,1,4,0
2642,5,3,9260,9260,9263,0,3,1
2643,6,3,9266,9266,9269,0,3,3
2644,2,2,9268,9269,9271,1,3,0
2645,3,3,9271,9271,9274,0,3,0
2646,3,1,9274,9274,9275,0,1,0
2647,3,1,9277,9277,9278,0,1,2
2648,5,2,9282,9282,9284,0,2,4
2649,6,3,9288,9288,9291,0,3,4
2650,2,2,9290,9291,9293,1,3,0
2651,5,2,9295,9295,9297,0,2,2
2652,1,1,9296,9297,9298,1,2,0
2653,6,1,9302,9302,9303,0,1,4
2654,6,3,9308,9308,9311,0,3,5
2655,6,1,9314,9314,9315,0,1,3
2656,2,2,9316,9316,9318,0,2,1
2657,5,1,9321,9321,9322,0,1,3
2658,5,1,9326,9326,9327,0,1,4
2659,2,2,9328,9328,9330,0,2,1
2660,1,2,9329,9330,9332,1,3,0
2661,5,1,9334,9334,9335,0,1,2
2662,1,2,9335,9335,9337,0,2,0
2663,3,2,9338,9338,9340,0,2,1
2664,1,2,9339,9340,9342,1,3,0
2665,5,3,9344,9344,9347,0,3,2
2666,1,2,9345,9347,9349,2,4,0
2667,6,2,9351,9351,9353,0,2,2
2668,2,3,9353,9353,9356,0,3,0
2669,4,3,9357,9357,9360,0,3,1
2670,6,2,9363,9363,9365,0,2,3
2671,2,1,9365,9365,9366,0,1,0
2672,4,2,9369,9369,9371,0,2,3
2673,5,3,9374,9374,9377,0,3,3
2674,3,3,9377,9377,9380,0,3,0
2675,5,2,9382,9382,9384,0,2,2
2676,3,3,9385,9385,9388,0,3,1
2677,2,2,9387,9388,9390,1,3,0
2678,2,2,9389,9390,9392,1,3,0
2679,1,2,9390,9392,9394,2,4,0
2680,3,1,9393,9394,9395,1,2,0
2681,5,2,9398,9398,9400,0,2,3
2682,1,1,9399,9400,9401,1,2,0
2683,5,1,9404,9404,9405,0,1,3
2684,6,1,9410,9410,9411,0,1,5
2685,1,1,9411,9411,9412,0,1,0
2686,2,2,9413,9413,9415,0,2,1
2687,5,1,9418,9418,9419,0,1,3
2688,3,3,9421,9421,9424,0,3,2
2689,5,1,9426,9426,9427,0,1,2
2690,5,3,9431,9431,9434,0,3,4
2691,2,3,9433,9434,9437,1,4,0
2692,1,1,9434,9437,9438,3,4,0
2693,3,3,9437,9438,9441,1,4,0
2694,6,3,9443,9443,9446,0,3,2
2695,1,3,9444,9446,9449,2,5,0
2696,6,1,9450,9450,9451,0,1,1
2697,5,2,9455,9455,9457,0,2,4
2698,4,2,9459,9459,9461,0,2,2
2699,1,1,9460,9461,9462,1,2,0
2700,2,3,9462,9462,9465,0,3,0
2701,2,2,9464,9465,9467,1,3,0
2702,4,1,9468,9468,9469,0,1,1
2703,3,3,9471,9471,9474,0,3,2
2704,4,1,9475,9475,9476,0,1,1
2705,3,1,9478,9478,9479,0,1,2
2706,4,2,9482,9482,9484,0,2,3
2707,3,1,9485,9485,9486,0,1,1
2708,3,1,9488,9488,9489,0,1,2
2709,1,3,9489,9489,9492,0,3,0
2710,6,2,9495,9495,9497,0,2,3
2711,6,3,9501,9501,9504,0,3,4
2712,3,3,9504,9504,9507,0,3,0
2713,2,2,9506,9507,9509,1,3,0
2714,5,2,9511,9511,9513,0,2,2
2715,2,2,9513,9513,9515,0,2,0
2716,2,2,9515,9515,9517,0,2,0
2717,5,3,9520,9520,9523,0,3,3
2718,3,2,9523,9523,9525,0,2,0
2719,5,3,9528,9528,9531,0,3,3
2720,6,1,9534,9534,9535,0,1,3
2721,4,3,9538,9538,9541,0,3,3
2722,1,3,9539,9541,9544,2,5,0
2723,1,1,9540,9544,9545,4,5,0
2724,6,1,9546,9546,9547,0,1,1
2725,2,2,9548,9548,9550,0,2,1
2726,3,2,9551,9551,9553,0,2,1
2727,4,2,9555,9555,9557,0,2,2
2728,2,2,9557,9557,9559,0,2,0
2729,6,1,9563,9563,9564,0,1,4
2730,3,1,9566,9566,9567,0,1,2
2731,2,1,9568,9568,9569,0,1,1
2732,1,2,9569,9569,9571,0,2,0
2733,4,3,9573,9573,9576,0,3,2
2734,5,2,9578,9578,9580,0,2,2
2735,5,3,9583,9583,9586,0,3,3
2736,3,2,9586,9586,9588,0,2,0
2737,3,3,9589,9589,9592,0,3,1
2738,6,1,9595,9595,9596,0,1,3
2739,4,2,9599,9599,9601,0,2,3
2740,4,1,9603,9603,9604,0,1,2
2741,2,3,9605,9605,9608,0,3,1
2742,4,2,9609,9609,9611,0,2,1
2743,3,1,9612,9612,9613,0,1,1
2744,5,1,9617,9617,9618,0,1,4
2745,3,1,9620,9620,9621,0,1,2
2746,4,3,9624,9624,9627,0,3,3
2747,2,2,9626,9627,9629,1,3,0
2748,2,1,9628,9629,9630,1,2,0
2749,3,1,9631,9631,9632,0,1,1
2750,4,1,9635,9635,9636,0,1,3
2751,6,1,9641,9641,9642,0,1,5
2752,6,3,9647,9647,9650,0,3,5
2753,3,1,9650,9650,9651,0,1,0
2754,4,3,9654,9654,9657,0,3,3
2755,1,1,9655,9657,9658,2,3,0
2756,6,2,9661,9661,9663,0,2,3
2757,3,3,9664,9664,9667,0,3,1
2758,1,3,9665,9667,9670,2,5,0
2759,6,1,9671,9671,9672,0,1,1
2760,6,1,9677,9677,9678,0,1,5
2761,4,2,9681,9681,9683,0,2,3
2762,4,3,9685,9685,9688,0,3,2
2763,2,3,9687,9688,9691,1,4,0
2764,6,1,9693,9693,9694,0,1,2
2765,4,3,9697,9697,9700,0,3,3
2766,6,1,9703,9703,9704,0,1,3
2767,3,1,9706,9706,9707,0,1,2
2768,5,3,9711,9711,9714,0,3,4
2769,5,3,9716,9716,9719,0,3,2
2770,1,2,9717,9719,9721,2,4,0
2771,3,2,9720,9721,9723,1,3,0
2772,6,3,9726,9726,9729,0,3,3
2773,2,2,9728,9729,9731,1,3,0
2774,4,1,9732,9732,9733,0,1,1
2775,5,1,9737,9737,9738,0,1,4
2776,1,3,9738,9738,9741,0,3,0
2777,6,1,9744,9744,9745,0,1,3
2778,1,3,9745,9745,9748,0,3,0
2779,4,1,9749,9749,9750,0,1,1
2780,4,2,9753,9753,9755,0,2,3
2781,3,1,9756,9756,9757,0,1,1
2782,6,3,9762,9762,9765,0,3,5
2783,2,1,9764,9765,9766,1,2,0
2784,4,1,9768,9768,9769,0,1,2
2785,6,2,9774,9774,9776,0,2,5
2786,2,1,9776,9776,9777,0,1,0
2787,2,1,9778,9778,9779,0,1,1
2788,1,2,9779,9779,9781,0,2,0
2789,2,2,9781,9781,9783,0,2,0
2790,1,1,9782,9783,9784,1,2,0
2791,1,1,9783,9784,9785,1,2,0
2792,4,1,9787,9787,9788,0,1,2
2793,3,1,9790,9790,9791,0,1,2
2794,5,1,9795,9795,9796,0,1,4
2795,5,3,9800,9800,9803,0,3,4
2796,2,1,9802,9803,9804,1,2,0
2797,3,3,9805,9805,9808,0,3,1
2798,4,2,9809,9809,9811,0,2,1
2799,6,1,9815,9815,9816,0,1,4
2800,3,1,9818,9818,9819,0,1,2
2801,1,2,9819,9819,9821,0,2,0
2802,3,1,9822,9822,9823,0,1,1
2803,3,1,9825,9825,9826,0,1,2
2804,1,3,9826,9826,9829,0,3,0
2805,1,1,9827,9829,9830,2,3,0
2806,3,2,9830,9830,9832,0,2,0
2807,5,2,9835,9835,9837,0,2,3
2808,4,1,9839,9839,9840,0,1,2
2809,1,3,9840,9840,9843,0,3,0
2810,4,1,9844,9844,9845,0,1,1
2811,2,2,9846,9846,9848,0,2,1
2812,2,2,9848,9848,9850,0,2,0
2813,3,2,9851,9851,9853,0,2,1
2814,5,3,9856,9856,9859,0,3,3
2815,3,2,9859,9859,9861,0,2,0
2816,2,2,9861,9861,9863,0,2,0
2817,1,1,9862,9863,9864,1,2,0
2818,4,1,9866,9866,9867,0,1,2
2819,1,2,9867,9867,9869,0,2,0
2820,1,1,9868,9869,9870,1,2,0
2821,2,1,9870,9870,9871,0,1,0
2822,3,3,9873,9873,9876,0,3,2
2823,3,2,9876,9876,9878,0,2,0
2824,5,2,9881,9881,9883,0,2,3
2825,3,2,9884,9884,9886,0,2,1
2826,3,2,9887,9887,9889,0,2,1
2827,4,2,9891,9891,9893,0,2,2
2828,4,2,9895,9895,9897,0,2,2
2829,6,1,9901,9901,9902,0,1,4
2830,4,3,9905,9905,9908,0,3,3
2831,2,1,9907,9908,9909,1,2,0
2832,6,3,9913,9913,9916,0,3,4
2833,4,1,9917,9917,9918,0,1,1
2834,4,2,9921,9921,9923,0,2,3
2835,2,3,9923,9923,9926,0,3,0
2836,3,3,9926,9926,9929,0,3,0
2837,3,1,9929,9929,9930,0,1,0
2838,5,1,9934,9934,9935,0,1,4
2839,3,1,9937,9937,9938,0,1,2
2840,4,2,9941,9941,9943,0,2,3
2841,3,2,9944,9944,9946,0,2,1
2842,5,1,9949,9949,9950,0,1,3
2843,3,3,9952,9952,9955,0,3,2
2844,2,3,9954,9955,9958,1,4,0
2845,3,3,9957,9958,9961,1,4,0
2846,5,2,9962,9962,9964,0,2,1
2847,2,2,9964,9964,9966,0,2,0
2848,5,2,9969,9969,9971,0,2,3
2849,5,3,9974,9974,9977,0,3,3
2850,1,2,9975,9977,9979,2,4,0
2851,6,3,9981,9981,9984,0,3,2
2852,6,1,9987,9987,9988,0,1,3
2853,2,2,9989,9989,9991,0,2,1
2854,5,2,9994,9994,9996,0,2,3
2855,2,1,9996,9996,9997,0,1,0
2856,5,3,10001,10001,10004,0,3,4
2857,1,3,10002,10004,10007,2,5,0
2858,1,1,10003,10007,10008,4,5,0
2859,5,3,10008,10008,10011,0,3,0
2860,6,1,10014,10014,10015,0,1,3
2861,4,2,10018,10018,10020,0,2,3
2862,6,2,10024,10024,10026,0,2,4
2863,2,1,10026,10026,10027,0,1,0
2864,5,2,10031,10031,10033,0,2,4
2865,5,2,10036,10036,10038,0,2,3
2866,2,2,10038,10038,10040,0,2,0
2867,4,1,10042,10042,10043,0,1,2
2868,2,3,10044,10044,10047,0,3,1
2869,2,1,10046,10047,10048,1,2,0
2870,2,1,10048,10048,10049,0,1,0
2871,6,2,10054,10054,10056,0,2,5
2872,2,3,10056,10056,10059,0,3,0
2873,2,2,10058,10059,10061,1,3,0
2874,4,1,10062,10062,10063,0,1,1
2875,5,1,10067,10067,10068,0,1,4
2876,6,2,10073,10073,10075,0,2,5
2877,5,3,10078,10078,10081,0,3,3
2878,1,3,10079,10081,10084,2,5,0
2879,5,3,10084,10084,10087,0,3,0
2880,4,3,10088,10088,10091,0,3,1
2881,3,1,10091,10091,10092,0,1,0
2882,6,3,10097,10097,10100,0,3,5
2883,4,1,10101,10101,10102,0,1,1
2884,1,2,10102,10102,10104,0,2,0
2885,3,2,10105,10105,10107,0,2,1
2886,6,3,10111,10111,10114,0,3,4
2887,5,1,10116,10116,10117,0,1,2
2888,2,2,10118,10118,10120,0,2,1
2889,4,2,10122,10122,10124,0,2,2
2890,5,2,10127,10127,10129,0,2,3
2891,4,3,10131,10131,10134,0,3,2
2892,3,3,10134,10134,10137,0,3,0
2893,3,2,10137,10137,10139,0,2,0
2894,2,3,10139,10139,10142,0,3,0
2895,4,1,10143,10143,10144,0,1,1
2896,4,2,10147,10147,10149,0,2,3
2897,4,3,10151,10151,10154,0,3,2
2898,1,2,10152,10154,10156,2,4,0
2899,1,1,10153,10156,10157,3,4,0
2900,4,3,10157,10157,10160,0,3,0
2901,5,3,10162,10162,10165,0,3,2
2902,5,2,10167,10167,10169,0,2,2
2903,6,2,10173,10173,10175,0,2,4
2904,3,1,10176,10176,10177,0,1,1
2905,4,1,10180,10180,10181,0,1,3
2906,3,1,10183,10183,10184,0,1,2
2907,1,2,10184,10184,10186,0,2,0
2908,1,3,10185,10186,10189,1,4,0
2909,1,3,10186,10189,10192,3,6,0
2910,1,3,10187,10192,10195,5,8,0
2911,5,3,10192,10195,10198,3,6,0
2912,6,1,10198,10198,10199,0,1,0
2913,1,1,10199,10199,10200,0,1,0
2914,4,2,10203,10203,10205,0,2,3
2915,1,1,10204,10205,10206,1,2,0
2916,6,3,10210,10210,10213,0,3,4
2917,4,1,10214,10214,10215,0,1,1
2918,2,2,10216,10216,10218,0,2,1
2919,5,3,10221,10221,10224,0,3,3
2920,3,3,10224,10224,10227,0,3,0
2921,4,3,10228,10228,10231,0,3,1
2922,2,2,10230,10231,10233,1,3,0
2923,6,1,10236,10236,10237,0,1,3
2924,2,1,10238,10238,10239,0,1,1
2925,1,1,10239,10239,10240,0,1,0
2926,3,2,10242,10242,10244,0,2,2
2927,3,3,10245,10245,10248,0,3,1
2928,6,2,10251,10251,10253,0,2,3
2929,4,1,10255,10255,10256,0,1,2
2930,5,2,10260,10260,10262,0,2,4
2931,6,2,10266,10266,10268,0,2,4
2932,1,2,10267,10268,10270,1,3,0
2933,2,1,10269,10270,10271,1,2,0
2934,3,3,10272,10272,10275,0,3,1
2935,5,1,10277,10277,10278,0,1,2
2936,6,2,10283,10283,10285,0,2,5
2937,2,2,10285,10285,10287,0,2,0
2938,5,3,10290,10290,10293,0,3,3
2939,4,1,10294,10294,10295,0,1,1
2940,3,3,10297,10297,10300,0,3,2
2941,5,3,10302,10302,10305,0,3,2
2942,6,3,10308,10308,10311,0,3,3
2943,5,2,10313,10313,10315,0,2,2
2944,2,1,10315,10315,10316,0,1,0
2945,4,1,10319,10319,10320,0,1,3
2946,5,2,10324,10324,10326,0,2,4
2947,6,3,10330,10330,10333,0,3,4
2948,6,2,10336,10336,10338,0,2,3
2949,5,2,10341,10341,10343,0,2,3
2950,6,3,10347,10347,10350,0,3,4
2951,6,3,10353,10353,10356,0,3,3
2952,5,3,10358,10358,10361,0,3,2
2953,5,2,10363,10363,10365,0,2,2
2954,1,2,10364,10365,10367,1,3,0
2955,2,2,10366,10367,10369,1,3,0
2956,6,3,10372,10372,10375,0,3,3
2957,6,3,10378,10378,10381,0,3,3
2958,6,2,10384,10384,10386,0,2,3
2959,5,3,10389,10389,10392,0,3,3
2960,4,1,10393,10393,10394,0,1,1
2961,1,1,10394,10394,10395,0,1,0
2962,4,3,10398,10398,10401,0,3,3
2963,1,3,10399,10401,10404,2,5,0
2964,4,2,10403,10404,10406,1,3,0
2965,3,3,10406,10406,10409,0,3,0
2966,1,1,10407,10409,10410,2,3,0
2967,6,1,10413,10413,10414,0,1,3
2968,2,2,10415,10415,10417,0,2,1
2969,1,1,10416,10417,10418,1,2,0
2970,5,2,10421,10421,10423,0,2,3
2971,2,1,10423,10423,10424,0,1,0
2972,5,2,10428,10428,10430,0,2,4
2973,4,2,10432,10432,10434,0,2,2
2974,2,1,10434,10434,10435,0,1,0
2975,1,2,10435,10435,10437,0,2,0
2976,2,3,10437,10437,10440,0,3,0
2977,6,3,10443,10443,10446,0,3,3
2978,1,3,10444,10446,10449,2,5,0
2979,1,2,10445,10449,10451,4,6,0
2980,6,1,10451,10451,10452,0,1,0
2981,6,1,10457,10457,10458,0,1,5
2982,4,2,10461,10461,10463,0,2,3
2983,6,1,10467,10467,10468,0,1,4
2984,5,3,10472,10472,10475,0,3,4
2985,6,3,10478,10478,10481,0,3,3
2986,2,2,10480,10481,10483,1,3,0
2987,6,1,10486,10486,10487,0,1,3
2988,1,3,10487,10487,10490,0,3,0
2989,2,1,10489,10490,10491,1,2,0
2990,3,3,10492,10492,10495,0,3,1
2991,4,1,10496,10496,10497,0,1,1
2992,6,2,10502,10502,10504,0,2,5
2993,4,2,10506,10506,10508,0,2,2
2994,5,2,10511,10511,10513,0,2,3
2995,1,3,10512,10513,10516,1,4,0
2996,2,3,10514,10516,10519,2,5,0
2997,4,2,10518,10519,10521,1,3,0
2998,4,1,10522,10522,10523,0,1,1
2999,5,3,10527,10527,10530,0,3,4
3000,5,1,10532,10532,10533,0,1,2
3001,6,2,10538,10538,10540,0,2,5
3002,5,3,10543,10543,10546,0,3,3
3003,1,3,10544,10546,10549,2,5,0
3004,5,2,10549,10549,10551,0,2,0
3005,6,3,10555,10555,10558,0,3,4
3006,5,2,10560,10560,10562,0,2,2
3007,2,2,10562,10562,10564,0,2,0
3008,6,2,10568,10568,10570,0,2,4
3009,1,2,10569,10570,10572,1,3,0
3010,1,2,10570,10572,10574,2,4,0
3011,4,2,10574,10574,10576,0,2,0
3012,5,1,10579,10579,10580,0,1,3
3013,4,2,10583,10583,10585,0,2,3
3014,5,2,10588,10588,10590,0,2,3
3015,1,2,10589,10590,10592,1,3,0
3016,5,1,10594,10594,10595,0,1,2
3017,3,2,10597,10597,10599,0,2,2
3018,2,3,10599,10599,10602,0,3,0
3019,1,3,10600,10602,10605,2,5,0
3020,6,2,10606,10606,10608,0,2,1
3021,1,1,10607,10608,10609,1,2,0
3022,3,1,10610,10610,10611,0,1,1
3023,1,3,10611,10611,10614,0,3,0
3024,3,2,10614,10614,10616,0,2,0
3025,1,3,10615,10616,10619,1,4,0
3026,1,2,10616,10619,10621,3,5,0
3027,2,1,10618,10621,10622,3,4,0
3028,3,3,10621,10622,10625,1,4,0
3029,6,1,10627,10627,10628,0,1,2
3030,1,1,10628,10628,10629,0,1,0
3031,1,2,10629,10629,10631,0,2,0
3032,2,1,10631,10631,10632,0,1,0
3033,1,3,10632,10632,10635,0,3,0
3034,4,1,10636,10636,10637,0,1,1
3035,3,3,10639,10639,10642,0,3,2
3036,6,2,10645,10645,10647,0,2,3
3037,2,3,10647,10647,10650,0,3,0
3038,4,2,10651,10651,10653,0,2,1
3039,2,3,10653,10653,10656,0,3,0
3040,2,2,10655,10656,10658,1,3,0
3041,1,2,10656,10658,10660,2,4,0
3042,6,2,10662,10662,10664,0,2,2
3043,1,1,10663,10664,10665,1,2,0
3044,4,2,10667,10667,10669,0,2,2
3045,6,2,10673,10673,10675,0,2,4
3046,2,1,10675,10675,10676,0,1,0
3047,6,2,10681,10681,10683,0,2,5
3048,1,2,10682,10683,10685,1,3,0
3049,5,2,10687,10687,10689,0,2,2
3050,6,3,10693,10693,10696,0,3,4
3051,6,1,10699,10699,10700,0,1,3
3052,2,3,10701,10701,10704,0,3,1
3053,6,3,10707,10707,10710,0,3,3
3054,4,1,10711,10711,10712,0,1,1
3055,2,3,10713,10713,10716,0,3,1
3056,3,2,10716,10716,10718,0,2,0
3057,4,3,10720,10720,10723,0,3,2
3058,2,2,10722,10723,10725,1,3,0
3059,3,2,10725,10725,10727,0,2,0
3060,3,3,10728,10728,10731,0,3,1
3061,5,1,10733,10733,10734,0,1,2
3062,3,2,10736,10736,10738,0,2,2
3063,3,2,10739,10739,10741,0,2,1
3064,6,2,10745,10745,10747,0,2,4
3065,4,3,10749,10749,10752,0,3,2
3066,3,2,10752,10752,10754,0,2,0
3067,3,2,10755,10755,10757,0,2,1
3068,2,3,10757,10757,10760,0,3,0
3069,4,2,10761,10761,10763,0,2,1
3070,6,3,10767,10767,10770,0,3,4
3071,2,1,10769,10770,10771,1,2,0
3072,3,2,10772,10772,10774,0,2,1
3073,3,3,10775,10775,10778,0,3,1
3074,2,3,10777,10778,10781,1,4,0
3075,4,2,10781,10781,10783,0,2,0
3076,5,1,10786,10786,10787,0,1,3
3077,4,1,10790,10790,10791,0,1,3
3078,4,3,10794,10794,10797,0,3,3
3079,1,3,10795,10797,10800,2,5,0
3080,1,2,10796,10800,10802,4,6,0
3081,2,2,10798,10802,10804,4,6,0
3082,1,2,10799,10804,10806,5,7,0
3083,4,1,10803,10806,10807,3,4,0
3084,1,3,10804,10807,10810,3,6,0
3085,1,3,10805,10810,10813,5,8,0
3086,1,3,10806,10813,10816,7,10,0
3087,2,3,10808,10816,10819,8,11,0
3088,6,2,10814,10819,10821,5,7,0
3089,4,2,10818,10821,10823,3,5,0
3090,5,2,10823,10823,10825,0,2,0
3091,4,2,10827,10827,10829,0,2,2
3092,1,3,10828,10829,10832,1,4,0
3093,6,1,10834,10834,10835,0,1,2
3094,5,2,10839,10839,10841,0,2,4
3095,2,2,10841,10841,10843,0,2,0
3096,6,3,10847,10847,10850,0,3,4
3097,3,2,10850,10850,10852,0,2,0
3098,4,2,10854,10854,10856,0,2,2
3099,4,1,10858,10858,10859,0,1,2
3100,1,1,10859,10859,10860,0,1,0
3101,4,1,10863,10863,10864,0,1,3
3102,2,1,10865,10865,10866,0,1,1
3103,5,2,10870,10870,10872,0,2,4
3104,4,1,10874,10874,10875,0,1,2
3105,6,3,10880,10880,10883,0,3,5
3106,2,3,10882,10883,10886,1,4,0
3107,3,1,10885,10886,10887,1,2,0
3108,6,3,10891,10891,10894,0,3,4
3109,1,1,10892,10894,10895,2,3,0
3110,3,1,10895,10895,10896,0,1,0
3111,5,2,10900,10900,10902,0,2,4
3112,6,1,10906,10906,10907,0,1,4
3113,2,2,10908,10908,10910,0,2,1
3114,4,2,10912,10912,10914,0,2,2
3115,5,2,10917,10917,10919,0,2,3
3116,1,3,10918,10919,10922,1,4,0
3117,4,3,10922,10922,10925,0,3,0
3118,3,3,10925,10925,10928,0,3,0
3119,3,3,10928,10928,10931,0,3,0
3120,2,2,10930,10931,10933,1,3,0
3121,6,3,10936,10936,10939,0,3,3
3122,1,2,10937,10939,10941,2,4,0
3123,6,3,10943,10943,10946,0,3,2
3124,3,3,10946,10946,10949,0,3,0
3125,5,1,10951,10951,10952,0,1,2
3126,3,1,10954,10954,10955,0,1,2
3127,1,2,10955,10955,10957,0,2,0
3128,1,2,10956,10957,10959,1,3,0
3129,1,3,10957,10959,10962,2,5,0
3130,4,1,10961,10962,10963,1,2,0
3131,5,2,10966,10966,10968,0,2,3
3132,4,3,10970,10970,10973,0,3,2
3133,4,3,10974,10974,10977,0,3,1
3134,1,3,10975,10977,10980,2,5,0
3135,6,1,10981,10981,10982,0,1,1
3136,1,1,10982,10982,10983,0,1,0
3137,3,1,10985,10985,10986,0,1,2
3138,4,1,10989,10989,10990,0,1,3
3139,3,2,10992,10992,10994,0,2,2
3140,1,2,10993,10994,10996,1,3,0
3141,6,2,10999,10999,11001,0,2,3
3142,3,2,11002,11002,11004,0,2,1
3143,3,3,11005,11005,11008,0,3,1
3144,4,2,11009,11009,11011,0,2,1
3145,2,1,11011,11011,11012,0,1,0
3146,2,1,11013,11013,11014,0,1,1
3147,2,2,11015,11015,11017,0,2,1
3148,3,2,11018,11018,11020,0,2,1
3149,4,1,11022,11022,11023,0,1,2
3150,3,2,11025,11025,11027,0,2,2
3151,6,3,11031,11031,11034,0,3,4
3152,4,2,11035,11035,11037,0,2,1
3153,3,1,11038,11038,11039,0,1,1
3154,4,2,11042,11042,11044,0,2,3
3155,5,3,11047,11047,11050,0,3,3
3156,6,3,11053,11053,11056,0,3,3
3157,4,3,11057,11057,11060,0,3,1
3158,6,1,11063,11063,11064,0,1,3
3159,1,2,11064,11064,11066,0,2,0
3160,1,1,11065,11066,11067,1,2,0
3161,5,2,11070,11070,11072,0,2,3
3162,2,1,11072,11072,11073,0,1,0
3163,5,1,11077,11077,11078,0,1,4
3164,1,1,11078,11078,11079,0,1,0
3165,5,2,11083,11083,11085,0,2,4
3166,3,1,11086,11086,11087,0,1,1
3167,4,3,11090,11090,11093,0,3,3
3168,1,3,11091,11093,11096,2,5,0
3169,4,1,11095,11096,11097,1,2,0
3170,2,1,11097,11097,11098,0,1,0
3171,1,1,11098,11098,11099,0,1,0
3172,2,2,11100,11100,11102,0,2,1
3173,6,2,11106,11106,11108,0,2,4
3174,3,1,11109,11109,11110,0,1,1
3175,4,1,11113,11113,11114,0,1,3
3176,5,2,11118,11118,11120,0,2,4
3177,3,1,11121,11121,11122,0,1,1
3178,6,1,11127,11127,11128,0,1,5
3179,4,3,11131,11131,11134,0,3,3
3180,6,2,11137,11137,11139,0,2,3
3181,3,3,11140,11140,11143,0,3,1
3182,5,1,11145,11145,11146,0,1,2
3183,5,3,11150,11150,11153,0,3,4
3184,5,1,11155,11155,11156,0,1,2
3185,1,2,11156,11156,11158,0,2,0
3186,2,3,11158,11158,11161,0,3,0
3187,4,1,11162,11162,11163,0,1,1
3188,6,2,11168,11168,11170,0,2,5
3189,3,1,11171,11171,11172,0,1,1
3190,2,3,11173,11173,11176,0,3,1
3191,1,1,11174,11176,11177,2,3,0
3192,3,1,11177,11177,11178,0,1,0
3193,6,2,11183,11183,11185,0,2,5
3194,3,2,11186,11186,11188,0,2,1
3195,2,1,11188,11188,11189,0,1,0
3196,5,3,11193,11193,11196,0,3,4
3197,3,1,11196,11196,11197,0,1,0
3198,3,3,11199,11199,11202,0,3,2
3199,4,3,11203,11203,11206,0,3,1
3200,1,1,11204,11206,11207,2,3,0
3201,5,2,11209,11209,11211,0,2,2
3202,4,3,11213,11213,11216,0,3,2
3203,5,1,11218,11218,11219,0,1,2
3204,4,3,11222,11222,11225,0,3,3
3205,1,1,11223,11225,11226,2,3,0
3206,3,3,11226,11226,11229,0,3,0
3207,2,3,11228,11229,11232,1,4,0
3208,4,2,11232,11232,11234,0,2,0
3209,3,2,11235,11235,11237,0,2,1
3210,3,2,11238,11238,11240,0,2,1
3211,1,3,11239,11240,11243,1,4,0
3212,5,1,11244,11244,11245,0,1,1
3213,4,1,11248,11248,11249,0,1,3
3214,3,1,11251,11251,11252,0,1,2
3215,2,3,11253,11253,11256,0,3,1
3216,3,1,11256,11256,11257,0,1,0
3217,4,3,11260,11260,11263,0,3,3
3218,2,2,11262,11263,11265,1,3,0
3219,2,1,11264,11265,11266,1,2,0
3220,3,3,11267,11267,11270,0,3,1
3221,1,1,11268,11270,11271,2,3,0
3222,1,1,11269,11271,11272,2,3,0
3223,6,3,11275,11275,11278,0,3,3
3224,1,1,11276,11278,11279,2,3,0
3225,1,1,11277,11279,11280,2,3,0
3226,4,3,11281,11281,11284,0,3,1
3227,5,1,11286,11286,11287,0,1,2
3228,5,1,11291,11291,11292,0,1,4
3229,4,3,11295,11295,11298,0,3,3
3230,1,2,11296,11298,11300,2,4,0
3231,2,1,11298,11300,11301,2,3,0
3232,3,3,11301,11301,11304,0,3,0
3233,3,2,11304,11304,11306,0,2,0
3234,1,1,11305,11306,11307,1,2,0
3235,4,3,11309,11309,11312,0,3,2
3236,5,3,11314,11314,11317,0,3,2
3237,6,1,11320,11320,11321,0,1,3
3238,1,2,11321,11321,11323,0,2,0
3239,3,3,11324,11324,11327,0,3,1
3240,1,1,11325,11327,11328,2,3,0
3241,6,2,11331,11331,11333,0,2,3
3242,2,2,11333,11333,11335,0,2,0
3243,4,3,11337,11337,11340,0,3,2
3244,6,1,11343,11343,11344,0,1,3
3245,3,3,11346,11346,11349,0,3,2
3246,5,1,11351,11351,11352,0,1,2
3247,2,2,11353,11353,11355,0,2,1
3248,5,2,11358,11358,11360,0,2,3
3249,6,1,11364,11364,11365,0,1,4
3250,3,3,11367,11367,11370,0,3,2
3251,3,1,11370,11370,11371,0,1,0
3252,2,3,11372,11372,11375,0,3,1
3253,2,3,11374,11375,11378,1,4,0
3254,6,2,11380,11380,11382,0,2,2
3255,2,1,11382,11382,11383,0,1,0
3256,5,3,11387,11387,11390,0,3,4
3257,3,1,11390,11390,11391,0,1,0
3258,3,3,11393,11393,11396,0,3,2
3259,6,1,11399,11399,11400,0,1,3
3260,4,2,11403,11403,11405,0,2,3
3261,2,1,11405,11405,11406,0,1,0
3262,4,1,11409,11409,11410,0,1,3
3263,1,3,11410,11410,11413,0,3,0
3264,5,1,11415,11415,11416,0,1,2
3265,1,3,11416,11416,11419,0,3,0
3266,1,2,11417,11419,11421,2,4,0
3267,1,2,11418,11421,11423,3,5,0
3268,5,1,11423,11423,11424,0,1,0
3269,6,2,11429,11429,11431,0,2,5
3270,3,2,11432,11432,11434,0,2,1
3271,5,1,11437,11437,11438,0,1,3
3272,4,3,11441,11441,11444,0,3,3
3273,6,1,11447,11447,11448,0,1,3
3274,5,1,11452,11452,11453,0,1,4
3275,5,2,11457,11457,11459,0,2,4
3276,1,3,11458,11459,11462,1,4,0
3277,6,1,11464,11464,11465,0,1,2
3278,5,3,11469,11469,11472,0,3,4
3279,2,1,11471,11472,11473,1,2,0
3280,3,3,11474,11474,11477,0,3,1
3281,6,2,11480,11480,11482,0,2,3
3282,4,3,11484,11484,11487,0,3,2
3283,4,1,11488,11488,11489,0,1,1
3284,5,3,11493,11493,11496,0,3,4
3285,5,2,11498,11498,11500,0,2,2
3286,4,2,11502,11502,11504,0,2,2
3287,4,1,11506,11506,11507,0,1,2
3288,4,2,11510,11510,11512,0,2,3
3289,1,2,11511,11512,11514,1,3,0
3290,6,3,11517,11517,11520,0,3,3
3291,6,3,11523,11523,11526,0,3,3
3292,6,3,11529,11529,11532,0,3,3
3293,3,1,11532,11532,11533,0,1,0
3294,4,3,11536,11536,11539,0,3,3
3295,3,3,11539,11539,11542,0,3,0
3296,4,1,11543,11543,11544,0,1,1
3297,4,3,11547,11547,11550,0,3,3
3298,5,1,11552,11552,11553,0,1,2
3299,5,3,11557,11557,11560,0,3,4
3300,3,2,11560,11560,11562,0,2,0
3301,3,2,11563,11563,11565,0,2,1
3302,2,1,11565,11565,11566,0,1,0
3303,2,2,11567,11567,11569,0,2,1
3304,3,3,11570,11570,11573,0,3,1
3305,3,3,11573,11573,11576,0,3,0
3306,3,2,11576,11576,11578,0,2,0
3307,2,3,11578,11578,11581,0,3,0
3308,2,2,11580,11581,11583,1,3,0
3309,2,3,11582,11583,11586,1,4,0
3310,3,2,11585,11586,11588,1,3,0
3311,3,2,11588,11588,11590,0,2,0
3312,6,3,11594,11594,11597,0,3,4
3313,4,2,11598,11598,11600,0,2,1
3314,3,2,11601,11601,11603,0,2,1
3315,3,3,11604,11604,11607,0,3,1
3316,6,2,11610,11610,11612,0,2,3
3317,3,3,11613,11613,11616,0,3,1
3318,5,1,11618,11618,11619,0,1,2
3319,2,2,11620,11620,11622,0,2,1
3320,2,2,11622,11622,11624,0,2,0
3321,4,1,11626,11626,11627,0,1,2
3322,5,3,11631,11631,11634,0,3,4
3323,1,2,11632,11634,11636,2,4,0
3324,4,3,11636,11636,11639,0,3,0
3325,6,3,11642,11642,11645,0,3,3
3326,3,3,11645,11645,11648,0,3,0
3327,3,2,11648,11648,11650,0,2,0
3328,2,3,11650,11650,11653,0,3,0
3329,3,1,11653,11653,11654,0,1,0
3330,6,3,11659,11659,11662,0,3,5
3331,5,3,11664,11664,11667,0,3,2
3332,1,1,11665,11667,11668,2,3,0
3333,1,1,11666,11668,11669,2,3,0
3334,4,1,11670,11670,11671,0,1,1
3335,1,3,11671,11671,11674,0,3,0
3336,6,2,11677,11677,11679,0,2,3
3337,5,2,11682,11682,11684,0,2,3
3338,1,3,11683,11684,11687,1,4,0
3339,4,2,11687,11687,11689,0,2,0
3340,6,2,11693,11693,11695,0,2,4
3341,2,1,11695,11695,11696,0,1,0
3342,2,1,11697,11697,11698,0,1,1
3343,5,2,11702,11702,11704,0,2,4
3344,5,3,11707,11707,11710,0,3,3
3345,4,2,11711,11711,11713,0,2,1
3346,2,2,11713,11713,11715,0,2,0
3347,6,1,11719,11719,11720,0,1,4
3348,2,3,11721,11721,11724,0,3,1
3349,2,2,11723,11724,11726,1,3,0
3350,6,1,11729,11729,11730,0,1,3
3351,1,1,11730,11730,11731,0,1,0
3352,5,1,11735,11735,11736,0,1,4
3353,4,3,11739,11739,11742,0,3,3
3354,3,2,11742,11742,11744,0,2,0
3355,1,2,11743,11744,11746,1,3,0
3356,3,1,11746,11746,11747,0,1,0
3357,5,1,11751,11751,11752,0,1,4
3358,5,3,11756,11756,11759,0,3,4
3359,2,2,11758,11759,11761,1,3,0
3360,4,2,11762,11762,11764,0,2,1
3361,6,3,11768,11768,11771,0,3,4
3362,4,1,11772,11772,11773,0,1,1
3363,5,1,11777,11777,11778,0,1,4
3364,2,1,11779,11779,11780,0,1,1
3365,4,2,11783,11783,11785,0,2,3
3366,6,1,11789,11789,11790,0,1,4
3367,6,2,11795,11795,11797,0,2,5
3368,3,2,11798,11798,11800,0,2,1
3369,2,1,11800,11800,11801,0,1,0
3370,2,3,11802,11802,11805,0,3,1
3371,2,3,11804,11805,11808,1,4,0
3372,3,1,11807,11808,11809,1,2,0
3373,3,3,11810,11810,11813,0,3,1
3374,2,1,11812,11813,11814,1,2,0
3375,1,3,11813,11814,11817,1,4,0
3376,3,2,11816,11817,11819,1,3,0
3377,3,3,11819,11819,11822,0,3,0
3378,3,1,11822,11822,11823,0,1,0
3379,6,3,11828,11828,11831,0,3,5
3380,6,3,11834,11834,11837,0,3,3
3381,6,3,11840,11840,11843,0,3,3
3382,2,1,11842,11843,11844,1,2,0
3383,5,3,11847,11847,11850,0,3,3
3384,5,2,11852,11852,11854,0,2,2
3385,2,2,11854,11854,11856,0,2,0
3386,2,2,11856,11856,11858,0,2,0
3387,2,3,11858,11858,11861,0,3,0
3388,2,3,11860,11861,11864,1,4,0
3389,2,1,11862,11864,11865,2,3,0
3390,2,2,11864,11865,11867,1,3,0
3391,5,1,11869,11869,11870,0,1,2
3392,6,2,11875,11875,11877,0,2,5
3393,6,1,11881,11881,11882,0,1,4
3394,3,1,11884,11884,11885,0,1,2
3395,5,1,11889,11889,11890,0,1,4
3396,1,2,11890,11890,11892,0,2,0
3397,6,1,11896,11896,11897,0,1,4
3398,5,3,11901,11901,11904,0,3,4
3399,6,2,11907,11907,11909,0,2,3
3400,6,3,11913,11913,11916,0,3,4
3401,3,2,11916,11916,11918,0,2,0
3402,1,2,11917,11918,11920,1,3,0
3403,4,2,11921,11921,11923,0,2,1
3404,6,2,11927,11927,11929,0,2,4
3405,1,1,11928,11929,11930,1,2,0
3406,6,3,11934,11934,11937,0,3,4
3407,1,2,11935,11937,11939,2,4,0
3408,4,1,11939,11939,11940,0,1,0
3409,1,3,11940,11940,11943,0,3,0
3410,3,2,11943,11943,11945,0,2,0
3411,1,2,11944,11945,11947,1,3,0
3412,3,1,11947,11947,11948,0,1,0
3413,4,2,11951,11951,11953,0,2,3
3414,4,3,11955,11955,11958,0,3,2
3415,4,1,11959,11959,11960,0,1,1
3416,3,1,11962,11962,11963,0,1,2
3417,4,3,11966,11966,11969,0,3,3
3418,6,1,11972,11972,11973,0,1,3
3419,5,2,11977,11977,11979,0,2,4
3420,3,3,11980,11980,11983,0,3,1
3421,2,1,11982,11983,11984,1,2,0
3422,5,1,11987,11987,11988,0,1,3
3423,3,1,11990,11990,11991,0,1,2
3424,5,2,11995,11995,11997,0,2,4
3425,4,2,11999,11999,12001,0,2,2
3426,3,2,12002,12002,12004,0,2,1
3427,2,2,12004,12004,12006,0,2,0
3428,2,2,12006,12006,12008,0,2,0
3429,4,3,12010,12010,12013,0,3,2
3430,6,1,12016,12016,12017,0,1,3
3431,1,3,12017,12017,12020,0,3,0
3432,1,2,12018,12020,12022,2,4,0
3433,4,1,12022,12022,12023,0,1,0
3434,2,3,12024,12024,12027,0,3,1
3435,6,3,12030,12030,12033,0,3,3
3436,6,3,12036,12036,12039,0,3,3
3437,3,1,12039,12039,12040,0,1,0
3438,6,2,12045,12045,12047,0,2,5
3439,3,2,12048,12048,12050,0,2,1
3440,6,2,12054,12054,12056,0,2,4
3441,4,1,12058,12058,12059,0,1,2
3442,5,2,12063,12063,12065,0,2,4
3443,5,3,12068,12068,12071,0,3,3
3444,3,1,12071,12071,12072,0,1,0
3445,4,1,12075,12075,12076,0,1,3
3446,3,2,12078,12078,12080,0,2,2
3447,3,1,12081,12081,12082,0,1,1
3448,2,3,12083,12083,12086,0,3,1
3449,3,1,12086,12086,12087,0,1,0
3450,1,2,12087,12087,12089,0,2,0
3451,4,1,12091,12091,12092,0,1,2
3452,5,3,12096,12096,12099,0,3,4
3453,2,1,12098,12099,12100,1,2,0
3454,3,3,12101,12101,12104,0,3,1
3455,1,3,12102,12104,12107,2,5,0
3456,2,2,12104,12107,12109,3,5,0
3457,6,2,12110,12110,12112,0,2,1
3458,2,1,12112,12112,12113,0,1,0
3459,2,3,12114,12114,12117,0,3,1
3460,4,3,12118,12118,12121,0,3,1
3461,2,1,12120,12121,12122,1,2,0
3462,6,1,12126,12126,12127,0,1,4
3463,4,2,12130,12130,12132,0,2,3
3464,5,2,12135,12135,12137,0,2,3
3465,6,3,12141,12141,12144,0,3,4
3466,5,1,12146,12146,12147,0,1,2
3467,3,1,12149,12149,12150,0,1,2
3468,1,1,12150,12150,12151,0,1,0
3469,6,3,12156,12156,12159,0,3,5
3470,4,2,12160,12160,12162,0,2,1
3471,2,2,12162,12162,12164,0,2,0
3472,3,3,12165,12165,12168,0,3,1
3473,6,1,12171,12171,12172,0,1,3
3474,2,3,12173,12173,12176,0,3,1
3475,3,2,12176,12176,12178,0,2,0
3476,6,1,12182,12182,12183,0,1,4
3477,1,3,12183,12183,12186,0,3,0
3478,3,2,12186,12186,12188,0,2,0
3479,1,1,12187,12188,12189,1,2,0
3480,6,3,12193,12193,12196,0,3,4
3481,5,3,12198,12198,12201,0,3,2
3482,2,3,12200,12201,12204,1,4,0
3483,5,1,12205,12205,12206,0,1,1
3484,1,1,12206,12206,12207,0,1,0
3485,4,2,12210,12210,12212,0,2,3
3486,3,1,12213,12213,12214,0,1,1
3487,6,1,12219,12219,12220,0,1,5
3488,1,3,12220,12220,12223,0,3,0
3489,6,1,12226,12226,12227,0,1,3
3490,6,2,12232,12232,12234,0,2,5
3491,4,2,12236,12236,12238,0,2,2
3492,4,2,12240,12240,12242,0,2,2
3493,5,2,12245,12245,12247,0,2,3
3494,6,2,12251,12251,12253,0,2,4
3495,4,1,12255,12255,12256,0,1,2
3496,3,1,12258,12258,12259,0,1,2
3497,3,3,12261,12261,12264,0,3,2
3498,3,2,12264,12264,12266,0,2,0
3499,3,3,12267,12267,12270,0,3,1
3500,2,1,12269,12270,12271,1,2,0
3501,4,1,12273,12273,12274,0,1,2
3502,1,3,12274,12274,12277,0,3,0
3503,5,2,12279,12279,12281,0,2,2
3504,6,1,12285,12285,12286,0,1,4
3505,6,2,12291,12291,12293,0,2,5
3506,5,1,12296,12296,12297,0,1,3
3507,2,1,12298,12298,12299,0,1,1
3508,4,3,12302,12302,12305,0,3,3
3509,4,2,12306,12306,12308,0,2,1
3510,1,2,12307,12308,12310,1,3,0
3511,5,1,12312,12312,12313,0,1,2
3512,3,3,12315,12315,12318,0,3,2
3513,6,2,12321,12321,12323,0,2,3
3514,4,3,12325,12325,12328,0,3,2
3515,2,3,12327,12328,12331,1,4,0
3516,5,1,12332,12332,12333,0,1,1
3517,5,2,12337,12337,12339,0,2,4
3518,1,3,12338,12339,12342,1,4,0
3519,3,2,12341,12342,12344,1,3,0
3520,5,2,12346,12346,12348,0,2,2
3521,4,2,12350,12350,12352,0,2,2
3522,6,3,12356,12356,12359,0,3,4
3523,2,1,12358,12359,12360,1,2,0
3524,2,3,12360,12360,12363,0,3,0
3525,6,2,12366,12366,12368,0,2,3
3526,5,1,12371,12371,12372,0,1,3
3527,2,1,12373,12373,12374,0,1,1
3528,3,1,12376,12376,12377,0,1,2
3529,3,3,12379,12379,12382,0,3,2
3530,4,1,12383,12383,12384,0,1,1
3531,2,2,12385,12385,12387,0,2,1
3532,2,1,12387,12387,12388,0,1,0
3533,5,2,12392,12392,12394,0,2,4
3534,2,2,12394,12394,12396,0,2,0
3535,5,2,12399,12399,12401,0,2,3
3536,2,2,12401,12401,12403,0,2,0
3537,4,2,12405,12405,12407,0,2,2
3538,4,2,12409,12409,12411,0,2,2
3539,4,3,12413,12413,12416,0,3,2
3540,3,3,12416,12416,12419,0,3,0
3541,6,2,12422,12422,12424,0,2,3
3542,4,2,12426,12426,12428,0,2,2
3543,5,3,12431,12431,12434,0,3,3
3544,2,1,12433,12434,12435,1,2,0
3545,3,1,12436,12436,12437,0,1,1
3546,5,3,12441,12441,12444,0,3,4
3547,5,1,12446,12446,12447,0,1,2
3548,6,3,12452,12452,12455,0,3,5
3549,3,2,12455,12455,12457,0,2,0
3550,5,1,12460,12460,12461,0,1,3
3551,4,1,12464,12464,12465,0,1,3
3552,6,1,12470,12470,12471,0,1,5
3553,4,3,12474,12474,12477,0,3,3
3554,2,1,12476,12477,12478,1,2,0
3555,4,2,12480,12480,12482,0,2,2
3556,6,1,12486,12486,12487,0,1,4
3557,4,2,12490,12490,12492,0,2,3
3558,4,1,12494,12494,12495,0,1,2
3559,3,1,12497,12497,12498,0,1,2
3560,4,1,12501,12501,12502,0,1,3
3561,6,1,12507,12507,12508,0,1,5
3562,3,3,12510,12510,12513,0,3,2
3563,4,3,12514,12514,12517,0,3,1
3564,1,1,12515,12517,12518,2,3,0
3565,2,3,12517,12518,12521,1,4,0
3566,2,1,12519,12521,12522,2,3,0
3567,1,1,12520,12522,12523,2,3,0
3568,2,3,12522,12523,12526,1,4,0
3569,1,2,12523,12526,12528,3,5,0
3570,1,2,12524,12528,12530,4,6,0
3571,4,3,12528,12530,12533,2,5,0
3572,1,1,12529,12533,12534,4,5,0
3573,3,2,12532,12534,12536,2,4,0
3574,1,3,12533,12536,12539,3,6,0
3575,2,2,12535,12539,12541,4,6,0
3576,4,2,12539,12541,12543,2,4,0
3577,4,3,12543,12543,12546,0,3,0
3578,1,3,12544,12546,12549,2,5,0
3579,1,1,12545,12549,12550,4,5,0
3580,6,2,12551,12551,12553,0,2,1
3581,6,2,12557,12557,12559,0,2,4
3582,3,3,12560,12560,12563,0,3,1
3583,4,3,12564,12564,12567,0,3,1
3584,6,1,12570,12570,12571,0,1,3
3585,6,1,12576,12576,12577,0,1,5
3586,1,2,12577,12577,12579,0,2,0
3587,3,1,12580,12580,12581,0,1,1
3588,5,2,12585,12585,12587,0,2,4
3589,3,3,12588,12588,12591,0,3,1
3590,3,3,12591,12591,12594,0,3,0
3591,5,1,12596,12596,12597,0,1,2
3592,5,1,12601,12601,12602,0,1,4
3593,3,1,12604,12604,12605,0,1,2
3594,3,1,12607,12607,12608,0,1,2
3595,6,1,12613,12613,12614,0,1,5
3596,2,3,12615,12615,12618,0,3,1
3597,1,3,12616,12618,12621,2,5,0
3598,6,1,12622,12622,12623,0,1,1
3599,5,2,12627,12627,12629,0,2,4
3600,5,1,12632,12632,12633,0,1,3
3601,4,3,12636,12636,12639,0,3,3
3602,6,3,12642,12642,12645,0,3,3
3603,6,3,12648,12648,12651,0,3,3
3604,4,1,12652,12652,12653,0,1,1
3605,5,3,12657,12657,12660,0,3,4
3606,5,1,12662,12662,12663,0,1,2
3607,3,1,12665,12665,12666,0,1,2
3608,1,1,12666,12666,12667,0,1,0
3609,1,3,12667,12667,12670,0,3,0
3610,6,1,12673,12673,12674,0,1,3
3611,3,3,12676,12676,12679,0,3,2
3612,1,1,12677,12679,12680,2,3,0
3613,5,1,12682,12682,12683,0,1,2
3614,5,3,12687,12687,12690,0,3,4
3615,6,1,12693,12693,12694,0,1,3
3616,6,2,12699,12699,12701,0,2,5
3617,2,3,12701,12701,12704,0,3,0
3618,6,3,12707,12707,12710,0,3,3
3619,3,1,12710,12710,12711,0,1,0
3620,3,3,12713,12713,12716,0,3,2
3621,5,2,12718,12718,12720,0,2,2
3622,4,3,12722,12722,12725,0,3,2
3623,1,3,12723,12725,12728,2,5,0
3624,6,1,12729,12729,12730,0,1,1
3625,1,1,12730,12730,12731,0,1,0
3626,1,1,12731,12731,12732,0,1,0
3627,4,2,12735,12735,12737,0,2,3
3628,3,1,12738,12738,12739,0,1,1
3629,1,2,12739,12739,12741,0,2,0
3630,3,3,12742,12742,12745,0,3,1
3631,3,3,12745,12745,12748,0,3,0
3632,4,2,12749,12749,12751,0,2,1
3633,1,1,12750,12751,12752,1,2,0
3634,4,1,12754,12754,12755,0,1,2
3635,3,1,12757,12757,12758,0,1,2
3636,4,2,12761,12761,12763,0,2,3
3637,2,2,12763,12763,12765,0,2,0
3638,3,2,12766,12766,12768,0,2,1
3639,1,2,12767,12768,12770,1,3,0
3640,5,1,12772,12772,12773,0,1,2
3641,1,3,12773,12773,12776,0,3,0
3642,6,2,12779,12779,12781,0,2,3
3643,5,3,12784,12784,12787,0,3,3
3644,5,1,12789,12789,12790,0,1,2
3645,3,3,12792,12792,12795,0,3,2
3646,4,3,12796,12796,12799,0,3,1
3647,2,1,12798,12799,12800,1,2,0
3648,2,2,12800,12800,12802,0,2,0
3649,3,2,12803,12803,12805,0,2,1
3650,5,3,12808,12808,12811,0,3,3
3651,6,2,12814,12814,12816,0,2,3
3652,3,2,12817,12817,12819,0,2,1
3653,2,2,12819,12819,12821,0,2,0
3654,2,3,12821,12821,12824,0,3,0
3655,6,3,12827,12827,12830,0,3,3
3656,6,1,12833,12833,12834,0,1,3
3657,6,3,12839,12839,12842,0,3,5
3658,5,1,12844,12844,12845,0,1,2
3659,2,2,12846,12846,12848,0,2,1
3660,5,1,12851,12851,12852,0,1,3
3661,1,2,12852,12852,12854,0,2,0
3662,2,1,12854,12854,12855,0,1,0
3663,5,3,12859,12859,12862,0,3,4
3664,2,3,12861,12862,12865,1,4,0
3665,6,3,12867,12867,12870,0,3,2
3666,4,3,12871,12871,12874,0,3,1
3667,6,3,12877,12877,12880,0,3,3
3668,3,2,12880,12880,12882,0,2,0
3669,5,1,12885,12885,12886,0,1,3
3670,5,1,12890,12890,12891,0,1,4
3671,6,2,12896,12896,12898,0,2,5
3672,2,3,12898,12898,12901,0,3,0
3673,4,2,12902,12902,12904,0,2,1
3674,1,2,12903,12904,12906,1,3,0
3675,3,3,12906,12906,12909,0,3,0
3676,3,2,12909,12909,12911,0,2,0
3677,3,1,12912,12912,12913,0,1,1
3678,2,2,12914,12914,12916,0,2,1
3679,3,1,12917,12917,12918,0,1,1
3680,1,3,12918,12918,12921,0,3,0
3681,6,1,12924,12924,12925,0,1,3
3682,6,2,12930,12930,12932,0,2,5
3683,5,3,12935,12935,12938,0,3,3
3684,2,3,12937,12938,12941,1,4,0
3685,3,2,12940,12941,12943,1,3,0
3686,2,2,12942,12943,12945,1,3,0
3687,4,2,12946,12946,12948,0,2,1
3688,3,1,12949,12949,12950,0,1,1
3689,5,3,12954,12954,12957,0,3,4
3690,1,3,12955,12957,12960,2,5,0
3691,6,2,12961,12961,12963,0,2,1
3692,1,2,12962,12963,12965,1,3,0
3693,2,1,12964,12965,12966,1,2,0
3694,2,1,12966,12966,12967,0,1,0
3695,3,2,12969,12969,12971,0,2,2
3696,4,2,12973,12973,12975,0,2,2
3697,1,2,12974,12975,12977,1,3,0
3698,5,1,12979,12979,12980,0,1,2
3699,1,2,12980,12980,12982,0,2,0
3700,5,3,12985,12985,12988,0,3,3
3701,3,2,12988,12988,12990,0,2,0
3702,5,3,12993,12993,12996,0,3,3
3703,2,1,12995,12996,12997,1,2,0
3704,5,2,13000,13000,13002,0,2,3
3705,5,2,13005,13005,13007,0,2,3
3706,6,3,13011,13011,13014,0,3,4
3707,5,2,13016,13016,13018,0,2,2
3708,2,3,13018,13018,13021,0,3,0
3709,2,2,13020,13021,13023,1,3,0
3710,3,2,13023,13023,13025,0,2,0
3711,2,3,13025,13025,13028,0,3,0
3712,4,3,13029,13029,13032,0,3,1
3713,2,3,13031,13032,13035,1,4,0
3714,5,1,13036,13036,13037,0,1,1
3715,1,1,13037,13037,13038,0,1,0
3716,3,2,13040,13040,13042,0,2,2
3717,6,2,13046,13046,13048,0,2,4
3718,2,2,13048,13048,13050,0,2,0
3719,3,2,13051,13051,13053,0,2,1
3720,5,3,13056,13056,13059,0,3,3
3721,5,1,13061,13061,13062,0,1,2
3722,3,1,13064,13064,13065,0,1,2
3723,5,2,13069,13069,13071,0,2,4
3724,6,2,13075,13075,13077,0,2,4
3725,3,1,13078,13078,13079,0,1,1
3726,1,2,13079,13079,13081,0,2,0
3727,4,1,13083,13083,13084,0,1,2
3728,5,2,13088,13088,13090,0,2,4
3729,5,1,13093,13093,13094,0,1,3
3730,1,2,13094,13094,13096,0,2,0
3731,2,1,13096,13096,13097,0,1,0
3732,4,3,13100,13100,13103,0,3,3
3733,3,1,13103,13103,13104,0,1,0
3734,3,1,13106,13106,13107,0,1,2
3735,3,1,13109,13109,13110,0,1,2
3736,3,2,13112,13112,13114,0,2,2
3737,4,1,13116,13116,13117,0,1,2
3738,5,3,13121,13121,13124,0,3,4
3739,3,3,13124,13124,13127,0,3,0
3740,2,1,13126,13127,13128,1,2,0
3741,6,3,13132,13132,13135,0,3,4
3742,6,3,13138,13138,13141,0,3,3
3743,3,3,13141,13141,13144,0,3,0
3744,2,1,13143,13144,13145,1,2,0
3745,1,2,13144,13145,13147,1,3,0
3746,6,3,13150,13150,13153,0,3,3
3747,1,2,13151,13153,13155,2,4,0
3748,4,3,13155,13155,13158,0,3,0
3749,2,1,13157,13158,13159,1,2,0
3750,1,2,13158,13159,13161,1,3,0
3751,4,3,13162,13162,13165,0,3,1
3752,2,2,13164,13165,13167,1,3,0
3753,3,1,13167,13167,13168,0,1,0
3754,6,2,13173,13173,13175,0,2,5
3755,4,1,13177,13177,13178,0,1,2
3756,6,1,13183,13183,13184,0,1,5
3757,6,3,13189,13189,13192,0,3,5
3758,5,1,13194,13194,13195,0,1,2
3759,4,1,13198,13198,13199,0,1,3
3760,5,1,13203,13203,13204,0,1,4
3761,4,2,13207,13207,13209,0,2,3
3762,1,2,13208,13209,13211,1,3,0
3763,3,3,13211,13211,13214,0,3,0
3764,6,2,13217,13217,13219,0,2,3
3765,1,3,13218,13219,13222,1,4,0
3766,1,1,13219,13222,13223,3,4,0
3767,1,2,13220,13223,13225,3,5,0
3768,1,1,13221,13225,13226,4,5,0
3769,4,1,13225,13226,13227,1,2,0
3770,1,1,13226,13227,13228,1,2,0
3771,2,2,13228,13228,13230,0,2,0
3772,6,2,13234,13234,13236,0,2,4
3773,2,1,13236,13236,13237,0,1,0
3774,4,3,13240,13240,13243,0,3,3
3775,5,3,13245,13245,13248,0,3,2
3776,6,1,13251,13251,13252,0,1,3
3777,4,3,13255,13255,13258,0,3,3
3778,3,3,13258,13258,13261,0,3,0
3779,3,1,13261,13261,13262,0,1,0
3780,5,3,13266,13266,13269,0,3,4
3781,2,2,13268,13269,13271,1,3,0
3782,2,3,13270,13271,13274,1,4,0
3783,3,3,13273,13274,13277,1,4,0
3784,2,3,13275,13277,13280,2,5,0
3785,3,3,13278,13280,13283,2,5,0
3786,5,3,13283,13283,13286,0,3,0
3787,5,3,13288,13288,13291,0,3,2
3788,4,2,13292,13292,13294,0,2,1
3789,3,2,13295,13295,13297,0,2,1
3790,1,2,13296,13297,13299,1,3,0
3791,2,1,13298,13299,13300,1,2,0
3792,5,3,13303,13303,13306,0,3,3
3793,4,3,13307,13307,13310,0,3,1
3794,5,3,13312,13312,13315,0,3,2
3795,1,2,13313,13315,13317,2,4,0
3796,3,2,13316,13317,13319,1,3,0
3797,2,2,13318,13319,13321,1,3,0
3798,1,2,13319,13321,13323,2,4,0
3799,5,1,13324,13324,13325,0,1,1
3800,5,3,13329,13329,13332,0,3,4
3801,1,2,13330,13332,13334,2,4,0
3802,2,2,13332,13334,13336,2,4,0
3803,2,3,13334,13336,13339,2,5,0
3804,1,2,13335,13339,13341,4,6,0
3805,4,2,13339,13341,13343,2,4,0
3806,6,3,13345,13345,13348,0,3,2
3807,1,2,13346,13348,13350,2,4,0
3808,1,2,13347,13350,13352,3,5,0
3809,1,3,13348,13352,13355,4,7,0
3810,3,3,13351,13355,13358,4,7,0
3811,1,1,13352,13358,13359,6,7,0
3812,5,1,13357,13359,13360,2,3,0
3813,6,3,13363,13363,13366,0,3,3
3814,4,1,13367,13367,13368,0,1,1
3815,3,2,13370,13370,13372,0,2,2
3816,6,1,13376,13376,13377,0,1,4
3817,3,2,13379,13379,13381,0,2,2
3818,4,3,13383,13383,13386,0,3,2
3819,5,1,13388,13388,13389,0,1,2
3820,6,3,13394,13394,13397,0,3,5
3821,2,2,13396,13397,13399,1,3,0
3822,5,3,13401,13401,13404,0,3,2
3823,4,3,13405,13405,13408,0,3,1
3824,3,1,13408,13408,13409,0,1,0
3825,4,1,13412,13412,13413,0,1,3
3826,2,2,13414,13414,13416,0,2,1
3827,1,2,13415,13416,13418,1,3,0
3828,1,3,13416,13418,13421,2,5,0
3829,5,3,13421,13421,13424,0,3,0
3830,1,3,13422,13424,13427,2,5,0
3831,6,3,13428,13428,13431,0,3,1
3832,2,3,13430,13431,13434,1,4,0
3833,4,3,13434,13434,13437,0,3,0
3834,1,2,13435,13437,13439,2,4,0
3835,1,2,13436,13439,13441,3,5,0
3836,1,2,13437,13441,13443,4,6,0
3837,4,1,13441,13443,13444,2,3,0
3838,6,1,13447,13447,13448,0,1,3
3839,6,1,13453,13453,13454,0,1,5
3840,3,3,13456,13456,13459,0,3,2
3841,1,3,13457,13459,13462,2,5,0
3842,2,1,13459,13462,13463,3,4,0
3843,5,3,13464,13464,13467,0,3,1
3844,2,2,13466,13467,13469,1,3,0
3845,3,3,13469,13469,13472,0,3,0
3846,3,2,13472,13472,13474,0,2,0
3847,3,3,13475,13475,13478,0,3,1
3848,4,2,13479,13479,13481,0,2,1
3849,4,1,13483,13483,13484,0,1,2
3850,2,3,13485,13485,13488,0,3,1
3851,2,3,13487,13488,13491,1,4,0
3852,1,2,13488,13491,13493,3,5,0
3853,3,1,13491,13493,13494,2,3,0
3854,3,1,13494,13494,13495,0,1,0
3855,4,3,13498,13498,13501,0,3,3
3856,5,2,13503,13503,13505,0,2,2
3857,6,2,13509,13509,13511,0,2,4
3858,1,3,13510,13511,13514,1,4,0
3859,4,2,13514,13514,13516,0,2,0
3860,2,3,13516,13516,13519,0,3,0
3861,1,3,13517,13519,13522,2,5,0
3862,3,3,13520,13522,13525,2,5,0
3863,2,2,13522,13525,13527,3,5,0
3864,5,1,13527,13527,13528,0,1,0
3865,6,2,13533,13533,13535,0,2,5
3866,1,2,13534,13535,13537,1,3,0
3867,6,2,13540,13540,13542,0,2,3
3868,4,1,13544,13544,13545,0,1,2
3869,3,3,13547,13547,13550,0,3,2
3870,3,1,13550,13550,13551,0,1,0
3871,4,3,13554,13554,13557,0,3,3
3872,4,1,13558,13558,13559,0,1,1
3873,3,1,13561,13561,13562,0,1,2
3874,2,3,13563,13563,13566,0,3,1
3875,6,2,13569,13569,13571,0,2,3
3876,4,3,13573,13573,13576,0,3,2
3877,2,3,13575,13576,13579,1,4,0
3878,4,1,13579,13579,13580,0,1,0
3879,5,2,13584,13584,13586,0,2,4
3880,6,1,13590,13590,13591,0,1,4
3881,5,2,13595,13595,13597,0,2,4
3882,2,1,13597,13597,13598,0,1,0
3883,4,1,13601,13601,13602,0,1,3
3884,1,2,13602,13602,13604,0,2,0
3885,4,1,13606,13606,13607,0,1,2
3886,1,3,13607,13607,13610,0,3,0
3887,3,3,13610,13610,13613,0,3,0
3888,3,2,13613,13613,13615,0,2,0
3889,3,2,13616,13616,13618,0,2,1
3890,4,1,13620,13620,13621,0,1,2
3891,4,1,13624,13624,13625,0,1,3
3892,3,2,13627,13627,13629,0,2,2
3893,4,2,13631,13631,13633,0,2,2
3894,5,1,13636,13636,13637,0,1,3
3895,6,2,13642,13642,13644,0,2,5
3896,6,1,13648,13648,13649,0,1,4
3897,1,3,13649,13649,13652,0,3,0
3898,2,3,13651,13652,13655,1,4,0
3899,1,2,13652,13655,13657,3,5,0
3900,5,3,13657,13657,13660,0,3,0
3901,4,1,13661,13661,13662,0,1,1
3902,2,2,13663,13663,13665,0,2,1
3903,5,1,13668,13668,13669,0,1,3
3904,5,2,13673,13673,13675,0,2,4
3905,3,3,13676,13676,13679,0,3,1
3906,4,3,13680,13680,13683,0,3,1
3907,5,2,13685,13685,13687,0,2,2
3908,6,3,13691,13691,13694,0,3,4
3909,2,2,13693,13694,13696,1,3,0
3910,5,1,13698,13698,13699,0,1,2
3911,3,3,13701,13701,13704,0,3,2
3912,5,3,13706,13706,13709,0,3,2
3913,4,1,13710,13710,13711,0,1,1
3914,6,3,13716,13716,13719,0,3,5
3915,3,1,13719,13719,13720,0,1,0
3916,6,1,13725,13725,13726,0,1,5
3917,1,1,13726,13726,13727,0,1,0
3918,4,2,13730,13730,13732,0,2,3
3919,2,1,13732,13732,13733,0,1,0
3920,4,2,13736,13736,13738,0,2,3
3921,3,3,13739,13739,13742,0,3,1
3922,4,2,13743,13743,13745,0,2,1
3923,6,1,13749,13749,13750,0,1,4
3924,3,1,13752,13752,13753,0,1,2
3925,1,2,13753,13753,13755,0,2,0
3926,6,3,13759,13759,13762,0,3,4
3927,5,3,13764,13764,13767,0,3,2
3928,5,1,13769,13769,13770,0,1,2
3929,3,1,13772,13772,13773,0,1,2
3930,4,1,13776,13776,13777,0,1,3
3931,1,2,13777,13777,13779,0,2,0
3932,5,3,13782,13782,13785,0,3,3
3933,6,1,13788,13788,13789,0,1,3
3934,3,3,13791,13791,13794,0,3,2
3935,1,2,13792,13794,13796,2,4,0
3936,4,1,13796,13796,13797,0,1,0
3937,2,1,13798,13798,13799,0,1,1
3938,6,1,13804,13804,13805,0,1,5
3939,3,2,13807,13807,13809,0,2,2
3940,6,2,13813,13813,13815,0,2,4
3941,1,3,13814,13815,13818,1,4,0
3942,1,1,13815,13818,13819,3,4,0
3943,1,1,13816,13819,13820,3,4,0
3944,5,2,13821,13821,13823,0,2,1
3945,6,1,13827,13827,13828,0,1,4
3946,6,2,13833,13833,13835,0,2,5
3947,1,1,13834,13835,13836,1,2,0
3948,2,3,13836,13836,13839,0,3,0
3949,4,2,13840,13840,13842,0,2,1
3950,6,2,13846,13846,13848,0,2,4
3951,2,3,13848,13848,13851,0,3,0
3952,5,1,13853,13853,13854,0,1,2
3953,6,3,13859,13859,13862,0,3,5
3954,5,2,13864,13864,13866,0,2,2
3955,2,3,13866,13866,13869,0,3,0
3956,4,2,13870,13870,13872,0,2,1
3957,2,3,13872,13872,13875,0,3,0
3958,1,3,13873,13875,13878,2,5,0
3959,5,3,13878,13878,13881,0,3,0
3960,2,3,13880,13881,13884,1,4,0
3961,5,2,13885,13885,13887,0,2,1
3962,6,1,13891,13891,13892,0,1,4
3963,2,2,13893,13893,13895,0,2,1
3964,4,1,13897,13897,13898,0,1,2
3965,3,3,13900,13900,13903,0,3,2
3966,3,2,13903,13903,13905,0,2,0
3967,2,2,13905,13905,13907,0,2,0
3968,1,3,13906,13907,13910,1,4,0
3969,3,1,13909,13910,13911,1,2,0
3970,6,2,13915,13915,13917,0,2,4
3971,5,1,13920,13920,13921,0,1,3
3972,3,2,13923,13923,13925,0,2,2
3973,6,1,13929,13929,13930,0,1,4
3974,1,2,13930,13930,13932,0,2,0
3975,2,2,13932,13932,13934,0,2,0
3976,2,2,13934,13934,13936,0,2,0
3977,1,2,13935,13936,13938,1,3,0
3978,2,2,13937,13938,13940,1,3,0
3979,5,2,13942,13942,13944,0,2,2
3980,4,2,13946,13946,13948,0,2,2
3981,6,1,13952,13952,13953,0,1,4
3982,5,1,13957,13957,13958,0,1,4
3983,2,1,13959,13959,13960,0,1,1
3984,2,3,13961,13961,13964,0,3,1
3985,1,1,13962,13964,13965,2,3,0
3986,3,3,13965,13965,13968,0,3,0
3987,3,1,13968,13968,13969,0,1,0
3988,6,2,13974,13974,13976,0,2,5
3989,4,3,13978,13978,13981,0,3,2
3990,2,1,13980,13981,13982,1,2,0
3991,4,2,13984,13984,13986,0,2,2
3992,1,1,13985,13986,13987,1,2,0
3993,5,1,13990,13990,13991,0,1,3
3994,3,1,13993,13993,13994,0,1,2
3995,4,3,13997,13997,14000,0,3,3
3996,6,3,14003,14003,14006,0,3,3
3997,3,2,14006,14006,14008,0,2,0
3998,2,2,14008,14008,14010,0,2,0
3999,6,3,14014,14014,14017,0,3,4
4000,4,1,14018,14018,14019,0,1,1
4001,3,1,14021,14021,14022,0,1,2
4002,4,1,14025,14025,14026,0,1,3
4003,6,2,14031,14031,14033,0,2,5
4004,1,3,14032,14033,14036,1,4,0
4005,1,1,14033,14036,14037,3,4,0
4006,3,3,14036,14037,14040,1,4,0
4007,1,3,14037,14040,14043,3,6,0
4008,3,3,14040,14043,14046,3,6,0
4009,3,3,14043,14046,14049,3,6,0
4010,1,2,14044,14049,14051,5,7,0
4011,4,1,14048,14051,14052,3,4,0
4012,6,1,14054,14054,14055,0,1,2
4013,3,3,14057,14057,14060,0,3,2
4014,5,1,14062,14062,14063,0,1,2
4015,6,3,14068,14068,14071,0,3,5
4016,2,3,14070,14071,14074,1,4,0
4017,2,1,14072,14074,14075,2,3,0
4018,3,2,14075,14075,14077,0,2,0
4019,5,1,14080,14080,14081,0,1,3
4020,4,3,14084,14084,14087,0,3,3
4021,6,2,14090,14090,14092,0,2,3
4022,6,2,14096,14096,14098,0,2,4
4023,6,3,14102,14102,14105,0,3,4
4024,5,2,14107,14107,14109,0,2,2
4025,1,1,14108,14109,14110,1,2,0
4026,3,3,14111,14111,14114,0,3,1
4027,4,1,14115,14115,14116,0,1,1
4028,6,3,14121,14121,14124,0,3,5
4029,2,1,14123,14124,14125,1,2,0
4030,4,2,14127,14127,14129,0,2,2
4031,1,2,14128,14129,14131,1,3,0
4032,5,2,14133,14133,14135,0,2,2
4033,4,1,14137,14137,14138,0,1,2
4034,5,1,14142,14142,14143,0,1,4
4035,4,2,14146,14146,14148,0,2,3
4036,3,1,14149,14149,14150,0,1,1
4037,1,1,14150,14150,14151,0,1,0
4038,6,1,14156,14156,14157,0,1,5
4039,4,2,14160,14160,14162,0,2,3
4040,4,3,14164,14164,14167,0,3,2
4041,1,3,14165,14167,14170,2,5,0
4042,5,3,14170,14170,14173,0,3,0
4043,4,1,14174,14174,14175,0,1,1
4044,1,1,14175,14175,14176,0,1,0
4045,3,1,14178,14178,14179,0,1,2
4046,2,2,14180,14180,14182,0,2,1
4047,3,1,14183,14183,14184,0,1,1
4048,5,1,14188,14188,14189,0,1,4
4049,5,3,14193,14193,14196,0,3,4
4050,1,2,14194,14196,14198,2,4,0
4051,4,3,14198,14198,14201,0,3,0
4052,4,1,14202,14202,14203,0,1,1
4053,3,1,14205,14205,14206,0,1,2
4054,5,1,14210,14210,14211,0,1,4
4055,5,3,14215,14215,14218,0,3,4
4056,4,1,14219,14219,14220,0,1,1
4057,2,3,14221,14221,14224,0,3,1
4058,5,1,14226,14226,14227,0,1,2
4059,5,1,14231,14231,14232,0,1,4
4060,6,3,14237,14237,14240,0,3,5
4061,1,1,14238,14240,14241,2,3,0
4062,2,3,14240,14241,14244,1,4,0
4063,1,1,14241,14244,14245,3,4,0
4064,3,1,14244,14245,14246,1,2,0
4065,1,3,14245,14246,14249,1,4,0
4066,5,1,14250,14250,14251,0,1,1
4067,1,1,14251,14251,14252,0,1,0
4068,5,2,14256,14256,14258,0,2,4
4069,6,2,14262,14262,14264,0,2,4
4070,4,1,14266,14266,14267,0,1,2
4071,2,3,14268,14268,14271,0,3,1
4072,5,2,14273,14273,14275,0,2,2
4073,3,1,14276,14276,14277,0,1,1
4074,5,1,14281,14281,14282,0,1,4
4075,6,3,14287,14287,14290,0,3,5
4076,5,3,14292,14292,14295,0,3,2
4077,2,3,14294,14295,14298,1,4,0
4078,1,3,14295,14298,14301,3,6,0
4079,6,2,14301,14301,14303,0,2,0
4080,4,3,14305,14305,14308,0,3,2
4081,4,1,14309,14309,14310,0,1,1
4082,5,2,14314,14314,14316,0,2,4
4083,3,3,14317,14317,14320,0,3,1
4084,5,1,14322,14322,14323,0,1,2
4085,6,2,14328,14328,14330,0,2,5
4086,2,1,14330,14330,14331,0,1,0
4087,4,2,14334,14334,14336,0,2,3
4088,4,1,14338,14338,14339,0,1,2
4089,2,2,14340,14340,14342,0,2,1
4090,2,2,14342,14342,14344,0,2,0
4091,6,3,14348,14348,14351,0,3,4
4092,3,1,14351,14351,14352,0,1,0
4093,3,3,14354,14354,14357,0,3,2
4094,1,1,14355,14357,14358,2,3,0
4095,2,2,14357,14358,14360,1,3,0
4096,2,2,14359,14360,14362,1,3,0
4097,5,1,14364,14364,14365,0,1,2
4098,6,2,14370,14370,14372,0,2,5
4099,3,3,14373,14373,14376,0,3,1
4100,1,1,14374,14376,14377,2,3,0
4101,2,3,14376,14377,14380,1,4,0
4102,4,3,14380,14380,14383,0,3,0
4103,1,2,14381,14383,14385,2,4,0
4104,3,3,14384,14385,14388,1,4,0
4105,2,1,14386,14388,14389,2,3,0
4106,4,1,14390,14390,14391,0,1,1
4107,5,2,14395,14395,14397,0,2,4
4108,5,2,14400,14400,14402,0,2,3
4109,3,1,14403,14403,14404,0,1,1
4110,3,3,14406,14406,14409,0,3,2
4111,6,2,14412,14412,14414,0,2,3
4112,4,2,14416,14416,14418,0,2,2
4113,6,3,14422,14422,14425,0,3,4
4114,1,3,14423,14425,14428,2,5,0
4115,6,3,14429,14429,14432,0,3,1
4116,1,2,14430,14432,14434,2,4,0
4117,1,2,14431,14434,14436,3,5,0
4118,1,3,14432,14436,14439,4,7,0
4119,1,1,14433,14439,14440,6,7,0
4120,6,2,14439,14440,14442,1,3,0
4121,2,2,14441,14442,14444,1,3,0
4122,4,2,14445,14445,14447,0,2,1
4123,6,2,14451,14451,14453,0,2,4
4124,2,3,14453,14453,14456,0,3,0
4125,5,1,14458,14458,14459,0,1,2
4126,2,1,14460,14460,14461,0,1,1
4127,1,3,14461,14461,14464,0,3,0
4128,3,2,14464,14464,14466,0,2,0
4129,5,3,14469,14469,14472,0,3,3
4130,6,3,14475,14475,14478,0,3,3
4131,5,3,14480,14480,14483,0,3,2
4132,5,2,14485,14485,14487,0,2,2
4133,3,1,14488,14488,14489,0,1,1
4134,3,1,14491,14491,14492,0,1,2
4135,6,3,14497,14497,14500,0,3,5
4136,1,1,14498,14500,14501,2,3,0
4137,1,1,14499,14501,14502,2,3,0
4138,1,1,14500,14502,14503,2,3,0
4139,4,1,14504,14504,14505,0,1,1
4140,3,1,14507,14507,14508,0,1,2
4141,5,2,14512,14512,14514,0,2,4
4142,5,3,14517,14517,14520,0,3,3
4143,4,2,14521,14521,14523,0,2,1
4144,5,1,14526,14526,14527,0,1,3
4145,3,3,14529,14529,14532,0,3,2
4146,1,1,14530,14532,14533,2,3,0
4147,4,3,14534,14534,14537,0,3,1
4148,5,3,14539,14539,14542,0,3,2
4149,4,2,14543,14543,14545,0,2,1
4150,4,1,14547,14547,14548,0,1,2
4151,1,1,14548,14548,14549,0,1,0
4152,4,3,14552,14552,14555,0,3,3
4153,2,2,14554,14555,14557,1,3,0
4154,1,3,14555,14557,14560,2,5,0
4155,5,2,14560,14560,14562,0,2,0
4156,1,1,14561,14562,14563,1,2,0
4157,1,2,14562,14563,14565,1,3,0
4158,3,2,14565,14565,14567,0,2,0
4159,4,3,14569,14569,14572,0,3,2
4160,1,3,14570,14572,14575,2,5,0
4161,2,1,14572,14575,14576,3,4,0
4162,3,2,14575,14576,14578,1,3,0
4163,6,3,14581,14581,14584,0,3,3
4164,6,3,14587,14587,14590,0,3,3
4165,2,2,14589,14590,14592,1,3,0
4166,4,2,14593,14593,14595,0,2,1
4167,4,1,14597,14597,14598,0,1,2
4168,1,3,14598,14598,14601,0,3,0
4169,3,3,14601,14601,14604,0,3,0
4170,3,1,14604,14604,14605,0,1,0
4171,6,2,14610,14610,14612,0,2,5
4172,2,3,14612,14612,14615,0,3,0
4173,6,1,14618,14618,14619,0,1,3
4174,2,2,14620,14620,14622,0,2,1
4175,1,1,14621,14622,14623,1,2,0
4176,3,1,14624,14624,14625,0,1,1
4177,3,3,14627,14627,14630,0,3,2
4178,1,1,14628,14630,14631,2,3,0
4179,4,1,14632,14632,14633,0,1,1
4180,4,2,14636,14636,14638,0,2,3
4181,1,2,14637,14638,14640,1,3,0
4182,5,3,14642,14642,14645,0,3,2
4183,1,2,14643,14645,14647,2,4,0
4184,5,3,14648,14648,14651,0,3,1
4185,3,1,14651,14651,14652,0,1,0
4186,2,1,14653,14653,14654,0,1,1
4187,4,2,14657,14657,14659,0,2,3
4188,5,1,14662,14662,14663,0,1,3
4189,5,2,14667,14667,14669,0,2,4
4190,1,3,14668,14669,14672,1,4,0
4191,2,2,14670,14672,14674,2,4,0
4192,6,2,14676,14676,14678,0,2,2
4193,2,3,14678,14678,14681,0,3,0
4194,4,2,14682,14682,14684,0,2,1
4195,1,2,14683,14684,14686,1,3,0
4196,3,1,14686,14686,14687,0,1,0
4197,4,2,14690,14690,14692,0,2,3
4198,6,1,14696,14696,14697,0,1,4
4199,1,1,14697,14697,14698,0,1,0
4200,6,1,14703,14703,14704,0,1,5
4201,2,1,14705,14705,14706,0,1,1
4202,5,3,14710,14710,14713,0,3,4
4203,2,1,14712,14713,14714,1,2,0
4204,2,2,14714,14714,14716,0,2,0
4205,1,1,14715,14716,14717,1,2,0
4206,4,1,14719,14719,14720,0,1,2
4207,4,3,14723,14723,14726,0,3,3
4208,3,3,14726,14726,14729,0,3,0
4209,5,3,14731,14731,14734,0,3,2
4210,1,2,14732,14734,14736,2,4,0
4211,4,1,14736,14736,14737,0,1,0
4212,4,2,14740,14740,14742,0,2,3
4213,3,3,14743,14743,14746,0,3,1
4214,2,2,14745,14746,14748,1,3,0
4215,5,1,14750,14750,14751,0,1,2
4216,4,3,14754,14754,14757,0,3,3
4217,1,1,14755,14757,14758,2,3,0
4218,4,1,14759,14759,14760,0,1,1
4219,6,1,14765,14765,14766,0,1,5
4220,5,2,14770,14770,14772,0,2,4
4221,5,1,14775,14775,14776,0,1,3
4222,2,3,14777,14777,14780,0,3,1
4223,6,1,14783,14783,14784,0,1,3
4224,5,3,14788,14788,14791,0,3,4
4225,1,2,14789,14791,14793,2,4,0
4226,4,3,14793,14793,14796,0,3,0
4227,1,3,14794,14796,14799,2,5,0
4228,1,2,14795,14799,14801,4,6,0
4229,6,1,14801,14801,14802,0,1,0
4230,4,3,14805,14805,14808,0,3,3
4231,4,2,14809,14809,14811,0,2,1
4232,2,2,14811,14811,14813,0,2,0
4233,5,1,14816,14816,14817,0,1,3
4234,3,2,14819,14819,14821,0,2,2
4235,2,3,14821,14821,14824,0,3,0
4236,5,3,14826,14826,14829,0,3,2
4237,2,3,14828,14829,14832,1,4,0
4238,1,1,14829,14832,14833,3,4,0
4239,5,1,14834,14834,14835,0,1,1
4240,3,2,14837,14837,14839,0,2,2
4241,6,3,14843,14843,14846,0,3,4
4242,1,2,14844,14846,14848,2,4,0
4243,3,3,14847,14848,14851,1,4,0
4244,3,2,14850,14851,14853,1,3,0
4245,1,1,14851,14853,14854,2,3,0
4246,4,2,14855,14855,14857,0,2,1
4247,6,1,14861,14861,14862,0,1,4
4248,1,2,14862,14862,14864,0,2,0
4249,5,2,14867,14867,14869,0,2,3
4250,2,2,14869,14869,14871,0,2,0
4251,1,3,14870,14871,14874,1,4,0
4252,4,3,14874,14874,14877,0,3,0
4253,3,3,14877,14877,14880,0,3,0
4254,6,2,14883,14883,14885,0,2,3
4255,1,3,14884,14885,14888,1,4,0
4256,1,3,14885,14888,14891,3,6,0
4257,3,3,14888,14891,14894,3,6,0
4258,3,2,14891,14894,14896,3,5,0
4259,5,1,14896,14896,14897,0,1,0
4260,1,2,14897,14897,14899,0,2,0
4261,4,3,14901,14901,14904,0,3,2
4262,5,3,14906,14906,14909,0,3,2
4263,3,2,14909,14909,14911,0,2,0
4264,4,3,14913,14913,14916,0,3,2
4265,6,1,14919,14919,14920,0,1,3
4266,6,2,14925,14925,14927,0,2,5
4267,3,1,14928,14928,14929,0,1,1
4268,4,3,14932,14932,14935,0,3,3
4269,4,1,14936,14936,14937,0,1,1
4270,2,2,14938,14938,14940,0,2,1
4271,4,1,14942,14942,14943,0,1,2
4272,3,1,14945,14945,14946,0,1,2
4273,3,3,14948,14948,14951,0,3,2
4274,1,2,14949,14951,14953,2,4,0
4275,2,2,14951,14953,14955,2,4,0
4276,4,3,14955,14955,14958,0,3,0
4277,4,3,14959,14959,14962,0,3,1
4278,4,1,14963,14963,14964,0,1,1
4279,2,3,14965,14965,14968,0,3,1
4280,6,3,14971,14971,14974,0,3,3
4281,5,3,14976,14976,14979,0,3,2
4282,1,1,14977,14979,14980,2,3,0
4283,2,1,14979,14980,14981,1,2,0
4284,4,3,14983,14983,14986,0,3,2
4285,3,2,14986,14986,14988,0,2,0
4286,1,3,14987,14988,14991,1,4,0
4287,4,1,14991,14991,14992,0,1,0
4288,2,3,14993,14993,14996,0,3,1
4289,6,3,14999,14999,15002,0,3,3
4290,6,2,15005,15005,15007,0,2,3
4291,5,3,15010,15010,15013,0,3,3
4292,5,3,15015,15015,15018,0,3,2
4293,6,2,15021,15021,15023,0,2,3
4294,6,3,15027,15027,15030,0,3,4
4295,5,3,15032,15032,15035,0,3,2
4296,1,3,15033,15035,15038,2,5,0
4297,2,1,15035,15038,15039,3,4,0
4298,1,2,15036,15039,15041,3,5,0
4299,3,1,15039,15041,15042,2,3,0
4300,3,1,15042,15042,15043,0,1,0
4301,2,2,15044,15044,15046,0,2,1
4302,3,2,15047,15047,15049,0,2,1
4303,3,2,15050,15050,15052,0,2,1
4304,3,2,15053,15053,15055,0,2,1
4305,6,3,15059,15059,15062,0,3,4
4306,2,1,15061,15062,15063,1,2,0
4307,3,3,15064,15064,15067,0,3,1
4308,2,2,15066,15067,15069,1,3,0
4309,4,2,15070,15070,15072,0,2,1
4310,2,1,15072,15072,15073,0,1,0
4311,3,3,15075,15075,15078,0,3,2
4312,3,2,15078,15078,15080,0,2,0
4313,3,2,15081,15081,15083,0,2,1
4314,3,2,15084,15084,15086,0,2,1
4315,4,2,15088,15088,15090,0,2,2
4316,6,1,15094,15094,15095,0,1,4
4317,6,1,15100,15100,15101,0,1,5
4318,5,1,15105,15105,15106,0,1,4
4319,1,1,15106,15106,15107,0,1,0
4320,3,3,15109,15109,15112,0,3,2
4321,3,3,15112,15112,15115,0,3,0
4322,3,3,15115,15115,15118,0,3,0
4323,2,1,15117,15118,15119,1,2,0
4324,6,2,15123,15123,15125,0,2,4
4325,2,3,15125,15125,15128,0,3,0
4326,3,2,15128,15128,15130,0,2,0
4327,3,2,15131,15131,15133,0,2,1
4328,6,2,15137,15137,15139,0,2,4
4329,6,3,15143,15143,15146,0,3,4
4330,6,1,15149,15149,15150,0,1,3
4331,6,2,15155,15155,15157,0,2,5
4332,1,3,15156,15157,15160,1,4,0
4333,4,1,15160,15160,15161,0,1,0
4334,2,2,15162,15162,15164,0,2,1
4335,3,3,15165,15165,15168,0,3,1
4336,5,1,15170,15170,15171,0,1,2
4337,1,3,15171,15171,15174,0,3,0
4338,3,3,15174,15174,15177,0,3,0
4339,2,3,15176,15177,15180,1,4,0
4340,6,2,15182,15182,15184,0,2,2
4341,1,3,15183,15184,15187,1,4,0
4342,5,3,15188,15188,15191,0,3,1
4343,4,1,15192,15192,15193,0,1,1
4344,5,3,15197,15197,15200,0,3,4
4345,4,1,15201,15201,15202,0,1,1
4346,3,2,15204,15204,15206,0,2,2
4347,6,1,15210,15210,15211,0,1,4
4348,6,2,15216,15216,15218,0,2,5
4349,4,2,15220,15220,15222,0,2,2
4350,1,1,15221,15222,15223,1,2,0
4351,4,2,15225,15225,15227,0,2,2
4352,2,3,15227,15227,15230,0,3,0
4353,6,1,15233,15233,15234,0,1,3
4354,1,2,15234,15234,15236,0,2,0
4355,2,1,15236,15236,15237,0,1,0
4356,4,3,15240,15240,15243,0,3,3
4357,5,2,15245,15245,15247,0,2,2
4358,4,1,15249,15249,15250,0,1,2
4359,1,2,15250,15250,15252,0,2,0
4360,6,3,15256,15256,15259,0,3,4
4361,1,2,15257,15259,15261,2,4,0
4362,4,1,15261,15261,15262,0,1,0
4363,3,1,15264,15264,15265,0,1,2
4364,5,1,15269,15269,15270,0,1,4
4365,6,2,15275,15275,15277,0,2,5
4366,2,2,15277,15277,15279,0,2,0
4367,1,3,15278,15279,15282,1,4,0
4368,2,2,15280,15282,15284,2,4,0
4369,3,3,15283,15284,15287,1,4,0
4370,4,3,15287,15287,15290,0,3,0
4371,6,1,15293,15293,15294,0,1,3
4372,2,3,15295,15295,15298,0,3,1
4373,2,2,15297,15298,15300,1,3,0
4374,1,3,15298,15300,15303,2,5,0
4375,4,2,15302,15303,15305,1,3,0
4376,4,1,15306,15306,15307,0,1,1
4377,3,2,15309,15309,15311,0,2,2
4378,3,3,15312,15312,15315,0,3,1
4379,3,1,15315,15315,15316,0,1,0
4380,5,3,15320,15320,15323,0,3,4
4381,2,2,15322,15323,15325,1,3,0
4382,4,3,15326,15326,15329,0,3,1
4383,2,1,15328,15329,15330,1,2,0
4384,3,1,15331,15331,15332,0,1,1
4385,3,1,15334,15334,15335,0,1,2
4386,6,2,15340,15340,15342,0,2,5
4387,1,2,15341,15342,15344,1,3,0
4388,2,1,15343,15344,15345,1,2,0
4389,5,3,15348,15348,15351,0,3,3
4390,5,2,15353,15353,15355,0,2,2
4391,3,2,15356,15356,15358,0,2,1
4392,1,3,15357,15358,15361,1,4,0
4393,1,1,15358,15361,15362,3,4,0
4394,2,3,15360,15362,15365,2,5,0
4395,5,3,15365,15365,15368,0,3,0
4396,4,1,15369,15369,15370,0,1,1
4397,3,1,15372,15372,15373,0,1,2
4398,4,3,15376,15376,15379,0,3,3
4399,1,1,15377,15379,15380,2,3,0
4400,1,1,15378,15380,15381,2,3,0
4401,1,2,15379,15381,15383,2,4,0
4402,1,2,15380,15383,15385,3,5,0
4403,2,3,15382,15385,15388,3,6,0
4404,2,1,15384,15388,15389,4,5,0
4405,5,1,15389,15389,15390,0,1,0
4406,2,3,15391,15391,15394,0,3,1
4407,6,2,15397,15397,15399,0,2,3
4408,1,3,15398,15399,15402,1,4,0
4409,4,2,15402,15402,15404,0,2,0
4410,1,3,15403,15404,15407,1,4,0
4411,5,2,15408,15408,15410,0,2,1
4412,5,2,15413,15413,15415,0,2,3
4413,2,1,15415,15415,15416,0,1,0
4414,2,2,15417,15417,15419,0,2,1
4415,4,1,15421,15421,15422,0,1,2
4416,3,2,15424,15424,15426,0,2,2
4417,1,1,15425,15426,15427,1,2,0
4418,6,2,15431,15431,15433,0,2,4
4419,1,2,15432,15433,15435,1,3,0
4420,4,1,15436,15436,15437,0,1,1
4421,1,3,15437,15437,15440,0,3,0
4422,2,2,15439,15440,15442,1,3,0
4423,3,3,15442,15442,15445,0,3,0
4424,4,1,15446,15446,15447,0,1,1
4425,1,2,15447,15447,15449,0,2,0
4426,2,3,15449,15449,15452,0,3,0
4427,3,1,15452,15452,15453,0,1,0
4428,6,2,15458,15458,15460,0,2,5
4429,3,2,15461,15461,15463,0,2,1
4430,2,1,15463,15463,15464,0,1,0
4431,5,3,15468,15468,15471,0,3,4
4432,4,1,15472,15472,15473,0,1,1
4433,6,1,15478,15478,15479,0,1,5
4434,3,1,15481,15481,15482,0,1,2
4435,3,1,15484,15484,15485,0,1,2
4436,1,2,15485,15485,15487,0,2,0
4437,2,3,15487,15487,15490,0,3,0
4438,6,1,15493,15493,15494,0,1,3
4439,4,3,15497,15497,15500,0,3,3
4440,6,3,15503,15503,15506,0,3,3
4441,3,3,15506,15506,15509,0,3,0
4442,3,2,15509,15509,15511,0,2,0
4443,2,3,15511,15511,15514,0,3,0
4444,2,1,15513,15514,15515,1,2,0
4445,2,2,15515,15515,15517,0,2,0
4446,6,2,15521,15521,15523,0,2,4
4447,4,2,15525,15525,15527,0,2,2
4448,4,2,15529,15529,15531,0,2,2
4449,4,3,15533,15533,15536,0,3,2
4450,1,3,15534,15536,15539,2,5,0
4451,5,1,15539,15539,15540,0,1,0
4452,4,1,15543,15543,15544,0,1,3
4453,1,2,15544,15544,15546,0,2,0
4454,5,2,15549,15549,15551,0,2,3
4455,1,3,15550,15551,15554,1,4,0
4456,3,3,15553,15554,15557,1,4,0
4457,3,3,15556,15557,15560,1,4,0
4458,1,3,15557,15560,15563,3,6,0
4459,3,2,15560,15563,15565,3,5,0
4460,1,1,15561,15565,15566,4,5,0
4461,2,1,15563,15566,15567,3,4,0
4462,6,2,15569,15569,15571,0,2,2
4463,4,3,15573,15573,15576,0,3,2
4464,4,3,15577,15577,15580,0,3,1
4465,3,1,15580,15580,15581,0,1,0
4466,6,3,15586,15586,15589,0,3,5
4467,6,1,15592,15592,15593,0,1,3
4468,5,1,15597,15597,15598,0,1,4
4469,6,2,15603,15603,15605,0,2,5
4470,1,1,15604,15605,15606,1,2,0
4471,5,3,15609,15609,15612,0,3,3
4472,5,3,15614,15614,15617,0,3,2
4473,3,1,15617,15617,15618,0,1,0
4474,2,2,15619,15619,15621,0,2,1
4475,2,1,15621,15621,15622,0,1,0
4476,4,2,15625,15625,15627,0,2,3
4477,5,3,15630,15630,15633,0,3,3
4478,2,2,15632,15633,15635,1,3,0
4479,6,2,15638,15638,15640,0,2,3
4480,1,2,15639,15640,15642,1,3,0
4481,4,2,15643,15643,15645,0,2,1
4482,6,1,15649,15649,15650,0,1,4
4483,1,1,15650,15650,15651,0,1,0
4484,5,2,15655,15655,15657,0,2,4
4485,3,3,15658,15658,15661,0,3,1
4486,5,1,15663,15663,15664,0,1,2
4487,1,3,15664,15664,15667,0,3,0
4488,2,1,15666,15667,15668,1,2,0
4489,6,3,15672,15672,15675,0,3,4
4490,4,3,15676,15676,15679,0,3,1
4491,1,2,15677,15679,15681,2,4,0
4492,1,3,15678,15681,15684,3,6,0
4493,3,3,15681,15684,15687,3,6,0
4494,5,1,15686,15687,15688,1,2,0
4495,2,3,15688,15688,15691,0,3,0
4496,5,1,15693,15693,15694,0,1,2
4497,3,2,15696,15696,15698,0,2,2
4498,3,2,15699,15699,15701,0,2,1
4499,1,3,15700,15701,15704,1,4,0
4500,1,2,15701,15704,15706,3,5,0
4501,2,2,15703,15706,15708,3,5,0
4502,2,1,15705,15708,15709,3,4,0
4503,2,3,15707,15709,15712,2,5,0
4504,3,1,15710,15712,15713,2,3,0
4505,3,3,15713,15713,15716,0,3,0
4506,3,2,15716,15716,15718,0,2,0
4507,3,1,15719,15719,15720,0,1,1
4508,5,2,15724,15724,15726,0,2,4
4509,4,2,15728,15728,15730,0,2,2
4510,3,1,15731,15731,15732,0,1,1
4511,5,2,15736,15736,15738,0,2,4
4512,6,1,15742,15742,15743,0,1,4
4513,4,1,15746,15746,15747,0,1,3
4514,1,1,15747,15747,15748,0,1,0
4515,2,1,15749,15749,15750,0,1,1
4516,1,2,15750,15750,15752,0,2,0
4517,2,3,15752,15752,15755,0,3,0
4518,1,2,15753,15755,15757,2,4,0
4519,4,1,15757,15757,15758,0,1,0
4520,6,2,15763,15763,15765,0,2,5
4521,3,1,15766,15766,15767,0,1,1
4522,2,1,15768,15768,15769,0,1,1
4523,2,3,15770,15770,15773,0,3,1
4524,6,1,15776,15776,15777,0,1,3
4525,6,2,15782,15782,15784,0,2,5
4526,2,1,15784,15784,15785,0,1,0
4527,2,1,15786,15786,15787,0,1,1
4528,1,3,15787,15787,15790,0,3,0
4529,2,1,15789,15790,15791,1,2,0
4530,6,1,15795,15795,15796,0,1,4
4531,3,2,15798,15798,15800,0,2,2
4532,3,2,15801,15801,15803,0,2,1
4533,3,1,15804,15804,15805,0,1,1
4534,1,1,15805,15805,15806,0,1,0
4535,6,2,15811,15811,15813,0,2,5
4536,2,2,15813,15813,15815,0,2,0
4537,6,1,15819,15819,15820,0,1,4
4538,1,1,15820,15820,15821,0,1,0
4539,3,3,15823,15823,15826,0,3,2
4540,2,1,15825,15826,15827,1,2,0
4541,3,1,15828,15828,15829,0,1,1
4542,5,1,15833,15833,15834,0,1,4
4543,1,1,15834,15834,15835,0,1,0
4544,4,1,15838,15838,15839,0,1,3
4545,2,2,15840,15840,15842,0,2,1
4546,6,2,15846,15846,15848,0,2,4
4547,3,3,15849,15849,15852,0,3,1
4548,4,2,15853,15853,15855,0,2,1
4549,3,3,15856,15856,15859,0,3,1
4550,1,1,15857,15859,15860,2,3,0
4551,4,3,15861,15861,15864,0,3,1
4552,6,3,15867,15867,15870,0,3,3
4553,3,2,15870,15870,15872,0,2,0
4554,1,1,15871,15872,15873,1,2,0
4555,1,1,15872,15873,15874,1,2,0
4556,5,2,15877,15877,15879,0,2,3
4557,3,1,15880,15880,15881,0,1,1
4558,5,1,15885,15885,15886,0,1,4
4559,1,3,15886,15886,15889,0,3,0
4560,2,3,15888,15889,15892,1,4,0
4561,2,1,15890,15892,15893,2,3,0
4562,5,2,15895,15895,15897,0,2,2
4563,5,3,15900,15900,15903,0,3,3
4564,3,1,15903,15903,15904,0,1,0
4565,5,1,15908,15908,15909,0,1,4
4566,4,3,15912,15912,15915,0,3,3
4567,2,3,15914,15915,15918,1,4,0
4568,6,1,15920,15920,15921,0,1,2
4569,3,3,15923,15923,15926,0,3,2
4570,5,1,15928,15928,15929,0,1,2
4571,2,3,15930,15930,15933,0,3,1
4572,3,3,15933,15933,15936,0,3,0
4573,3,1,15936,15936,15937,0,1,0
4574,4,3,15940,15940,15943,0,3,3
4575,2,1,15942,15943,15944,1,2,0
4576,4,3,15946,15946,15949,0,3,2
4577,4,2,15950,15950,15952,0,2,1
4578,1,3,15951,15952,15955,1,4,0
4579,6,2,15957,15957,15959,0,2,2
4580,2,1,15959,15959,15960,0,1,0
4581,6,2,15965,15965,15967,0,2,5
4582,2,3,15967,15967,15970,0,3,0
4583,3,2,15970,15970,15972,0,2,0
4584,3,1,15973,15973,15974,0,1,1
4585,5,1,15978,15978,15979,0,1,4
4586,1,1,15979,15979,15980,0,1,0
4587,2,2,15981,15981,15983,0,2,1
4588,3,1,15984,15984,15985,0,1,1
4589,5,1,15989,15989,15990,0,1,4
4590,2,3,15991,15991,15994,0,3,1
4591,2,1,15993,15994,15995,1,2,0
4592,4,3,15997,15997,16000,0,3,2
4593,5,3,16002,16002,16005,0,3,2
4594,4,1,16006,16006,16007,0,1,1
4595,3,1,16009,16009,16010,0,1,2
4596,4,1,16013,16013,16014,0,1,3
4597,4,3,16017,16017,16020,0,3,3
4598,6,2,16023,16023,16025,0,2,3
4599,1,1,16024,16025,16026,1,2,0
4600,2,1,16026,16026,16027,0,1,0
4601,1,2,16027,16027,16029,0,2,0
4602,6,1,16033,16033,16034,0,1,4
4603,5,3,16038,16038,16041,0,3,4
4604,6,2,16044,16044,16046,0,2,3
4605,4,3,16048,16048,16051,0,3,2
4606,1,2,16049,16051,16053,2,4,0
4607,6,2,16055,16055,16057,0,2,2
4608,4,2,16059,16059,16061,0,2,2
4609,6,2,16065,16065,16067,0,2,4
4610,3,2,16068,16068,16070,0,2,1
4611,3,1,16071,16071,16072,0,1,1
4612,4,2,16075,16075,16077,0,2,3
4613,2,3,16077,16077,16080,0,3,0
4614,3,1,16080,16080,16081,0,1,0
4615,1,1,16081,16081,16082,0,1,0
4616,4,2,16085,16085,16087,0,2,3
4617,1,2,16086,16087,16089,1,3,0
4618,4,1,16090,16090,16091,0,1,1
4619,6,2,16096,16096,16098,0,2,5
4620,2,2,16098,16098,16100,0,2,0
4621,1,1,16099,16100,16101,1,2,0
4622,4,3,16103,16103,16106,0,3,2
4623,3,3,16106,16106,16109,0,3,0
4624,6,3,16112,16112,16115,0,3,3
4625,3,3,16115,16115,16118,0,3,0
4626,3,1,16118,16118,16119,0,1,0
4627,5,1,16123,16123,16124,0,1,4
4628,6,1,16129,16129,16130,0,1,5
4629,3,3,16132,16132,16135,0,3,2
4630,5,3,16137,16137,16140,0,3,2
4631,5,3,16142,16142,16145,0,3,2
4632,5,3,16147,16147,16150,0,3,2
4633,3,2,16150,16150,16152,0,2,0
4634,2,3,16152,16152,16155,0,3,0
4635,4,2,16156,16156,16158,0,2,1
4636,6,2,16162,16162,16164,0,2,4
4637,1,3,16163,16164,16167,1,4,0
4638,3,2,16166,16167,16169,1,3,0
4639,2,1,16168,16169,16170,1,2,0
4640,4,1,16172,16172,16173,0,1,2
4641,5,3,16177,16177,16180,0,3,4
4642,4,1,16181,16181,16182,0,1,1
4643,3,1,16184,16184,16185,0,1,2
4644,3,2,16187,16187,16189,0,2,2
4645,6,3,16193,16193,16196,0,3,4
4646,5,3,16198,16198,16201,0,3,2
4647,6,1,16204,16204,16205,0,1,3
4648,4,1,16208,16208,16209,0,1,3
4649,6,2,16214,16214,16216,0,2,5
4650,6,1,16220,16220,16221,0,1,4
4651,1,2,16221,16221,16223,0,2,0
4652,3,3,16224,16224,16227,0,3,1
4653,1,1,16225,16227,16228,2,3,0
4654,6,3,16231,16231,16234,0,3,3
4655,2,2,16233,16234,16236,1,3,0
4656,3,1,16236,16236,16237,0,1,0
4657,2,1,16238,16238,16239,0,1,1
4658,3,2,16241,16241,16243,0,2,2
4659,6,3,16247,16247,16250,0,3,4
4660,6,1,16253,16253,16254,0,1,3
4661,1,3,16254,16254,16257,0,3,0
4662,2,1,16256,16257,16258,1,2,0
4663,1,2,16257,16258,16260,1,3,0
4664,6,1,16263,16263,16264,0,1,3
4665,3,2,16266,16266,16268,0,2,2
4666,6,2,16272,16272,16274,0,2,4
4667,3,1,16275,16275,16276,0,1,1
4668,2,3,16277,16277,16280,0,3,1
4669,2,3,16279,16280,16283,1,4,0
4670,1,2,16280,16283,16285,3,5,0
4671,4,3,16284,16285,16288,1,4,0
4672,5,2,16289,16289,16291,0,2,1
4673,4,2,16293,16293,16295,0,2,2
4674,5,3,16298,16298,16301,0,3,3
4675,6,1,16304,16304,16305,0,1,3
4676,2,3,16306,16306,16309,0,3,1
4677,4,3,16310,16310,16313,0,3,1
4678,3,1,16313,16313,16314,0,1,0
4679,5,2,16318,16318,16320,0,2,4
4680,4,1,16322,16322,16323,0,1,2
4681,6,2,16328,16328,16330,0,2,5
4682,4,1,16332,16332,16333,0,1,2
4683,2,3,16334,16334,16337,0,3,1
4684,5,1,16339,16339,16340,0,1,2
4685,5,3,16344,16344,16347,0,3,4
4686,4,1,16348,16348,16349,0,1,1
4687,4,3,16352,16352,16355,0,3,3
4688,6,3,16358,16358,16361,0,3,3
4689,5,2,16363,16363,16365,0,2,2
4690,5,1,16368,16368,16369,0,1,3
4691,1,3,16369,16369,16372,0,3,0
4692,4,1,16373,16373,16374,0,1,1
4693,5,1,16378,16378,16379,0,1,4
4694,5,1,16383,16383,16384,0,1,4
4695,1,2,16384,16384,16386,0,2,0
4696,6,1,16390,16390,16391,0,1,4
4697,1,2,16391,16391,16393,0,2,0
4698,3,3,16394,16394,16397,0,3,1
4699,1,3,16395,16397,16400,2,5,0
4700,6,3,16401,16401,16404,0,3,1
4701,1,1,16402,16404,16405,2,3,0
4702,2,3,16404,16405,16408,1,4,0
4703,4,1,16408,16408,16409,0,1,0
4704,4,2,16412,16412,16414,0,2,3
4705,6,1,16418,16418,16419,0,1,4
4706,5,3,16423,16423,16426,0,3,4
4707,5,1,16428,16428,16429,0,1,2
4708,6,2,16434,16434,16436,0,2,5
4709,5,3,16439,16439,16442,0,3,3
4710,6,2,16445,16445,16447,0,2,3
4711,4,2,16449,16449,16451,0,2,2
4712,2,2,16451,16451,16453,0,2,0
4713,6,2,16457,16457,16459,0,2,4
4714,2,1,16459,16459,16460,0,1,0
4715,3,3,16462,16462,16465,0,3,2
4716,2,2,16464,16465,16467,1,3,0
4717,2,3,16466,16467,16470,1,4,0
4718,1,1,16467,16470,16471,3,4,0
4719,4,3,16471,16471,16474,0,3,0
4720,6,3,16477,16477,16480,0,3,3
4721,6,1,16483,16483,16484,0,1,3
4722,4,1,16487,16487,16488,0,1,3
4723,2,3,16489,16489,16492,0,3,1
4724,2,2,16491,16492,16494,1,3,0
4725,3,3,16494,16494,16497,0,3,0
4726,4,2,16498,16498,16500,0,2,1
4727,5,3,16503,16503,16506,0,3,3
4728,2,3,16505,16506,16509,1,4,0
4729,3,2,16508,16509,16511,1,3,0
4730,3,1,16511,16511,16512,0,1,0
4731,2,3,16513,16513,16516,0,3,1
4732,5,1,16518,16518,16519,0,1,2
4733,2,2,16520,16520,16522,0,2,1
4734,3,1,16523,16523,16524,0,1,1
4735,6,1,16529,16529,16530,0,1,5
4736,5,1,16534,16534,16535,0,1,4
4737,3,1,16537,16537,16538,0,1,2
4738,2,3,16539,16539,16542,0,3,1
4739,6,2,16545,16545,16547,0,2,3
4740,2,2,16547,16547,16549,0,2,0
4741,6,3,16553,16553,16556,0,3,4
4742,1,1,16554,16556,16557,2,3,0
4743,5,3,16559,16559,16562,0,3,2
4744,6,3,16565,16565,16568,0,3,3
4745,2,1,16567,16568,16569,1,2,0
4746,3,1,16570,16570,16571,0,1,1
4747,5,2,16575,16575,16577,0,2,4
4748,6,1,16581,16581,16582,0,1,4
4749,6,2,16587,16587,16589,0,2,5
4750,4,3,16591,16591,16594,0,3,2
4751,1,2,16592,16594,16596,2,4,0
4752,3,3,16595,16596,16599,1,4,0
4753,3,1,16598,16599,16600,1,2,0
4754,6,3,16604,16604,16607,0,3,4
4755,4,3,16608,16608,16611,0,3,1
4756,5,1,16613,16613,16614,0,1,2
4757,4,1,16617,16617,16618,0,1,3
4758,6,2,16623,16623,16625,0,2,5
4759,2,3,16625,16625,16628,0,3,0
4760,1,3,16626,16628,16631,2,5,0
4761,1,3,16627,16631,16634,4,7,0
4762,3,2,16630,16634,16636,4,6,0
4763,5,1,16635,16636,16637,1,2,0
4764,2,3,16637,16637,16640,0,3,0
4765,4,3,16641,16641,16644,0,3,1
4766,1,2,16642,16644,16646,2,4,0
4767,6,1,16648,16648,16649,0,1,2
4768,2,1,16650,16650,16651,0,1,1
4769,4,2,16654,16654,16656,0,2,3
4770,4,1,16658,16658,16659,0,1,2
4771,1,1,16659,16659,16660,0,1,0
4772,1,3,16660,16660,16663,0,3,0
4773,6,1,16666,16666,16667,0,1,3
4774,6,1,16672,16672,16673,0,1,5
4775,4,2,16676,16676,16678,0,2,3
4776,6,1,16682,16682,16683,0,1,4
4777,1,1,16683,16683,16684,0,1,0
4778,5,2,16688,16688,16690,0,2,4
4779,4,2,16692,16692,16694,0,2,2
4780,2,2,16694,16694,16696,0,2,0
4781,5,3,16699,16699,16702,0,3,3
4782,4,1,16703,16703,16704,0,1,1
4783,5,3,16708,16708,16711,0,3,4
4784,4,1,16712,16712,16713,0,1,1
4785,1,3,16713,16713,16716,0,3,0
4786,2,2,16715,16716,16718,1,3,0
4787,3,3,16718,16718,16721,0,3,0
4788,5,2,16723,16723,16725,0,2,2
4789,3,3,16726,16726,16729,0,3,1
4790,4,1,16730,16730,16731,0,1,1
4791,4,1,16734,16734,16735,0,1,3
4792,2,2,16736,16736,16738,0,2,1
4793,4,2,16740,16740,16742,0,2,2
4794,3,3,16743,16743,16746,0,3,1
4795,2,1,16745,16746,16747,1,2,0
4796,2,1,16747,16747,16748,0,1,0
4797,6,1,16753,16753,16754,0,1,5
4798,5,1,16758,16758,16759,0,1,4
4799,3,3,16761,16761,16764,0,3,2
4800,6,1,16767,16767,16768,0,1,3
4801,3,1,16770,16770,16771,0,1,2
4802,6,1,16776,16776,16777,0,1,5
4803,4,1,16780,16780,16781,0,1,3
4804,5,3,16785,16785,16788,0,3,4
4805,6,1,16791,16791,16792,0,1,3
4806,2,2,16793,16793,16795,0,2,1
4807,5,1,16798,16798,16799,0,1,3
4808,3,2,16801,16801,16803,0,2,2
4809,3,3,16804,16804,16807,0,3,1
4810,2,2,16806,16807,16809,1,3,0
4811,3,2,16809,16809,16811,0,2,0
4812,5,3,16814,16814,16817,0,3,3
4813,6,2,16820,16820,16822,0,2,3
4814,2,3,16822,16822,16825,0,3,0
4815,2,1,16824,16825,16826,1,2,0
4816,4,3,16828,16828,16831,0,3,2
4817,1,3,16829,16831,16834,2,5,0
4818,2,3,16831,16834,16837,3,6,0
4819,5,2,16836,16837,16839,1,3,0
4820,3,2,16839,16839,16841,0,2,0
4821,4,1,16843,16843,16844,0,1,2
4822,3,3,16846,16846,16849,0,3,2
4823,3,2,16849,16849,16851,0,2,0
4824,1,2,16850,16851,16853,1,3,0
4825,4,1,16854,16854,16855,0,1,1
4826,5,2,16859,16859,16861,0,2,4
4827,5,3,16864,16864,16867,0,3,3
4828,1,1,16865,16867,16868,2,3,0
4829,2,3,16867,16868,16871,1,4,0
4830,6,2,16873,16873,16875,0,2,2
4831,1,2,16874,16875,16877,1,3,0
4832,1,2,16875,16877,16879,2,4,0
4833,4,2,16879,16879,16881,0,2,0
4834,5,1,16884,16884,16885,0,1,3
4835,2,2,16886,16886,16888,0,2,1
4836,6,1,16892,16892,16893,0,1,4
4837,3,3,16895,16895,16898,0,3,2
4838,4,1,16899,16899,16900,0,1,1
4839,3,1,16902,16902,16903,0,1,2
4840,2,2,16904,16904,16906,0,2,1
4841,4,2,16908,16908,16910,0,2,2
4842,1,3,16909,16910,16913,1,4,0
4843,2,1,16911,16913,16914,2,3,0
4844,4,2,16915,16915,16917,0,2,1
4845,2,3,16917,16917,16920,0,3,0
4846,4,2,16921,16921,16923,0,2,1
4847,5,2,16926,16926,16928,0,2,3
4848,2,1,16928,16928,16929,0,1,0
4849,2,3,16930,16930,16933,0,3,1
4850,3,3,16933,16933,16936,0,3,0
4851,5,3,16938,16938,16941,0,3,2
4852,1,3,16939,16941,16944,2,5,0
4853,2,1,16941,16944,16945,3,4,0
4854,1,3,16942,16945,16948,3,6,0
4855,1,2,16943,16948,16950,5,7,0
4856,4,3,16947,16950,16953,3,6,0
4857,1,3,16948,16953,16956,5,8,0
4858,2,1,16950,16956,16957,6,7,0
4859,6,1,16956,16957,16958,1,2,0
4860,5,2,16961,16961,16963,0,2,3
4861,4,3,16965,16965,16968,0,3,2
4862,5,2,16970,16970,16972,0,2,2
4863,6,2,16976,16976,16978,0,2,4
4864,4,1,16980,16980,16981,0,1,2
4865,4,3,16984,16984,16987,0,3,3
4866,2,2,16986,16987,16989,1,3,0
4867,6,1,16992,16992,16993,0,1,3
4868,4,3,16996,16996,16999,0,3,3
4869,4,1,17000,17000,17001,0,1,1
4870,1,3,17001,17001,17004,0,3,0
4871,5,3,17006,17006,17009,0,3,2
4872,6,2,17012,17012,17014,0,2,3
4873,4,1,17016,17016,17017,0,1,2
4874,3,2,17019,17019,17021,0,2,2
4875,5,3,17024,17024,17027,0,3,3
4876,5,1,17029,17029,17030,0,1,2
4877,5,1,17034,17034,17035,0,1,4
4878,5,3,17039,17039,17042,0,3,4
4879,1,2,17040,17042,17044,2,4,0
4880,5,1,17045,17045,17046,0,1,1
4881,3,1,17048,17048,17049,0,1,2
4882,6,1,17054,17054,17055,0,1,5
4883,1,2,17055,17055,17057,0,2,0
4884,2,3,17057,17057,17060,0,3,0
4885,6,1,17063,17063,17064,0,1,3
4886,4,3,17067,17067,17070,0,3,3
4887,1,1,17068,17070,17071,2,3,0
4888,6,2,17074,17074,17076,0,2,3
4889,2,2,17076,17076,17078,0,2,0
4890,1,1,17077,17078,17079,1,2,0
4891,3,3,17080,17080,17083,0,3,1
4892,4,3,17084,17084,17087,0,3,1
4893,1,2,17085,17087,17089,2,4,0
4894,6,3,17091,17091,17094,0,3,2
4895,4,2,17095,17095,17097,0,2,1
4896,4,3,17099,17099,17102,0,3,2
4897,3,2,17102,17102,17104,0,2,0
4898,4,2,17106,17106,17108,0,2,2
4899,5,1,17111,17111,17112,0,1,3
4900,3,3,17114,17114,17117,0,3,2
4901,1,2,17115,17117,17119,2,4,0
4902,2,1,17117,17119,17120,2,3,0
4903,2,3,17119,17120,17123,1,4,0
4904,1,1,17120,17123,17124,3,4,0
4905,1,3,17121,17124,17127,3,6,0
4906,3,1,17124,17127,17128,3,4,0
4907,4,2,17128,17128,17130,0,2,0
4908,2,2,17130,17130,17132,0,2,0
4909,1,3,17131,17132,17135,1,4,0
4910,3,2,17134,17135,17137,1,3,0
4911,5,2,17139,17139,17141,0,2,2
4912,1,2,17140,17141,17143,1,3,0
4913,6,3,17146,17146,17149,0,3,3
4914,4,3,17150,17150,17153,0,3,1
4915,2,1,17152,17153,17154,1,2,0
4916,5,2,17157,17157,17159,0,2,3
4917,2,2,17159,17159,17161,0,2,0
4918,2,3,17161,17161,17164,0,3,0
4919,2,2,17163,17164,17166,1,3,0
4920,4,1,17167,17167,17168,0,1,1
4921,5,1,17172,17172,17173,0,1,4
4922,1,3,17173,17173,17176,0,3,0
4923,2,3,17175,17176,17179,1,4,0
4924,3,3,17178,17179,17182,1,4,0
4925,1,1,17179,17182,17183,3,4,0
4926,2,3,17181,17183,17186,2,5,0
4927,5,3,17186,17186,17189,0,3,0
4928,6,1,17192,17192,17193,0,1,3
4929,6,3,17198,17198,17201,0,3,5
4930,5,2,17203,17203,17205,0,2,2
4931,5,1,17208,17208,17209,0,1,3
4932,4,2,17212,17212,17214,0,2,3
4933,6,2,17218,17218,17220,0,2,4
4934,6,3,17224,17224,17227,0,3,4
4935,1,3,17225,17227,17230,2,5,0
4936,1,2,17226,17230,17232,4,6,0
4937,6,2,17232,17232,17234,0,2,0
4938,4,2,17236,17236,17238,0,2,2
4939,5,3,17241,17241,17244,0,3,3
4940,4,1,17245,17245,17246,0,1,1
4941,1,2,17246,17246,17248,0,2,0
4942,2,1,17248,17248,17249,0,1,0
4943,3,3,17251,17251,17254,0,3,2
4944,4,1,17255,17255,17256,0,1,1
4945,1,1,17256,17256,17257,0,1,0
4946,5,3,17261,17261,17264,0,3,4
4947,6,3,17267,17267,17270,0,3,3
4948,5,2,17272,17272,17274,0,2,2
4949,3,3,17275,17275,17278,0,3,1
4950,6,2,17281,17281,17283,0,2,3
4951,6,3,17287,17287,17290,0,3,4
4952,5,1,17292,17292,17293,0,1,2
4953,1,2,17293,17293,17295,0,2,0
4954,6,1,17299,17299,17300,0,1,4
4955,3,2,17302,17302,17304,0,2,2
4956,2,2,17304,17304,17306,0,2,0
4957,6,3,17310,17310,17313,0,3,4
4958,4,2,17314,17314,17316,0,2,1
4959,2,1,17316,17316,17317,0,1,0
4960,5,3,17321,17321,17324,0,3,4
4961,5,3,17326,17326,17329,0,3,2
4962,1,3,17327,17329,17332,2,5,0
4963,5,2,17332,17332,17334,0,2,0
4964,2,3,17334,17334,17337,0,3,0
4965,3,3,17337,17337,17340,0,3,0
4966,4,1,17341,17341,17342,0,1,1
4967,1,3,17342,17342,17345,0,3,0
4968,4,1,17346,17346,17347,0,1,1
4969,3,1,17349,17349,17350,0,1,2
4970,3,3,17352,17352,17355,0,3,2
4971,2,2,17354,17355,17357,1,3,0
4972,5,2,17359,17359,17361,0,2,2
4973,3,2,17362,17362,17364,0,2,1
4974,2,3,17364,17364,17367,0,3,0
4975,6,2,17370,17370,17372,0,2,3
4976,3,1,17373,17373,17374,0,1,1
4977,4,3,17377,17377,17380,0,3,3
4978,1,1,17378,17380,17381,2,3,0
4979,4,3,17382,17382,17385,0,3,1
4980,3,3,17385,17385,17388,0,3,0
4981,6,2,17391,17391,17393,0,2,3
4982,5,2,17396,17396,17398,0,2,3
4983,2,2,17398,17398,17400,0,2,0
4984,5,1,17403,17403,17404,0,1,3
4985,1,2,17404,17404,17406,0,2,0
4986,4,1,17408,17408,17409,0,1,2
4987,2,2,17410,17410,17412,0,2,1
4988,4,1,17414,17414,17415,0,1,2
4989,1,1,17415,17415,17416,0,1,0
4990,2,3,17417,17417,17420,0,3,1
4991,3,1,17420,17420,17421,0,1,0
4992,5,1,17425,17425,17426,0,1,4
4993,2,1,17427,17427,17428,0,1,1
4994,6,2,17433,17433,17435,0,2,5
4995,1,1,17434,17435,17436,1,2,0
4996,1,1,17435,17436,17437,1,2,0
4997,5,1,17440,17440,17441,0,1,3
4998,6,1,17446,17446,17447,0,1,5
4999,4,1,17450,17450,17451,0,1,3
5000,5,3,17455,17455,17458,0,3,4
5001,6,2,17461,17461,17463,0,2,3
5002,5,3,17466,17466,17469,0,3,3
5003,3,3,17469,17469,17472,0,3,0
5004,4,3,17473,17473,17476,0,3,1
5005,4,3,17477,17477,17480,0,3,1
5006,1,1,17478,17480,17481,2,3,0
5007,4,3,17482,17482,17485,0,3,1
5008,2,1,17484,17485,17486,1,2,0
5009,1,3,17485,17486,17489,1,4,0
5010,4,2,17489,17489,17491,0,2,0
5011,6,1,17495,17495,17496,0,1,4
5012,3,1,17498,17498,17499,0,1,2
5013,5,1,17503,17503,17504,0,1,4
5014,4,1,17507,17507,17508,0,1,3
5015,3,3,17510,17510,17513,0,3,2
5016,5,2,17515,17515,17517,0,2,2
5017,4,3,17519,17519,17522,0,3,2
5018,6,3,17525,17525,17528,0,3,3
5019,1,2,17526,17528,17530,2,4,0
5020,2,3,17528,17530,17533,2,5,0
5021,3,3,17531,17533,17536,2,5,0
5022,1,2,17532,17536,17538,4,6,0
5023,1,2,17533,17538,17540,5,7,0
5024,3,3,17536,17540,17543,4,7,0
5025,2,1,17538,17543,17544,5,6,0
5026,1,3,17539,17544,17547,5,8,0
5027,1,2,17540,17547,17549,7,9,0
5028,4,1,17544,17549,17550,5,6,0
5029,6,3,17550,17550,17553,0,3,0
5030,2,1,17552,17553,17554,1,2,0
5031,1,2,17553,17554,17556,1,3,0
5032,5,3,17558,17558,17561,0,3,2
5033,4,2,17562,17562,17564,0,2,1
5034,2,3,17564,17564,17567,0,3,0
5035,4,3,17568,17568,17571,0,3,1
5036,1,1,17569,17571,17572,2,3,0
5037,3,1,17572,17572,17573,0,1,0
5038,5,1,17577,17577,17578,0,1,4
5039,4,1,17581,17581,17582,0,1,3
5040,2,3,17583,17583,17586,0,3,1
5041,4,2,17587,17587,17589,0,2,1
5042,2,2,17589,17589,17591,0,2,0
5043,3,3,17592,17592,17595,0,3,1
5044,6,3,17598,17598,17601,0,3,3
5045,6,3,17604,17604,17607,0,3,3
5046,1,3,17605,17607,17610,2,5,0
5047,4,1,17609,17610,17611,1,2,0
5048,3,1,17612,17612,17613,0,1,1
5049,6,3,17618,17618,17621,0,3,5
5050,3,1,17621,17621,17622,0,1,0
5051,6,2,17627,17627,17629,0,2,5
5052,5,3,17632,17632,17635,0,3,3
5053,3,1,17635,17635,17636,0,1,0
5054,2,2,17637,17637,17639,0,2,1
5055,4,1,17641,17641,17642,0,1,2
5056,1,2,17642,17642,17644,0,2,0
5057,4,3,17646,17646,17649,0,3,2
5058,4,2,17650,17650,17652,0,2,1
5059,5,2,17655,17655,17657,0,2,3
5060,4,2,17659,17659,17661,0,2,2
5061,2,2,17661,17661,17663,0,2,0
5062,4,2,17665,17665,17667,0,2,2
5063,3,3,17668,17668,17671,0,3,1
5064,3,3,17671,17671,17674,0,3,0
5065,6,1,17677,17677,17678,0,1,3
5066,1,3,17678,17678,17681,0,3,0
5067,4,1,17682,17682,17683,0,1,1
5068,3,1,17685,17685,17686,0,1,2
5069,4,2,17689,17689,17691,0,2,3
5070,4,2,17693,17693,17695,0,2,2
5071,3,2,17696,17696,17698,0,2,1
5072,2,1,17698,17698,17699,0,1,0
5073,4,3,17702,17702,17705,0,3,3
5074,3,1,17705,17705,17706,0,1,0
5075,2,2,17707,17707,17709,0,2,1
5076,2,3,17709,17709,17712,0,3,0
5077,2,1,17711,17712,17713,1,2,0
5078,2,1,17713,17713,17714,0,1,0
5079,2,2,17715,17715,17717,0,2,1
5080,1,1,17716,17717,17718,1,2,0
5081,6,3,17722,17722,17725,0,3,4
5082,3,3,17725,17725,17728,0,3,0
5083,5,1,17730,17730,17731,0,1,2
5084,1,3,17731,17731,17734,0,3,0
5085,3,2,17734,17734,17736,0,2,0
5086,1,3,17735,17736,17739,1,4,0
5087,6,1,17741,17741,17742,0,1,2
5088,4,2,17745,17745,17747,0,2,3
5089,4,3,17749,17749,17752,0,3,2
5090,1,2,17750,17752,17754,2,4,0
5091,2,1,17752,17754,17755,2,3,0
5092,3,1,17755,17755,17756,0,1,0
5093,2,3,17757,17757,17760,0,3,1
5094,4,2,17761,17761,17763,0,2,1
5095,2,1,17763,17763,17764,0,1,0
5096,5,1,17768,17768,17769,0,1,4
5097,6,3,17774,17774,17777,0,3,5
5098,6,2,17780,17780,17782,0,2,3
5099,3,3,17783,17783,17786,0,3,1
5100,6,2,17789,17789,17791,0,2,3
5101,2,3,17791,17791,17794,0,3,0
5102,4,1,17795,17795,17796,0,1,1
5103,5,2,17800,17800,17802,0,2,4
5104,5,2,17805,17805,17807,0,2,3
5105,1,1,17806,17807,17808,1,2,0
5106,4,1,17810,17810,17811,0,1,2
5107,4,2,17814,17814,17816,0,2,3
5108,1,2,17815,17816,17818,1,3,0
5109,1,1,17816,17818,17819,2,3,0
5110,4,2,17820,17820,17822,0,2,1
5111,1,3,17821,17822,17825,1,4,0
5112,3,1,17824,17825,17826,1,2,0
5113,4,2,17828,17828,17830,0,2,2
5114,6,1,17834,17834,17835,0,1,4
5115,3,2,17837,17837,17839,0,2,2
5116,3,3,17840,17840,17843,0,3,1
5117,6,1,17846,17846,17847,0,1,3
5118,1,3,17847,17847,17850,0,3,0
5119,4,2,17851,17851,17853,0,2,1
5120,5,1,17856,17856,17857,0,1,3
5121,2,3,17858,17858,17861,0,3,1
5122,4,3,17862,17862,17865,0,3,1
5123,2,2,17864,17865,17867,1,3,0
5124,6,1,17870,17870,17871,0,1,3
5125,1,1,17871,17871,17872,0,1,0
5126,4,2,17875,17875,17877,0,2,3
5127,4,1,17879,17879,17880,0,1,2
5128,6,1,17885,17885,17886,0,1,5
5129,3,2,17888,17888,17890,0,2,2
5130,1,1,17889,17890,17891,1,2,0
5131,1,3,17890,17891,17894,1,4,0
5132,1,3,17891,17894,17897,3,6,0
5133,5,2,17896,17897,17899,1,3,0
5134,3,3,17899,17899,17902,0,3,0
5135,6,3,17905,17905,17908,0,3,3
5136,4,1,17909,17909,17910,0,1,1
5137,2,1,17911,17911,17912,0,1,1
5138,4,1,17915,17915,17916,0,1,3
5139,5,3,17920,17920,17923,0,3,4
5140,5,3,17925,17925,17928,0,3,2
5141,3,2,17928,17928,17930,0,2,0
5142,2,2,17930,17930,17932,0,2,0
5143,5,3,17935,17935,17938,0,3,3
5144,5,2,17940,17940,17942,0,2,2
5145,2,1,17942,17942,17943,0,1,0
5146,2,2,17944,17944,17946,0,2,1
5147,4,2,17948,17948,17950,0,2,2
5148,2,1,17950,17950,17951,0,1,0
5149,6,1,17956,17956,17957,0,1,5
5150,6,2,17962,17962,17964,0,2,5
5151,4,1,17966,17966,17967,0,1,2
5152,4,3,17970,17970,17973,0,3,3
5153,2,3,17972,17973,17976,1,4,0
5154,4,1,17976,17976,17977,0,1,0
5155,6,2,17982,17982,17984,0,2,5
5156,6,2,17988,17988,17990,0,2,4
5157,2,2,17990,17990,17992,0,2,0
5158,2,2,17992,17992,17994,0,2,0
5159,5,1,17997,17997,17998,0,1,3
5160,4,3,18001,18001,18004,0,3,3
5161,5,2,18006,18006,18008,0,2,2
5162,5,1,18011,18011,18012,0,1,3
5163,2,2,18013,18013,18015,0,2,1
5164,1,3,18014,18015,18018,1,4,0
5165,5,1,18019,18019,18020,0,1,1
5166,5,3,18024,18024,18027,0,3,4
5167,6,1,18030,18030,18031,0,1,3
5168,3,1,18033,18033,18034,0,1,2
5169,4,2,18037,18037,18039,0,2,3
5170,6,1,18043,18043,18044,0,1,4
5171,2,3,18045,18045,18048,0,3,1
5172,6,1,18051,18051,18052,0,1,3
5173,5,3,18056,18056,18059,0,3,4
5174,5,1,18061,18061,18062,0,1,2
5175,2,1,18063,18063,18064,0,1,1
5176,1,1,18064,18064,18065,0,1,0
5177,6,2,18070,18070,18072,0,2,5
5178,2,1,18072,18072,18073,0,1,0
5179,2,2,18074,18074,18076,0,2,1
5180,1,1,18075,18076,18077,1,2,0
5181,6,2,18081,18081,18083,0,2,4
5182,5,1,18086,18086,18087,0,1,3
5183,6,2,18092,18092,18094,0,2,5
5184,5,2,18097,18097,18099,0,2,3
5185,1,2,18098,18099,18101,1,3,0
5186,1,1,18099,18101,18102,2,3,0
5187,6,1,18105,18105,18106,0,1,3
5188,4,3,18109,18109,18112,0,3,3
5189,1,1,18110,18112,18113,2,3,0
5190,2,2,18112,18113,18115,1,3,0
5191,1,1,18113,18115,18116,2,3,0
5192,1,2,18114,18116,18118,2,4,0
5193,1,1,18115,18118,18119,3,4,0
5194,5,2,18120,18120,18122,0,2,1
5195,2,1,18122,18122,18123,0,1,0
5196,5,2,18127,18127,18129,0,2,4
5197,4,2,18131,18131,18133,0,2,2
5198,4,1,18135,18135,18136,0,1,2
5199,5,1,18140,18140,18141,0,1,4
5200,6,3,18146,18146,18149,0,3,5
5201,1,1,18147,18149,18150,2,3,0
5202,2,2,18149,18150,18152,1,3,0
5203,1,1,18150,18152,18153,2,3,0
5204,1,2,18151,18153,18155,2,4,0
5205,6,1,18157,18157,18158,0,1,2
5206,3,3,18160,18160,18163,0,3,2
5207,2,2,18162,18163,18165,1,3,0
5208,1,2,18163,18165,18167,2,4,0
5209,2,1,18165,18167,18168,2,3,0
5210,2,3,18167,18168,18171,1,4,0
5211,4,2,18171,18171,18173,0,2,0
5212,6,1,18177,18177,18178,0,1,4
5213,2,3,18179,18179,18182,0,3,1
5214,4,2,18183,18183,18185,0,2,1
5215,5,2,18188,18188,18190,0,2,3
5216,2,2,18190,18190,18192,0,2,0
5217,2,1,18192,18192,18193,0,1,0
5218,3,1,18195,18195,18196,0,1,2
5219,3,3,18198,18198,18201,0,3,2
5220,3,2,18201,18201,18203,0,2,0
5221,3,2,18204,18204,18206,0,2,1
5222,5,1,18209,18209,18210,0,1,3
5223,1,3,18210,18210,18213,0,3,0
5224,1,2,18211,18213,18215,2,4,0
5225,1,1,18212,18215,18216,3,4,0
5226,2,2,18214,18216,18218,2,4,0
5227,6,2,18220,18220,18222,0,2,2
5228,3,3,18223,18223,18226,0,3,1
5229,1,3,18224,18226,18229,2,5,0
5230,4,2,18228,18229,18231,1,3,0
5231,2,2,18230,18231,18233,1,3,0
5232,5,1,18235,18235,18236,0,1,2
5233,2,3,18237,18237,18240,0,3,1
5234,4,1,18241,18241,18242,0,1,1
5235,1,2,18242,18242,18244,0,2,0
5236,5,1,18247,18247,18248,0,1,3
5237,6,1,18253,18253,18254,0,1,5
5238,3,1,18256,18256,18257,0,1,2
5239,6,2,18262,18262,18264,0,2,5
5240,5,2,18267,18267,18269,0,2,3
5241,2,3,18269,18269,18272,0,3,0
5242,5,3,18274,18274,18277,0,3,2
5243,1,3,18275,18277,18280,2,5,0
5244,4,2,18279,18280,18282,1,3,0
5245,5,3,18284,18284,18287,0,3,2
5246,2,2,18286,18287,18289,1,3,0
5247,1,3,18287,18289,18292,2,5,0
5248,2,3,18289,18292,18295,3,6,0
5249,1,2,18290,18295,18297,5,7,0
5250,3,3,18293,18297,18300,4,7,0
5251,5,3,18298,18300,18303,2,5,0
5252,5,2,18303,18303,18305,0,2,0
5253,5,3,18308,18308,18311,0,3,3
5254,3,2,18311,18311,18313,0,2,0
5255,5,1,18316,18316,18317,0,1,3
5256,2,1,18318,18318,18319,0,1,1
5257,5,3,18323,18323,18326,0,3,4
5258,6,1,18329,18329,18330,0,1,3
5259,5,2,18334,18334,18336,0,2,4
5260,1,1,18335,18336,18337,1,2,0
5261,5,1,18340,18340,18341,0,1,3
5262,2,2,18342,18342,18344,0,2,1
5263,2,1,18344,18344,18345,0,1,0
5264,3,2,18347,18347,18349,0,2,2
5265,4,2,18351,18351,18353,0,2,2
5266,4,1,18355,18355,18356,0,1,2
5267,3,1,18358,18358,18359,0,1,2
5268,1,3,18359,18359,18362,0,3,0
5269,5,3,18364,18364,18367,0,3,2
5270,1,1,18365,18367,18368,2,3,0
5271,6,3,18371,18371,18374,0,3,3
5272,6,2,18377,18377,18379,0,2,3
5273,1,1,18378,18379,18380,1,2,0
5274,3,2,18381,18381,18383,0,2,1
5275,6,2,18387,18387,18389,0,2,4
5276,4,1,18391,18391,18392,0,1,2
5277,1,1,18392,18392,18393,0,1,0
5278,1,2,18393,18393,18395,0,2,0
5279,4,1,18397,18397,18398,0,1,2
5280,5,3,18402,18402,18405,0,3,4
5281,6,1,18408,18408,18409,0,1,3
5282,2,1,18410,18410,18411,0,1,1
5283,2,3,18412,18412,18415,0,3,1
5284,2,1,18414,18415,18416,1,2,0
5285,6,3,18420,18420,18423,0,3,4
5286,4,1,18424,18424,18425,0,1,1
5287,3,1,18427,18427,18428,0,1,2
5288,6,1,18433,18433,18434,0,1,5
5289,1,1,18434,18434,18435,0,1,0
5290,1,1,18435,18435,18436,0,1,0
5291,1,3,18436,18436,18439,0,3,0
5292,5,1,18441,18441,18442,0,1,2
5293,2,1,18443,18443,18444,0,1,1
5294,4,1,18447,18447,18448,0,1,3
5295,4,3,18451,18451,18454,0,3,3
5296,4,1,18455,18455,18456,0,1,1
5297,1,2,18456,18456,18458,0,2,0
5298,3,3,18459,18459,18462,0,3,1
5299,1,1,18460,18462,18463,2,3,0
5300,5,2,18465,18465,18467,0,2,2
5301,3,3,18468,18468,18471,0,3,1
5302,6,2,18474,18474,18476,0,2,3
5303,4,3,18478,18478,18481,0,3,2
5304,3,1,18481,18481,18482,0,1,0
5305,5,3,18486,18486,18489,0,3,4
5306,6,1,18492,18492,18493,0,1,3
5307,4,1,18496,18496,18497,0,1,3
5308,1,2,18497,18497,18499,0,2,0
5309,1,1,18498,18499,18500,1,2,0
5310,5,3,18503,18503,18506,0,3,3
5311,5,1,18508,18508,18509,0,1,2
5312,2,2,18510,18510,18512,0,2,1
5313,6,3,18516,18516,18519,0,3,4
5314,6,2,18522,18522,18524,0,2,3
5315,5,1,18527,18527,18528,0,1,3
5316,5,2,18532,18532,18534,0,2,4
5317,2,3,18534,18534,18537,0,3,0
5318,1,2,18535,18537,18539,2,4,0
5319,3,3,18538,18539,18542,1,4,0
5320,1,3,18539,18542,18545,3,6,0
5321,5,3,18544,18545,18548,1,4,0
5322,5,1,18549,18549,18550,0,1,1
5323,6,2,18555,18555,18557,0,2,5
5324,4,2,18559,18559,18561,0,2,2
5325,4,2,18563,18563,18565,0,2,2
5326,6,2,18569,18569,18571,0,2,4
5327,3,1,18572,18572,18573,0,1,1
5328,4,3,18576,18576,18579,0,3,3
5329,6,1,18582,18582,18583,0,1,3
5330,4,3,18586,18586,18589,0,3,3
5331,3,3,18589,18589,18592,0,3,0
5332,1,1,18590,18592,18593,2,3,0
5333,3,3,18593,18593,18596,0,3,0
5334,2,1,18595,18596,18597,1,2,0
5335,6,3,18601,18601,18604,0,3,4
5336,2,2,18603,18604,18606,1,3,0
5337,3,3,18606,18606,18609,0,3,0
5338,1,3,18607,18609,18612,2,5,0
5339,4,3,18611,18612,18615,1,4,0
5340,4,2,18615,18615,18617,0,2,0
5341,3,1,18618,18618,18619,0,1,1
5342,4,3,18622,18622,18625,0,3,3
5343,5,1,18627,18627,18628,0,1,2
5344,4,3,18631,18631,18634,0,3,3
5345,3,3,18634,18634,18637,0,3,0
5346,1,3,18635,18637,18640,2,5,0
5347,2,2,18637,18640,18642,3,5,0
5348,3,1,18640,18642,18643,2,3,0
5349,3,2,18643,18643,18645,0,2,0
5350,3,1,18646,18646,18647,0,1,1
5351,1,1,18647,18647,18648,0,1,0
5352,5,2,18652,18652,18654,0,2,4
5353,6,2,18658,18658,18660,0,2,4
5354,5,3,18663,18663,18666,0,3,3
5355,5,2,18668,18668,18670,0,2,2
5356,6,1,18674,18674,18675,0,1,4
5357,2,1,18676,18676,18677,0,1,1
5358,1,2,18677,18677,18679,0,2,0
5359,5,2,18682,18682,18684,0,2,3
5360,6,2,18688,18688,18690,0,2,4
5361,1,2,18689,18690,18692,1,3,0
5362,2,3,18691,18692,18695,1,4,0
5363,6,2,18697,18697,18699,0,2,2
5364,2,3,18699,18699,18702,0,3,0
5365,3,3,18702,18702,18705,0,3,0
5366,1,2,18703,18705,18707,2,4,0
5367,2,3,18705,18707,18710,2,5,0
5368,4,1,18709,18710,18711,1,2,0
5369,3,3,18712,18712,18715,0,3,1
5370,2,2,18714,18715,18717,1,3,0
5371,1,2,18715,18717,18719,2,4,0
5372,4,3,18719,18719,18722,0,3,0
5373,3,2,18722,18722,18724,0,2,0
5374,6,1,18728,18728,18729,0,1,4
5375,4,3,18732,18732,18735,0,3,3
5376,1,2,18733,18735,18737,2,4,0
5377,1,1,18734,18737,18738,3,4,0
5378,1,1,18735,18738,18739,3,4,0
5379,2,3,18737,18739,18742,2,5,0
5380,3,1,18740,18742,18743,2,3,0
5381,4,3,18744,18744,18747,0,3,1
5382,1,1,18745,18747,18748,2,3,0
5383,3,2,18748,18748,18750,0,2,0
5384,2,1,18750,18750,18751,0,1,0
5385,4,1,18754,18754,18755,0,1,3
5386,3,2,18757,18757,18759,0,2,2
5387,4,1,18761,18761,18762,0,1,2
5388,4,3,18765,18765,18768,0,3,3
5389,5,2,18770,18770,18772,0,2,2
5390,3,1,18773,18773,18774,0,1,1
5391,1,3,18774,18774,18777,0,3,0
5392,3,2,18777,18777,18779,0,2,0
5393,2,2,18779,18779,18781,0,2,0
5394,2,1,18781,18781,18782,0,1,0
5395,6,1,18787,18787,18788,0,1,5
5396,1,2,18788,18788,18790,0,2,0
5397,1,2,18789,18790,18792,1,3,0
5398,6,3,18795,18795,18798,0,3,3
5399,1,3,18796,18798,18801,2,5,0
5400,4,3,18800,18801,18804,1,4,0
5401,3,2,18803,18804,18806,1,3,0
5402,3,1,18806,18806,18807,0,1,0
5403,3,1,18809,18809,18810,0,1,2
5404,3,2,18812,18812,18814,0,2,2
5405,3,3,18815,18815,18818,0,3,1
5406,2,3,18817,18818,18821,1,4,0
5407,1,1,18818,18821,18822,3,4,0
5408,1,3,18819,18822,18825,3,6,0
5409,5,3,18824,18825,18828,1,4,0
5410,2,3,18826,18828,18831,2,5,0
5411,5,1,18831,18831,18832,0,1,0
5412,4,2,18835,18835,18837,0,2,3
5413,2,1,18837,18837,18838,0,1,0
5414,5,3,18842,18842,18845,0,3,4
5415,2,3,18844,18845,18848,1,4,0
5416,2,3,18846,18848,18851,2,5,0
5417,3,3,18849,18851,18854,2,5,0
5418,1,3,18850,18854,18857,4,7,0
5419,6,3,18856,18857,18860,1,4,0
5420,5,1,18861,18861,18862,0,1,1
5421,3,1,18864,18864,18865,0,1,2
5422,6,2,18870,18870,18872,0,2,5
5423,3,2,18873,18873,18875,0,2,1
5424,6,1,18879,18879,18880,0,1,4
5425,4,2,18883,18883,18885,0,2,3
5426,5,1,18888,18888,18889,0,1,3
5427,3,3,18891,18891,18894,0,3,2
5428,4,3,18895,18895,18898,0,3,1
5429,5,3,18900,18900,18903,0,3,2
5430,4,3,18904,18904,18907,0,3,1
5431,1,1,18905,18907,18908,2,3,0
5432,6,3,18911,18911,18914,0,3,3
5433,1,3,18912,18914,18917,2,5,0
5434,4,2,18916,18917,18919,1,3,0
5435,3,2,18919,18919,18921,0,2,0
5436,6,1,18925,18925,18926,0,1,4
5437,1,1,18926,18926,18927,0,1,0
5438,3,3,18929,18929,18932,0,3,2
5439,2,2,18931,18932,18934,1,3,0
5440,1,3,18932,18934,18937,2,5,0
5441,2,2,18934,18937,18939,3,5,0
5442,4,1,18938,18939,18940,1,2,0
5443,2,3,18940,18940,18943,0,3,0
5444,6,3,18946,18946,18949,0,3,3
5445,6,2,18952,18952,18954,0,2,3
5446,5,1,18957,18957,18958,0,1,3
5447,1,1,18958,18958,18959,0,1,0
5448,3,1,18961,18961,18962,0,1,2
5449,1,3,18962,18962,18965,0,3,0
5450,1,3,18963,18965,18968,2,5,0
5451,1,3,18964,18968,18971,4,7,0
5452,6,1,18970,18971,18972,1,2,0
5453,1,2,18971,18972,18974,1,3,0
5454,5,1,18976,18976,18977,0,1,2
5455,4,1,18980,18980,18981,0,1,3
5456,2,3,18982,18982,18985,0,3,1
5457,6,3,18988,18988,18991,0,3,3
5458,5,1,18993,18993,18994,0,1,2
5459,1,2,18994,18994,18996,0,2,0
5460,2,2,18996,18996,18998,0,2,0
5461,5,2,19001,19001,19003,0,2,3
5462,4,3,19005,19005,19008,0,3,2
5463,5,3,19010,19010,19013,0,3,2
5464,3,2,19013,19013,19015,0,2,0
5465,5,3,19018,19018,19021,0,3,3
5466,3,1,19021,19021,19022,0,1,0
5467,3,1,19024,19024,19025,0,1,2
5468,5,2,19029,19029,19031,0,2,4
5469,5,3,19034,19034,19037,0,3,3
5470,5,1,19039,19039,19040,0,1,2
5471,6,2,19045,19045,19047,0,2,5
5472,4,3,19049,19049,19052,0,3,2
5473,1,1,19050,19052,19053,2,3,0
5474,6,2,19056,19056,19058,0,2,3
5475,4,2,19060,19060,19062,0,2,2
5476,2,2,19062,19062,19064,0,2,0
5477,6,1,19068,19068,19069,0,1,4
5478,2,1,19070,19070,19071,0,1,1
5479,5,2,19075,19075,19077,0,2,4
5480,1,2,19076,19077,19079,1,3,0
5481,1,1,19077,19079,19080,2,3,0
5482,1,3,19078,19080,19083,2,5,0
5483,1,2,19079,19083,19085,4,6,0
5484,2,2,19081,19085,19087,4,6,0
5485,2,3,19083,19087,19090,4,7,0
5486,4,3,19087,19090,19093,3,6,0
5487,2,2,19089,19093,19095,4,6,0
5488,4,1,19093,19095,19096,2,3,0
5489,5,1,19098,19098,19099,0,1,2
5490,6,1,19104,19104,19105,0,1,5
5491,5,2,19109,19109,19111,0,2,4
5492,5,1,19114,19114,19115,0,1,3
5493,5,3,19119,19119,19122,0,3,4
5494,1,3,19120,19122,19125,2,5,0
5495,4,2,19124,19125,19127,1,3,0
5496,6,2,19130,19130,19132,0,2,3
5497,3,3,19133,19133,19136,0,3,1
5498,4,1,19137,19137,19138,0,1,1
5499,2,1,19139,19139,19140,0,1,1
5500,4,3,19143,19143,19146,0,3,3
5501,6,2,19149,19149,19151,0,2,3
5502,2,1,19151,19151,19152,0,1,0
5503,3,3,19154,19154,19157,0,3,2
5504,5,2,19159,19159,19161,0,2,2
5505,3,3,19162,19162,19165,0,3,1
5506,5,3,19167,19167,19170,0,3,2
5507,1,1,19168,19170,19171,2,3,0
5508,4,1,19172,19172,19173,0,1,1
5509,5,2,19177,19177,19179,0,2,4
5510,1,3,19178,19179,19182,1,4,0
5511,1,1,19179,19182,19183,3,4,0
5512,5,2,19184,19184,19186,0,2,1
5513,3,2,19187,19187,19189,0,2,1
5514,5,2,19192,19192,19194,0,2,3
5515,4,1,19196,19196,19197,0,1,2
5516,2,3,19198,19198,19201,0,3,1
5517,2,2,19200,19201,19203,1,3,0
5518,2,1,19202,19203,19204,1,2,0
5519,3,2,19205,19205,19207,0,2,1
5520,3,1,19208,19208,19209,0,1,1
5521,5,3,19213,19213,19216,0,3,4
5522,5,1,19218,19218,19219,0,1,2
5523,1,3,19219,19219,19222,0,3,0
5524,5,2,19224,19224,19226,0,2,2
5525,4,1,19228,19228,19229,0,1,2
5526,4,2,19232,19232,19234,0,2,3
5527,1,3,19233,19234,19237,1,4,0
5528,2,1,19235,19237,19238,2,3,0
5529,1,2,19236,19238,19240,2,4,0
5530,2,1,19238,19240,19241,2,3,0
5531,2,3,19240,19241,19244,1,4,0
5532,4,3,19244,19244,19247,0,3,0
5533,2,1,19246,19247,19248,1,2,0
5534,2,3,19248,19248,19251,0,3,0
5535,3,1,19251,19251,19252,0,1,0
5536,3,3,19254,19254,19257,0,3,2
5537,6,2,19260,19260,19262,0,2,3
5538,6,3,19266,19266,19269,0,3,4
5539,6,3,19272,19272,19275,0,3,3
5540,2,3,19274,19275,19278,1,4,0
5541,1,2,19275,19278,19280,3,5,0
5542,4,2,19279,19280,19282,1,3,0
5543,4,2,19283,19283,19285,0,2,1
5544,5,2,19288,19288,19290,0,2,3
5545,2,3,19290,19290,19293,0,3,0
5546,1,3,19291,19293,19296,2,5,0
5547,6,2,19297,19297,19299,0,2,1
5548,5,2,19302,19302,19304,0,2,3
5549,1,3,19303,19304,19307,1,4,0
5550,3,2,19306,19307,19309,1,3,0
5551,2,2,19308,19309,19311,1,3,0
5552,4,3,19312,19312,19315,0,3,1
5553,3,3,19315,19315,19318,0,3,0
5554,4,3,19319,19319,19322,0,3,1
5555,4,3,19323,19323,19326,0,3,1
5556,6,1,19329,19329,19330,0,1,3
5557,2,1,19331,19331,19332,0,1,1
5558,5,2,19336,19336,19338,0,2,4
5559,5,1,19341,19341,19342,0,1,3
5560,5,3,19346,19346,19349,0,3,4
5561,6,3,19352,19352,19355,0,3,3
5562,5,1,19357,19357,19358,0,1,2
5563,6,1,19363,19363,19364,0,1,5
5564,4,3,19367,19367,19370,0,3,3
5565,2,2,19369,19370,19372,1,3,0
5566,1,3,19370,19372,19375,2,5,0
5567,5,3,19375,19375,19378,0,3,0
5568,2,3,19377,19378,19381,1,4,0
5569,5,1,19382,19382,19383,0,1,1
5570,4,3,19386,19386,19389,0,3,3
5571,1,3,19387,19389,19392,2,5,0
5572,3,3,19390,19392,19395,2,5,0
5573,4,1,19394,19395,19396,1,2,0
5574,3,1,19397,19397,19398,0,1,1
5575,5,3,19402,19402,19405,0,3,4
5576,6,2,19408,19408,19410,0,2,3
5577,3,3,19411,19411,19414,0,3,1
5578,4,2,19415,19415,19417,0,2,1
5579,6,1,19421,19421,19422,0,1,4
5580,2,3,19423,19423,19426,0,3,1
5581,2,3,19425,19426,19429,1,4,0
5582,6,2,19431,19431,19433,0,2,2
5583,2,1,19433,19433,19434,0,1,0
5584,3,1,19436,19436,19437,0,1,2
5585,4,2,19440,19440,19442,0,2,3
5586,5,2,19445,19445,19447,0,2,3
5587,6,3,19451,19451,19454,0,3,4
5588,1,3,19452,19454,19457,2,5,0
5589,4,1,19456,19457,19458,1,2,0
5590,1,2,19457,19458,19460,1,3,0
5591,1,3,19458,19460,19463,2,5,0
5592,5,1,19463,19463,19464,0,1,0
5593,3,3,19466,19466,19469,0,3,2
5594,4,2,19470,19470,19472,0,2,1
5595,1,1,19471,19472,19473,1,2,0
5596,4,2,19475,19475,19477,0,2,2
5597,5,2,19480,19480,19482,0,2,3
5598,4,3,19484,19484,19487,0,3,2
5599,6,2,19490,19490,19492,0,2,3
5600,3,1,19493,19493,19494,0,1,1
5601,2,3,19495,19495,19498,0,3,1
5602,6,2,19501,19501,19503,0,2,3
5603,2,3,19503,19503,19506,0,3,0
5604,2,2,19505,19506,19508,1,3,0
5605,2,3,19507,19508,19511,1,4,0
5606,4,1,19511,19511,19512,0,1,0
5607,3,3,19514,19514,19517,0,3,2
5608,1,2,19515,19517,19519,2,4,0
5609,5,3,19520,19520,19523,0,3,1
5610,3,3,19523,19523,19526,0,3,0
5611,2,2,19525,19526,19528,1,3,0
5612,1,3,19526,19528,19531,2,5,0
5613,1,2,19527,19531,19533,4,6,0
5614,3,2,19530,19533,19535,3,5,0
5615,5,1,19535,19535,19536,0,1,0
5616,6,2,19541,19541,19543,0,2,5
5617,1,1,19542,19543,19544,1,2,0
5618,1,2,19543,19544,19546,1,3,0
5619,4,3,19547,19547,19550,0,3,1
5620,5,2,19552,19552,19554,0,2,2
5621,1,2,19553,19554,19556,1,3,0
5622,6,3,19559,19559,19562,0,3,3
5623,6,3,19565,19565,19568,0,3,3
5624,4,2,19569,19569,19571,0,2,1
5625,5,1,19574,19574,19575,0,1,3
5626,1,2,19575,19575,19577,0,2,0
5627,6,3,19581,19581,19584,0,3,4
5628,2,2,19583,19584,19586,1,3,0
5629,5,3,19588,19588,19591,0,3,2
5630,5,1,19593,19593,19594,0,1,2
5631,6,2,19599,19599,19601,0,2,5
5632,2,3,19601,19601,19604,0,3,0
5633,5,2,19606,19606,19608,0,2,2
5634,1,1,19607,19608,19609,1,2,0
5635,1,3,19608,19609,19612,1,4,0
5636,1,2,19609,19612,19614,3,5,0
5637,4,1,19613,19614,19615,1,2,0
5638,5,3,19618,19618,19621,0,3,3
5639,2,3,19620,19621,19624,1,4,0
5640,4,3,19624,19624,19627,0,3,0
5641,4,2,19628,19628,19630,0,2,1
5642,2,1,19630,19630,19631,0,1,0
5643,1,3,19631,19631,19634,0,3,0
5644,2,3,19633,19634,19637,1,4,0
5645,1,2,19634,19637,19639,3,5,0
5646,2,1,19636,19639,19640,3,4,0
5647,1,1,19637,19640,19641,3,4,0
5648,4,3,19641,19641,19644,0,3,0
5649,2,3,19643,19644,19647,1,4,0
5650,1,2,19644,19647,19649,3,5,0
5651,5,2,19649,19649,19651,0,2,0
5652,5,2,19654,19654,19656,0,2,3
5653,2,2,19656,19656,19658,0,2,0
5654,5,3,19661,19661,19664,0,3,3
5655,4,1,19665,19665,19666,0,1,1
5656,3,1,19668,19668,19669,0,1,2
5657,3,1,19671,19671,19672,0,1,2
5658,2,1,19673,19673,19674,0,1,1
5659,3,3,19676,19676,19679,0,3,2
5660,2,3,19678,19679,19682,1,4,0
5661,1,1,19679,19682,19683,3,4,0
5662,3,2,19682,19683,19685,1,3,0
5663,6,3,19688,19688,19691,0,3,3
5664,4,2,19692,19692,19694,0,2,1
5665,2,2,19694,19694,19696,0,2,0
5666,4,2,19698,19698,19700,0,2,2
5667,5,2,19703,19703,19705,0,2,3
5668,2,2,19705,19705,19707,0,2,0
5669,5,1,19710,19710,19711,0,1,3
5670,2,3,19712,19712,19715,0,3,1
5671,2,2,19714,19715,19717,1,3,0
5672,5,3,19719,19719,19722,0,3,2
5673,6,3,19725,19725,19728,0,3,3
5674,4,3,19729,19729,19732,0,3,1
5675,3,2,19732,19732,19734,0,2,0
5676,2,3,19734,19734,19737,0,3,0
5677,3,3,19737,19737,19740,0,3,0
5678,4,1,19741,19741,19742,0,1,1
5679,5,1,19746,19746,19747,0,1,4
5680,6,1,19752,19752,19753,0,1,5
5681,4,2,19756,19756,19758,0,2,3
5682,1,2,19757,19758,19760,1,3,0
5683,5,2,19762,19762,19764,0,2,2
5684,1,3,19763,19764,19767,1,4,0
5685,2,2,19765,19767,19769,2,4,0
5686,5,2,19770,19770,19772,0,2,1
5687,6,3,19776,19776,19779,0,3,4
5688,2,3,19778,19779,19782,1,4,0
5689,4,1,19782,19782,19783,0,1,0
5690,6,1,19788,19788,19789,0,1,5
5691,6,3,19794,19794,19797,0,3,5
5692,3,1,19797,19797,19798,0,1,0
5693,3,1,19800,19800,19801,0,1,2
5694,6,1,19806,19806,19807,0,1,5
5695,6,3,19812,19812,19815,0,3,5
5696,1,1,19813,19815,19816,2,3,0
5697,6,2,19819,19819,19821,0,2,3
5698,4,1,19823,19823,19824,0,1,2
5699,1,3,19824,19824,19827,0,3,0
5700,1,1,19825,19827,19828,2,3,0
5701,6,1,19831,19831,19832,0,1,3
5702,3,2,19834,19834,19836,0,2,2
5703,3,2,19837,19837,19839,0,2,1
5704,2,1,19839,19839,19840,0,1,0
5705,6,2,19845,19845,19847,0,2,5
5706,3,2,19848,19848,19850,0,2,1
5707,1,1,19849,19850,19851,1,2,0
5708,4,2,19853,19853,19855,0,2,2
5709,6,2,19859,19859,19861,0,2,4
5710,1,1,19860,19861,19862,1,2,0
5711,5,1,19865,19865,19866,0,1,3
5712,3,2,19868,19868,19870,0,2,2
5713,3,2,19871,19871,19873,0,2,1
5714,5,2,19876,19876,19878,0,2,3
5715,5,2,19881,19881,19883,0,2,3
5716,3,2,19884,19884,19886,0,2,1
5717,3,2,19887,19887,19889,0,2,1
5718,6,1,19893,19893,19894,0,1,4
5719,4,3,19897,19897,19900,0,3,3
5720,6,1,19903,19903,19904,0,1,3
5721,4,3,19907,19907,19910,0,3,3
5722,6,1,19913,19913,19914,0,1,3
5723,3,1,19916,19916,19917,0,1,2
5724,2,3,19918,19918,19921,0,3,1
5725,3,1,19921,19921,19922,0,1,0
5726,6,3,19927,19927,19930,0,3,5
5727,4,2,19931,19931,19933,0,2,1
5728,2,3,19933,19933,19936,0,3,0
5729,2,2,19935,19936,19938,1,3,0
5730,4,2,19939,19939,19941,0,2,1
5731,4,2,19943,19943,19945,0,2,2
5732,1,3,19944,19945,19948,1,4,0
5733,3,2,19947,19948,19950,1,3,0
5734,6,3,19953,19953,19956,0,3,3
5735,6,3,19959,19959,19962,0,3,3
5736,1,2,19960,19962,19964,2,4,0
5737,5,2,19965,19965,19967,0,2,1
5738,1,2,19966,19967,19969,1,3,0
5739,6,2,19972,19972,19974,0,2,3
5740,2,1,19974,19974,19975,0,1,0
5741,6,2,19980,19980,19982,0,2,5
5742,6,3,19986,19986,19989,0,3,4
5743,5,1,19991,19991,19992,0,1,2
5744,3,3,19994,19994,19997,0,3,2
5745,3,2,19997,19997,19999,0,2,0
5746,5,2,20002,20002,20004,0,2,3
5747,5,2,20007,20007,20009,0,2,3
5748,5,3,20012,20012,20015,0,3,3
5749,4,2,20016,20016,20018,0,2,1
5750,6,3,20022,20022,20025,0,3,4
5751,2,1,20024,20025,20026,1,2,0
5752,4,3,20028,20028,20031,0,3,2
5753,6,1,20034,20034,20035,0,1,3
5754,4,1,20038,20038,20039,0,1,3
5755,6,2,20044,20044,20046,0,2,5
5756,2,3,20046,20046,20049,0,3,0
5757,1,1,20047,20049,20050,2,3,0
5758,3,2,20050,20050,20052,0,2,0
5759,2,3,20052,20052,20055,0,3,0
5760,1,1,20053,20055,20056,2,3,0
5761,2,3,20055,20056,20059,1,4,0
5762,4,2,20059,20059,20061,0,2,0
5763,1,2,20060,20061,20063,1,3,0
5764,6,3,20066,20066,20069,0,3,3
5765,5,2,20071,20071,20073,0,2,2
5766,5,3,20076,20076,20079,0,3,3
5767,2,3,20078,20079,20082,1,4,0
5768,5,2,20083,20083,20085,0,2,1
5769,6,2,20089,20089,20091,0,2,4
5770,5,3,20094,20094,20097,0,3,3
5771,6,3,20100,20100,20103,0,3,3
5772,4,2,20104,20104,20106,0,2,1
5773,4,2,20108,20108,20110,0,2,2
5774,1,2,20109,20110,20112,1,3,0
5775,6,1,20115,20115,20116,0,1,3
5776,5,2,20120,20120,20122,0,2,4
5777,2,3,20122,20122,20125,0,3,0
5778,2,2,20124,20125,20127,1,3,0
5779,2,1,20126,20127,20128,1,2,0
5780,5,1,20131,20131,20132,0,1,3
5781,6,3,20137,20137,20140,0,3,5
5782,2,2,20139,20140,20142,1,3,0
5783,1,2,20140,20142,20144,2,4,0
5784,6,1,20146,20146,20147,0,1,2
5785,5,1,20151,20151,20152,0,1,4
5786,3,1,20154,20154,20155,0,1,2
5787,4,3,20158,20158,20161,0,3,3
5788,6,3,20164,20164,20167,0,3,3
5789,2,3,20166,20167,20170,1,4,0
5790,3,2,20169,20170,20172,1,3,0
5791,4,1,20173,20173,20174,0,1,1
5792,2,3,20175,20175,20178,0,3,1
5793,4,3,20179,20179,20182,0,3,1
5794,2,3,20181,20182,20185,1,4,0
5795,4,3,20185,20185,20188,0,3,0
5796,4,2,20189,20189,20191,0,2,1
5797,2,1,20191,20191,20192,0,1,0
5798,5,3,20196,20196,20199,0,3,4
5799,3,2,20199,20199,20201,0,2,0
5800,3,2,20202,20202,20204,0,2,1
5801,6,3,20208,20208,20211,0,3,4
5802,5,1,20213,20213,20214,0,1,2
5803,3,2,20216,20216,20218,0,2,2
5804,5,2,20221,20221,20223,0,2,3
5805,4,2,20225,20225,20227,0,2,2
5806,1,3,20226,20227,20230,1,4,0
5807,1,2,20227,20230,20232,3,5,0
5808,2,1,20229,20232,20233,3,4,0
5809,2,1,20231,20233,20234,2,3,0
5810,4,3,20235,20235,20238,0,3,1
5811,5,1,20240,20240,20241,0,1,2
5812,3,1,20243,20243,20244,0,1,2
5813,1,1,20244,20244,20245,0,1,0
5814,2,3,20246,20246,20249,0,3,1
5815,5,2,20251,20251,20253,0,2,2
5816,3,3,20254,20254,20257,0,3,1
5817,3,1,20257,20257,20258,0,1,0
5818,3,2,20260,20260,20262,0,2,2
5819,4,3,20264,20264,20267,0,3,2
5820,3,1,20267,20267,20268,0,1,0
5821,3,2,20270,20270,20272,0,2,2
5822,1,1,20271,20272,20273,1,2,0
5823,6,3,20277,20277,20280,0,3,4
5824,4,3,20281,20281,20284,0,3,1
5825,6,2,20287,20287,20289,0,2,3
5826,6,1,20293,20293,20294,0,1,4
5827,2,3,20295,20295,20298,0,3,1
5828,6,3,20301,20301,20304,0,3,3
5829,2,3,20303,20304,20307,1,4,0
5830,1,1,20304,20307,20308,3,4,0
5831,1,2,20305,20308,20310,3,5,0
5832,2,3,20307,20310,20313,3,6,0
5833,4,1,20311,20313,20314,2,3,0
5834,2,1,20313,20314,20315,1,2,0
5835,3,1,20316,20316,20317,0,1,1
5836,4,3,20320,20320,20323,0,3,3
5837,1,1,20321,20323,20324,2,3,0
5838,5,2,20326,20326,20328,0,2,2
5839,4,1,20330,20330,20331,0,1,2
5840,3,3,20333,20333,20336,0,3,2
5841,2,3,20335,20336,20339,1,4,0
5842,5,2,20340,20340,20342,0,2,1
5843,4,1,20344,20344,20345,0,1,2
5844,1,2,20345,20345,20347,0,2,0
5845,3,2,20348,20348,20350,0,2,1
5846,2,3,20350,20350,20353,0,3,0
5847,2,3,20352,20353,20356,1,4,0
5848,4,2,20356,20356,20358,0,2,0
5849,6,3,20362,20362,20365,0,3,4
5850,5,2,20367,20367,20369,0,2,2
5851,5,1,20372,20372,20373,0,1,3
5852,2,3,20374,20374,20377,0,3,1
5853,4,2,20378,20378,20380,0,2,1
5854,6,2,20384,20384,20386,0,2,4
5855,4,1,20388,20388,20389,0,1,2
5856,2,3,20390,20390,20393,0,3,1
5857,2,3,20392,20393,20396,1,4,0
5858,5,2,20397,20397,20399,0,2,1
5859,5,1,20402,20402,20403,0,1,3
5860,6,1,20408,20408,20409,0,1,5
5861,4,1,20412,20412,20413,0,1,3
5862,3,3,20415,20415,20418,0,3,2
5863,1,3,20416,20418,20421,2,5,0
5864,5,1,20421,20421,20422,0,1,0
5865,2,1,20423,20423,20424,0,1,1
5866,3,2,20426,20426,20428,0,2,2
5867,5,1,20431,20431,20432,0,1,3
5868,2,2,20433,20433,20435,0,2,1
5869,5,1,20438,20438,20439,0,1,3
5870,4,1,20442,20442,20443,0,1,3
5871,1,3,20443,20443,20446,0,3,0
5872,5,2,20448,20448,20450,0,2,2
5873,5,2,20453,20453,20455,0,2,3
5874,6,1,20459,20459,20460,0,1,4
5875,1,3,20460,20460,20463,0,3,0
5876,2,3,20462,20463,20466,1,4,0
5877,5,3,20467,20467,20470,0,3,1
5878,5,3,20472,20472,20475,0,3,2
5879,1,1,20473,20475,20476,2,3,0
5880,4,3,20477,20477,20480,0,3,1
5881,3,3,20480,20480,20483,0,3,0
5882,4,1,20484,20484,20485,0,1,1
5883,3,2,20487,20487,20489,0,2,2
5884,3,3,20490,20490,20493,0,3,1
5885,3,3,20493,20493,20496,0,3,0
5886,4,3,20497,20497,20500,0,3,1
5887,1,2,20498,20500,20502,2,4,0
5888,6,3,20504,20504,20507,0,3,2
5889,1,3,20505,20507,20510,2,5,0
5890,6,2,20511,20511,20513,0,2,1
5891,5,1,20516,20516,20517,0,1,3
5892,1,1,20517,20517,20518,0,1,0
5893,5,1,20522,20522,20523,0,1,4
5894,4,1,20526,20526,20527,0,1,3
5895,3,3,20529,20529,20532,0,3,2
5896,5,3,20534,20534,20537,0,3,2
5897,5,1,20539,20539,20540,0,1,2
5898,4,1,20543,20543,20544,0,1,3
5899,3,3,20546,20546,20549,0,3,2
5900,3,2,20549,20549,20551,0,2,0
5901,4,3,20553,20553,20556,0,3,2
5902,3,1,20556,20556,20557,0,1,0
5903,4,2,20560,20560,20562,0,2,3
5904,2,3,20562,20562,20565,0,3,0
5905,6,1,20568,20568,20569,0,1,3
5906,4,3,20572,20572,20575,0,3,3
5907,3,1,20575,20575,20576,0,1,0
5908,1,3,20576,20576,20579,0,3,0
5909,4,3,20580,20580,20583,0,3,1
5910,1,2,20581,20583,20585,2,4,0
5911,2,3,20583,20585,20588,2,5,0
5912,6,1,20589,20589,20590,0,1,1
5913,1,2,20590,20590,20592,0,2,0
5914,5,2,20595,20595,20597,0,2,3
5915,4,2,20599,20599,20601,0,2,2
5916,1,2,20600,20601,20603,1,3,0
5917,5,1,20605,20605,20606,0,1,2
5918,1,3,20606,20606,20609,0,3,0
5919,5,1,20611,20611,20612,0,1,2
5920,5,1,20616,20616,20617,0,1,4
5921,5,1,20621,20621,20622,0,1,4
5922,4,1,20625,20625,20626,0,1,3
5923,1,2,20626,20626,20628,0,2,0
5924,5,1,20631,20631,20632,0,1,3
5925,3,1,20634,20634,20635,0,1,2
5926,3,3,20637,20637,20640,0,3,2
5927,1,2,20638,20640,20642,2,4,0
5928,6,1,20644,20644,20645,0,1,2
5929,1,3,20645,20645,20648,0,3,0
5930,5,3,20650,20650,20653,0,3,2
5931,2,1,20652,20653,20654,1,2,0
5932,4,1,20656,20656,20657,0,1,2
5933,3,2,20659,20659,20661,0,2,2
5934,6,3,20665,20665,20668,0,3,4
5935,1,2,20666,20668,20670,2,4,0
5936,3,3,20669,20670,20673,1,4,0
5937,2,3,20671,20673,20676,2,5,0
5938,4,1,20675,20676,20677,1,2,0
5939,5,3,20680,20680,20683,0,3,3
5940,3,3,20683,20683,20686,0,3,0
5941,6,2,20689,20689,20691,0,2,3
5942,5,3,20694,20694,20697,0,3,3
5943,4,3,20698,20698,20701,0,3,1
5944,6,3,20704,20704,20707,0,3,3
5945,5,3,20709,20709,20712,0,3,2
5946,3,1,20712,20712,20713,0,1,0
5947,4,1,20716,20716,20717,0,1,3
5948,2,1,20718,20718,20719,0,1,1
5949,4,2,20722,20722,20724,0,2,3
5950,3,3,20725,20725,20728,0,3,1
5951,5,2,20730,20730,20732,0,2,2
5952,2,2,20732,20732,20734,0,2,0
5953,5,2,20737,20737,20739,0,2,3
5954,5,1,20742,20742,20743,0,1,3
5955,3,2,20745,20745,20747,0,2,2
5956,5,2,20750,20750,20752,0,2,3
5957,3,2,20753,20753,20755,0,2,1
5958,4,1,20757,20757,20758,0,1,2
5959,6,1,20763,20763,20764,0,1,5
5960,2,2,20765,20765,20767,0,2,1
5961,6,1,20771,20771,20772,0,1,4
5962,1,3,20772,20772,20775,0,3,0
5963,5,2,20777,20777,20779,0,2,2
5964,4,2,20781,20781,20783,0,2,2
5965,2,2,20783,20783,20785,0,2,0
5966,3,1,20786,20786,20787,0,1,1
5967,2,3,20788,20788,20791,0,3,1
5968,4,3,20792,20792,20795,0,3,1
5969,2,1,20794,20795,20796,1,2,0
5970,6,1,20800,20800,20801,0,1,4
5971,1,1,20801,20801,20802,0,1,0
5972,1,1,20802,20802,20803,0,1,0
5973,4,1,20806,20806,20807,0,1,3
5974,2,3,20808,20808,20811,0,3,1
5975,6,2,20814,20814,20816,0,2,3
5976,6,2,20820,20820,20822,0,2,4
5977,4,2,20824,20824,20826,0,2,2
5978,1,2,20825,20826,20828,1,3,0
5979,3,1,20828,20828,20829,0,1,0
5980,6,1,20834,20834,20835,0,1,5
5981,2,3,20836,20836,20839,0,3,1
5982,5,3,20841,20841,20844,0,3,2
5983,2,1,20843,20844,20845,1,2,0
5984,3,1,20846,20846,20847,0,1,1
5985,1,2,20847,20847,20849,0,2,0
5986,5,2,20852,20852,20854,0,2,3
5987,1,2,20853,20854,20856,1,3,0
5988,5,1,20858,20858,20859,0,1,2
5989,4,2,20862,20862,20864,0,2,3
5990,2,3,20864,20864,20867,0,3,0
5991,6,2,20870,20870,20872,0,2,3
5992,3,1,20873,20873,20874,0,1,1
5993,5,2,20878,20878,20880,0,2,4
5994,1,2,20879,20880,20882,1,3,0
5995,4,3,20883,20883,20886,0,3,1
5996,5,1,20888,20888,20889,0,1,2
5997,6,1,20894,20894,20895,0,1,5
5998,1,3,20895,20895,20898,0,3,0
5999,1,1,20896,20898,20899,2,3,0
6000,4,3,20900,20900,20903,0,3,1
6001,3,2,20903,20903,20905,0,2,0
6002,4,1,20907,20907,20908,0,1,2
6003,1,1,20908,20908,20909,0,1,0
6004,4,1,20912,20912,20913,0,1,3
6005,4,3,20916,20916,20919,0,3,3
6006,2,3,20918,20919,20922,1,4,0
6007,6,2,20924,20924,20926,0,2,2
6008,5,3,20929,20929,20932,0,3,3
6009,3,3,20932,20932,20935,0,3,0
6010,1,2,20933,20935,20937,2,4,0
6011,6,1,20939,20939,20940,0,1,2
6012,5,3,20944,20944,20947,0,3,4
6013,4,2,20948,20948,20950,0,2,1
6014,5,2,20953,20953,20955,0,2,3
6015,2,3,20955,20955,20958,0,3,0
6016,4,3,20959,20959,20962,0,3,1
6017,2,2,20961,20962,20964,1,3,0
6018,2,2,20963,20964,20966,1,3,0
6019,5,2,20968,20968,20970,0,2,2
6020,4,3,20972,20972,20975,0,3,2
6021,3,2,20975,20975,20977,0,2,0
6022,1,1,20976,20977,20978,1,2,0
6023,2,2,20978,20978,20980,0,2,0
6024,5,2,20983,20983,20985,0,2,3
6025,3,3,20986,20986,20989,0,3,1
6026,5,2,20991,20991,20993,0,2,2
6027,2,2,20993,20993,20995,0,2,0
6028,2,2,20995,20995,20997,0,2,0
6029,3,2,20998,20998,21000,0,2,1
6030,2,1,21000,21000,21001,0,1,0
6031,2,1,21002,21002,21003,0,1,1
6032,2,2,21004,21004,21006,0,2,1
6033,3,3,21007,21007,21010,0,3,1
6034,3,3,21010,21010,21013,0,3,0
6035,4,1,21014,21014,21015,0,1,1
6036,6,2,21020,21020,21022,0,2,5
6037,2,1,21022,21022,21023,0,1,0
6038,1,3,21023,21023,21026,0,3,0
6039,4,3,21027,21027,21030,0,3,1
6040,1,1,21028,21030,21031,2,3,0
6041,4,1,21032,21032,21033,0,1,1
6042,2,2,21034,21034,21036,0,2,1
6043,5,3,21039,21039,21042,0,3,3
6044,4,2,21043,21043,21045,0,2,1
6045,2,2,21045,21045,21047,0,2,0
6046,6,3,21051,21051,21054,0,3,4
6047,4,1,21055,21055,21056,0,1,1
6048,2,1,21057,21057,21058,0,1,1
6049,1,3,21058,21058,21061,0,3,0
6050,1,2,21059,21061,21063,2,4,0
6051,5,3,21064,21064,21067,0,3,1
6052,4,2,21068,21068,21070,0,2,1
6053,4,1,21072,21072,21073,0,1,2
6054,2,2,21074,21074,21076,0,2,1
6055,1,2,21075,21076,21078,1,3,0
6056,1,1,21076,21078,21079,2,3,0
6057,6,3,21082,21082,21085,0,3,3
6058,2,2,21084,21085,21087,1,3,0
6059,3,1,21087,21087,21088,0,1,0
6060,3,3,21090,21090,21093,0,3,2
6061,6,2,21096,21096,21098,0,2,3
6062,4,2,21100,21100,21102,0,2,2
6063,5,2,21105,21105,21107,0,2,3
6064,2,1,21107,21107,21108,0,1,0
6065,6,3,21113,21113,21116,0,3,5
6066,4,3,21117,21117,21120,0,3,1
6067,4,3,21121,21121,21124,0,3,1
6068,3,1,21124,21124,21125,0,1,0
6069,1,3,21125,21125,21128,0,3,0
6070,5,2,21130,21130,21132,0,2,2
6071,1,3,21131,21132,21135,1,4,0
6072,2,3,21133,21135,21138,2,5,0
6073,5,2,21138,21138,21140,0,2,0
6074,4,3,21142,21142,21145,0,3,2
6075,2,1,21144,21145,21146,1,2,0
6076,4,1,21148,21148,21149,0,1,2
6077,5,2,21153,21153,21155,0,2,4
6078,4,2,21157,21157,21159,0,2,2
6079,2,3,21159,21159,21162,0,3,0
6080,2,3,21161,21162,21165,1,4,0
6081,2,1,21163,21165,21166,2,3,0
6082,4,1,21167,21167,21168,0,1,1
6083,1,3,21168,21168,21171,0,3,0
6084,3,2,21171,21171,21173,0,2,0
6085,6,2,21177,21177,21179,0,2,4
6086,5,3,21182,21182,21185,0,3,3
6087,3,1,21185,21185,21186,0,1,0
6088,3,3,21188,21188,21191,0,3,2
6089,4,1,21192,21192,21193,0,1,1
6090,6,2,21198,21198,21200,0,2,5
6091,2,1,21200,21200,21201,0,1,0
6092,3,1,21203,21203,21204,0,1,2
6093,4,3,21207,21207,21210,0,3,3
6094,1,2,21208,21210,21212,2,4,0
6095,5,2,21213,21213,21215,0,2,1
6096,6,1,21219,21219,21220,0,1,4
6097,6,2,21225,21225,21227,0,2,5
6098,6,3,21231,21231,21234,0,3,4
6099,3,1,21234,21234,21235,0,1,0
6100,6,3,21240,21240,21243,0,3,5
6101,4,3,21244,21244,21247,0,3,1
6102,1,3,21245,21247,21250,2,5,0
6103,1,3,21246,21250,21253,4,7,0
6104,1,2,21247,21253,21255,6,8,0
6105,1,2,21248,21255,21257,7,9,0
6106,3,1,21251,21257,21258,6,7,0
6107,1,1,21252,21258,21259,6,7,0
6108,2,3,21254,21259,21262,5,8,0
6109,2,1,21256,21262,21263,6,7,0
6110,3,3,21259,21263,21266,4,7,0
6111,4,3,21263,21266,21269,3,6,0
6112,3,2,21266,21269,21271,3,5,0
6113,3,1,21269,21271,21272,2,3,0
6114,3,1,21272,21272,21273,0,1,0
6115,6,1,21278,21278,21279,0,1,5
6116,3,1,21281,21281,21282,0,1,2
6117,5,3,21286,21286,21289,0,3,4
6118,5,3,21291,21291,21294,0,3,2
6119,3,1,21294,21294,21295,0,1,0
6120,2,2,21296,21296,21298,0,2,1
6121,1,2,21297,21298,21300,1,3,0
6122,3,3,21300,21300,21303,0,3,0
6123,6,1,21306,21306,21307,0,1,3
6124,4,3,21310,21310,21313,0,3,3
6125,2,2,21312,21313,21315,1,3,0
6126,5,2,21317,21317,21319,0,2,2
6127,5,3,21322,21322,21325,0,3,3
6128,6,3,21328,21328,21331,0,3,3
6129,5,3,21333,21333,21336,0,3,2
6130,4,1,21337,21337,21338,0,1,1
6131,1,2,21338,21338,21340,0,2,0
6132,1,2,21339,21340,21342,1,3,0
6133,1,1,21340,21342,21343,2,3,0
6134,4,3,21344,21344,21347,0,3,1
6135,1,3,21345,21347,21350,2,5,0
6136,6,2,21351,21351,21353,0,2,1
6137,4,3,21355,21355,21358,0,3,2
6138,1,1,21356,21358,21359,2,3,0
6139,4,1,21360,21360,21361,0,1,1
6140,1,1,21361,21361,21362,0,1,0
6141,4,2,21365,21365,21367,0,2,3
6142,1,1,21366,21367,21368,1,2,0
6143,3,1,21369,21369,21370,0,1,1
6144,1,2,21370,21370,21372,0,2,0
6145,1,3,21371,21372,21375,1,4,0
6146,6,3,21377,21377,21380,0,3,2
6147,5,2,21382,21382,21384,0,2,2
6148,5,2,21387,21387,21389,0,2,3
6149,2,2,21389,21389,21391,0,2,0
6150,3,1,21392,21392,21393,0,1,1
6151,6,3,21398,21398,21401,0,3,5
6152,2,3,21400,21401,21404,1,4,0
6153,6,3,21406,21406,21409,0,3,2
6154,1,1,21407,21409,21410,2,3,0
6155,5,3,21412,21412,21415,0,3,2
6156,5,3,21417,21417,21420,0,3,2
6157,1,2,21418,21420,21422,2,4,0
6158,2,3,21420,21422,21425,2,5,0
6159,3,1,21423,21425,21426,2,3,0
6160,3,1,21426,21426,21427,0,1,0
6161,3,2,21429,21429,21431,0,2,2
6162,6,1,21435,21435,21436,0,1,4
6163,5,1,21440,21440,21441,0,1,4
6164,4,3,21444,21444,21447,0,3,3
6165,5,2,21449,21449,21451,0,2,2
6166,5,3,21454,21454,21457,0,3,3
6167,5,3,21459,21459,21462,0,3,2
6168,5,2,21464,21464,21466,0,2,2
6169,4,2,21468,21468,21470,0,2,2
6170,2,3,21470,21470,21473,0,3,0
6171,3,1,21473,21473,21474,0,1,0
6172,4,3,21477,21477,21480,0,3,3
6173,4,3,21481,21481,21484,0,3,1
6174,2,1,21483,21484,21485,1,2,0
6175,1,1,21484,21485,21486,1,2,0
6176,6,1,21490,21490,21491,0,1,4
6177,1,2,21491,21491,21493,0,2,0
6178,2,2,21493,21493,21495,0,2,0
6179,3,3,21496,21496,21499,0,3,1
6180,2,2,21498,21499,21501,1,3,0
6181,1,3,21499,21501,21504,2,5,0
6182,1,3,21500,21504,21507,4,7,0
6183,3,3,21503,21507,21510,4,7,0
6184,1,3,21504,21510,21513,6,9,0
6185,5,1,21509,21513,21514,4,5,0
6186,1,3,21510,21514,21517,4,7,0
6187,1,2,21511,21517,21519,6,8,0
6188,6,2,21517,21519,21521,2,4,0
6189,1,1,21518,21521,21522,3,4,0
6190,2,1,21520,21522,21523,2,3,0
6191,5,1,21525,21525,21526,0,1,2
6192,5,3,21530,21530,21533,0,3,4
6193,4,2,21534,21534,21536,0,2,1
6194,5,1,21539,21539,21540,0,1,3
6195,3,1,21542,21542,21543,0,1,2
6196,3,2,21545,21545,21547,0,2,2
6197,6,1,21551,21551,21552,0,1,4
6198,5,3,21556,21556,21559,0,3,4
6199,4,1,21560,21560,21561,0,1,1
6200,6,2,21566,21566,21568,0,2,5
6201,3,2,21569,21569,21571,0,2,1
6202,5,1,21574,21574,21575,0,1,3
6203,6,2,21580,21580,21582,0,2,5
6204,6,1,21586,21586,21587,0,1,4
6205,4,1,21590,21590,21591,0,1,3
6206,2,3,21592,21592,21595,0,3,1
6207,3,1,21595,21595,21596,0,1,0
6208,2,3,21597,21597,21600,0,3,1
6209,2,2,21599,21600,21602,1,3,0
6210,1,2,21600,21602,21604,2,4,0
6211,5,2,21605,21605,21607,0,2,1
6212,3,2,21608,21608,21610,0,2,1
6213,2,3,21610,21610,21613,0,3,0
6214,1,3,21611,21613,21616,2,5,0
6215,1,2,21612,21616,21618,4,6,0
6216,1,3,21613,21618,21621,5,8,0
6217,3,3,21616,21621,21624,5,8,0
6218,4,2,21620,21624,21626,4,6,0
6219,2,1,21622,21626,21627,4,5,0
6220,5,2,21627,21627,21629,0,2,0
6221,2,3,21629,21629,21632,0,3,0
6222,6,1,21635,21635,21636,0,1,3
6223,3,1,21638,21638,21639,0,1,2
6224,5,1,21643,21643,21644,0,1,4
6225,3,1,21646,21646,21647,0,1,2
6226,1,1,21647,21647,21648,0,1,0
6227,4,2,21651,21651,21653,0,2,3
6228,1,1,21652,21653,21654,1,2,0
6229,3,1,21655,21655,21656,0,1,1
6230,3,2,21658,21658,21660,0,2,2
6231,3,3,21661,21661,21664,0,3,1
6232,1,3,21662,21664,21667,2,5,0
6233,6,1,21668,21668,21669,0,1,1
6234,2,2,21670,21670,21672,0,2,1
6235,5,1,21675,21675,21676,0,1,3
6236,3,1,21678,21678,21679,0,1,2
6237,3,3,21681,21681,21684,0,3,2
6238,4,1,21685,21685,21686,0,1,1
6239,1,1,21686,21686,21687,0,1,0
6240,4,2,21690,21690,21692,0,2,3
6241,6,2,21696,21696,21698,0,2,4
6242,3,1,21699,21699,21700,0,1,1
6243,3,2,21702,21702,21704,0,2,2
6244,6,2,21708,21708,21710,0,2,4
6245,3,2,21711,21711,21713,0,2,1
6246,3,3,21714,21714,21717,0,3,1
6247,6,3,21720,21720,21723,0,3,3
6248,2,2,21722,21723,21725,1,3,0
6249,5,1,21727,21727,21728,0,1,2
6250,2,1,21729,21729,21730,0,1,1
6251,5,3,21734,21734,21737,0,3,4
6252,1,3,21735,21737,21740,2,5,0
6253,6,3,21741,21741,21744,0,3,1
6254,6,3,21747,21747,21750,0,3,3
6255,1,1,21748,21750,21751,2,3,0
6256,4,1,21752,21752,21753,0,1,1
6257,4,1,21756,21756,21757,0,1,3
6258,2,1,21758,21758,21759,0,1,1
6259,1,1,21759,21759,21760,0,1,0
6260,3,3,21762,21762,21765,0,3,2
6261,5,1,21767,21767,21768,0,1,2
6262,1,3,21768,21768,21771,0,3,0
6263,4,2,21772,21772,21774,0,2,1
6264,4,1,21776,21776,21777,0,1,2
6265,6,2,21782,21782,21784,0,2,5
6266,6,3,21788,21788,21791,0,3,4
6267,6,2,21794,21794,21796,0,2,3
6268,3,3,21797,21797,21800,0,3,1
6269,6,1,21803,21803,21804,0,1,3
6270,6,2,21809,21809,21811,0,2,5
6271,6,3,21815,21815,21818,0,3,4
6272,3,3,21818,21818,21821,0,3,0
6273,4,2,21822,21822,21824,0,2,1
6274,3,2,21825,21825,21827,0,2,1
6275,4,3,21829,21829,21832,0,3,2
6276,4,3,21833,21833,21836,0,3,1
6277,5,3,21838,21838,21841,0,3,2
6278,1,1,21839,21841,21842,2,3,0
6279,3,1,21842,21842,21843,0,1,0
6280,3,1,21845,21845,21846,0,1,2
6281,2,3,21847,21847,21850,0,3,1
6282,1,2,21848,21850,21852,2,4,0
6283,5,1,21853,21853,21854,0,1,1
6284,1,2,21854,21854,21856,0,2,0
6285,2,3,21856,21856,21859,0,3,0
6286,1,1,21857,21859,21860,2,3,0
6287,1,2,21858,21860,21862,2,4,0
6288,1,2,21859,21862,21864,3,5,0
6289,4,1,21863,21864,21865,1,2,0
6290,5,1,21868,21868,21869,0,1,3
6291,5,3,21873,21873,21876,0,3,4
6292,1,1,21874,21876,21877,2,3,0
6293,2,3,21876,21877,21880,1,4,0
6294,1,1,21877,21880,21881,3,4,0
6295,1,1,21878,21881,21882,3,4,0
6296,4,3,21882,21882,21885,0,3,0
6297,4,3,21886,21886,21889,0,3,1
6298,1,2,21887,21889,21891,2,4,0
6299,5,1,21892,21892,21893,0,1,1
6300,3,1,21895,21895,21896,0,1,2
6301,4,2,21899,21899,21901,0,2,3
6302,1,2,21900,21901,21903,1,3,0
6303,2,3,21902,21903,21906,1,4,0
6304,5,3,21907,21907,21910,0,3,1
6305,4,1,21911,21911,21912,0,1,1
6306,3,2,21914,21914,21916,0,2,2
6307,5,3,21919,21919,21922,0,3,3
6308,4,3,21923,21923,21926,0,3,1
6309,2,1,21925,21926,21927,1,2,0
6310,3,3,21928,21928,21931,0,3,1
6311,2,1,21930,21931,21932,1,2,0
6312,6,3,21936,21936,21939,0,3,4
6313,3,2,21939,21939,21941,0,2,0
6314,3,1,21942,21942,21943,0,1,1
6315,3,2,21945,21945,21947,0,2,2
6316,1,2,21946,21947,21949,1,3,0
6317,6,3,21952,21952,21955,0,3,3
6318,3,2,21955,21955,21957,0,2,0
6319,5,1,21960,21960,21961,0,1,3
6320,1,1,21961,21961,21962,0,1,0
6321,2,2,21963,21963,21965,0,2,1
6322,5,3,21968,21968,21971,0,3,3
6323,4,1,21972,21972,21973,0,1,1
6324,4,1,21976,21976,21977,0,1,3
6325,2,2,21978,21978,21980,0,2,1
6326,1,2,21979,21980,21982,1,3,0
6327,1,3,21980,21982,21985,2,5,0
6328,1,3,21981,21985,21988,4,7,0
6329,3,3,21984,21988,21991,4,7,0
6330,2,2,21986,21991,21993,5,7,0
6331,6,2,21992,21993,21995,1,3,0
6332,5,1,21997,21997,21998,0,1,2
6333,5,1,22002,22002,22003,0,1,4
6334,2,1,22004,22004,22005,0,1,1
6335,3,2,22007,22007,22009,0,2,2
6336,4,1,22011,22011,22012,0,1,2
6337,3,2,22014,22014,22016,0,2,2
6338,2,3,22016,22016,22019,0,3,0
6339,4,2,22020,22020,22022,0,2,1
6340,2,1,22022,22022,22023,0,1,0
6341,3,3,22025,22025,22028,0,3,2
6342,5,1,22030,22030,22031,0,1,2
6343,5,3,22035,22035,22038,0,3,4
6344,2,2,22037,22038,22040,1,3,0
6345,3,1,22040,22040,22041,0,1,0
6346,6,3,22046,22046,22049,0,3,5
6347,4,3,22050,22050,22053,0,3,1
6348,1,1,22051,22053,22054,2,3,0
6349,4,1,22055,22055,22056,0,1,1
6350,2,2,22057,22057,22059,0,2,1
6351,5,3,22062,22062,22065,0,3,3
6352,4,3,22066,22066,22069,0,3,1
6353,5,1,22071,22071,22072,0,1,2
6354,6,1,22077,22077,22078,0,1,5
6355,4,1,22081,22081,22082,0,1,3
6356,2,3,22083,22083,22086,0,3,1
6357,6,3,22089,22089,22092,0,3,3
6358,3,3,22092,22092,22095,0,3,0
6359,4,1,22096,22096,22097,0,1,1
6360,1,1,22097,22097,22098,0,1,0
6361,3,2,22100,22100,22102,0,2,2
6362,3,3,22103,22103,22106,0,3,1
6363,5,2,22108,22108,22110,0,2,2
6364,4,3,22112,22112,22115,0,3,2
6365,6,1,22118,22118,22119,0,1,3
6366,2,2,22120,22120,22122,0,2,1
6367,6,3,22126,22126,22129,0,3,4
6368,5,3,22131,22131,22134,0,3,2
6369,1,1,22132,22134,22135,2,3,0
6370,2,1,22134,22135,22136,1,2,0
6371,6,1,22140,22140,22141,0,1,4
6372,1,1,22141,22141,22142,0,1,0
6373,6,2,22147,22147,22149,0,2,5
6374,2,1,22149,22149,22150,0,1,0
6375,3,3,22152,22152,22155,0,3,2
6376,5,2,22157,22157,22159,0,2,2
6377,6,3,22163,22163,22166,0,3,4
6378,1,1,22164,22166,22167,2,3,0
6379,6,2,22170,22170,22172,0,2,3
6380,1,3,22171,22172,22175,1,4,0
6381,4,2,22175,22175,22177,0,2,0
6382,3,1,22178,22178,22179,0,1,1
6383,6,2,22184,22184,22186,0,2,5
6384,3,1,22187,22187,22188,0,1,1
6385,1,2,22188,22188,22190,0,2,0
6386,6,1,22194,22194,22195,0,1,4
6387,6,3,22200,22200,22203,0,3,5
6388,6,2,22206,22206,22208,0,2,3
6389,4,1,22210,22210,22211,0,1,2
6390,1,1,22211,22211,22212,0,1,0
6391,5,3,22216,22216,22219,0,3,4
6392,4,1,22220,22220,22221,0,1,1
6393,1,2,22221,22221,22223,0,2,0
6394,4,1,22225,22225,22226,0,1,2
6395,2,3,22227,22227,22230,0,3,1
6396,4,1,22231,22231,22232,0,1,1
6397,1,1,22232,22232,22233,0,1,0
6398,1,2,22233,22233,22235,0,2,0
6399,6,2,22239,22239,22241,0,2,4
6400,3,3,22242,22242,22245,0,3,1
6401,1,1,22243,22245,22246,2,3,0
6402,6,1,22249,22249,22250,0,1,3
6403,3,2,22252,22252,22254,0,2,2
6404,2,3,22254,22254,22257,0,3,0
6405,1,3,22255,22257,22260,2,5,0
6406,4,1,22259,22260,22261,1,2,0
6407,4,1,22263,22263,22264,0,1,2
6408,5,1,22268,22268,22269,0,1,4
6409,2,1,22270,22270,22271,0,1,1
6410,4,1,22274,22274,22275,0,1,3
6411,4,1,22278,22278,22279,0,1,3
6412,4,1,22282,22282,22283,0,1,3
6413,6,3,22288,22288,22291,0,3,5
6414,6,3,22294,22294,22297,0,3,3
6415,3,2,22297,22297,22299,0,2,0
6416,4,1,22301,22301,22302,0,1,2
6417,2,1,22303,22303,22304,0,1,1
6418,4,1,22307,22307,22308,0,1,3
6419,1,3,22308,22308,22311,0,3,0
6420,6,1,22314,22314,22315,0,1,3
6421,1,3,22315,22315,22318,0,3,0
6422,2,2,22317,22318,22320,1,3,0
6423,5,2,22322,22322,22324,0,2,2
6424,2,3,22324,22324,22327,0,3,0
6425,6,1,22330,22330,22331,0,1,3
6426,5,2,22335,22335,22337,0,2,4
6427,5,2,22340,22340,22342,0,2,3
6428,2,2,22342,22342,22344,0,2,0
6429,5,2,22347,22347,22349,0,2,3
6430,5,1,22352,22352,22353,0,1,3
6431,3,1,22355,22355,22356,0,1,2
6432,3,1,22358,22358,22359,0,1,2
6433,5,1,22363,22363,22364,0,1,4
6434,4,2,22367,22367,22369,0,2,3
6435,2,1,22369,22369,22370,0,1,0
6436,4,3,22373,22373,22376,0,3,3
6437,1,2,22374,22376,22378,2,4,0
6438,4,1,22378,22378,22379,0,1,0
6439,1,3,22379,22379,22382,0,3,0
6440,2,1,22381,22382,22383,1,2,0
6441,2,3,22383,22383,22386,0,3,0
6442,4,1,22387,22387,22388,0,1,1
6443,2,2,22389,22389,22391,0,2,1
6444,6,1,22395,22395,22396,0,1,4
6445,6,3,22401,22401,22404,0,3,5
6446,6,3,22407,22407,22410,0,3,3
6447,6,2,22413,22413,22415,0,2,3
6448,1,2,22414,22415,22417,1,3,0
6449,6,1,22420,22420,22421,0,1,3
6450,6,3,22426,22426,22429,0,3,5
6451,2,3,22428,22429,22432,1,4,0
6452,3,1,22431,22432,22433,1,2,0
6453,3,1,22434,22434,22435,0,1,1
6454,2,3,22436,22436,22439,0,3,1
6455,5,2,22441,22441,22443,0,2,2
6456,1,2,22442,22443,22445,1,3,0
6457,3,1,22445,22445,22446,0,1,0
6458,3,3,22448,22448,22451,0,3,2
6459,4,2,22452,22452,22454,0,2,1
6460,5,2,22457,22457,22459,0,2,3
6461,3,2,22460,22460,22462,0,2,1
6462,4,1,22464,22464,22465,0,1,2
6463,2,2,22466,22466,22468,0,2,1
6464,5,1,22471,22471,22472,0,1,3
6465,2,2,22473,22473,22475,0,2,1
6466,4,1,22477,22477,22478,0,1,2
6467,6,3,22483,22483,22486,0,3,5
6468,4,3,22487,22487,22490,0,3,1
6469,4,3,22491,22491,22494,0,3,1
6470,2,2,22493,22494,22496,1,3,0
6471,2,3,22495,22496,22499,1,4,0
6472,4,2,22499,22499,22501,0,2,0
6473,3,1,22502,22502,22503,0,1,1
6474,4,3,22506,22506,22509,0,3,3
6475,6,1,22512,22512,22513,0,1,3
6476,3,3,22515,22515,22518,0,3,2
6477,6,1,22521,22521,22522,0,1,3
6478,1,3,22522,22522,22525,0,3,0
6479,1,3,22523,22525,22528,2,5,0
6480,4,3,22527,22528,22531,1,4,0
6481,4,2,22531,22531,22533,0,2,0
6482,3,3,22534,22534,22537,0,3,1
6483,2,2,22536,22537,22539,1,3,0
6484,6,3,22542,22542,22545,0,3,3
6485,6,1,22548,22548,22549,0,1,3
6486,2,1,22550,22550,22551,0,1,1
6487,1,1,22551,22551,22552,0,1,0
6488,2,2,22553,22553,22555,0,2,1
6489,4,2,22557,22557,22559,0,2,2
6490,6,3,22563,22563,22566,0,3,4
6491,4,3,22567,22567,22570,0,3,1
6492,2,2,22569,22570,22572,1,3,0
6493,5,1,22574,22574,22575,0,1,2
6494,1,2,22575,22575,22577,0,2,0
6495,3,2,22578,22578,22580,0,2,1
6496,3,3,22581,22581,22584,0,3,1
6497,2,1,22583,22584,22585,1,2,0
6498,5,3,22588,22588,22591,0,3,3
6499,3,2,22591,22591,22593,0,2,0
6500,4,2,22595,22595,22597,0,2,2
6501,2,3,22597,22597,22600,0,3,0
6502,5,2,22602,22602,22604,0,2,2
6503,5,2,22607,22607,22609,0,2,3
6504,2,3,22609,22609,22612,0,3,0
6505,1,2,22610,22612,22614,2,4,0
6506,2,1,22612,22614,22615,2,3,0
6507,6,3,22618,22618,22621,0,3,3
6508,6,2,22624,22624,22626,0,2,3
6509,2,3,22626,22626,22629,0,3,0
6510,5,2,22631,22631,22633,0,2,2
6511,6,1,22637,22637,22638,0,1,4
6512,4,2,22641,22641,22643,0,2,3
6513,2,2,22643,22643,22645,0,2,0
6514,3,3,22646,22646,22649,0,3,1
6515,2,1,22648,22649,22650,1,2,0
6516,2,1,22650,22650,22651,0,1,0
6517,3,2,22653,22653,22655,0,2,2
6518,5,3,22658,22658,22661,0,3,3
6519,3,3,22661,22661,22664,0,3,0
6520,6,1,22667,22667,22668,0,1,3
6521,2,1,22669,22669,22670,0,1,1
6522,6,1,22675,22675,22676,0,1,5
6523,4,2,22679,22679,22681,0,2,3
6524,1,1,22680,22681,22682,1,2,0
6525,1,2,22681,22682,22684,1,3,0
6526,3,3,22684,22684,22687,0,3,0
6527,6,2,22690,22690,22692,0,2,3
6528,1,2,22691,22692,22694,1,3,0
6529,3,2,22694,22694,22696,0,2,0
6530,5,1,22699,22699,22700,0,1,3
6531,2,1,22701,22701,22702,0,1,1
6532,5,2,22706,22706,22708,0,2,4
6533,4,1,22710,22710,22711,0,1,2
6534,5,2,22715,22715,22717,0,2,4
6535,5,3,22720,22720,22723,0,3,3
6536,6,1,22726,22726,22727,0,1,3
6537,6,3,22732,22732,22735,0,3,5
6538,4,1,22736,22736,22737,0,1,1
6539,3,3,22739,22739,22742,0,3,2
6540,2,2,22741,22742,22744,1,3,0
6541,3,1,22744,22744,22745,0,1,0
6542,3,2,22747,22747,22749,0,2,2
6543,2,2,22749,22749,22751,0,2,0
6544,6,3,22755,22755,22758,0,3,4
6545,6,3,22761,22761,22764,0,3,3
6546,4,1,22765,22765,22766,0,1,1
6547,2,1,22767,22767,22768,0,1,1
6548,1,3,22768,22768,22771,0,3,0
6549,5,3,22773,22773,22776,0,3,2
6550,4,2,22777,22777,22779,0,2,1
6551,4,2,22781,22781,22783,0,2,2
6552,5,2,22786,22786,22788,0,2,3
6553,6,3,22792,22792,22795,0,3,4
6554,4,3,22796,22796,22799,0,3,1
6555,3,1,22799,22799,22800,0,1,0
6556,2,3,22801,22801,22804,0,3,1
6557,1,3,22802,22804,22807,2,5,0
6558,2,1,22804,22807,22808,3,4,0
6559,6,3,22810,22810,22813,0,3,2
6560,6,3,22816,22816,22819,0,3,3
6561,5,2,22821,22821,22823,0,2,2
6562,5,2,22826,22826,22828,0,2,3
6563,3,3,22829,22829,22832,0,3,1
6564,4,3,22833,22833,22836,0,3,1
6565,1,1,22834,22836,22837,2,3,0
6566,3,2,22837,22837,22839,0,2,0
6567,2,2,22839,22839,22841,0,2,0
6568,2,2,22841,22841,22843,0,2,0
6569,6,1,22847,22847,22848,0,1,4
6570,2,1,22849,22849,22850,0,1,1
6571,6,1,22855,22855,22856,0,1,5
6572,6,2,22861,22861,22863,0,2,5
6573,3,2,22864,22864,22866,0,2,1
6574,2,3,22866,22866,22869,0,3,0
6575,1,3,22867,22869,22872,2,5,0
6576,5,3,22872,22872,22875,0,3,0
6577,1,1,22873,22875,22876,2,3,0
6578,2,2,22875,22876,22878,1,3,0
6579,2,2,22877,22878,22880,1,3,0
6580,2,2,22879,22880,22882,1,3,0
6581,5,1,22884,22884,22885,0,1,2
6582,6,3,22890,22890,22893,0,3,5
6583,6,1,22896,22896,22897,0,1,3
6584,1,1,22897,22897,22898,0,1,0
6585,6,3,22903,22903,22906,0,3,5
6586,1,2,22904,22906,22908,2,4,0
6587,6,3,22910,22910,22913,0,3,2
6588,2,3,22912,22913,22916,1,4,0
6589,2,3,22914,22916,22919,2,5,0
6590,4,3,22918,22919,22922,1,4,0
6591,5,1,22923,22923,22924,0,1,1
6592,2,2,22925,22925,22927,0,2,1
6593,2,2,22927,22927,22929,0,2,0
6594,3,1,22930,22930,22931,0,1,1
6595,2,1,22932,22932,22933,0,1,1
6596,3,3,22935,22935,22938,0,3,2
6597,5,2,22940,22940,22942,0,2,2
6598,3,2,22943,22943,22945,0,2,1
6599,1,1,22944,22945,22946,1,2,0
6600,1,3,22945,22946,22949,1,4,0
6601,2,2,22947,22949,22951,2,4,0
6602,1,1,22948,22951,22952,3,4,0
6603,3,3,22951,22952,22955,1,4,0
6604,3,2,22954,22955,22957,1,3,0
6605,3,2,22957,22957,22959,0,2,0
6606,5,3,22962,22962,22965,0,3,3
6607,5,3,22967,22967,22970,0,3,2
6608,5,1,22972,22972,22973,0,1,2
6609,3,1,22975,22975,22976,0,1,2
6610,6,3,22981,22981,22984,0,3,5
6611,1,3,22982,22984,22987,2,5,0
6612,4,1,22986,22987,22988,1,2,0
6613,4,2,22990,22990,22992,0,2,2
6614,3,3,22993,22993,22996,0,3,1
6615,3,3,22996,22996,22999,0,3,0
6616,4,2,23000,23000,23002,0,2,1
6617,5,2,23005,23005,23007,0,2,3
6618,5,3,23010,23010,23013,0,3,3
6619,5,2,23015,23015,23017,0,2,2
6620,2,3,23017,23017,23020,0,3,0
6621,6,3,23023,23023,23026,0,3,3
6622,4,3,23027,23027,23030,0,3,1
6623,4,2,23031,23031,23033,0,2,1
6624,6,3,23037,23037,23040,0,3,4
6625,2,3,23039,23040,23043,1,4,0
6626,1,3,23040,23043,23046,3,6,0
6627,5,2,23045,23046,23048,1,3,0
6628,4,2,23049,23049,23051,0,2,1
6629,5,3,23054,23054,23057,0,3,3
6630,3,1,23057,23057,23058,0,1,0
6631,4,2,23061,23061,23063,0,2,3
6632,3,1,23064,23064,23065,0,1,1
6633,6,1,23070,23070,23071,0,1,5
6634,2,3,23072,23072,23075,0,3,1
6635,5,3,23077,23077,23080,0,3,2
6636,4,3,23081,23081,23084,0,3,1
6637,2,3,23083,23084,23087,1,4,0
6638,2,1,23085,23087,23088,2,3,0
6639,2,2,23087,23088,23090,1,3,0
6640,3,1,23090,23090,23091,0,1,0
6641,6,3,23096,23096,23099,0,3,5
6642,3,1,23099,23099,23100,0,1,0
6643,2,1,23101,23101,23102,0,1,1
6644,4,3,23105,23105,23108,0,3,3
6645,3,1,23108,23108,23109,0,1,0
6646,6,1,23114,23114,23115,0,1,5
6647,1,3,23115,23115,23118,0,3,0
6648,3,2,23118,23118,23120,0,2,0
6649,3,3,23121,23121,23124,0,3,1
6650,5,2,23126,23126,23128,0,2,2
6651,4,3,23130,23130,23133,0,3,2
6652,3,3,23133,23133,23136,0,3,0
6653,4,3,23137,23137,23140,0,3,1
6654,1,3,23138,23140,23143,2,5,0
6655,3,3,23141,23143,23146,2,5,0
6656,6,2,23147,23147,23149,0,2,1
6657,3,3,23150,23150,23153,0,3,1
6658,5,1,23155,23155,23156,0,1,2
6659,4,1,23159,23159,23160,0,1,3
6660,2,3,23161,23161,23164,0,3,1
6661,4,2,23165,23165,23167,0,2,1
6662,2,2,23167,23167,23169,0,2,0
6663,3,1,23170,23170,23171,0,1,1
6664,5,2,23175,23175,23177,0,2,4
6665,1,1,23176,23177,23178,1,2,0
6666,5,1,23181,23181,23182,0,1,3
6667,4,3,23185,23185,23188,0,3,3
6668,5,3,23190,23190,23193,0,3,2
6669,1,1,23191,23193,23194,2,3,0
6670,2,1,23193,23194,23195,1,2,0
6671,6,3,23199,23199,23202,0,3,4
6672,6,2,23205,23205,23207,0,2,3
6673,6,3,23211,23211,23214,0,3,4
6674,3,2,23214,23214,23216,0,2,0
6675,2,2,23216,23216,23218,0,2,0
6676,2,2,23218,23218,23220,0,2,0
6677,2,1,23220,23220,23221,0,1,0
6678,5,1,23225,23225,23226,0,1,4
6679,5,1,23230,23230,23231,0,1,4
6680,2,1,23232,23232,23233,0,1,1
6681,1,3,23233,23233,23236,0,3,0
6682,6,3,23239,23239,23242,0,3,3
6683,4,2,23243,23243,23245,0,2,1
6684,4,1,23247,23247,23248,0,1,2
6685,4,2,23251,23251,23253,0,2,3
6686,4,2,23255,23255,23257,0,2,2
6687,4,1,23259,23259,23260,0,1,2
6688,5,2,23264,23264,23266,0,2,4
6689,3,3,23267,23267,23270,0,3,1
6690,1,2,23268,23270,23272,2,4,0
6691,5,2,23273,23273,23275,0,2,1
6692,1,2,23274,23275,23277,1,3,0
6693,2,1,23276,23277,23278,1,2,0
6694,5,1,23281,23281,23282,0,1,3
6695,6,3,23287,23287,23290,0,3,5
6696,2,3,23289,23290,23293,1,4,0
6697,5,1,23294,23294,23295,0,1,1
6698,4,1,23298,23298,23299,0,1,3
6699,5,2,23303,23303,23305,0,2,4
6700,1,1,23304,23305,23306,1,2,0
6701,2,3,23306,23306,23309,0,3,0
6702,4,2,23310,23310,23312,0,2,1
6703,5,1,23315,23315,23316,0,1,3
6704,4,2,23319,23319,23321,0,2,3
6705,5,1,23324,23324,23325,0,1,3
6706,2,3,23326,23326,23329,0,3,1
6707,6,3,23332,23332,23335,0,3,3
6708,1,3,23333,23335,23338,2,5,0
6709,1,3,23334,23338,23341,4,7,0
6710,2,3,23336,23341,23344,5,8,0
6711,3,2,23339,23344,23346,5,7,0
6712,5,1,23344,23346,23347,2,3,0
6713,6,1,23350,23350,23351,0,1,3
6714,3,2,23353,23353,23355,0,2,2
6715,2,3,23355,23355,23358,0,3,0
6716,5,1,23360,23360,23361,0,1,2
6717,4,1,23364,23364,23365,0,1,3
6718,5,2,23369,23369,23371,0,2,4
6719,3,2,23372,23372,23374,0,2,1
6720,2,3,23374,23374,23377,0,3,0
6721,5,1,23379,23379,23380,0,1,2
6722,6,3,23385,23385,23388,0,3,5
6723,6,2,23391,23391,23393,0,2,3
6724,5,2,23396,23396,23398,0,2,3
6725,5,1,23401,23401,23402,0,1,3
6726,6,1,23407,23407,23408,0,1,5
6727,1,1,23408,23408,23409,0,1,0
6728,3,1,23411,23411,23412,0,1,2
6729,6,2,23417,23417,23419,0,2,5
6730,2,2,23419,23419,23421,0,2,0
6731,2,3,23421,23421,23424,0,3,0
6732,6,1,23427,23427,23428,0,1,3
6733,2,1,23429,23429,23430,0,1,1
6734,2,3,23431,23431,23434,0,3,1
6735,4,3,23435,23435,23438,0,3,1
6736,6,2,23441,23441,23443,0,2,3
6737,1,3,23442,23443,23446,1,4,0
6738,1,3,23443,23446,23449,3,6,0
6739,1,2,23444,23449,23451,5,7,0
6740,6,3,23450,23451,23454,1,4,0
6741,3,2,23453,23454,23456,1,3,0
6742,6,2,23459,23459,23461,0,2,3
6743,6,1,23465,23465,23466,0,1,4
6744,5,2,23470,23470,23472,0,2,4
6745,3,1,23473,23473,23474,0,1,1
6746,4,3,23477,23477,23480,0,3,3
6747,6,1,23483,23483,23484,0,1,3
6748,6,3,23489,23489,23492,0,3,5
6749,6,2,23495,23495,23497,0,2,3
6750,1,2,23496,23497,23499,1,3,0
6751,1,1,23497,23499,23500,2,3,0
6752,1,3,23498,23500,23503,2,5,0
6753,1,1,23499,23503,23504,4,5,0
6754,3,1,23502,23504,23505,2,3,0
6755,4,2,23506,23506,23508,0,2,1
6756,6,3,23512,23512,23515,0,3,4
6757,1,2,23513,23515,23517,2,4,0
6758,5,1,23518,23518,23519,0,1,1
6759,6,2,23524,23524,23526,0,2,5
6760,2,2,23526,23526,23528,0,2,0
6761,4,1,23530,23530,23531,0,1,2
6762,3,2,23533,23533,23535,0,2,2
6763,3,1,23536,23536,23537,0,1,1
6764,2,1,23538,23538,23539,0,1,1
6765,3,1,23541,23541,23542,0,1,2
6766,6,2,23547,23547,23549,0,2,5
6767,3,1,23550,23550,23551,0,1,1
6768,5,1,23555,23555,23556,0,1,4
6769,3,1,23558,23558,23559,0,1,2
6770,4,1,23562,23562,23563,0,1,3
6771,4,1,23566,23566,23567,0,1,3
6772,1,2,23567,23567,23569,0,2,0
6773,6,1,23573,23573,23574,0,1,4
6774,1,1,23574,23574,23575,0,1,0
6775,6,2,23580,23580,23582,0,2,5
6776,1,3,23581,23582,23585,1,4,0
6777,2,1,23583,23585,23586,2,3,0
6778,4,3,23587,23587,23590,0,3,1
6779,4,2,23591,23591,23593,0,2,1
6780,5,2,23596,23596,23598,0,2,3
6781,3,3,23599,23599,23602,0,3,1
6782,1,2,23600,23602,23604,2,4,0
6783,6,2,23606,23606,23608,0,2,2
6784,1,2,23607,23608,23610,1,3,0
6785,6,2,23613,23613,23615,0,2,3
6786,6,1,23619,23619,23620,0,1,4
6787,5,3,23624,23624,23627,0,3,4
6788,2,2,23626,23627,23629,1,3,0
6789,2,1,23628,23629,23630,1,2,0
6790,4,2,23632,23632,23634,0,2,2
6791,3,3,23635,23635,23638,0,3,1
6792,2,2,23637,23638,23640,1,3,0
6793,4,3,23641,23641,23644,0,3,1
6794,3,3,23644,23644,23647,0,3,0
6795,4,3,23648,23648,23651,0,3,1
6796,5,3,23653,23653,23656,0,3,2
6797,2,2,23655,23656,23658,1,3,0
6798,2,3,23657,23658,23661,1,4,0
6799,6,3,23663,23663,23666,0,3,2
6800,5,1,23668,23668,23669,0,1,2
6801,6,1,23674,23674,23675,0,1,5
6802,6,1,23680,23680,23681,0,1,5
6803,2,2,23682,23682,23684,0,2,1
6804,3,2,23685,23685,23687,0,2,1
6805,2,3,23687,23687,23690,0,3,0
6806,5,3,23692,23692,23695,0,3,2
6807,6,3,23698,23698,23701,0,3,3
6808,1,2,23699,23701,23703,2,4,0
6809,6,3,23705,23705,23708,0,3,2
6810,1,3,23706,23708,23711,2,5,0
6811,4,2,23710,23711,23713,1,3,0
6812,3,2,23713,23713,23715,0,2,0
6813,1,2,23714,23715,23717,1,3,0
6814,3,2,23717,23717,23719,0,2,0
6815,2,1,23719,23719,23720,0,1,0
6816,3,1,23722,23722,23723,0,1,2
6817,2,1,23724,23724,23725,0,1,1
6818,6,2,23730,23730,23732,0,2,5
6819,1,3,23731,23732,23735,1,4,0
6820,4,3,23735,23735,23738,0,3,0
6821,3,2,23738,23738,23740,0,2,0
6822,6,3,23744,23744,23747,0,3,4
6823,1,1,23745,23747,23748,2,3,0
6824,4,1,23749,23749,23750,0,1,1
6825,6,2,23755,23755,23757,0,2,5
6826,1,2,23756,23757,23759,1,3,0
6827,3,3,23759,23759,23762,0,3,0
6828,6,2,23765,23765,23767,0,2,3
6829,6,2,23771,23771,23773,0,2,4
6830,4,1,23775,23775,23776,0,1,2
6831,4,1,23779,23779,23780,0,1,3
6832,1,3,23780,23780,23783,0,3,0
6833,1,2,23781,23783,23785,2,4,0
6834,1,1,23782,23785,23786,3,4,0
6835,4,1,23786,23786,23787,0,1,0
6836,6,1,23792,23792,23793,0,1,5
6837,2,3,23794,23794,23797,0,3,1
6838,1,1,23795,23797,23798,2,3,0
6839,5,1,23800,23800,23801,0,1,2
6840,1,2,23801,23801,23803,0,2,0
6841,5,1,23806,23806,23807,0,1,3
6842,2,2,23808,23808,23810,0,2,1
6843,6,2,23814,23814,23816,0,2,4
6844,5,2,23819,23819,23821,0,2,3
6845,4,2,23823,23823,23825,0,2,2
6846,4,2,23827,23827,23829,0,2,2
6847,1,2,23828,23829,23831,1,3,0
6848,4,1,23832,23832,23833,0,1,1
6849,6,1,23838,23838,23839,0,1,5
6850,5,2,23843,23843,23845,0,2,4
6851,2,2,23845,23845,23847,0,2,0
6852,3,3,23848,23848,23851,0,3,1
6853,3,3,23851,23851,23854,0,3,0
6854,5,3,23856,23856,23859,0,3,2
6855,4,3,23860,23860,23863,0,3,1
6856,3,1,23863,23863,23864,0,1,0
6857,2,1,23865,23865,23866,0,1,1
6858,2,3,23867,23867,23870,0,3,1
6859,1,3,23868,23870,23873,2,5,0
6860,1,1,23869,23873,23874,4,5,0
6861,6,3,23875,23875,23878,0,3,1
6862,6,2,23881,23881,23883,0,2,3
6863,1,2,23882,23883,23885,1,3,0
6864,3,1,23885,23885,23886,0,1,0
6865,6,2,23891,23891,23893,0,2,5
6866,6,3,23897,23897,23900,0,3,4
6867,4,1,23901,23901,23902,0,1,1
6868,3,2,23904,23904,23906,0,2,2
6869,3,2,23907,23907,23909,0,2,1
6870,2,3,23909,23909,23912,0,3,0
6871,4,2,23913,23913,23915,0,2,1
6872,4,1,23917,23917,23918,0,1,2
6873,3,2,23920,23920,23922,0,2,2
6874,1,1,23921,23922,23923,1,2,0
6875,4,3,23925,23925,23928,0,3,2
6876,1,1,23926,23928,23929,2,3,0
6877,5,1,23931,23931,23932,0,1,2
6878,2,1,23933,23933,23934,0,1,1
6879,4,3,23937,23937,23940,0,3,3
6880,6,3,23943,23943,23946,0,3,3
6881,6,3,23949,23949,23952,0,3,3
6882,4,1,23953,23953,23954,0,1,1
6883,4,1,23957,23957,23958,0,1,3
6884,6,2,23963,23963,23965,0,2,5
6885,3,2,23966,23966,23968,0,2,1
6886,3,3,23969,23969,23972,0,3,1
6887,5,3,23974,23974,23977,0,3,2
6888,6,2,23980,23980,23982,0,2,3
6889,3,2,23983,23983,23985,0,2,1
6890,1,2,23984,23985,23987,1,3,0
6891,3,2,23987,23987,23989,0,2,0
6892,3,3,23990,23990,23993,0,3,1
6893,1,3,23991,23993,23996,2,5,0
6894,3,2,23994,23996,23998,2,4,0
6895,1,1,23995,23998,23999,3,4,0
6896,5,3,24000,24000,24003,0,3,1
6897,6,3,24006,24006,24009,0,3,3
6898,3,2,24009,24009,24011,0,2,0
6899,2,3,24011,24011,24014,0,3,0
6900,6,2,24017,24017,24019,0,2,3
6901,2,3,24019,24019,24022,0,3,0
6902,2,1,24021,24022,24023,1,2,0
6903,4,2,24025,24025,24027,0,2,2
6904,5,2,24030,24030,24032,0,2,3
6905,5,2,24035,24035,24037,0,2,3
6906,5,2,24040,24040,24042,0,2,3
6907,6,2,24046,24046,24048,0,2,4
6908,4,2,24050,24050,24052,0,2,2
6909,3,1,24053,24053,24054,0,1,1
6910,6,2,24059,24059,24061,0,2,5
6911,4,2,24063,24063,24065,0,2,2
6912,3,2,24066,24066,24068,0,2,1
6913,3,2,24069,24069,24071,0,2,1
6914,6,3,24075,24075,24078,0,3,4
6915,6,2,24081,24081,24083,0,2,3
6916,2,3,24083,24083,24086,0,3,0
6917,4,2,24087,24087,24089,0,2,1
6918,5,1,24092,24092,24093,0,1,3
6919,1,2,24093,24093,24095,0,2,0
6920,3,3,24096,24096,24099,0,3,1
6921,1,1,24097,24099,24100,2,3,0
6922,1,3,24098,24100,24103,2,5,0
6923,2,2,24100,24103,24105,3,5,0
6924,5,1,24105,24105,24106,0,1,0
6925,4,1,24109,24109,24110,0,1,3
6926,1,3,24110,24110,24113,0,3,0
6927,4,2,24114,24114,24116,0,2,1
6928,3,2,24117,24117,24119,0,2,1
6929,4,2,24121,24121,24123,0,2,2
6930,1,1,24122,24123,24124,1,2,0
6931,3,3,24125,24125,24128,0,3,1
6932,6,1,24131,24131,24132,0,1,3
6933,3,3,24134,24134,24137,0,3,2
6934,4,1,24138,24138,24139,0,1,1
6935,1,2,24139,24139,24141,0,2,0
6936,3,2,24142,24142,24144,0,2,1
6937,5,3,24147,24147,24150,0,3,3
6938,4,2,24151,24151,24153,0,2,1
6939,3,3,24154,24154,24157,0,3,1
6940,5,2,24159,24159,24161,0,2,2
6941,6,2,24165,24165,24167,0,2,4
6942,3,2,24168,24168,24170,0,2,1
6943,6,2,24174,24174,24176,0,2,4
6944,6,2,24180,24180,24182,0,2,4
6945,4,1,24184,24184,24185,0,1,2
6946,1,1,24185,24185,24186,0,1,0
6947,5,1,24190,24190,24191,0,1,4
6948,6,1,24196,24196,24197,0,1,5
6949,5,3,24201,24201,24204,0,3,4
6950,1,2,24202,24204,24206,2,4,0
6951,3,3,24205,24206,24209,1,4,0
6952,1,3,24206,24209,24212,3,6,0
6953,6,3,24212,24212,24215,0,3,0
6954,1,3,24213,24215,24218,2,5,0
6955,2,2,24215,24218,24220,3,5,0
6956,2,1,24217,24220,24221,3,4,0
6957,4,3,24221,24221,24224,0,3,0
6958,3,3,24224,24224,24227,0,3,0
6959,4,3,24228,24228,24231,0,3,1
6960,1,2,24229,24231,24233,2,4,0
6961,2,2,24231,24233,24235,2,4,0
6962,3,2,24234,24235,24237,1,3,0
6963,1,2,24235,24237,24239,2,4,0
6964,2,3,24237,24239,24242,2,5,0
6965,3,3,24240,24242,24245,2,5,0
6966,2,1,24242,24245,24246,3,4,0
6967,3,2,24245,24246,24248,1,3,0
6968,5,1,24250,24250,24251,0,1,2
6969,1,1,24251,24251,24252,0,1,0
6970,5,1,24256,24256,24257,0,1,4
6971,3,3,24259,24259,24262,0,3,2
6972,4,1,24263,24263,24264,0,1,1
6973,5,2,24268,24268,24270,0,2,4
6974,2,1,24270,24270,24271,0,1,0
6975,5,2,24275,24275,24277,0,2,4
6976,2,2,24277,24277,24279,0,2,0
6977,4,2,24281,24281,24283,0,2,2
6978,1,1,24282,24283,24284,1,2,0
6979,1,1,24283,24284,24285,1,2,0
6980,4,2,24287,24287,24289,0,2,2
6981,5,1,24292,24292,24293,0,1,3
6982,3,2,24295,24295,24297,0,2,2
6983,4,2,24299,24299,24301,0,2,2
6984,5,3,24304,24304,24307,0,3,3
6985,4,1,24308,24308,24309,0,1,1
6986,3,1,24311,24311,24312,0,1,2
6987,1,1,24312,24312,24313,0,1,0
6988,5,2,24317,24317,24319,0,2,4
6989,5,1,24322,24322,24323,0,1,3
6990,6,3,24328,24328,24331,0,3,5
6991,5,1,24333,24333,24334,0,1,2
6992,4,2,24337,24337,24339,0,2,3
6993,4,2,24341,24341,24343,0,2,2
6994,6,2,24347,24347,24349,0,2,4
6995,1,1,24348,24349,24350,1,2,0
6996,4,1,24352,24352,24353,0,1,2
6997,1,2,24353,24353,24355,0,2,0
6998,5,2,24358,24358,24360,0,2,3
6999,3,2,24361,24361,24363,0,2,1
7000,4,3,24365,24365,24368,0,3,2
7001,6,1,24371,24371,24372,0,1,3
7002,3,2,24374,24374,24376,0,2,2
7003,3,1,24377,24377,24378,0,1,1
7004,2,1,24379,24379,24380,0,1,1
7005,4,2,24383,24383,24385,0,2,3
7006,2,3,24385,24385,24388,0,3,0
7007,4,2,24389,24389,24391,0,2,1
7008,6,2,24395,24395,24397,0,2,4
7009,3,3,24398,24398,24401,0,3,1
7010,4,1,24402,24402,24403,0,1,1
7011,1,2,24403,24403,24405,0,2,0
7012,4,2,24407,24407,24409,0,2,2
7013,1,2,24408,24409,24411,1,3,0
7014,6,1,24414,24414,24415,0,1,3
7015,5,1,24419,24419,24420,0,1,4
7016,5,2,24424,24424,24426,0,2,4
7017,6,3,24430,24430,24433,0,3,4
7018,3,2,24433,24433,24435,0,2,0
7019,3,2,24436,24436,24438,0,2,1
7020,1,1,24437,24438,24439,1,2,0
7021,5,3,24442,24442,24445,0,3,3
7022,2,3,24444,24445,24448,1,4,0
7023,5,1,24449,24449,24450,0,1,1
7024,5,2,24454,24454,24456,0,2,4
7025,5,1,24459,24459,24460,0,1,3
7026,3,1,24462,24462,24463,0,1,2
7027,2,2,24464,24464,24466,0,2,1
7028,3,1,24467,24467,24468,0,1,1
7029,1,2,24468,24468,24470,0,2,0
7030,1,1,24469,24470,24471,1,2,0
7031,4,3,24473,24473,24476,0,3,2
7032,1,3,24474,24476,24479,2,5,0
7033,4,1,24478,24479,24480,1,2,0
7034,6,3,24484,24484,24487,0,3,4
7035,2,2,24486,24487,24489,1,3,0
7036,5,1,24491,24491,24492,0,1,2
7037,1,3,24492,24492,24495,0,3,0
7038,4,3,24496,24496,24499,0,3,1
7039,1,2,24497,24499,24501,2,4,0
7040,2,3,24499,24501,24504,2,5,0
7041,2,2,24501,24504,24506,3,5,0
7042,3,2,24504,24506,24508,2,4,0
7043,6,1,24510,24510,24511,0,1,2
7044,3,2,24513,24513,24515,0,2,2
7045,4,1,24517,24517,24518,0,1,2
7046,5,2,24522,24522,24524,0,2,4
7047,2,2,24524,24524,24526,0,2,0
7048,1,3,24525,24526,24529,1,4,0
7049,6,3,24531,24531,24534,0,3,2
7050,1,3,24532,24534,24537,2,5,0
7051,4,3,24536,24537,24540,1,4,0
7052,3,2,24539,24540,24542,1,3,0
7053,6,2,24545,24545,24547,0,2,3
7054,5,1,24550,24550,24551,0,1,3
7055,2,1,24552,24552,24553,0,1,1
7056,4,1,24556,24556,24557,0,1,3
7057,4,3,24560,24560,24563,0,3,3
7058,5,3,24565,24565,24568,0,3,2
7059,1,2,24566,24568,24570,2,4,0
7060,6,3,24572,24572,24575,0,3,2
7061,2,3,24574,24575,24578,1,4,0
7062,2,1,24576,24578,24579,2,3,0
7063,4,1,24580,24580,24581,0,1,1
7064,6,2,24586,24586,24588,0,2,5
7065,3,2,24589,24589,24591,0,2,1
7066,2,3,24591,24591,24594,0,3,0
7067,4,2,24595,24595,24597,0,2,1
7068,2,3,24597,24597,24600,0,3,0
7069,6,1,24603,24603,24604,0,1,3
7070,2,3,24605,24605,24608,0,3,1
7071,5,1,24610,24610,24611,0,1,2
7072,3,3,24613,24613,24616,0,3,2
7073,5,3,24618,24618,24621,0,3,2
7074,3,3,24621,24621,24624,0,3,0
7075,2,2,24623,24624,24626,1,3,0
7076,4,2,24627,24627,24629,0,2,1
7077,4,1,24631,24631,24632,0,1,2
7078,4,3,24635,24635,24638,0,3,3
7079,4,3,24639,24639,24642,0,3,1
7080,6,3,24645,24645,24648,0,3,3
7081,5,1,24650,24650,24651,0,1,2
7082,2,3,24652,24652,24655,0,3,1
7083,4,1,24656,24656,24657,0,1,1
7084,1,2,24657,24657,24659,0,2,0
7085,3,2,24660,24660,24662,0,2,1
7086,4,1,24664,24664,24665,0,1,2
7087,1,3,24665,24665,24668,0,3,0
7088,6,1,24671,24671,24672,0,1,3
7089,1,2,24672,24672,24674,0,2,0
7090,3,3,24675,24675,24678,0,3,1
7091,4,2,24679,24679,24681,0,2,1
7092,2,1,24681,24681,24682,0,1,0
7093,4,3,24685,24685,24688,0,3,3
7094,4,2,24689,24689,24691,0,2,1
7095,2,2,24691,24691,24693,0,2,0
7096,6,3,24697,24697,24700,0,3,4
7097,3,3,24700,24700,24703,0,3,0
7098,5,2,24705,24705,24707,0,2,2
7099,2,2,24707,24707,24709,0,2,0
7100,3,3,24710,24710,24713,0,3,1
7101,6,1,24716,24716,24717,0,1,3
7102,4,1,24720,24720,24721,0,1,3
7103,5,2,24725,24725,24727,0,2,4
7104,5,3,24730,24730,24733,0,3,3
7105,1,1,24731,24733,24734,2,3,0
7106,6,2,24737,24737,24739,0,2,3
7107,4,3,24741,24741,24744,0,3,2
7108,2,1,24743,24744,24745,1,2,0
7109,2,1,24745,24745,24746,0,1,0
7110,3,3,24748,24748,24751,0,3,2
7111,4,2,24752,24752,24754,0,2,1
7112,6,2,24758,24758,24760,0,2,4
7113,5,2,24763,24763,24765,0,2,3
7114,3,2,24766,24766,24768,0,2,1
7115,5,2,24771,24771,24773,0,2,3
7116,1,3,24772,24773,24776,1,4,0
7117,4,2,24776,24776,24778,0,2,0
7118,3,1,24779,24779,24780,0,1,1
7119,3,3,24782,24782,24785,0,3,2
7120,2,1,24784,24785,24786,1,2,0
7121,1,1,24785,24786,24787,1,2,0
7122,5,3,24790,24790,24793,0,3,3
7123,1,2,24791,24793,24795,2,4,0
7124,5,3,24796,24796,24799,0,3,1
7125,4,3,24800,24800,24803,0,3,1
7126,3,3,24803,24803,24806,0,3,0
7127,3,2,24806,24806,24808,0,2,0
7128,6,2,24812,24812,24814,0,2,4
7129,2,2,24814,24814,24816,0,2,0
7130,1,1,24815,24816,24817,1,2,0
7131,4,2,24819,24819,24821,0,2,2
7132,2,1,24821,24821,24822,0,1,0
7133,4,3,24825,24825,24828,0,3,3
7134,3,3,24828,24828,24831,0,3,0
7135,2,1,24830,24831,24832,1,2,0
7136,4,3,24834,24834,24837,0,3,2
7137,5,2,24839,24839,24841,0,2,2
7138,2,2,24841,24841,24843,0,2,0
7139,3,1,24844,24844,24845,0,1,1
7140,6,1,24850,24850,24851,0,1,5
7141,5,3,24855,24855,24858,0,3,4
7142,3,2,24858,24858,24860,0,2,0
7143,3,1,24861,24861,24862,0,1,1
7144,3,3,24864,24864,24867,0,3,2
7145,5,3,24869,24869,24872,0,3,2
7146,5,1,24874,24874,24875,0,1,2
7147,5,3,24879,24879,24882,0,3,4
7148,6,2,24885,24885,24887,0,2,3
7149,3,3,24888,24888,24891,0,3,1
7150,5,1,24893,24893,24894,0,1,2
7151,4,2,24897,24897,24899,0,2,3
7152,6,2,24903,24903,24905,0,2,4
7153,3,2,24906,24906,24908,0,2,1
7154,2,2,24908,24908,24910,0,2,0
7155,5,1,24913,24913,24914,0,1,3
7156,2,1,24915,24915,24916,0,1,1
7157,5,3,24920,24920,24923,0,3,4
7158,4,3,24924,24924,24927,0,3,1
7159,2,3,24926,24927,24930,1,4,0
7160,4,1,24930,24930,24931,0,1,0
7161,3,1,24933,24933,24934,0,1,2
7162,4,3,24937,24937,24940,0,3,3
7163,5,3,24942,24942,24945,0,3,2
7164,1,3,24943,24945,24948,2,5,0
7165,2,1,24945,24948,24949,3,4,0
7166,4,3,24949,24949,24952,0,3,0
7167,1,3,24950,24952,24955,2,5,0
7168,6,1,24956,24956,24957,0,1,1
7169,6,2,24962,24962,24964,0,2,5
7170,2,3,24964,24964,24967,0,3,0
7171,5,2,24969,24969,24971,0,2,2
7172,3,2,24972,24972,24974,0,2,1
7173,3,1,24975,24975,24976,0,1,1
7174,5,1,24980,24980,24981,0,1,4
7175,2,1,24982,24982,24983,0,1,1
7176,2,3,24984,24984,24987,0,3,1
7177,6,2,24990,24990,24992,0,2,3
7178,4,1,24994,24994,24995,0,1,2
7179,4,1,24998,24998,24999,0,1,3
7180,3,2,25001,25001,25003,0,2,2
7181,3,1,25004,25004,25005,0,1,1
7182,6,1,25010,25010,25011,0,1,5
7183,5,1,25015,25015,25016,0,1,4
7184,6,3,25021,25021,25024,0,3,5
7185,1,3,25022,25024,25027,2,5,0
7186,3,1,25025,25027,25028,2,3,0
7187,2,1,25027,25028,25029,1,2,0
7188,1,3,25028,25029,25032,1,4,0
7189,4,1,25032,25032,25033,0,1,0
7190,3,3,25035,25035,25038,0,3,2
7191,5,1,25040,25040,25041,0,1,2
7192,3,1,25043,25043,25044,0,1,2
7193,4,3,25047,25047,25050,0,3,3
7194,1,2,25048,25050,25052,2,4,0
7195,5,1,25053,25053,25054,0,1,1
7196,4,3,25057,25057,25060,0,3,3
7197,2,3,25059,25060,25063,1,4,0
7198,4,1,25063,25063,25064,0,1,0
7199,3,1,25066,25066,25067,0,1,2
7200,4,3,25070,25070,25073,0,3,3
7201,4,2,25074,25074,25076,0,2,1
7202,3,1,25077,25077,25078,0,1,1
7203,6,1,25083,25083,25084,0,1,5
7204,4,1,25087,25087,25088,0,1,3
7205,6,2,25093,25093,25095,0,2,5
7206,1,3,25094,25095,25098,1,4,0
7207,4,3,25098,25098,25101,0,3,0
7208,2,3,25100,25101,25104,1,4,0
7209,4,1,25104,25104,25105,0,1,0
7210,6,2,25110,25110,25112,0,2,5
7211,1,3,25111,25112,25115,1,4,0
7212,1,2,25112,25115,25117,3,5,0
7213,6,2,25118,25118,25120,0,2,1
7214,6,1,25124,25124,25125,0,1,4
7215,3,2,25127,25127,25129,0,2,2
7216,4,3,25131,25131,25134,0,3,2
7217,2,3,25133,25134,25137,1,4,0
7218,4,3,25137,25137,25140,0,3,0
7219,1,1,25138,25140,25141,2,3,0
7220,2,1,25140,25141,25142,1,2,0
7221,1,2,25141,25142,25144,1,3,0
7222,3,2,25144,25144,25146,0,2,0
7223,5,1,25149,25149,25150,0,1,3
7224,1,2,25150,25150,25152,0,2,0
7225,3,1,25153,25153,25154,0,1,1
7226,6,1,25159,25159,25160,0,1,5
7227,4,1,25163,25163,25164,0,1,3
7228,2,1,25165,25165,25166,0,1,1
7229,3,3,25168,25168,25171,0,3,2
7230,6,1,25174,25174,25175,0,1,3
7231,2,1,25176,25176,25177,0,1,1
7232,3,1,25179,25179,25180,0,1,2
7233,3,3,25182,25182,25185,0,3,2
7234,3,2,25185,25185,25187,0,2,0
7235,4,3,25189,25189,25192,0,3,2
7236,4,1,25193,25193,25194,0,1,1
7237,2,3,25195,25195,25198,0,3,1
7238,2,2,25197,25198,25200,1,3,0
7239,4,2,25201,25201,25203,0,2,1
7240,1,1,25202,25203,25204,1,2,0
7241,5,3,25207,25207,25210,0,3,3
7242,5,1,25212,25212,25213,0,1,2
7243,5,1,25217,25217,25218,0,1,4
7244,4,1,25221,25221,25222,0,1,3
7245,5,1,25226,25226,25227,0,1,4
7246,6,2,25232,25232,25234,0,2,5
7247,3,2,25235,25235,25237,0,2,1
7248,3,1,25238,25238,25239,0,1,1
7249,1,1,25239,25239,25240,0,1,0
7250,4,1,25243,25243,25244,0,1,3
7251,4,3,25247,25247,25250,0,3,3
7252,2,3,25249,25250,25253,1,4,0
7253,5,3,25254,25254,25257,0,3,1
7254,2,3,25256,25257,25260,1,4,0
7255,3,2,25259,25260,25262,1,3,0
7256,5,1,25264,25264,25265,0,1,2
7257,5,2,25269,25269,25271,0,2,4
7258,6,1,25275,25275,25276,0,1,4
7259,3,1,25278,25278,25279,0,1,2
7260,5,2,25283,25283,25285,0,2,4
7261,2,2,25285,25285,25287,0,2,0
7262,2,1,25287,25287,25288,0,1,0
7263,5,3,25292,25292,25295,0,3,4
7264,1,1,25293,25295,25296,2,3,0
7265,2,3,25295,25296,25299,1,4,0
7266,4,3,25299,25299,25302,0,3,0
7267,6,3,25305,25305,25308,0,3,3
7268,6,2,25311,25311,25313,0,2,3
7269,6,1,25317,25317,25318,0,1,4
7270,2,3,25319,25319,25322,0,3,1
7271,6,2,25325,25325,25327,0,2,3
7272,5,2,25330,25330,25332,0,2,3
7273,4,3,25334,25334,25337,0,3,2
7274,5,3,25339,25339,25342,0,3,2
7275,5,2,25344,25344,25346,0,2,2
7276,1,1,25345,25346,25347,1,2,0
7277,3,3,25348,25348,25351,0,3,1
7278,2,1,25350,25351,25352,1,2,0
7279,1,2,25351,25352,25354,1,3,0
7280,6,1,25357,25357,25358,0,1,3
7281,1,3,25358,25358,25361,0,3,0
7282,2,1,25360,25361,25362,1,2,0
7283,3,2,25363,25363,25365,0,2,1
7284,2,3,25365,25365,25368,0,3,0
7285,4,2,25369,25369,25371,0,2,1
7286,2,3,25371,25371,25374,0,3,0
7287,4,1,25375,25375,25376,0,1,1
7288,3,2,25378,25378,25380,0,2,2
7289,5,3,25383,25383,25386,0,3,3
7290,6,3,25389,25389,25392,0,3,3
7291,4,2,25393,25393,25395,0,2,1
7292,4,2,25397,25397,25399,0,2,2
7293,1,3,25398,25399,25402,1,4,0
7294,4,3,25402,25402,25405,0,3,0
7295,3,2,25405,25405,25407,0,2,0
7296,1,2,25406,25407,25409,1,3,0
7297,1,1,25407,25409,25410,2,3,0
7298,6,1,25413,25413,25414,0,1,3
7299,5,2,25418,25418,25420,0,2,4
7300,6,1,25424,25424,25425,0,1,4
7301,5,3,25429,25429,25432,0,3,4
7302,2,2,25431,25432,25434,1,3,0
7303,5,3,25436,25436,25439,0,3,2
7304,1,3,25437,25439,25442,2,5,0
7305,5,2,25442,25442,25444,0,2,0
7306,5,2,25447,25447,25449,0,2,3
7307,5,1,25452,25452,25453,0,1,3
7308,5,2,25457,25457,25459,0,2,4
7309,1,1,25458,25459,25460,1,2,0
7310,5,1,25463,25463,25464,0,1,3
7311,1,2,25464,25464,25466,0,2,0
7312,1,3,25465,25466,25469,1,4,0
7313,4,2,25469,25469,25471,0,2,0
7314,3,2,25472,25472,25474,0,2,1
7315,5,3,25477,25477,25480,0,3,3
7316,2,2,25479,25480,25482,1,3,0
7317,4,2,25483,25483,25485,0,2,1
7318,4,3,25487,25487,25490,0,3,2
7319,4,2,25491,25491,25493,0,2,1
7320,1,2,25492,25493,25495,1,3,0
7321,1,3,25493,25495,25498,2,5,0
7322,2,3,25495,25498,25501,3,6,0
7323,5,3,25500,25501,25504,1,4,0
7324,1,2,25501,25504,25506,3,5,0
7325,1,3,25502,25506,25509,4,7,0
7326,3,1,25505,25509,25510,4,5,0
7327,4,3,25509,25510,25513,1,4,0
7328,4,3,25513,25513,25516,0,3,0
7329,6,2,25519,25519,25521,0,2,3
7330,5,1,25524,25524,25525,0,1,3
7331,3,2,25527,25527,25529,0,2,2
7332,3,3,25530,25530,25533,0,3,1
7333,2,2,25532,25533,25535,1,3,0
7334,4,3,25536,25536,25539,0,3,1
7335,2,1,25538,25539,25540,1,2,0
7336,2,2,25540,25540,25542,0,2,0
7337,5,2,25545,25545,25547,0,2,3
7338,3,3,25548,25548,25551,0,3,1
7339,3,2,25551,25551,25553,0,2,0
7340,6,3,25557,25557,25560,0,3,4
7341,3,3,25560,25560,25563,0,3,0
7342,3,1,25563,25563,25564,0,1,0
7343,3,3,25566,25566,25569,0,3,2
7344,6,1,25572,25572,25573,0,1,3
7345,6,2,25578,25578,25580,0,2,5
7346,4,3,25582,25582,25585,0,3,2
7347,6,1,25588,25588,25589,0,1,3
7348,2,3,25590,25590,25593,0,3,1
7349,3,1,25593,25593,25594,0,1,0
7350,6,1,25599,25599,25600,0,1,5
7351,5,3,25604,25604,25607,0,3,4
7352,5,1,25609,25609,25610,0,1,2
7353,2,3,25611,25611,25614,0,3,1
7354,6,3,25617,25617,25620,0,3,3
7355,5,1,25622,25622,25623,0,1,2
7356,4,1,25626,25626,25627,0,1,3
7357,5,3,25631,25631,25634,0,3,4
7358,2,2,25633,25634,25636,1,3,0
7359,4,3,25637,25637,25640,0,3,1
7360,1,1,25638,25640,25641,2,3,0
7361,2,1,25640,25641,25642,1,2,0
7362,6,2,25646,25646,25648,0,2,4
7363,1,1,25647,25648,25649,1,2,0
7364,6,3,25653,25653,25656,0,3,4
7365,4,3,25657,25657,25660,0,3,1
7366,4,2,25661,25661,25663,0,2,1
7367,2,1,25663,25663,25664,0,1,0
7368,2,3,25665,25665,25668,0,3,1
7369,1,3,25666,25668,25671,2,5,0
7370,4,2,25670,25671,25673,1,3,0
7371,3,3,25673,25673,25676,0,3,0
7372,6,1,25679,25679,25680,0,1,3
7373,4,2,25683,25683,25685,0,2,3
7374,6,1,25689,25689,25690,0,1,4
7375,1,1,25690,25690,25691,0,1,0
7376,4,2,25694,25694,25696,0,2,3
7377,1,3,25695,25696,25699,1,4,0
7378,4,1,25699,25699,25700,0,1,0
7379,6,2,25705,25705,25707,0,2,5
7380,5,3,25710,25710,25713,0,3,3
7381,3,1,25713,25713,25714,0,1,0
7382,2,1,25715,25715,25716,0,1,1
7383,3,2,25718,25718,25720,0,2,2
7384,4,3,25722,25722,25725,0,3,2
7385,1,3,25723,25725,25728,2,5,0
7386,4,1,25727,25728,25729,1,2,0
7387,3,3,25730,25730,25733,0,3,1
7388,5,1,25735,25735,25736,0,1,2
7389,2,3,25737,25737,25740,0,3,1
7390,1,2,25738,25740,25742,2,4,0
7391,1,2,25739,25742,25744,3,5,0
7392,2,2,25741,25744,25746,3,5,0
7393,1,2,25742,25746,25748,4,6,0
7394,6,2,25748,25748,25750,0,2,0
7395,3,2,25751,25751,25753,0,2,1
7396,4,2,25755,25755,25757,0,2,2
7397,3,1,25758,25758,25759,0,1,1
7398,3,2,25761,25761,25763,0,2,2
7399,4,3,25765,25765,25768,0,3,2
7400,2,1,25767,25768,25769,1,2,0
7401,6,2,25773,25773,25775,0,2,4
7402,3,3,25776,25776,25779,0,3,1
7403,1,1,25777,25779,25780,2,3,0
7404,2,1,25779,25780,25781,1,2,0
7405,6,3,25785,25785,25788,0,3,4
7406,5,3,25790,25790,25793,0,3,2
7407,1,3,25791,25793,25796,2,5,0
7408,5,1,25796,25796,25797,0,1,0
7409,2,3,25798,25798,25801,0,3,1
7410,5,3,25803,25803,25806,0,3,2
7411,2,1,25805,25806,25807,1,2,0
7412,6,2,25811,25811,25813,0,2,4
7413,3,2,25814,25814,25816,0,2,1
7414,2,2,25816,25816,25818,0,2,0
7415,4,1,25820,25820,25821,0,1,2
7416,6,2,25826,25826,25828,0,2,5
7417,1,2,25827,25828,25830,1,3,0
7418,1,1,25828,25830,25831,2,3,0
7419,5,2,25833,25833,25835,0,2,2
7420,2,3,25835,25835,25838,0,3,0
7421,3,1,25838,25838,25839,0,1,0
7422,6,3,25844,25844,25847,0,3,5
7423,4,1,25848,25848,25849,0,1,1
7424,2,2,25850,25850,25852,0,2,1
7425,1,3,25851,25852,25855,1,4,0
7426,5,2,25856,25856,25858,0,2,1
7427,1,3,25857,25858,25861,1,4,0
7428,6,2,25863,25863,25865,0,2,2
7429,1,2,25864,25865,25867,1,3,0
7430,6,2,25870,25870,25872,0,2,3
7431,4,2,25874,25874,25876,0,2,2
7432,1,1,25875,25876,25877,1,2,0
7433,6,3,25881,25881,25884,0,3,4
7434,4,2,25885,25885,25887,0,2,1
7435,2,2,25887,25887,25889,0,2,0
7436,3,2,25890,25890,25892,0,2,1
7437,4,1,25894,25894,25895,0,1,2
7438,4,1,25898,25898,25899,0,1,3
7439,6,3,25904,25904,25907,0,3,5
7440,3,2,25907,25907,25909,0,2,0
7441,6,2,25913,25913,25915,0,2,4
7442,3,3,25916,25916,25919,0,3,1
7443,2,1,25918,25919,25920,1,2,0
7444,2,1,25920,25920,25921,0,1,0
7445,6,3,25926,25926,25929,0,3,5
7446,6,1,25932,25932,25933,0,1,3
7447,4,1,25936,25936,25937,0,1,3
7448,3,2,25939,25939,25941,0,2,2
7449,2,2,25941,25941,25943,0,2,0
7450,1,3,25942,25943,25946,1,4,0
7451,1,2,25943,25946,25948,3,5,0
7452,4,1,25947,25948,25949,1,2,0
7453,2,3,25949,25949,25952,0,3,0
7454,4,2,25953,25953,25955,0,2,1
7455,1,1,25954,25955,25956,1,2,0
7456,3,1,25957,25957,25958,0,1,1
7457,2,1,25959,25959,25960,0,1,1
7458,1,2,25960,25960,25962,0,2,0
7459,5,1,25965,25965,25966,0,1,3
7460,2,1,25967,25967,25968,0,1,1
7461,2,3,25969,25969,25972,0,3,1
7462,6,1,25975,25975,25976,0,1,3
7463,2,3,25977,25977,25980,0,3,1
7464,2,2,25979,25980,25982,1,3,0
7465,5,1,25984,25984,25985,0,1,2
7466,3,2,25987,25987,25989,0,2,2
7467,2,3,25989,25989,25992,0,3,0
7468,3,2,25992,25992,25994,0,2,0
7469,1,3,25993,25994,25997,1,4,0
7470,5,1,25998,25998,25999,0,1,1
7471,3,2,26001,26001,26003,0,2,2
7472,6,3,26007,26007,26010,0,3,4
7473,6,1,26013,26013,26014,0,1,3
7474,5,1,26018,26018,26019,0,1,4
7475,4,3,26022,26022,26025,0,3,3
7476,3,2,26025,26025,26027,0,2,0
7477,4,3,26029,26029,26032,0,3,2
7478,5,2,26034,26034,26036,0,2,2
7479,2,3,26036,26036,26039,0,3,0
7480,5,2,26041,26041,26043,0,2,2
7481,4,2,26045,26045,26047,0,2,2
7482,4,3,26049,26049,26052,0,3,2
7483,3,2,26052,26052,26054,0,2,0
7484,2,3,26054,26054,26057,0,3,0
7485,3,2,26057,26057,26059,0,2,0
7486,5,2,26062,26062,26064,0,2,3
7487,2,1,26064,26064,26065,0,1,0
7488,4,3,26068,26068,26071,0,3,3
7489,2,2,26070,26071,26073,1,3,0
7490,4,1,26074,26074,26075,0,1,1
7491,2,2,26076,26076,26078,0,2,1
7492,5,2,26081,26081,26083,0,2,3
7493,6,2,26087,26087,26089,0,2,4
7494,1,2,26088,26089,26091,1,3,0
7495,6,2,26094,26094,26096,0,2,3
7496,6,2,26100,26100,26102,0,2,4
7497,2,3,26102,26102,26105,0,3,0
7498,2,2,26104,26105,26107,1,3,0
7499,1,2,26105,26107,26109,2,4,0
7500,5,2,26110,26110,26112,0,2,1
7501,1,3,26111,26112,26115,1,4,0
7502,5,2,26116,26116,26118,0,2,1
7503,6,1,26122,26122,26123,0,1,4
7504,5,1,26127,26127,26128,0,1,4
7505,3,1,26130,26130,26131,0,1,2
7506,1,1,26131,26131,26132,0,1,0
7507,3,3,26134,26134,26137,0,3,2
7508,2,1,26136,26137,26138,1,2,0
7509,5,3,26141,26141,26144,0,3,3
7510,6,1,26147,26147,26148,0,1,3
7511,6,2,26153,26153,26155,0,2,5
7512,5,1,26158,26158,26159,0,1,3
7513,4,3,26162,26162,26165,0,3,3
7514,2,2,26164,26165,26167,1,3,0
7515,5,1,26169,26169,26170,0,1,2
7516,6,3,26175,26175,26178,0,3,5
7517,1,3,26176,26178,26181,2,5,0
7518,4,3,26180,26181,26184,1,4,0
7519,1,1,26181,26184,26185,3,4,0
7520,3,3,26184,26185,26188,1,4,0
7521,3,1,26187,26188,26189,1,2,0
7522,2,1,26189,26189,26190,0,1,0
7523,4,1,26193,26193,26194,0,1,3
7524,6,2,26199,26199,26201,0,2,5
7525,4,2,26203,26203,26205,0,2,2
7526,1,2,26204,26205,26207,1,3,0
7527,1,3,26205,26207,26210,2,5,0
7528,2,2,26207,26210,26212,3,5,0
7529,1,2,26208,26212,26214,4,6,0
7530,1,1,26209,26214,26215,5,6,0
7531,3,2,26212,26215,26217,3,5,0
7532,5,2,26217,26217,26219,0,2,0
7533,4,3,26221,26221,26224,0,3,2
7534,4,1,26225,26225,26226,0,1,1
7535,5,1,26230,26230,26231,0,1,4
7536,1,1,26231,26231,26232,0,1,0
7537,3,2,26234,26234,26236,0,2,2
7538,2,3,26236,26236,26239,0,3,0
7539,3,2,26239,26239,26241,0,2,0
7540,2,1,26241,26241,26242,0,1,0
7541,3,3,26244,26244,26247,0,3,2
7542,1,3,26245,26247,26250,2,5,0
7543,4,1,26249,26250,26251,1,2,0
7544,5,3,26254,26254,26257,0,3,3
7545,6,1,26260,26260,26261,0,1,3
7546,6,2,26266,26266,26268,0,2,5
7547,1,3,26267,26268,26271,1,4,0
7548,1,1,26268,26271,26272,3,4,0
7549,2,1,26270,26272,26273,2,3,0
7550,1,1,26271,26273,26274,2,3,0
7551,2,1,26273,26274,26275,1,2,0
7552,5,1,26278,26278,26279,0,1,3
7553,2,3,26280,26280,26283,0,3,1
7554,3,2,26283,26283,26285,0,2,0
7555,6,2,26289,26289,26291,0,2,4
7556,1,2,26290,26291,26293,1,3,0
7557,2,1,26292,26293,26294,1,2,0
7558,3,3,26295,26295,26298,0,3,1
7559,6,1,26301,26301,26302,0,1,3
7560,2,3,26303,26303,26306,0,3,1
7561,3,1,26306,26306,26307,0,1,0
7562,1,3,26307,26307,26310,0,3,0
7563,4,3,26311,26311,26314,0,3,1
7564,6,3,26317,26317,26320,0,3,3
7565,6,3,26323,26323,26326,0,3,3
7566,6,1,26329,26329,26330,0,1,3
7567,3,3,26332,26332,26335,0,3,2
7568,2,3,26334,26335,26338,1,4,0
7569,4,2,26338,26338,26340,0,2,0
7570,3,3,26341,26341,26344,0,3,1
7571,1,3,26342,26344,26347,2,5,0
7572,5,3,26347,26347,26350,0,3,0
7573,3,3,26350,26350,26353,0,3,0
7574,1,3,26351,26353,26356,2,5,0
7575,6,2,26357,26357,26359,0,2,1
7576,6,2,26363,26363,26365,0,2,4
7577,5,3,26368,26368,26371,0,3,3
7578,2,1,26370,26371,26372,1,2,0
7579,1,3,26371,26372,26375,1,4,0
7580,4,1,26375,26375,26376,0,1,0
7581,6,1,26381,26381,26382,0,1,5
7582,4,2,26385,26385,26387,0,2,3
7583,2,2,26387,26387,26389,0,2,0
7584,4,1,26391,26391,26392,0,1,2
7585,5,3,26396,26396,26399,0,3,4
7586,1,2,26397,26399,26401,2,4,0
7587,4,1,26401,26401,26402,0,1,0
7588,6,2,26407,26407,26409,0,2,5
7589,4,2,26411,26411,26413,0,2,2
7590,5,1,26416,26416,26417,0,1,3
7591,4,3,26420,26420,26423,0,3,3
7592,4,3,26424,26424,26427,0,3,1
7593,6,1,26430,26430,26431,0,1,3
7594,4,1,26434,26434,26435,0,1,3
7595,5,3,26439,26439,26442,0,3,4
7596,3,3,26442,26442,26445,0,3,0
7597,1,3,26443,26445,26448,2,5,0
7598,1,1,26444,26448,26449,4,5,0
7599,6,1,26450,26450,26451,0,1,1
7600,6,1,26456,26456,26457,0,1,5
7601,5,1,26461,26461,26462,0,1,4
7602,6,2,26467,26467,26469,0,2,5
7603,3,3,26470,26470,26473,0,3,1
7604,6,2,26476,26476,26478,0,2,3
7605,6,2,26482,26482,26484,0,2,4
7606,4,2,26486,26486,26488,0,2,2
7607,1,1,26487,26488,26489,1,2,0
7608,6,1,26493,26493,26494,0,1,4
7609,3,1,26496,26496,26497,0,1,2
7610,3,3,26499,26499,26502,0,3,2
7611,5,1,26504,26504,26505,0,1,2
7612,1,1,26505,26505,26506,0,1,0
7613,4,2,26509,26509,26511,0,2,3
7614,1,2,26510,26511,26513,1,3,0
7615,4,3,26514,26514,26517,0,3,1
7616,4,1,26518,26518,26519,0,1,1
7617,5,1,26523,26523,26524,0,1,4
7618,2,3,26525,26525,26528,0,3,1
7619,4,3,26529,26529,26532,0,3,1
7620,5,1,26534,26534,26535,0,1,2
7621,5,2,26539,26539,26541,0,2,4
7622,3,3,26542,26542,26545,0,3,1
7623,1,3,26543,26545,26548,2,5,0
7624,1,2,26544,26548,26550,4,6,0
7625,2,3,26546,26550,26553,4,7,0
7626,1,3,26547,26553,26556,6,9,0
7627,3,1,26550,26556,26557,6,7,0
7628,1,2,26551,26557,26559,6,8,0
7629,3,1,26554,26559,26560,5,6,0
7630,1,1,26555,26560,26561,5,6,0
7631,4,2,26559,26561,26563,2,4,0
7632,3,1,26562,26563,26564,1,2,0
7633,2,2,26564,26564,26566,0,2,0
7634,1,2,26565,26566,26568,1,3,0
7635,3,2,26568,26568,26570,0,2,0
7636,3,3,26571,26571,26574,0,3,1
7637,6,3,26577,26577,26580,0,3,3
7638,5,1,26582,26582,26583,0,1,2
7639,1,3,26583,26583,26586,0,3,0
7640,6,3,26589,26589,26592,0,3,3
7641,4,2,26593,26593,26595,0,2,1
7642,6,1,26599,26599,26600,0,1,4
7643,5,3,26604,26604,26607,0,3,4
7644,5,3,26609,26609,26612,0,3,2
7645,2,1,26611,26612,26613,1,2,0
7646,5,1,26616,26616,26617,0,1,3
7647,3,3,26619,26619,26622,0,3,2
7648,4,2,26623,26623,26625,0,2,1
7649,5,3,26628,26628,26631,0,3,3
7650,2,1,26630,26631,26632,1,2,0
7651,2,3,26632,26632,26635,0,3,0
7652,4,1,26636,26636,26637,0,1,1
7653,4,1,26640,26640,26641,0,1,3
7654,6,3,26646,26646,26649,0,3,5
7655,3,1,26649,26649,26650,0,1,0
7656,2,1,26651,26651,26652,0,1,1
7657,6,1,26657,26657,26658,0,1,5
7658,5,3,26662,26662,26665,0,3,4
7659,4,2,26666,26666,26668,0,2,1
7660,4,3,26670,26670,26673,0,3,2
7661,4,1,26674,26674,26675,0,1,1
7662,6,3,26680,26680,26683,0,3,5
7663,6,2,26686,26686,26688,0,2,3
7664,1,2,26687,26688,26690,1,3,0
7665,4,2,26691,26691,26693,0,2,1
7666,5,3,26696,26696,26699,0,3,3
7667,1,3,26697,26699,26702,2,5,0
7668,6,1,26703,26703,26704,0,1,1
7669,1,2,26704,26704,26706,0,2,0
7670,3,2,26707,26707,26709,0,2,1
7671,1,3,26708,26709,26712,1,4,0
7672,3,1,26711,26712,26713,1,2,0
7673,6,2,26717,26717,26719,0,2,4
7674,4,2,26721,26721,26723,0,2,2
7675,3,2,26724,26724,26726,0,2,1
7676,1,1,26725,26726,26727,1,2,0
7677,5,1,26730,26730,26731,0,1,3
7678,6,3,26736,26736,26739,0,3,5
7679,2,2,26738,26739,26741,1,3,0
7680,2,1,26740,26741,26742,1,2,0
7681,5,3,26745,26745,26748,0,3,3
7682,1,1,26746,26748,26749,2,3,0
7683,4,1,26750,26750,26751,0,1,1
7684,3,3,26753,26753,26756,0,3,2
7685,5,3,26758,26758,26761,0,3,2
7686,1,1,26759,26761,26762,2,3,0
7687,2,3,26761,26762,26765,1,4,0
7688,1,1,26762,26765,26766,3,4,0
7689,1,1,26763,26766,26767,3,4,0
7690,2,2,26765,26767,26769,2,4,0
7691,5,1,26770,26770,26771,0,1,1
7692,4,2,26774,26774,26776,0,2,3
7693,4,2,26778,26778,26780,0,2,2
7694,1,1,26779,26780,26781,1,2,0
7695,4,1,26783,26783,26784,0,1,2
7696,5,2,26788,26788,26790,0,2,4
7697,6,3,26794,26794,26797,0,3,4
7698,5,2,26799,26799,26801,0,2,2
7699,6,3,26805,26805,26808,0,3,4
7700,3,1,26808,26808,26809,0,1,0
7701,3,2,26811,26811,26813,0,2,2
7702,3,3,26814,26814,26817,0,3,1
7703,3,3,26817,26817,26820,0,3,0
7704,1,1,26818,26820,26821,2,3,0
7705,3,3,26821,26821,26824,0,3,0
7706,4,1,26825,26825,26826,0,1,1
7707,5,2,26830,26830,26832,0,2,4
7708,1,3,26831,26832,26835,1,4,0
7709,3,1,26834,26835,26836,1,2,0
7710,6,2,26840,26840,26842,0,2,4
7711,5,1,26845,26845,26846,0,1,3
7712,1,3,26846,26846,26849,0,3,0
7713,4,2,26850,26850,26852,0,2,1
7714,2,3,26852,26852,26855,0,3,0
7715,1,3,26853,26855,26858,2,5,0
7716,5,2,26858,26858,26860,0,2,0
7717,3,3,26861,26861,26864,0,3,1
7718,3,1,26864,26864,26865,0,1,0
7719,4,3,26868,26868,26871,0,3,3
7720,6,2,26874,26874,26876,0,2,3
7721,6,3,26880,26880,26883,0,3,4
7722,5,1,26885,26885,26886,0,1,2
7723,5,2,26890,26890,26892,0,2,4
7724,1,2,26891,26892,26894,1,3,0
7725,3,1,26894,26894,26895,0,1,0
7726,1,3,26895,26895,26898,0,3,0
7727,1,1,26896,26898,26899,2,3,0
7728,1,1,26897,26899,26900,2,3,0
7729,3,2,26900,26900,26902,0,2,0
7730,1,2,26901,26902,26904,1,3,0
7731,5,3,26906,26906,26909,0,3,2
7732,1,1,26907,26909,26910,2,3,0
7733,5,1,26912,26912,26913,0,1,2
7734,4,2,26916,26916,26918,0,2,3
7735,6,2,26922,26922,26924,0,2,4
7736,2,2,26924,26924,26926,0,2,0
7737,3,2,26927,26927,26929,0,2,1
7738,3,3,26930,26930,26933,0,3,1
7739,6,1,26936,26936,26937,0,1,3
7740,4,1,26940,26940,26941,0,1,3
7741,3,2,26943,26943,26945,0,2,2
7742,3,1,26946,26946,26947,0,1,1
7743,5,1,26951,26951,26952,0,1,4
7744,6,3,26957,26957,26960,0,3,5
7745,6,3,26963,26963,26966,0,3,3
7746,6,2,26969,26969,26971,0,2,3
7747,3,1,26972,26972,26973,0,1,1
7748,6,1,26978,26978,26979,0,1,5
7749,4,1,26982,26982,26983,0,1,3
7750,6,3,26988,26988,26991,0,3,5
7751,2,3,26990,26991,26994,1,4,0
7752,2,1,26992,26994,26995,2,3,0
7753,3,3,26995,26995,26998,0,3,0
7754,3,3,26998,26998,27001,0,3,0
7755,1,2,26999,27001,27003,2,4,0
7756,1,1,27000,27003,27004,3,4,0
7757,3,3,27003,27004,27007,1,4,0
7758,3,2,27006,27007,27009,1,3,0
7759,5,1,27011,27011,27012,0,1,2
7760,3,2,27014,27014,27016,0,2,2
7761,2,1,27016,27016,27017,0,1,0
7762,1,1,27017,27017,27018,0,1,0
7763,6,2,27023,27023,27025,0,2,5
7764,3,3,27026,27026,27029,0,3,1
7765,2,2,27028,27029,27031,1,3,0
7766,1,3,27029,27031,27034,2,5,0
7767,1,3,27030,27034,27037,4,7,0
7768,5,3,27035,27037,27040,2,5,0
7769,4,1,27039,27040,27041,1,2,0
7770,3,2,27042,27042,27044,0,2,1
7771,4,3,27046,27046,27049,0,3,2
7772,1,1,27047,27049,27050,2,3,0
7773,3,3,27050,27050,27053,0,3,0
7774,4,3,27054,27054,27057,0,3,1
7775,3,3,27057,27057,27060,0,3,0
7776,6,2,27063,27063,27065,0,2,3
7777,1,2,27064,27065,27067,1,3,0
7778,4,2,27068,27068,27070,0,2,1
7779,3,2,27071,27071,27073,0,2,1
7780,4,3,27075,27075,27078,0,3,2
7781,2,3,27077,27078,27081,1,4,0
7782,3,3,27080,27081,27084,1,4,0
7783,6,1,27086,27086,27087,0,1,2
7784,6,3,27092,27092,27095,0,3,5
7785,3,3,27095,27095,27098,0,3,0
7786,5,2,27100,27100,27102,0,2,2
7787,2,1,27102,27102,27103,0,1,0
7788,1,2,27103,27103,27105,0,2,0
7789,4,2,27107,27107,27109,0,2,2
7790,4,2,27111,27111,27113,0,2,2
7791,2,3,27113,27113,27116,0,3,0
7792,4,2,27117,27117,27119,0,2,1
7793,3,3,27120,27120,27123,0,3,1
7794,1,3,27121,27123,27126,2,5,0
7795,1,2,27122,27126,27128,4,6,0
7796,6,1,27128,27128,27129,0,1,0
7797,1,2,27129,27129,27131,0,2,0
7798,5,3,27134,27134,27137,0,3,3
7799,6,2,27140,27140,27142,0,2,3
7800,5,1,27145,27145,27146,0,1,3
7801,4,3,27149,27149,27152,0,3,3
7802,6,3,27155,27155,27158,0,3,3
7803,1,3,27156,27158,27161,2,5,0
7804,6,2,27162,27162,27164,0,2,1
7805,3,1,27165,27165,27166,0,1,1
7806,2,2,27167,27167,27169,0,2,1
7807,5,2,27172,27172,27174,0,2,3
7808,4,3,27176,27176,27179,0,3,2
7809,4,1,27180,27180,27181,0,1,1
7810,2,1,27182,27182,27183,0,1,1
7811,5,2,27187,27187,27189,0,2,4
7812,6,3,27193,27193,27196,0,3,4
7813,5,3,27198,27198,27201,0,3,2
7814,3,1,27201,27201,27202,0,1,0
7815,5,1,27206,27206,27207,0,1,4
7816,6,1,27212,27212,27213,0,1,5
7817,2,3,27214,27214,27217,0,3,1
7818,6,1,27220,27220,27221,0,1,3
7819,6,3,27226,27226,27229,0,3,5
7820,5,3,27231,27231,27234,0,3,2
7821,2,2,27233,27234,27236,1,3,0
7822,3,3,27236,27236,27239,0,3,0
7823,5,3,27241,27241,27244,0,3,2
7824,6,1,27247,27247,27248,0,1,3
7825,1,2,27248,27248,27250,0,2,0
7826,5,2,27253,27253,27255,0,2,3
7827,6,3,27259,27259,27262,0,3,4
7828,2,1,27261,27262,27263,1,2,0
7829,1,1,27262,27263,27264,1,2,0
7830,2,3,27264,27264,27267,0,3,0
7831,1,2,27265,27267,27269,2,4,0
7832,2,1,27267,27269,27270,2,3,0
7833,1,1,27268,27270,27271,2,3,0
7834,3,3,27271,27271,27274,0,3,0
7835,1,3,27272,27274,27277,2,5,0
7836,6,3,27278,27278,27281,0,3,1
7837,6,3,27284,27284,27287,0,3,3
7838,6,1,27290,27290,27291,0,1,3
7839,4,2,27294,27294,27296,0,2,3
7840,5,2,27299,27299,27301,0,2,3
7841,1,2,27300,27301,27303,1,3,0
7842,2,3,27302,27303,27306,1,4,0
7843,6,2,27308,27308,27310,0,2,2
7844,5,3,27313,27313,27316,0,3,3
7845,3,1,27316,27316,27317,0,1,0
7846,3,2,27319,27319,27321,0,2,2
7847,4,3,27323,27323,27326,0,3,2
7848,3,1,27326,27326,27327,0,1,0
7849,6,1,27332,27332,27333,0,1,5
7850,4,2,27336,27336,27338,0,2,3
7851,5,1,27341,27341,27342,0,1,3
7852,4,3,27345,27345,27348,0,3,3
7853,1,2,27346,27348,27350,2,4,0
7854,5,3,27351,27351,27354,0,3,1
7855,4,3,27355,27355,27358,0,3,1
7856,2,3,27357,27358,27361,1,4,0
7857,3,2,27360,27361,27363,1,3,0
7858,1,3,27361,27363,27366,2,5,0
7859,5,3,27366,27366,27369,0,3,0
7860,2,2,27368,27369,27371,1,3,0
7861,3,1,27371,27371,27372,0,1,0
7862,5,2,27376,27376,27378,0,2,4
7863,2,3,27378,27378,27381,0,3,0
7864,4,1,27382,27382,27383,0,1,1
7865,2,1,27384,27384,27385,0,1,1
7866,4,3,27388,27388,27391,0,3,3
7867,1,3,27389,27391,27394,2,5,0
7868,6,2,27395,27395,27397,0,2,1
7869,1,3,27396,27397,27400,1,4,0
7870,4,2,27400,27400,27402,0,2,0
7871,6,3,27406,27406,27409,0,3,4
7872,3,3,27409,27409,27412,0,3,0
7873,4,3,27413,27413,27416,0,3,1
7874,6,2,27419,27419,27421,0,2,3
7875,4,3,27423,27423,27426,0,3,2
7876,2,2,27425,27426,27428,1,3,0
7877,6,3,27431,27431,27434,0,3,3
7878,6,3,27437,27437,27440,0,3,3
7879,6,2,27443,27443,27445,0,2,3
7880,3,3,27446,27446,27449,0,3,1
7881,4,3,27450,27450,27453,0,3,1
7882,5,2,27455,27455,27457,0,2,2
7883,6,2,27461,27461,27463,0,2,4
7884,4,3,27465,27465,27468,0,3,2
7885,3,3,27468,27468,27471,0,3,0
7886,1,1,27469,27471,27472,2,3,0
7887,5,3,27474,27474,27477,0,3,2
7888,3,1,27477,27477,27478,0,1,0
7889,1,2,27478,27478,27480,0,2,0
7890,4,3,27482,27482,27485,0,3,2
7891,2,2,27484,27485,27487,1,3,0
7892,2,3,27486,27487,27490,1,4,0
7893,6,1,27492,27492,27493,0,1,2
7894,2,3,27494,27494,27497,0,3,1
7895,2,3,27496,27497,27500,1,4,0
7896,1,3,27497,27500,27503,3,6,0
7897,4,3,27501,27503,27506,2,5,0
7898,4,1,27505,27506,27507,1,2,0
7899,5,3,27510,27510,27513,0,3,3
7900,3,1,27513,27513,27514,0,1,0
7901,1,1,27514,27514,27515,0,1,0
7902,2,3,27516,27516,27519,0,3,1
7903,5,2,27521,27521,27523,0,2,2
7904,1,1,27522,27523,27524,1,2,0
7905,1,1,27523,27524,27525,1,2,0
7906,6,1,27529,27529,27530,0,1,4
7907,1,1,27530,27530,27531,0,1,0
7908,1,3,27531,27531,27534,0,3,0
7909,5,3,27536,27536,27539,0,3,2
7910,3,2,27539,27539,27541,0,2,0
7911,2,1,27541,27541,27542,0,1,0
7912,5,3,27546,27546,27549,0,3,4
7913,6,1,27552,27552,27553,0,1,3
7914,6,1,27558,27558,27559,0,1,5
7915,1,1,27559,27559,27560,0,1,0
7916,2,2,27561,27561,27563,0,2,1
7917,5,1,27566,27566,27567,0,1,3
7918,4,3,27570,27570,27573,0,3,3
7919,3,2,27573,27573,27575,0,2,0
7920,5,1,27578,27578,27579,0,1,3
7921,3,2,27581,27581,27583,0,2,2
7922,3,2,27584,27584,27586,0,2,1
7923,3,1,27587,27587,27588,0,1,1
7924,2,1,27589,27589,27590,0,1,1
7925,6,2,27595,27595,27597,0,2,5
7926,6,3,27601,27601,27604,0,3,4
7927,4,1,27605,27605,27606,0,1,1
7928,5,1,27610,27610,27611,0,1,4
7929,2,2,27612,27612,27614,0,2,1
7930,1,3,27613,27614,27617,1,4,0
7931,1,3,27614,27617,27620,3,6,0
7932,1,2,27615,27620,27622,5,7,0
7933,4,2,27619,27622,27624,3,5,0
7934,3,1,27622,27624,27625,2,3,0
7935,1,2,27623,27625,27627,2,4,0
7936,4,3,27627,27627,27630,0,3,0
7937,5,2,27632,27632,27634,0,2,2
7938,2,3,27634,27634,27637,0,3,0
7939,4,3,27638,27638,27641,0,3,1
7940,5,2,27643,27643,27645,0,2,2
7941,4,3,27647,27647,27650,0,3,2
7942,4,1,27651,27651,27652,0,1,1
7943,3,3,27654,27654,27657,0,3,2
7944,2,2,27656,27657,27659,1,3,0
7945,4,2,27660,27660,27662,0,2,1
7946,2,1,27662,27662,27663,0,1,0
7947,4,1,27666,27666,27667,0,1,3
7948,4,1,27670,27670,27671,0,1,3
7949,6,2,27676,27676,27678,0,2,5
7950,6,3,27682,27682,27685,0,3,4
7951,5,1,27687,27687,27688,0,1,2
7952,4,2,27691,27691,27693,0,2,3
7953,2,3,27693,27693,27696,0,3,0
7954,1,1,27694,27696,27697,2,3,0
7955,4,1,27698,27698,27699,0,1,1
7956,1,1,27699,27699,27700,0,1,0
7957,6,3,27705,27705,27708,0,3,5
7958,6,2,27711,27711,27713,0,2,3
7959,5,2,27716,27716,27718,0,2,3
7960,4,3,27720,27720,27723,0,3,2
7961,2,3,27722,27723,27726,1,4,0
7962,6,2,27728,27728,27730,0,2,2
7963,6,2,27734,27734,27736,0,2,4
7964,2,2,27736,27736,27738,0,2,0
7965,1,1,27737,27738,27739,1,2,0
7966,6,2,27743,27743,27745,0,2,4
7967,2,1,27745,27745,27746,0,1,0
7968,2,3,27747,27747,27750,0,3,1
7969,4,1,27751,27751,27752,0,1,1
7970,5,3,27756,27756,27759,0,3,4
7971,2,2,27758,27759,27761,1,3,0
7972,2,2,27760,27761,27763,1,3,0
7973,3,2,27763,27763,27765,0,2,0
7974,1,3,27764,27765,27768,1,4,0
7975,5,3,27769,27769,27772,0,3,1
7976,1,3,27770,27772,27775,2,5,0
7977,5,1,27775,27775,27776,0,1,0
7978,6,1,27781,27781,27782,0,1,5
7979,1,2,27782,27782,27784,0,2,0
7980,5,1,27787,27787,27788,0,1,3
7981,6,1,27793,27793,27794,0,1,5
7982,5,2,27798,27798,27800,0,2,4
7983,3,1,27801,27801,27802,0,1,1
7984,5,1,27806,27806,27807,0,1,4
7985,2,1,27808,27808,27809,0,1,1
7986,3,2,27811,27811,27813,0,2,2
7987,3,3,27814,27814,27817,0,3,1
7988,5,1,27819,27819,27820,0,1,2
7989,2,1,27821,27821,27822,0,1,1
7990,5,1,27826,27826,27827,0,1,4
7991,4,2,27830,27830,27832,0,2,3
7992,2,2,27832,27832,27834,0,2,0
7993,5,1,27837,27837,27838,0,1,3
7994,2,1,27839,27839,27840,0,1,1
7995,6,3,27845,27845,27848,0,3,5
7996,2,2,27847,27848,27850,1,3,0
7997,6,2,27853,27853,27855,0,2,3
7998,6,1,27859,27859,27860,0,1,4
7999,6,3,27865,27865,27868,0,3,5
8000,4,2,27869,27869,27871,0,2,1
8001,2,2,27871,27871,27873,0,2,0
8002,2,1,27873,27873,27874,0,1,0
8003,2,2,27875,27875,27877,0,2,1
8004,1,1,27876,27877,27878,1,2,0
8005,3,1,27879,27879,27880,0,1,1
8006,2,2,27881,27881,27883,0,2,1
8007,6,1,27887,27887,27888,0,1,4
8008,3,1,27890,27890,27891,0,1,2
8009,6,2,27896,27896,27898,0,2,5
8010,1,3,27897,27898,27901,1,4,0
8011,3,1,27900,27901,27902,1,2,0
8012,5,2,27905,27905,27907,0,2,3
8013,4,3,27909,27909,27912,0,3,2
8014,6,2,27915,27915,27917,0,2,3
8015,3,1,27918,27918,27919,0,1,1
8016,1,3,27919,27919,27922,0,3,0
8017,3,2,27922,27922,27924,0,2,0
8018,1,1,27923,27924,27925,1,2,0
8019,5,2,27928,27928,27930,0,2,3
8020,4,3,27932,27932,27935,0,3,2
8021,6,2,27938,27938,27940,0,2,3
8022,5,3,27943,27943,27946,0,3,3
8023,1,1,27944,27946,27947,2,3,0
8024,4,1,27948,27948,27949,0,1,1
8025,6,3,27954,27954,27957,0,3,5
8026,5,2,27959,27959,27961,0,2,2
8027,6,2,27965,27965,27967,0,2,4
8028,4,1,27969,27969,27970,0,1,2
8029,2,3,27971,27971,27974,0,3,1
8030,2,3,27973,27974,27977,1,4,0
8031,2,1,27975,27977,27978,2,3,0
8032,5,3,27980,27980,27983,0,3,2
8033,2,3,27982,27983,27986,1,4,0
8034,4,2,27986,27986,27988,0,2,0
8035,4,2,27990,27990,27992,0,2,2
8036,3,2,27993,27993,27995,0,2,1
8037,3,1,27996,27996,27997,0,1,1
8038,3,3,27999,27999,28002,0,3,2
8039,1,1,28000,28002,28003,2,3,0
8040,4,2,28004,28004,28006,0,2,1
8041,2,1,28006,28006,28007,0,1,0
8042,4,3,28010,28010,28013,0,3,3
8043,6,2,28016,28016,28018,0,2,3
8044,5,2,28021,28021,28023,0,2,3
8045,3,1,28024,28024,28025,0,1,1
8046,5,2,28029,28029,28031,0,2,4
8047,2,3,28031,28031,28034,0,3,0
8048,5,2,28036,28036,28038,0,2,2
8049,6,2,28042,28042,28044,0,2,4
8050,3,2,28045,28045,28047,0,2,1
8051,5,2,28050,28050,28052,0,2,3
8052,2,1,28052,28052,28053,0,1,0
8053,6,3,28058,28058,28061,0,3,5
8054,5,3,28063,28063,28066,0,3,2
8055,3,1,28066,28066,28067,0,1,0
8056,5,2,28071,28071,28073,0,2,4
8057,4,3,28075,28075,28078,0,3,2
8058,6,3,28081,28081,28084,0,3,3
8059,6,2,28087,28087,28089,0,2,3
8060,6,3,28093,28093,28096,0,3,4
8061,3,1,28096,28096,28097,0,1,0
8062,4,2,28100,28100,28102,0,2,3
8063,2,3,28102,28102,28105,0,3,0
8064,5,2,28107,28107,28109,0,2,2
8065,3,1,28110,28110,28111,0,1,1
8066,2,2,28112,28112,28114,0,2,1
8067,6,3,28118,28118,28121,0,3,4
8068,4,1,28122,28122,28123,0,1,1
8069,1,2,28123,28123,28125,0,2,0
8070,3,2,28126,28126,28128,0,2,1
8071,5,2,28131,28131,28133,0,2,3
8072,5,1,28136,28136,28137,0,1,3
8073,5,1,28141,28141,28142,0,1,4
8074,5,1,28146,28146,28147,0,1,4
8075,1,1,28147,28147,28148,0,1,0
8076,6,1,28153,28153,28154,0,1,5
8077,1,2,28154,28154,28156,0,2,0
8078,6,1,28160,28160,28161,0,1,4
8079,5,2,28165,28165,28167,0,2,4
8080,6,1,28171,28171,28172,0,1,4
8081,4,1,28175,28175,28176,0,1,3
8082,5,1,28180,28180,28181,0,1,4
8083,4,2,28184,28184,28186,0,2,3
8084,4,2,28188,28188,28190,0,2,2
8085,5,2,28193,28193,28195,0,2,3
8086,4,3,28197,28197,28200,0,3,2
8087,2,1,28199,28200,28201,1,2,0
8088,6,3,28205,28205,28208,0,3,4
8089,4,3,28209,28209,28212,0,3,1
8090,5,2,28214,28214,28216,0,2,2
8091,6,3,28220,28220,28223,0,3,4
8092,2,3,28222,28223,28226,1,4,0
8093,4,1,28226,28226,28227,0,1,0
8094,6,3,28232,28232,28235,0,3,5
8095,5,1,28237,28237,28238,0,1,2
8096,6,3,28243,28243,28246,0,3,5
8097,2,2,28245,28246,28248,1,3,0
8098,5,1,28250,28250,28251,0,1,2
8099,2,3,28252,28252,28255,0,3,1
8100,2,1,28254,28255,28256,1,2,0
8101,1,3,28255,28256,28259,1,4,0
8102,1,1,28256,28259,28260,3,4,0
8103,6,1,28262,28262,28263,0,1,2
8104,2,3,28264,28264,28267,0,3,1
8105,5,2,28269,28269,28271,0,2,2
8106,6,2,28275,28275,28277,0,2,4
8107,2,1,28277,28277,28278,0,1,0
8108,5,2,28282,28282,28284,0,2,4
8109,5,3,28287,28287,28290,0,3,3
8110,6,2,28293,28293,28295,0,2,3
8111,2,2,28295,28295,28297,0,2,0
8112,6,3,28301,28301,28304,0,3,4
8113,5,2,28306,28306,28308,0,2,2
8114,4,1,28310,28310,28311,0,1,2
8115,1,1,28311,28311,28312,0,1,0
8116,4,3,28315,28315,28318,0,3,3
8117,4,1,28319,28319,28320,0,1,1
8118,3,2,28322,28322,28324,0,2,2
8119,1,1,28323,28324,28325,1,2,0
8120,3,1,28326,28326,28327,0,1,1
8121,2,1,28328,28328,28329,0,1,1
8122,4,1,28332,28332,28333,0,1,3
8123,1,2,28333,28333,28335,0,2,0
8124,2,3,28335,28335,28338,0,3,0
8125,5,1,28340,28340,28341,0,1,2
8126,3,3,28343,28343,28346,0,3,2
8127,6,1,28349,28349,28350,0,1,3
8128,6,1,28355,28355,28356,0,1,5
8129,4,2,28359,28359,28361,0,2,3
8130,1,2,28360,28361,28363,1,3,0
8131,3,2,28363,28363,28365,0,2,0
8132,5,2,28368,28368,28370,0,2,3
8133,6,3,28374,28374,28377,0,3,4
8134,4,1,28378,28378,28379,0,1,1
8135,6,3,28384,28384,28387,0,3,5
8136,2,2,28386,28387,28389,1,3,0
8137,3,1,28389,28389,28390,0,1,0
8138,5,3,28394,28394,28397,0,3,4
8139,1,3,28395,28397,28400,2,5,0
8140,5,1,28400,28400,28401,0,1,0
8141,3,3,28403,28403,28406,0,3,2
8142,4,1,28407,28407,28408,0,1,1
8143,6,1,28413,28413,28414,0,1,5
8144,4,3,28417,28417,28420,0,3,3
8145,5,2,28422,28422,28424,0,2,2
8146,4,2,28426,28426,28428,0,2,2
8147,1,2,28427,28428,28430,1,3,0
8148,4,3,28431,28431,28434,0,3,1
8149,5,2,28436,28436,28438,0,2,2
8150,3,2,28439,28439,28441,0,2,1
8151,3,3,28442,28442,28445,0,3,1
8152,5,2,28447,28447,28449,0,2,2
8153,4,2,28451,28451,28453,0,2,2
8154,4,1,28455,28455,28456,0,1,2
8155,6,2,28461,28461,28463,0,2,5
8156,3,2,28464,28464,28466,0,2,1
8157,1,2,28465,28466,28468,1,3,0
8158,4,1,28469,28469,28470,0,1,1
8159,4,3,28473,28473,28476,0,3,3
8160,6,3,28479,28479,28482,0,3,3
8161,6,2,28485,28485,28487,0,2,3
8162,1,1,28486,28487,28488,1,2,0
8163,6,1,28492,28492,28493,0,1,4
8164,1,2,28493,28493,28495,0,2,0
8165,1,2,28494,28495,28497,1,3,0
8166,6,3,28500,28500,28503,0,3,3
8167,5,3,28505,28505,28508,0,3,2
8168,6,2,28511,28511,28513,0,2,3
8169,3,2,28514,28514,28516,0,2,1
8170,5,1,28519,28519,28520,0,1,3
8171,5,1,28524,28524,28525,0,1,4
8172,5,1,28529,28529,28530,0,1,4
8173,6,2,28535,28535,28537,0,2,5
8174,3,2,28538,28538,28540,0,2,1
8175,3,2,28541,28541,28543,0,2,1
8176,6,1,28547,28547,28548,0,1,4
8177,6,2,28553,28553,28555,0,2,5
8178,6,3,28559,28559,28562,0,3,4
8179,6,2,28565,28565,28567,0,2,3
8180,1,3,28566,28567,28570,1,4,0
8181,3,3,28569,28570,28573,1,4,0
8182,3,2,28572,28573,28575,1,3,0
8183,1,3,28573,28575,28578,2,5,0
8184,3,2,28576,28578,28580,2,4,0
8185,6,2,28582,28582,28584,0,2,2
8186,3,2,28585,28585,28587,0,2,1
8187,5,2,28590,28590,28592,0,2,3
8188,2,2,28592,28592,28594,0,2,0
8189,5,2,28597,28597,28599,0,2,3
8190,6,2,28603,28603,28605,0,2,4
8191,2,3,28605,28605,28608,0,3,0
8192,1,3,28606,28608,28611,2,5,0
8193,6,3,28612,28612,28615,0,3,1
8194,2,3,28614,28615,28618,1,4,0
8195,3,1,28617,28618,28619,1,2,0
8196,3,3,28620,28620,28623,0,3,1
8197,2,2,28622,28623,28625,1,3,0
8198,3,2,28625,28625,28627,0,2,0
8199,3,2,28628,28628,28630,0,2,1
8200,2,3,28630,28630,28633,0,3,0
8201,1,1,28631,28633,28634,2,3,0
8202,3,1,28634,28634,28635,0,1,0
8203,1,1,28635,28635,28636,0,1,0
8204,6,3,28641,28641,28644,0,3,5
8205,5,3,28646,28646,28649,0,3,2
8206,3,1,28649,28649,28650,0,1,0
8207,5,2,28654,28654,28656,0,2,4
8208,4,1,28658,28658,28659,0,1,2
8209,2,3,28660,28660,28663,0,3,1
8210,2,1,28662,28663,28664,1,2,0
8211,1,1,28663,28664,28665,1,2,0
8212,3,1,28666,28666,28667,0,1,1
8213,6,3,28672,28672,28675,0,3,5
8214,4,3,28676,28676,28679,0,3,1
8215,6,1,28682,28682,28683,0,1,3
8216,3,1,28685,28685,28686,0,1,2
8217,4,2,28689,28689,28691,0,2,3
8218,2,3,28691,28691,28694,0,3,0
8219,6,3,28697,28697,28700,0,3,3
8220,4,2,28701,28701,28703,0,2,1
8221,4,2,28705,28705,28707,0,2,2
8222,5,1,28710,28710,28711,0,1,3
8223,5,2,28715,28715,28717,0,2,4
8224,3,1,28718,28718,28719,0,1,1
8225,4,3,28722,28722,28725,0,3,3
8226,1,1,28723,28725,28726,2,3,0
8227,2,1,28725,28726,28727,1,2,0
8228,2,1,28727,28727,28728,0,1,0
8229,6,2,28733,28733,28735,0,2,5
8230,4,2,28737,28737,28739,0,2,2
8231,4,3,28741,28741,28744,0,3,2
8232,5,2,28746,28746,28748,0,2,2
8233,5,3,28751,28751,28754,0,3,3
8234,5,1,28756,28756,28757,0,1,2
8235,4,3,28760,28760,28763,0,3,3
8236,5,1,28765,28765,28766,0,1,2
8237,5,2,28770,28770,28772,0,2,4
8238,5,1,28775,28775,28776,0,1,3
8239,4,1,28779,28779,28780,0,1,3
8240,3,3,28782,28782,28785,0,3,2
8241,4,3,28786,28786,28789,0,3,1
8242,3,3,28789,28789,28792,0,3,0
8243,5,1,28794,28794,28795,0,1,2
8244,4,1,28798,28798,28799,0,1,3
8245,3,1,28801,28801,28802,0,1,2
8246,5,3,28806,28806,28809,0,3,4
8247,2,2,28808,28809,28811,1,3,0
8248,2,2,28810,28811,28813,1,3,0
8249,3,2,28813,28813,28815,0,2,0
8250,1,3,28814,28815,28818,1,4,0
8251,3,3,28817,28818,28821,1,4,0
8252,2,2,28819,28821,28823,2,4,0
8253,2,1,28821,28823,28824,2,3,0
8254,5,1,28826,28826,28827,0,1,2
8255,3,3,28829,28829,28832,0,3,2
8256,1,2,28830,28832,28834,2,4,0
8257,4,1,28834,28834,28835,0,1,0
8258,3,2,28837,28837,28839,0,2,2
8259,5,2,28842,28842,28844,0,2,3
8260,6,2,28848,28848,28850,0,2,4
8261,2,3,28850,28850,28853,0,3,0
8262,5,3,28855,28855,28858,0,3,2
8263,5,1,28860,28860,28861,0,1,2
8264,3,2,28863,28863,28865,0,2,2
8265,5,2,28868,28868,28870,0,2,3
8266,4,3,28872,28872,28875,0,3,2
8267,6,1,28878,28878,28879,0,1,3
8268,2,1,28880,28880,28881,0,1,1
8269,5,3,28885,28885,28888,0,3,4
8270,2,1,28887,28888,28889,1,2,0
8271,2,1,28889,28889,28890,0,1,0
8272,1,1,28890,28890,28891,0,1,0
8273,3,1,28893,28893,28894,0,1,2
8274,6,2,28899,28899,28901,0,2,5
8275,1,1,28900,28901,28902,1,2,0
8276,5,3,28905,28905,28908,0,3,3
8277,3,1,28908,28908,28909,0,1,0
8278,5,1,28913,28913,28914,0,1,4
8279,4,2,28917,28917,28919,0,2,3
8280,4,2,28921,28921,28923,0,2,2
8281,2,2,28923,28923,28925,0,2,0
8282,4,1,28927,28927,28928,0,1,2
8283,3,2,28930,28930,28932,0,2,2
8284,2,3,28932,28932,28935,0,3,0
8285,2,2,28934,28935,28937,1,3,0
8286,6,2,28940,28940,28942,0,2,3
8287,5,2,28945,28945,28947,0,2,3
8288,5,1,28950,28950,28951,0,1,3
8289,6,3,28956,28956,28959,0,3,5
8290,1,2,28957,28959,28961,2,4,0
8291,5,1,28962,28962,28963,0,1,1
8292,6,3,28968,28968,28971,0,3,5
8293,6,3,28974,28974,28977,0,3,3
8294,5,3,28979,28979,28982,0,3,2
8295,1,3,28980,28982,28985,2,5,0
8296,2,1,28982,28985,28986,3,4,0
8297,6,1,28988,28988,28989,0,1,2
8298,6,3,28994,28994,28997,0,3,5
8299,5,2,28999,28999,29001,0,2,2
8300,5,1,29004,29004,29005,0,1,3
8301,5,3,29009,29009,29012,0,3,4
8302,6,3,29015,29015,29018,0,3,3
8303,1,2,29016,29018,29020,2,4,0
8304,4,3,29020,29020,29023,0,3,0
8305,2,1,29022,29023,29024,1,2,0
8306,4,3,29026,29026,29029,0,3,2
8307,4,2,29030,29030,29032,0,2,1
8308,2,3,29032,29032,29035,0,3,0
8309,1,3,29033,29035,29038,2,5,0
8310,2,1,29035,29038,29039,3,4,0
8311,3,3,29038,29039,29042,1,4,0
8312,1,2,29039,29042,29044,3,5,0
8313,2,2,29041,29044,29046,3,5,0
8314,1,1,29042,29046,29047,4,5,0
8315,3,2,29045,29047,29049,2,4,0
8316,3,2,29048,29049,29051,1,3,0
8317,5,3,29053,29053,29056,0,3,2
8318,6,3,29059,29059,29062,0,3,3
8319,3,2,29062,29062,29064,0,2,0
8320,3,3,29065,29065,29068,0,3,1
8321,2,3,29067,29068,29071,1,4,0
8322,3,3,29070,29071,29074,1,4,0
8323,3,1,29073,29074,29075,1,2,0
8324,5,3,29078,29078,29081,0,3,3
8325,2,2,29080,29081,29083,1,3,0
8326,5,1,29085,29085,29086,0,1,2
8327,3,3,29088,29088,29091,0,3,2
8328,6,3,29094,29094,29097,0,3,3
8329,6,1,29100,29100,29101,0,1,3
8330,3,3,29103,29103,29106,0,3,2
8331,6,2,29109,29109,29111,0,2,3
8332,1,3,29110,29111,29114,1,4,0
8333,3,2,29113,29114,29116,1,3,0
8334,3,2,29116,29116,29118,0,2,0
8335,1,3,29117,29118,29121,1,4,0
8336,1,1,29118,29121,29122,3,4,0
8337,5,2,29123,29123,29125,0,2,1
8338,3,1,29126,29126,29127,0,1,1
8339,1,3,29127,29127,29130,0,3,0
8340,1,1,29128,29130,29131,2,3,0
8341,4,1,29132,29132,29133,0,1,1
8342,2,1,29134,29134,29135,0,1,1
8343,4,2,29138,29138,29140,0,2,3
8344,4,1,29142,29142,29143,0,1,2
8345,4,1,29146,29146,29147,0,1,3
8346,3,3,29149,29149,29152,0,3,2
8347,2,3,29151,29152,29155,1,4,0
8348,6,3,29157,29157,29160,0,3,2
8349,3,1,29160,29160,29161,0,1,0
8350,6,3,29166,29166,29169,0,3,5
8351,3,2,29169,29169,29171,0,2,0
8352,3,3,29172,29172,29175,0,3,1
8353,2,2,29174,29175,29177,1,3,0
8354,6,2,29180,29180,29182,0,2,3
8355,6,3,29186,29186,29189,0,3,4
8356,2,1,29188,29189,29190,1,2,0
8357,6,3,29194,29194,29197,0,3,4
8358,1,3,29195,29197,29200,2,5,0
8359,4,3,29199,29200,29203,1,4,0
8360,4,2,29203,29203,29205,0,2,0
8361,4,1,29207,29207,29208,0,1,2
8362,1,3,29208,29208,29211,0,3,0
8363,5,1,29213,29213,29214,0,1,2
8364,5,1,29218,29218,29219,0,1,4
8365,2,3,29220,29220,29223,0,3,1
8366,2,3,29222,29223,29226,1,4,0
8367,2,1,29224,29226,29227,2,3,0
8368,1,3,29225,29227,29230,2,5,0
8369,3,3,29228,29230,29233,2,5,0
8370,2,3,29230,29233,29236,3,6,0
8371,6,1,29236,29236,29237,0,1,0
8372,4,3,29240,29240,29243,0,3,3
8373,4,3,29244,29244,29247,0,3,1
8374,4,2,29248,29248,29250,0,2,1
8375,1,2,29249,29250,29252,1,3,0
8376,2,3,29251,29252,29255,1,4,0
8377,2,1,29253,29255,29256,2,3,0
8378,1,2,29254,29256,29258,2,4,0
8379,5,1,29259,29259,29260,0,1,1
8380,5,2,29264,29264,29266,0,2,4
8381,5,1,29269,29269,29270,0,1,3
8382,3,2,29272,29272,29274,0,2,2
8383,4,3,29276,29276,29279,0,3,2
8384,3,3,29279,29279,29282,0,3,0
8385,1,2,29280,29282,29284,2,4,0
8386,6,3,29286,29286,29289,0,3,2
8387,5,1,29291,29291,29292,0,1,2
8388,6,2,29297,29297,29299,0,2,5
8389,6,2,29303,29303,29305,0,2,4
8390,5,1,29308,29308,29309,0,1,3
8391,3,2,29311,29311,29313,0,2,2
8392,4,1,29315,29315,29316,0,1,2
8393,2,1,29317,29317,29318,0,1,1
8394,3,1,29320,29320,29321,0,1,2
8395,1,3,29321,29321,29324,0,3,0
8396,3,2,29324,29324,29326,0,2,0
8397,1,3,29325,29326,29329,1,4,0
8398,6,2,29331,29331,29333,0,2,2
8399,5,2,29336,29336,29338,0,2,3
8400,3,1,29339,29339,29340,0,1,1
8401,2,3,29341,29341,29344,0,3,1
8402,3,1,29344,29344,29345,0,1,0
8403,3,3,29347,29347,29350,0,3,2
8404,4,3,29351,29351,29354,0,3,1
8405,2,3,29353,29354,29357,1,4,0
8406,2,3,29355,29357,29360,2,5,0
8407,3,3,29358,29360,29363,2,5,0
8408,6,1,29364,29364,29365,0,1,1
8409,5,2,29369,29369,29371,0,2,4
8410,3,2,29372,29372,29374,0,2,1
8411,2,2,29374,29374,29376,0,2,0
8412,3,3,29377,29377,29380,0,3,1
8413,2,1,29379,29380,29381,1,2,0
8414,2,2,29381,29381,29383,0,2,0
8415,3,2,29384,29384,29386,0,2,1
8416,6,1,29390,29390,29391,0,1,4
8417,1,2,29391,29391,29393,0,2,0
8418,2,3,29393,29393,29396,0,3,0
8419,6,3,29399,29399,29402,0,3,3
8420,5,1,29404,29404,29405,0,1,2
8421,4,2,29408,29408,29410,0,2,3
8422,4,1,29412,29412,29413,0,1,2
8423,4,1,29416,29416,29417,0,1,3
8424,3,1,29419,29419,29420,0,1,2
8425,4,1,29423,29423,29424,0,1,3
8426,6,3,29429,29429,29432,0,3,5
8427,3,1,29432,29432,29433,0,1,0
8428,3,2,29435,29435,29437,0,2,2
8429,4,1,29439,29439,29440,0,1,2
8430,1,1,29440,29440,29441,0,1,0
8431,6,2,29446,29446,29448,0,2,5
8432,3,1,29449,29449,29450,0,1,1
8433,1,3,29450,29450,29453,0,3,0
8434,1,1,29451,29453,29454,2,3,0
8435,1,1,29452,29454,29455,2,3,0
8436,3,3,29455,29455,29458,0,3,0
8437,1,1,29456,29458,29459,2,3,0
8438,5,2,29461,29461,29463,0,2,2
8439,3,1,29464,29464,29465,0,1,1
8440,5,3,29469,29469,29472,0,3,4
8441,5,3,29474,29474,29477,0,3,2
8442,4,2,29478,29478,29480,0,2,1
8443,5,1,29483,29483,29484,0,1,3
8444,3,3,29486,29486,29489,0,3,2
8445,3,3,29489,29489,29492,0,3,0
8446,6,2,29495,29495,29497,0,2,3
8447,3,3,29498,29498,29501,0,3,1
8448,6,2,29504,29504,29506,0,2,3
8449,2,1,29506,29506,29507,0,1,0
8450,2,3,29508,29508,29511,0,3,1
8451,1,3,29509,29511,29514,2,5,0
8452,3,3,29512,29514,29517,2,5,0
8453,6,2,29518,29518,29520,0,2,1
8454,4,2,29522,29522,29524,0,2,2
8455,1,1,29523,29524,29525,1,2,0
8456,6,1,29529,29529,29530,0,1,4
8457,3,1,29532,29532,29533,0,1,2
8458,4,1,29536,29536,29537,0,1,3
8459,4,3,29540,29540,29543,0,3,3
8460,5,2,29545,29545,29547,0,2,2
8461,1,2,29546,29547,29549,1,3,0
8462,3,2,29549,29549,29551,0,2,0
8463,5,1,29554,29554,29555,0,1,3
8464,2,3,29556,29556,29559,0,3,1
8465,2,1,29558,29559,29560,1,2,0
8466,3,2,29561,29561,29563,0,2,1
8467,4,1,29565,29565,29566,0,1,2
8468,3,3,29568,29568,29571,0,3,2
8469,2,3,29570,29571,29574,1,4,0
8470,1,1,29571,29574,29575,3,4,0
8471,4,2,29575,29575,29577,0,2,0
8472,1,2,29576,29577,29579,1,3,0
8473,2,3,29578,29579,29582,1,4,0
8474,5,1,29583,29583,29584,0,1,1
8475,2,1,29585,29585,29586,0,1,1
8476,4,3,29589,29589,29592,0,3,3
8477,3,3,29592,29592,29595,0,3,0
8478,4,3,29596,29596,29599,0,3,1
8479,3,1,29599,29599,29600,0,1,0
8480,1,2,29600,29600,29602,0,2,0
8481,5,3,29605,29605,29608,0,3,3
8482,6,3,29611,29611,29614,0,3,3
8483,6,3,29617,29617,29620,0,3,3
8484,3,3,29620,29620,29623,0,3,0
8485,5,2,29625,29625,29627,0,2,2
8486,1,2,29626,29627,29629,1,3,0
8487,6,1,29632,29632,29633,0,1,3
8488,4,3,29636,29636,29639,0,3,3
8489,2,2,29638,29639,29641,1,3,0
8490,1,1,29639,29641,29642,2,3,0
8491,1,2,29640,29642,29644,2,4,0
8492,4,2,29644,29644,29646,0,2,0
8493,3,3,29647,29647,29650,0,3,1
8494,4,2,29651,29651,29653,0,2,1
8495,4,2,29655,29655,29657,0,2,2
8496,4,2,29659,29659,29661,0,2,2
8497,6,3,29665,29665,29668,0,3,4
8498,5,2,29670,29670,29672,0,2,2
8499,6,3,29676,29676,29679,0,3,4
8500,5,1,29681,29681,29682,0,1,2
8501,2,3,29683,29683,29686,0,3,1
8502,5,3,29688,29688,29691,0,3,2
8503,3,3,29691,29691,29694,0,3,0
8504,5,3,29696,29696,29699,0,3,2
8505,1,1,29697,29699,29700,2,3,0
8506,3,1,29700,29700,29701,0,1,0
8507,3,1,29703,29703,29704,0,1,2
8508,6,3,29709,29709,29712,0,3,5
8509,3,1,29712,29712,29713,0,1,0
8510,2,2,29714,29714,29716,0,2,1
8511,2,1,29716,29716,29717,0,1,0
8512,4,1,29720,29720,29721,0,1,3
8513,5,3,29725,29725,29728,0,3,4
8514,2,1,29727,29728,29729,1,2,0
8515,4,3,29731,29731,29734,0,3,2
8516,4,2,29735,29735,29737,0,2,1
8517,3,1,29738,29738,29739,0,1,1
8518,6,2,29744,29744,29746,0,2,5
8519,1,1,29745,29746,29747,1,2,0
8520,6,3,29751,29751,29754,0,3,4
8521,4,2,29755,29755,29757,0,2,1
8522,4,2,29759,29759,29761,0,2,2
8523,2,3,29761,29761,29764,0,3,0
8524,4,1,29765,29765,29766,0,1,1
8525,5,3,29770,29770,29773,0,3,4
8526,2,3,29772,29773,29776,1,4,0
8527,1,3,29773,29776,29779,3,6,0
8528,4,2,29777,29779,29781,2,4,0
8529,3,3,29780,29781,29784,1,4,0
8530,6,3,29786,29786,29789,0,3,2
8531,1,3,29787,29789,29792,2,5,0
8532,5,2,29792,29792,29794,0,2,0
8533,6,1,29798,29798,29799,0,1,4
8534,6,3,29804,29804,29807,0,3,5
8535,4,1,29808,29808,29809,0,1,1
8536,4,1,29812,29812,29813,0,1,3
8537,6,1,29818,29818,29819,0,1,5
8538,6,1,29824,29824,29825,0,1,5
8539,1,1,29825,29825,29826,0,1,0
8540,1,1,29826,29826,29827,0,1,0
8541,3,3,29829,29829,29832,0,3,2
8542,6,1,29835,29835,29836,0,1,3
8543,1,3,29836,29836,29839,0,3,0
8544,6,1,29842,29842,29843,0,1,3
8545,6,2,29848,29848,29850,0,2,5
8546,1,1,29849,29850,29851,1,2,0
8547,2,1,29851,29851,29852,0,1,0
8548,3,2,29854,29854,29856,0,2,2
8549,1,2,29855,29856,29858,1,3,0
8550,3,2,29858,29858,29860,0,2,0
8551,4,3,29862,29862,29865,0,3,2
8552,5,3,29867,29867,29870,0,3,2
8553,3,2,29870,29870,29872,0,2,0
8554,3,1,29873,29873,29874,0,1,1
8555,1,1,29874,29874,29875,0,1,0
8556,4,3,29878,29878,29881,0,3,3
8557,5,1,29883,29883,29884,0,1,2
8558,1,1,29884,29884,29885,0,1,0
8559,4,1,29888,29888,29889,0,1,3
8560,1,2,29889,29889,29891,0,2,0
8561,4,2,29893,29893,29895,0,2,2
8562,4,1,29897,29897,29898,0,1,2
8563,2,3,29899,29899,29902,0,3,1
8564,4,1,29903,29903,29904,0,1,1
8565,2,2,29905,29905,29907,0,2,1
8566,4,2,29909,29909,29911,0,2,2
8567,1,1,29910,29911,29912,1,2,0
8568,6,1,29916,29916,29917,0,1,4
8569,6,3,29922,29922,29925,0,3,5
8570,5,3,29927,29927,29930,0,3,2
8571,2,2,29929,29930,29932,1,3,0
8572,4,1,29933,29933,29934,0,1,1
8573,1,1,29934,29934,29935,0,1,0
8574,3,2,29937,29937,29939,0,2,2
8575,3,1,29940,29940,29941,0,1,1
8576,2,2,29942,29942,29944,0,2,1
8577,2,3,29944,29944,29947,0,3,0
8578,5,2,29949,29949,29951,0,2,2
8579,6,1,29955,29955,29956,0,1,4
8580,3,2,29958,29958,29960,0,2,2
8581,3,1,29961,29961,29962,0,1,1
8582,3,2,29964,29964,29966,0,2,2
8583,4,1,29968,29968,29969,0,1,2
8584,3,2,29971,29971,29973,0,2,2
8585,5,3,29976,29976,29979,0,3,3
8586,3,1,29979,29979,29980,0,1,0
8587,6,2,29985,29985,29987,0,2,5
8588,5,3,29990,29990,29993,0,3,3
8589,3,3,29993,29993,29996,0,3,0
8590,3,3,29996,29996,29999,0,3,0
8591,5,2,30001,30001,30003,0,2,2
8592,6,2,30007,30007,30009,0,2,4
8593,2,1,30009,30009,30010,0,1,0
8594,3,1,30012,30012,30013,0,1,2
8595,2,2,30014,30014,30016,0,2,1
8596,1,3,30015,30016,30019,1,4,0
8597,3,1,30018,30019,30020,1,2,0
8598,1,1,30019,30020,30021,1,2,0
8599,4,3,30023,30023,30026,0,3,2
8600,6,3,30029,30029,30032,0,3,3
8601,4,2,30033,30033,30035,0,2,1
8602,6,2,30039,30039,30041,0,2,4
8603,1,3,30040,30041,30044,1,4,0
8604,4,3,30044,30044,30047,0,3,0
8605,4,3,30048,30048,30051,0,3,1
8606,1,3,30049,30051,30054,2,5,0
8607,1,3,30050,30054,30057,4,7,0
8608,2,3,30052,30057,30060,5,8,0
8609,1,3,30053,30060,30063,7,10,0
8610,6,3,30059,30063,30066,4,7,0
8611,4,3,30063,30066,30069,3,6,0
8612,4,1,30067,30069,30070,2,3,0
8613,2,1,30069,30070,30071,1,2,0
8614,4,3,30073,30073,30076,0,3,2
8615,1,1,30074,30076,30077,2,3,0
8616,4,1,30078,30078,30079,0,1,1
8617,4,3,30082,30082,30085,0,3,3
8618,2,3,30084,30085,30088,1,4,0
8619,6,3,30090,30090,30093,0,3,2
8620,3,3,30093,30093,30096,0,3,0
8621,5,3,30098,30098,30101,0,3,2
8622,1,1,30099,30101,30102,2,3,0
8623,1,1,30100,30102,30103,2,3,0
8624,5,3,30105,30105,30108,0,3,2
8625,5,2,30110,30110,30112,0,2,2
8626,6,2,30116,30116,30118,0,2,4
8627,2,3,30118,30118,30121,0,3,0
8628,4,3,30122,30122,30125,0,3,1
8629,6,2,30128,30128,30130,0,2,3
8630,1,1,30129,30130,30131,1,2,0
8631,6,2,30135,30135,30137,0,2,4
8632,1,2,30136,30137,30139,1,3,0
8633,5,3,30141,30141,30144,0,3,2
8634,5,2,30146,30146,30148,0,2,2
8635,4,3,30150,30150,30153,0,3,2
8636,1,3,30151,30153,30156,2,5,0
8637,3,1,30154,30156,30157,2,3,0
8638,5,3,30159,30159,30162,0,3,2
8639,6,3,30165,30165,30168,0,3,3
8640,5,1,30170,30170,30171,0,1,2
8641,5,2,30175,30175,30177,0,2,4
8642,5,1,30180,30180,30181,0,1,3
8643,2,2,30182,30182,30184,0,2,1
8644,6,3,30188,30188,30191,0,3,4
8645,4,1,30192,30192,30193,0,1,1
8646,2,3,30194,30194,30197,0,3,1
8647,5,2,30199,30199,30201,0,2,2
8648,6,1,30205,30205,30206,0,1,4
8649,1,3,30206,30206,30209,0,3,0
8650,2,3,30208,30209,30212,1,4,0
8651,6,3,30214,30214,30217,0,3,2
8652,3,1,30217,30217,30218,0,1,0
8653,6,2,30223,30223,30225,0,2,5
8654,4,2,30227,30227,30229,0,2,2
8655,5,3,30232,30232,30235,0,3,3
8656,1,2,30233,30235,30237,2,4,0
8657,2,1,30235,30237,30238,2,3,0
8658,6,1,30241,30241,30242,0,1,3
8659,3,1,30244,30244,30245,0,1,2
8660,2,3,30246,30246,30249,0,3,1
8661,5,2,30251,30251,30253,0,2,2
8662,5,3,30256,30256,30259,0,3,3
8663,3,2,30259,30259,30261,0,2,0
8664,1,2,30260,30261,30263,1,3,0
8665,1,2,30261,30263,30265,2,4,0
8666,1,3,30262,30265,30268,3,6,0
8667,6,1,30268,30268,30269,0,1,0
8668,2,1,30270,30270,30271,0,1,1
8669,5,1,30275,30275,30276,0,1,4
8670,6,1,30281,30281,30282,0,1,5
8671,4,2,30285,30285,30287,0,2,3
8672,3,2,30288,30288,30290,0,2,1
8673,3,2,30291,30291,30293,0,2,1
8674,5,1,30296,30296,30297,0,1,3
8675,3,1,30299,30299,30300,0,1,2
8676,3,2,30302,30302,30304,0,2,2
8677,1,2,30303,30304,30306,1,3,0
8678,4,2,30307,30307,30309,0,2,1
8679,4,1,30311,30311,30312,0,1,2
8680,5,1,30316,30316,30317,0,1,4
8681,6,3,30322,30322,30325,0,3,5
8682,5,3,30327,30327,30330,0,3,2
8683,4,3,30331,30331,30334,0,3,1
8684,6,3,30337,30337,30340,0,3,3
8685,4,2,30341,30341,30343,0,2,1
8686,1,1,30342,30343,30344,1,2,0
8687,2,1,30344,30344,30345,0,1,0
8688,5,1,30349,30349,30350,0,1,4
8689,2,1,30351,30351,30352,0,1,1
8690,1,1,30352,30352,30353,0,1,0
8691,2,2,30354,30354,30356,0,2,1
8692,2,1,30356,30356,30357,0,1,0
8693,5,3,30361,30361,30364,0,3,4
8694,6,2,30367,30367,30369,0,2,3
8695,6,3,30373,30373,30376,0,3,4
8696,3,1,30376,30376,30377,0,1,0
8697,3,3,30379,30379,30382,0,3,2
8698,3,3,30382,30382,30385,0,3,0
8699,4,1,30386,30386,30387,0,1,1
8700,5,3,30391,30391,30394,0,3,4
8701,5,1,30396,30396,30397,0,1,2
8702,5,1,30401,30401,30402,0,1,4
8703,4,3,30405,30405,30408,0,3,3
8704,5,1,30410,30410,30411,0,1,2
8705,5,2,30415,30415,30417,0,2,4
8706,3,3,30418,30418,30421,0,3,1
8707,2,2,30420,30421,30423,1,3,0
8708,2,1,30422,30423,30424,1,2,0
8709,1,1,30423,30424,30425,1,2,0
8710,5,1,30428,30428,30429,0,1,3
8711,2,3,30430,30430,30433,0,3,1
8712,6,2,30436,30436,30438,0,2,3
8713,1,2,30437,30438,30440,1,3,0
8714,4,3,30441,30441,30444,0,3,1
8715,2,2,30443,30444,30446,1,3,0
8716,2,1,30445,30446,30447,1,2,0
8717,5,2,30450,30450,30452,0,2,3
8718,5,2,30455,30455,30457,0,2,3
8719,6,3,30461,30461,30464,0,3,4
8720,4,1,30465,30465,30466,0,1,1
8721,4,2,30469,30469,30471,0,2,3
8722,6,1,30475,30475,30476,0,1,4
8723,4,1,30479,30479,30480,0,1,3
8724,4,2,30483,30483,30485,0,2,3
8725,6,3,30489,30489,30492,0,3,4
8726,4,3,30493,30493,30496,0,3,1
8727,2,2,30495,30496,30498,1,3,0
8728,4,1,30499,30499,30500,0,1,1
8729,3,2,30502,30502,30504,0,2,2
8730,5,3,30507,30507,30510,0,3,3
8731,4,2,30511,30511,30513,0,2,1
8732,1,2,30512,30513,30515,1,3,0
8733,1,1,30513,30515,30516,2,3,0
8734,1,3,30514,30516,30519,2,5,0
8735,4,2,30518,30519,30521,1,3,0
8736,5,1,30523,30523,30524,0,1,2
8737,1,2,30524,30524,30526,0,2,0
8738,1,2,30525,30526,30528,1,3,0
8739,1,2,30526,30528,30530,2,4,0
8740,2,1,30528,30530,30531,2,3,0
8741,4,2,30532,30532,30534,0,2,1
8742,5,1,30537,30537,30538,0,1,3
8743,4,2,30541,30541,30543,0,2,3
8744,6,2,30547,30547,30549,0,2,4
8745,4,3,30551,30551,30554,0,3,2
8746,3,3,30554,30554,30557,0,3,0
8747,2,1,30556,30557,30558,1,2,0
8748,1,2,30557,30558,30560,1,3,0
8749,4,1,30561,30561,30562,0,1,1
8750,6,3,30567,30567,30570,0,3,5
8751,1,1,30568,30570,30571,2,3,0
8752,5,3,30573,30573,30576,0,3,2
8753,5,1,30578,30578,30579,0,1,2
8754,5,3,30583,30583,30586,0,3,4
8755,2,3,30585,30586,30589,1,4,0
8756,2,2,30587,30589,30591,2,4,0
8757,1,2,30588,30591,30593,3,5,0
8758,3,3,30591,30593,30596,2,5,0
8759,3,1,30594,30596,30597,2,3,0
8760,2,2,30596,30597,30599,1,3,0
8761,1,3,30597,30599,30602,2,5,0
8762,4,2,30601,30602,30604,1,3,0
8763,6,3,30607,30607,30610,0,3,3
8764,3,3,30610,30610,30613,0,3,0
8765,2,3,30612,30613,30616,1,4,0
8766,2,1,30614,30616,30617,2,3,0
8767,4,2,30618,30618,30620,0,2,1
8768,3,3,30621,30621,30624,0,3,1
8769,3,1,30624,30624,30625,0,1,0
8770,3,3,30627,30627,30630,0,3,2
8771,2,2,30629,30630,30632,1,3,0
8772,2,3,30631,30632,30635,1,4,0
8773,6,2,30637,30637,30639,0,2,2
8774,5,2,30642,30642,30644,0,2,3
8775,4,1,30646,30646,30647,0,1,2
8776,6,3,30652,30652,30655,0,3,5
8777,4,2,30656,30656,30658,0,2,1
8778,2,3,30658,30658,30661,0,3,0
8779,1,1,30659,30661,30662,2,3,0
8780,1,3,30660,30662,30665,2,5,0
8781,4,2,30664,30665,30667,1,3,0
8782,5,2,30669,30669,30671,0,2,2
8783,3,1,30672,30672,30673,0,1,1
8784,2,3,30674,30674,30677,0,3,1
8785,4,1,30678,30678,30679,0,1,1
8786,5,2,30683,30683,30685,0,2,4
8787,2,1,30685,30685,30686,0,1,0
8788,4,2,30689,30689,30691,0,2,3
8789,6,2,30695,30695,30697,0,2,4
8790,3,1,30698,30698,30699,0,1,1
8791,4,2,30702,30702,30704,0,2,3
8792,3,1,30705,30705,30706,0,1,1
8793,4,1,30709,30709,30710,0,1,3
8794,1,3,30710,30710,30713,0,3,0
8795,5,1,30715,30715,30716,0,1,2
8796,5,1,30720,30720,30721,0,1,4
8797,6,1,30726,30726,30727,0,1,5
8798,1,2,30727,30727,30729,0,2,0
8799,3,2,30730,30730,30732,0,2,1
8800,1,1,30731,30732,30733,1,2,0
8801,4,1,30735,30735,30736,0,1,2
8802,2,2,30737,30737,30739,0,2,1
8803,5,2,30742,30742,30744,0,2,3
8804,3,1,30745,30745,30746,0,1,1
8805,1,2,30746,30746,30748,0,2,0
8806,2,1,30748,30748,30749,0,1,0
8807,3,1,30751,30751,30752,0,1,2
8808,4,2,30755,30755,30757,0,2,3
8809,3,2,30758,30758,30760,0,2,1
8810,2,2,30760,30760,30762,0,2,0
8811,6,2,30766,30766,30768,0,2,4
8812,6,3,30772,30772,30775,0,3,4
8813,1,2,30773,30775,30777,2,4,0
8814,2,2,30775,30777,30779,2,4,0
8815,4,3,30779,30779,30782,0,3,0
8816,5,1,30784,30784,30785,0,1,2
8817,4,2,30788,30788,30790,0,2,3
8818,2,3,30790,30790,30793,0,3,0
8819,6,2,30796,30796,30798,0,2,3
8820,3,2,30799,30799,30801,0,2,1
8821,4,1,30803,30803,30804,0,1,2
8822,4,1,30807,30807,30808,0,1,3
8823,6,1,30813,30813,30814,0,1,5
8824,3,2,30816,30816,30818,0,2,2
8825,3,1,30819,30819,30820,0,1,1
8826,6,2,30825,30825,30827,0,2,5
8827,6,2,30831,30831,30833,0,2,4
8828,1,1,30832,30833,30834,1,2,0
8829,6,2,30838,30838,30840,0,2,4
8830,4,1,30842,30842,30843,0,1,2
8831,3,2,30845,30845,30847,0,2,2
8832,6,1,30851,30851,30852,0,1,4
8833,3,3,30854,30854,30857,0,3,2
8834,4,2,30858,30858,30860,0,2,1
8835,2,1,30860,30860,30861,0,1,0
8836,1,1,30861,30861,30862,0,1,0
8837,5,2,30866,30866,30868,0,2,4
8838,2,3,30868,30868,30871,0,3,0
8839,1,2,30869,30871,30873,2,4,0
8840,6,2,30875,30875,30877,0,2,2
8841,2,2,30877,30877,30879,0,2,0
8842,4,1,30881,30881,30882,0,1,2
8843,2,3,30883,30883,30886,0,3,1
8844,2,3,30885,30886,30889,1,4,0
8845,4,1,30889,30889,30890,0,1,0
8846,4,1,30893,30893,30894,0,1,3
8847,5,3,30898,30898,30901,0,3,4
8848,1,3,30899,30901,30904,2,5,0
8849,2,1,30901,30904,30905,3,4,0
8850,6,3,30907,30907,30910,0,3,2
8851,2,3,30909,30910,30913,1,4,0
8852,1,2,30910,30913,30915,3,5,0
8853,4,1,30914,30915,30916,1,2,0
8854,2,3,30916,30916,30919,0,3,0
8855,1,1,30917,30919,30920,2,3,0
8856,3,2,30920,30920,30922,0,2,0
8857,4,1,30924,30924,30925,0,1,2
8858,6,1,30930,30930,30931,0,1,5
8859,3,3,30933,30933,30936,0,3,2
8860,3,2,30936,30936,30938,0,2,0
8861,4,1,30940,30940,30941,0,1,2
8862,2,2,30942,30942,30944,0,2,1
8863,2,1,30944,30944,30945,0,1,0
8864,4,1,30948,30948,30949,0,1,3
8865,5,3,30953,30953,30956,0,3,4
8866,2,1,30955,30956,30957,1,2,0
8867,5,2,30960,30960,30962,0,2,3
8868,3,2,30963,30963,30965,0,2,1
8869,1,1,30964,30965,30966,1,2,0
8870,2,1,30966,30966,30967,0,1,0
8871,5,2,30971,30971,30973,0,2,4
8872,4,2,30975,30975,30977,0,2,2
8873,5,3,30980,30980,30983,0,3,3
8874,3,1,30983,30983,30984,0,1,0
8875,2,2,30985,30985,30987,0,2,1
8876,5,2,30990,30990,30992,0,2,3
8877,4,3,30994,30994,30997,0,3,2
8878,4,1,30998,30998,30999,0,1,1
8879,2,2,31000,31000,31002,0,2,1
8880,6,2,31006,31006,31008,0,2,4
8881,5,3,31011,31011,31014,0,3,3
8882,3,3,31014,31014,31017,0,3,0
8883,1,2,31015,31017,31019,2,4,0
8884,6,1,31021,31021,31022,0,1,2
8885,5,1,31026,31026,31027,0,1,4
8886,2,2,31028,31028,31030,0,2,1
8887,2,1,31030,31030,31031,0,1,0
8888,5,2,31035,31035,31037,0,2,4
8889,5,1,31040,31040,31041,0,1,3
8890,6,1,31046,31046,31047,0,1,5
8891,5,3,31051,31051,31054,0,3,4
8892,2,1,31053,31054,31055,1,2,0
8893,5,2,31058,31058,31060,0,2,3
8894,6,3,31064,31064,31067,0,3,4
8895,5,3,31069,31069,31072,0,3,2
8896,3,2,31072,31072,31074,0,2,0
8897,1,3,31073,31074,31077,1,4,0
8898,3,3,31076,31077,31080,1,4,0
8899,2,1,31078,31080,31081,2,3,0
8900,4,3,31082,31082,31085,0,3,1
8901,2,3,31084,31085,31088,1,4,0
8902,6,2,31090,31090,31092,0,2,2
8903,6,2,31096,31096,31098,0,2,4
8904,5,2,31101,31101,31103,0,2,3
8905,2,2,31103,31103,31105,0,2,0
8906,4,1,31107,31107,31108,0,1,2
8907,3,2,31110,31110,31112,0,2,2
8908,3,1,31113,31113,31114,0,1,1
8909,2,2,31115,31115,31117,0,2,1
8910,6,3,31121,31121,31124,0,3,4
8911,6,1,31127,31127,31128,0,1,3
8912,3,1,31130,31130,31131,0,1,2
8913,6,3,31136,31136,31139,0,3,5
8914,1,1,31137,31139,31140,2,3,0
8915,5,1,31142,31142,31143,0,1,2
8916,3,2,31145,31145,31147,0,2,2
8917,2,2,31147,31147,31149,0,2,0
8918,1,1,31148,31149,31150,1,2,0
8919,6,2,31154,31154,31156,0,2,4
8920,5,2,31159,31159,31161,0,2,3
8921,4,2,31163,31163,31165,0,2,2
8922,2,2,31165,31165,31167,0,2,0
8923,6,3,31171,31171,31174,0,3,4
8924,2,2,31173,31174,31176,1,3,0
8925,1,1,31174,31176,31177,2,3,0
8926,4,3,31178,31178,31181,0,3,1
8927,1,1,31179,31181,31182,2,3,0
8928,4,3,31183,31183,31186,0,3,1
8929,5,3,31188,31188,31191,0,3,2
8930,4,1,31192,31192,31193,0,1,1
8931,1,2,31193,31193,31195,0,2,0
8932,6,3,31199,31199,31202,0,3,4
8933,1,1,31200,31202,31203,2,3,0
8934,1,3,31201,31203,31206,2,5,0
8935,5,2,31206,31206,31208,0,2,0
8936,4,1,31210,31210,31211,0,1,2
8937,5,2,31215,31215,31217,0,2,4
8938,1,1,31216,31217,31218,1,2,0
8939,1,1,31217,31218,31219,1,2,0
8940,4,2,31221,31221,31223,0,2,2
8941,2,2,31223,31223,31225,0,2,0
8942,3,2,31226,31226,31228,0,2,1
8943,1,2,31227,31228,31230,1,3,0
8944,2,3,31229,31230,31233,1,4,0
8945,3,3,31232,31233,31236,1,4,0
8946,3,3,31235,31236,31239,1,4,0
8947,5,3,31240,31240,31243,0,3,1
8948,1,2,31241,31243,31245,2,4,0
8949,2,2,31243,31245,31247,2,4,0
8950,2,3,31245,31247,31250,2,5,0
8951,1,1,31246,31250,31251,4,5,0
8952,5,2,31251,31251,31253,0,2,0
8953,1,2,31252,31253,31255,1,3,0
8954,6,1,31258,31258,31259,0,1,3
8955,3,1,31261,31261,31262,0,1,2
8956,6,3,31267,31267,31270,0,3,5
8957,5,3,31272,31272,31275,0,3,2
8958,1,2,31273,31275,31277,2,4,0
8959,4,3,31277,31277,31280,0,3,0
8960,6,1,31283,31283,31284,0,1,3
8961,6,3,31289,31289,31292,0,3,5
8962,2,3,31291,31292,31295,1,4,0
8963,3,3,31294,31295,31298,1,4,0
8964,2,2,31296,31298,31300,2,4,0
8965,3,1,31299,31300,31301,1,2,0
8966,3,3,31302,31302,31305,0,3,1
8967,1,3,31303,31305,31308,2,5,0
8968,2,3,31305,31308,31311,3,6,0
8969,6,1,31311,31311,31312,0,1,0
8970,2,3,31313,31313,31316,0,3,1
8971,5,1,31318,31318,31319,0,1,2
8972,1,1,31319,31319,31320,0,1,0
8973,1,1,31320,31320,31321,0,1,0
8974,3,3,31323,31323,31326,0,3,2
8975,3,2,31326,31326,31328,0,2,0
8976,6,3,31332,31332,31335,0,3,4
8977,6,3,31338,31338,31341,0,3,3
8978,3,1,31341,31341,31342,0,1,0
8979,5,1,31346,31346,31347,0,1,4
8980,2,2,31348,31348,31350,0,2,1
8981,6,2,31354,31354,31356,0,2,4
8982,5,2,31359,31359,31361,0,2,3
8983,4,3,31363,31363,31366,0,3,2
8984,5,2,31368,31368,31370,0,2,2
8985,2,2,31370,31370,31372,0,2,0
8986,4,1,31374,31374,31375,0,1,2
8987,6,2,31380,31380,31382,0,2,5
8988,5,1,31385,31385,31386,0,1,3
8989,3,1,31388,31388,31389,0,1,2
8990,1,3,31389,31389,31392,0,3,0
8991,3,2,31392,31392,31394,0,2,0
8992,5,1,31397,31397,31398,0,1,3
8993,5,2,31402,31402,31404,0,2,4
8994,3,1,31405,31405,31406,0,1,1
8995,3,3,31408,31408,31411,0,3,2
8996,1,1,31409,31411,31412,2,3,0
8997,1,1,31410,31412,31413,2,3,0
8998,2,2,31412,31413,31415,1,3,0
8999,1,3,31413,31415,31418,2,5,0
9000,6,2,31419,31419,31421,0,2,1
9001,2,3,31421,31421,31424,0,3,0
9002,2,1,31423,31424,31425,1,2,0
9003,4,3,31427,31427,31430,0,3,2
9004,4,3,31431,31431,31434,0,3,1
9005,2,3,31433,31434,31437,1,4,0
9006,6,2,31439,31439,31441,0,2,2
9007,1,3,31440,31441,31444,1,4,0
9008,6,3,31446,31446,31449,0,3,2
9009,1,3,31447,31449,31452,2,5,0
9010,2,3,31449,31452,31455,3,6,0
9011,2,3,31451,31455,31458,4,7,0
9012,3,1,31454,31458,31459,4,5,0
9013,3,1,31457,31459,31460,2,3,0
9014,1,1,31458,31460,31461,2,3,0
9015,5,1,31463,31463,31464,0,1,2
9016,1,1,31464,31464,31465,0,1,0
9017,6,1,31470,31470,31471,0,1,5
9018,5,1,31475,31475,31476,0,1,4
9019,4,2,31479,31479,31481,0,2,3
9020,5,2,31484,31484,31486,0,2,3
9021,5,2,31489,31489,31491,0,2,3
9022,5,2,31494,31494,31496,0,2,3
9023,2,3,31496,31496,31499,0,3,0
9024,5,1,31501,31501,31502,0,1,2
9025,5,3,31506,31506,31509,0,3,4
9026,6,3,31512,31512,31515,0,3,3
9027,2,1,31514,31515,31516,1,2,0
9028,3,2,31517,31517,31519,0,2,1
9029,2,3,31519,31519,31522,0,3,0
9030,6,1,31525,31525,31526,0,1,3
9031,4,2,31529,31529,31531,0,2,3
9032,3,2,31532,31532,31534,0,2,1
9033,1,3,31533,31534,31537,1,4,0
9034,6,3,31539,31539,31542,0,3,2
9035,2,3,31541,31542,31545,1,4,0
9036,4,3,31545,31545,31548,0,3,0
9037,3,3,31548,31548,31551,0,3,0
9038,6,2,31554,31554,31556,0,2,3
9039,3,2,31557,31557,31559,0,2,1
9040,3,3,31560,31560,31563,0,3,1
9041,5,2,31565,31565,31567,0,2,2
9042,6,1,31571,31571,31572,0,1,4
9043,5,1,31576,31576,31577,0,1,4
9044,6,2,31582,31582,31584,0,2,5
9045,2,2,31584,31584,31586,0,2,0
9046,4,1,31588,31588,31589,0,1,2
9047,6,3,31594,31594,31597,0,3,5
9048,4,2,31598,31598,31600,0,2,1
9049,5,2,31603,31603,31605,0,2,3
9050,2,1,31605,31605,31606,0,1,0
9051,1,2,31606,31606,31608,0,2,0
9052,6,2,31612,31612,31614,0,2,4
9053,3,3,31615,31615,31618,0,3,1
9054,6,3,31621,31621,31624,0,3,3
9055,2,3,31623,31624,31627,1,4,0
9056,6,1,31629,31629,31630,0,1,2
9057,4,1,31633,31633,31634,0,1,3
9058,1,2,31634,31634,31636,0,2,0
9059,6,3,31640,31640,31643,0,3,4
9060,4,3,31644,31644,31647,0,3,1
9061,4,2,31648,31648,31650,0,2,1
9062,6,2,31654,31654,31656,0,2,4
9063,2,2,31656,31656,31658,0,2,0
9064,5,3,31661,31661,31664,0,3,3
9065,3,2,31664,31664,31666,0,2,0
9066,3,3,31667,31667,31670,0,3,1
9067,5,3,31672,31672,31675,0,3,2
9068,2,1,31674,31675,31676,1,2,0
9069,1,1,31675,31676,31677,1,2,0
9070,6,3,31681,31681,31684,0,3,4
9071,4,3,31685,31685,31688,0,3,1
9072,6,1,31691,31691,31692,0,1,3
9073,4,3,31695,31695,31698,0,3,3
9074,4,1,31699,31699,31700,0,1,1
9075,2,3,31701,31701,31704,0,3,1
9076,3,3,31704,31704,31707,0,3,0
9077,4,1,31708,31708,31709,0,1,1
9078,1,3,31709,31709,31712,0,3,0
9079,4,3,31713,31713,31716,0,3,1
9080,5,1,31718,31718,31719,0,1,2
9081,4,1,31722,31722,31723,0,1,3
9082,3,2,31725,31725,31727,0,2,2
9083,3,1,31728,31728,31729,0,1,1
9084,4,1,31732,31732,31733,0,1,3
9085,3,1,31735,31735,31736,0,1,2
9086,5,1,31740,31740,31741,0,1,4
9087,1,3,31741,31741,31744,0,3,0
9088,4,1,31745,31745,31746,0,1,1
9089,6,2,31751,31751,31753,0,2,5
9090,3,3,31754,31754,31757,0,3,1
9091,3,3,31757,31757,31760,0,3,0
9092,5,2,31762,31762,31764,0,2,2
9093,1,1,31763,31764,31765,1,2,0
9094,4,1,31767,31767,31768,0,1,2
9095,1,2,31768,31768,31770,0,2,0
9096,5,2,31773,31773,31775,0,2,3
9097,3,3,31776,31776,31779,0,3,1
9098,1,1,31777,31779,31780,2,3,0
9099,4,1,31781,31781,31782,0,1,1
9100,2,3,31783,31783,31786,0,3,1
9101,3,1,31786,31786,31787,0,1,0
9102,5,2,31791,31791,31793,0,2,4
9103,6,2,31797,31797,31799,0,2,4
9104,5,1,31802,31802,31803,0,1,3
9105,3,2,31805,31805,31807,0,2,2
9106,1,1,31806,31807,31808,1,2,0
9107,1,2,31807,31808,31810,1,3,0
9108,1,3,31808,31810,31813,2,5,0
9109,1,2,31809,31813,31815,4,6,0
9110,5,3,31814,31815,31818,1,4,0
9111,2,2,31816,31818,31820,2,4,0
9112,6,2,31822,31822,31824,0,2,2
9113,3,1,31825,31825,31826,0,1,1
9114,6,1,31831,31831,31832,0,1,5
9115,6,1,31837,31837,31838,0,1,5
9116,5,1,31842,31842,31843,0,1,4
9117,3,2,31845,31845,31847,0,2,2
9118,3,1,31848,31848,31849,0,1,1
9119,5,2,31853,31853,31855,0,2,4
9120,4,3,31857,31857,31860,0,3,2
9121,5,3,31862,31862,31865,0,3,2
9122,1,2,31863,31865,31867,2,4,0
9123,2,2,31865,31867,31869,2,4,0
9124,3,3,31868,31869,31872,1,4,0
9125,3,3,31871,31872,31875,1,4,0
9126,6,1,31877,31877,31878,0,1,2
9127,3,3,31880,31880,31883,0,3,2
9128,6,3,31886,31886,31889,0,3,3
9129,6,2,31892,31892,31894,0,2,3
9130,1,1,31893,31894,31895,1,2,0
9131,1,2,31894,31895,31897,1,3,0
9132,4,2,31898,31898,31900,0,2,1
9133,4,1,31902,31902,31903,0,1,2
9134,2,3,31904,31904,31907,0,3,1
9135,6,2,31910,31910,31912,0,2,3
9136,3,1,31913,31913,31914,0,1,1
9137,5,3,31918,31918,31921,0,3,4
9138,2,1,31920,31921,31922,1,2,0
9139,2,1,31922,31922,31923,0,1,0
9140,3,2,31925,31925,31927,0,2,2
9141,6,1,31931,31931,31932,0,1,4
9142,2,3,31933,31933,31936,0,3,1
9143,3,3,31936,31936,31939,0,3,0
9144,5,1,31941,31941,31942,0,1,2
9145,3,3,31944,31944,31947,0,3,2
9146,4,2,31948,31948,31950,0,2,1
9147,6,3,31954,31954,31957,0,3,4
9148,1,3,31955,31957,31960,2,5,0
9149,6,2,31961,31961,31963,0,2,1
9150,6,3,31967,31967,31970,0,3,4
9151,4,2,31971,31971,31973,0,2,1
9152,5,1,31976,31976,31977,0,1,3
9153,3,1,31979,31979,31980,0,1,2
9154,1,1,31980,31980,31981,0,1,0
9155,3,1,31983,31983,31984,0,1,2
9156,4,1,31987,31987,31988,0,1,3
9157,2,2,31989,31989,31991,0,2,1
9158,1,3,31990,31991,31994,1,4,0
9159,6,1,31996,31996,31997,0,1,2
9160,6,2,32002,32002,32004,0,2,5
9161,4,1,32006,32006,32007,0,1,2
9162,6,3,32012,32012,32015,0,3,5
9163,5,2,32017,32017,32019,0,2,2
9164,1,2,32018,32019,32021,1,3,0
9165,4,2,32022,32022,32024,0,2,1
9166,5,2,32027,32027,32029,0,2,3
9167,2,1,32029,32029,32030,0,1,0
9168,4,2,32033,32033,32035,0,2,3
9169,6,3,32039,32039,32042,0,3,4
9170,5,1,32044,32044,32045,0,1,2
9171,5,3,32049,32049,32052,0,3,4
9172,5,1,32054,32054,32055,0,1,2
9173,5,3,32059,32059,32062,0,3,4
9174,2,3,32061,32062,32065,1,4,0
9175,5,1,32066,32066,32067,0,1,1
9176,5,3,32071,32071,32074,0,3,4
9177,5,2,32076,32076,32078,0,2,2
9178,2,3,32078,32078,32081,0,3,0
9179,4,2,32082,32082,32084,0,2,1
9180,1,3,32083,32084,32087,1,4,0
9181,1,2,32084,32087,32089,3,5,0
9182,5,3,32089,32089,32092,0,3,0
9183,1,1,32090,32092,32093,2,3,0
9184,4,1,32094,32094,32095,0,1,1
9185,1,1,32095,32095,32096,0,1,0
9186,3,3,32098,32098,32101,0,3,2
9187,1,1,32099,32101,32102,2,3,0
9188,2,1,32101,32102,32103,1,2,0
9189,6,1,32107,32107,32108,0,1,4
9190,2,2,32109,32109,32111,0,2,1
9191,6,1,32115,32115,32116,0,1,4
9192,5,3,32120,32120,32123,0,3,4
9193,5,1,32125,32125,32126,0,1,2
9194,4,1,32129,32129,32130,0,1,3
9195,1,1,32130,32130,32131,0,1,0
9196,2,1,32132,32132,32133,0,1,1
9197,4,2,32136,32136,32138,0,2,3
9198,2,2,32138,32138,32140,0,2,0
9199,3,1,32141,32141,32142,0,1,1
9200,3,3,32144,32144,32147,0,3,2
9201,1,1,32145,32147,32148,2,3,0
9202,1,3,32146,32148,32151,2,5,0
9203,3,3,32149,32151,32154,2,5,0
9204,5,1,32154,32154,32155,0,1,0
9205,2,2,32156,32156,32158,0,2,1
9206,6,3,32162,32162,32165,0,3,4
9207,4,1,32166,32166,32167,0,1,1
9208,5,2,32171,32171,32173,0,2,4
9209,6,2,32177,32177,32179,0,2,4
9210,2,3,32179,32179,32182,0,3,0
9211,2,1,32181,32182,32183,1,2,0
9212,1,1,32182,32183,32184,1,2,0
9213,2,3,32184,32184,32187,0,3,0
9214,5,2,32189,32189,32191,0,2,2
9215,4,1,32193,32193,32194,0,1,2
9216,1,2,32194,32194,32196,0,2,0
9217,4,1,32198,32198,32199,0,1,2
9218,6,3,32204,32204,32207,0,3,5
9219,1,2,32205,32207,32209,2,4,0
9220,2,3,32207,32209,32212,2,5,0
9221,3,2,32210,32212,32214,2,4,0
9222,6,2,32216,32216,32218,0,2,2
9223,6,1,32222,32222,32223,0,1,4
9224,5,3,32227,32227,32230,0,3,4
9225,3,3,32230,32230,32233,0,3,0
9226,1,3,32231,32233,32236,2,5,0
9227,5,3,32236,32236,32239,0,3,0
9228,3,2,32239,32239,32241,0,2,0
9229,5,2,32244,32244,32246,0,2,3
9230,3,2,32247,32247,32249,0,2,1
9231,1,1,32248,32249,32250,1,2,0
9232,1,1,32249,32250,32251,1,2,0
9233,1,3,32250,32251,32254,1,4,0
9234,5,1,32255,32255,32256,0,1,1
9235,2,3,32257,32257,32260,0,3,1
9236,3,3,32260,32260,32263,0,3,0
9237,1,1,32261,32263,32264,2,3,0
9238,3,3,32264,32264,32267,0,3,0
9239,6,2,32270,32270,32272,0,2,3
9240,5,1,32275,32275,32276,0,1,3
9241,3,3,32278,32278,32281,0,3,2
9242,5,2,32283,32283,32285,0,2,2
9243,4,2,32287,32287,32289,0,2,2
9244,3,3,32290,32290,32293,0,3,1
9245,5,2,32295,32295,32297,0,2,2
9246,4,1,32299,32299,32300,0,1,2
9247,1,3,32300,32300,32303,0,3,0
9248,2,3,32302,32303,32306,1,4,0
9249,5,1,32307,32307,32308,0,1,1
9250,4,1,32311,32311,32312,0,1,3
9251,1,3,32312,32312,32315,0,3,0
9252,5,2,32317,32317,32319,0,2,2
9253,5,3,32322,32322,32325,0,3,3
9254,3,1,32325,32325,32326,0,1,0
9255,2,2,32327,32327,32329,0,2,1
9256,5,3,32332,32332,32335,0,3,3
9257,6,3,32338,32338,32341,0,3,3
9258,5,2,32343,32343,32345,0,2,2
9259,4,3,32347,32347,32350,0,3,2
9260,3,1,32350,32350,32351,0,1,0
9261,5,1,32355,32355,32356,0,1,4
9262,2,2,32357,32357,32359,0,2,1
9263,1,1,32358,32359,32360,1,2,0
9264,1,3,32359,32360,32363,1,4,0
9265,3,3,32362,32363,32366,1,4,0
9266,1,1,32363,32366,32367,3,4,0
9267,2,3,32365,32367,32370,2,5,0
9268,1,1,32366,32370,32371,4,5,0
9269,2,2,32368,32371,32373,3,5,0
9270,2,1,32370,32373,32374,3,4,0
9271,3,1,32373,32374,32375,1,2,0
9272,2,3,32375,32375,32378,0,3,0
9273,6,2,32381,32381,32383,0,2,3
9274,1,1,32382,32383,32384,1,2,0
9275,3,2,32385,32385,32387,0,2,1
9276,3,1,32388,32388,32389,0,1,1
9277,3,1,32391,32391,32392,0,1,2
9278,6,2,32397,32397,32399,0,2,5
9279,5,2,32402,32402,32404,0,2,3
9280,5,2,32407,32407,32409,0,2,3
9281,5,1,32412,32412,32413,0,1,3
9282,4,2,32416,32416,32418,0,2,3
9283,2,3,32418,32418,32421,0,3,0
9284,4,3,32422,32422,32425,0,3,1
9285,3,1,32425,32425,32426,0,1,0
9286,4,2,32429,32429,32431,0,2,3
9287,5,2,32434,32434,32436,0,2,3
9288,4,3,32438,32438,32441,0,3,2
9289,3,1,32441,32441,32442,0,1,0
9290,3,1,32444,32444,32445,0,1,2
9291,5,1,32449,32449,32450,0,1,4
9292,2,1,32451,32451,32452,0,1,1
9293,4,1,32455,32455,32456,0,1,3
9294,1,2,32456,32456,32458,0,2,0
9295,3,1,32459,32459,32460,0,1,1
9296,5,2,32464,32464,32466,0,2,4
9297,3,2,32467,32467,32469,0,2,1
9298,2,3,32469,32469,32472,0,3,0
9299,1,1,32470,32472,32473,2,3,0
9300,1,3,32471,32473,32476,2,5,0
9301,2,2,32473,32476,32478,3,5,0
9302,1,1,32474,32478,32479,4,5,0
9303,5,2,32479,32479,32481,0,2,0
9304,6,1,32485,32485,32486,0,1,4
9305,2,1,32487,32487,32488,0,1,1
9306,6,3,32493,32493,32496,0,3,5
9307,4,3,32497,32497,32500,0,3,1
9308,6,1,32503,32503,32504,0,1,3
9309,1,3,32504,32504,32507,0,3,0
9310,2,1,32506,32507,32508,1,2,0
9311,3,1,32509,32509,32510,0,1,1
9312,1,1,32510,32510,32511,0,1,0
9313,6,2,32516,32516,32518,0,2,5
9314,6,2,32522,32522,32524,0,2,4
9315,6,2,32528,32528,32530,0,2,4
9316,3,2,32531,32531,32533,0,2,1
9317,5,3,32536,32536,32539,0,3,3
9318,3,2,32539,32539,32541,0,2,0
9319,1,2,32540,32541,32543,1,3,0
9320,2,1,32542,32543,32544,1,2,0
9321,3,3,32545,32545,32548,0,3,1
9322,4,1,32549,32549,32550,0,1,1
9323,4,2,32553,32553,32555,0,2,3
9324,6,2,32559,32559,32561,0,2,4
9325,1,1,32560,32561,32562,1,2,0
9326,4,2,32564,32564,32566,0,2,2
9327,3,2,32567,32567,32569,0,2,1
9328,1,2,32568,32569,32571,1,3,0
9329,5,1,32573,32573,32574,0,1,2
9330,4,2,32577,32577,32579,0,2,3
9331,1,1,32578,32579,32580,1,2,0
9332,2,2,32580,32580,32582,0,2,0
9333,4,2,32584,32584,32586,0,2,2
9334,4,3,32588,32588,32591,0,3,2
9335,4,2,32592,32592,32594,0,2,1
9336,2,1,32594,32594,32595,0,1,0
9337,5,1,32599,32599,32600,0,1,4
9338,5,3,32604,32604,32607,0,3,4
9339,5,3,32609,32609,32612,0,3,2
9340,5,3,32614,32614,32617,0,3,2
9341,6,1,32620,32620,32621,0,1,3
9342,4,1,32624,32624,32625,0,1,3
9343,6,3,32630,32630,32633,0,3,5
9344,4,2,32634,32634,32636,0,2,1
9345,3,1,32637,32637,32638,0,1,1
9346,2,1,32639,32639,32640,0,1,1
9347,1,1,32640,32640,32641,0,1,0
9348,3,3,32643,32643,32646,0,3,2
9349,5,2,32648,32648,32650,0,2,2
9350,4,3,32652,32652,32655,0,3,2
9351,1,2,32653,32655,32657,2,4,0
9352,6,1,32659,32659,32660,0,1,2
9353,1,1,32660,32660,32661,0,1,0
9354,1,1,32661,32661,32662,0,1,0
9355,1,3,32662,32662,32665,0,3,0
9356,5,1,32667,32667,32668,0,1,2
9357,5,2,32672,32672,32674,0,2,4
9358,1,3,32673,32674,32677,1,4,0
9359,3,1,32676,32677,32678,1,2,0
9360,3,3,32679,32679,32682,0,3,1
9361,4,3,32683,32683,32686,0,3,1
9362,6,1,32689,32689,32690,0,1,3
9363,1,1,32690,32690,32691,0,1,0
9364,3,3,32693,32693,32696,0,3,2
9365,1,1,32694,32696,32697,2,3,0
9366,6,3,32700,32700,32703,0,3,3
9367,6,1,32706,32706,32707,0,1,3
9368,1,2,32707,32707,32709,0,2,0
9369,5,1,32712,32712,32713,0,1,3
9370,4,2,32716,32716,32718,0,2,3
9371,3,3,32719,32719,32722,0,3,1
9372,3,2,32722,32722,32724,0,2,0
9373,3,1,32725,32725,32726,0,1,1
9374,1,2,32726,32726,32728,0,2,0
9375,6,2,32732,32732,32734,0,2,4
9376,6,3,32738,32738,32741,0,3,4
9377,1,3,32739,32741,32744,2,5,0
9378,2,1,32741,32744,32745,3,4,0
9379,2,2,32743,32745,32747,2,4,0
9380,1,3,32744,32747,32750,3,6,0
9381,5,1,32749,32750,32751,1,2,0
9382,3,3,32752,32752,32755,0,3,1
9383,3,1,32755,32755,32756,0,1,0
9384,1,3,32756,32756,32759,0,3,0
9385,1,1,32757,32759,32760,2,3,0
9386,4,1,32761,32761,32762,0,1,1
9387,5,1,32766,32766,32767,0,1,4
9388,2,2,32768,32768,32770,0,2,1
9389,6,3,32774,32774,32777,0,3,4
9390,6,2,32780,32780,32782,0,2,3
9391,3,1,32783,32783,32784,0,1,1
9392,2,1,32785,32785,32786,0,1,1
9393,2,1,32787,32787,32788,0,1,1
9394,4,3,32791,32791,32794,0,3,3
9395,5,1,32796,32796,32797,0,1,2
9396,3,2,32799,32799,32801,0,2,2
9397,4,3,32803,32803,32806,0,3,2
9398,3,3,32806,32806,32809,0,3,0
9399,5,3,32811,32811,32814,0,3,2
9400,6,1,32817,32817,32818,0,1,3
9401,3,1,32820,32820,32821,0,1,2
9402,1,1,32821,32821,32822,0,1,0
9403,1,1,32822,32822,32823,0,1,0
9404,1,1,32823,32823,32824,0,1,0
9405,6,3,32829,32829,32832,0,3,5
9406,2,3,32831,32832,32835,1,4,0
9407,1,1,32832,32835,32836,3,4,0
9408,2,3,32834,32836,32839,2,5,0
9409,5,3,32839,32839,32842,0,3,0
9410,2,2,32841,32842,32844,1,3,0
9411,2,1,32843,32844,32845,1,2,0
9412,2,1,32845,32845,32846,0,1,0
9413,1,1,32846,32846,32847,0,1,0
9414,4,3,32850,32850,32853,0,3,3
9415,5,2,32855,32855,32857,0,2,2
9416,1,2,32856,32857,32859,1,3,0
9417,1,3,32857,32859,32862,2,5,0
9418,4,1,32861,32862,32863,1,2,0
9419,2,2,32863,32863,32865,0,2,0
9420,5,1,32868,32868,32869,0,1,3
9421,4,1,32872,32872,32873,0,1,3
9422,5,3,32877,32877,32880,0,3,4
9423,5,1,32882,32882,32883,0,1,2
9424,2,1,32884,32884,32885,0,1,1
9425,2,2,32886,32886,32888,0,2,1
9426,1,3,32887,32888,32891,1,4,0
9427,1,3,32888,32891,32894,3,6,0
9428,5,2,32893,32894,32896,1,3,0
9429,1,1,32894,32896,32897,2,3,0
9430,5,3,32899,32899,32902,0,3,2
9431,5,2,32904,32904,32906,0,2,2
9432,5,1,32909,32909,32910,0,1,3
9433,2,1,32911,32911,32912,0,1,1
9434,6,1,32917,32917,32918,0,1,5
9435,3,2,32920,32920,32922,0,2,2
9436,4,3,32924,32924,32927,0,3,2
9437,4,3,32928,32928,32931,0,3,1
9438,2,1,32930,32931,32932,1,2,0
9439,3,1,32933,32933,32934,0,1,1
9440,2,2,32935,32935,32937,0,2,1
9441,5,2,32940,32940,32942,0,2,3
9442,5,3,32945,32945,32948,0,3,3
9443,3,3,32948,32948,32951,0,3,0
9444,6,2,32954,32954,32956,0,2,3
9445,2,1,32956,32956,32957,0,1,0
9446,1,1,32957,32957,32958,0,1,0
9447,5,2,32962,32962,32964,0,2,4
9448,3,3,32965,32965,32968,0,3,1
9449,5,2,32970,32970,32972,0,2,2
9450,5,2,32975,32975,32977,0,2,3
9451,6,1,32981,32981,32982,0,1,4
9452,5,2,32986,32986,32988,0,2,4
9453,1,1,32987,32988,32989,1,2,0
9454,5,3,32992,32992,32995,0,3,3
9455,2,2,32994,32995,32997,1,3,0
9456,6,2,33000,33000,33002,0,2,3
9457,3,2,33003,33003,33005,0,2,1
9458,4,3,33007,33007,33010,0,3,2
9459,2,2,33009,33010,33012,1,3,0
9460,4,1,33013,33013,33014,0,1,1
9461,2,3,33015,33015,33018,0,3,1
9462,3,1,33018,33018,33019,0,1,0
9463,6,1,33024,33024,33025,0,1,5
9464,3,1,33027,33027,33028,0,1,2
9465,6,1,33033,33033,33034,0,1,5
9466,6,2,33039,33039,33041,0,2,5
9467,6,3,33045,33045,33048,0,3,4
9468,5,2,33050,33050,33052,0,2,2
9469,3,3,33053,33053,33056,0,3,1
9470,4,1,33057,33057,33058,0,1,1
9471,2,3,33059,33059,33062,0,3,1
9472,4,1,33063,33063,33064,0,1,1
9473,5,2,33068,33068,33070,0,2,4
9474,3,1,33071,33071,33072,0,1,1
9475,4,1,33075,33075,33076,0,1,3
9476,2,2,33077,33077,33079,0,2,1
9477,6,2,33083,33083,33085,0,2,4
9478,4,2,33087,33087,33089,0,2,2
9479,3,2,33090,33090,33092,0,2,1
9480,2,2,33092,33092,33094,0,2,0
9481,1,2,33093,33094,33096,1,3,0
9482,1,2,33094,33096,33098,2,4,0
9483,1,3,33095,33098,33101,3,6,0
9484,4,3,33099,33101,33104,2,5,0
9485,5,2,33104,33104,33106,0,2,0
9486,3,1,33107,33107,33108,0,1,1
9487,3,3,33110,33110,33113,0,3,2
9488,2,2,33112,33113,33115,1,3,0
9489,1,3,33113,33115,33118,2,5,0
9490,6,2,33119,33119,33121,0,2,1
9491,4,2,33123,33123,33125,0,2,2
9492,3,1,33126,33126,33127,0,1,1
9493,4,1,33130,33130,33131,0,1,3
9494,6,3,33136,33136,33139,0,3,5
9495,3,2,33139,33139,33141,0,2,0
9496,1,3,33140,33141,33144,1,4,0
9497,2,1,33142,33144,33145,2,3,0
9498,3,1,33145,33145,33146,0,1,0
9499,4,2,33149,33149,33151,0,2,3
9500,5,2,33154,33154,33156,0,2,3
9501,2,3,33156,33156,33159,0,3,0
9502,3,1,33159,33159,33160,0,1,0
9503,6,2,33165,33165,33167,0,2,5
9504,3,2,33168,33168,33170,0,2,1
9505,3,2,33171,33171,33173,0,2,1
9506,6,2,33177,33177,33179,0,2,4
9507,1,3,33178,33179,33182,1,4,0
9508,6,3,33184,33184,33187,0,3,2
9509,5,3,33189,33189,33192,0,3,2
9510,1,1,33190,33192,33193,2,3,0
9511,6,3,33196,33196,33199,0,3,3
9512,4,3,33200,33200,33203,0,3,1
9513,5,1,33205,33205,33206,0,1,2
9514,1,1,33206,33206,33207,0,1,0
9515,6,1,33212,33212,33213,0,1,5
9516,4,1,33216,33216,33217,0,1,3
9517,6,2,33222,33222,33224,0,2,5
9518,5,3,33227,33227,33230,0,3,3
9519,5,3,33232,33232,33235,0,3,2
9520,1,3,33233,33235,33238,2,5,0
9521,3,3,33236,33238,33241,2,5,0
9522,5,2,33241,33241,33243,0,2,0
9523,3,2,33244,33244,33246,0,2,1
9524,2,1,33246,33246,33247,0,1,0
9525,6,1,33252,33252,33253,0,1,5
9526,5,2,33257,33257,33259,0,2,4
9527,4,1,33261,33261,33262,0,1,2
9528,6,1,33267,33267,33268,0,1,5
9529,4,3,33271,33271,33274,0,3,3
9530,2,1,33273,33274,33275,1,2,0
9531,5,2,33278,33278,33280,0,2,3
9532,1,1,33279,33280,33281,1,2,0
9533,6,3,33285,33285,33288,0,3,4
9534,4,3,33289,33289,33292,0,3,1
9535,4,3,33293,33293,33296,0,3,1
9536,6,3,33299,33299,33302,0,3,3
9537,3,1,33302,33302,33303,0,1,0
9538,1,3,33303,33303,33306,0,3,0
9539,1,1,33304,33306,33307,2,3,0
9540,2,2,33306,33307,33309,1,3,0
9541,5,1,33311,33311,33312,0,1,2
9542,4,2,33315,33315,33317,0,2,3
9543,1,2,33316,33317,33319,1,3,0
9544,6,3,33322,33322,33325,0,3,3
9545,1,3,33323,33325,33328,2,5,0
9546,5,3,33328,33328,33331,0,3,0
9547,4,1,33332,33332,33333,0,1,1
9548,3,2,33335,33335,33337,0,2,2
9549,1,2,33336,33337,33339,1,3,0
9550,1,2,33337,33339,33341,2,4,0
9551,6,3,33343,33343,33346,0,3,2
9552,5,3,33348,33348,33351,0,3,2
9553,1,3,33349,33351,33354,2,5,0
9554,4,2,33353,33354,33356,1,3,0
9555,4,1,33357,33357,33358,0,1,1
9556,5,2,33362,33362,33364,0,2,4
9557,1,3,33363,33364,33367,1,4,0
9558,2,2,33365,33367,33369,2,4,0
9559,6,1,33371,33371,33372,0,1,2
9560,5,2,33376,33376,33378,0,2,4
9561,4,3,33380,33380,33383,0,3,2
9562,1,2,33381,33383,33385,2,4,0
9563,4,1,33385,33385,33386,0,1,0
9564,5,1,33390,33390,33391,0,1,4
9565,2,3,33392,33392,33395,0,3,1
9566,2,3,33394,33395,33398,1,4,0
9567,1,2,33395,33398,33400,3,5,0
9568,5,3,33400,33400,33403,0,3,0
9569,1,3,33401,33403,33406,2,5,0
9570,6,3,33407,33407,33410,0,3,1
9571,3,2,33410,33410,33412,0,2,0
9572,5,3,33415,33415,33418,0,3,3
9573,4,1,33419,33419,33420,0,1,1
9574,1,2,33420,33420,33422,0,2,0
9575,2,3,33422,33422,33425,0,3,0
9576,1,2,33423,33425,33427,2,4,0
9577,6,2,33429,33429,33431,0,2,2
9578,6,1,33435,33435,33436,0,1,4
9579,3,2,33438,33438,33440,0,2,2
9580,3,3,33441,33441,33444,0,3,1
9581,6,3,33447,33447,33450,0,3,3
9582,5,3,33452,33452,33455,0,3,2
9583,6,3,33458,33458,33461,0,3,3
9584,5,1,33463,33463,33464,0,1,2
9585,5,3,33468,33468,33471,0,3,4
9586,6,1,33474,33474,33475,0,1,3
9587,6,2,33480,33480,33482,0,2,5
9588,6,3,33486,33486,33489,0,3,4
9589,1,2,33487,33489,33491,2,4,0
9590,2,1,33489,33491,33492,2,3,0
9591,4,1,33493,33493,33494,0,1,1
9592,2,3,33495,33495,33498,0,3,1
9593,6,2,33501,33501,33503,0,2,3
9594,6,2,33507,33507,33509,0,2,4
9595,5,2,33512,33512,33514,0,2,3
9596,6,1,33518,33518,33519,0,1,4
9597,6,2,33524,33524,33526,0,2,5
9598,4,2,33528,33528,33530,0,2,2
9599,1,3,33529,33530,33533,1,4,0
9600,1,3,33530,33533,33536,3,6,0
9601,1,3,33531,33536,33539,5,8,0
9602,5,3,33536,33539,33542,3,6,0
9603,5,1,33541,33542,33543,1,2,0
9604,5,2,33546,33546,33548,0,2,3
9605,2,3,33548,33548,33551,0,3,0
9606,5,1,33553,33553,33554,0,1,2
9607,5,1,33558,33558,33559,0,1,4
9608,1,1,33559,33559,33560,0,1,0
9609,1,1,33560,33560,33561,0,1,0
9610,4,2,33564,33564,33566,0,2,3
9611,1,3,33565,33566,33569,1,4,0
9612,3,1,33568,33569,33570,1,2,0
9613,3,2,33571,33571,33573,0,2,1
9614,2,3,33573,33573,33576,0,3,0
9615,6,1,33579,33579,33580,0,1,3
9616,4,3,33583,33583,33586,0,3,3
9617,3,2,33586,33586,33588,0,2,0
9618,1,1,33587,33588,33589,1,2,0
9619,2,1,33589,33589,33590,0,1,0
9620,1,1,33590,33590,33591,0,1,0
9621,3,3,33593,33593,33596,0,3,2
9622,5,2,33598,33598,33600,0,2,2
9623,2,2,33600,33600,33602,0,2,0
9624,4,2,33604,33604,33606,0,2,2
9625,5,1,33609,33609,33610,0,1,3
9626,6,3,33615,33615,33618,0,3,5
9627,2,3,33617,33618,33621,1,4,0
9628,3,2,33620,33621,33623,1,3,0
9629,5,1,33625,33625,33626,0,1,2
9630,5,3,33630,33630,33633,0,3,4
9631,6,1,33636,33636,33637,0,1,3
9632,2,3,33638,33638,33641,0,3,1
9633,1,1,33639,33641,33642,2,3,0
9634,1,3,33640,33642,33645,2,5,0
9635,5,3,33645,33645,33648,0,3,0
9636,3,2,33648,33648,33650,0,2,0
9637,5,1,33653,33653,33654,0,1,3
9638,6,3,33659,33659,33662,0,3,5
9639,2,2,33661,33662,33664,1,3,0
9640,4,3,33665,33665,33668,0,3,1
9641,1,2,33666,33668,33670,2,4,0
9642,2,3,33668,33670,33673,2,5,0
9643,3,2,33671,33673,33675,2,4,0
9644,1,3,33672,33675,33678,3,6,0
9645,4,2,33676,33678,33680,2,4,0
9646,3,3,33679,33680,33683,1,4,0
9647,1,3,33680,33683,33686,3,6,0
9648,1,1,33681,33686,33687,5,6,0
9649,3,2,33684,33687,33689,3,5,0
9650,6,1,33690,33690,33691,0,1,1
9651,3,2,33693,33693,33695,0,2,2
9652,4,1,33697,33697,33698,0,1,2
9653,1,2,33698,33698,33700,0,2,0
9654,2,1,33700,33700,33701,0,1,0
9655,1,3,33701,33701,33704,0,3,0
9656,6,1,33707,33707,33708,0,1,3
9657,2,2,33709,33709,33711,0,2,1
9658,5,2,33714,33714,33716,0,2,3
9659,5,2,33719,33719,33721,0,2,3
9660,5,1,33724,33724,33725,0,1,3
9661,3,1,33727,33727,33728,0,1,2
9662,5,2,33732,33732,33734,0,2,4
9663,4,1,33736,33736,33737,0,1,2
9664,6,1,33742,33742,33743,0,1,5
9665,5,3,33747,33747,33750,0,3,4
9666,3,1,33750,33750,33751,0,1,0
9667,5,1,33755,33755,33756,0,1,4
9668,4,2,33759,33759,33761,0,2,3
9669,5,2,33764,33764,33766,0,2,3
9670,2,3,33766,33766,33769,0,3,0
9671,2,2,33768,33769,33771,1,3,0
9672,5,3,33773,33773,33776,0,3,2
9673,5,3,33778,33778,33781,0,3,2
9674,6,3,33784,33784,33787,0,3,3
9675,1,2,33785,33787,33789,2,4,0
9676,1,2,33786,33789,33791,3,5,0
9677,5,3,33791,33791,33794,0,3,0
9678,6,3,33797,33797,33800,0,3,3
9679,1,2,33798,33800,33802,2,4,0
9680,5,1,33803,33803,33804,0,1,1
9681,6,2,33809,33809,33811,0,2,5
9682,3,2,33812,33812,33814,0,2,1
9683,4,3,33816,33816,33819,0,3,2
9684,6,3,33822,33822,33825,0,3,3
9685,3,3,33825,33825,33828,0,3,0
9686,2,3,33827,33828,33831,1,4,0
9687,5,3,33832,33832,33835,0,3,1
9688,5,2,33837,33837,33839,0,2,2
9689,6,3,33843,33843,33846,0,3,4
9690,2,2,33845,33846,33848,1,3,0
9691,3,1,33848,33848,33849,0,1,0
9692,5,1,33853,33853,33854,0,1,4
9693,4,2,33857,33857,33859,0,2,3
9694,4,3,33861,33861,33864,0,3,2
9695,2,3,33863,33864,33867,1,4,0
9696,1,2,33864,33867,33869,3,5,0
9697,5,2,33869,33869,33871,0,2,0
9698,3,1,33872,33872,33873,0,1,1
9699,2,2,33874,33874,33876,0,2,1
9700,1,2,33875,33876,33878,1,3,0
9701,4,1,33879,33879,33880,0,1,1
9702,3,2,33882,33882,33884,0,2,2
9703,5,3,33887,33887,33890,0,3,3
9704,5,3,33892,33892,33895,0,3,2
9705,6,2,33898,33898,33900,0,2,3
9706,1,1,33899,33900,33901,1,2,0
9707,2,1,33901,33901,33902,0,1,0
9708,4,3,33905,33905,33908,0,3,3
9709,1,3,33906,33908,33911,2,5,0
9710,6,2,33912,33912,33914,0,2,1
9711,3,2,33915,33915,33917,0,2,1
9712,3,2,33918,33918,33920,0,2,1
9713,5,3,33923,33923,33926,0,3,3
9714,4,1,33927,33927,33928,0,1,1
9715,2,3,33929,33929,33932,0,3,1
9716,2,1,33931,33932,33933,1,2,0
9717,5,3,33936,33936,33939,0,3,3
9718,6,3,33942,33942,33945,0,3,3
9719,1,2,33943,33945,33947,2,4,0
9720,5,3,33948,33948,33951,0,3,1
9721,6,1,33954,33954,33955,0,1,3
9722,3,2,33957,33957,33959,0,2,2
9723,1,3,33958,33959,33962,1,4,0
9724,5,2,33963,33963,33965,0,2,1
9725,4,2,33967,33967,33969,0,2,2
9726,5,1,33972,33972,33973,0,1,3
9727,1,1,33973,33973,33974,0,1,0
9728,4,1,33977,33977,33978,0,1,3
9729,5,2,33982,33982,33984,0,2,4
9730,5,3,33987,33987,33990,0,3,3
9731,1,3,33988,33990,33993,2,5,0
9732,2,3,33990,33993,33996,3,6,0
9733,5,2,33995,33996,33998,1,3,0
9734,4,3,33999,33999,34002,0,3,1
9735,2,3,34001,34002,34005,1,4,0
9736,2,1,34003,34005,34006,2,3,0
9737,4,3,34007,34007,34010,0,3,1
9738,5,1,34012,34012,34013,0,1,2
9739,1,1,34013,34013,34014,0,1,0
9740,3,3,34016,34016,34019,0,3,2
9741,6,1,34022,34022,34023,0,1,3
9742,5,3,34027,34027,34030,0,3,4
9743,4,3,34031,34031,34034,0,3,1
9744,6,2,34037,34037,34039,0,2,3
9745,4,3,34041,34041,34044,0,3,2
9746,2,2,34043,34044,34046,1,3,0
9747,2,3,34045,34046,34049,1,4,0
9748,5,2,34050,34050,34052,0,2,1
9749,4,3,34054,34054,34057,0,3,2
9750,5,1,34059,34059,34060,0,1,2
9751,5,1,34064,34064,34065,0,1,4
9752,1,2,34065,34065,34067,0,2,0
9753,3,1,34068,34068,34069,0,1,1
9754,2,2,34070,34070,34072,0,2,1
9755,1,1,34071,34072,34073,1,2,0
9756,3,2,34074,34074,34076,0,2,1
9757,6,1,34080,34080,34081,0,1,4
9758,1,1,34081,34081,34082,0,1,0
9759,4,2,34085,34085,34087,0,2,3
9760,3,3,34088,34088,34091,0,3,1
9761,6,3,34094,34094,34097,0,3,3
9762,5,2,34099,34099,34101,0,2,2
9763,6,2,34105,34105,34107,0,2,4
9764,6,1,34111,34111,34112,0,1,4
9765,1,3,34112,34112,34115,0,3,0
9766,5,3,34117,34117,34120,0,3,2
9767,6,3,34123,34123,34126,0,3,3
9768,6,1,34129,34129,34130,0,1,3
9769,6,3,34135,34135,34138,0,3,5
9770,6,1,34141,34141,34142,0,1,3
9771,4,1,34145,34145,34146,0,1,3
9772,5,1,34150,34150,34151,0,1,4
9773,4,3,34154,34154,34157,0,3,3
9774,5,3,34159,34159,34162,0,3,2
9775,2,1,34161,34162,34163,1,2,0
9776,1,1,34162,34163,34164,1,2,0
9777,1,3,34163,34164,34167,1,4,0
9778,5,3,34168,34168,34171,0,3,1
9779,3,2,34171,34171,34173,0,2,0
9780,3,3,34174,34174,34177,0,3,1
9781,4,2,34178,34178,34180,0,2,1
9782,5,2,34183,34183,34185,0,2,3
9783,6,1,34189,34189,34190,0,1,4
9784,3,3,34192,34192,34195,0,3,2
9785,4,3,34196,34196,34199,0,3,1
9786,4,2,34200,34200,34202,0,2,1
9787,4,1,34204,34204,34205,0,1,2
9788,3,2,34207,34207,34209,0,2,2
9789,5,3,34212,34212,34215,0,3,3
9790,6,1,34218,34218,34219,0,1,3
9791,2,3,34220,34220,34223,0,3,1
9792,1,2,34221,34223,34225,2,4,0
9793,6,2,34227,34227,34229,0,2,2
9794,2,3,34229,34229,34232,0,3,0
9795,2,3,34231,34232,34235,1,4,0
9796,5,3,34236,34236,34239,0,3,1
9797,3,2,34239,34239,34241,0,2,0
9798,1,1,34240,34241,34242,1,2,0
9799,2,1,34242,34242,34243,0,1,0
9800,6,3,34248,34248,34251,0,3,5
9801,6,1,34254,34254,34255,0,1,3
9802,4,2,34258,34258,34260,0,2,3
9803,5,1,34263,34263,34264,0,1,3
9804,4,1,34267,34267,34268,0,1,3
9805,4,2,34271,34271,34273,0,2,3
9806,5,2,34276,34276,34278,0,2,3
9807,3,2,34279,34279,34281,0,2,1
9808,4,1,34283,34283,34284,0,1,2
9809,1,3,34284,34284,34287,0,3,0
9810,2,3,34286,34287,34290,1,4,0
9811,2,1,34288,34290,34291,2,3,0
9812,6,2,34294,34294,34296,0,2,3
9813,5,1,34299,34299,34300,0,1,3
9814,5,2,34304,34304,34306,0,2,4
9815,2,1,34306,34306,34307,0,1,0
9816,5,1,34311,34311,34312,0,1,4
9817,6,3,34317,34317,34320,0,3,5
9818,2,3,34319,34320,34323,1,4,0
9819,1,3,34320,34323,34326,3,6,0
9820,1,3,34321,34326,34329,5,8,0
9821,5,2,34326,34329,34331,3,5,0
9822,3,1,34329,34331,34332,2,3,0
9823,6,1,34335,34335,34336,0,1,3
9824,4,3,34339,34339,34342,0,3,3
9825,2,1,34341,34342,34343,1,2,0
9826,2,3,34343,34343,34346,0,3,0
9827,5,3,34348,34348,34351,0,3,2
9828,3,3,34351,34351,34354,0,3,0
9829,6,3,34357,34357,34360,0,3,3
9830,4,2,34361,34361,34363,0,2,1
9831,1,1,34362,34363,34364,1,2,0
9832,5,2,34367,34367,34369,0,2,3
9833,4,2,34371,34371,34373,0,2,2
9834,2,1,34373,34373,34374,0,1,0
9835,5,2,34378,34378,34380,0,2,4
9836,1,2,34379,34380,34382,1,3,0
9837,5,2,34384,34384,34386,0,2,2
9838,2,3,34386,34386,34389,0,3,0
9839,6,3,34392,34392,34395,0,3,3
9840,2,3,34394,34395,34398,1,4,0
9841,2,3,34396,34398,34401,2,5,0
9842,1,1,34397,34401,34402,4,5,0
9843,3,3,34400,34402,34405,2,5,0
9844,3,3,34403,34405,34408,2,5,0
9845,4,3,34407,34408,34411,1,4,0
9846,6,3,34413,34413,34416,0,3,2
9847,1,2,34414,34416,34418,2,4,0
9848,1,3,34415,34418,34421,3,6,0
9849,5,3,34420,34421,34424,1,4,0
9850,6,3,34426,34426,34429,0,3,2
9851,1,2,34427,34429,34431,2,4,0
9852,1,2,34428,34431,34433,3,5,0
9853,3,2,34431,34433,34435,2,4,0
9854,3,3,34434,34435,34438,1,4,0
9855,5,1,34439,34439,34440,0,1,1
9856,1,3,34440,34440,34443,0,3,0
9857,2,2,34442,34443,34445,1,3,0
9858,4,2,34446,34446,34448,0,2,1
9859,1,3,34447,34448,34451,1,4,0
9860,1,1,34448,34451,34452,3,4,0
9861,3,2,34451,34452,34454,1,3,0
9862,4,2,34455,34455,34457,0,2,1
9863,6,2,34461,34461,34463,0,2,4
9864,3,1,34464,34464,34465,0,1,1
9865,2,1,34466,34466,34467,0,1,1
9866,2,1,34468,34468,34469,0,1,1
9867,1,2,34469,34469,34471,0,2,0
9868,2,3,34471,34471,34474,0,3,0
9869,2,2,34473,34474,34476,1,3,0
9870,6,2,34479,34479,34481,0,2,3
9871,1,1,34480,34481,34482,1,2,0
9872,2,2,34482,34482,34484,0,2,0
9873,2,3,34484,34484,34487,0,3,0
9874,3,1,34487,34487,34488,0,1,0
9875,1,3,34488,34488,34491,0,3,0
9876,1,2,34489,34491,34493,2,4,0
9877,4,2,34493,34493,34495,0,2,0
9878,4,3,34497,34497,34500,0,3,2
9879,3,1,34500,34500,34501,0,1,0
9880,1,3,34501,34501,34504,0,3,0
9881,2,3,34503,34504,34507,1,4,0
9882,1,2,34504,34507,34509,3,5,0
9883,5,2,34509,34509,34511,0,2,0
9884,4,3,34513,34513,34516,0,3,2
9885,4,3,34517,34517,34520,0,3,1
9886,6,1,34523,34523,34524,0,1,3
9887,1,3,34524,34524,34527,0,3,0
9888,5,1,34529,34529,34530,0,1,2
9889,3,1,34532,34532,34533,0,1,2
9890,6,3,34538,34538,34541,0,3,5
9891,2,3,34540,34541,34544,1,4,0
9892,5,3,34545,34545,34548,0,3,1
9893,2,2,34547,34548,34550,1,3,0
9894,6,1,34553,34553,34554,0,1,3
9895,5,2,34558,34558,34560,0,2,4
9896,6,2,34564,34564,34566,0,2,4
9897,6,2,34570,34570,34572,0,2,4
9898,2,2,34572,34572,34574,0,2,0
9899,5,2,34577,34577,34579,0,2,3
9900,5,1,34582,34582,34583,0,1,3
9901,2,1,34584,34584,34585,0,1,1
9902,4,2,34588,34588,34590,0,2,3
9903,1,2,34589,34590,34592,1,3,0
9904,6,2,34595,34595,34597,0,2,3
9905,5,3,34600,34600,34603,0,3,3
9906,3,1,34603,34603,34604,0,1,0
9907,1,2,34604,34604,34606,0,2,0
9908,2,2,34606,34606,34608,0,2,0
9909,1,2,34607,34608,34610,1,3,0
9910,3,3,34610,34610,34613,0,3,0
9911,5,3,34615,34615,34618,0,3,2
9912,6,3,34621,34621,34624,0,3,3
9913,1,1,34622,34624,34625,2,3,0
9914,4,1,34626,34626,34627,0,1,1
9915,1,2,34627,34627,34629,0,2,0
9916,2,2,34629,34629,34631,0,2,0
9917,2,1,34631,34631,34632,0,1,0
9918,4,3,34635,34635,34638,0,3,3
9919,4,2,34639,34639,34641,0,2,1
9920,2,3,34641,34641,34644,0,3,0
9921,5,2,34646,34646,34648,0,2,2
9922,5,1,34651,34651,34652,0,1,3
9923,4,2,34655,34655,34657,0,2,3
9924,4,2,34659,34659,34661,0,2,2
9925,1,2,34660,34661,34663,1,3,0
9926,5,3,34665,34665,34668,0,3,2
9927,2,2,34667,34668,34670,1,3,0
9928,1,1,34668,34670,34671,2,3,0
9929,5,1,34673,34673,34674,0,1,2
9930,2,2,34675,34675,34677,0,2,1
9931,2,3,34677,34677,34680,0,3,0
9932,1,3,34678,34680,34683,2,5,0
9933,2,2,34680,34683,34685,3,5,0
9934,2,1,34682,34685,34686,3,4,0
9935,3,1,34685,34686,34687,1,2,0
9936,1,2,34686,34687,34689,1,3,0
9937,4,1,34690,34690,34691,0,1,1
9938,3,1,34693,34693,34694,0,1,2
9939,2,3,34695,34695,34698,0,3,1
9940,4,1,34699,34699,34700,0,1,1
9941,4,3,34703,34703,34706,0,3,3
9942,1,3,34704,34706,34709,2,5,0
9943,4,3,34708,34709,34712,1,4,0
9944,3,1,34711,34712,34713,1,2,0
9945,3,2,34714,34714,34716,0,2,1
9946,1,3,34715,34716,34719,1,4,0
9947,1,3,34716,34719,34722,3,6,0
9948,6,2,34722,34722,34724,0,2,0
9949,6,2,34728,34728,34730,0,2,4
9950,2,3,34730,34730,34733,0,3,0
9951,3,3,34733,34733,34736,0,3,0
9952,4,1,34737,34737,34738,0,1,1
9953,4,1,34741,34741,34742,0,1,3
9954,5,3,34746,34746,34749,0,3,4
9955,3,2,34749,34749,34751,0,2,0
9956,4,3,34753,34753,34756,0,3,2
9957,6,3,34759,34759,34762,0,3,3
9958,5,1,34764,34764,34765,0,1,2
9959,2,2,34766,34766,34768,0,2,1
9960,5,3,34771,34771,34774,0,3,3
9961,1,2,34772,34774,34776,2,4,0
9962,6,3,34778,34778,34781,0,3,2
9963,2,3,34780,34781,34784,1,4,0
9964,2,1,34782,34784,34785,2,3,0
9965,6,2,34788,34788,34790,0,2,3
9966,5,2,34793,34793,34795,0,2,3
9967,1,2,34794,34795,34797,1,3,0
9968,6,3,34800,34800,34803,0,3,3
9969,2,1,34802,34803,34804,1,2,0
9970,2,3,34804,34804,34807,0,3,0
9971,6,3,34810,34810,34813,0,3,3
9972,4,2,34814,34814,34816,0,2,1
9973,4,1,34818,34818,34819,0,1,2
9974,6,2,34824,34824,34826,0,2,5
9975,1,1,34825,34826,34827,1,2,0
9976,2,2,34827,34827,34829,0,2,0
9977,1,3,34828,34829,34832,1,4,0
9978,6,3,34834,34834,34837,0,3,2
9979,4,3,34838,34838,34841,0,3,1
9980,5,3,34843,34843,34846,0,3,2
9981,2,1,34845,34846,34847,1,2,0
9982,1,3,34846,34847,34850,1,4,0
9983,4,2,34850,34850,34852,0,2,0
9984,6,3,34856,34856,34859,0,3,4
9985,2,3,34858,34859,34862,1,4,0
9986,6,1,34864,34864,34865,0,1,2
9987,2,2,34866,34866,34868,0,2,1
9988,1,1,34867,34868,34869,1,2,0
9989,4,2,34871,34871,34873,0,2,2
9990,2,3,34873,34873,34876,0,3,0
9991,5,2,34878,34878,34880,0,2,2
9992,6,2,34884,34884,34886,0,2,4
9993,3,3,34887,34887,34890,0,3,1
9994,3,2,34890,34890,34892,0,2,0
9995,3,2,34893,34893,34895,0,2,1
9996,6,3,34899,34899,34902,0,3,4
9997,2,2,34901,34902,34904,1,3,0
9998,2,3,34903,34904,34907,1,4,0
9999,4,3,34907,34907,34910,0,3,0
10000,6,1,34913,34913,34914,0,1,3
10001,4,3,34917,34917,34920,0,3,3
10002,5,1,34922,34922,34923,0,1,2
10003,6,3,34928,34928,34931,0,3,5
10004,1,2,34929,34931,34933,2,4,0
10005,2,2,34931,34933,34935,2,4,0
10006,6,3,34937,34937,34940,0,3,2
10007,6,1,34943,34943,34944,0,1,3
10008,1,1,34944,34944,34945,0,1,0
10009,2,1,34946,34946,34947,0,1,1
10010,5,1,34951,34951,34952,0,1,4
10011,3,2,34954,34954,34956,0,2,2
10012,4,3,34958,34958,34961,0,3,2
10013,1,3,34959,34961,34964,2,5,0
10014,1,1,34960,34964,34965,4,5,0
10015,4,3,34964,34965,34968,1,4,0
10016,3,3,34967,34968,34971,1,4,0
10017,5,3,34972,34972,34975,0,3,1
10018,1,1,34973,34975,34976,2,3,0
10019,5,3,34978,34978,34981,0,3,2
10020,1,2,34979,34981,34983,2,4,0
10021,1,1,34980,34983,34984,3,4,0
10022,5,3,34985,34985,34988,0,3,1
10023,6,2,34991,34991,34993,0,2,3
10024,6,1,34997,34997,34998,0,1,4
10025,2,3,34999,34999,35002,0,3,1
10026,5,2,35004,35004,35006,0,2,2
10027,2,1,35006,35006,35007,0,1,0
10028,6,2,35012,35012,35014,0,2,5
10029,3,3,35015,35015,35018,0,3,1
10030,5,2,35020,35020,35022,0,2,2
10031,2,1,35022,35022,35023,0,1,0
10032,3,2,35025,35025,35027,0,2,2
10033,1,3,35026,35027,35030,1,4,0
10034,5,1,35031,35031,35032,0,1,1
10035,5,2,35036,35036,35038,0,2,4
10036,6,3,35042,35042,35045,0,3,4
10037,3,3,35045,35045,35048,0,3,0
10038,6,2,35051,35051,35053,0,2,3
10039,3,3,35054,35054,35057,0,3,1
10040,1,2,35055,35057,35059,2,4,0
10041,1,1,35056,35059,35060,3,4,0
10042,2,1,35058,35060,35061,2,3,0
10043,4,3,35062,35062,35065,0,3,1
10044,2,2,35064,35065,35067,1,3,0
10045,3,2,35067,35067,35069,0,2,0
10046,4,3,35071,35071,35074,0,3,2
10047,5,3,35076,35076,35079,0,3,2
10048,1,3,35077,35079,35082,2,5,0
10049,3,2,35080,35082,35084,2,4,0
10050,5,3,35085,35085,35088,0,3,1
10051,2,1,35087,35088,35089,1,2,0
10052,4,1,35091,35091,35092,0,1,2
10053,2,1,35093,35093,35094,0,1,1
10054,4,1,35097,35097,35098,0,1,3
10055,5,2,35102,35102,35104,0,2,4
10056,3,3,35105,35105,35108,0,3,1
10057,5,1,35110,35110,35111,0,1,2
10058,5,1,35115,35115,35116,0,1,4
10059,5,2,35120,35120,35122,0,2,4
10060,2,2,35122,35122,35124,0,2,0
10061,3,3,35125,35125,35128,0,3,1
10062,6,3,35131,35131,35134,0,3,3
10063,2,2,35133,35134,35136,1,3,0
10064,6,1,35139,35139,35140,0,1,3
10065,3,2,35142,35142,35144,0,2,2
10066,2,2,35144,35144,35146,0,2,0
10067,2,3,35146,35146,35149,0,3,0
10068,1,2,35147,35149,35151,2,4,0
10069,1,1,35148,35151,35152,3,4,0
10070,1,1,35149,35152,35153,3,4,0
10071,3,3,35152,35153,35156,1,4,0
10072,4,1,35156,35156,35157,0,1,0
10073,6,1,35162,35162,35163,0,1,5
10074,4,2,35166,35166,35168,0,2,3
10075,1,1,35167,35168,35169,1,2,0
10076,3,2,35170,35170,35172,0,2,1
10077,4,3,35174,35174,35177,0,3,2
10078,2,1,35176,35177,35178,1,2,0
10079,6,1,35182,35182,35183,0,1,4
10080,3,3,35185,35185,35188,0,3,2
10081,3,2,35188,35188,35190,0,2,0
10082,6,1,35194,35194,35195,0,1,4
10083,5,2,35199,35199,35201,0,2,4
10084,2,3,35201,35201,35204,0,3,0
10085,6,2,35207,35207,35209,0,2,3
10086,1,2,35208,35209,35211,1,3,0
10087,5,2,35213,35213,35215,0,2,2
10088,1,2,35214,35215,35217,1,3,0
10089,5,3,35219,35219,35222,0,3,2
10090,6,2,35225,35225,35227,0,2,3
10091,1,1,35226,35227,35228,1,2,0
10092,5,3,35231,35231,35234,0,3,3
10093,6,2,35237,35237,35239,0,2,3
10094,4,2,35241,35241,35243,0,2,2
10095,5,1,35246,35246,35247,0,1,3
10096,5,1,35251,35251,35252,0,1,4
10097,2,1,35253,35253,35254,0,1,1
10098,4,3,35257,35257,35260,0,3,3
10099,3,3,35260,35260,35263,0,3,0
10100,5,1,35265,35265,35266,0,1,2
10101,2,3,35267,35267,35270,0,3,1
10102,3,2,35270,35270,35272,0,2,0
10103,3,3,35273,35273,35276,0,3,1
10104,4,3,35277,35277,35280,0,3,1
10105,3,3,35280,35280,35283,0,3,0
10106,4,3,35284,35284,35287,0,3,1
10107,4,2,35288,35288,35290,0,2,1
10108,5,1,35293,35293,35294,0,1,3
10109,5,3,35298,35298,35301,0,3,4
10110,4,3,35302,35302,35305,0,3,1
10111,5,1,35307,35307,35308,0,1,2
10112,4,3,35311,35311,35314,0,3,3
10113,5,2,35316,35316,35318,0,2,2
10114,3,1,35319,35319,35320,0,1,1
10115,3,3,35322,35322,35325,0,3,2
10116,2,2,35324,35325,35327,1,3,0
10117,4,1,35328,35328,35329,0,1,1
10118,2,2,35330,35330,35332,0,2,1
10119,1,3,35331,35332,35335,1,4,0
10120,6,2,35337,35337,35339,0,2,2
10121,5,3,35342,35342,35345,0,3,3
10122,2,3,35344,35345,35348,1,4,0
10123,3,3,35347,35348,35351,1,4,0
10124,2,3,35349,35351,35354,2,5,0
10125,6,1,35355,35355,35356,0,1,1
10126,6,3,35361,35361,35364,0,3,5
10127,2,3,35363,35364,35367,1,4,0
10128,4,3,35367,35367,35370,0,3,0
10129,6,1,35373,35373,35374,0,1,3
10130,2,2,35375,35375,35377,0,2,1
10131,1,1,35376,35377,35378,1,2,0
10132,5,1,35381,35381,35382,0,1,3
10133,4,3,35385,35385,35388,0,3,3
10134,4,2,35389,35389,35391,0,2,1
10135,5,1,35394,35394,35395,0,1,3
10136,2,2,35396,35396,35398,0,2,1
10137,4,2,35400,35400,35402,0,2,2
10138,3,3,35403,35403,35406,0,3,1
10139,5,1,35408,35408,35409,0,1,2
10140,1,2,35409,35409,35411,0,2,0
10141,5,2,35414,35414,35416,0,2,3
10142,5,3,35419,35419,35422,0,3,3
10143,1,2,35420,35422,35424,2,4,0
10144,3,2,35423,35424,35426,1,3,0
10145,2,3,35425,35426,35429,1,4,0
10146,4,3,35429,35429,35432,0,3,0
10147,2,1,35431,35432,35433,1,2,0
10148,5,3,35436,35436,35439,0,3,3
10149,5,2,35441,35441,35443,0,2,2
10150,4,3,35445,35445,35448,0,3,2
10151,1,2,35446,35448,35450,2,4,0
10152,3,2,35449,35450,35452,1,3,0
10153,2,1,35451,35452,35453,1,2,0
10154,1,1,35452,35453,35454,1,2,0
10155,4,2,35456,35456,35458,0,2,2
10156,5,3,35461,35461,35464,0,3,3
10157,2,2,35463,35464,35466,1,3,0
10158,5,1,35468,35468,35469,0,1,2
10159,3,3,35471,35471,35474,0,3,2
10160,6,2,35477,35477,35479,0,2,3
10161,4,1,35481,35481,35482,0,1,2
10162,6,2,35487,35487,35489,0,2,5
10163,5,2,35492,35492,35494,0,2,3
10164,4,1,35496,35496,35497,0,1,2
10165,2,3,35498,35498,35501,0,3,1
10166,6,3,35504,35504,35507,0,3,3
10167,4,3,35508,35508,35511,0,3,1
10168,6,2,35514,35514,35516,0,2,3
10169,4,1,35518,35518,35519,0,1,2
10170,1,3,35519,35519,35522,0,3,0
10171,5,3,35524,35524,35527,0,3,2
10172,1,1,35525,35527,35528,2,3,0
10173,3,2,35528,35528,35530,0,2,0
10174,4,2,35532,35532,35534,0,2,2
10175,3,3,35535,35535,35538,0,3,1
10176,4,3,35539,35539,35542,0,3,1
10177,3,3,35542,35542,35545,0,3,0
10178,3,2,35545,35545,35547,0,2,0
10179,6,2,35551,35551,35553,0,2,4
10180,4,1,35555,35555,35556,0,1,2
10181,2,3,35557,35557,35560,0,3,1
10182,2,3,35559,35560,35563,1,4,0
10183,4,2,35563,35563,35565,0,2,0
10184,3,2,35566,35566,35568,0,2,1
10185,5,1,35571,35571,35572,0,1,3
10186,2,2,35573,35573,35575,0,2,1
10187,3,3,35576,35576,35579,0,3,1
10188,4,3,35580,35580,35583,0,3,1
10189,4,1,35584,35584,35585,0,1,1
10190,2,1,35586,35586,35587,0,1,1
10191,3,2,35589,35589,35591,0,2,2
10192,3,2,35592,35592,35594,0,2,1
10193,5,1,35597,35597,35598,0,1,3
10194,1,1,35598,35598,35599,0,1,0
10195,5,3,35603,35603,35606,0,3,4
10196,5,3,35608,35608,35611,0,3,2
10197,1,1,35609,35611,35612,2,3,0
10198,4,3,35613,35613,35616,0,3,1
10199,3,3,35616,35616,35619,0,3,0
10200,5,2,35621,35621,35623,0,2,2
10201,6,2,35627,35627,35629,0,2,4
10202,4,1,35631,35631,35632,0,1,2
10203,5,2,35636,35636,35638,0,2,4
10204,4,3,35640,35640,35643,0,3,2
10205,5,3,35645,35645,35648,0,3,2
10206,3,3,35648,35648,35651,0,3,0
10207,4,1,35652,35652,35653,0,1,1
10208,5,1,35657,35657,35658,0,1,4
10209,3,2,35660,35660,35662,0,2,2
10210,4,2,35664,35664,35666,0,2,2
10211,3,3,35667,35667,35670,0,3,1
10212,1,3,35668,35670,35673,2,5,0
10213,6,1,35674,35674,35675,0,1,1
10214,5,3,35679,35679,35682,0,3,4
10215,1,2,35680,35682,35684,2,4,0
10216,6,1,35686,35686,35687,0,1,2
10217,1,2,35687,35687,35689,0,2,0
10218,1,3,35688,35689,35692,1,4,0
10219,1,2,35689,35692,35694,3,5,0
10220,3,2,35692,35694,35696,2,4,0
10221,4,2,35696,35696,35698,0,2,0
10222,6,1,35702,35702,35703,0,1,4
10223,3,3,35705,35705,35708,0,3,2
10224,3,2,35708,35708,35710,0,2,0
10225,3,2,35711,35711,35713,0,2,1
10226,1,2,35712,35713,35715,1,3,0
10227,1,1,35713,35715,35716,2,3,0
10228,6,1,35719,35719,35720,0,1,3
10229,4,3,35723,35723,35726,0,3,3
10230,6,1,35729,35729,35730,0,1,3
10231,5,3,35734,35734,35737,0,3,4
10232,3,2,35737,35737,35739,0,2,0
10233,5,2,35742,35742,35744,0,2,3
10234,6,2,35748,35748,35750,0,2,4
10235,4,2,35752,35752,35754,0,2,2
10236,5,1,35757,35757,35758,0,1,3
10237,5,3,35762,35762,35765,0,3,4
10238,1,1,35763,35765,35766,2,3,0
10239,6,2,35769,35769,35771,0,2,3
10240,5,3,35774,35774,35777,0,3,3
10241,4,1,35778,35778,35779,0,1,1
10242,1,2,35779,35779,35781,0,2,0
10243,2,2,35781,35781,35783,0,2,0
10244,4,1,35785,35785,35786,0,1,2
10245,6,3,35791,35791,35794,0,3,5
10246,2,3,35793,35794,35797,1,4,0
10247,5,1,35798,35798,35799,0,1,1
10248,3,3,35801,35801,35804,0,3,2
10249,5,3,35806,35806,35809,0,3,2
10250,3,1,35809,35809,35810,0,1,0
10251,2,2,35811,35811,35813,0,2,1
10252,5,1,35816,35816,35817,0,1,3
10253,5,2,35821,35821,35823,0,2,4
10254,5,3,35826,35826,35829,0,3,3
10255,5,1,35831,35831,35832,0,1,2
10256,1,3,35832,35832,35835,0,3,0
10257,4,3,35836,35836,35839,0,3,1
10258,3,1,35839,35839,35840,0,1,0
10259,1,2,35840,35840,35842,0,2,0
10260,2,2,35842,35842,35844,0,2,0
10261,6,3,35848,35848,35851,0,3,4
10262,3,2,35851,35851,35853,0,2,0
10263,1,2,35852,35853,35855,1,3,0
10264,6,1,35858,35858,35859,0,1,3
10265,5,3,35863,35863,35866,0,3,4
10266,3,2,35866,35866,35868,0,2,0
10267,1,1,35867,35868,35869,1,2,0
10268,4,1,35871,35871,35872,0,1,2
10269,4,1,35875,35875,35876,0,1,3
10270,1,2,35876,35876,35878,0,2,0
10271,1,3,35877,35878,35881,1,4,0
10272,1,3,35878,35881,35884,3,6,0
10273,4,3,35882,35884,35887,2,5,0
10274,6,2,35888,35888,35890,0,2,1
10275,1,2,35889,35890,35892,1,3,0
10276,1,2,35890,35892,35894,2,4,0
10277,2,2,35892,35894,35896,2,4,0
10278,5,3,35897,35897,35900,0,3,1
10279,1,2,35898,35900,35902,2,4,0
10280,6,2,35904,35904,35906,0,2,2
10281,6,1,35910,35910,35911,0,1,4
10282,5,2,35915,35915,35917,0,2,4
10283,5,2,35920,35920,35922,0,2,3
10284,2,2,35922,35922,35924,0,2,0
10285,2,1,35924,35924,35925,0,1,0
10286,5,2,35929,35929,35931,0,2,4
10287,3,1,35932,35932,35933,0,1,1
10288,6,2,35938,35938,35940,0,2,5
10289,5,3,35943,35943,35946,0,3,3
10290,1,2,35944,35946,35948,2,4,0
10291,6,3,35950,35950,35953,0,3,2
10292,4,1,35954,35954,35955,0,1,1
10293,4,2,35958,35958,35960,0,2,3
10294,2,2,35960,35960,35962,0,2,0
10295,4,1,35964,35964,35965,0,1,2
10296,1,3,35965,35965,35968,0,3,0
10297,3,2,35968,35968,35970,0,2,0
10298,6,3,35974,35974,35977,0,3,4
10299,1,3,35975,35977,35980,2,5,0
10300,2,2,35977,35980,35982,3,5,0
10301,2,1,35979,35982,35983,3,4,0
10302,5,1,35984,35984,35985,0,1,1
10303,1,2,35985,35985,35987,0,2,0
10304,4,3,35989,35989,35992,0,3,2
10305,2,3,35991,35992,35995,1,4,0
10306,5,3,35996,35996,35999,0,3,1
10307,5,3,36001,36001,36004,0,3,2
10308,6,1,36007,36007,36008,0,1,3
10309,6,2,36013,36013,36015,0,2,5
10310,2,1,36015,36015,36016,0,1,0
10311,2,1,36017,36017,36018,0,1,1
10312,4,1,36021,36021,36022,0,1,3
10313,2,2,36023,36023,36025,0,2,1
10314,6,2,36029,36029,36031,0,2,4
10315,3,1,36032,36032,36033,0,1,1
10316,6,2,36038,36038,36040,0,2,5
10317,6,3,36044,36044,36047,0,3,4
10318,1,3,36045,36047,36050,2,5,0
10319,2,1,36047,36050,36051,3,4,0
10320,5,2,36052,36052,36054,0,2,1
10321,2,3,36054,36054,36057,0,3,0
10322,6,3,36060,36060,36063,0,3,3
10323,4,3,36064,36064,36067,0,3,1
10324,2,2,36066,36067,36069,1,3,0
10325,1,3,36067,36069,36072,2,5,0
10326,6,1,36073,36073,36074,0,1,1
10327,3,3,36076,36076,36079,0,3,2
10328,6,2,36082,36082,36084,0,2,3
10329,6,3,36088,36088,36091,0,3,4
10330,2,3,36090,36091,36094,1,4,0
10331,2,2,36092,36094,36096,2,4,0
10332,5,3,36097,36097,36100,0,3,1
10333,5,2,36102,36102,36104,0,2,2
10334,5,1,36107,36107,36108,0,1,3
10335,5,3,36112,36112,36115,0,3,4
10336,2,3,36114,36115,36118,1,4,0
10337,4,1,36118,36118,36119,0,1,0
10338,1,1,36119,36119,36120,0,1,0
10339,4,3,36123,36123,36126,0,3,3
10340,2,3,36125,36126,36129,1,4,0
10341,5,3,36130,36130,36133,0,3,1
10342,5,1,36135,36135,36136,0,1,2
10343,4,3,36139,36139,36142,0,3,3
10344,2,1,36141,36142,36143,1,2,0
10345,3,2,36144,36144,36146,0,2,1
10346,1,1,36145,36146,36147,1,2,0
10347,4,1,36149,36149,36150,0,1,2
10348,2,3,36151,36151,36154,0,3,1
10349,6,2,36157,36157,36159,0,2,3
10350,1,3,36158,36159,36162,1,4,0
10351,1,1,36159,36162,36163,3,4,0
10352,1,3,36160,36163,36166,3,6,0
10353,5,1,36165,36166,36167,1,2,0
10354,5,2,36170,36170,36172,0,2,3
10355,4,1,36174,36174,36175,0,1,2
10356,6,1,36180,36180,36181,0,1,5
10357,3,1,36183,36183,36184,0,1,2
10358,1,3,36184,36184,36187,0,3,0
10359,2,1,36186,36187,36188,1,2,0
10360,5,3,36191,36191,36194,0,3,3
10361,3,3,36194,36194,36197,0,3,0
10362,4,2,36198,36198,36200,0,2,1
10363,5,2,36203,36203,36205,0,2,3
10364,3,1,36206,36206,36207,0,1,1
10365,2,1,36208,36208,36209,0,1,1
10366,3,3,36211,36211,36214,0,3,2
10367,6,2,36217,36217,36219,0,2,3
10368,1,2,36218,36219,36221,1,3,0
10369,1,1,36219,36221,36222,2,3,0
10370,6,3,36225,36225,36228,0,3,3
10371,4,2,36229,36229,36231,0,2,1
10372,6,2,36235,36235,36237,0,2,4
10373,2,3,36237,36237,36240,0,3,0
10374,1,2,36238,36240,36242,2,4,0
10375,5,2,36243,36243,36245,0,2,1
10376,4,1,36247,36247,36248,0,1,2
10377,5,1,36252,36252,36253,0,1,4
10378,3,3,36255,36255,36258,0,3,2
10379,3,3,36258,36258,36261,0,3,0
10380,3,1,36261,36261,36262,0,1,0
10381,6,2,36267,36267,36269,0,2,5
10382,1,3,36268,36269,36272,1,4,0
10383,5,2,36273,36273,36275,0,2,1
10384,2,3,36275,36275,36278,0,3,0
10385,5,1,36280,36280,36281,0,1,2
10386,2,3,36282,36282,36285,0,3,1
10387,6,2,36288,36288,36290,0,2,3
10388,4,3,36292,36292,36295,0,3,2
10389,4,1,36296,36296,36297,0,1,1
10390,5,3,36301,36301,36304,0,3,4
10391,3,3,36304,36304,36307,0,3,0
10392,2,1,36306,36307,36308,1,2,0
10393,3,3,36309,36309,36312,0,3,1
10394,1,2,36310,36312,36314,2,4,0
10395,3,2,36313,36314,36316,1,3,0
10396,1,2,36314,36316,36318,2,4,0
10397,1,1,36315,36318,36319,3,4,0
10398,6,2,36321,36321,36323,0,2,2
10399,4,3,36325,36325,36328,0,3,2
10400,3,2,36328,36328,36330,0,2,0
10401,5,1,36333,36333,36334,0,1,3
10402,2,3,36335,36335,36338,0,3,1
10403,1,1,36336,36338,36339,2,3,0
10404,2,1,36338,36339,36340,1,2,0
10405,6,1,36344,36344,36345,0,1,4
10406,1,2,36345,36345,36347,0,2,0
10407,3,1,36348,36348,36349,0,1,1
10408,3,3,36351,36351,36354,0,3,2
10409,2,1,36353,36354,36355,1,2,0
10410,1,3,36354,36355,36358,1,4,0
10411,2,3,36356,36358,36361,2,5,0
10412,3,1,36359,36361,36362,2,3,0
10413,4,1,36363,36363,36364,0,1,1
10414,5,2,36368,36368,36370,0,2,4
10415,4,3,36372,36372,36375,0,3,2
10416,6,3,36378,36378,36381,0,3,3
10417,1,1,36379,36381,36382,2,3,0
10418,1,3,36380,36382,36385,2,5,0
10419,2,1,36382,36385,36386,3,4,0
10420,3,3,36385,36386,36389,1,4,0
10421,2,2,36387,36389,36391,2,4,0
10422,2,2,36389,36391,36393,2,4,0
10423,2,3,36391,36393,36396,2,5,0
10424,1,2,36392,36396,36398,4,6,0
10425,1,1,36393,36398,36399,5,6,0
10426,3,1,36396,36399,36400,3,4,0
10427,2,2,36398,36400,36402,2,4,0
10428,1,2,36399,36402,36404,3,5,0
10429,5,3,36404,36404,36407,0,3,0
10430,4,2,36408,36408,36410,0,2,1
10431,1,3,36409,36410,36413,1,4,0
10432,6,1,36415,36415,36416,0,1,2
10433,4,2,36419,36419,36421,0,2,3
10434,2,1,36421,36421,36422,0,1,0
10435,2,1,36423,36423,36424,0,1,1
10436,4,3,36427,36427,36430,0,3,3
10437,3,3,36430,36430,36433,0,3,0
10438,2,3,36432,36433,36436,1,4,0
10439,3,2,36435,36436,36438,1,3,0
10440,5,3,36440,36440,36443,0,3,2
10441,2,3,36442,36443,36446,1,4,0
10442,6,1,36448,36448,36449,0,1,2
10443,3,1,36451,36451,36452,0,1,2
10444,3,2,36454,36454,36456,0,2,2
10445,3,1,36457,36457,36458,0,1,1
10446,3,1,36460,36460,36461,0,1,2
10447,2,3,36462,36462,36465,0,3,1
10448,1,2,36463,36465,36467,2,4,0
10449,4,2,36467,36467,36469,0,2,0
10450,3,3,36470,36470,36473,0,3,1
10451,2,3,36472,36473,36476,1,4,0
10452,6,2,36478,36478,36480,0,2,2
10453,3,1,36481,36481,36482,0,1,1
10454,2,2,36483,36483,36485,0,2,1
10455,1,1,36484,36485,36486,1,2,0
10456,2,1,36486,36486,36487,0,1,0
10457,3,1,36489,36489,36490,0,1,2
10458,3,1,36492,36492,36493,0,1,2
10459,4,3,36496,36496,36499,0,3,3
10460,1,3,36497,36499,36502,2,5,0
10461,5,3,36502,36502,36505,0,3,0
10462,1,1,36503,36505,36506,2,3,0
10463,3,1,36506,36506,36507,0,1,0
10464,6,1,36512,36512,36513,0,1,5
10465,4,1,36516,36516,36517,0,1,3
10466,6,1,36522,36522,36523,0,1,5
10467,6,2,36528,36528,36530,0,2,5
10468,2,3,36530,36530,36533,0,3,0
10469,3,3,36533,36533,36536,0,3,0
10470,4,1,36537,36537,36538,0,1,1
10471,4,3,36541,36541,36544,0,3,3
10472,2,2,36543,36544,36546,1,3,0
10473,6,3,36549,36549,36552,0,3,3
10474,5,1,36554,36554,36555,0,1,2
10475,3,2,36557,36557,36559,0,2,2
10476,4,3,36561,36561,36564,0,3,2
10477,1,3,36562,36564,36567,2,5,0
10478,6,2,36568,36568,36570,0,2,1
10479,1,1,36569,36570,36571,1,2,0
10480,2,1,36571,36571,36572,0,1,0
10481,1,2,36572,36572,36574,0,2,0
10482,2,2,36574,36574,36576,0,2,0
10483,4,2,36578,36578,36580,0,2,2
10484,4,2,36582,36582,36584,0,2,2
10485,4,2,36586,36586,36588,0,2,2
10486,5,3,36591,36591,36594,0,3,3
10487,4,2,36595,36595,36597,0,2,1
10488,1,1,36596,36597,36598,1,2,0
10489,5,2,36601,36601,36603,0,2,3
10490,2,1,36603,36603,36604,0,1,0
10491,4,1,36607,36607,36608,0,1,3
10492,1,2,36608,36608,36610,0,2,0
10493,3,2,36611,36611,36613,0,2,1
10494,3,2,36614,36614,36616,0,2,1
10495,4,3,36618,36618,36621,0,3,2
10496,3,3,36621,36621,36624,0,3,0
10497,3,3,36624,36624,36627,0,3,0
10498,2,1,36626,36627,36628,1,2,0
10499,4,3,36630,36630,36633,0,3,2
10500,6,1,36636,36636,36637,0,1,3
10501,1,3,36637,36637,36640,0,3,0
10502,2,3,36639,36640,36643,1,4,0
10503,4,1,36643,36643,36644,0,1,0
10504,5,3,36648,36648,36651,0,3,4
10505,4,3,36652,36652,36655,0,3,1
10506,4,2,36656,36656,36658,0,2,1
10507,3,3,36659,36659,36662,0,3,1
10508,6,2,36665,36665,36667,0,2,3
10509,4,2,36669,36669,36671,0,2,2
10510,3,2,36672,36672,36674,0,2,1
10511,1,1,36673,36674,36675,1,2,0
10512,1,1,36674,36675,36676,1,2,0
10513,2,2,36676,36676,36678,0,2,0
10514,6,2,36682,36682,36684,0,2,4
10515,6,2,36688,36688,36690,0,2,4
10516,5,3,36693,36693,36696,0,3,3
10517,4,3,36697,36697,36700,0,3,1
10518,5,2,36702,36702,36704,0,2,2
10519,1,3,36703,36704,36707,1,4,0
10520,6,3,36709,36709,36712,0,3,2
10521,3,1,36712,36712,36713,0,1,0
10522,2,1,36714,36714,36715,0,1,1
10523,4,2,36718,36718,36720,0,2,3
10524,2,3,36720,36720,36723,0,3,0
10525,5,1,36725,36725,36726,0,1,2
10526,6,2,36731,36731,36733,0,2,5
10527,6,3,36737,36737,36740,0,3,4
10528,6,2,36743,36743,36745,0,2,3
10529,6,3,36749,36749,36752,0,3,4
10530,6,2,36755,36755,36757,0,2,3
10531,3,1,36758,36758,36759,0,1,1
10532,5,3,36763,36763,36766,0,3,4
10533,4,1,36767,36767,36768,0,1,1
10534,3,1,36770,36770,36771,0,1,2
10535,5,1,36775,36775,36776,0,1,4
10536,3,2,36778,36778,36780,0,2,2
10537,6,3,36784,36784,36787,0,3,4
10538,2,2,36786,36787,36789,1,3,0
10539,3,3,36789,36789,36792,0,3,0
10540,4,3,36793,36793,36796,0,3,1
10541,2,1,36795,36796,36797,1,2,0
10542,1,1,36796,36797,36798,1,2,0
10543,3,2,36799,36799,36801,0,2,1
10544,4,1,36803,36803,36804,0,1,2
10545,3,2,36806,36806,36808,0,2,2
10546,3,1,36809,36809,36810,0,1,1
10547,5,3,36814,36814,36817,0,3,4
10548,4,3,36818,36818,36821,0,3,1
10549,6,1,36824,36824,36825,0,1,3
10550,6,1,36830,36830,36831,0,1,5
10551,6,3,36836,36836,36839,0,3,5
10552,1,3,36837,36839,36842,2,5,0
10553,3,2,36840,36842,36844,2,4,0
10554,3,3,36843,36844,36847,1,4,0
10555,5,1,36848,36848,36849,0,1,1
10556,1,2,36849,36849,36851,0,2,0
10557,2,2,36851,36851,36853,0,2,0
10558,3,1,36854,36854,36855,0,1,1
10559,1,2,36855,36855,36857,0,2,0
10560,4,2,36859,36859,36861,0,2,2
10561,4,1,36863,36863,36864,0,1,2
10562,2,1,36865,36865,36866,0,1,1
10563,3,3,36868,36868,36871,0,3,2
10564,4,3,36872,36872,36875,0,3,1
10565,6,1,36878,36878,36879,0,1,3
10566,4,2,36882,36882,36884,0,2,3
10567,1,3,36883,36884,36887,1,4,0
10568,4,2,36887,36887,36889,0,2,0
10569,2,3,36889,36889,36892,0,3,0
10570,6,1,36895,36895,36896,0,1,3
10571,5,2,36900,36900,36902,0,2,4
10572,5,2,36905,36905,36907,0,2,3
10573,1,2,36906,36907,36909,1,3,0
10574,4,3,36910,36910,36913,0,3,1
10575,4,2,36914,36914,36916,0,2,1
10576,2,1,36916,36916,36917,0,1,0
10577,6,2,36922,36922,36924,0,2,5
10578,4,1,36926,36926,36927,0,1,2
10579,4,1,36930,36930,36931,0,1,3
10580,2,2,36932,36932,36934,0,2,1
10581,3,1,36935,36935,36936,0,1,1
10582,3,3,36938,36938,36941,0,3,2
10583,6,1,36944,36944,36945,0,1,3
10584,5,1,36949,36949,36950,0,1,4
10585,2,1,36951,36951,36952,0,1,1
10586,1,2,36952,36952,36954,0,2,0
10587,5,3,36957,36957,36960,0,3,3
10588,2,3,36959,36960,36963,1,4,0
10589,5,3,36964,36964,36967,0,3,1
10590,1,3,36965,36967,36970,2,5,0
10591,6,2,36971,36971,36973,0,2,1
10592,1,2,36972,36973,36975,1,3,0
10593,5,1,36977,36977,36978,0,1,2
10594,4,2,36981,36981,36983,0,2,3
10595,2,1,36983,36983,36984,0,1,0
10596,6,1,36989,36989,36990,0,1,5
10597,4,1,36993,36993,36994,0,1,3
10598,5,2,36998,36998,37000,0,2,4
10599,1,3,36999,37000,37003,1,4,0
10600,3,2,37002,37003,37005,1,3,0
10601,2,2,37004,37005,37007,1,3,0
10602,4,3,37008,37008,37011,0,3,1
10603,4,1,37012,37012,37013,0,1,1
10604,2,3,37014,37014,37017,0,3,1
10605,6,1,37020,37020,37021,0,1,3
10606,6,2,37026,37026,37028,0,2,5
10607,1,1,37027,37028,37029,1,2,0
10608,5,1,37032,37032,37033,0,1,3
10609,2,3,37034,37034,37037,0,3,1
10610,2,3,37036,37037,37040,1,4,0
10611,4,2,37040,37040,37042,0,2,0
10612,4,3,37044,37044,37047,0,3,2
10613,1,1,37045,37047,37048,2,3,0
10614,5,2,37050,37050,37052,0,2,2
10615,3,1,37053,37053,37054,0,1,1
10616,3,1,37056,37056,37057,0,1,2
10617,3,3,37059,37059,37062,0,3,2
10618,4,3,37063,37063,37066,0,3,1
10619,3,2,37066,37066,37068,0,2,0
10620,5,1,37071,37071,37072,0,1,3
10621,4,2,37075,37075,37077,0,2,3
10622,5,1,37080,37080,37081,0,1,3
10623,6,3,37086,37086,37089,0,3,5
10624,5,1,37091,37091,37092,0,1,2
10625,4,1,37095,37095,37096,0,1,3
10626,2,3,37097,37097,37100,0,3,1
10627,1,2,37098,37100,37102,2,4,0
10628,6,2,37104,37104,37106,0,2,2
10629,6,3,37110,37110,37113,0,3,4
10630,2,1,37112,37113,37114,1,2,0
10631,6,2,37118,37118,37120,0,2,4
10632,3,1,37121,37121,37122,0,1,1
10633,6,3,37127,37127,37130,0,3,5
10634,6,1,37133,37133,37134,0,1,3
10635,6,1,37139,37139,37140,0,1,5
10636,2,1,37141,37141,37142,0,1,1
10637,5,2,37146,37146,37148,0,2,4
10638,1,2,37147,37148,37150,1,3,0
10639,3,2,37150,37150,37152,0,2,0
10640,3,3,37153,37153,37156,0,3,1
10641,1,2,37154,37156,37158,2,4,0
10642,2,2,37156,37158,37160,2,4,0
10643,2,1,37158,37160,37161,2,3,0
10644,5,1,37163,37163,37164,0,1,2
10645,5,2,37168,37168,37170,0,2,4
10646,1,3,37169,37170,37173,1,4,0
10647,1,3,37170,37173,37176,3,6,0
10648,6,1,37176,37176,37177,0,1,0
10649,1,2,37177,37177,37179,0,2,0
10650,5,3,37182,37182,37185,0,3,3
10651,6,1,37188,37188,37189,0,1,3
10652,6,3,37194,37194,37197,0,3,5
10653,2,3,37196,37197,37200,1,4,0
10654,2,3,37198,37200,37203,2,5,0
10655,1,2,37199,37203,37205,4,6,0
10656,5,1,37204,37205,37206,1,2,0
10657,2,1,37206,37206,37207,0,1,0
10658,1,1,37207,37207,37208,0,1,0
10659,2,2,37209,37209,37211,0,2,1
10660,4,1,37213,37213,37214,0,1,2
10661,5,1,37218,37218,37219,0,1,4
10662,6,3,37224,37224,37227,0,3,5
10663,3,2,37227,37227,37229,0,2,0
10664,3,1,37230,37230,37231,0,1,1
10665,2,1,37232,37232,37233,0,1,1
10666,2,3,37234,37234,37237,0,3,1
10667,6,2,37240,37240,37242,0,2,3
10668,1,1,37241,37242,37243,1,2,0
10669,3,3,37244,37244,37247,0,3,1
10670,5,1,37249,37249,37250,0,1,2
10671,6,1,37255,37255,37256,0,1,5
10672,4,2,37259,37259,37261,0,2,3
10673,4,2,37263,37263,37265,0,2,2
10674,2,1,37265,37265,37266,0,1,0
10675,2,3,37267,37267,37270,0,3,1
10676,5,2,37272,37272,37274,0,2,2
10677,4,2,37276,37276,37278,0,2,2
10678,1,1,37277,37278,37279,1,2,0
10679,1,1,37278,37279,37280,1,2,0
10680,2,2,37280,37280,37282,0,2,0
10681,5,3,37285,37285,37288,0,3,3
10682,4,1,37289,37289,37290,0,1,1
10683,4,1,37293,37293,37294,0,1,3
10684,2,2,37295,37295,37297,0,2,1
10685,3,2,37298,37298,37300,0,2,1
10686,2,3,37300,37300,37303,0,3,0
10687,1,2,37301,37303,37305,2,4,0
10688,4,1,37305,37305,37306,0,1,0
10689,1,1,37306,37306,37307,0,1,0
10690,4,3,37310,37310,37313,0,3,3
10691,3,3,37313,37313,37316,0,3,0
10692,4,2,37317,37317,37319,0,2,1
10693,2,3,37319,37319,37322,0,3,0
10694,3,1,37322,37322,37323,0,1,0
10695,5,3,37327,37327,37330,0,3,4
10696,1,3,37328,37330,37333,2,5,0
10697,6,1,37334,37334,37335,0,1,1
10698,4,2,37338,37338,37340,0,2,3
10699,1,3,37339,37340,37343,1,4,0
10700,6,3,37345,37345,37348,0,3,2
10701,2,3,37347,37348,37351,1,4,0
10702,4,3,37351,37351,37354,0,3,0
10703,3,3,37354,37354,37357,0,3,0
10704,3,3,37357,37357,37360,0,3,0
10705,3,3,37360,37360,37363,0,3,0
10706,1,3,37361,37363,37366,2,5,0
10707,3,3,37364,37366,37369,2,5,0
10708,1,1,37365,37369,37370,4,5,0
10709,1,2,37366,37370,37372,4,6,0
10710,4,1,37370,37372,37373,2,3,0
10711,6,1,37376,37376,37377,0,1,3
10712,6,2,37382,37382,37384,0,2,5
10713,6,3,37388,37388,37391,0,3,4
10714,3,2,37391,37391,37393,0,2,0
10715,1,2,37392,37393,37395,1,3,0
10716,4,3,37396,37396,37399,0,3,1
10717,6,1,37402,37402,37403,0,1,3
10718,1,1,37403,37403,37404,0,1,0
10719,3,3,37406,37406,37409,0,3,2
10720,5,1,37411,37411,37412,0,1,2
10721,3,1,37414,37414,37415,0,1,2
10722,4,3,37418,37418,37421,0,3,3
10723,3,2,37421,37421,37423,0,2,0
10724,4,2,37425,37425,37427,0,2,2
10725,3,3,37428,37428,37431,0,3,1
10726,6,3,37434,37434,37437,0,3,3
10727,1,2,37435,37437,37439,2,4,0
10728,4,2,37439,37439,37441,0,2,0
10729,3,2,37442,37442,37444,0,2,1
10730,1,1,37443,37444,37445,1,2,0
10731,5,3,37448,37448,37451,0,3,3
10732,6,2,37454,37454,37456,0,2,3
10733,3,1,37457,37457,37458,0,1,1
10734,1,3,37458,37458,37461,0,3,0
10735,5,1,37463,37463,37464,0,1,2
10736,5,2,37468,37468,37470,0,2,4
10737,2,2,37470,37470,37472,0,2,0
10738,2,1,37472,37472,37473,0,1,0
10739,2,3,37474,37474,37477,0,3,1
10740,3,1,37477,37477,37478,0,1,0
10741,6,2,37483,37483,37485,0,2,5
10742,2,1,37485,37485,37486,0,1,0
10743,1,2,37486,37486,37488,0,2,0
10744,1,1,37487,37488,37489,1,2,0
10745,2,2,37489,37489,37491,0,2,0
10746,3,1,37492,37492,37493,0,1,1
10747,1,2,37493,37493,37495,0,2,0
10748,3,1,37496,37496,37497,0,1,1
10749,6,1,37502,37502,37503,0,1,5
10750,4,1,37506,37506,37507,0,1,3
10751,1,3,37507,37507,37510,0,3,0
10752,5,1,37512,37512,37513,0,1,2
10753,6,1,37518,37518,37519,0,1,5
10754,2,3,37520,37520,37523,0,3,1
10755,4,2,37524,37524,37526,0,2,1
10756,4,1,37528,37528,37529,0,1,2
10757,5,1,37533,37533,37534,0,1,4
10758,5,3,37538,37538,37541,0,3,4
10759,5,2,37543,37543,37545,0,2,2
10760,3,2,37546,37546,37548,0,2,1
10761,1,3,37547,37548,37551,1,4,0
10762,2,3,37549,37551,37554,2,5,0
10763,2,2,37551,37554,37556,3,5,0
10764,2,3,37553,37556,37559,3,6,0
10765,4,3,37557,37559,37562,2,5,0
10766,4,3,37561,37562,37565,1,4,0
10767,3,3,37564,37565,37568,1,4,0
10768,3,3,37567,37568,37571,1,4,0
10769,3,3,37570,37571,37574,1,4,0
10770,5,3,37575,37575,37578,0,3,1
10771,6,3,37581,37581,37584,0,3,3
10772,5,3,37586,37586,37589,0,3,2
10773,2,3,37588,37589,37592,1,4,0
10774,3,1,37591,37592,37593,1,2,0
10775,5,1,37596,37596,37597,0,1,3
10776,3,2,37599,37599,37601,0,2,2
10777,4,2,37603,37603,37605,0,2,2
10778,1,1,37604,37605,37606,1,2,0
10779,4,1,37608,37608,37609,0,1,2
10780,6,3,37614,37614,37617,0,3,5
10781,1,1,37615,37617,37618,2,3,0
10782,2,1,37617,37618,37619,1,2,0
10783,1,2,37618,37619,37621,1,3,0
10784,1,1,37619,37621,37622,2,3,0
10785,2,2,37621,37622,37624,1,3,0
10786,6,2,37627,37627,37629,0,2,3
10787,1,1,37628,37629,37630,1,2,0
10788,3,1,37631,37631,37632,0,1,1
10789,3,1,37634,37634,37635,0,1,2
10790,6,2,37640,37640,37642,0,2,5
10791,4,3,37644,37644,37647,0,3,2
10792,1,2,37645,37647,37649,2,4,0
10793,4,2,37649,37649,37651,0,2,0
10794,3,1,37652,37652,37653,0,1,1
10795,4,3,37656,37656,37659,0,3,3
10796,5,2,37661,37661,37663,0,2,2
10797,2,1,37663,37663,37664,0,1,0
10798,6,3,37669,37669,37672,0,3,5
10799,1,2,37670,37672,37674,2,4,0
10800,1,3,37671,37674,37677,3,6,0
10801,1,3,37672,37677,37680,5,8,0
10802,3,1,37675,37680,37681,5,6,0
10803,2,3,37677,37681,37684,4,7,0
10804,6,1,37683,37684,37685,1,2,0
10805,3,3,37686,37686,37689,0,3,1
10806,1,2,37687,37689,37691,2,4,0
10807,5,1,37692,37692,37693,0,1,1
10808,3,3,37695,37695,37698,0,3,2
10809,3,3,37698,37698,37701,0,3,0
10810,3,1,37701,37701,37702,0,1,0
10811,5,1,37706,37706,37707,0,1,4
10812,6,1,37712,37712,37713,0,1,5
10813,2,2,37714,37714,37716,0,2,1
10814,5,3,37719,37719,37722,0,3,3
10815,1,2,37720,37722,37724,2,4,0
10816,1,2,37721,37724,37726,3,5,0
10817,5,3,37726,37726,37729,0,3,0
10818,1,2,37727,37729,37731,2,4,0
10819,6,1,37733,37733,37734,0,1,2
10820,1,3,37734,37734,37737,0,3,0
10821,1,3,37735,37737,37740,2,5,0
10822,4,1,37739,37740,37741,1,2,0
10823,2,3,37741,37741,37744,0,3,0
10824,3,1,37744,37744,37745,0,1,0
10825,2,1,37746,37746,37747,0,1,1
10826,2,1,37748,37748,37749,0,1,1
10827,4,1,37752,37752,37753,0,1,3
10828,2,3,37754,37754,37757,0,3,1
10829,6,1,37760,37760,37761,0,1,3
10830,5,2,37765,37765,37767,0,2,4
10831,3,2,37768,37768,37770,0,2,1
10832,1,3,37769,37770,37773,1,4,0
10833,4,3,37773,37773,37776,0,3,0
10834,3,3,37776,37776,37779,0,3,0
10835,2,3,37778,37779,37782,1,4,0
10836,1,1,37779,37782,37783,3,4,0
10837,2,1,37781,37783,37784,2,3,0
10838,4,1,37785,37785,37786,0,1,1
10839,6,2,37791,37791,37793,0,2,5
10840,6,3,37797,37797,37800,0,3,4
10841,4,2,37801,37801,37803,0,2,1
10842,2,2,37803,37803,37805,0,2,0
10843,4,2,37807,37807,37809,0,2,2
10844,2,1,37809,37809,37810,0,1,0
10845,6,1,37815,37815,37816,0,1,5
10846,2,2,37817,37817,37819,0,2,1
10847,4,1,37821,37821,37822,0,1,2
10848,2,3,37823,37823,37826,0,3,1
10849,1,3,37824,37826,37829,2,5,0
10850,6,3,37830,37830,37833,0,3,1
10851,6,3,37836,37836,37839,0,3,3
10852,5,2,37841,37841,37843,0,2,2
10853,6,1,37847,37847,37848,0,1,4
10854,1,1,37848,37848,37849,0,1,0
10855,3,1,37851,37851,37852,0,1,2
10856,6,2,37857,37857,37859,0,2,5
10857,1,2,37858,37859,37861,1,3,0
10858,2,2,37860,37861,37863,1,3,0
10859,2,1,37862,37863,37864,1,2,0
10860,2,3,37864,37864,37867,0,3,0
10861,3,2,37867,37867,37869,0,2,0
10862,6,2,37873,37873,37875,0,2,4
10863,2,3,37875,37875,37878,0,3,0
10864,4,3,37879,37879,37882,0,3,1
10865,6,3,37885,37885,37888,0,3,3
10866,3,1,37888,37888,37889,0,1,0
10867,1,2,37889,37889,37891,0,2,0
10868,5,1,37894,37894,37895,0,1,3
10869,6,2,37900,37900,37902,0,2,5
10870,2,1,37902,37902,37903,0,1,0
10871,5,3,37907,37907,37910,0,3,4
10872,1,3,37908,37910,37913,2,5,0
10873,4,2,37912,37913,37915,1,3,0
10874,6,3,37918,37918,37921,0,3,3
10875,6,1,37924,37924,37925,0,1,3
10876,2,2,37926,37926,37928,0,2,1
10877,5,2,37931,37931,37933,0,2,3
10878,6,3,37937,37937,37940,0,3,4
10879,3,2,37940,37940,37942,0,2,0
10880,3,1,37943,37943,37944,0,1,1
10881,3,2,37946,37946,37948,0,2,2
10882,2,2,37948,37948,37950,0,2,0
10883,2,1,37950,37950,37951,0,1,0
10884,2,2,37952,37952,37954,0,2,1
10885,4,1,37956,37956,37957,0,1,2
10886,4,3,37960,37960,37963,0,3,3
10887,5,1,37965,37965,37966,0,1,2
10888,6,3,37971,37971,37974,0,3,5
10889,4,1,37975,37975,37976,0,1,1
10890,2,1,37977,37977,37978,0,1,1
10891,2,3,37979,37979,37982,0,3,1
10892,5,2,37984,37984,37986,0,2,2
10893,2,1,37986,37986,37987,0,1,0
10894,2,3,37988,37988,37991,0,3,1
10895,6,3,37994,37994,37997,0,3,3
10896,3,3,37997,37997,38000,0,3,0
10897,5,3,38002,38002,38005,0,3,2
10898,5,2,38007,38007,38009,0,2,2
10899,1,1,38008,38009,38010,1,2,0
10900,5,3,38013,38013,38016,0,3,3
10901,4,3,38017,38017,38020,0,3,1
10902,2,3,38019,38020,38023,1,4,0
10903,3,2,38022,38023,38025,1,3,0
10904,6,2,38028,38028,38030,0,2,3
10905,5,1,38033,38033,38034,0,1,3
10906,6,1,38039,38039,38040,0,1,5
10907,3,3,38042,38042,38045,0,3,2
10908,2,2,38044,38045,38047,1,3,0
10909,2,3,38046,38047,38050,1,4,0
10910,5,3,38051,38051,38054,0,3,1
10911,4,2,38055,38055,38057,0,2,1
10912,2,2,38057,38057,38059,0,2,0
10913,6,3,38063,38063,38066,0,3,4
10914,1,3,38064,38066,38069,2,5,0
10915,5,1,38069,38069,38070,0,1,0
10916,6,1,38075,38075,38076,0,1,5
10917,1,1,38076,38076,38077,0,1,0
10918,1,1,38077,38077,38078,0,1,0
10919,2,1,38079,38079,38080,0,1,1
10920,6,1,38085,38085,38086,0,1,5
10921,5,3,38090,38090,38093,0,3,4
10922,1,3,38091,38093,38096,2,5,0
10923,3,1,38094,38096,38097,2,3,0
10924,2,2,38096,38097,38099,1,3,0
10925,4,2,38100,38100,38102,0,2,1
10926,1,1,38101,38102,38103,1,2,0
10927,4,1,38105,38105,38106,0,1,2
10928,2,1,38107,38107,38108,0,1,1
10929,1,1,38108,38108,38109,0,1,0
10930,3,1,38111,38111,38112,0,1,2
10931,3,2,38114,38114,38116,0,2,2
10932,3,2,38117,38117,38119,0,2,1
10933,3,1,38120,38120,38121,0,1,1
10934,3,2,38123,38123,38125,0,2,2
10935,5,1,38128,38128,38129,0,1,3
10936,1,2,38129,38129,38131,0,2,0
10937,5,2,38134,38134,38136,0,2,3
10938,1,2,38135,38136,38138,1,3,0
10939,1,3,38136,38138,38141,2,5,0
10940,4,1,38140,38141,38142,1,2,0
10941,5,1,38145,38145,38146,0,1,3
10942,5,2,38150,38150,38152,0,2,4
10943,3,1,38153,38153,38154,0,1,1
10944,3,1,38156,38156,38157,0,1,2
10945,4,1,38160,38160,38161,0,1,3
10946,4,3,38164,38164,38167,0,3,3
10947,4,3,38168,38168,38171,0,3,1
10948,2,1,38170,38171,38172,1,2,0
10949,6,3,38176,38176,38179,0,3,4
10950,5,1,38181,38181,38182,0,1,2
10951,5,2,38186,38186,38188,0,2,4
10952,2,2,38188,38188,38190,0,2,0
10953,6,2,38194,38194,38196,0,2,4
10954,4,2,38198,38198,38200,0,2,2
10955,4,3,38202,38202,38205,0,3,2
10956,6,1,38208,38208,38209,0,1,3
10957,5,2,38213,38213,38215,0,2,4
10958,6,3,38219,38219,38222,0,3,4
10959,4,2,38223,38223,38225,0,2,1
10960,1,3,38224,38225,38228,1,4,0
10961,3,3,38227,38228,38231,1,4,0
10962,5,2,38232,38232,38234,0,2,1
10963,6,3,38238,38238,38241,0,3,4
10964,4,1,38242,38242,38243,0,1,1
10965,2,2,38244,38244,38246,0,2,1
10966,5,2,38249,38249,38251,0,2,3
10967,6,3,38255,38255,38258,0,3,4
10968,3,1,38258,38258,38259,0,1,0
10969,1,3,38259,38259,38262,0,3,0
10970,2,2,38261,38262,38264,1,3,0
10971,3,2,38264,38264,38266,0,2,0
10972,4,3,38268,38268,38271,0,3,2
10973,1,1,38269,38271,38272,2,3,0
10974,2,1,38271,38272,38273,1,2,0
10975,6,2,38277,38277,38279,0,2,4
10976,6,1,38283,38283,38284,0,1,4
10977,6,2,38289,38289,38291,0,2,5
10978,5,2,38294,38294,38296,0,2,3
10979,1,1,38295,38296,38297,1,2,0
10980,6,1,38301,38301,38302,0,1,4
10981,2,3,38303,38303,38306,0,3,1
10982,6,2,38309,38309,38311,0,2,3
10983,5,3,38314,38314,38317,0,3,3
10984,1,3,38315,38317,38320,2,5,0
10985,4,1,38319,38320,38321,1,2,0
10986,1,3,38320,38321,38324,1,4,0
10987,3,2,38323,38324,38326,1,3,0
10988,2,2,38325,38326,38328,1,3,0
10989,5,2,38330,38330,38332,0,2,2
10990,5,2,38335,38335,38337,0,2,3
10991,5,1,38340,38340,38341,0,1,3
10992,3,1,38343,38343,38344,0,1,2
10993,5,2,38348,38348,38350,0,2,4
10994,1,3,38349,38350,38353,1,4,0
10995,3,3,38352,38353,38356,1,4,0
10996,4,3,38356,38356,38359,0,3,0
10997,2,2,38358,38359,38361,1,3,0
10998,1,1,38359,38361,38362,2,3,0
10999,5,3,38364,38364,38367,0,3,2
11000,6,2,38370,38370,38372,0,2,3
11001,2,1,38372,38372,38373,0,1,0
11002,6,1,38378,38378,38379,0,1,5
11003,6,3,38384,38384,38387,0,3,5
11004,4,1,38388,38388,38389,0,1,1
11005,6,3,38394,38394,38397,0,3,5
11006,1,1,38395,38397,38398,2,3,0
11007,1,2,38396,38398,38400,2,4,0
11008,5,1,38401,38401,38402,0,1,1
11009,5,1,38406,38406,38407,0,1,4
11010,5,1,38411,38411,38412,0,1,4
11011,2,2,38413,38413,38415,0,2,1
11012,3,2,38416,38416,38418,0,2,1
11013,2,2,38418,38418,38420,0,2,0
11014,5,1,38423,38423,38424,0,1,3
11015,3,1,38426,38426,38427,0,1,2
11016,5,2,38431,38431,38433,0,2,4
11017,2,1,38433,38433,38434,0,1,0
11018,2,2,38435,38435,38437,0,2,1
11019,6,1,38441,38441,38442,0,1,4
11020,5,1,38446,38446,38447,0,1,4
11021,3,2,38449,38449,38451,0,2,2
11022,4,2,38453,38453,38455,0,2,2
11023,6,1,38459,38459,38460,0,1,4
11024,1,3,38460,38460,38463,0,3,0
11025,6,1,38466,38466,38467,0,1,3
11026,3,1,38469,38469,38470,0,1,2
11027,6,1,38475,38475,38476,0,1,5
11028,4,1,38479,38479,38480,0,1,3
11029,1,1,38480,38480,38481,0,1,0
11030,2,2,38482,38482,38484,0,2,1
11031,2,1,38484,38484,38485,0,1,0
11032,6,1,38490,38490,38491,0,1,5
11033,1,1,38491,38491,38492,0,1,0
11034,1,1,38492,38492,38493,0,1,0
11035,1,2,38493,38493,38495,0,2,0
11036,5,2,38498,38498,38500,0,2,3
11037,3,2,38501,38501,38503,0,2,1
11038,4,3,38505,38505,38508,0,3,2
11039,1,2,38506,38508,38510,2,4,0
11040,1,1,38507,38510,38511,3,4,0
11041,2,3,38509,38511,38514,2,5,0
11042,1,1,38510,38514,38515,4,5,0
11043,3,1,38513,38515,38516,2,3,0
11044,1,2,38514,38516,38518,2,4,0
11045,4,3,38518,38518,38521,0,3,0
11046,4,3,38522,38522,38525,0,3,1
11047,1,1,38523,38525,38526,2,3,0
11048,4,3,38527,38527,38530,0,3,1
11049,2,1,38529,38530,38531,1,2,0
11050,2,1,38531,38531,38532,0,1,0
11051,4,1,38535,38535,38536,0,1,3
11052,1,1,38536,38536,38537,0,1,0
11053,2,3,38538,38538,38541,0,3,1
11054,3,2,38541,38541,38543,0,2,0
11055,1,3,38542,38543,38546,1,4,0
11056,5,3,38547,38547,38550,0,3,1
11057,4,1,38551,38551,38552,0,1,1
11058,6,2,38557,38557,38559,0,2,5
11059,1,3,38558,38559,38562,1,4,0
11060,5,1,38563,38563,38564,0,1,1
11061,2,2,38565,38565,38567,0,2,1
11062,5,1,38570,38570,38571,0,1,3
11063,1,1,38571,38571,38572,0,1,0
11064,6,1,38577,38577,38578,0,1,5
11065,5,3,38582,38582,38585,0,3,4
11066,5,1,38587,38587,38588,0,1,2
11067,5,1,38592,38592,38593,0,1,4
11068,2,3,38594,38594,38597,0,3,1
11069,4,2,38598,38598,38600,0,2,1
11070,6,1,38604,38604,38605,0,1,4
11071,4,1,38608,38608,38609,0,1,3
11072,2,1,38610,38610,38611,0,1,1
11073,2,1,38612,38612,38613,0,1,1
11074,6,2,38618,38618,38620,0,2,5
11075,2,1,38620,38620,38621,0,1,0
11076,4,1,38624,38624,38625,0,1,3
11077,6,3,38630,38630,38633,0,3,5
11078,5,2,38635,38635,38637,0,2,2
11079,2,1,38637,38637,38638,0,1,0
11080,6,3,38643,38643,38646,0,3,5
11081,2,2,38645,38646,38648,1,3,0
11082,2,1,38647,38648,38649,1,2,0
11083,3,2,38650,38650,38652,0,2,1
11084,2,2,38652,38652,38654,0,2,0
11085,4,3,38656,38656,38659,0,3,2
11086,1,1,38657,38659,38660,2,3,0
11087,3,3,38660,38660,38663,0,3,0
11088,2,1,38662,38663,38664,1,2,0
11089,3,1,38665,38665,38666,0,1,1
11090,5,3,38670,38670,38673,0,3,4
11091,4,2,38674,38674,38676,0,2,1
11092,4,2,38678,38678,38680,0,2,2
11093,4,2,38682,38682,38684,0,2,2
11094,1,3,38683,38684,38687,1,4,0
11095,2,1,38685,38687,38688,2,3,0
11096,5,3,38690,38690,38693,0,3,2
11097,6,2,38696,38696,38698,0,2,3
11098,3,3,38699,38699,38702,0,3,1
11099,3,2,38702,38702,38704,0,2,0
11100,3,2,38705,38705,38707,0,2,1
11101,5,2,38710,38710,38712,0,2,3
11102,2,2,38712,38712,38714,0,2,0
11103,4,3,38716,38716,38719,0,3,2
11104,4,2,38720,38720,38722,0,2,1
11105,5,1,38725,38725,38726,0,1,3
11106,3,1,38728,38728,38729,0,1,2
11107,4,3,38732,38732,38735,0,3,3
11108,2,1,38734,38735,38736,1,2,0
11109,5,1,38739,38739,38740,0,1,3
11110,5,1,38744,38744,38745,0,1,4
11111,2,2,38746,38746,38748,0,2,1
11112,5,3,38751,38751,38754,0,3,3
11113,5,2,38756,38756,38758,0,2,2
11114,4,2,38760,38760,38762,0,2,2
11115,6,3,38766,38766,38769,0,3,4
11116,2,1,38768,38769,38770,1,2,0
11117,3,1,38771,38771,38772,0,1,1
11118,5,1,38776,38776,38777,0,1,4
11119,6,3,38782,38782,38785,0,3,5
11120,6,3,38788,38788,38791,0,3,3
11121,2,3,38790,38791,38794,1,4,0
11122,2,3,38792,38794,38797,2,5,0
11123,4,3,38796,38797,38800,1,4,0
11124,6,2,38802,38802,38804,0,2,2
11125,3,2,38805,38805,38807,0,2,1
11126,4,1,38809,38809,38810,0,1,2
11127,3,1,38812,38812,38813,0,1,2
11128,6,2,38818,38818,38820,0,2,5
11129,4,2,38822,38822,38824,0,2,2
11130,2,1,38824,38824,38825,0,1,0
11131,2,3,38826,38826,38829,0,3,1
11132,5,2,38831,38831,38833,0,2,2
11133,2,1,38833,38833,38834,0,1,0
11134,2,1,38835,38835,38836,0,1,1
11135,4,3,38839,38839,38842,0,3,3
11136,1,3,38840,38842,38845,2,5,0
11137,5,2,38845,38845,38847,0,2,0
11138,2,1,38847,38847,38848,0,1,0
11139,6,2,38853,38853,38855,0,2,5
11140,1,2,38854,38855,38857,1,3,0
11141,3,2,38857,38857,38859,0,2,0
11142,2,3,38859,38859,38862,0,3,0
11143,1,1,38860,38862,38863,2,3,0
11144,5,3,38865,38865,38868,0,3,2
11145,2,3,38867,38868,38871,1,4,0
11146,2,2,38869,38871,38873,2,4,0
11147,2,2,38871,38873,38875,2,4,0
11148,6,2,38877,38877,38879,0,2,2
11149,6,2,38883,38883,38885,0,2,4
11150,1,3,38884,38885,38888,1,4,0
11151,6,3,38890,38890,38893,0,3,2
11152,1,2,38891,38893,38895,2,4,0
11153,3,3,38894,38895,38898,1,4,0
11154,2,1,38896,38898,38899,2,3,0
11155,5,1,38901,38901,38902,0,1,2
11156,6,3,38907,38907,38910,0,3,5
11157,5,1,38912,38912,38913,0,1,2
11158,2,3,38914,38914,38917,0,3,1
11159,5,2,38919,38919,38921,0,2,2
11160,1,3,38920,38921,38924,1,4,0
11161,4,2,38924,38924,38926,0,2,0
11162,4,1,38928,38928,38929,0,1,2
11163,4,2,38932,38932,38934,0,2,3
11164,5,2,38937,38937,38939,0,2,3
11165,1,3,38938,38939,38942,1,4,0
11166,4,3,38942,38942,38945,0,3,0
11167,5,1,38947,38947,38948,0,1,2
11168,2,3,38949,38949,38952,0,3,1
11169,2,2,38951,38952,38954,1,3,0
11170,3,1,38954,38954,38955,0,1,0
11171,5,1,38959,38959,38960,0,1,4
11172,5,1,38964,38964,38965,0,1,4
11173,4,1,38968,38968,38969,0,1,3
11174,3,1,38971,38971,38972,0,1,2
11175,1,1,38972,38972,38973,0,1,0
11176,3,2,38975,38975,38977,0,2,2
11177,5,1,38980,38980,38981,0,1,3
11178,6,3,38986,38986,38989,0,3,5
11179,4,2,38990,38990,38992,0,2,1
11180,5,3,38995,38995,38998,0,3,3
11181,4,2,38999,38999,39001,0,2,1
11182,1,3,39000,39001,39004,1,4,0
11183,6,3,39006,39006,39009,0,3,2
11184,3,2,39009,39009,39011,0,2,0
11185,5,3,39014,39014,39017,0,3,3
11186,5,2,39019,39019,39021,0,2,2
11187,4,1,39023,39023,39024,0,1,2
11188,3,2,39026,39026,39028,0,2,2
11189,4,2,39030,39030,39032,0,2,2
11190,1,3,39031,39032,39035,1,4,0
11191,5,2,39036,39036,39038,0,2,1
11192,4,2,39040,39040,39042,0,2,2
11193,4,2,39044,39044,39046,0,2,2
11194,6,2,39050,39050,39052,0,2,4
11195,6,2,39056,39056,39058,0,2,4
11196,6,3,39062,39062,39065,0,3,4
11197,6,3,39068,39068,39071,0,3,3
11198,3,3,39071,39071,39074,0,3,0
11199,6,1,39077,39077,39078,0,1,3
11200,6,2,39083,39083,39085,0,2,5
11201,3,3,39086,39086,39089,0,3,1
11202,6,1,39092,39092,39093,0,1,3
11203,1,1,39093,39093,39094,0,1,0
11204,6,3,39099,39099,39102,0,3,5
11205,3,2,39102,39102,39104,0,2,0
11206,6,3,39108,39108,39111,0,3,4
11207,5,1,39113,39113,39114,0,1,2
11208,2,2,39115,39115,39117,0,2,1
11209,1,1,39116,39117,39118,1,2,0
11210,4,2,39120,39120,39122,0,2,2
11211,2,3,39122,39122,39125,0,3,0
11212,5,2,39127,39127,39129,0,2,2
11213,3,1,39130,39130,39131,0,1,1
11214,6,1,39136,39136,39137,0,1,5
11215,2,2,39138,39138,39140,0,2,1
11216,4,2,39142,39142,39144,0,2,2
11217,3,2,39145,39145,39147,0,2,1
11218,3,3,39148,39148,39151,0,3,1
11219,2,3,39150,39151,39154,1,4,0
11220,4,1,39154,39154,39155,0,1,0
11221,3,1,39157,39157,39158,0,1,2
11222,3,2,39160,39160,39162,0,2,2
11223,2,2,39162,39162,39164,0,2,0
11224,2,2,39164,39164,39166,0,2,0
11225,4,2,39168,39168,39170,0,2,2
11226,5,3,39173,39173,39176,0,3,3
11227,5,1,39178,39178,39179,0,1,2
11228,1,1,39179,39179,39180,0,1,0
11229,4,1,39183,39183,39184,0,1,3
11230,3,1,39186,39186,39187,0,1,2
11231,6,3,39192,39192,39195,0,3,5
11232,3,3,39195,39195,39198,0,3,0
11233,5,2,39200,39200,39202,0,2,2
11234,4,3,39204,39204,39207,0,3,2
11235,2,1,39206,39207,39208,1,2,0
11236,4,1,39210,39210,39211,0,1,2
11237,1,1,39211,39211,39212,0,1,0
11238,3,2,39214,39214,39216,0,2,2
11239,1,2,39215,39216,39218,1,3,0
11240,1,3,39216,39218,39221,2,5,0
11241,5,3,39221,39221,39224,0,3,0
11242,2,2,39223,39224,39226,1,3,0
11243,3,3,39226,39226,39229,0,3,0
11244,6,3,39232,39232,39235,0,3,3
11245,3,1,39235,39235,39236,0,1,0
11246,3,2,39238,39238,39240,0,2,2
11247,3,2,39241,39241,39243,0,2,1
11248,1,3,39242,39243,39246,1,4,0
11249,1,3,39243,39246,39249,3,6,0
11250,4,3,39247,39249,39252,2,5,0
11251,2,2,39249,39252,39254,3,5,0
11252,4,1,39253,39254,39255,1,2,0
11253,3,1,39256,39256,39257,0,1,1
11254,1,1,39257,39257,39258,0,1,0
11255,4,3,39261,39261,39264,0,3,3
11256,5,3,39266,39266,39269,0,3,2
11257,1,3,39267,39269,39272,2,5,0
11258,2,3,39269,39272,39275,3,6,0
11259,6,2,39275,39275,39277,0,2,0
11260,3,1,39278,39278,39279,0,1,1
11261,5,3,39283,39283,39286,0,3,4
11262,1,2,39284,39286,39288,2,4,0
11263,2,3,39286,39288,39291,2,5,0
11264,1,1,39287,39291,39292,4,5,0
11265,6,2,39293,39293,39295,0,2,1
11266,4,1,39297,39297,39298,0,1,2
11267,3,2,39300,39300,39302,0,2,2
11268,1,1,39301,39302,39303,1,2,0
11269,1,3,39302,39303,39306,1,4,0
11270,5,3,39307,39307,39310,0,3,1
11271,3,2,39310,39310,39312,0,2,0
11272,6,1,39316,39316,39317,0,1,4
11273,2,2,39318,39318,39320,0,2,1
11274,3,2,39321,39321,39323,0,2,1
11275,4,1,39325,39325,39326,0,1,2
11276,5,1,39330,39330,39331,0,1,4
11277,1,1,39331,39331,39332,0,1,0
11278,2,2,39333,39333,39335,0,2,1
11279,3,1,39336,39336,39337,0,1,1
11280,3,1,39339,39339,39340,0,1,2
11281,3,1,39342,39342,39343,0,1,2
11282,4,2,39346,39346,39348,0,2,3
11283,4,2,39350,39350,39352,0,2,2
11284,2,3,39352,39352,39355,0,3,0
11285,3,3,39355,39355,39358,0,3,0
11286,3,1,39358,39358,39359,0,1,0
11287,1,2,39359,39359,39361,0,2,0
11288,4,3,39363,39363,39366,0,3,2
11289,2,3,39365,39366,39369,1,4,0
11290,4,2,39369,39369,39371,0,2,0
11291,3,3,39372,39372,39375,0,3,1
11292,2,3,39374,39375,39378,1,4,0
11293,3,2,39377,39378,39380,1,3,0
11294,3,2,39380,39380,39382,0,2,0
11295,2,3,39382,39382,39385,0,3,0
11296,3,3,39385,39385,39388,0,3,0
11297,1,1,39386,39388,39389,2,3,0
11298,3,1,39389,39389,39390,0,1,0
11299,6,1,39395,39395,39396,0,1,5
11300,6,2,39401,39401,39403,0,2,5
11301,2,3,39403,39403,39406,0,3,0
11302,5,1,39408,39408,39409,0,1,2
11303,6,1,39414,39414,39415,0,1,5
11304,6,2,39420,39420,39422,0,2,5
11305,5,1,39425,39425,39426,0,1,3
11306,5,3,39430,39430,39433,0,3,4
11307,3,2,39433,39433,39435,0,2,0
11308,1,3,39434,39435,39438,1,4,0
11309,6,2,39440,39440,39442,0,2,2
11310,1,3,39441,39442,39445,1,4,0
11311,4,2,39445,39445,39447,0,2,0
11312,5,3,39450,39450,39453,0,3,3
11313,1,1,39451,39453,39454,2,3,0
11314,3,3,39454,39454,39457,0,3,0
11315,1,2,39455,39457,39459,2,4,0
11316,6,2,39461,39461,39463,0,2,2
11317,5,1,39466,39466,39467,0,1,3
11318,3,3,39469,39469,39472,0,3,2
11319,4,3,39473,39473,39476,0,3,1
11320,6,2,39479,39479,39481,0,2,3
11321,3,3,39482,39482,39485,0,3,1
11322,1,2,39483,39485,39487,2,4,0
11323,1,3,39484,39487,39490,3,6,0
11324,4,1,39488,39490,39491,2,3,0
11325,4,2,39492,39492,39494,0,2,1
11326,5,1,39497,39497,39498,0,1,3
11327,4,2,39501,39501,39503,0,2,3
11328,1,1,39502,39503,39504,1,2,0
11329,3,3,39505,39505,39508,0,3,1
11330,6,1,39511,39511,39512,0,1,3
11331,3,1,39514,39514,39515,0,1,2
11332,2,2,39516,39516,39518,0,2,1
11333,6,2,39522,39522,39524,0,2,4
11334,3,2,39525,39525,39527,0,2,1
11335,4,3,39529,39529,39532,0,3,2
11336,1,1,39530,39532,39533,2,3,0
11337,5,3,39535,39535,39538,0,3,2
11338,3,3,39538,39538,39541,0,3,0
11339,1,1,39539,39541,39542,2,3,0
11340,4,2,39543,39543,39545,0,2,1
11341,1,1,39544,39545,39546,1,2,0
11342,1,2,39545,39546,39548,1,3,0
11343,6,3,39551,39551,39554,0,3,3
11344,3,1,39554,39554,39555,0,1,0
11345,1,2,39555,39555,39557,0,2,0
11346,2,1,39557,39557,39558,0,1,0
11347,3,3,39560,39560,39563,0,3,2
11348,4,3,39564,39564,39567,0,3,1
11349,2,3,39566,39567,39570,1,4,0
11350,4,3,39570,39570,39573,0,3,0
11351,6,1,39576,39576,39577,0,1,3
11352,2,3,39578,39578,39581,0,3,1
11353,2,3,39580,39581,39584,1,4,0
11354,6,2,39586,39586,39588,0,2,2
11355,2,2,39588,39588,39590,0,2,0
11356,4,3,39592,39592,39595,0,3,2
11357,6,2,39598,39598,39600,0,2,3
11358,3,2,39601,39601,39603,0,2,1
11359,1,2,39602,39603,39605,1,3,0
11360,5,1,39607,39607,39608,0,1,2
11361,4,2,39611,39611,39613,0,2,3
11362,4,2,39615,39615,39617,0,2,2
11363,3,3,39618,39618,39621,0,3,1
11364,5,3,39623,39623,39626,0,3,2
11365,5,2,39628,39628,39630,0,2,2
11366,1,1,39629,39630,39631,1,2,0
11367,5,1,39634,39634,39635,0,1,3
11368,4,2,39638,39638,39640,0,2,3
11369,2,3,39640,39640,39643,0,3,0
11370,5,1,39645,39645,39646,0,1,2
11371,1,3,39646,39646,39649,0,3,0
11372,5,1,39651,39651,39652,0,1,2
11373,6,1,39657,39657,39658,0,1,5
11374,2,3,39659,39659,39662,0,3,1
11375,4,1,39663,39663,39664,0,1,1
11376,5,1,39668,39668,39669,0,1,4
11377,3,1,39671,39671,39672,0,1,2
11378,3,2,39674,39674,39676,0,2,2
11379,1,1,39675,39676,39677,1,2,0
11380,5,3,39680,39680,39683,0,3,3
11381,5,3,39685,39685,39688,0,3,2
11382,6,1,39691,39691,39692,0,1,3
11383,5,3,39696,39696,39699,0,3,4
11384,3,3,39699,39699,39702,0,3,0
11385,6,3,39705,39705,39708,0,3,3
11386,5,1,39710,39710,39711,0,1,2
11387,4,1,39714,39714,39715,0,1,3
11388,2,2,39716,39716,39718,0,2,1
11389,1,2,39717,39718,39720,1,3,0
11390,4,1,39721,39721,39722,0,1,1
11391,5,1,39726,39726,39727,0,1,4
11392,3,2,39729,39729,39731,0,2,2
11393,6,2,39735,39735,39737,0,2,4
11394,1,1,39736,39737,39738,1,2,0
11395,6,1,39742,39742,39743,0,1,4
11396,3,3,39745,39745,39748,0,3,2
11397,3,1,39748,39748,39749,0,1,0
11398,4,3,39752,39752,39755,0,3,3
11399,4,1,39756,39756,39757,0,1,1
11400,2,2,39758,39758,39760,0,2,1
11401,6,1,39764,39764,39765,0,1,4
11402,1,1,39765,39765,39766,0,1,0
11403,3,3,39768,39768,39771,0,3,2
11404,1,1,39769,39771,39772,2,3,0
11405,1,2,39770,39772,39774,2,4,0
11406,2,2,39772,39774,39776,2,4,0
11407,3,2,39775,39776,39778,1,3,0
11408,1,1,39776,39778,39779,2,3,0
11409,5,1,39781,39781,39782,0,1,2
11410,5,1,39786,39786,39787,0,1,4
11411,2,2,39788,39788,39790,0,2,1
11412,4,2,39792,39792,39794,0,2,2
11413,2,3,39794,39794,39797,0,3,0
11414,1,2,39795,39797,39799,2,4,0
11415,3,3,39798,39799,39802,1,4,0
11416,1,3,39799,39802,39805,3,6,0
11417,4,1,39803,39805,39806,2,3,0
11418,6,1,39809,39809,39810,0,1,3
11419,3,2,39812,39812,39814,0,2,2
11420,3,2,39815,39815,39817,0,2,1
11421,4,2,39819,39819,39821,0,2,2
11422,4,2,39823,39823,39825,0,2,2
11423,2,3,39825,39825,39828,0,3,0
11424,5,2,39830,39830,39832,0,2,2
11425,3,3,39833,39833,39836,0,3,1
11426,2,3,39835,39836,39839,1,4,0
11427,3,3,39838,39839,39842,1,4,0
11428,5,2,39843,39843,39845,0,2,1
11429,4,2,39847,39847,39849,0,2,2
11430,3,1,39850,39850,39851,0,1,1
11431,2,2,39852,39852,39854,0,2,1
11432,1,2,39853,39854,39856,1,3,0
11433,3,1,39856,39856,39857,0,1,0
11434,4,1,39860,39860,39861,0,1,3
11435,4,2,39864,39864,39866,0,2,3
11436,1,3,39865,39866,39869,1,4,0
11437,6,1,39871,39871,39872,0,1,2
11438,5,3,39876,39876,39879,0,3,4
11439,4,1,39880,39880,39881,0,1,1
11440,3,3,39883,39883,39886,0,3,2
11441,6,3,39889,39889,39892,0,3,3
11442,4,2,39893,39893,39895,0,2,1
11443,3,3,39896,39896,39899,0,3,1
11444,2,1,39898,39899,39900,1,2,0
11445,6,1,39904,39904,39905,0,1,4
11446,2,1,39906,39906,39907,0,1,1
11447,4,3,39910,39910,39913,0,3,3
11448,1,3,39911,39913,39916,2,5,0
11449,3,2,39914,39916,39918,2,4,0
11450,1,3,39915,39918,39921,3,6,0
11451,1,3,39916,39921,39924,5,8,0
11452,2,1,39918,39924,39925,6,7,0
11453,1,1,39919,39925,39926,6,7,0
11454,6,3,39925,39926,39929,1,4,0
11455,2,2,39927,39929,39931,2,4,0
11456,2,1,39929,39931,39932,2,3,0
11457,5,1,39934,39934,39935,0,1,2
11458,3,2,39937,39937,39939,0,2,2
11459,2,1,39939,39939,39940,0,1,0
11460,3,3,39942,39942,39945,0,3,2
11461,3,1,39945,39945,39946,0,1,0
11462,6,3,39951,39951,39954,0,3,5
11463,2,1,39953,39954,39955,1,2,0
11464,5,3,39958,39958,39961,0,3,3
11465,2,2,39960,39961,39963,1,3,0
11466,6,3,39966,39966,39969,0,3,3
11467,3,3,39969,39969,39972,0,3,0
11468,5,1,39974,39974,39975,0,1,2
11469,1,1,39975,39975,39976,0,1,0
11470,6,2,39981,39981,39983,0,2,5
11471,3,2,39984,39984,39986,0,2,1
11472,2,1,39986,39986,39987,0,1,0
11473,3,1,39989,39989,39990,0,1,2
11474,5,2,39994,39994,39996,0,2,4
11475,1,3,39995,39996,39999,1,4,0
11476,2,2,39997,39999,40001,2,4,0
11477,6,3,40003,40003,40006,0,3,2
11478,4,2,40007,40007,40009,0,2,1
11479,6,2,40013,40013,40015,0,2,4
11480,1,3,40014,40015,40018,1,4,0
11481,4,1,40018,40018,40019,0,1,0
11482,4,2,40022,40022,40024,0,2,3
11483,5,1,40027,40027,40028,0,1,3
11484,5,2,40032,40032,40034,0,2,4
11485,2,1,40034,40034,40035,0,1,0
11486,1,3,40035,40035,40038,0,3,0
11487,2,2,40037,40038,40040,1,3,0
11488,4,2,40041,40041,40043,0,2,1
11489,2,3,40043,40043,40046,0,3,0
11490,5,3,40048,40048,40051,0,3,2
11491,4,1,40052,40052,40053,0,1,1
11492,2,1,40054,40054,40055,0,1,1
11493,2,3,40056,40056,40059,0,3,1
11494,2,3,40058,40059,40062,1,4,0
11495,4,2,40062,40062,40064,0,2,0
11496,4,1,40066,40066,40067,0,1,2
11497,6,2,40072,40072,40074,0,2,5
11498,1,1,40073,40074,40075,1,2,0
11499,6,1,40079,40079,40080,0,1,4
11500,3,3,40082,40082,40085,0,3,2
11501,3,1,40085,40085,40086,0,1,0
11502,3,1,40088,40088,40089,0,1,2
11503,5,3,40093,40093,40096,0,3,4
11504,4,1,40097,40097,40098,0,1,1
11505,5,2,40102,40102,40104,0,2,4
11506,4,1,40106,40106,40107,0,1,2
11507,4,2,40110,40110,40112,0,2,3
11508,4,2,40114,40114,40116,0,2,2
11509,3,2,40117,40117,40119,0,2,1
11510,6,3,40123,40123,40126,0,3,4
11511,3,3,40126,40126,40129,0,3,0
11512,4,3,40130,40130,40133,0,3,1
11513,5,3,40135,40135,40138,0,3,2
11514,1,1,40136,40138,40139,2,3,0
11515,1,1,40137,40139,40140,2,3,0
11516,3,1,40140,40140,40141,0,1,0
11517,2,1,40142,40142,40143,0,1,1
11518,3,3,40145,40145,40148,0,3,2
11519,5,1,40150,40150,40151,0,1,2
11520,5,3,40155,40155,40158,0,3,4
11521,1,3,40156,40158,40161,2,5,0
11522,1,3,40157,40161,40164,4,7,0
11523,6,1,40163,40164,40165,1,2,0
11524,5,3,40168,40168,40171,0,3,3
11525,5,2,40173,40173,40175,0,2,2
11526,6,1,40179,40179,40180,0,1,4
11527,1,1,40180,40180,40181,0,1,0
11528,1,1,40181,40181,40182,0,1,0
11529,3,1,40184,40184,40185,0,1,2
11530,3,1,40187,40187,40188,0,1,2
11531,4,3,40191,40191,40194,0,3,3
11532,2,1,40193,40194,40195,1,2,0
11533,5,2,40198,40198,40200,0,2,3
11534,1,1,40199,40200,40201,1,2,0
11535,5,2,40204,40204,40206,0,2,3
11536,2,1,40206,40206,40207,0,1,0
11537,1,3,40207,40207,40210,0,3,0
11538,4,3,40211,40211,40214,0,3,1
11539,1,1,40212,40214,40215,2,3,0
11540,5,2,40217,40217,40219,0,2,2
11541,2,2,40219,40219,40221,0,2,0
11542,2,2,40221,40221,40223,0,2,0
11543,4,3,40225,40225,40228,0,3,2
11544,5,2,40230,40230,40232,0,2,2
11545,1,2,40231,40232,40234,1,3,0
11546,2,3,40233,40234,40237,1,4,0
11547,6,3,40239,40239,40242,0,3,2
11548,6,2,40245,40245,40247,0,2,3
11549,5,2,40250,40250,40252,0,2,3
11550,2,2,40252,40252,40254,0,2,0
11551,4,3,40256,40256,40259,0,3,2
11552,2,1,40258,40259,40260,1,2,0
11553,1,3,40259,40260,40263,1,4,0
11554,6,3,40265,40265,40268,0,3,2
11555,3,3,40268,40268,40271,0,3,0
11556,6,1,40274,40274,40275,0,1,3
11557,6,1,40280,40280,40281,0,1,5
11558,2,3,40282,40282,40285,0,3,1
11559,3,3,40285,40285,40288,0,3,0
11560,2,2,40287,40288,40290,1,3,0
11561,3,1,40290,40290,40291,0,1,0
11562,1,2,40291,40291,40293,0,2,0
11563,6,2,40297,40297,40299,0,2,4
11564,5,1,40302,40302,40303,0,1,3
11565,1,2,40303,40303,40305,0,2,0
11566,6,3,40309,40309,40312,0,3,4
11567,3,2,40312,40312,40314,0,2,0
11568,6,1,40318,40318,40319,0,1,4
11569,3,3,40321,40321,40324,0,3,2
11570,6,1,40327,40327,40328,0,1,3
11571,3,2,40330,40330,40332,0,2,2
11572,3,2,40333,40333,40335,0,2,1
11573,1,1,40334,40335,40336,1,2,0
11574,2,3,40336,40336,40339,0,3,0
11575,1,2,40337,40339,40341,2,4,0
11576,3,1,40340,40341,40342,1,2,0
11577,5,3,40345,40345,40348,0,3,3
11578,2,1,40347,40348,40349,1,2,0
11579,3,2,40350,40350,40352,0,2,1
11580,4,2,40354,40354,40356,0,2,2
11581,3,2,40357,40357,40359,0,2,1
11582,1,3,40358,40359,40362,1,4,0
11583,5,3,40363,40363,40366,0,3,1
11584,1,2,40364,40366,40368,2,4,0
11585,5,3,40369,40369,40372,0,3,1
11586,3,2,40372,40372,40374,0,2,0
11587,1,1,40373,40374,40375,1,2,0
11588,5,3,40378,40378,40381,0,3,3
11589,5,3,40383,40383,40386,0,3,2
11590,4,3,40387,40387,40390,0,3,1
11591,5,1,40392,40392,40393,0,1,2
11592,6,3,40398,40398,40401,0,3,5
11593,1,3,40399,40401,40404,2,5,0
11594,5,3,40404,40404,40407,0,3,0
11595,4,3,40408,40408,40411,0,3,1
11596,4,3,40412,40412,40415,0,3,1
11597,5,2,40417,40417,40419,0,2,2
11598,2,1,40419,40419,40420,0,1,0
11599,4,2,40423,40423,40425,0,2,3
11600,5,1,40428,40428,40429,0,1,3
11601,3,1,40431,40431,40432,0,1,2
11602,2,1,40433,40433,40434,0,1,1
11603,3,1,40436,40436,40437,0,1,2
11604,4,1,40440,40440,40441,0,1,3
11605,5,1,40445,40445,40446,0,1,4
11606,2,1,40447,40447,40448,0,1,1
11607,6,2,40453,40453,40455,0,2,5
11608,2,3,40455,40455,40458,0,3,0
11609,4,2,40459,40459,40461,0,2,1
11610,2,2,40461,40461,40463,0,2,0
11611,2,1,40463,40463,40464,0,1,0
11612,5,3,40468,40468,40471,0,3,4
11613,5,1,40473,40473,40474,0,1,2
11614,3,2,40476,40476,40478,0,2,2
11615,3,1,40479,40479,40480,0,1,1
11616,1,3,40480,40480,40483,0,3,0
11617,1,2,40481,40483,40485,2,4,0
11618,3,1,40484,40485,40486,1,2,0
11619,6,2,40490,40490,40492,0,2,4
11620,4,3,40494,40494,40497,0,3,2
11621,5,1,40499,40499,40500,0,1,2
11622,5,1,40504,40504,40505,0,1,4
11623,5,2,40509,40509,40511,0,2,4
11624,3,3,40512,40512,40515,0,3,1
11625,1,1,40513,40515,40516,2,3,0
11626,2,3,40515,40516,40519,1,4,0
11627,4,3,40519,40519,40522,0,3,0
11628,6,1,40525,40525,40526,0,1,3
11629,5,2,40530,40530,40532,0,2,4
11630,4,2,40534,40534,40536,0,2,2
11631,2,3,40536,40536,40539,0,3,0
11632,3,1,40539,40539,40540,0,1,0
11633,3,1,40542,40542,40543,0,1,2
11634,4,1,40546,40546,40547,0,1,3
11635,6,3,40552,40552,40555,0,3,5
11636,3,2,40555,40555,40557,0,2,0
11637,1,1,40556,40557,40558,1,2,0
11638,4,3,40560,40560,40563,0,3,2
11639,6,1,40566,40566,40567,0,1,3
11640,3,2,40569,40569,40571,0,2,2
11641,3,2,40572,40572,40574,0,2,1
11642,6,1,40578,40578,40579,0,1,4
11643,1,1,40579,40579,40580,0,1,0
11644,4,3,40583,40583,40586,0,3,3
11645,2,1,40585,40586,40587,1,2,0
11646,1,1,40586,40587,40588,1,2,0
11647,6,2,40592,40592,40594,0,2,4
11648,3,1,40595,40595,40596,0,1,1
11649,5,3,40600,40600,40603,0,3,4
11650,3,3,40603,40603,40606,0,3,0
11651,5,2,40608,40608,40610,0,2,2
11652,2,3,40610,40610,40613,0,3,0
11653,5,1,40615,40615,40616,0,1,2
11654,5,3,40620,40620,40623,0,3,4
11655,3,3,40623,40623,40626,0,3,0
11656,1,3,40624,40626,40629,2,5,0
11657,2,1,40626,40629,40630,3,4,0
11658,4,3,40630,40630,40633,0,3,0
11659,4,3,40634,40634,40637,0,3,1
11660,2,2,40636,40637,40639,1,3,0
11661,5,3,40641,40641,40644,0,3,2
11662,6,2,40647,40647,40649,0,2,3
11663,5,2,40652,40652,40654,0,2,3
11664,5,2,40657,40657,40659,0,2,3
11665,2,3,40659,40659,40662,0,3,0
11666,4,2,40663,40663,40665,0,2,1
11667,1,3,40664,40665,40668,1,4,0
11668,6,1,40670,40670,40671,0,1,2
11669,4,1,40674,40674,40675,0,1,3
11670,1,3,40675,40675,40678,0,3,0
11671,6,2,40681,40681,40683,0,2,3
11672,4,3,40685,40685,40688,0,3,2
11673,4,2,40689,40689,40691,0,2,1
11674,2,2,40691,40691,40693,0,2,0
11675,4,2,40695,40695,40697,0,2,2
11676,2,3,40697,40697,40700,0,3,0
11677,6,1,40703,40703,40704,0,1,3
11678,3,1,40706,40706,40707,0,1,2
11679,3,2,40709,40709,40711,0,2,2
11680,5,3,40714,40714,40717,0,3,3
11681,3,1,40717,40717,40718,0,1,0
11682,3,2,40720,40720,40722,0,2,2
11683,6,3,40726,40726,40729,0,3,4
11684,6,3,40732,40732,40735,0,3,3
11685,4,1,40736,40736,40737,0,1,1
11686,1,2,40737,40737,40739,0,2,0
11687,4,1,40741,40741,40742,0,1,2
11688,1,3,40742,40742,40745,0,3,0
11689,4,2,40746,40746,40748,0,2,1
11690,4,2,40750,40750,40752,0,2,2
11691,6,3,40756,40756,40759,0,3,4
11692,1,3,40757,40759,40762,2,5,0
11693,1,2,40758,40762,40764,4,6,0
11694,6,3,40764,40764,40767,0,3,0
11695,4,3,40768,40768,40771,0,3,1
11696,2,1,40770,40771,40772,1,2,0
11697,3,2,40773,40773,40775,0,2,1
11698,4,3,40777,40777,40780,0,3,2
11699,6,1,40783,40783,40784,0,1,3
11700,6,3,40789,40789,40792,0,3,5
11701,2,2,40791,40792,40794,1,3,0
11702,1,2,40792,40794,40796,2,4,0
11703,4,1,40796,40796,40797,0,1,0
11704,4,1,40800,40800,40801,0,1,3
11705,5,3,40805,40805,40808,0,3,4
11706,6,3,40811,40811,40814,0,3,3
11707,2,3,40813,40814,40817,1,4,0
11708,3,1,40816,40817,40818,1,2,0
11709,5,1,40821,40821,40822,0,1,3
11710,4,1,40825,40825,40826,0,1,3
11711,1,1,40826,40826,40827,0,1,0
11712,2,1,40828,40828,40829,0,1,1
11713,4,2,40832,40832,40834,0,2,3
11714,6,3,40838,40838,40841,0,3,4
11715,4,3,40842,40842,40845,0,3,1
11716,4,2,40846,40846,40848,0,2,1
11717,6,3,40852,40852,40855,0,3,4
11718,5,3,40857,40857,40860,0,3,2
11719,4,2,40861,40861,40863,0,2,1
11720,4,1,40865,40865,40866,0,1,2
11721,3,2,40868,40868,40870,0,2,2
11722,5,1,40873,40873,40874,0,1,3
11723,4,2,40877,40877,40879,0,2,3
11724,3,1,40880,40880,40881,0,1,1
11725,1,3,40881,40881,40884,0,3,0
11726,5,3,40886,40886,40889,0,3,2
11727,5,2,40891,40891,40893,0,2,2
11728,4,1,40895,40895,40896,0,1,2
11729,6,2,40901,40901,40903,0,2,5
11730,3,2,40904,40904,40906,0,2,1
11731,2,1,40906,40906,40907,0,1,0
11732,3,1,40909,40909,40910,0,1,2
11733,5,3,40914,40914,40917,0,3,4
11734,6,3,40920,40920,40923,0,3,3
11735,3,1,40923,40923,40924,0,1,0
11736,1,2,40924,40924,40926,0,2,0
11737,3,1,40927,40927,40928,0,1,1
11738,6,2,40933,40933,40935,0,2,5
11739,6,1,40939,40939,40940,0,1,4
11740,2,1,40941,40941,40942,0,1,1
11741,4,2,40945,40945,40947,0,2,3
11742,6,3,40951,40951,40954,0,3,4
11743,1,3,40952,40954,40957,2,5,0
11744,1,3,40953,40957,40960,4,7,0
11745,1,2,40954,40960,40962,6,8,0
11746,5,3,40959,40962,40965,3,6,0
11747,4,3,40963,40965,40968,2,5,0
11748,6,3,40969,40969,40972,0,3,1
11749,2,2,40971,40972,40974,1,3,0
11750,1,3,40972,40974,40977,2,5,0
11751,6,1,40978,40978,40979,0,1,1
11752,3,2,40981,40981,40983,0,2,2
11753,5,2,40986,40986,40988,0,2,3
11754,4,1,40990,40990,40991,0,1,2
11755,4,2,40994,40994,40996,0,2,3
11756,2,1,40996,40996,40997,0,1,0
11757,3,1,40999,40999,41000,0,1,2
11758,1,1,41000,41000,41001,0,1,0
11759,5,2,41005,41005,41007,0,2,4
11760,5,1,41010,41010,41011,0,1,3
11761,6,1,41016,41016,41017,0,1,5
11762,1,3,41017,41017,41020,0,3,0
11763,6,1,41023,41023,41024,0,1,3
11764,5,1,41028,41028,41029,0,1,4
11765,6,1,41034,41034,41035,0,1,5
11766,4,1,41038,41038,41039,0,1,3
11767,3,3,41041,41041,41044,0,3,2
11768,4,1,41045,41045,41046,0,1,1
11769,6,2,41051,41051,41053,0,2,5
11770,6,1,41057,41057,41058,0,1,4
11771,1,1,41058,41058,41059,0,1,0
11772,3,3,41061,41061,41064,0,3,2
11773,5,3,41066,41066,41069,0,3,2
11774,5,2,41071,41071,41073,0,2,2
11775,4,1,41075,41075,41076,0,1,2
11776,2,1,41077,41077,41078,0,1,1
11777,5,1,41082,41082,41083,0,1,4
11778,4,1,41086,41086,41087,0,1,3
11779,2,3,41088,41088,41091,0,3,1
11780,6,3,41094,41094,41097,0,3,3
11781,3,2,41097,41097,41099,0,2,0
11782,1,2,41098,41099,41101,1,3,0
11783,5,1,41103,41103,41104,0,1,2
11784,1,2,41104,41104,41106,0,2,0
11785,2,2,41106,41106,41108,0,2,0
11786,4,1,41110,41110,41111,0,1,2
11787,6,2,41116,41116,41118,0,2,5
11788,3,1,41119,41119,41120,0,1,1
11789,5,3,41124,41124,41127,0,3,4
11790,3,1,41127,41127,41128,0,1,0
11791,6,3,41133,41133,41136,0,3,5
11792,4,3,41137,41137,41140,0,3,1
11793,3,1,41140,41140,41141,0,1,0
11794,6,3,41146,41146,41149,0,3,5
11795,1,3,41147,41149,41152,2,5,0
11796,3,2,41150,41152,41154,2,4,0
11797,2,1,41152,41154,41155,2,3,0
11798,1,1,41153,41155,41156,2,3,0
11799,6,2,41159,41159,41161,0,2,3
11800,1,2,41160,41161,41163,1,3,0
11801,6,2,41166,41166,41168,0,2,3
11802,1,2,41167,41168,41170,1,3,0
11803,1,2,41168,41170,41172,2,4,0
11804,1,3,41169,41172,41175,3,6,0
11805,5,1,41174,41175,41176,1,2,0
11806,3,3,41177,41177,41180,0,3,1
11807,2,1,41179,41180,41181,1,2,0
11808,4,1,41183,41183,41184,0,1,2
11809,4,3,41187,41187,41190,0,3,3
11810,5,3,41192,41192,41195,0,3,2
11811,6,3,41198,41198,41201,0,3,3
11812,2,3,41200,41201,41204,1,4,0
11813,4,1,41204,41204,41205,0,1,0
11814,3,2,41207,41207,41209,0,2,2
11815,6,2,41213,41213,41215,0,2,4
11816,1,2,41214,41215,41217,1,3,0
11817,5,1,41219,41219,41220,0,1,2
11818,1,1,41220,41220,41221,0,1,0
11819,5,1,41225,41225,41226,0,1,4
11820,6,2,41231,41231,41233,0,2,5
11821,3,2,41234,41234,41236,0,2,1
11822,6,2,41240,41240,41242,0,2,4
11823,3,1,41243,41243,41244,0,1,1
11824,5,1,41248,41248,41249,0,1,4
11825,5,3,41253,41253,41256,0,3,4
11826,1,1,41254,41256,41257,2,3,0
11827,2,3,41256,41257,41260,1,4,0
11828,1,2,41257,41260,41262,3,5,0
11829,3,3,41260,41262,41265,2,5,0
11830,1,3,41261,41265,41268,4,7,0
11831,1,2,41262,41268,41270,6,8,0
11832,3,3,41265,41270,41273,5,8,0
11833,2,3,41267,41273,41276,6,9,0
11834,3,2,41270,41276,41278,6,8,0
11835,1,1,41271,41278,41279,7,8,0
11836,5,1,41276,41279,41280,3,4,0
11837,6,1,41282,41282,41283,0,1,2
11838,2,1,41284,41284,41285,0,1,1
11839,3,2,41287,41287,41289,0,2,2
11840,5,1,41292,41292,41293,0,1,3
11841,1,2,41293,41293,41295,0,2,0
11842,1,2,41294,41295,41297,1,3,0
11843,1,3,41295,41297,41300,2,5,0
11844,4,2,41299,41300,41302,1,3,0
11845,3,2,41302,41302,41304,0,2,0
11846,2,3,41304,41304,41307,0,3,0
11847,2,1,41306,41307,41308,1,2,0
11848,4,3,41310,41310,41313,0,3,2
11849,5,3,41315,41315,41318,0,3,2
11850,3,3,41318,41318,41321,0,3,0
11851,5,3,41323,41323,41326,0,3,2
11852,5,2,41328,41328,41330,0,2,2
11853,2,1,41330,41330,41331,0,1,0
11854,4,1,41334,41334,41335,0,1,3
11855,4,3,41338,41338,41341,0,3,3
11856,1,3,41339,41341,41344,2,5,0
11857,1,1,41340,41344,41345,4,5,0
11858,5,1,41345,41345,41346,0,1,0
11859,5,3,41350,41350,41353,0,3,4
11860,4,2,41354,41354,41356,0,2,1
11861,5,2,41359,41359,41361,0,2,3
11862,2,1,41361,41361,41362,0,1,0
11863,5,1,41366,41366,41367,0,1,4
11864,3,3,41369,41369,41372,0,3,2
11865,4,3,41373,41373,41376,0,3,1
11866,6,1,41379,41379,41380,0,1,3
11867,2,1,41381,41381,41382,0,1,1
11868,1,1,41382,41382,41383,0,1,0
11869,6,3,41388,41388,41391,0,3,5
11870,6,1,41394,41394,41395,0,1,3
11871,4,2,41398,41398,41400,0,2,3
11872,3,1,41401,41401,41402,0,1,1
11873,2,1,41403,41403,41404,0,1,1
11874,2,3,41405,41405,41408,0,3,1
11875,5,1,41410,41410,41411,0,1,2
11876,4,1,41414,41414,41415,0,1,3
11877,3,1,41417,41417,41418,0,1,2
11878,5,1,41422,41422,41423,0,1,4
11879,6,1,41428,41428,41429,0,1,5
11880,6,1,41434,41434,41435,0,1,5
11881,1,1,41435,41435,41436,0,1,0
11882,4,1,41439,41439,41440,0,1,3
11883,2,3,41441,41441,41444,0,3,1
11884,2,2,41443,41444,41446,1,3,0
11885,2,2,41445,41446,41448,1,3,0
11886,4,1,41449,41449,41450,0,1,1
11887,3,2,41452,41452,41454,0,2,2
11888,2,2,41454,41454,41456,0,2,0
11889,4,2,41458,41458,41460,0,2,2
11890,3,1,41461,41461,41462,0,1,1
11891,4,2,41465,41465,41467,0,2,3
11892,1,2,41466,41467,41469,1,3,0
11893,2,3,41468,41469,41472,1,4,0
11894,6,1,41474,41474,41475,0,1,2
11895,2,3,41476,41476,41479,0,3,1
11896,6,3,41482,41482,41485,0,3,3
11897,1,1,41483,41485,41486,2,3,0
11898,1,3,41484,41486,41489,2,5,0
11899,2,2,41486,41489,41491,3,5,0
11900,2,3,41488,41491,41494,3,6,0
11901,2,1,41490,41494,41495,4,5,0
11902,6,1,41496,41496,41497,0,1,1
11903,5,1,41501,41501,41502,0,1,4
11904,3,1,41504,41504,41505,0,1,2
11905,3,1,41507,41507,41508,0,1,2
11906,5,3,41512,41512,41515,0,3,4
11907,3,1,41515,41515,41516,0,1,0
11908,6,2,41521,41521,41523,0,2,5
11909,5,2,41526,41526,41528,0,2,3
11910,1,1,41527,41528,41529,1,2,0
11911,1,3,41528,41529,41532,1,4,0
11912,2,3,41530,41532,41535,2,5,0
11913,2,1,41532,41535,41536,3,4,0
11914,4,3,41536,41536,41539,0,3,0
11915,3,2,41539,41539,41541,0,2,0
11916,1,3,41540,41541,41544,1,4,0
11917,4,3,41544,41544,41547,0,3,0
11918,3,2,41547,41547,41549,0,2,0
11919,1,1,41548,41549,41550,1,2,0
11920,6,2,41554,41554,41556,0,2,4
11921,6,1,41560,41560,41561,0,1,4
11922,3,1,41563,41563,41564,0,1,2
11923,5,1,41568,41568,41569,0,1,4
11924,5,3,41573,41573,41576,0,3,4
11925,1,3,41574,41576,41579,2,5,0
11926,3,1,41577,41579,41580,2,3,0
11927,6,3,41583,41583,41586,0,3,3
11928,1,1,41584,41586,41587,2,3,0
11929,6,1,41590,41590,41591,0,1,3
11930,4,1,41594,41594,41595,0,1,3
11931,1,3,41595,41595,41598,0,3,0
11932,2,2,41597,41598,41600,1,3,0
11933,5,1,41602,41602,41603,0,1,2
11934,4,3,41606,41606,41609,0,3,3
11935,5,3,41611,41611,41614,0,3,2
11936,4,1,41615,41615,41616,0,1,1
11937,2,2,41617,41617,41619,0,2,1
11938,4,2,41621,41621,41623,0,2,2
11939,2,1,41623,41623,41624,0,1,0
11940,2,1,41625,41625,41626,0,1,1
11941,2,3,41627,41627,41630,0,3,1
11942,4,3,41631,41631,41634,0,3,1
11943,3,1,41634,41634,41635,0,1,0
11944,6,2,41640,41640,41642,0,2,5
11945,2,1,41642,41642,41643,0,1,0
11946,6,2,41648,41648,41650,0,2,5
11947,6,3,41654,41654,41657,0,3,4
11948,4,3,41658,41658,41661,0,3,1
11949,4,1,41662,41662,41663,0,1,1
11950,5,1,41667,41667,41668,0,1,4
11951,6,3,41673,41673,41676,0,3,5
11952,5,2,41678,41678,41680,0,2,2
11953,6,3,41684,41684,41687,0,3,4
11954,5,1,41689,41689,41690,0,1,2
11955,1,1,41690,41690,41691,0,1,0
11956,4,2,41694,41694,41696,0,2,3
11957,2,1,41696,41696,41697,0,1,0
11958,5,3,41701,41701,41704,0,3,4
11959,6,2,41707,41707,41709,0,2,3
11960,2,3,41709,41709,41712,0,3,0
11961,5,3,41714,41714,41717,0,3,2
11962,6,3,41720,41720,41723,0,3,3
11963,1,1,41721,41723,41724,2,3,0
11964,5,2,41726,41726,41728,0,2,2
11965,2,1,41728,41728,41729,0,1,0
11966,4,2,41732,41732,41734,0,2,3
11967,2,2,41734,41734,41736,0,2,0
11968,3,3,41737,41737,41740,0,3,1
11969,2,1,41739,41740,41741,1,2,0
11970,6,2,41745,41745,41747,0,2,4
11971,3,2,41748,41748,41750,0,2,1
11972,4,3,41752,41752,41755,0,3,2
11973,5,3,41757,41757,41760,0,3,2
11974,1,1,41758,41760,41761,2,3,0
11975,1,3,41759,41761,41764,2,5,0
11976,5,3,41764,41764,41767,0,3,0
11977,2,2,41766,41767,41769,1,3,0
11978,2,1,41768,41769,41770,1,2,0
11979,2,3,41770,41770,41773,0,3,0
11980,4,3,41774,41774,41777,0,3,1
11981,5,1,41779,41779,41780,0,1,2
11982,3,2,41782,41782,41784,0,2,2
11983,1,3,41783,41784,41787,1,4,0
11984,5,1,41788,41788,41789,0,1,1
11985,2,2,41790,41790,41792,0,2,1
11986,2,2,41792,41792,41794,0,2,0
11987,1,2,41793,41794,41796,1,3,0
11988,5,3,41798,41798,41801,0,3,2
11989,3,1,41801,41801,41802,0,1,0
11990,5,3,41806,41806,41809,0,3,4
11991,3,2,41809,41809,41811,0,2,0
11992,1,3,41810,41811,41814,1,4,0
11993,6,3,41816,41816,41819,0,3,2
11994,2,3,41818,41819,41822,1,4,0
11995,2,3,41820,41822,41825,2,5,0
11996,2,2,41822,41825,41827,3,5,0
11997,4,2,41826,41827,41829,1,3,0
11998,3,1,41829,41829,41830,0,1,0
11999,2,3,41831,41831,41834,0,3,1
12000,1,1,41832,41834,41835,2,3,0
12001,2,2,41834,41835,41837,1,3,0
12002,1,1,41835,41837,41838,2,3,0
12003,2,2,41837,41838,41840,1,3,0
12004,6,2,41843,41843,41845,0,2,3
12005,4,1,41847,41847,41848,0,1,2
12006,1,2,41848,41848,41850,0,2,0
12007,6,2,41854,41854,41856,0,2,4
12008,3,3,41857,41857,41860,0,3,1
12009,1,3,41858,41860,41863,2,5,0
12010,1,1,41859,41863,41864,4,5,0
12011,5,2,41864,41864,41866,0,2,0
12012,2,1,41866,41866,41867,0,1,0
12013,1,2,41867,41867,41869,0,2,0
12014,2,1,41869,41869,41870,0,1,0
12015,3,3,41872,41872,41875,0,3,2
12016,3,2,41875,41875,41877,0,2,0
12017,1,3,41876,41877,41880,1,4,0
12018,6,3,41882,41882,41885,0,3,2
12019,4,2,41886,41886,41888,0,2,1
12020,6,2,41892,41892,41894,0,2,4
12021,3,1,41895,41895,41896,0,1,1
12022,5,3,41900,41900,41903,0,3,4
12023,6,3,41906,41906,41909,0,3,3
12024,2,1,41908,41909,41910,1,2,0
12025,3,2,41911,41911,41913,0,2,1
12026,1,3,41912,41913,41916,1,4,0
12027,3,2,41915,41916,41918,1,3,0
12028,4,1,41919,41919,41920,0,1,1
12029,6,3,41925,41925,41928,0,3,5
12030,6,3,41931,41931,41934,0,3,3
12031,6,3,41937,41937,41940,0,3,3
12032,1,3,41938,41940,41943,2,5,0
12033,2,3,41940,41943,41946,3,6,0
12034,6,2,41946,41946,41948,0,2,0
12035,5,3,41951,41951,41954,0,3,3
12036,5,3,41956,41956,41959,0,3,2
12037,4,2,41960,41960,41962,0,2,1
12038,1,3,41961,41962,41965,1,4,0
12039,1,3,41962,41965,41968,3,6,0
12040,6,1,41968,41968,41969,0,1,0
12041,5,3,41973,41973,41976,0,3,4
12042,2,1,41975,41976,41977,1,2,0
12043,6,1,41981,41981,41982,0,1,4
12044,4,1,41985,41985,41986,0,1,3
12045,5,1,41990,41990,41991,0,1,4
12046,4,3,41994,41994,41997,0,3,3
12047,1,1,41995,41997,41998,2,3,0
12048,3,1,41998,41998,41999,0,1,0
12049,6,2,42004,42004,42006,0,2,5
12050,6,3,42010,42010,42013,0,3,4
12051,1,3,42011,42013,42016,2,5,0
12052,4,2,42015,42016,42018,1,3,0
12053,2,1,42017,42018,42019,1,2,0
12054,5,3,42022,42022,42025,0,3,3
12055,3,1,42025,42025,42026,0,1,0
12056,3,1,42028,42028,42029,0,1,2
12057,1,1,42029,42029,42030,0,1,0
12058,4,2,42033,42033,42035,0,2,3
12059,5,1,42038,42038,42039,0,1,3
12060,3,1,42041,42041,42042,0,1,2
12061,5,2,42046,42046,42048,0,2,4
12062,3,3,42049,42049,42052,0,3,1
12063,4,1,42053,42053,42054,0,1,1
12064,6,3,42059,42059,42062,0,3,5
12065,2,1,42061,42062,42063,1,2,0
12066,5,2,42066,42066,42068,0,2,3
12067,3,2,42069,42069,42071,0,2,1
12068,5,1,42074,42074,42075,0,1,3
12069,5,1,42079,42079,42080,0,1,4
12070,6,3,42085,42085,42088,0,3,5
12071,2,3,42087,42088,42091,1,4,0
12072,5,3,42092,42092,42095,0,3,1
12073,1,1,42093,42095,42096,2,3,0
12074,2,2,42095,42096,42098,1,3,0
12075,1,2,42096,42098,42100,2,4,0
12076,1,3,42097,42100,42103,3,6,0
12077,5,2,42102,42103,42105,1,3,0
12078,1,2,42103,42105,42107,2,4,0
12079,5,2,42108,42108,42110,0,2,1
12080,3,2,42111,42111,42113,0,2,1
12081,5,2,42116,42116,42118,0,2,3
12082,1,3,42117,42118,42121,1,4,0
12083,5,1,42122,42122,42123,0,1,1
12084,3,3,42125,42125,42128,0,3,2
12085,2,2,42127,42128,42130,1,3,0
12086,2,3,42129,42130,42133,1,4,0
12087,3,2,42132,42133,42135,1,3,0
12088,3,3,42135,42135,42138,0,3,0
12089,1,1,42136,42138,42139,2,3,0
12090,1,1,42137,42139,42140,2,3,0
12091,2,2,42139,42140,42142,1,3,0
12092,5,3,42144,42144,42147,0,3,2
12093,4,3,42148,42148,42151,0,3,1
12094,4,1,42152,42152,42153,0,1,1
12095,1,2,42153,42153,42155,0,2,0
12096,4,1,42157,42157,42158,0,1,2
12097,6,3,42163,42163,42166,0,3,5
12098,6,1,42169,42169,42170,0,1,3
12099,6,2,42175,42175,42177,0,2,5
12100,5,1,42180,42180,42181,0,1,3
12101,5,2,42185,42185,42187,0,2,4
12102,2,2,42187,42187,42189,0,2,0
12103,4,1,42191,42191,42192,0,1,2
12104,3,3,42194,42194,42197,0,3,2
12105,5,2,42199,42199,42201,0,2,2
12106,4,3,42203,42203,42206,0,3,2
12107,2,1,42205,42206,42207,1,2,0
12108,4,3,42209,42209,42212,0,3,2
12109,3,1,42212,42212,42213,0,1,0
12110,3,2,42215,42215,42217,0,2,2
12111,4,2,42219,42219,42221,0,2,2
12112,6,2,42225,42225,42227,0,2,4
12113,3,2,42228,42228,42230,0,2,1
12114,3,2,42231,42231,42233,0,2,1
12115,6,1,42237,42237,42238,0,1,4
12116,4,1,42241,42241,42242,0,1,3
12117,4,1,42245,42245,42246,0,1,3
12118,4,2,42249,42249,42251,0,2,3
12119,5,2,42254,42254,42256,0,2,3
12120,3,2,42257,42257,42259,0,2,1
12121,3,3,42260,42260,42263,0,3,1
12122,4,2,42264,42264,42266,0,2,1
12123,1,2,42265,42266,42268,1,3,0
12124,1,3,42266,42268,42271,2,5,0
12125,4,1,42270,42271,42272,1,2,0
12126,2,3,42272,42272,42275,0,3,0
12127,5,1,42277,42277,42278,0,1,2
12128,4,1,42281,42281,42282,0,1,3
12129,4,1,42285,42285,42286,0,1,3
12130,3,2,42288,42288,42290,0,2,2
12131,6,1,42294,42294,42295,0,1,4
12132,2,3,42296,42296,42299,0,3,1
12133,5,1,42301,42301,42302,0,1,2
12134,4,3,42305,42305,42308,0,3,3
12135,1,2,42306,42308,42310,2,4,0
12136,4,3,42310,42310,42313,0,3,0
12137,5,2,42315,42315,42317,0,2,2
12138,6,1,42321,42321,42322,0,1,4
12139,5,1,42326,42326,42327,0,1,4
12140,3,2,42329,42329,42331,0,2,2
12141,5,2,42334,42334,42336,0,2,3
12142,3,3,42337,42337,42340,0,3,1
12143,6,1,42343,42343,42344,0,1,3
12144,1,3,42344,42344,42347,0,3,0
12145,5,1,42349,42349,42350,0,1,2
12146,6,3,42355,42355,42358,0,3,5
12147,5,3,42360,42360,42363,0,3,2
12148,4,1,42364,42364,42365,0,1,1
12149,4,3,42368,42368,42371,0,3,3
12150,4,3,42372,42372,42375,0,3,1
12151,1,2,42373,42375,42377,2,4,0
12152,2,3,42375,42377,42380,2,5,0
12153,3,3,42378,42380,42383,2,5,0
12154,2,3,42380,42383,42386,3,6,0
12155,6,2,42386,42386,42388,0,2,0
12156,3,2,42389,42389,42391,0,2,1
12157,3,2,42392,42392,42394,0,2,1
12158,1,1,42393,42394,42395,1,2,0
12159,3,3,42396,42396,42399,0,3,1
12160,2,1,42398,42399,42400,1,2,0
12161,3,3,42401,42401,42404,0,3,1
12162,5,3,42406,42406,42409,0,3,2
12163,6,3,42412,42412,42415,0,3,3
12164,2,3,42414,42415,42418,1,4,0
12165,3,3,42417,42418,42421,1,4,0
12166,6,3,42423,42423,42426,0,3,2
12167,1,3,42424,42426,42429,2,5,0
12168,2,1,42426,42429,42430,3,4,0
12169,4,3,42430,42430,42433,0,3,0
12170,3,1,42433,42433,42434,0,1,0
12171,4,3,42437,42437,42440,0,3,3
12172,1,2,42438,42440,42442,2,4,0
12173,1,1,42439,42442,42443,3,4,0
12174,5,3,42444,42444,42447,0,3,1
12175,2,2,42446,42447,42449,1,3,0
12176,1,1,42447,42449,42450,2,3,0
12177,3,1,42450,42450,42451,0,1,0
12178,3,2,42453,42453,42455,0,2,2
12179,4,1,42457,42457,42458,0,1,2
12180,3,3,42460,42460,42463,0,3,2
12181,4,2,42464,42464,42466,0,2,1
12182,3,1,42467,42467,42468,0,1,1
12183,5,2,42472,42472,42474,0,2,4
12184,4,3,42476,42476,42479,0,3,2
12185,2,3,42478,42479,42482,1,4,0
12186,3,2,42481,42482,42484,1,3,0
12187,4,2,42485,42485,42487,0,2,1
12188,6,1,42491,42491,42492,0,1,4
12189,6,1,42497,42497,42498,0,1,5
12190,1,2,42498,42498,42500,0,2,0
12191,2,1,42500,42500,42501,0,1,0
12192,2,2,42502,42502,42504,0,2,1
12193,5,2,42507,42507,42509,0,2,3
12194,4,3,42511,42511,42514,0,3,2
12195,5,1,42516,42516,42517,0,1,2
12196,4,3,42520,42520,42523,0,3,3
12197,4,1,42524,42524,42525,0,1,1
12198,2,3,42526,42526,42529,0,3,1
12199,4,3,42530,42530,42533,0,3,1
12200,6,3,42536,42536,42539,0,3,3
12201,5,3,42541,42541,42544,0,3,2
12202,4,1,42545,42545,42546,0,1,1
12203,1,2,42546,42546,42548,0,2,0
12204,6,1,42552,42552,42553,0,1,4
12205,2,3,42554,42554,42557,0,3,1
12206,4,2,42558,42558,42560,0,2,1
12207,3,3,42561,42561,42564,0,3,1
12208,2,1,42563,42564,42565,1,2,0
12209,6,3,42569,42569,42572,0,3,4
12210,3,1,42572,42572,42573,0,1,0
12211,1,2,42573,42573,42575,0,2,0
12212,6,1,42579,42579,42580,0,1,4
12213,5,2,42584,42584,42586,0,2,4
12214,6,1,42590,42590,42591,0,1,4
12215,2,1,42592,42592,42593,0,1,1
12216,1,2,42593,42593,42595,0,2,0
12217,2,3,42595,42595,42598,0,3,0
12218,6,3,42601,42601,42604,0,3,3
12219,1,1,42602,42604,42605,2,3,0
12220,4,3,42606,42606,42609,0,3,1
12221,6,1,42612,42612,42613,0,1,3
12222,3,2,42615,42615,42617,0,2,2
12223,3,1,42618,42618,42619,0,1,1
12224,6,2,42624,42624,42626,0,2,5
12225,3,3,42627,42627,42630,0,3,1
12226,1,1,42628,42630,42631,2,3,0
12227,5,2,42633,42633,42635,0,2,2
12228,3,3,42636,42636,42639,0,3,1
12229,1,1,42637,42639,42640,2,3,0
12230,6,2,42643,42643,42645,0,2,3
12231,1,2,42644,42645,42647,1,3,0
12232,4,3,42648,42648,42651,0,3,1
12233,3,2,42651,42651,42653,0,2,0
12234,2,1,42653,42653,42654,0,1,0
12235,5,1,42658,42658,42659,0,1,4
12236,5,3,42663,42663,42666,0,3,4
12237,3,1,42666,42666,42667,0,1,0
12238,3,2,42669,42669,42671,0,2,2
12239,3,3,42672,42672,42675,0,3,1
12240,4,2,42676,42676,42678,0,2,1
12241,6,2,42682,42682,42684,0,2,4
12242,6,1,42688,42688,42689,0,1,4
12243,2,3,42690,42690,42693,0,3,1
12244,6,2,42696,42696,42698,0,2,3
12245,4,1,42700,42700,42701,0,1,2
12246,3,3,42703,42703,42706,0,3,2
12247,1,1,42704,42706,42707,2,3,0
12248,6,1,42710,42710,42711,0,1,3
12249,4,2,42714,42714,42716,0,2,3
12250,4,2,42718,42718,42720,0,2,2
12251,2,3,42720,42720,42723,0,3,0
12252,3,2,42723,42723,42725,0,2,0
12253,3,2,42726,42726,42728,0,2,1
12254,2,2,42728,42728,42730,0,2,0
12255,4,2,42732,42732,42734,0,2,2
12256,5,2,42737,42737,42739,0,2,3
12257,3,1,42740,42740,42741,0,1,1
12258,4,3,42744,42744,42747,0,3,3
12259,5,3,42749,42749,42752,0,3,2
12260,5,1,42754,42754,42755,0,1,2
12261,5,2,42759,42759,42761,0,2,4
12262,5,3,42764,42764,42767,0,3,3
12263,5,1,42769,42769,42770,0,1,2
12264,2,1,42771,42771,42772,0,1,1
12265,1,3,42772,42772,42775,0,3,0
12266,5,3,42777,42777,42780,0,3,2
12267,1,1,42778,42780,42781,2,3,0
12268,6,3,42784,42784,42787,0,3,3
12269,5,3,42789,42789,42792,0,3,2
12270,5,1,42794,42794,42795,0,1,2
12271,2,2,42796,42796,42798,0,2,1
12272,4,2,42800,42800,42802,0,2,2
12273,3,3,42803,42803,42806,0,3,1
12274,6,2,42809,42809,42811,0,2,3
12275,4,1,42813,42813,42814,0,1,2
12276,4,1,42817,42817,42818,0,1,3
12277,3,1,42820,42820,42821,0,1,2
12278,1,1,42821,42821,42822,0,1,0
12279,1,1,42822,42822,42823,0,1,0
12280,4,3,42826,42826,42829,0,3,3
12281,2,2,42828,42829,42831,1,3,0
12282,6,2,42834,42834,42836,0,2,3
12283,2,1,42836,42836,42837,0,1,0
12284,1,1,42837,42837,42838,0,1,0
12285,6,3,42843,42843,42846,0,3,5
12286,3,1,42846,42846,42847,0,1,0
12287,6,1,42852,42852,42853,0,1,5
12288,4,2,42856,42856,42858,0,2,3
12289,2,3,42858,42858,42861,0,3,0
12290,3,3,42861,42861,42864,0,3,0
12291,5,3,42866,42866,42869,0,3,2
12292,1,2,42867,42869,42871,2,4,0
12293,3,2,42870,42871,42873,1,3,0
12294,1,3,42871,42873,42876,2,5,0
12295,6,1,42877,42877,42878,0,1,1
12296,4,1,42881,42881,42882,0,1,3
12297,4,3,42885,42885,42888,0,3,3
12298,2,3,42887,42888,42891,1,4,0
12299,2,1,42889,42891,42892,2,3,0
12300,4,1,42893,42893,42894,0,1,1
12301,1,1,42894,42894,42895,0,1,0
12302,3,2,42897,42897,42899,0,2,2
12303,4,3,42901,42901,42904,0,3,2
12304,2,3,42903,42904,42907,1,4,0
12305,4,2,42907,42907,42909,0,2,0
12306,2,1,42909,42909,42910,0,1,0
12307,4,1,42913,42913,42914,0,1,3
12308,2,2,42915,42915,42917,0,2,1
12309,6,3,42921,42921,42924,0,3,4
12310,5,3,42926,42926,42929,0,3,2
12311,6,2,42932,42932,42934,0,2,3
12312,6,3,42938,42938,42941,0,3,4
12313,3,2,42941,42941,42943,0,2,0
12314,6,2,42947,42947,42949,0,2,4
12315,6,2,42953,42953,42955,0,2,4
12316,4,2,42957,42957,42959,0,2,2
12317,1,2,42958,42959,42961,1,3,0
12318,5,2,42963,42963,42965,0,2,2
12319,3,1,42966,42966,42967,0,1,1
12320,1,2,42967,42967,42969,0,2,0
12321,5,1,42972,42972,42973,0,1,3
12322,5,1,42977,42977,42978,0,1,4
12323,4,1,42981,42981,42982,0,1,3
12324,5,3,42986,42986,42989,0,3,4
12325,5,2,42991,42991,42993,0,2,2
12326,4,3,42995,42995,42998,0,3,2
12327,5,2,43000,43000,43002,0,2,2
12328,1,3,43001,43002,43005,1,4,0
12329,5,2,43006,43006,43008,0,2,1
12330,6,3,43012,43012,43015,0,3,4
12331,4,3,43016,43016,43019,0,3,1
12332,2,1,43018,43019,43020,1,2,0
12333,5,3,43023,43023,43026,0,3,3
12334,1,1,43024,43026,43027,2,3,0
12335,4,2,43028,43028,43030,0,2,1
12336,4,2,43032,43032,43034,0,2,2
12337,2,3,43034,43034,43037,0,3,0
12338,6,3,43040,43040,43043,0,3,3
12339,6,2,43046,43046,43048,0,2,3
12340,2,1,43048,43048,43049,0,1,0
12341,4,3,43052,43052,43055,0,3,3
12342,3,1,43055,43055,43056,0,1,0
12343,5,1,43060,43060,43061,0,1,4
12344,5,3,43065,43065,43068,0,3,4
12345,5,2,43070,43070,43072,0,2,2
12346,5,1,43075,43075,43076,0,1,3
12347,2,1,43077,43077,43078,0,1,1
12348,2,1,43079,43079,43080,0,1,1
12349,1,2,43080,43080,43082,0,2,0
12350,2,3,43082,43082,43085,0,3,0
12351,2,1,43084,43085,43086,1,2,0
12352,6,2,43090,43090,43092,0,2,4
12353,2,1,43092,43092,43093,0,1,0
12354,3,3,43095,43095,43098,0,3,2
12355,6,1,43101,43101,43102,0,1,3
12356,1,2,43102,43102,43104,0,2,0
12357,6,1,43108,43108,43109,0,1,4
12358,2,3,43110,43110,43113,0,3,1
12359,6,3,43116,43116,43119,0,3,3
12360,4,3,43120,43120,43123,0,3,1
12361,3,3,43123,43123,43126,0,3,0
12362,1,1,43124,43126,43127,2,3,0
12363,3,2,43127,43127,43129,0,2,0
12364,2,2,43129,43129,43131,0,2,0
12365,5,2,43134,43134,43136,0,2,3
12366,3,3,43137,43137,43140,0,3,1
12367,2,3,43139,43140,43143,1,4,0
12368,4,3,43143,43143,43146,0,3,0
12369,4,1,43147,43147,43148,0,1,1
12370,4,1,43151,43151,43152,0,1,3
12371,4,2,43155,43155,43157,0,2,3
12372,1,3,43156,43157,43160,1,4,0
12373,3,2,43159,43160,43162,1,3,0
12374,4,3,43163,43163,43166,0,3,1
12375,4,1,43167,43167,43168,0,1,1
12376,4,3,43171,43171,43174,0,3,3
12377,4,2,43175,43175,43177,0,2,1
12378,1,2,43176,43177,43179,1,3,0
12379,6,3,43182,43182,43185,0,3,3
12380,4,3,43186,43186,43189,0,3,1
12381,4,3,43190,43190,43193,0,3,1
12382,6,1,43196,43196,43197,0,1,3
12383,3,2,43199,43199,43201,0,2,2
12384,6,2,43205,43205,43207,0,2,4
12385,1,3,43206,43207,43210,1,4,0
12386,3,1,43209,43210,43211,1,2,0
12387,3,1,43212,43212,43213,0,1,1
12388,5,2,43217,43217,43219,0,2,4
12389,2,3,43219,43219,43222,0,3,0
12390,5,1,43224,43224,43225,0,1,2
12391,5,2,43229,43229,43231,0,2,4
12392,3,3,43232,43232,43235,0,3,1
12393,5,2,43237,43237,43239,0,2,2
12394,1,1,43238,43239,43240,1,2,0
12395,5,3,43243,43243,43246,0,3,3
12396,3,3,43246,43246,43249,0,3,0
12397,6,3,43252,43252,43255,0,3,3
12398,4,1,43256,43256,43257,0,1,1
12399,1,2,43257,43257,43259,0,2,0
12400,6,2,43263,43263,43265,0,2,4
12401,6,1,43269,43269,43270,0,1,4
12402,2,1,43271,43271,43272,0,1,1
12403,1,1,43272,43272,43273,0,1,0
12404,5,2,43277,43277,43279,0,2,4
12405,5,2,43282,43282,43284,0,2,3
12406,6,2,43288,43288,43290,0,2,4
12407,6,3,43294,43294,43297,0,3,4
12408,4,1,43298,43298,43299,0,1,1
12409,3,3,43301,43301,43304,0,3,2
12410,4,1,43305,43305,43306,0,1,1
12411,5,1,43310,43310,43311,0,1,4
12412,2,3,43312,43312,43315,0,3,1
12413,4,1,43316,43316,43317,0,1,1
12414,4,1,43320,43320,43321,0,1,3
12415,3,2,43323,43323,43325,0,2,2
12416,4,3,43327,43327,43330,0,3,2
12417,3,2,43330,43330,43332,0,2,0
12418,4,3,43334,43334,43337,0,3,2
12419,2,2,43336,43337,43339,1,3,0
12420,5,1,43341,43341,43342,0,1,2
12421,5,3,43346,43346,43349,0,3,4
12422,2,2,43348,43349,43351,1,3,0
12423,2,3,43350,43351,43354,1,4,0
12424,4,1,43354,43354,43355,0,1,0
12425,6,2,43360,43360,43362,0,2,5
12426,5,3,43365,43365,43368,0,3,3
12427,2,2,43367,43368,43370,1,3,0
12428,3,3,43370,43370,43373,0,3,0
12429,3,3,43373,43373,43376,0,3,0
12430,4,3,43377,43377,43380,0,3,1
12431,6,2,43383,43383,43385,0,2,3
12432,4,2,43387,43387,43389,0,2,2
12433,6,2,43393,43393,43395,0,2,4
12434,4,1,43397,43397,43398,0,1,2
12435,2,3,43399,43399,43402,0,3,1
12436,2,2,43401,43402,43404,1,3,0
12437,1,1,43402,43404,43405,2,3,0
12438,5,2,43407,43407,43409,0,2,2
12439,5,1,43412,43412,43413,0,1,3
12440,5,1,43417,43417,43418,0,1,4
12441,2,3,43419,43419,43422,0,3,1
12442,2,2,43421,43422,43424,1,3,0
12443,2,2,43423,43424,43426,1,3,0
12444,1,2,43424,43426,43428,2,4,0
12445,6,2,43430,43430,43432,0,2,2
12446,6,1,43436,43436,43437,0,1,4
12447,6,3,43442,43442,43445,0,3,5
12448,3,2,43445,43445,43447,0,2,0
12449,4,2,43449,43449,43451,0,2,2
12450,1,3,43450,43451,43454,1,4,0
12451,2,2,43452,43454,43456,2,4,0
12452,3,2,43455,43456,43458,1,3,0
12453,2,3,43457,43458,43461,1,4,0
12454,3,1,43460,43461,43462,1,2,0
12455,2,2,43462,43462,43464,0,2,0
12456,2,3,43464,43464,43467,0,3,0
12457,3,3,43467,43467,43470,0,3,0
12458,4,1,43471,43471,43472,0,1,1
12459,3,1,43474,43474,43475,0,1,2
12460,1,2,43475,43475,43477,0,2,0
12461,2,1,43477,43477,43478,0,1,0
12462,4,3,43481,43481,43484,0,3,3
12463,1,3,43482,43484,43487,2,5,0
12464,6,3,43488,43488,43491,0,3,1
12465,2,2,43490,43491,43493,1,3,0
12466,4,1,43494,43494,43495,0,1,1
12467,5,1,43499,43499,43500,0,1,4
12468,3,2,43502,43502,43504,0,2,2
12469,4,2,43506,43506,43508,0,2,2
12470,5,2,43511,43511,43513,0,2,3
12471,1,3,43512,43513,43516,1,4,0
12472,2,3,43514,43516,43519,2,5,0
12473,1,1,43515,43519,43520,4,5,0
12474,5,2,43520,43520,43522,0,2,0
12475,1,3,43521,43522,43525,1,4,0
12476,6,2,43527,43527,43529,0,2,2
12477,4,3,43531,43531,43534,0,3,2
12478,6,1,43537,43537,43538,0,1,3
12479,1,1,43538,43538,43539,0,1,0
12480,3,3,43541,43541,43544,0,3,2
12481,2,2,43543,43544,43546,1,3,0
12482,2,2,43545,43546,43548,1,3,0
12483,5,3,43550,43550,43553,0,3,2
12484,2,1,43552,43553,43554,1,2,0
12485,6,3,43558,43558,43561,0,3,4
12486,5,1,43563,43563,43564,0,1,2
12487,4,1,43567,43567,43568,0,1,3
12488,5,2,43572,43572,43574,0,2,4
12489,1,1,43573,43574,43575,1,2,0
12490,3,1,43576,43576,43577,0,1,1
12491,4,3,43580,43580,43583,0,3,3
12492,3,3,43583,43583,43586,0,3,0
12493,4,1,43587,43587,43588,0,1,1
12494,3,3,43590,43590,43593,0,3,2
12495,6,1,43596,43596,43597,0,1,3
12496,1,2,43597,43597,43599,0,2,0
12497,1,1,43598,43599,43600,1,2,0
12498,5,3,43603,43603,43606,0,3,3
12499,5,1,43608,43608,43609,0,1,2
12500,1,2,43609,43609,43611,0,2,0
12501,1,3,43610,43611,43614,1,4,0
12502,6,2,43616,43616,43618,0,2,2
12503,3,2,43619,43619,43621,0,2,1
12504,4,3,43623,43623,43626,0,3,2
12505,6,1,43629,43629,43630,0,1,3
12506,3,3,43632,43632,43635,0,3,2
12507,4,2,43636,43636,43638,0,2,1
12508,4,1,43640,43640,43641,0,1,2
12509,6,3,43646,43646,43649,0,3,5
12510,3,3,43649,43649,43652,0,3,0
12511,5,3,43654,43654,43657,0,3,2
12512,3,3,43657,43657,43660,0,3,0
12513,4,1,43661,43661,43662,0,1,1
12514,1,1,43662,43662,43663,0,1,0
12515,6,2,43668,43668,43670,0,2,5
12516,5,3,43673,43673,43676,0,3,3
12517,2,3,43675,43676,43679,1,4,0
12518,1,2,43676,43679,43681,3,5,0
12519,5,1,43681,43681,43682,0,1,0
12520,6,2,43687,43687,43689,0,2,5
12521,1,1,43688,43689,43690,1,2,0
12522,2,3,43690,43690,43693,0,3,0
12523,4,1,43694,43694,43695,0,1,1
12524,3,1,43697,43697,43698,0,1,2
12525,5,3,43702,43702,43705,0,3,4
12526,1,1,43703,43705,43706,2,3,0
12527,1,3,43704,43706,43709,2,5,0
12528,2,2,43706,43709,43711,3,5,0
12529,5,2,43711,43711,43713,0,2,0
12530,1,3,43712,43713,43716,1,4,0
12531,3,3,43715,43716,43719,1,4,0
12532,1,1,43716,43719,43720,3,4,0
12533,6,2,43722,43722,43724,0,2,2
12534,1,1,43723,43724,43725,1,2,0
12535,5,3,43728,43728,43731,0,3,3
12536,1,2,43729,43731,43733,2,4,0
12537,6,3,43735,43735,43738,0,3,2
12538,5,2,43740,43740,43742,0,2,2
12539,3,2,43743,43743,43745,0,2,1
12540,4,1,43747,43747,43748,0,1,2
12541,2,1,43749,43749,43750,0,1,1
12542,3,3,43752,43752,43755,0,3,2
12543,6,3,43758,43758,43761,0,3,3
12544,6,3,43764,43764,43767,0,3,3
12545,3,3,43767,43767,43770,0,3,0
12546,1,2,43768,43770,43772,2,4,0
12547,1,1,43769,43772,43773,3,4,0
12548,2,2,43771,43773,43775,2,4,0
12549,6,1,43777,43777,43778,0,1,2
12550,3,1,43780,43780,43781,0,1,2
12551,3,2,43783,43783,43785,0,2,2
12552,3,3,43786,43786,43789,0,3,1
12553,3,1,43789,43789,43790,0,1,0
12554,4,1,43793,43793,43794,0,1,3
12555,5,2,43798,43798,43800,0,2,4
12556,4,3,43802,43802,43805,0,3,2
12557,5,3,43807,43807,43810,0,3,2
12558,3,1,43810,43810,43811,0,1,0
12559,6,2,43816,43816,43818,0,2,5
12560,6,2,43822,43822,43824,0,2,4
12561,6,1,43828,43828,43829,0,1,4
12562,2,2,43830,43830,43832,0,2,1
12563,5,2,43835,43835,43837,0,2,3
12564,5,1,43840,43840,43841,0,1,3
12565,5,1,43845,43845,43846,0,1,4
12566,5,3,43850,43850,43853,0,3,4
12567,3,1,43853,43853,43854,0,1,0
12568,6,1,43859,43859,43860,0,1,5
12569,6,1,43865,43865,43866,0,1,5
12570,6,1,43871,43871,43872,0,1,5
12571,6,2,43877,43877,43879,0,2,5
12572,4,3,43881,43881,43884,0,3,2
12573,1,2,43882,43884,43886,2,4,0
12574,5,3,43887,43887,43890,0,3,1
12575,4,1,43891,43891,43892,0,1,1
12576,4,3,43895,43895,43898,0,3,3
12577,1,3,43896,43898,43901,2,5,0
12578,1,2,43897,43901,43903,4,6,0
12579,3,1,43900,43903,43904,3,4,0
12580,2,1,43902,43904,43905,2,3,0
12581,2,1,43904,43905,43906,1,2,0
12582,2,2,43906,43906,43908,0,2,0
12583,5,1,43911,43911,43912,0,1,3
12584,4,3,43915,43915,43918,0,3,3
12585,3,2,43918,43918,43920,0,2,0
12586,2,1,43920,43920,43921,0,1,0
12587,3,3,43923,43923,43926,0,3,2
12588,6,1,43929,43929,43930,0,1,3
12589,1,2,43930,43930,43932,0,2,0
12590,6,2,43936,43936,43938,0,2,4
12591,4,2,43940,43940,43942,0,2,2
12592,3,1,43943,43943,43944,0,1,1
12593,2,2,43945,43945,43947,0,2,1
12594,1,3,43946,43947,43950,1,4,0
12595,6,1,43952,43952,43953,0,1,2
12596,6,3,43958,43958,43961,0,3,5
12597,4,1,43962,43962,43963,0,1,1
12598,4,1,43966,43966,43967,0,1,3
12599,5,2,43971,43971,43973,0,2,4
12600,4,2,43975,43975,43977,0,2,2
12601,6,3,43981,43981,43984,0,3,4
12602,6,3,43987,43987,43990,0,3,3
12603,2,3,43989,43990,43993,1,4,0
12604,2,3,43991,43993,43996,2,5,0
12605,4,1,43995,43996,43997,1,2,0
12606,2,2,43997,43997,43999,0,2,0
12607,1,1,43998,43999,44000,1,2,0
12608,3,2,44001,44001,44003,0,2,1
12609,1,1,44002,44003,44004,1,2,0
12610,2,1,44004,44004,44005,0,1,0
12611,6,3,44010,44010,44013,0,3,5
12612,2,2,44012,44013,44015,1,3,0
12613,4,2,44016,44016,44018,0,2,1
12614,1,3,44017,44018,44021,1,4,0
12615,2,1,44019,44021,44022,2,3,0
12616,5,1,44024,44024,44025,0,1,2
12617,5,1,44029,44029,44030,0,1,4
12618,6,2,44035,44035,44037,0,2,5
12619,2,3,44037,44037,44040,0,3,0
12620,3,1,44040,44040,44041,0,1,0
12621,4,2,44044,44044,44046,0,2,3
12622,1,2,44045,44046,44048,1,3,0
12623,1,3,44046,44048,44051,2,5,0
12624,2,1,44048,44051,44052,3,4,0
12625,1,3,44049,44052,44055,3,6,0
12626,1,3,44050,44055,44058,5,8,0
12627,2,3,44052,44058,44061,6,9,0
12628,1,2,44053,44061,44063,8,10,0
12629,2,3,44055,44063,44066,8,11,0
12630,4,2,44059,44066,44068,7,9,0
12631,4,3,44063,44068,44071,5,8,0
12632,3,1,44066,44071,44072,5,6,0
12633,6,3,44072,44072,44075,0,3,0
12634,1,1,44073,44075,44076,2,3,0
12635,3,3,44076,44076,44079,0,3,0
12636,2,2,44078,44079,44081,1,3,0
12637,6,2,44084,44084,44086,0,2,3
12638,4,3,44088,44088,44091,0,3,2
12639,2,1,44090,44091,44092,1,2,0
12640,5,3,44095,44095,44098,0,3,3
12641,2,3,44097,44098,44101,1,4,0
12642,5,3,44102,44102,44105,0,3,1
12643,4,3,44106,44106,44109,0,3,1
12644,1,1,44107,44109,44110,2,3,0
12645,2,3,44109,44110,44113,1,4,0
12646,5,3,44114,44114,44117,0,3,1
12647,3,3,44117,44117,44120,0,3,0
12648,5,2,44122,44122,44124,0,2,2
12649,4,2,44126,44126,44128,0,2,2
12650,2,3,44128,44128,44131,0,3,0
12651,3,3,44131,44131,44134,0,3,0
12652,5,2,44136,44136,44138,0,2,2
12653,2,2,44138,44138,44140,0,2,0
12654,5,1,44143,44143,44144,0,1,3
12655,1,3,44144,44144,44147,0,3,0
12656,6,3,44150,44150,44153,0,3,3
12657,6,2,44156,44156,44158,0,2,3
12658,3,1,44159,44159,44160,0,1,1
12659,6,3,44165,44165,44168,0,3,5
12660,4,1,44169,44169,44170,0,1,1
12661,1,1,44170,44170,44171,0,1,0
12662,1,3,44171,44171,44174,0,3,0
12663,5,1,44176,44176,44177,0,1,2
12664,3,1,44179,44179,44180,0,1,2
12665,2,2,44181,44181,44183,0,2,1
12666,6,1,44187,44187,44188,0,1,4
12667,2,1,44189,44189,44190,0,1,1
12668,4,3,44193,44193,44196,0,3,3
12669,1,3,44194,44196,44199,2,5,0
12670,1,1,44195,44199,44200,4,5,0
12671,1,2,44196,44200,44202,4,6,0
12672,4,3,44200,44202,44205,2,5,0
12673,1,1,44201,44205,44206,4,5,0
12674,1,1,44202,44206,44207,4,5,0
12675,6,2,44208,44208,44210,0,2,1
12676,3,3,44211,44211,44214,0,3,1
12677,4,1,44215,44215,44216,0,1,1
12678,6,3,44221,44221,44224,0,3,5
12679,5,2,44226,44226,44228,0,2,2
12680,3,1,44229,44229,44230,0,1,1
12681,6,2,44235,44235,44237,0,2,5
12682,4,1,44239,44239,44240,0,1,2
12683,5,3,44244,44244,44247,0,3,4
12684,6,2,44250,44250,44252,0,2,3
12685,6,2,44256,44256,44258,0,2,4
12686,2,1,44258,44258,44259,0,1,0
12687,6,2,44264,44264,44266,0,2,5
12688,4,2,44268,44268,44270,0,2,2
12689,1,2,44269,44270,44272,1,3,0
12690,3,1,44272,44272,44273,0,1,0
12691,5,1,44277,44277,44278,0,1,4
12692,1,2,44278,44278,44280,0,2,0
12693,4,3,44282,44282,44285,0,3,2
12694,5,1,44287,44287,44288,0,1,2
12695,1,2,44288,44288,44290,0,2,0
12696,5,1,44293,44293,44294,0,1,3
12697,3,1,44296,44296,44297,0,1,2
12698,3,1,44299,44299,44300,0,1,2
12699,2,1,44301,44301,44302,0,1,1
12700,6,3,44307,44307,44310,0,3,5
12701,2,3,44309,44310,44313,1,4,0
12702,4,3,44313,44313,44316,0,3,0
12703,3,2,44316,44316,44318,0,2,0
12704,1,1,44317,44318,44319,1,2,0
12705,4,3,44321,44321,44324,0,3,2
12706,5,2,44326,44326,44328,0,2,2
12707,3,3,44329,44329,44332,0,3,1
12708,4,1,44333,44333,44334,0,1,1
12709,5,3,44338,44338,44341,0,3,4
12710,4,1,44342,44342,44343,0,1,1
12711,1,1,44343,44343,44344,0,1,0
12712,6,2,44349,44349,44351,0,2,5
12713,4,2,44353,44353,44355,0,2,2
12714,4,1,44357,44357,44358,0,1,2
12715,2,3,44359,44359,44362,0,3,1
12716,1,1,44360,44362,44363,2,3,0
12717,1,3,44361,44363,44366,2,5,0
12718,5,3,44366,44366,44369,0,3,0
12719,4,1,44370,44370,44371,0,1,1
12720,3,3,44373,44373,44376,0,3,2
12721,1,3,44374,44376,44379,2,5,0
12722,2,3,44376,44379,44382,3,6,0
12723,5,1,44381,44382,44383,1,2,0
12724,2,1,44383,44383,44384,0,1,0
12725,3,2,44386,44386,44388,0,2,2
12726,5,2,44391,44391,44393,0,2,3
12727,6,1,44397,44397,44398,0,1,4
12728,2,3,44399,44399,44402,0,3,1
12729,5,1,44404,44404,44405,0,1,2
12730,5,2,44409,44409,44411,0,2,4
12731,4,3,44413,44413,44416,0,3,2
12732,4,1,44417,44417,44418,0,1,1
12733,1,3,44418,44418,44421,0,3,0
12734,6,1,44424,44424,44425,0,1,3
12735,6,1,44430,44430,44431,0,1,5
12736,3,2,44433,44433,44435,0,2,2
12737,4,1,44437,44437,44438,0,1,2
12738,5,2,44442,44442,44444,0,2,4
12739,3,3,44445,44445,44448,0,3,1
12740,6,1,44451,44451,44452,0,1,3
12741,1,1,44452,44452,44453,0,1,0
12742,5,1,44457,44457,44458,0,1,4
12743,4,2,44461,44461,44463,0,2,3
12744,1,2,44462,44463,44465,1,3,0
12745,1,1,44463,44465,44466,2,3,0
12746,1,3,44464,44466,44469,2,5,0
12747,1,2,44465,44469,44471,4,6,0
12748,3,3,44468,44471,44474,3,6,0
12749,5,3,44473,44474,44477,1,4,0
12750,6,2,44479,44479,44481,0,2,2
12751,2,1,44481,44481,44482,0,1,0
12752,3,3,44484,44484,44487,0,3,2
12753,1,1,44485,44487,44488,2,3,0
12754,2,3,44487,44488,44491,1,4,0
12755,6,2,44493,44493,44495,0,2,2
12756,3,3,44496,44496,44499,0,3,1
12757,5,1,44501,44501,44502,0,1,2
12758,5,1,44506,44506,44507,0,1,4
12759,5,2,44511,44511,44513,0,2,4
12760,6,2,44517,44517,44519,0,2,4
12761,5,3,44522,44522,44525,0,3,3
12762,2,3,44524,44525,44528,1,4,0
12763,6,3,44530,44530,44533,0,3,2
12764,5,3,44535,44535,44538,0,3,2
12765,2,1,44537,44538,44539,1,2,0
12766,4,3,44541,44541,44544,0,3,2
12767,3,2,44544,44544,44546,0,2,0
12768,3,2,44547,44547,44549,0,2,1
12769,6,2,44553,44553,44555,0,2,4
12770,2,2,44555,44555,44557,0,2,0
12771,5,1,44560,44560,44561,0,1,3
12772,4,3,44564,44564,44567,0,3,3
12773,6,2,44570,44570,44572,0,2,3
12774,5,3,44575,44575,44578,0,3,3
12775,4,1,44579,44579,44580,0,1,1
12776,1,2,44580,44580,44582,0,2,0
12777,1,3,44581,44582,44585,1,4,0
12778,2,3,44583,44585,44588,2,5,0
12779,3,3,44586,44588,44591,2,5,0
12780,6,2,44592,44592,44594,0,2,1
12781,2,3,44594,44594,44597,0,3,0
12782,5,3,44599,44599,44602,0,3,2
12783,4,2,44603,44603,44605,0,2,1
12784,3,2,44606,44606,44608,0,2,1
12785,1,2,44607,44608,44610,1,3,0
12786,5,3,44612,44612,44615,0,3,2
12787,5,2,44617,44617,44619,0,2,2
12788,3,1,44620,44620,44621,0,1,1
12789,3,2,44623,44623,44625,0,2,2
12790,3,3,44626,44626,44629,0,3,1
12791,4,3,44630,44630,44633,0,3,1
12792,3,1,44633,44633,44634,0,1,0
12793,5,1,44638,44638,44639,0,1,4
12794,2,1,44640,44640,44641,0,1,1
12795,4,1,44644,44644,44645,0,1,3
12796,4,2,44648,44648,44650,0,2,3
12797,5,2,44653,44653,44655,0,2,3
12798,6,2,44659,44659,44661,0,2,4
12799,1,3,44660,44661,44664,1,4,0
12800,1,3,44661,44664,44667,3,6,0
12801,6,2,44667,44667,44669,0,2,0
12802,2,2,44669,44669,44671,0,2,0
12803,2,1,44671,44671,44672,0,1,0
12804,5,2,44676,44676,44678,0,2,4
12805,2,3,44678,44678,44681,0,3,0
12806,4,1,44682,44682,44683,0,1,1
12807,3,1,44685,44685,44686,0,1,2
12808,3,3,44688,44688,44691,0,3,2
12809,1,1,44689,44691,44692,2,3,0
12810,3,1,44692,44692,44693,0,1,0
12811,1,1,44693,44693,44694,0,1,0
12812,5,2,44698,44698,44700,0,2,4
12813,6,2,44704,44704,44706,0,2,4
12814,4,2,44708,44708,44710,0,2,2
12815,6,2,44714,44714,44716,0,2,4
12816,4,3,44718,44718,44721,0,3,2
12817,5,3,44723,44723,44726,0,3,2
12818,2,1,44725,44726,44727,1,2,0
12819,5,2,44730,44730,44732,0,2,3
12820,6,3,44736,44736,44739,0,3,4
12821,6,1,44742,44742,44743,0,1,3
12822,1,1,44743,44743,44744,0,1,0
12823,4,3,44747,44747,44750,0,3,3
12824,4,1,44751,44751,44752,0,1,1
12825,3,1,44754,44754,44755,0,1,2
12826,5,3,44759,44759,44762,0,3,4
12827,5,1,44764,44764,44765,0,1,2
12828,5,2,44769,44769,44771,0,2,4
12829,3,2,44772,44772,44774,0,2,1
12830,4,1,44776,44776,44777,0,1,2
12831,3,2,44779,44779,44781,0,2,2
12832,1,2,44780,44781,44783,1,3,0
12833,3,1,44783,44783,44784,0,1,0
12834,3,3,44786,44786,44789,0,3,2
12835,1,1,44787,44789,44790,2,3,0
12836,3,2,44790,44790,44792,0,2,0
12837,5,2,44795,44795,44797,0,2,3
12838,1,1,44796,44797,44798,1,2,0
12839,2,2,44798,44798,44800,0,2,0
12840,5,3,44803,44803,44806,0,3,3
12841,4,3,44807,44807,44810,0,3,1
12842,1,3,44808,44810,44813,2,5,0
12843,3,2,44811,44813,44815,2,4,0
12844,5,1,44816,44816,44817,0,1,1
12845,2,2,44818,44818,44820,0,2,1
12846,6,3,44824,44824,44827,0,3,4
12847,4,1,44828,44828,44829,0,1,1
12848,4,1,44832,44832,44833,0,1,3
12849,6,1,44838,44838,44839,0,1,5
12850,1,3,44839,44839,44842,0,3,0
12851,2,2,44841,44842,44844,1,3,0
12852,1,2,44842,44844,44846,2,4,0
12853,1,1,44843,44846,44847,3,4,0
12854,2,3,44845,44847,44850,2,5,0
12855,3,2,44848,44850,44852,2,4,0
12856,5,2,44853,44853,44855,0,2,1
12857,2,3,44855,44855,44858,0,3,0
12858,1,2,44856,44858,44860,2,4,0
12859,5,1,44861,44861,44862,0,1,1
12860,2,2,44863,44863,44865,0,2,1
12861,5,3,44868,44868,44871,0,3,3
12862,3,3,44871,44871,44874,0,3,0
12863,1,3,44872,44874,44877,2,5,0
12864,5,3,44877,44877,44880,0,3,0
12865,6,2,44883,44883,44885,0,2,3
12866,2,3,44885,44885,44888,0,3,0
12867,1,3,44886,44888,44891,2,5,0
12868,1,1,44887,44891,44892,4,5,0
12869,4,3,44891,44892,44895,1,4,0
12870,3,3,44894,44895,44898,1,4,0
12871,3,2,44897,44898,44900,1,3,0
12872,5,3,44902,44902,44905,0,3,2
12873,5,1,44907,44907,44908,0,1,2
12874,5,3,44912,44912,44915,0,3,4
12875,1,3,44913,44915,44918,2,5,0
12876,5,2,44918,44918,44920,0,2,0
12877,5,3,44923,44923,44926,0,3,3
12878,1,3,44924,44926,44929,2,5,0
12879,3,2,44927,44929,44931,2,4,0
12880,4,3,44931,44931,44934,0,3,0
12881,4,1,44935,44935,44936,0,1,1
12882,2,2,44937,44937,44939,0,2,1
12883,3,3,44940,44940,44943,0,3,1
12884,2,2,44942,44943,44945,1,3,0
12885,1,2,44943,44945,44947,2,4,0
12886,5,3,44948,44948,44951,0,3,1
12887,2,3,44950,44951,44954,1,4,0
12888,3,3,44953,44954,44957,1,4,0
12889,1,3,44954,44957,44960,3,6,0
12890,2,2,44956,44960,44962,4,6,0
12891,6,3,44962,44962,44965,0,3,0
12892,4,1,44966,44966,44967,0,1,1
12893,2,2,44968,44968,44970,0,2,1
12894,3,1,44971,44971,44972,0,1,1
12895,6,3,44977,44977,44980,0,3,5
12896,3,1,44980,44980,44981,0,1,0
12897,4,2,44984,44984,44986,0,2,3
12898,4,3,44988,44988,44991,0,3,2
12899,4,1,44992,44992,44993,0,1,1
12900,2,2,44994,44994,44996,0,2,1
12901,4,1,44998,44998,44999,0,1,2
12902,6,1,45004,45004,45005,0,1,5
12903,6,2,45010,45010,45012,0,2,5
12904,6,2,45016,45016,45018,0,2,4
12905,5,2,45021,45021,45023,0,2,3
12906,1,1,45022,45023,45024,1,2,0
12907,3,1,45025,45025,45026,0,1,1
12908,5,3,45030,45030,45033,0,3,4
12909,5,2,45035,45035,45037,0,2,2
12910,3,1,45038,45038,45039,0,1,1
12911,6,1,45044,45044,45045,0,1,5
12912,3,2,45047,45047,45049,0,2,2
12913,3,2,45050,45050,45052,0,2,1
12914,6,2,45056,45056,45058,0,2,4
12915,1,3,45057,45058,45061,1,4,0
12916,3,2,45060,45061,45063,1,3,0
12917,5,3,45065,45065,45068,0,3,2
12918,4,3,45069,45069,45072,0,3,1
12919,6,2,45075,45075,45077,0,2,3
12920,3,2,45078,45078,45080,0,2,1
12921,1,3,45079,45080,45083,1,4,0
12922,1,3,45080,45083,45086,3,6,0
12923,5,2,45085,45086,45088,1,3,0
12924,6,1,45091,45091,45092,0,1,3
12925,2,2,45093,45093,45095,0,2,1
12926,3,3,45096,45096,45099,0,3,1
12927,3,1,45099,45099,45100,0,1,0
12928,3,2,45102,45102,45104,0,2,2
12929,6,1,45108,45108,45109,0,1,4
12930,3,3,45111,45111,45114,0,3,2
12931,1,2,45112,45114,45116,2,4,0
12932,6,3,45118,45118,45121,0,3,2
12933,3,2,45121,45121,45123,0,2,0
12934,2,2,45123,45123,45125,0,2,0
12935,6,2,45129,45129,45131,0,2,4
12936,5,1,45134,45134,45135,0,1,3
12937,3,3,45137,45137,45140,0,3,2
12938,2,3,45139,45140,45143,1,4,0
12939,6,1,45145,45145,45146,0,1,2
12940,1,2,45146,45146,45148,0,2,0
12941,4,2,45150,45150,45152,0,2,2
12942,2,1,45152,45152,45153,0,1,0
12943,6,2,45158,45158,45160,0,2,5
12944,2,1,45160,45160,45161,0,1,0
12945,4,1,45164,45164,45165,0,1,3
12946,2,3,45166,45166,45169,0,3,1
12947,1,2,45167,45169,45171,2,4,0
12948,2,3,45169,45171,45174,2,5,0
12949,3,1,45172,45174,45175,2,3,0
12950,3,3,45175,45175,45178,0,3,0
12951,4,3,45179,45179,45182,0,3,1
12952,6,1,45185,45185,45186,0,1,3
12953,2,1,45187,45187,45188,0,1,1
12954,4,3,45191,45191,45194,0,3,3
12955,2,1,45193,45194,45195,1,2,0
12956,6,3,45199,45199,45202,0,3,4
12957,4,3,45203,45203,45206,0,3,1
12958,1,3,45204,45206,45209,2,5,0
12959,5,3,45209,45209,45212,0,3,0
12960,1,2,45210,45212,45214,2,4,0
12961,3,2,45213,45214,45216,1,3,0
12962,4,3,45217,45217,45220,0,3,1
12963,6,3,45223,45223,45226,0,3,3
12964,3,3,45226,45226,45229,0,3,0
12965,2,2,45228,45229,45231,1,3,0
12966,2,2,45230,45231,45233,1,3,0
12967,5,1,45235,45235,45236,0,1,2
12968,3,1,45238,45238,45239,0,1,2
12969,1,2,45239,45239,45241,0,2,0
12970,2,1,45241,45241,45242,0,1,0
12971,1,2,45242,45242,45244,0,2,0
12972,4,3,45246,45246,45249,0,3,2
12973,4,3,45250,45250,45253,0,3,1
12974,1,3,45251,45253,45256,2,5,0
12975,4,2,45255,45256,45258,1,3,0
12976,4,1,45259,45259,45260,0,1,1
12977,5,1,45264,45264,45265,0,1,4
12978,6,3,45270,45270,45273,0,3,5
12979,5,3,45275,45275,45278,0,3,2
12980,6,1,45281,45281,45282,0,1,3
12981,1,3,45282,45282,45285,0,3,0
12982,4,1,45286,45286,45287,0,1,1
12983,3,2,45289,45289,45291,0,2,2
12984,1,1,45290,45291,45292,1,2,0
12985,4,2,45294,45294,45296,0,2,2
12986,1,3,45295,45296,45299,1,4,0
12987,5,3,45300,45300,45303,0,3,1
12988,2,2,45302,45303,45305,1,3,0
12989,5,1,45307,45307,45308,0,1,2
12990,5,2,45312,45312,45314,0,2,4
12991,5,1,45317,45317,45318,0,1,3
12992,1,2,45318,45318,45320,0,2,0
12993,2,1,45320,45320,45321,0,1,0
12994,3,1,45323,45323,45324,0,1,2
12995,3,1,45326,45326,45327,0,1,2
12996,2,3,45328,45328,45331,0,3,1
12997,1,1,45329,45331,45332,2,3,0
12998,4,1,45333,45333,45334,0,1,1
12999,3,3,45336,45336,45339,0,3,2
13000,5,3,45341,45341,45344,0,3,2
13001,1,2,45342,45344,45346,2,4,0
13002,3,2,45345,45346,45348,1,3,0
13003,2,1,45347,45348,45349,1,2,0
13004,2,1,45349,45349,45350,0,1,0
13005,4,2,45353,45353,45355,0,2,3
13006,1,2,45354,45355,45357,1,3,0
13007,5,2,45359,45359,45361,0,2,2
13008,6,3,45365,45365,45368,0,3,4
13009,1,2,45366,45368,45370,2,4,0
13010,2,2,45368,45370,45372,2,4,0
13011,4,1,45372,45372,45373,0,1,0
13012,1,3,45373,45373,45376,0,3,0
13013,3,3,45376,45376,45379,0,3,0
13014,4,3,45380,45380,45383,0,3,1
13015,6,3,45386,45386,45389,0,3,3
13016,5,1,45391,45391,45392,0,1,2
13017,1,3,45392,45392,45395,0,3,0
13018,4,2,45396,45396,45398,0,2,1
13019,4,3,45400,45400,45403,0,3,2
13020,1,2,45401,45403,45405,2,4,0
13021,5,2,45406,45406,45408,0,2,1
13022,5,2,45411,45411,45413,0,2,3
13023,4,3,45415,45415,45418,0,3,2
13024,6,3,45421,45421,45424,0,3,3
13025,5,2,45426,45426,45428,0,2,2
13026,1,1,45427,45428,45429,1,2,0
13027,1,1,45428,45429,45430,1,2,0
13028,1,3,45429,45430,45433,1,4,0
13029,5,2,45434,45434,45436,0,2,1
13030,3,2,45437,45437,45439,0,2,1
13031,6,2,45443,45443,45445,0,2,4
13032,4,3,45447,45447,45450,0,3,2
13033,5,1,45452,45452,45453,0,1,2
13034,2,3,45454,45454,45457,0,3,1
13035,2,3,45456,45457,45460,1,4,0
13036,4,1,45460,45460,45461,0,1,0
13037,6,2,45466,45466,45468,0,2,5
13038,2,1,45468,45468,45469,0,1,0
13039,6,3,45474,45474,45477,0,3,5
13040,6,1,45480,45480,45481,0,1,3
13041,3,3,45483,45483,45486,0,3,2
13042,2,2,45485,45486,45488,1,3,0
13043,4,1,45489,45489,45490,0,1,1
13044,4,2,45493,45493,45495,0,2,3
13045,6,3,45499,45499,45502,0,3,4
13046,6,1,45505,45505,45506,0,1,3
13047,1,2,45506,45506,45508,0,2,0
13048,4,3,45510,45510,45513,0,3,2
13049,3,1,45513,45513,45514,0,1,0
13050,6,2,45519,45519,45521,0,2,5
13051,5,3,45524,45524,45527,0,3,3
13052,6,3,45530,45530,45533,0,3,3
13053,3,2,45533,45533,45535,0,2,0
13054,3,2,45536,45536,45538,0,2,1
13055,5,1,45541,45541,45542,0,1,3
13056,1,2,45542,45542,45544,0,2,0
13057,1,2,45543,45544,45546,1,3,0
13058,3,3,45546,45546,45549,0,3,0
13059,4,1,45550,45550,45551,0,1,1
13060,5,1,45555,45555,45556,0,1,4
13061,4,3,45559,45559,45562,0,3,3
13062,6,3,45565,45565,45568,0,3,3
13063,6,2,45571,45571,45573,0,2,3
13064,3,2,45574,45574,45576,0,2,1
13065,1,3,45575,45576,45579,1,4,0
13066,2,2,45577,45579,45581,2,4,0
13067,2,1,45579,45581,45582,2,3,0
13068,2,2,45581,45582,45584,1,3,0
13069,2,3,45583,45584,45587,1,4,0
13070,1,3,45584,45587,45590,3,6,0
13071,4,2,45588,45590,45592,2,4,0
13072,5,3,45593,45593,45596,0,3,1
13073,1,2,45594,45596,45598,2,4,0
13074,2,1,45596,45598,45599,2,3,0
13075,1,2,45597,45599,45601,2,4,0
13076,5,1,45602,45602,45603,0,1,1
13077,5,3,45607,45607,45610,0,3,4
13078,5,1,45612,45612,45613,0,1,2
13079,5,3,45617,45617,45620,0,3,4
13080,2,1,45619,45620,45621,1,2,0
13081,5,2,45624,45624,45626,0,2,3
13082,3,3,45627,45627,45630,0,3,1
13083,3,1,45630,45630,45631,0,1,0
13084,1,1,45631,45631,45632,0,1,0
13085,4,3,45635,45635,45638,0,3,3
13086,4,3,45639,45639,45642,0,3,1
13087,1,2,45640,45642,45644,2,4,0
13088,3,3,45643,45644,45647,1,4,0
13089,1,3,45644,45647,45650,3,6,0
13090,5,1,45649,45650,45651,1,2,0
13091,1,3,45650,45651,45654,1,4,0
13092,6,2,45656,45656,45658,0,2,2
13093,1,2,45657,45658,45660,1,3,0
13094,1,1,45658,45660,45661,2,3,0
13095,1,3,45659,45661,45664,2,5,0
13096,1,1,45660,45664,45665,4,5,0
13097,3,2,45663,45665,45667,2,4,0
13098,1,3,45664,45667,45670,3,6,0
13099,6,3,45670,45670,45673,0,3,0
13100,5,3,45675,45675,45678,0,3,2
13101,1,2,45676,45678,45680,2,4,0
13102,6,3,45682,45682,45685,0,3,2
13103,4,2,45686,45686,45688,0,2,1
13104,2,1,45688,45688,45689,0,1,0
13105,3,3,45691,45691,45694,0,3,2
13106,1,2,45692,45694,45696,2,4,0
13107,1,3,45693,45696,45699,3,6,0
13108,5,2,45698,45699,45701,1,3,0
13109,1,2,45699,45701,45703,2,4,0
13110,5,1,45704,45704,45705,0,1,1
13111,2,1,45706,45706,45707,0,1,1
13112,2,3,45708,45708,45711,0,3,1
13113,1,1,45709,45711,45712,2,3,0
13114,2,2,45711,45712,45714,1,3,0
13115,2,2,45713,45714,45716,1,3,0
13116,5,2,45718,45718,45720,0,2,2
13117,6,1,45724,45724,45725,0,1,4
13118,4,1,45728,45728,45729,0,1,3
13119,4,3,45732,45732,45735,0,3,3
13120,6,3,45738,45738,45741,0,3,3
13121,3,1,45741,45741,45742,0,1,0
13122,1,2,45742,45742,45744,0,2,0
13123,5,2,45747,45747,45749,0,2,3
13124,4,1,45751,45751,45752,0,1,2
13125,4,3,45755,45755,45758,0,3,3
13126,4,1,45759,45759,45760,0,1,1
13127,1,3,45760,45760,45763,0,3,0
13128,6,1,45766,45766,45767,0,1,3
13129,5,1,45771,45771,45772,0,1,4
13130,1,1,45772,45772,45773,0,1,0
13131,4,2,45776,45776,45778,0,2,3
13132,5,1,45781,45781,45782,0,1,3
13133,4,3,45785,45785,45788,0,3,3
13134,4,3,45789,45789,45792,0,3,1
13135,6,2,45795,45795,45797,0,2,3
13136,5,3,45800,45800,45803,0,3,3
13137,2,1,45802,45803,45804,1,2,0
13138,5,3,45807,45807,45810,0,3,3
13139,4,2,45811,45811,45813,0,2,1
13140,5,3,45816,45816,45819,0,3,3
13141,1,1,45817,45819,45820,2,3,0
13142,5,2,45822,45822,45824,0,2,2
13143,3,2,45825,45825,45827,0,2,1
13144,5,3,45830,45830,45833,0,3,3
13145,3,3,45833,45833,45836,0,3,0
13146,4,2,45837,45837,45839,0,2,1
13147,4,1,45841,45841,45842,0,1,2
13148,3,3,45844,45844,45847,0,3,2
13149,5,1,45849,45849,45850,0,1,2
13150,6,1,45855,45855,45856,0,1,5
13151,4,2,45859,45859,45861,0,2,3
13152,2,2,45861,45861,45863,0,2,0
13153,2,1,45863,45863,45864,0,1,0
13154,4,1,45867,45867,45868,0,1,3
13155,6,3,45873,45873,45876,0,3,5
13156,1,3,45874,45876,45879,2,5,0
13157,2,1,45876,45879,45880,3,4,0
13158,5,3,45881,45881,45884,0,3,1
13159,5,3,45886,45886,45889,0,3,2
13160,6,2,45892,45892,45894,0,2,3
13161,1,1,45893,45894,45895,1,2,0
13162,3,3,45896,45896,45899,0,3,1
13163,5,1,45901,45901,45902,0,1,2
13164,1,2,45902,45902,45904,0,2,0
13165,5,1,45907,45907,45908,0,1,3
13166,5,2,45912,45912,45914,0,2,4
13167,1,3,45913,45914,45917,1,4,0
13168,1,2,45914,45917,45919,3,5,0
13169,1,1,45915,45919,45920,4,5,0
13170,6,2,45921,45921,45923,0,2,1
13171,3,3,45924,45924,45927,0,3,1
13172,6,1,45930,45930,45931,0,1,3
13173,4,2,45934,45934,45936,0,2,3
13174,6,3,45940,45940,45943,0,3,4
13175,2,1,45942,45943,45944,1,2,0
13176,2,3,45944,45944,45947,0,3,0
13177,2,1,45946,45947,45948,1,2,0
13178,2,3,45948,45948,45951,0,3,0
13179,1,1,45949,45951,45952,2,3,0
13180,5,2,45954,45954,45956,0,2,2
13181,4,2,45958,45958,45960,0,2,2
13182,5,1,45963,45963,45964,0,1,3
13183,6,1,45969,45969,45970,0,1,5
13184,3,1,45972,45972,45973,0,1,2
13185,1,1,45973,45973,45974,0,1,0
13186,4,3,45977,45977,45980,0,3,3
13187,2,2,45979,45980,45982,1,3,0
13188,4,3,45983,45983,45986,0,3,1
13189,6,1,45989,45989,45990,0,1,3
13190,1,1,45990,45990,45991,0,1,0
13191,4,3,45994,45994,45997,0,3,3
13192,4,3,45998,45998,46001,0,3,1
13193,5,1,46003,46003,46004,0,1,2
13194,5,2,46008,46008,46010,0,2,4
13195,5,1,46013,46013,46014,0,1,3
13196,6,1,46019,46019,46020,0,1,5
13197,6,2,46025,46025,46027,0,2,5
13198,6,1,46031,46031,46032,0,1,4
13199,5,2,46036,46036,46038,0,2,4
13200,3,2,46039,46039,46041,0,2,1
13201,1,1,46040,46041,46042,1,2,0
13202,5,2,46045,46045,46047,0,2,3
13203,4,1,46049,46049,46050,0,1,2
13204,5,1,46054,46054,46055,0,1,4
13205,6,3,46060,46060,46063,0,3,5
13206,3,1,46063,46063,46064,0,1,0
13207,1,3,46064,46064,46067,0,3,0
13208,1,2,46065,46067,46069,2,4,0
13209,5,1,46070,46070,46071,0,1,1
13210,1,2,46071,46071,46073,0,2,0
13211,4,2,46075,46075,46077,0,2,2
13212,3,2,46078,46078,46080,0,2,1
13213,4,1,46082,46082,46083,0,1,2
13214,5,1,46087,46087,46088,0,1,4
13215,3,3,46090,46090,46093,0,3,2
13216,4,1,46094,46094,46095,0,1,1
13217,1,1,46095,46095,46096,0,1,0
13218,3,1,46098,46098,46099,0,1,2
13219,2,2,46100,46100,46102,0,2,1
13220,5,1,46105,46105,46106,0,1,3
13221,5,1,46110,46110,46111,0,1,4
13222,2,3,46112,46112,46115,0,3,1
13223,3,1,46115,46115,46116,0,1,0
13224,6,1,46121,46121,46122,0,1,5
13225,6,1,46127,46127,46128,0,1,5
13226,1,3,46128,46128,46131,0,3,0
13227,4,1,46132,46132,46133,0,1,1
13228,3,1,46135,46135,46136,0,1,2
13229,4,3,46139,46139,46142,0,3,3
13230,2,2,46141,46142,46144,1,3,0
13231,5,1,46146,46146,46147,0,1,2
13232,3,3,46149,46149,46152,0,3,2
13233,4,3,46153,46153,46156,0,3,1
13234,1,2,46154,46156,46158,2,4,0
13235,5,2,46159,46159,46161,0,2,1
13236,5,3,46164,46164,46167,0,3,3
13237,4,3,46168,46168,46171,0,3,1
13238,2,3,46170,46171,46174,1,4,0
13239,6,3,46176,46176,46179,0,3,2
13240,1,3,46177,46179,46182,2,5,0
13241,1,2,46178,46182,46184,4,6,0
13242,1,1,46179,46184,46185,5,6,0
13243,6,1,46185,46185,46186,0,1,0
13244,6,2,46191,46191,46193,0,2,5
13245,2,1,46193,46193,46194,0,1,0
13246,5,2,46198,46198,46200,0,2,4
13247,2,1,46200,46200,46201,0,1,0
13248,2,2,46202,46202,46204,0,2,1
13249,4,2,46206,46206,46208,0,2,2
13250,4,2,46210,46210,46212,0,2,2
13251,1,3,46211,46212,46215,1,4,0
13252,6,3,46217,46217,46220,0,3,2
13253,4,3,46221,46221,46224,0,3,1
13254,6,1,46227,46227,46228,0,1,3
13255,6,2,46233,46233,46235,0,2,5
13256,2,1,46235,46235,46236,0,1,0
13257,2,3,46237,46237,46240,0,3,1
13258,6,3,46243,46243,46246,0,3,3
13259,2,1,46245,46246,46247,1,2,0
13260,3,2,46248,46248,46250,0,2,1
13261,1,2,46249,46250,46252,1,3,0
13262,2,2,46251,46252,46254,1,3,0
13263,5,3,46256,46256,46259,0,3,2
13264,3,1,46259,46259,46260,0,1,0
13265,5,1,46264,46264,46265,0,1,4
13266,5,3,46269,46269,46272,0,3,4
13267,4,1,46273,46273,46274,0,1,1
13268,6,1,46279,46279,46280,0,1,5
13269,3,1,46282,46282,46283,0,1,2
13270,5,2,46287,46287,46289,0,2,4
13271,5,1,46292,46292,46293,0,1,3
13272,5,1,46297,46297,46298,0,1,4
13273,4,3,46301,46301,46304,0,3,3
13274,5,2,46306,46306,46308,0,2,2
13275,4,1,46310,46310,46311,0,1,2
13276,4,2,46314,46314,46316,0,2,3
13277,5,2,46319,46319,46321,0,2,3
13278,2,2,46321,46321,46323,0,2,0
13279,5,2,46326,46326,46328,0,2,3
13280,4,1,46330,46330,46331,0,1,2
13281,2,2,46332,46332,46334,0,2,1
13282,1,3,46333,46334,46337,1,4,0
13283,6,2,46339,46339,46341,0,2,2
13284,3,1,46342,46342,46343,0,1,1
13285,5,3,46347,46347,46350,0,3,4
13286,3,3,46350,46350,46353,0,3,0
13287,5,2,46355,46355,46357,0,2,2
13288,6,3,46361,46361,46364,0,3,4
13289,1,3,46362,46364,46367,2,5,0
13290,4,1,46366,46367,46368,1,2,0
13291,4,1,46370,46370,46371,0,1,2
13292,4,3,46374,46374,46377,0,3,3
13293,1,1,46375,46377,46378,2,3,0
13294,3,1,46378,46378,46379,0,1,0
13295,6,1,46384,46384,46385,0,1,5
13296,5,1,46389,46389,46390,0,1,4
13297,2,3,46391,46391,46394,0,3,1
13298,2,3,46393,46394,46397,1,4,0
13299,2,3,46395,46397,46400,2,5,0
13300,4,3,46399,46400,46403,1,4,0
13301,1,3,46400,46403,46406,3,6,0
13302,2,2,46402,46406,46408,4,6,0
13303,6,1,46408,46408,46409,0,1,0
13304,1,2,46409,46409,46411,0,2,0
13305,6,2,46415,46415,46417,0,2,4
13306,3,1,46418,46418,46419,0,1,1
13307,3,1,46421,46421,46422,0,1,2
13308,1,3,46422,46422,46425,0,3,0
13309,2,2,46424,46425,46427,1,3,0
13310,4,1,46428,46428,46429,0,1,1
13311,3,3,46431,46431,46434,0,3,2
13312,6,1,46437,46437,46438,0,1,3
13313,3,2,46440,46440,46442,0,2,2
13314,1,1,46441,46442,46443,1,2,0
13315,5,3,46446,46446,46449,0,3,3
13316,6,3,46452,46452,46455,0,3,3
13317,1,1,46453,46455,46456,2,3,0
13318,4,2,46457,46457,46459,0,2,1
13319,2,3,46459,46459,46462,0,3,0
13320,1,2,46460,46462,46464,2,4,0
13321,6,2,46466,46466,46468,0,2,2
13322,3,2,46469,46469,46471,0,2,1
13323,1,1,46470,46471,46472,1,2,0
13324,1,1,46471,46472,46473,1,2,0
13325,4,3,46475,46475,46478,0,3,2
13326,4,2,46479,46479,46481,0,2,1
13327,2,2,46481,46481,46483,0,2,0
13328,5,1,46486,46486,46487,0,1,3
13329,1,1,46487,46487,46488,0,1,0
13330,6,1,46493,46493,46494,0,1,5
13331,5,1,46498,46498,46499,0,1,4
13332,6,1,46504,46504,46505,0,1,5
13333,2,2,46506,46506,46508,0,2,1
13334,2,1,46508,46508,46509,0,1,0
13335,5,2,46513,46513,46515,0,2,4
13336,2,3,46515,46515,46518,0,3,0
13337,6,3,46521,46521,46524,0,3,3
13338,4,3,46525,46525,46528,0,3,1
13339,6,1,46531,46531,46532,0,1,3
13340,6,2,46537,46537,46539,0,2,5
13341,2,1,46539,46539,46540,0,1,0
13342,5,1,46544,46544,46545,0,1,4
13343,6,1,46550,46550,46551,0,1,5
13344,5,3,46555,46555,46558,0,3,4
13345,4,3,46559,46559,46562,0,3,1
13346,3,1,46562,46562,46563,0,1,0
13347,5,3,46567,46567,46570,0,3,4
13348,5,1,46572,46572,46573,0,1,2
13349,2,1,46574,46574,46575,0,1,1
13350,6,1,46580,46580,46581,0,1,5
13351,1,1,46581,46581,46582,0,1,0
13352,1,2,46582,46582,46584,0,2,0
13353,6,3,46588,46588,46591,0,3,4
13354,1,2,46589,46591,46593,2,4,0
13355,3,2,46592,46593,46595,1,3,0
13356,4,2,46596,46596,46598,0,2,1
13357,5,3,46601,46601,46604,0,3,3
13358,4,3,46605,46605,46608,0,3,1
13359,6,2,46611,46611,46613,0,2,3
13360,5,2,46616,46616,46618,0,2,3
13361,5,2,46621,46621,46623,0,2,3
13362,3,1,46624,46624,46625,0,1,1
13363,6,1,46630,46630,46631,0,1,5
13364,6,3,46636,46636,46639,0,3,5
13365,3,2,46639,46639,46641,0,2,0
13366,4,3,46643,46643,46646,0,3,2
13367,6,2,46649,46649,46651,0,2,3
13368,6,3,46655,46655,46658,0,3,4
13369,2,2,46657,46658,46660,1,3,0
13370,1,1,46658,46660,46661,2,3,0
13371,4,1,46662,46662,46663,0,1,1
13372,2,1,46664,46664,46665,0,1,1
13373,1,1,46665,46665,46666,0,1,0
13374,6,1,46671,46671,46672,0,1,5
13375,6,3,46677,46677,46680,0,3,5
13376,4,1,46681,46681,46682,0,1,1
13377,1,2,46682,46682,46684,0,2,0
13378,2,3,46684,46684,46687,0,3,0
13379,1,3,46685,46687,46690,2,5,0
13380,2,2,46687,46690,46692,3,5,0
13381,6,2,46693,46693,46695,0,2,1
13382,5,1,46698,46698,46699,0,1,3
13383,6,2,46704,46704,46706,0,2,5
13384,5,3,46709,46709,46712,0,3,3
13385,3,3,46712,46712,46715,0,3,0
13386,5,3,46717,46717,46720,0,3,2
13387,6,1,46723,46723,46724,0,1,3
13388,5,1,46728,46728,46729,0,1,4
13389,5,3,46733,46733,46736,0,3,4
13390,4,2,46737,46737,46739,0,2,1
13391,1,2,46738,46739,46741,1,3,0
13392,5,3,46743,46743,46746,0,3,2
13393,4,3,46747,46747,46750,0,3,1
13394,4,3,46751,46751,46754,0,3,1
13395,2,3,46753,46754,46757,1,4,0
13396,1,3,46754,46757,46760,3,6,0
13397,4,1,46758,46760,46761,2,3,0
13398,2,3,46760,46761,46764,1,4,0
13399,4,2,46764,46764,46766,0,2,0
13400,1,3,46765,46766,46769,1,4,0
13401,3,1,46768,46769,46770,1,2,0
13402,4,3,46772,46772,46775,0,3,2
13403,6,2,46778,46778,46780,0,2,3
13404,1,3,46779,46780,46783,1,4,0
13405,1,1,46780,46783,46784,3,4,0
13406,6,1,46786,46786,46787,0,1,2
13407,4,3,46790,46790,46793,0,3,3
13408,6,3,46796,46796,46799,0,3,3
13409,5,3,46801,46801,46804,0,3,2
13410,1,3,46802,46804,46807,2,5,0
13411,4,3,46806,46807,46810,1,4,0
13412,4,2,46810,46810,46812,0,2,0
13413,4,3,46814,46814,46817,0,3,2
13414,2,2,46816,46817,46819,1,3,0
13415,5,1,46821,46821,46822,0,1,2
13416,2,1,46823,46823,46824,0,1,1
13417,3,2,46826,46826,46828,0,2,2
13418,1,2,46827,46828,46830,1,3,0
13419,4,2,46831,46831,46833,0,2,1
13420,5,2,46836,46836,46838,0,2,3
13421,6,1,46842,46842,46843,0,1,4
13422,3,1,46845,46845,46846,0,1,2
13423,6,1,46851,46851,46852,0,1,5
13424,3,2,46854,46854,46856,0,2,2
13425,4,2,46858,46858,46860,0,2,2
13426,4,3,46862,46862,46865,0,3,2
13427,4,2,46866,46866,46868,0,2,1
13428,2,3,46868,46868,46871,0,3,0
13429,2,1,46870,46871,46872,1,2,0
13430,6,1,46876,46876,46877,0,1,4
13431,5,3,46881,46881,46884,0,3,4
13432,6,2,46887,46887,46889,0,2,3
13433,3,1,46890,46890,46891,0,1,1
13434,2,2,46892,46892,46894,0,2,1
13435,2,2,46894,46894,46896,0,2,0
13436,6,1,46900,46900,46901,0,1,4
13437,2,1,46902,46902,46903,0,1,1
13438,6,1,46908,46908,46909,0,1,5
13439,2,2,46910,46910,46912,0,2,1
13440,2,1,46912,46912,46913,0,1,0
13441,1,3,46913,46913,46916,0,3,0
13442,5,1,46918,46918,46919,0,1,2
13443,2,1,46920,46920,46921,0,1,1
13444,2,3,46922,46922,46925,0,3,1
13445,3,3,46925,46925,46928,0,3,0
13446,3,1,46928,46928,46929,0,1,0
13447,5,3,46933,46933,46936,0,3,4
13448,4,1,46937,46937,46938,0,1,1
13449,4,2,46941,46941,46943,0,2,3
13450,4,1,46945,46945,46946,0,1,2
13451,2,3,46947,46947,46950,0,3,1
13452,3,3,46950,46950,46953,0,3,0
13453,6,1,46956,46956,46957,0,1,3
13454,4,3,46960,46960,46963,0,3,3
13455,6,1,46966,46966,46967,0,1,3
13456,3,1,46969,46969,46970,0,1,2
13457,5,2,46974,46974,46976,0,2,4
13458,6,1,46980,46980,46981,0,1,4
13459,1,1,46981,46981,46982,0,1,0
13460,2,3,46983,46983,46986,0,3,1
13461,6,2,46989,46989,46991,0,2,3
13462,4,1,46993,46993,46994,0,1,2
13463,2,1,46995,46995,46996,0,1,1
13464,5,1,47000,47000,47001,0,1,4
13465,1,2,47001,47001,47003,0,2,0
13466,4,2,47005,47005,47007,0,2,2
13467,1,3,47006,47007,47010,1,4,0
13468,1,1,47007,47010,47011,3,4,0
13469,6,2,47013,47013,47015,0,2,2
13470,6,1,47019,47019,47020,0,1,4
13471,4,2,47023,47023,47025,0,2,3
13472,3,3,47026,47026,47029,0,3,1
13473,3,1,47029,47029,47030,0,1,0
13474,2,3,47031,47031,47034,0,3,1
13475,2,2,47033,47034,47036,1,3,0
13476,6,3,47039,47039,47042,0,3,3
13477,5,1,47044,47044,47045,0,1,2
13478,2,2,47046,47046,47048,0,2,1
13479,2,1,47048,47048,47049,0,1,0
13480,5,2,47053,47053,47055,0,2,4
13481,2,2,47055,47055,47057,0,2,0
13482,3,1,47058,47058,47059,0,1,1
13483,3,1,47061,47061,47062,0,1,2
13484,1,1,47062,47062,47063,0,1,0
13485,4,1,47066,47066,47067,0,1,3
13486,2,1,47068,47068,47069,0,1,1
13487,6,3,47074,47074,47077,0,3,5
13488,4,3,47078,47078,47081,0,3,1
13489,6,3,47084,47084,47087,0,3,3
13490,2,3,47086,47087,47090,1,4,0
13491,1,3,47087,47090,47093,3,6,0
13492,1,2,47088,47093,47095,5,7,0
13493,1,2,47089,47095,47097,6,8,0
13494,6,1,47095,47097,47098,2,3,0
13495,2,2,47097,47098,47100,1,3,0
13496,2,3,47099,47100,47103,1,4,0
13497,1,2,47100,47103,47105,3,5,0
13498,1,2,47101,47105,47107,4,6,0
13499,1,2,47102,47107,47109,5,7,0
13500,6,3,47108,47109,47112,1,4,0
13501,4,3,47112,47112,47115,0,3,0
13502,4,2,47116,47116,47118,0,2,1
13503,4,2,47120,47120,47122,0,2,2
13504,3,2,47123,47123,47125,0,2,1
13505,1,2,47124,47125,47127,1,3,0
13506,5,2,47129,47129,47131,0,2,2
13507,4,2,47133,47133,47135,0,2,2
13508,6,2,47139,47139,47141,0,2,4
13509,3,3,47142,47142,47145,0,3,1
13510,3,3,47145,47145,47148,0,3,0
13511,5,2,47150,47150,47152,0,2,2
13512,6,1,47156,47156,47157,0,1,4
13513,2,2,47158,47158,47160,0,2,1
13514,3,1,47161,47161,47162,0,1,1
13515,4,2,47165,47165,47167,0,2,3
13516,3,2,47168,47168,47170,0,2,1
13517,3,3,47171,47171,47174,0,3,1
13518,3,3,47174,47174,47177,0,3,0
13519,6,1,47180,47180,47181,0,1,3
13520,2,2,47182,47182,47184,0,2,1
13521,5,3,47187,47187,47190,0,3,3
13522,4,3,47191,47191,47194,0,3,1
13523,6,1,47197,47197,47198,0,1,3
13524,4,1,47201,47201,47202,0,1,3
13525,2,3,47203,47203,47206,0,3,1
13526,6,1,47209,47209,47210,0,1,3
13527,2,2,47211,47211,47213,0,2,1
13528,3,2,47214,47214,47216,0,2,1
13529,4,1,47218,47218,47219,0,1,2
13530,2,1,47220,47220,47221,0,1,1
13531,3,3,47223,47223,47226,0,3,2
13532,6,3,47229,47229,47232,0,3,3
13533,2,2,47231,47232,47234,1,3,0
13534,5,1,47236,47236,47237,0,1,2
13535,3,3,47239,47239,47242,0,3,2
13536,4,3,47243,47243,47246,0,3,1
13537,1,2,47244,47246,47248,2,4,0
13538,2,3,47246,47248,47251,2,5,0
13539,6,2,47252,47252,47254,0,2,1
13540,1,2,47253,47254,47256,1,3,0
13541,3,2,47256,47256,47258,0,2,0
13542,5,3,47261,47261,47264,0,3,3
13543,6,3,47267,47267,47270,0,3,3
13544,3,2,47270,47270,47272,0,2,0
13545,2,1,47272,47272,47273,0,1,0
13546,3,3,47275,47275,47278,0,3,2
13547,3,3,47278,47278,47281,0,3,0
13548,3,2,47281,47281,47283,0,2,0
13549,3,2,47284,47284,47286,0,2,1
13550,5,3,47289,47289,47292,0,3,3
13551,2,3,47291,47292,47295,1,4,0
13552,4,1,47295,47295,47296,0,1,0
13553,6,3,47301,47301,47304,0,3,5
13554,3,1,47304,47304,47305,0,1,0
13555,6,2,47310,47310,47312,0,2,5
13556,3,3,47313,47313,47316,0,3,1
13557,5,3,47318,47318,47321,0,3,2
13558,4,2,47322,47322,47324,0,2,1
13559,4,1,47326,47326,47327,0,1,2
13560,4,3,47330,47330,47333,0,3,3
13561,1,1,47331,47333,47334,2,3,0
13562,5,2,47336,47336,47338,0,2,2
13563,6,1,47342,47342,47343,0,1,4
13564,2,2,47344,47344,47346,0,2,1
13565,6,2,47350,47350,47352,0,2,4
13566,6,3,47356,47356,47359,0,3,4
13567,4,1,47360,47360,47361,0,1,1
13568,3,3,47363,47363,47366,0,3,2
13569,1,1,47364,47366,47367,2,3,0
13570,3,2,47367,47367,47369,0,2,0
13571,4,1,47371,47371,47372,0,1,2
13572,5,1,47376,47376,47377,0,1,4
13573,5,3,47381,47381,47384,0,3,4
13574,5,3,47386,47386,47389,0,3,2
13575,3,1,47389,47389,47390,0,1,0
13576,6,2,47395,47395,47397,0,2,5
13577,3,2,47398,47398,47400,0,2,1
13578,1,1,47399,47400,47401,1,2,0
13579,4,2,47403,47403,47405,0,2,2
13580,3,2,47406,47406,47408,0,2,1
13581,2,2,47408,47408,47410,0,2,0
13582,3,1,47411,47411,47412,0,1,1
13583,6,1,47417,47417,47418,0,1,5
13584,6,1,47423,47423,47424,0,1,5
13585,3,1,47426,47426,47427,0,1,2
13586,5,3,47431,47431,47434,0,3,4
13587,3,1,47434,47434,47435,0,1,0
13588,6,1,47440,47440,47441,0,1,5
13589,6,2,47446,47446,47448,0,2,5
13590,1,2,47447,47448,47450,1,3,0
13591,4,2,47451,47451,47453,0,2,1
13592,6,2,47457,47457,47459,0,2,4
13593,2,3,47459,47459,47462,0,3,0
13594,3,3,47462,47462,47465,0,3,0
13595,2,1,47464,47465,47466,1,2,0
13596,4,2,47468,47468,47470,0,2,2
13597,5,1,47473,47473,47474,0,1,3
13598,1,1,47474,47474,47475,0,1,0
13599,5,1,47479,47479,47480,0,1,4
13600,5,1,47484,47484,47485,0,1,4
13601,4,1,47488,47488,47489,0,1,3
13602,1,1,47489,47489,47490,0,1,0
13603,1,1,47490,47490,47491,0,1,0
13604,2,3,47492,47492,47495,0,3,1
13605,4,3,47496,47496,47499,0,3,1
13606,5,3,47501,47501,47504,0,3,2
13607,5,1,47506,47506,47507,0,1,2
13608,1,1,47507,47507,47508,0,1,0
13609,2,2,47509,47509,47511,0,2,1
13610,3,1,47512,47512,47513,0,1,1
13611,3,3,47515,47515,47518,0,3,2
13612,5,1,47520,47520,47521,0,1,2
13613,3,3,47523,47523,47526,0,3,2
13614,4,3,47527,47527,47530,0,3,1
13615,2,3,47529,47530,47533,1,4,0
13616,4,2,47533,47533,47535,0,2,0
13617,5,2,47538,47538,47540,0,2,3
13618,3,1,47541,47541,47542,0,1,1
13619,3,1,47544,47544,47545,0,1,2
13620,3,3,47547,47547,47550,0,3,2
13621,6,1,47553,47553,47554,0,1,3
13622,3,2,47556,47556,47558,0,2,2
13623,6,3,47562,47562,47565,0,3,4
13624,3,2,47565,47565,47567,0,2,0
13625,5,3,47570,47570,47573,0,3,3
13626,2,2,47572,47573,47575,1,3,0
13627,1,3,47573,47575,47578,2,5,0
13628,6,1,47579,47579,47580,0,1,1
13629,5,2,47584,47584,47586,0,2,4
13630,1,3,47585,47586,47589,1,4,0
13631,1,1,47586,47589,47590,3,4,0
13632,1,3,47587,47590,47593,3,6,0
13633,5,1,47592,47593,47594,1,2,0
13634,2,2,47594,47594,47596,0,2,0
13635,3,1,47597,47597,47598,0,1,1
13636,6,1,47603,47603,47604,0,1,5
13637,5,1,47608,47608,47609,0,1,4
13638,4,3,47612,47612,47615,0,3,3
13639,1,3,47613,47615,47618,2,5,0
13640,6,1,47619,47619,47620,0,1,1
13641,3,1,47622,47622,47623,0,1,2
13642,3,3,47625,47625,47628,0,3,2
13643,5,1,47630,47630,47631,0,1,2
13644,2,2,47632,47632,47634,0,2,1
13645,3,2,47635,47635,47637,0,2,1
13646,1,2,47636,47637,47639,1,3,0
13647,1,1,47637,47639,47640,2,3,0
13648,3,1,47640,47640,47641,0,1,0
13649,6,3,47646,47646,47649,0,3,5
13650,6,2,47652,47652,47654,0,2,3
13651,6,3,47658,47658,47661,0,3,4
13652,3,2,47661,47661,47663,0,2,0
13653,6,3,47667,47667,47670,0,3,4
13654,2,1,47669,47670,47671,1,2,0
13655,5,3,47674,47674,47677,0,3,3
13656,6,1,47680,47680,47681,0,1,3
13657,6,2,47686,47686,47688,0,2,5
13658,4,3,47690,47690,47693,0,3,2
13659,1,1,47691,47693,47694,2,3,0
13660,5,2,47696,47696,47698,0,2,2
13661,4,1,47700,47700,47701,0,1,2
13662,3,1,47703,47703,47704,0,1,2
13663,4,2,47707,47707,47709,0,2,3
13664,5,3,47712,47712,47715,0,3,3
13665,4,2,47716,47716,47718,0,2,1
13666,5,1,47721,47721,47722,0,1,3
13667,6,1,47727,47727,47728,0,1,5
13668,5,1,47732,47732,47733,0,1,4
13669,2,2,47734,47734,47736,0,2,1
13670,5,1,47739,47739,47740,0,1,3
13671,5,1,47744,47744,47745,0,1,4
13672,1,2,47745,47745,47747,0,2,0
13673,2,2,47747,47747,47749,0,2,0
13674,4,1,47751,47751,47752,0,1,2
13675,1,3,47752,47752,47755,0,3,0
13676,2,1,47754,47755,47756,1,2,0
13677,6,1,47760,47760,47761,0,1,4
13678,4,3,47764,47764,47767,0,3,3
13679,1,3,47765,47767,47770,2,5,0
13680,3,1,47768,47770,47771,2,3,0
13681,5,3,47773,47773,47776,0,3,2
13682,5,3,47778,47778,47781,0,3,2
13683,6,1,47784,47784,47785,0,1,3
13684,1,3,47785,47785,47788,0,3,0
13685,3,1,47788,47788,47789,0,1,0
13686,1,3,47789,47789,47792,0,3,0
13687,3,1,47792,47792,47793,0,1,0
13688,3,1,47795,47795,47796,0,1,2
13689,5,1,47800,47800,47801,0,1,4
13690,1,3,47801,47801,47804,0,3,0
13691,6,1,47807,47807,47808,0,1,3
13692,4,3,47811,47811,47814,0,3,3
13693,1,2,47812,47814,47816,2,4,0
13694,5,2,47817,47817,47819,0,2,1
13695,4,3,47821,47821,47824,0,3,2
13696,1,1,47822,47824,47825,2,3,0
13697,1,1,47823,47825,47826,2,3,0
13698,6,3,47829,47829,47832,0,3,3
13699,3,1,47832,47832,47833,0,1,0
13700,2,3,47834,47834,47837,0,3,1
13701,1,3,47835,47837,47840,2,5,0
13702,5,3,47840,47840,47843,0,3,0
13703,3,3,47843,47843,47846,0,3,0
13704,2,3,47845,47846,47849,1,4,0
13705,5,1,47850,47850,47851,0,1,1
13706,1,1,47851,47851,47852,0,1,0
13707,4,3,47855,47855,47858,0,3,3
13708,3,2,47858,47858,47860,0,2,0
13709,6,2,47864,47864,47866,0,2,4
13710,1,3,47865,47866,47869,1,4,0
13711,3,1,47868,47869,47870,1,2,0
13712,2,3,47870,47870,47873,0,3,0
13713,1,2,47871,47873,47875,2,4,0
13714,3,3,47874,47875,47878,1,4,0
13715,5,2,47879,47879,47881,0,2,1
13716,2,3,47881,47881,47884,0,3,0
13717,3,1,47884,47884,47885,0,1,0
13718,5,2,47889,47889,47891,0,2,4
13719,5,3,47894,47894,47897,0,3,3
13720,5,1,47899,47899,47900,0,1,2
13721,3,3,47902,47902,47905,0,3,2
13722,6,3,47908,47908,47911,0,3,3
13723,6,1,47914,47914,47915,0,1,3
13724,2,3,47916,47916,47919,0,3,1
13725,6,2,47922,47922,47924,0,2,3
13726,1,1,47923,47924,47925,1,2,0
13727,5,1,47928,47928,47929,0,1,3
13728,1,1,47929,47929,47930,0,1,0
13729,6,2,47935,47935,47937,0,2,5
13730,6,3,47941,47941,47944,0,3,4
13731,6,1,47947,47947,47948,0,1,3
13732,3,2,47950,47950,47952,0,2,2
13733,1,3,47951,47952,47955,1,4,0
13734,3,1,47954,47955,47956,1,2,0
13735,5,3,47959,47959,47962,0,3,3
13736,4,2,47963,47963,47965,0,2,1
13737,1,1,47964,47965,47966,1,2,0
13738,2,1,47966,47966,47967,0,1,0
13739,5,2,47971,47971,47973,0,2,4
13740,6,3,47977,47977,47980,0,3,4
13741,2,2,47979,47980,47982,1,3,0
13742,5,2,47984,47984,47986,0,2,2
13743,5,3,47989,47989,47992,0,3,3
13744,6,1,47995,47995,47996,0,1,3
13745,1,3,47996,47996,47999,0,3,0
13746,5,1,48001,48001,48002,0,1,2
13747,1,2,48002,48002,48004,0,2,0
13748,4,1,48006,48006,48007,0,1,2
13749,3,2,48009,48009,48011,0,2,2
13750,6,3,48015,48015,48018,0,3,4
13751,5,1,48020,48020,48021,0,1,2
13752,6,2,48026,48026,48028,0,2,5
13753,3,2,48029,48029,48031,0,2,1
13754,2,1,48031,48031,48032,0,1,0
13755,2,2,48033,48033,48035,0,2,1
13756,1,3,48034,48035,48038,1,4,0
13757,5,1,48039,48039,48040,0,1,1
13758,4,2,48043,48043,48045,0,2,3
13759,5,1,48048,48048,48049,0,1,3
13760,5,3,48053,48053,48056,0,3,4
13761,5,3,48058,48058,48061,0,3,2
13762,5,1,48063,48063,48064,0,1,2
13763,1,2,48064,48064,48066,0,2,0
13764,4,3,48068,48068,48071,0,3,2
13765,2,3,48070,48071,48074,1,4,0
13766,1,3,48071,48074,48077,3,6,0
13767,5,1,48076,48077,48078,1,2,0
13768,4,2,48080,48080,48082,0,2,2
13769,5,1,48085,48085,48086,0,1,3
13770,1,2,48086,48086,48088,0,2,0
13771,5,2,48091,48091,48093,0,2,3
13772,6,1,48097,48097,48098,0,1,4
13773,3,1,48100,48100,48101,0,1,2
13774,1,2,48101,48101,48103,0,2,0
13775,6,1,48107,48107,48108,0,1,4
13776,3,3,48110,48110,48113,0,3,2
13777,6,1,48116,48116,48117,0,1,3
13778,6,3,48122,48122,48125,0,3,5
13779,6,2,48128,48128,48130,0,2,3
13780,2,1,48130,48130,48131,0,1,0
13781,1,2,48131,48131,48133,0,2,0
13782,2,3,48133,48133,48136,0,3,0
13783,1,3,48134,48136,48139,2,5,0
13784,1,2,48135,48139,48141,4,6,0
13785,5,3,48140,48141,48144,1,4,0
13786,4,2,48144,48144,48146,0,2,0
13787,4,2,48148,48148,48150,0,2,2
13788,6,2,48154,48154,48156,0,2,4
13789,2,3,48156,48156,48159,0,3,0
13790,4,1,48160,48160,48161,0,1,1
13791,5,2,48165,48165,48167,0,2,4
13792,1,3,48166,48167,48170,1,4,0
13793,3,2,48169,48170,48172,1,3,0
13794,6,3,48175,48175,48178,0,3,3
13795,4,2,48179,48179,48181,0,2,1
13796,5,1,48184,48184,48185,0,1,3
13797,4,3,48188,48188,48191,0,3,3
13798,6,3,48194,48194,48197,0,3,3
13799,4,2,48198,48198,48200,0,2,1
13800,5,3,48203,48203,48206,0,3,3
13801,1,2,48204,48206,48208,2,4,0
13802,5,2,48209,48209,48211,0,2,1
13803,5,3,48214,48214,48217,0,3,3
13804,4,3,48218,48218,48221,0,3,1
13805,3,2,48221,48221,48223,0,2,0
13806,2,3,48223,48223,48226,0,3,0
13807,4,1,48227,48227,48228,0,1,1
13808,4,1,48231,48231,48232,0,1,3
13809,2,2,48233,48233,48235,0,2,1
13810,3,1,48236,48236,48237,0,1,1
13811,3,3,48239,48239,48242,0,3,2
13812,5,3,48244,48244,48247,0,3,2
13813,3,3,48247,48247,48250,0,3,0
13814,6,3,48253,48253,48256,0,3,3
13815,6,2,48259,48259,48261,0,2,3
13816,1,2,48260,48261,48263,1,3,0
13817,1,1,48261,48263,48264,2,3,0
13818,1,3,48262,48264,48267,2,5,0
13819,3,1,48265,48267,48268,2,3,0
13820,6,1,48271,48271,48272,0,1,3
13821,5,1,48276,48276,48277,0,1,4
13822,4,1,48280,48280,48281,0,1,3
13823,6,2,48286,48286,48288,0,2,5
13824,4,2,48290,48290,48292,0,2,2
13825,5,3,48295,48295,48298,0,3,3
13826,3,1,48298,48298,48299,0,1,0
13827,3,3,48301,48301,48304,0,3,2
13828,3,2,48304,48304,48306,0,2,0
13829,5,3,48309,48309,48312,0,3,3
13830,6,1,48315,48315,48316,0,1,3
13831,1,3,48316,48316,48319,0,3,0
13832,5,2,48321,48321,48323,0,2,2
13833,1,1,48322,48323,48324,1,2,0
13834,6,2,48328,48328,48330,0,2,4
13835,4,1,48332,48332,48333,0,1,2
13836,3,1,48335,48335,48336,0,1,2
13837,5,2,48340,48340,48342,0,2,4
13838,2,1,48342,48342,48343,0,1,0
13839,1,2,48343,48343,48345,0,2,0
13840,1,1,48344,48345,48346,1,2,0
13841,6,1,48350,48350,48351,0,1,4
13842,3,3,48353,48353,48356,0,3,2
13843,3,1,48356,48356,48357,0,1,0
13844,6,1,48362,48362,48363,0,1,5
13845,5,1,48367,48367,48368,0,1,4
13846,2,1,48369,48369,48370,0,1,1
13847,2,1,48371,48371,48372,0,1,1
13848,3,1,48374,48374,48375,0,1,2
13849,6,2,48380,48380,48382,0,2,5
13850,4,1,48384,48384,48385,0,1,2
13851,3,2,48387,48387,48389,0,2,2
13852,1,3,48388,48389,48392,1,4,0
13853,6,3,48394,48394,48397,0,3,2
13854,6,3,48400,48400,48403,0,3,3
13855,6,2,48406,48406,48408,0,2,3
13856,5,1,48411,48411,48412,0,1,3
13857,4,2,48415,48415,48417,0,2,3
13858,5,2,48420,48420,48422,0,2,3
13859,1,1,48421,48422,48423,1,2,0
13860,4,3,48425,48425,48428,0,3,2
13861,3,1,48428,48428,48429,0,1,0
13862,1,3,48429,48429,48432,0,3,0
13863,6,2,48435,48435,48437,0,2,3
13864,5,3,48440,48440,48443,0,3,3
13865,2,2,48442,48443,48445,1,3,0
13866,1,1,48443,48445,48446,2,3,0
13867,5,2,48448,48448,48450,0,2,2
13868,3,1,48451,48451,48452,0,1,1
13869,5,3,48456,48456,48459,0,3,4
13870,5,1,48461,48461,48462,0,1,2
13871,2,1,48463,48463,48464,0,1,1
13872,5,3,48468,48468,48471,0,3,4
13873,4,3,48472,48472,48475,0,3,1
13874,3,2,48475,48475,48477,0,2,0
13875,2,2,48477,48477,48479,0,2,0
13876,3,1,48480,48480,48481,0,1,1
13877,5,2,48485,48485,48487,0,2,4
13878,4,3,48489,48489,48492,0,3,2
13879,5,1,48494,48494,48495,0,1,2
13880,6,3,48500,48500,48503,0,3,5
13881,5,1,48505,48505,48506,0,1,2
13882,4,3,48509,48509,48512,0,3,3
13883,6,1,48515,48515,48516,0,1,3
13884,5,2,48520,48520,48522,0,2,4
13885,1,1,48521,48522,48523,1,2,0
13886,6,3,48527,48527,48530,0,3,4
13887,4,1,48531,48531,48532,0,1,1
13888,1,2,48532,48532,48534,0,2,0
13889,4,2,48536,48536,48538,0,2,2
13890,1,1,48537,48538,48539,1,2,0
13891,5,2,48542,48542,48544,0,2,3
13892,1,2,48543,48544,48546,1,3,0
13893,4,1,48547,48547,48548,0,1,1
13894,6,3,48553,48553,48556,0,3,5
13895,2,3,48555,48556,48559,1,4,0
13896,2,3,48557,48559,48562,2,5,0
13897,4,1,48561,48562,48563,1,2,0
13898,4,3,48565,48565,48568,0,3,2
13899,4,1,48569,48569,48570,0,1,1
13900,1,3,48570,48570,48573,0,3,0
13901,4,3,48574,48574,48577,0,3,1
13902,5,3,48579,48579,48582,0,3,2
13903,1,3,48580,48582,48585,2,5,0
13904,6,2,48586,48586,48588,0,2,1
13905,2,3,48588,48588,48591,0,3,0
13906,2,3,48590,48591,48594,1,4,0
13907,4,2,48594,48594,48596,0,2,0
13908,1,3,48595,48596,48599,1,4,0
13909,2,1,48597,48599,48600,2,3,0
13910,4,1,48601,48601,48602,0,1,1
13911,4,2,48605,48605,48607,0,2,3
13912,5,1,48610,48610,48611,0,1,3
13913,2,2,48612,48612,48614,0,2,1
13914,4,3,48616,48616,48619,0,3,2
13915,3,3,48619,48619,48622,0,3,0
13916,5,2,48624,48624,48626,0,2,2
13917,2,1,48626,48626,48627,0,1,0
13918,3,2,48629,48629,48631,0,2,2
13919,6,2,48635,48635,48637,0,2,4
13920,2,1,48637,48637,48638,0,1,0
13921,1,2,48638,48638,48640,0,2,0
13922,2,2,48640,48640,48642,0,2,0
13923,1,2,48641,48642,48644,1,3,0
13924,3,1,48644,48644,48645,0,1,0
13925,4,3,48648,48648,48651,0,3,3
13926,5,3,48653,48653,48656,0,3,2
13927,4,1,48657,48657,48658,0,1,1
13928,3,1,48660,48660,48661,0,1,2
13929,6,2,48666,48666,48668,0,2,5
13930,2,3,48668,48668,48671,0,3,0
13931,5,3,48673,48673,48676,0,3,2
13932,3,2,48676,48676,48678,0,2,0
13933,3,1,48679,48679,48680,0,1,1
13934,1,3,48680,48680,48683,0,3,0
13935,4,3,48684,48684,48687,0,3,1
13936,4,2,48688,48688,48690,0,2,1
13937,5,3,48693,48693,48696,0,3,3
13938,1,2,48694,48696,48698,2,4,0
13939,4,3,48698,48698,48701,0,3,0
13940,4,1,48702,48702,48703,0,1,1
13941,4,3,48706,48706,48709,0,3,3
13942,4,1,48710,48710,48711,0,1,1
13943,3,2,48713,48713,48715,0,2,2
13944,1,3,48714,48715,48718,1,4,0
13945,1,2,48715,48718,48720,3,5,0
13946,5,3,48720,48720,48723,0,3,0
13947,6,2,48726,48726,48728,0,2,3
13948,4,2,48730,48730,48732,0,2,2
13949,5,3,48735,48735,48738,0,3,3
13950,2,1,48737,48738,48739,1,2,0
13951,4,2,48741,48741,48743,0,2,2
13952,5,3,48746,48746,48749,0,3,3
13953,6,2,48752,48752,48754,0,2,3
13954,5,3,48757,48757,48760,0,3,3
13955,4,2,48761,48761,48763,0,2,1
13956,2,2,48763,48763,48765,0,2,0
13957,4,1,48767,48767,48768,0,1,2
13958,2,2,48769,48769,48771,0,2,1
13959,5,2,48774,48774,48776,0,2,3
13960,5,1,48779,48779,48780,0,1,3
13961,4,1,48783,48783,48784,0,1,3
13962,3,1,48786,48786,48787,0,1,2
13963,3,3,48789,48789,48792,0,3,2
13964,3,1,48792,48792,48793,0,1,0
13965,1,2,48793,48793,48795,0,2,0
13966,6,3,48799,48799,48802,0,3,4
13967,3,1,48802,48802,48803,0,1,0
13968,2,1,48804,48804,48805,0,1,1
13969,5,3,48809,48809,48812,0,3,4
13970,4,2,48813,48813,48815,0,2,1
13971,5,2,48818,48818,48820,0,2,3
13972,5,3,48823,48823,48826,0,3,3
13973,5,2,48828,48828,48830,0,2,2
13974,1,1,48829,48830,48831,1,2,0
13975,2,3,48831,48831,48834,0,3,0
13976,4,3,48835,48835,48838,0,3,1
13977,5,2,48840,48840,48842,0,2,2
13978,4,3,48844,48844,48847,0,3,2
13979,3,2,48847,48847,48849,0,2,0
13980,4,1,48851,48851,48852,0,1,2
13981,6,2,48857,48857,48859,0,2,5
13982,6,1,48863,48863,48864,0,1,4
13983,6,1,48869,48869,48870,0,1,5
13984,2,1,48871,48871,48872,0,1,1
13985,3,2,48874,48874,48876,0,2,2
13986,4,3,48878,48878,48881,0,3,2
13987,3,3,48881,48881,48884,0,3,0
13988,4,2,48885,48885,48887,0,2,1
13989,3,3,48888,48888,48891,0,3,1
13990,4,3,48892,48892,48895,0,3,1
13991,6,3,48898,48898,48901,0,3,3
13992,6,1,48904,48904,48905,0,1,3
13993,2,1,48906,48906,48907,0,1,1
13994,6,1,48912,48912,48913,0,1,5
13995,2,3,48914,48914,48917,0,3,1
13996,2,3,48916,48917,48920,1,4,0
13997,4,1,48920,48920,48921,0,1,0
13998,2,2,48922,48922,48924,0,2,1
13999,1,2,48923,48924,48926,1,3,0
14000,4,2,48927,48927,48929,0,2,1
14001,4,1,48931,48931,48932,0,1,2
14002,6,2,48937,48937,48939,0,2,5
14003,3,1,48940,48940,48941,0,1,1
14004,5,3,48945,48945,48948,0,3,4
14005,4,1,48949,48949,48950,0,1,1
14006,6,1,48955,48955,48956,0,1,5
14007,1,2,48956,48956,48958,0,2,0
14008,3,3,48959,48959,48962,0,3,1
14009,2,1,48961,48962,48963,1,2,0
14010,5,2,48966,48966,48968,0,2,3
14011,4,3,48970,48970,48973,0,3,2
14012,5,1,48975,48975,48976,0,1,2
14013,5,2,48980,48980,48982,0,2,4
14014,4,2,48984,48984,48986,0,2,2
14015,1,3,48985,48986,48989,1,4,0
14016,2,3,48987,48989,48992,2,5,0
14017,1,3,48988,48992,48995,4,7,0
14018,2,1,48990,48995,48996,5,6,0
14019,2,3,48992,48996,48999,4,7,0
14020,6,1,48998,48999,49000,1,2,0
14021,4,2,49002,49002,49004,0,2,2
14022,3,2,49005,49005,49007,0,2,1
14023,3,2,49008,49008,49010,0,2,1
14024,4,1,49012,49012,49013,0,1,2
14025,5,2,49017,49017,49019,0,2,4
14026,5,1,49022,49022,49023,0,1,3
14027,4,1,49026,49026,49027,0,1,3
14028,4,1,49030,49030,49031,0,1,3
14029,2,1,49032,49032,49033,0,1,1
14030,4,2,49036,49036,49038,0,2,3
14031,1,1,49037,49038,49039,1,2,0
14032,4,3,49041,49041,49044,0,3,2
14033,2,3,49043,49044,49047,1,4,0
14034,5,1,49048,49048,49049,0,1,1
14035,6,2,49054,49054,49056,0,2,5
14036,5,2,49059,49059,49061,0,2,3
14037,1,3,49060,49061,49064,1,4,0
14038,5,1,49065,49065,49066,0,1,1
14039,2,1,49067,49067,49068,0,1,1
14040,1,1,49068,49068,49069,0,1,0
14041,1,2,49069,49069,49071,0,2,0
14042,5,1,49074,49074,49075,0,1,3
14043,2,1,49076,49076,49077,0,1,1
14044,1,2,49077,49077,49079,0,2,0
14045,1,1,49078,49079,49080,1,2,0
14046,3,3,49081,49081,49084,0,3,1
14047,1,2,49082,49084,49086,2,4,0
14048,3,2,49085,49086,49088,1,3,0
14049,4,3,49089,49089,49092,0,3,1
14050,2,3,49091,49092,49095,1,4,0
14051,2,2,49093,49095,49097,2,4,0
14052,6,1,49099,49099,49100,0,1,2
14053,6,3,49105,49105,49108,0,3,5
14054,2,2,49107,49108,49110,1,3,0
14055,5,2,49112,49112,49114,0,2,2
14056,3,3,49115,49115,49118,0,3,1
14057,4,3,49119,49119,49122,0,3,1
14058,1,1,49120,49122,49123,2,3,0
14059,6,3,49126,49126,49129,0,3,3
14060,1,3,49127,49129,49132,2,5,0
14061,5,1,49132,49132,49133,0,1,0
14062,5,2,49137,49137,49139,0,2,4
14063,5,1,49142,49142,49143,0,1,3
14064,2,2,49144,49144,49146,0,2,1
14065,6,3,49150,49150,49153,0,3,4
14066,4,3,49154,49154,49157,0,3,1
14067,4,3,49158,49158,49161,0,3,1
14068,3,1,49161,49161,49162,0,1,0
14069,4,2,49165,49165,49167,0,2,3
14070,6,2,49171,49171,49173,0,2,4
14071,5,3,49176,49176,49179,0,3,3
14072,5,1,49181,49181,49182,0,1,2
14073,5,2,49186,49186,49188,0,2,4
14074,5,3,49191,49191,49194,0,3,3
14075,6,3,49197,49197,49200,0,3,3
14076,5,1,49202,49202,49203,0,1,2
14077,3,3,49205,49205,49208,0,3,2
14078,4,1,49209,49209,49210,0,1,1
14079,5,2,49214,49214,49216,0,2,4
14080,6,1,49220,49220,49221,0,1,4
14081,6,2,49226,49226,49228,0,2,5
14082,4,1,49230,49230,49231,0,1,2
14083,1,1,49231,49231,49232,0,1,0
14084,4,2,49235,49235,49237,0,2,3
14085,2,2,49237,49237,49239,0,2,0
14086,5,2,49242,49242,49244,0,2,3
14087,5,1,49247,49247,49248,0,1,3
14088,2,2,49249,49249,49251,0,2,1
14089,6,3,49255,49255,49258,0,3,4
14090,1,1,49256,49258,49259,2,3,0
14091,5,3,49261,49261,49264,0,3,2
14092,1,2,49262,49264,49266,2,4,0
14093,2,3,49264,49266,49269,2,5,0
14094,2,2,49266,49269,49271,3,5,0
14095,6,3,49272,49272,49275,0,3,1
14096,6,1,49278,49278,49279,0,1,3
14097,1,3,49279,49279,49282,0,3,0
14098,3,3,49282,49282,49285,0,3,0
14099,1,2,49283,49285,49287,2,4,0
14100,2,2,49285,49287,49289,2,4,0
14101,6,2,49291,49291,49293,0,2,2
14102,1,2,49292,49293,49295,1,3,0
14103,3,3,49295,49295,49298,0,3,0
14104,2,1,49297,49298,49299,1,2,0
14105,1,3,49298,49299,49302,1,4,0
14106,6,3,49304,49304,49307,0,3,2
14107,4,3,49308,49308,49311,0,3,1
14108,4,2,49312,49312,49314,0,2,1
14109,6,2,49318,49318,49320,0,2,4
14110,3,3,49321,49321,49324,0,3,1
14111,3,1,49324,49324,49325,0,1,0
14112,6,2,49330,49330,49332,0,2,5
14113,1,3,49331,49332,49335,1,4,0
14114,6,3,49337,49337,49340,0,3,2
14115,6,1,49343,49343,49344,0,1,3
14116,3,1,49346,49346,49347,0,1,2
14117,2,2,49348,49348,49350,0,2,1
14118,2,1,49350,49350,49351,0,1,0
14119,5,3,49355,49355,49358,0,3,4
14120,6,3,49361,49361,49364,0,3,3
14121,4,3,49365,49365,49368,0,3,1
14122,5,2,49370,49370,49372,0,2,2
14123,6,1,49376,49376,49377,0,1,4
14124,4,2,49380,49380,49382,0,2,3
14125,1,2,49381,49382,49384,1,3,0
14126,6,3,49387,49387,49390,0,3,3
14127,3,2,49390,49390,49392,0,2,0
14128,5,3,49395,49395,49398,0,3,3
14129,5,1,49400,49400,49401,0,1,2
14130,1,3,49401,49401,49404,0,3,0
14131,3,3,49404,49404,49407,0,3,0
14132,6,2,49410,49410,49412,0,2,3
14133,4,3,49414,49414,49417,0,3,2
14134,6,3,49420,49420,49423,0,3,3
14135,4,1,49424,49424,49425,0,1,1
14136,4,3,49428,49428,49431,0,3,3
14137,2,3,49430,49431,49434,1,4,0
14138,1,1,49431,49434,49435,3,4,0
14139,4,2,49435,49435,49437,0,2,0
14140,5,1,49440,49440,49441,0,1,3
14141,4,1,49444,49444,49445,0,1,3
14142,3,3,49447,49447,49450,0,3,2
14143,3,2,49450,49450,49452,0,2,0
14144,1,2,49451,49452,49454,1,3,0
14145,3,3,49454,49454,49457,0,3,0
14146,5,2,49459,49459,49461,0,2,2
14147,1,1,49460,49461,49462,1,2,0
14148,4,2,49464,49464,49466,0,2,2
14149,5,2,49469,49469,49471,0,2,3
14150,4,1,49473,49473,49474,0,1,2
14151,6,3,49479,49479,49482,0,3,5
14152,1,1,49480,49482,49483,2,3,0
14153,5,2,49485,49485,49487,0,2,2
14154,5,3,49490,49490,49493,0,3,3
14155,2,3,49492,49493,49496,1,4,0
14156,3,1,49495,49496,49497,1,2,0
14157,6,3,49501,49501,49504,0,3,4
14158,4,3,49505,49505,49508,0,3,1
14159,4,1,49509,49509,49510,0,1,1
14160,2,1,49511,49511,49512,0,1,1
14161,5,1,49516,49516,49517,0,1,4
14162,6,3,49522,49522,49525,0,3,5
14163,4,2,49526,49526,49528,0,2,1
14164,1,2,49527,49528,49530,1,3,0
14165,2,3,49529,49530,49533,1,4,0
14166,4,1,49533,49533,49534,0,1,0
14167,5,3,49538,49538,49541,0,3,4
14168,2,1,49540,49541,49542,1,2,0
14169,6,3,49546,49546,49549,0,3,4
14170,3,2,49549,49549,49551,0,2,0
14171,1,3,49550,49551,49554,1,4,0
14172,2,1,49552,49554,49555,2,3,0
14173,6,2,49558,49558,49560,0,2,3
14174,3,2,49561,49561,49563,0,2,1
14175,6,3,49567,49567,49570,0,3,4
14176,4,1,49571,49571,49572,0,1,1
14177,2,1,49573,49573,49574,0,1,1
14178,4,3,49577,49577,49580,0,3,3
14179,4,2,49581,49581,49583,0,2,1
14180,6,2,49587,49587,49589,0,2,4
14181,4,1,49591,49591,49592,0,1,2
14182,6,2,49597,49597,49599,0,2,5
14183,1,1,49598,49599,49600,1,2,0
14184,5,3,49603,49603,49606,0,3,3
14185,2,2,49605,49606,49608,1,3,0
14186,1,3,49606,49608,49611,2,5,0
14187,2,2,49608,49611,49613,3,5,0
14188,2,3,49610,49613,49616,3,6,0
14189,2,1,49612,49616,49617,4,5,0
14190,4,2,49616,49617,49619,1,3,0
14191,3,1,49619,49619,49620,0,1,0
14192,6,1,49625,49625,49626,0,1,5
14193,4,1,49629,49629,49630,0,1,3
14194,1,2,49630,49630,49632,0,2,0
14195,3,3,49633,49633,49636,0,3,1
14196,4,1,49637,49637,49638,0,1,1
14197,4,2,49641,49641,49643,0,2,3
14198,5,1,49646,49646,49647,0,1,3
14199,2,3,49648,49648,49651,0,3,1
14200,1,3,49649,49651,49654,2,5,0
14201,3,3,49652,49654,49657,2,5,0
14202,3,1,49655,49657,49658,2,3,0
14203,2,3,49657,49658,49661,1,4,0
14204,2,1,49659,49661,49662,2,3,0
14205,1,1,49660,49662,49663,2,3,0
14206,2,1,49662,49663,49664,1,2,0
14207,1,2,49663,49664,49666,1,3,0
14208,2,1,49665,49666,49667,1,2,0
14209,5,3,49670,49670,49673,0,3,3
14210,6,1,49676,49676,49677,0,1,3
14211,2,3,49678,49678,49681,0,3,1
14212,2,3,49680,49681,49684,1,4,0
14213,5,2,49685,49685,49687,0,2,1
14214,1,3,49686,49687,49690,1,4,0
14215,3,2,49689,49690,49692,1,3,0
14216,5,2,49694,49694,49696,0,2,2
14217,3,1,49697,49697,49698,0,1,1
14218,6,3,49703,49703,49706,0,3,5
14219,3,3,49706,49706,49709,0,3,0
14220,2,2,49708,49709,49711,1,3,0
14221,4,2,49712,49712,49714,0,2,1
14222,2,3,49714,49714,49717,0,3,0
14223,6,2,49720,49720,49722,0,2,3
14224,3,2,49723,49723,49725,0,2,1
14225,2,1,49725,49725,49726,0,1,0
14226,3,3,49728,49728,49731,0,3,2
14227,3,1,49731,49731,49732,0,1,0
14228,6,3,49737,49737,49740,0,3,5
14229,3,1,49740,49740,49741,0,1,0
14230,2,3,49742,49742,49745,0,3,1
14231,2,1,49744,49745,49746,1,2,0
14232,3,3,49747,49747,49750,0,3,1
14233,2,1,49749,49750,49751,1,2,0
14234,5,3,49754,49754,49757,0,3,3
14235,5,1,49759,49759,49760,0,1,2
14236,3,1,49762,49762,49763,0,1,2
14237,5,2,49767,49767,49769,0,2,4
14238,4,1,49771,49771,49772,0,1,2
14239,3,2,49774,49774,49776,0,2,2
14240,2,2,49776,49776,49778,0,2,0
14241,5,3,49781,49781,49784,0,3,3
14242,4,1,49785,49785,49786,0,1,1
14243,5,2,49790,49790,49792,0,2,4
14244,3,2,49793,49793,49795,0,2,1
14245,1,1,49794,49795,49796,1,2,0
14246,1,3,49795,49796,49799,1,4,0
14247,1,2,49796,49799,49801,3,5,0
14248,1,3,49797,49801,49804,4,7,0
14249,2,3,49799,49804,49807,5,8,0
14250,4,1,49803,49807,49808,4,5,0
14251,6,2,49809,49809,49811,0,2,1
14252,4,2,49813,49813,49815,0,2,2
14253,5,3,49818,49818,49821,0,3,3
14254,5,1,49823,49823,49824,0,1,2
14255,4,1,49827,49827,49828,0,1,3
14256,6,2,49833,49833,49835,0,2,5
14257,4,1,49837,49837,49838,0,1,2
14258,3,1,49840,49840,49841,0,1,2
14259,5,3,49845,49845,49848,0,3,4
14260,2,3,49847,49848,49851,1,4,0
14261,2,3,49849,49851,49854,2,5,0
14262,4,3,49853,49854,49857,1,4,0
14263,1,1,49854,49857,49858,3,4,0
14264,3,2,49857,49858,49860,1,3,0
14265,3,1,49860,49860,49861,0,1,0
14266,1,3,49861,49861,49864,0,3,0
14267,6,2,49867,49867,49869,0,2,3
14268,4,3,49871,49871,49874,0,3,2
14269,4,1,49875,49875,49876,0,1,1
14270,6,1,49881,49881,49882,0,1,5
14271,1,1,49882,49882,49883,0,1,0
14272,1,1,49883,49883,49884,0,1,0
14273,3,2,49886,49886,49888,0,2,2
14274,6,2,49892,49892,49894,0,2,4
14275,4,3,49896,49896,49899,0,3,2
14276,1,2,49897,49899,49901,2,4,0
14277,5,1,49902,49902,49903,0,1,1
14278,3,2,49905,49905,49907,0,2,2
14279,1,1,49906,49907,49908,1,2,0
14280,3,1,49909,49909,49910,0,1,1
14281,2,3,49911,49911,49914,0,3,1
14282,1,1,49912,49914,49915,2,3,0
14283,2,1,49914,49915,49916,1,2,0
14284,3,1,49917,49917,49918,0,1,1
14285,4,2,49921,49921,49923,0,2,3
14286,6,2,49927,49927,49929,0,2,4
14287,6,2,49933,49933,49935,0,2,4
14288,1,1,49934,49935,49936,1,2,0
14289,6,1,49940,49940,49941,0,1,4
14290,2,3,49942,49942,49945,0,3,1
14291,3,3,49945,49945,49948,0,3,0
14292,2,2,49947,49948,49950,1,3,0
14293,4,2,49951,49951,49953,0,2,1
14294,4,3,49955,49955,49958,0,3,2
14295,6,1,49961,49961,49962,0,1,3
14296,2,2,49963,49963,49965,0,2,1
14297,1,2,49964,49965,49967,1,3,0
14298,2,2,49966,49967,49969,1,3,0
14299,5,3,49971,49971,49974,0,3,2
14300,3,1,49974,49974,49975,0,1,0
14301,2,2,49976,49976,49978,0,2,1
14302,5,3,49981,49981,49984,0,3,3
14303,5,3,49986,49986,49989,0,3,2
14304,1,2,49987,49989,49991,2,4,0
14305,3,1,49990,49991,49992,1,2,0
14306,5,1,49995,49995,49996,0,1,3
14307,6,2,50001,50001,50003,0,2,5
14308,3,2,50004,50004,50006,0,2,1
14309,6,3,50010,50010,50013,0,3,4
14310,1,1,50011,50013,50014,2,3,0
14311,6,2,50017,50017,50019,0,2,3
14312,4,2,50021,50021,50023,0,2,2
14313,5,3,50026,50026,50029,0,3,3
14314,5,3,50031,50031,50034,0,3,2
14315,5,2,50036,50036,50038,0,2,2
14316,4,1,50040,50040,50041,0,1,2
14317,1,3,50041,50041,50044,0,3,0
14318,6,3,50047,50047,50050,0,3,3
14319,5,1,50052,50052,50053,0,1,2
14320,1,3,50053,50053,50056,0,3,0
14321,3,1,50056,50056,50057,0,1,0
14322,2,3,50058,50058,50061,0,3,1
14323,3,1,50061,50061,50062,0,1,0
14324,1,3,50062,50062,50065,0,3,0
14325,5,3,50067,50067,50070,0,3,2
14326,2,2,50069,50070,50072,1,3,0
14327,4,2,50073,50073,50075,0,2,1
14328,3,3,50076,50076,50079,0,3,1
14329,2,2,50078,50079,50081,1,3,0
14330,5,2,50083,50083,50085,0,2,2
14331,2,1,50085,50085,50086,0,1,0
14332,6,2,50091,50091,50093,0,2,5
14333,3,3,50094,50094,50097,0,3,1
14334,6,2,50100,50100,50102,0,2,3
14335,4,2,50104,50104,50106,0,2,2
14336,2,1,50106,50106,50107,0,1,0
14337,2,3,50108,50108,50111,0,3,1
14338,5,1,50113,50113,50114,0,1,2
14339,6,3,50119,50119,50122,0,3,5
14340,5,1,50124,50124,50125,0,1,2
14341,2,3,50126,50126,50129,0,3,1
14342,4,1,50130,50130,50131,0,1,1
14343,5,3,50135,50135,50138,0,3,4
14344,6,3,50141,50141,50144,0,3,3
14345,6,1,50147,50147,50148,0,1,3
14346,6,1,50153,50153,50154,0,1,5
14347,5,3,50158,50158,50161,0,3,4
14348,5,1,50163,50163,50164,0,1,2
14349,4,3,50167,50167,50170,0,3,3
14350,1,3,50168,50170,50173,2,5,0
14351,1,3,50169,50173,50176,4,7,0
14352,1,1,50170,50176,50177,6,7,0
14353,1,3,50171,50177,50180,6,9,0
14354,2,3,50173,50180,50183,7,10,0
14355,2,1,50175,50183,50184,8,9,0
14356,4,2,50179,50184,50186,5,7,0
14357,5,1,50184,50186,50187,2,3,0
14358,6,1,50190,50190,50191,0,1,3
14359,4,3,50194,50194,50197,0,3,3
14360,6,2,50200,50200,50202,0,2,3
14361,4,1,50204,50204,50205,0,1,2
14362,4,1,50208,50208,50209,0,1,3
14363,2,3,50210,50210,50213,0,3,1
14364,1,3,50211,50213,50216,2,5,0
14365,4,2,50215,50216,50218,1,3,0
14366,2,2,50217,50218,50220,1,3,0
14367,5,1,50222,50222,50223,0,1,2
14368,6,1,50228,50228,50229,0,1,5
14369,2,3,50230,50230,50233,0,3,1
14370,5,2,50235,50235,50237,0,2,2
14371,5,2,50240,50240,50242,0,2,3
14372,5,2,50245,50245,50247,0,2,3
14373,5,1,50250,50250,50251,0,1,3
14374,2,1,50252,50252,50253,0,1,1
14375,2,2,50254,50254,50256,0,2,1
14376,4,3,50258,50258,50261,0,3,2
14377,1,3,50259,50261,50264,2,5,0
14378,6,3,50265,50265,50268,0,3,1
14379,6,3,50271,50271,50274,0,3,3
14380,1,3,50272,50274,50277,2,5,0
14381,1,2,50273,50277,50279,4,6,0
14382,1,1,50274,50279,50280,5,6,0
14383,4,3,50278,50280,50283,2,5,0
14384,5,3,50283,50283,50286,0,3,0
14385,5,1,50288,50288,50289,0,1,2
14386,2,2,50290,50290,50292,0,2,1
14387,5,3,50295,50295,50298,0,3,3
14388,3,2,50298,50298,50300,0,2,0
14389,2,1,50300,50300,50301,0,1,0
14390,3,1,50303,50303,50304,0,1,2
14391,2,1,50305,50305,50306,0,1,1
14392,5,1,50310,50310,50311,0,1,4
14393,6,3,50316,50316,50319,0,3,5
14394,2,2,50318,50319,50321,1,3,0
14395,3,2,50321,50321,50323,0,2,0
14396,3,1,50324,50324,50325,0,1,1
14397,1,2,50325,50325,50327,0,2,0
14398,2,1,50327,50327,50328,0,1,0
14399,4,1,50331,50331,50332,0,1,3
14400,5,1,50336,50336,50337,0,1,4
14401,4,3,50340,50340,50343,0,3,3
14402,6,2,50346,50346,50348,0,2,3
14403,6,2,50352,50352,50354,0,2,4
14404,5,1,50357,50357,50358,0,1,3
14405,3,3,50360,50360,50363,0,3,2
14406,6,1,50366,50366,50367,0,1,3
14407,5,1,50371,50371,50372,0,1,4
14408,6,2,50377,50377,50379,0,2,5
14409,3,1,50380,50380,50381,0,1,1
14410,1,3,50381,50381,50384,0,3,0
14411,4,3,50385,50385,50388,0,3,1
14412,5,3,50390,50390,50393,0,3,2
14413,2,2,50392,50393,50395,1,3,0
14414,5,1,50397,50397,50398,0,1,2
14415,6,1,50403,50403,50404,0,1,5
14416,6,3,50409,50409,50412,0,3,5
14417,4,2,50413,50413,50415,0,2,1
14418,6,2,50419,50419,50421,0,2,4
14419,3,3,50422,50422,50425,0,3,1
14420,5,1,50427,50427,50428,0,1,2
14421,4,1,50431,50431,50432,0,1,3
14422,1,3,50432,50432,50435,0,3,0
14423,6,1,50438,50438,50439,0,1,3
14424,6,2,50444,50444,50446,0,2,5
14425,1,3,50445,50446,50449,1,4,0
14426,4,1,50449,50449,50450,0,1,0
14427,4,2,50453,50453,50455,0,2,3
14428,3,2,50456,50456,50458,0,2,1
14429,1,2,50457,50458,50460,1,3,0
14430,4,1,50461,50461,50462,0,1,1
14431,2,1,50463,50463,50464,0,1,1
14432,3,1,50466,50466,50467,0,1,2
14433,2,2,50468,50468,50470,0,2,1
14434,6,3,50474,50474,50477,0,3,4
14435,1,3,50475,50477,50480,2,5,0
14436,4,1,50479,50480,50481,1,2,0
14437,3,2,50482,50482,50484,0,2,1
14438,3,3,50485,50485,50488,0,3,1
14439,3,3,50488,50488,50491,0,3,0
14440,4,3,50492,50492,50495,0,3,1
14441,6,3,50498,50498,50501,0,3,3
14442,4,1,50502,50502,50503,0,1,1
14443,5,1,50507,50507,50508,0,1,4
14444,1,2,50508,50508,50510,0,2,0
14445,3,3,50511,50511,50514,0,3,1
14446,2,1,50513,50514,50515,1,2,0
14447,6,1,50519,50519,50520,0,1,4
14448,5,3,50524,50524,50527,0,3,4
14449,6,2,50530,50530,50532,0,2,3
14450,1,1,50531,50532,50533,1,2,0
14451,2,2,50533,50533,50535,0,2,0
14452,3,3,50536,50536,50539,0,3,1
14453,4,1,50540,50540,50541,0,1,1
14454,1,3,50541,50541,50544,0,3,0
14455,2,2,50543,50544,50546,1,3,0
14456,1,1,50544,50546,50547,2,3,0
14457,1,1,50545,50547,50548,2,3,0
14458,3,3,50548,50548,50551,0,3,0
14459,3,1,50551,50551,50552,0,1,0
14460,5,2,50556,50556,50558,0,2,4
14461,6,2,50562,50562,50564,0,2,4
14462,4,2,50566,50566,50568,0,2,2
14463,1,3,50567,50568,50571,1,4,0
14464,3,2,50570,50571,50573,1,3,0
14465,4,1,50574,50574,50575,0,1,1
14466,4,3,50578,50578,50581,0,3,3
14467,5,2,50583,50583,50585,0,2,2
14468,4,2,50587,50587,50589,0,2,2
14469,4,2,50591,50591,50593,0,2,2
14470,1,2,50592,50593,50595,1,3,0
14471,2,2,50594,50595,50597,1,3,0
14472,1,2,50595,50597,50599,2,4,0
14473,5,3,50600,50600,50603,0,3,1
14474,2,2,50602,50603,50605,1,3,0
14475,3,3,50605,50605,50608,0,3,0
14476,5,2,50610,50610,50612,0,2,2
14477,4,1,50614,50614,50615,0,1,2
14478,6,3,50620,50620,50623,0,3,5
14479,1,3,50621,50623,50626,2,5,0
14480,4,2,50625,50626,50628,1,3,0
14481,2,1,50627,50628,50629,1,2,0
14482,2,2,50629,50629,50631,0,2,0
14483,4,3,50633,50633,50636,0,3,2
14484,2,2,50635,50636,50638,1,3,0
14485,1,1,50636,50638,50639,2,3,0
14486,2,1,50638,50639,50640,1,2,0
14487,3,3,50641,50641,50644,0,3,1
14488,1,3,50642,50644,50647,2,5,0
14489,6,1,50648,50648,50649,0,1,1
14490,6,3,50654,50654,50657,0,3,5
14491,6,2,50660,50660,50662,0,2,3
14492,2,2,50662,50662,50664,0,2,0
14493,3,1,50665,50665,50666,0,1,1
14494,3,3,50668,50668,50671,0,3,2
14495,2,2,50670,50671,50673,1,3,0
14496,1,2,50671,50673,50675,2,4,0
14497,4,3,50675,50675,50678,0,3,0
14498,4,3,50679,50679,50682,0,3,1
14499,3,2,50682,50682,50684,0,2,0
14500,1,1,50683,50684,50685,1,2,0
14501,4,1,50687,50687,50688,0,1,2
14502,1,2,50688,50688,50690,0,2,0
14503,1,3,50689,50690,50693,1,4,0
14504,5,1,50694,50694,50695,0,1,1
14505,3,1,50697,50697,50698,0,1,2
14506,2,3,50699,50699,50702,0,3,1
14507,1,1,50700,50702,50703,2,3,0
14508,3,2,50703,50703,50705,0,2,0
14509,5,3,50708,50708,50711,0,3,3
14510,3,2,50711,50711,50713,0,2,0
14511,2,1,50713,50713,50714,0,1,0
14512,5,1,50718,50718,50719,0,1,4
14513,1,1,50719,50719,50720,0,1,0
14514,4,2,50723,50723,50725,0,2,3
14515,1,2,50724,50725,50727,1,3,0
14516,3,2,50727,50727,50729,0,2,0
14517,5,2,50732,50732,50734,0,2,3
14518,5,3,50737,50737,50740,0,3,3
14519,5,3,50742,50742,50745,0,3,2
14520,6,2,50748,50748,50750,0,2,3
14521,3,1,50751,50751,50752,0,1,1
14522,2,3,50753,50753,50756,0,3,1
14523,5,3,50758,50758,50761,0,3,2
14524,5,2,50763,50763,50765,0,2,2
14525,3,2,50766,50766,50768,0,2,1
14526,4,1,50770,50770,50771,0,1,2
14527,1,2,50771,50771,50773,0,2,0
14528,6,3,50777,50777,50780,0,3,4
14529,2,2,50779,50780,50782,1,3,0
14530,6,3,50785,50785,50788,0,3,3
14531,6,1,50791,50791,50792,0,1,3
14532,4,3,50795,50795,50798,0,3,3
14533,4,3,50799,50799,50802,0,3,1
14534,5,1,50804,50804,50805,0,1,2
14535,3,3,50807,50807,50810,0,3,2
14536,4,3,50811,50811,50814,0,3,1
14537,5,1,50816,50816,50817,0,1,2
14538,6,2,50822,50822,50824,0,2,5
14539,4,2,50826,50826,50828,0,2,2
14540,4,2,50830,50830,50832,0,2,2
14541,2,2,50832,50832,50834,0,2,0
14542,5,2,50837,50837,50839,0,2,3
14543,3,3,50840,50840,50843,0,3,1
14544,1,2,50841,50843,50845,2,4,0
14545,6,3,50847,50847,50850,0,3,2
14546,1,3,50848,50850,50853,2,5,0
14547,1,3,50849,50853,50856,4,7,0
14548,1,1,50850,50856,50857,6,7,0
14549,5,2,50855,50857,50859,2,4,0
14550,6,3,50861,50861,50864,0,3,2
14551,5,2,50866,50866,50868,0,2,2
14552,3,3,50869,50869,50872,0,3,1
14553,3,3,50872,50872,50875,0,3,0
14554,6,2,50878,50878,50880,0,2,3
14555,2,1,50880,50880,50881,0,1,0
14556,1,1,50881,50881,50882,0,1,0
14557,1,2,50882,50882,50884,0,2,0
14558,2,3,50884,50884,50887,0,3,0
14559,4,3,50888,50888,50891,0,3,1
14560,2,1,50890,50891,50892,1,2,0
14561,1,1,50891,50892,50893,1,2,0
14562,6,3,50897,50897,50900,0,3,4
14563,5,3,50902,50902,50905,0,3,2
14564,6,2,50908,50908,50910,0,2,3
14565,3,2,50911,50911,50913,0,2,1
14566,5,1,50916,50916,50917,0,1,3
14567,4,3,50920,50920,50923,0,3,3
14568,2,1,50922,50923,50924,1,2,0
14569,6,1,50928,50928,50929,0,1,4
14570,1,1,50929,50929,50930,0,1,0
14571,4,1,50933,50933,50934,0,1,3
14572,6,1,50939,50939,50940,0,1,5
14573,3,3,50942,50942,50945,0,3,2
14574,1,3,50943,50945,50948,2,5,0
14575,5,1,50948,50948,50949,0,1,0
14576,6,1,50954,50954,50955,0,1,5
14577,4,3,50958,50958,50961,0,3,3
14578,2,2,50960,50961,50963,1,3,0
14579,2,2,50962,50963,50965,1,3,0
14580,2,3,50964,50965,50968,1,4,0
14581,5,3,50969,50969,50972,0,3,1
14582,1,3,50970,50972,50975,2,5,0
14583,3,3,50973,50975,50978,2,5,0
14584,4,2,50977,50978,50980,1,3,0
14585,2,1,50979,50980,50981,1,2,0
14586,5,2,50984,50984,50986,0,2,3
14587,2,2,50986,50986,50988,0,2,0
14588,3,2,50989,50989,50991,0,2,1
14589,6,1,50995,50995,50996,0,1,4
14590,4,2,50999,50999,51001,0,2,3
14591,2,3,51001,51001,51004,0,3,0
14592,1,2,51002,51004,51006,2,4,0
14593,2,2,51004,51006,51008,2,4,0
14594,1,1,51005,51008,51009,3,4,0
14595,5,3,51010,51010,51013,0,3,1
14596,6,1,51016,51016,51017,0,1,3
14597,1,2,51017,51017,51019,0,2,0
14598,3,2,51020,51020,51022,0,2,1
14599,1,2,51021,51022,51024,1,3,0
14600,1,3,51022,51024,51027,2,5,0
14601,6,3,51028,51028,51031,0,3,1
14602,1,1,51029,51031,51032,2,3,0
14603,2,2,51031,51032,51034,1,3,0
14604,6,1,51037,51037,51038,0,1,3
14605,5,3,51042,51042,51045,0,3,4
14606,4,2,51046,51046,51048,0,2,1
14607,3,1,51049,51049,51050,0,1,1
14608,3,1,51052,51052,51053,0,1,2
14609,3,3,51055,51055,51058,0,3,2
14610,5,2,51060,51060,51062,0,2,2
14611,1,2,51061,51062,51064,1,3,0
14612,2,3,51063,51064,51067,1,4,0
14613,4,2,51067,51067,51069,0,2,0
14614,6,2,51073,51073,51075,0,2,4
14615,4,2,51077,51077,51079,0,2,2
14616,5,2,51082,51082,51084,0,2,3
14617,6,2,51088,51088,51090,0,2,4
14618,3,3,51091,51091,51094,0,3,1
14619,6,2,51097,51097,51099,0,2,3
14620,3,3,51100,51100,51103,0,3,1
14621,5,3,51105,51105,51108,0,3,2
14622,2,3,51107,51108,51111,1,4,0
14623,2,1,51109,51111,51112,2,3,0
14624,4,1,51113,51113,51114,0,1,1
14625,2,3,51115,51115,51118,0,3,1
14626,5,3,51120,51120,51123,0,3,2
14627,5,1,51125,51125,51126,0,1,2
14628,6,2,51131,51131,51133,0,2,5
14629,4,3,51135,51135,51138,0,3,2
14630,6,2,51141,51141,51143,0,2,3
14631,6,1,51147,51147,51148,0,1,4
14632,4,3,51151,51151,51154,0,3,3
14633,2,2,51153,51154,51156,1,3,0
14634,1,3,51154,51156,51159,2,5,0
14635,5,2,51159,51159,51161,0,2,0
14636,6,1,51165,51165,51166,0,1,4
14637,1,1,51166,51166,51167,0,1,0
14638,6,1,51172,51172,51173,0,1,5
14639,1,3,51173,51173,51176,0,3,0
14640,1,1,51174,51176,51177,2,3,0
14641,6,3,51180,51180,51183,0,3,3
14642,3,2,51183,51183,51185,0,2,0
14643,1,3,51184,51185,51188,1,4,0
14644,3,3,51187,51188,51191,1,4,0
14645,4,2,51191,51191,51193,0,2,0
14646,1,1,51192,51193,51194,1,2,0
14647,5,3,51197,51197,51200,0,3,3
14648,2,1,51199,51200,51201,1,2,0
14649,3,2,51202,51202,51204,0,2,1
14650,3,3,51205,51205,51208,0,3,1
14651,3,1,51208,51208,51209,0,1,0
14652,5,3,51213,51213,51216,0,3,4
14653,6,1,51219,51219,51220,0,1,3
14654,1,3,51220,51220,51223,0,3,0
14655,5,1,51225,51225,51226,0,1,2
14656,3,1,51228,51228,51229,0,1,2
14657,4,2,51232,51232,51234,0,2,3
14658,5,2,51237,51237,51239,0,2,3
14659,5,3,51242,51242,51245,0,3,3
14660,5,2,51247,51247,51249,0,2,2
14661,5,3,51252,51252,51255,0,3,3
14662,4,3,51256,51256,51259,0,3,1
14663,4,2,51260,51260,51262,0,2,1
14664,2,2,51262,51262,51264,0,2,0
14665,1,3,51263,51264,51267,1,4,0
14666,6,3,51269,51269,51272,0,3,2
14667,5,2,51274,51274,51276,0,2,2
14668,3,3,51277,51277,51280,0,3,1
14669,1,1,51278,51280,51281,2,3,0
14670,1,2,51279,51281,51283,2,4,0
14671,1,1,51280,51283,51284,3,4,0
14672,1,2,51281,51284,51286,3,5,0
14673,4,1,51285,51286,51287,1,2,0
14674,2,2,51287,51287,51289,0,2,0
14675,6,3,51293,51293,51296,0,3,4
14676,5,3,51298,51298,51301,0,3,2
14677,2,1,51300,51301,51302,1,2,0
14678,2,3,51302,51302,51305,0,3,0
14679,3,3,51305,51305,51308,0,3,0
14680,3,2,51308,51308,51310,0,2,0
14681,1,3,51309,51310,51313,1,4,0
14682,6,3,51315,51315,51318,0,3,2
14683,6,2,51321,51321,51323,0,2,3
14684,5,3,51326,51326,51329,0,3,3
14685,4,2,51330,51330,51332,0,2,1
14686,6,2,51336,51336,51338,0,2,4
14687,4,3,51340,51340,51343,0,3,2
14688,1,2,51341,51343,51345,2,4,0
14689,2,2,51343,51345,51347,2,4,0
14690,2,2,51345,51347,51349,2,4,0
14691,5,2,51350,51350,51352,0,2,1
14692,5,2,51355,51355,51357,0,2,3
14693,5,3,51360,51360,51363,0,3,3
14694,3,3,51363,51363,51366,0,3,0
14695,3,2,51366,51366,51368,0,2,0
14696,1,1,51367,51368,51369,1,2,0
14697,1,1,51368,51369,51370,1,2,0
14698,1,2,51369,51370,51372,1,3,0
14699,6,1,51375,51375,51376,0,1,3
14700,6,2,51381,51381,51383,0,2,5
14701,2,1,51383,51383,51384,0,1,0
14702,4,3,51387,51387,51390,0,3,3
14703,4,2,51391,51391,51393,0,2,1
14704,4,2,51395,51395,51397,0,2,2
14705,5,3,51400,51400,51403,0,3,3
14706,3,1,51403,51403,51404,0,1,0
14707,3,3,51406,51406,51409,0,3,2
14708,5,3,51411,51411,51414,0,3,2
14709,2,1,51413,51414,51415,1,2,0
14710,1,3,51414,51415,51418,1,4,0
14711,5,2,51419,51419,51421,0,2,1
14712,3,2,51422,51422,51424,0,2,1
14713,2,3,51424,51424,51427,0,3,0
14714,6,1,51430,51430,51431,0,1,3
14715,1,1,51431,51431,51432,0,1,0
14716,2,1,51433,51433,51434,0,1,1
14717,1,3,51434,51434,51437,0,3,0
14718,2,2,51436,51437,51439,1,3,0
14719,6,2,51442,51442,51444,0,2,3
14720,3,2,51445,51445,51447,0,2,1
14721,5,1,51450,51450,51451,0,1,3
14722,5,2,51455,51455,51457,0,2,4
14723,5,2,51460,51460,51462,0,2,3
14724,6,2,51466,51466,51468,0,2,4
14725,4,2,51470,51470,51472,0,2,2
14726,6,2,51476,51476,51478,0,2,4
14727,1,1,51477,51478,51479,1,2,0
14728,3,2,51480,51480,51482,0,2,1
14729,5,1,51485,51485,51486,0,1,3
14730,3,3,51488,51488,51491,0,3,2
14731,4,3,51492,51492,51495,0,3,1
14732,4,1,51496,51496,51497,0,1,1
14733,2,1,51498,51498,51499,0,1,1
14734,2,2,51500,51500,51502,0,2,1
14735,2,1,51502,51502,51503,0,1,0
14736,5,2,51507,51507,51509,0,2,4
14737,5,2,51512,51512,51514,0,2,3
14738,3,1,51515,51515,51516,0,1,1
14739,2,1,51517,51517,51518,0,1,1
14740,6,2,51523,51523,51525,0,2,5
14741,4,1,51527,51527,51528,0,1,2
14742,2,3,51529,51529,51532,0,3,1
14743,1,1,51530,51532,51533,2,3,0
14744,3,2,51533,51533,51535,0,2,0
14745,5,2,51538,51538,51540,0,2,3
14746,4,3,51542,51542,51545,0,3,2
14747,3,3,51545,51545,51548,0,3,0
14748,3,2,51548,51548,51550,0,2,0
14749,1,1,51549,51550,51551,1,2,0
14750,1,2,51550,51551,51553,1,3,0
14751,6,2,51556,51556,51558,0,2,3
14752,2,3,51558,51558,51561,0,3,0
14753,1,3,51559,51561,51564,2,5,0
14754,3,2,51562,51564,51566,2,4,0
14755,1,3,51563,51566,51569,3,6,0
14756,3,3,51566,51569,51572,3,6,0
14757,4,3,51570,51572,51575,2,5,0
14758,5,3,51575,51575,51578,0,3,0
14759,6,3,51581,51581,51584,0,3,3
14760,4,3,51585,51585,51588,0,3,1
14761,6,1,51591,51591,51592,0,1,3
14762,2,3,51593,51593,51596,0,3,1
14763,3,1,51596,51596,51597,0,1,0
14764,3,1,51599,51599,51600,0,1,2
14765,2,2,51601,51601,51603,0,2,1
14766,4,3,51605,51605,51608,0,3,2
14767,1,2,51606,51608,51610,2,4,0
14768,2,3,51608,51610,51613,2,5,0
14769,1,3,51609,51613,51616,4,7,0
14770,1,2,51610,51616,51618,6,8,0
14771,4,1,51614,51618,51619,4,5,0
14772,1,3,51615,51619,51622,4,7,0
14773,2,1,51617,51622,51623,5,6,0
14774,6,2,51623,51623,51625,0,2,0
14775,2,2,51625,51625,51627,0,2,0
14776,3,2,51628,51628,51630,0,2,1
14777,5,2,51633,51633,51635,0,2,3
14778,2,2,51635,51635,51637,0,2,0
14779,2,1,51637,51637,51638,0,1,0
14780,2,3,51639,51639,51642,0,3,1
14781,3,1,51642,51642,51643,0,1,0
14782,1,2,51643,51643,51645,0,2,0
14783,5,3,51648,51648,51651,0,3,3
14784,1,3,51649,51651,51654,2,5,0
14785,1,3,51650,51654,51657,4,7,0
14786,1,1,51651,51657,51658,6,7,0
14787,6,2,51657,51658,51660,1,3,0
14788,5,2,51662,51662,51664,0,2,2
14789,1,3,51663,51664,51667,1,4,0
14790,1,3,51664,51667,51670,3,6,0
14791,3,1,51667,51670,51671,3,4,0
14792,3,1,51670,51671,51672,1,2,0
14793,6,3,51676,51676,51679,0,3,4
14794,3,3,51679,51679,51682,0,3,0
14795,1,3,51680,51682,51685,2,5,0
14796,6,1,51686,51686,51687,0,1,1
14797,5,1,51691,51691,51692,0,1,4
14798,6,3,51697,51697,51700,0,3,5
14799,4,2,51701,51701,51703,0,2,1
14800,3,1,51704,51704,51705,0,1,1
14801,3,1,51707,51707,51708,0,1,2
14802,1,3,51708,51708,51711,0,3,0
14803,3,1,51711,51711,51712,0,1,0
14804,1,2,51712,51712,51714,0,2,0
14805,6,3,51718,51718,51721,0,3,4
14806,1,1,51719,51721,51722,2,3,0
14807,5,3,51724,51724,51727,0,3,2
14808,2,3,51726,51727,51730,1,4,0
14809,2,3,51728,51730,51733,2,5,0
14810,1,2,51729,51733,51735,4,6,0
14811,4,3,51733,51735,51738,2,5,0
14812,6,1,51739,51739,51740,0,1,1
14813,4,1,51743,51743,51744,0,1,3
14814,1,1,51744,51744,51745,0,1,0
14815,2,3,51746,51746,51749,0,3,1
14816,6,1,51752,51752,51753,0,1,3
14817,6,1,51758,51758,51759,0,1,5
14818,3,2,51761,51761,51763,0,2,2
14819,5,2,51766,51766,51768,0,2,3
14820,1,1,51767,51768,51769,1,2,0
14821,2,3,51769,51769,51772,0,3,0
14822,5,1,51774,51774,51775,0,1,2
14823,3,2,51777,51777,51779,0,2,2
14824,3,3,51780,51780,51783,0,3,1
14825,1,2,51781,51783,51785,2,4,0
14826,3,3,51784,51785,51788,1,4,0
14827,4,1,51788,51788,51789,0,1,0
14828,1,1,51789,51789,51790,0,1,0
14829,6,2,51795,51795,51797,0,2,5
14830,6,3,51801,51801,51804,0,3,4
14831,1,1,51802,51804,51805,2,3,0
14832,3,2,51805,51805,51807,0,2,0
14833,4,3,51809,51809,51812,0,3,2
14834,2,3,51811,51812,51815,1,4,0
14835,2,1,51813,51815,51816,2,3,0
14836,4,1,51817,51817,51818,0,1,1
14837,3,1,51820,51820,51821,0,1,2
14838,3,3,51823,51823,51826,0,3,2
14839,6,3,51829,51829,51832,0,3,3
14840,5,1,51834,51834,51835,0,1,2
14841,1,1,51835,51835,51836,0,1,0
14842,4,3,51839,51839,51842,0,3,3
14843,6,2,51845,51845,51847,0,2,3
14844,6,1,51851,51851,51852,0,1,4
14845,6,2,51857,51857,51859,0,2,5
14846,2,3,51859,51859,51862,0,3,0
14847,2,3,51861,51862,51865,1,4,0
14848,6,3,51867,51867,51870,0,3,2
14849,3,3,51870,51870,51873,0,3,0
14850,4,3,51874,51874,51877,0,3,1
14851,3,1,51877,51877,51878,0,1,0
14852,5,2,51882,51882,51884,0,2,4
14853,4,2,51886,51886,51888,0,2,2
14854,3,2,51889,51889,51891,0,2,1
14855,1,1,51890,51891,51892,1,2,0
14856,1,2,51891,51892,51894,1,3,0
14857,1,1,51892,51894,51895,2,3,0
14858,4,3,51896,51896,51899,0,3,1
14859,2,2,51898,51899,51901,1,3,0
14860,6,2,51904,51904,51906,0,2,3
14861,5,3,51909,51909,51912,0,3,3
14862,6,1,51915,51915,51916,0,1,3
14863,5,3,51920,51920,51923,0,3,4
14864,1,1,51921,51923,51924,2,3,0
14865,4,2,51925,51925,51927,0,2,1
14866,4,1,51929,51929,51930,0,1,2
14867,5,3,51934,51934,51937,0,3,4
14868,5,2,51939,51939,51941,0,2,2
14869,5,3,51944,51944,51947,0,3,3
14870,4,1,51948,51948,51949,0,1,1
14871,4,3,51952,51952,51955,0,3,3
14872,5,1,51957,51957,51958,0,1,2
14873,2,2,51959,51959,51961,0,2,1
14874,1,1,51960,51961,51962,1,2,0
14875,1,2,51961,51962,51964,1,3,0
14876,4,1,51965,51965,51966,0,1,1
14877,6,3,51971,51971,51974,0,3,5
14878,1,3,51972,51974,51977,2,5,0
14879,6,2,51978,51978,51980,0,2,1
14880,3,2,51981,51981,51983,0,2,1
14881,6,2,51987,51987,51989,0,2,4
14882,6,1,51993,51993,51994,0,1,4
14883,4,3,51997,51997,52000,0,3,3
14884,4,2,52001,52001,52003,0,2,1
14885,5,2,52006,52006,52008,0,2,3
14886,2,2,52008,52008,52010,0,2,0
14887,2,2,52010,52010,52012,0,2,0
14888,1,1,52011,52012,52013,1,2,0
14889,5,3,52016,52016,52019,0,3,3
14890,4,1,52020,52020,52021,0,1,1
14891,4,1,52024,52024,52025,0,1,3
14892,2,1,52026,52026,52027,0,1,1
14893,1,3,52027,52027,52030,0,3,0
14894,3,2,52030,52030,52032,0,2,0
14895,2,1,52032,52032,52033,0,1,0
14896,5,3,52037,52037,52040,0,3,4
14897,2,3,52039,52040,52043,1,4,0
14898,4,3,52043,52043,52046,0,3,0
14899,2,2,52045,52046,52048,1,3,0
14900,5,2,52050,52050,52052,0,2,2
14901,2,3,52052,52052,52055,0,3,0
14902,6,1,52058,52058,52059,0,1,3
14903,3,2,52061,52061,52063,0,2,2
14904,6,3,52067,52067,52070,0,3,4
14905,1,3,52068,52070,52073,2,5,0
14906,3,1,52071,52073,52074,2,3,0
14907,2,3,52073,52074,52077,1,4,0
14908,3,1,52076,52077,52078,1,2,0
14909,1,2,52077,52078,52080,1,3,0
14910,5,1,52082,52082,52083,0,1,2
14911,5,1,52087,52087,52088,0,1,4
14912,1,2,52088,52088,52090,0,2,0
14913,2,2,52090,52090,52092,0,2,0
14914,1,2,52091,52092,52094,1,3,0
14915,6,3,52097,52097,52100,0,3,3
14916,1,1,52098,52100,52101,2,3,0
14917,5,2,52103,52103,52105,0,2,2
14918,6,3,52109,52109,52112,0,3,4
14919,4,1,52113,52113,52114,0,1,1
14920,4,3,52117,52117,52120,0,3,3
14921,3,3,52120,52120,52123,0,3,0
14922,5,1,52125,52125,52126,0,1,2
14923,1,3,52126,52126,52129,0,3,0
14924,6,1,52132,52132,52133,0,1,3
14925,5,2,52137,52137,52139,0,2,4
14926,6,1,52143,52143,52144,0,1,4
14927,3,2,52146,52146,52148,0,2,2
14928,5,3,52151,52151,52154,0,3,3
14929,2,2,52153,52154,52156,1,3,0
14930,3,3,52156,52156,52159,0,3,0
14931,6,1,52162,52162,52163,0,1,3
14932,6,3,52168,52168,52171,0,3,5
14933,1,1,52169,52171,52172,2,3,0
14934,5,3,52174,52174,52177,0,3,2
14935,1,3,52175,52177,52180,2,5,0
14936,4,2,52179,52180,52182,1,3,0
14937,1,2,52180,52182,52184,2,4,0
14938,4,2,52184,52184,52186,0,2,0
14939,6,2,52190,52190,52192,0,2,4
14940,5,2,52195,52195,52197,0,2,3
14941,1,1,52196,52197,52198,1,2,0
14942,6,1,52202,52202,52203,0,1,4
14943,3,1,52205,52205,52206,0,1,2
14944,4,1,52209,52209,52210,0,1,3
14945,1,1,52210,52210,52211,0,1,0
14946,1,1,52211,52211,52212,0,1,0
14947,6,3,52217,52217,52220,0,3,5
14948,6,1,52223,52223,52224,0,1,3
14949,6,1,52229,52229,52230,0,1,5
14950,4,2,52233,52233,52235,0,2,3
14951,6,1,52239,52239,52240,0,1,4
14952,4,3,52243,52243,52246,0,3,3
14953,5,1,52248,52248,52249,0,1,2
14954,4,1,52252,52252,52253,0,1,3
14955,4,2,52256,52256,52258,0,2,3
14956,3,1,52259,52259,52260,0,1,1
14957,3,1,52262,52262,52263,0,1,2
14958,3,2,52265,52265,52267,0,2,2
14959,1,2,52266,52267,52269,1,3,0
14960,6,2,52272,52272,52274,0,2,3
14961,3,3,52275,52275,52278,0,3,1
14962,6,3,52281,52281,52284,0,3,3
14963,5,3,52286,52286,52289,0,3,2
14964,5,2,52291,52291,52293,0,2,2
14965,1,2,52292,52293,52295,1,3,0
14966,5,2,52297,52297,52299,0,2,2
14967,4,1,52301,52301,52302,0,1,2
14968,4,2,52305,52305,52307,0,2,3
14969,2,1,52307,52307,52308,0,1,0
14970,4,2,52311,52311,52313,0,2,3
14971,3,3,52314,52314,52317,0,3,1
14972,6,1,52320,52320,52321,0,1,3
14973,4,1,52324,52324,52325,0,1,3
14974,6,1,52330,52330,52331,0,1,5
14975,5,1,52335,52335,52336,0,1,4
14976,1,1,52336,52336,52337,0,1,0
14977,5,1,52341,52341,52342,0,1,4
14978,5,1,52346,52346,52347,0,1,4
14979,3,1,52349,52349,52350,0,1,2
14980,4,3,52353,52353,52356,0,3,3
14981,1,1,52354,52356,52357,2,3,0
14982,5,3,52359,52359,52362,0,3,2
14983,5,3,52364,52364,52367,0,3,2
14984,6,3,52370,52370,52373,0,3,3
14985,2,1,52372,52373,52374,1,2,0
14986,6,2,52378,52378,52380,0,2,4
14987,2,2,52380,52380,52382,0,2,0
14988,6,3,52386,52386,52389,0,3,4
14989,2,3,52388,52389,52392,1,4,0
14990,6,1,52394,52394,52395,0,1,2
14991,3,1,52397,52397,52398,0,1,2
14992,1,3,52398,52398,52401,0,3,0
14993,3,1,52401,52401,52402,0,1,0
14994,3,3,52404,52404,52407,0,3,2
14995,5,1,52409,52409,52410,0,1,2
14996,1,3,52410,52410,52413,0,3,0
14997,5,2,52415,52415,52417,0,2,2
14998,5,2,52420,52420,52422,0,2,3
14999,6,1,52426,52426,52427,0,1,4
15000,1,1,52427,52427,52428,0,1,0
15001,6,3,52433,52433,52436,0,3,5
15002,3,1,52436,52436,52437,0,1,0
15003,5,3,52441,52441,52444,0,3,4
15004,2,3,52443,52444,52447,1,4,0
15005,2,2,52445,52447,52449,2,4,0
15006,6,2,52451,52451,52453,0,2,2
15007,4,3,52455,52455,52458,0,3,2
15008,3,1,52458,52458,52459,0,1,0
15009,2,1,52460,52460,52461,0,1,1
15010,4,2,52464,52464,52466,0,2,3
15011,1,2,52465,52466,52468,1,3,0
15012,1,1,52466,52468,52469,2,3,0
15013,4,2,52470,52470,52472,0,2,1
15014,3,2,52473,52473,52475,0,2,1
15015,3,1,52476,52476,52477,0,1,1
15016,2,3,52478,52478,52481,0,3,1
15017,6,2,52484,52484,52486,0,2,3
15018,5,2,52489,52489,52491,0,2,3
15019,5,1,52494,52494,52495,0,1,3
15020,6,2,52500,52500,52502,0,2,5
15021,6,2,52506,52506,52508,0,2,4
15022,2,2,52508,52508,52510,0,2,0
15023,3,1,52511,52511,52512,0,1,1
15024,5,2,52516,52516,52518,0,2,4
15025,5,2,52521,52521,52523,0,2,3
15026,3,1,52524,52524,52525,0,1,1
15027,5,2,52529,52529,52531,0,2,4
15028,5,1,52534,52534,52535,0,1,3
15029,6,1,52540,52540,52541,0,1,5
15030,5,1,52545,52545,52546,0,1,4
15031,3,1,52548,52548,52549,0,1,2
15032,4,1,52552,52552,52553,0,1,3
15033,3,1,52555,52555,52556,0,1,2
15034,6,1,52561,52561,52562,0,1,5
15035,2,1,52563,52563,52564,0,1,1
15036,5,1,52568,52568,52569,0,1,4
15037,6,2,52574,52574,52576,0,2,5
15038,5,2,52579,52579,52581,0,2,3
15039,1,3,52580,52581,52584,1,4,0
15040,5,1,52585,52585,52586,0,1,1
15041,4,2,52589,52589,52591,0,2,3
15042,3,1,52592,52592,52593,0,1,1
15043,2,1,52594,52594,52595,0,1,1
15044,4,3,52598,52598,52601,0,3,3
15045,3,1,52601,52601,52602,0,1,0
15046,4,1,52605,52605,52606,0,1,3
15047,1,3,52606,52606,52609,0,3,0
15048,5,3,52611,52611,52614,0,3,2
15049,1,1,52612,52614,52615,2,3,0
15050,6,3,52618,52618,52621,0,3,3
15051,1,3,52619,52621,52624,2,5,0
15052,4,1,52623,52624,52625,1,2,0
15053,5,1,52628,52628,52629,0,1,3
15054,5,2,52633,52633,52635,0,2,4
15055,2,1,52635,52635,52636,0,1,0
15056,1,2,52636,52636,52638,0,2,0
15057,1,1,52637,52638,52639,1,2,0
15058,3,3,52640,52640,52643,0,3,1
15059,4,3,52644,52644,52647,0,3,1
15060,4,2,52648,52648,52650,0,2,1
15061,1,1,52649,52650,52651,1,2,0
15062,4,2,52653,52653,52655,0,2,2
15063,2,3,52655,52655,52658,0,3,0
15064,4,3,52659,52659,52662,0,3,1
15065,6,1,52665,52665,52666,0,1,3
15066,4,1,52669,52669,52670,0,1,3
15067,2,1,52671,52671,52672,0,1,1
15068,5,1,52676,52676,52677,0,1,4
15069,3,3,52679,52679,52682,0,3,2
15070,3,2,52682,52682,52684,0,2,0
15071,4,1,52686,52686,52687,0,1,2
15072,1,1,52687,52687,52688,0,1,0
15073,2,2,52689,52689,52691,0,2,1
15074,4,1,52693,52693,52694,0,1,2
15075,5,2,52698,52698,52700,0,2,4
15076,6,3,52704,52704,52707,0,3,4
15077,2,1,52706,52707,52708,1,2,0
15078,5,3,52711,52711,52714,0,3,3
15079,5,2,52716,52716,52718,0,2,2
15080,5,3,52721,52721,52724,0,3,3
15081,4,2,52725,52725,52727,0,2,1
15082,1,2,52726,52727,52729,1,3,0
15083,1,1,52727,52729,52730,2,3,0
15084,4,2,52731,52731,52733,0,2,1
15085,6,3,52737,52737,52740,0,3,4
15086,5,1,52742,52742,52743,0,1,2
15087,4,3,52746,52746,52749,0,3,3
15088,5,2,52751,52751,52753,0,2,2
15089,3,3,52754,52754,52757,0,3,1
15090,1,2,52755,52757,52759,2,4,0
15091,2,2,52757,52759,52761,2,4,0
15092,2,3,52759,52761,52764,2,5,0
15093,5,3,52764,52764,52767,0,3,0
15094,1,1,52765,52767,52768,2,3,0
15095,5,3,52770,52770,52773,0,3,2
15096,4,2,52774,52774,52776,0,2,1
15097,1,2,52775,52776,52778,1,3,0
15098,4,2,52779,52779,52781,0,2,1
15099,6,1,52785,52785,52786,0,1,4
15100,5,1,52790,52790,52791,0,1,4
15101,3,3,52793,52793,52796,0,3,2
15102,5,3,52798,52798,52801,0,3,2
15103,4,2,52802,52802,52804,0,2,1
15104,1,3,52803,52804,52807,1,4,0
15105,6,2,52809,52809,52811,0,2,2
15106,5,3,52814,52814,52817,0,3,3
15107,4,1,52818,52818,52819,0,1,1
15108,6,3,52824,52824,52827,0,3,5
15109,5,2,52829,52829,52831,0,2,2
15110,5,1,52834,52834,52835,0,1,3
15111,5,2,52839,52839,52841,0,2,4
15112,5,1,52844,52844,52845,0,1,3
15113,5,2,52849,52849,52851,0,2,4
15114,5,1,52854,52854,52855,0,1,3
15115,2,2,52856,52856,52858,0,2,1
15116,3,3,52859,52859,52862,0,3,1
15117,1,1,52860,52862,52863,2,3,0
15118,2,3,52862,52863,52866,1,4,0
15119,6,3,52868,52868,52871,0,3,2
15120,5,1,52873,52873,52874,0,1,2
15121,6,2,52879,52879,52881,0,2,5
15122,4,2,52883,52883,52885,0,2,2
15123,2,3,52885,52885,52888,0,3,0
15124,3,1,52888,52888,52889,0,1,0
15125,5,3,52893,52893,52896,0,3,4
15126,4,1,52897,52897,52898,0,1,1
15127,1,1,52898,52898,52899,0,1,0
15128,5,3,52903,52903,52906,0,3,4
15129,1,1,52904,52906,52907,2,3,0
15130,2,2,52906,52907,52909,1,3,0
15131,5,3,52911,52911,52914,0,3,2
15132,6,3,52917,52917,52920,0,3,3
15133,1,1,52918,52920,52921,2,3,0
15134,2,3,52920,52921,52924,1,4,0
15135,5,1,52925,52925,52926,0,1,1
15136,1,3,52926,52926,52929,0,3,0
15137,4,1,52930,52930,52931,0,1,1
15138,3,1,52933,52933,52934,0,1,2
15139,2,1,52935,52935,52936,0,1,1
15140,1,1,52936,52936,52937,0,1,0
15141,2,2,52938,52938,52940,0,2,1
15142,1,3,52939,52940,52943,1,4,0
15143,5,2,52944,52944,52946,0,2,1
15144,2,1,52946,52946,52947,0,1,0
15145,6,2,52952,52952,52954,0,2,5
15146,3,3,52955,52955,52958,0,3,1
15147,3,2,52958,52958,52960,0,2,0
15148,1,2,52959,52960,52962,1,3,0
15149,5,3,52964,52964,52967,0,3,2
15150,3,2,52967,52967,52969,0,2,0
15151,5,1,52972,52972,52973,0,1,3
15152,6,3,52978,52978,52981,0,3,5
15153,1,3,52979,52981,52984,2,5,0
15154,2,1,52981,52984,52985,3,4,0
15155,5,2,52986,52986,52988,0,2,1
15156,6,1,52992,52992,52993,0,1,4
15157,2,1,52994,52994,52995,0,1,1
15158,4,2,52998,52998,53000,0,2,3
15159,4,2,53002,53002,53004,0,2,2
15160,4,3,53006,53006,53009,0,3,2
15161,6,2,53012,53012,53014,0,2,3
15162,4,3,53016,53016,53019,0,3,2
15163,4,2,53020,53020,53022,0,2,1
15164,6,1,53026,53026,53027,0,1,4
15165,4,3,53030,53030,53033,0,3,3
15166,3,2,53033,53033,53035,0,2,0
15167,2,1,53035,53035,53036,0,1,0
15168,2,3,53037,53037,53040,0,3,1
15169,1,2,53038,53040,53042,2,4,0
15170,6,1,53044,53044,53045,0,1,2
15171,5,2,53049,53049,53051,0,2,4
15172,5,2,53054,53054,53056,0,2,3
15173,4,2,53058,53058,53060,0,2,2
15174,2,1,53060,53060,53061,0,1,0
15175,3,3,53063,53063,53066,0,3,2
15176,6,2,53069,53069,53071,0,2,3
15177,5,2,53074,53074,53076,0,2,3
15178,6,1,53080,53080,53081,0,1,4
15179,5,1,53085,53085,53086,0,1,4
15180,3,1,53088,53088,53089,0,1,2
15181,6,2,53094,53094,53096,0,2,5
15182,6,3,53100,53100,53103,0,3,4
15183,2,3,53102,53103,53106,1,4,0
15184,2,2,53104,53106,53108,2,4,0
15185,3,2,53107,53108,53110,1,3,0
15186,1,2,53108,53110,53112,2,4,0
15187,4,3,53112,53112,53115,0,3,0
15188,2,1,53114,53115,53116,1,2,0
15189,1,1,53115,53116,53117,1,2,0
15190,1,2,53116,53117,53119,1,3,0
15191,3,1,53119,53119,53120,0,1,0
15192,2,2,53121,53121,53123,0,2,1
15193,1,1,53122,53123,53124,1,2,0
15194,2,2,53124,53124,53126,0,2,0
15195,4,1,53128,53128,53129,0,1,2
15196,1,2,53129,53129,53131,0,2,0
15197,4,1,53133,53133,53134,0,1,2
15198,2,2,53135,53135,53137,0,2,1
15199,3,1,53138,53138,53139,0,1,1
15200,3,1,53141,53141,53142,0,1,2
15201,2,1,53143,53143,53144,0,1,1
15202,2,3,53145,53145,53148,0,3,1
15203,2,3,53147,53148,53151,1,4,0
15204,1,2,53148,53151,53153,3,5,0
15205,3,3,53151,53153,53156,2,5,0
15206,2,3,53153,53156,53159,3,6,0
15207,3,1,53156,53159,53160,3,4,0
15208,5,3,53161,53161,53164,0,3,1
15209,5,2,53166,53166,53168,0,2,2
15210,1,2,53167,53168,53170,1,3,0
15211,5,2,53172,53172,53174,0,2,2
15212,2,1,53174,53174,53175,0,1,0
15213,2,1,53176,53176,53177,0,1,1
15214,1,2,53177,53177,53179,0,2,0
15215,4,3,53181,53181,53184,0,3,2
15216,6,1,53187,53187,53188,0,1,3
15217,3,2,53190,53190,53192,0,2,2
15218,3,3,53193,53193,53196,0,3,1
15219,1,2,53194,53196,53198,2,4,0
15220,1,2,53195,53198,53200,3,5,0
15221,2,2,53197,53200,53202,3,5,0
15222,5,1,53202,53202,53203,0,1,0
15223,2,2,53204,53204,53206,0,2,1
15224,5,3,53209,53209,53212,0,3,3
15225,5,3,53214,53214,53217,0,3,2
15226,6,3,53220,53220,53223,0,3,3
15227,5,1,53225,53225,53226,0,1,2
15228,4,2,53229,53229,53231,0,2,3
15229,5,3,53234,53234,53237,0,3,3
15230,1,3,53235,53237,53240,2,5,0
15231,3,2,53238,53240,53242,2,4,0
15232,2,3,53240,53242,53245,2,5,0
15233,5,1,53245,53245,53246,0,1,0
15234,5,1,53250,53250,53251,0,1,4
15235,2,2,53252,53252,53254,0,2,1
15236,4,2,53256,53256,53258,0,2,2
15237,1,1,53257,53258,53259,1,2,0
15238,1,3,53258,53259,53262,1,4,0
15239,4,1,53262,53262,53263,0,1,0
15240,4,2,53266,53266,53268,0,2,3
15241,6,1,53272,53272,53273,0,1,4
15242,2,1,53274,53274,53275,0,1,1
15243,2,3,53276,53276,53279,0,3,1
15244,5,2,53281,53281,53283,0,2,2
15245,5,1,53286,53286,53287,0,1,3
15246,6,3,53292,53292,53295,0,3,5
15247,3,3,53295,53295,53298,0,3,0
15248,1,3,53296,53298,53301,2,5,0
15249,1,2,53297,53301,53303,4,6,0
15250,5,1,53302,53303,53304,1,2,0
15251,2,2,53304,53304,53306,0,2,0
15252,4,2,53308,53308,53310,0,2,2
15253,4,1,53312,53312,53313,0,1,2
15254,5,2,53317,53317,53319,0,2,4
15255,5,2,53322,53322,53324,0,2,3
15256,5,2,53327,53327,53329,0,2,3
15257,2,2,53329,53329,53331,0,2,0
15258,6,1,53335,53335,53336,0,1,4
15259,6,3,53341,53341,53344,0,3,5
15260,3,3,53344,53344,53347,0,3,0
15261,2,1,53346,53347,53348,1,2,0
15262,2,1,53348,53348,53349,0,1,0
15263,1,2,53349,53349,53351,0,2,0
15264,1,2,53350,53351,53353,1,3,0
15265,1,2,53351,53353,53355,2,4,0
15266,6,1,53357,53357,53358,0,1,2
15267,3,1,53360,53360,53361,0,1,2
15268,6,1,53366,53366,53367,0,1,5
15269,3,1,53369,53369,53370,0,1,2
15270,2,3,53371,53371,53374,0,3,1
15271,3,3,53374,53374,53377,0,3,0
15272,3,1,53377,53377,53378,0,1,0
15273,2,2,53379,53379,53381,0,2,1
15274,5,1,53384,53384,53385,0,1,3
15275,4,2,53388,53388,53390,0,2,3
15276,2,2,53390,53390,53392,0,2,0
15277,3,2,53393,53393,53395,0,2,1
15278,1,1,53394,53395,53396,1,2,0
15279,6,3,53400,53400,53403,0,3,4
15280,5,2,53405,53405,53407,0,2,2
15281,1,2,53406,53407,53409,1,3,0
15282,1,3,53407,53409,53412,2,5,0
15283,1,1,53408,53412,53413,4,5,0
15284,3,2,53411,53413,53415,2,4,0
15285,1,1,53412,53415,53416,3,4,0
15286,2,3,53414,53416,53419,2,5,0
15287,3,3,53417,53419,53422,2,5,0
15288,6,2,53423,53423,53425,0,2,1
15289,4,1,53427,53427,53428,0,1,2
15290,2,1,53429,53429,53430,0,1,1
15291,2,3,53431,53431,53434,0,3,1
15292,3,3,53434,53434,53437,0,3,0
15293,1,3,53435,53437,53440,2,5,0
15294,6,3,53441,53441,53444,0,3,1
15295,1,3,53442,53444,53447,2,5,0
15296,6,2,53448,53448,53450,0,2,1
15297,2,2,53450,53450,53452,0,2,0
15298,4,3,53454,53454,53457,0,3,2
15299,6,2,53460,53460,53462,0,2,3
15300,1,3,53461,53462,53465,1,4,0
15301,1,2,53462,53465,53467,3,5,0
15302,4,3,53466,53467,53470,1,4,0
15303,6,3,53472,53472,53475,0,3,2
15304,6,3,53478,53478,53481,0,3,3
15305,3,3,53481,53481,53484,0,3,0
15306,1,3,53482,53484,53487,2,5,0
15307,3,1,53485,53487,53488,2,3,0
15308,6,1,53491,53491,53492,0,1,3
15309,2,2,53493,53493,53495,0,2,1
15310,6,3,53499,53499,53502,0,3,4
15311,3,1,53502,53502,53503,0,1,0
15312,4,1,53506,53506,53507,0,1,3
15313,1,1,53507,53507,53508,0,1,0
15314,1,2,53508,53508,53510,0,2,0
15315,4,1,53512,53512,53513,0,1,2
15316,1,3,53513,53513,53516,0,3,0
15317,6,2,53519,53519,53521,0,2,3
15318,1,2,53520,53521,53523,1,3,0
15319,5,3,53525,53525,53528,0,3,2
15320,3,2,53528,53528,53530,0,2,0
15321,6,1,53534,53534,53535,0,1,4
15322,5,3,53539,53539,53542,0,3,4
15323,4,3,53543,53543,53546,0,3,1
15324,4,2,53547,53547,53549,0,2,1
15325,3,2,53550,53550,53552,0,2,1
15326,6,2,53556,53556,53558,0,2,4
15327,6,2,53562,53562,53564,0,2,4
15328,4,3,53566,53566,53569,0,3,2
15329,6,1,53572,53572,53573,0,1,3
15330,6,2,53578,53578,53580,0,2,5
15331,4,1,53582,53582,53583,0,1,2
15332,1,3,53583,53583,53586,0,3,0
15333,5,3,53588,53588,53591,0,3,2
15334,4,2,53592,53592,53594,0,2,1
15335,3,2,53595,53595,53597,0,2,1
15336,3,3,53598,53598,53601,0,3,1
15337,2,2,53600,53601,53603,1,3,0
15338,3,1,53603,53603,53604,0,1,0
15339,2,2,53605,53605,53607,0,2,1
15340,1,1,53606,53607,53608,1,2,0
15341,2,3,53608,53608,53611,0,3,0
15342,6,3,53614,53614,53617,0,3,3
15343,4,2,53618,53618,53620,0,2,1
15344,6,1,53624,53624,53625,0,1,4
15345,6,3,53630,53630,53633,0,3,5
15346,1,1,53631,53633,53634,2,3,0
15347,4,1,53635,53635,53636,0,1,1
15348,4,1,53639,53639,53640,0,1,3
15349,6,1,53645,53645,53646,0,1,5
15350,4,3,53649,53649,53652,0,3,3
15351,5,1,53654,53654,53655,0,1,2
15352,4,3,53658,53658,53661,0,3,3
15353,3,2,53661,53661,53663,0,2,0
15354,2,3,53663,53663,53666,0,3,0
15355,4,3,53667,53667,53670,0,3,1
15356,4,1,53671,53671,53672,0,1,1
15357,3,3,53674,53674,53677,0,3,2
15358,1,3,53675,53677,53680,2,5,0
15359,3,1,53678,53680,53681,2,3,0
15360,1,1,53679,53681,53682,2,3,0
15361,4,3,53683,53683,53686,0,3,1
15362,6,1,53689,53689,53690,0,1,3
15363,4,2,53693,53693,53695,0,2,3
15364,6,2,53699,53699,53701,0,2,4
15365,1,3,53700,53701,53704,1,4,0
15366,6,1,53706,53706,53707,0,1,2
15367,6,3,53712,53712,53715,0,3,5
15368,2,1,53714,53715,53716,1,2,0
15369,5,3,53719,53719,53722,0,3,3
15370,5,3,53724,53724,53727,0,3,2
15371,3,1,53727,53727,53728,0,1,0
15372,6,1,53733,53733,53734,0,1,5
15373,2,2,53735,53735,53737,0,2,1
15374,1,2,53736,53737,53739,1,3,0
15375,2,1,53738,53739,53740,1,2,0
15376,1,3,53739,53740,53743,1,4,0
15377,1,1,53740,53743,53744,3,4,0
15378,5,2,53745,53745,53747,0,2,1
15379,6,3,53751,53751,53754,0,3,4
15380,1,3,53752,53754,53757,2,5,0
15381,3,3,53755,53757,53760,2,5,0
15382,5,1,53760,53760,53761,0,1,0
15383,2,3,53762,53762,53765,0,3,1
15384,5,2,53767,53767,53769,0,2,2
15385,4,3,53771,53771,53774,0,3,2
15386,6,1,53777,53777,53778,0,1,3
15387,4,2,53781,53781,53783,0,2,3
15388,6,2,53787,53787,53789,0,2,4
15389,3,2,53790,53790,53792,0,2,1
15390,2,2,53792,53792,53794,0,2,0
15391,4,1,53796,53796,53797,0,1,2
15392,1,1,53797,53797,53798,0,1,0
15393,1,3,53798,53798,53801,0,3,0
15394,4,3,53802,53802,53805,0,3,1
15395,3,1,53805,53805,53806,0,1,0
15396,1,2,53806,53806,53808,0,2,0
15397,2,1,53808,53808,53809,0,1,0
15398,6,2,53814,53814,53816,0,2,5
15399,3,1,53817,53817,53818,0,1,1
15400,5,3,53822,53822,53825,0,3,4
15401,6,3,53828,53828,53831,0,3,3
15402,4,1,53832,53832,53833,0,1,1
15403,2,2,53834,53834,53836,0,2,1
15404,4,3,53838,53838,53841,0,3,2
15405,2,2,53840,53841,53843,1,3,0
15406,3,1,53843,53843,53844,0,1,0
15407,1,1,53844,53844,53845,0,1,0
15408,6,2,53850,53850,53852,0,2,5
15409,2,1,53852,53852,53853,0,1,0
15410,2,3,53854,53854,53857,0,3,1
15411,2,1,53856,53857,53858,1,2,0
15412,4,1,53860,53860,53861,0,1,2
15413,2,1,53862,53862,53863,0,1,1
15414,5,1,53867,53867,53868,0,1,4
15415,6,1,53873,53873,53874,0,1,5
15416,3,1,53876,53876,53877,0,1,2
15417,4,1,53880,53880,53881,0,1,3
15418,3,3,53883,53883,53886,0,3,2
15419,4,1,53887,53887,53888,0,1,1
15420,2,2,53889,53889,53891,0,2,1
15421,6,1,53895,53895,53896,0,1,4
15422,2,1,53897,53897,53898,0,1,1
15423,5,3,53902,53902,53905,0,3,4
15424,6,2,53908,53908,53910,0,2,3
15425,5,3,53913,53913,53916,0,3,3
15426,3,3,53916,53916,53919,0,3,0
15427,5,3,53921,53921,53924,0,3,2
15428,4,2,53925,53925,53927,0,2,1
15429,6,3,53931,53931,53934,0,3,4
15430,3,3,53934,53934,53937,0,3,0
15431,4,1,53938,53938,53939,0,1,1
15432,2,1,53940,53940,53941,0,1,1
15433,4,2,53944,53944,53946,0,2,3
15434,1,2,53945,53946,53948,1,3,0
15435,2,1,53947,53948,53949,1,2,0
15436,5,1,53952,53952,53953,0,1,3
15437,6,1,53958,53958,53959,0,1,5
15438,5,2,53963,53963,53965,0,2,4
15439,6,2,53969,53969,53971,0,2,4
15440,3,1,53972,53972,53973,0,1,1
15441,6,3,53978,53978,53981,0,3,5
15442,4,1,53982,53982,53983,0,1,1
15443,6,3,53988,53988,53991,0,3,5
15444,5,3,53993,53993,53996,0,3,2
15445,1,2,53994,53996,53998,2,4,0
15446,3,1,53997,53998,53999,1,2,0
15447,2,2,53999,53999,54001,0,2,0
15448,3,1,54002,54002,54003,0,1,1
15449,1,3,54003,54003,54006,0,3,0
15450,4,1,54007,54007,54008,0,1,1
15451,3,1,54010,54010,54011,0,1,2
15452,1,2,54011,54011,54013,0,2,0
15453,4,1,54015,54015,54016,0,1,2
15454,2,1,54017,54017,54018,0,1,1
15455,3,3,54020,54020,54023,0,3,2
15456,5,2,54025,54025,54027,0,2,2
15457,5,3,54030,54030,54033,0,3,3
15458,5,2,54035,54035,54037,0,2,2
15459,4,2,54039,54039,54041,0,2,2
15460,2,1,54041,54041,54042,0,1,0
15461,6,3,54047,54047,54050,0,3,5
15462,4,1,54051,54051,54052,0,1,1
15463,4,3,54055,54055,54058,0,3,3
15464,4,3,54059,54059,54062,0,3,1
15465,6,3,54065,54065,54068,0,3,3
15466,6,1,54071,54071,54072,0,1,3
15467,6,3,54077,54077,54080,0,3,5
15468,1,3,54078,54080,54083,2,5,0
15469,1,2,54079,54083,54085,4,6,0
15470,4,2,54083,54085,54087,2,4,0
15471,1,2,54084,54087,54089,3,5,0
15472,3,1,54087,54089,54090,2,3,0
15473,3,2,54090,54090,54092,0,2,0
15474,2,2,54092,54092,54094,0,2,0
15475,5,3,54097,54097,54100,0,3,3
15476,6,2,54103,54103,54105,0,2,3
15477,6,3,54109,54109,54112,0,3,4
15478,6,1,54115,54115,54116,0,1,3
15479,3,3,54118,54118,54121,0,3,2
15480,1,2,54119,54121,54123,2,4,0
15481,1,3,54120,54123,54126,3,6,0
15482,3,1,54123,54126,54127,3,4,0
15483,1,2,54124,54127,54129,3,5,0
15484,4,2,54128,54129,54131,1,3,0
15485,1,2,54129,54131,54133,2,4,0
15486,6,2,54135,54135,54137,0,2,2
15487,5,1,54140,54140,54141,0,1,3
15488,6,3,54146,54146,54149,0,3,5
15489,2,2,54148,54149,54151,1,3,0
15490,1,3,54149,54151,54154,2,5,0
15491,1,2,54150,54154,54156,4,6,0
15492,4,2,54154,54156,54158,2,4,0
15493,2,2,54156,54158,54160,2,4,0
15494,6,1,54162,54162,54163,0,1,2
15495,6,1,54168,54168,54169,0,1,5
15496,4,2,54172,54172,54174,0,2,3
15497,3,1,54175,54175,54176,0,1,1
15498,2,3,54177,54177,54180,0,3,1
15499,3,1,54180,54180,54181,0,1,0
15500,4,2,54184,54184,54186,0,2,3
15501,1,1,54185,54186,54187,1,2,0
15502,5,2,54190,54190,54192,0,2,3
15503,1,1,54191,54192,54193,1,2,0
15504,2,1,54193,54193,54194,0,1,0
15505,6,1,54199,54199,54200,0,1,5
15506,3,3,54202,54202,54205,0,3,2
15507,1,3,54203,54205,54208,2,5,0
15508,2,3,54205,54208,54211,3,6,0
15509,1,3,54206,54211,54214,5,8,0
15510,5,1,54211,54214,54215,3,4,0
15511,6,1,54217,54217,54218,0,1,2
15512,3,3,54220,54220,54223,0,3,2
15513,1,1,54221,54223,54224,2,3,0
15514,3,1,54224,54224,54225,0,1,0
15515,2,3,54226,54226,54229,0,3,1
15516,5,2,54231,54231,54233,0,2,2
15517,3,2,54234,54234,54236,0,2,1
15518,1,2,54235,54236,54238,1,3,0
15519,5,2,54240,54240,54242,0,2,2
15520,2,2,54242,54242,54244,0,2,0
15521,3,3,54245,54245,54248,0,3,1
15522,3,2,54248,54248,54250,0,2,0
15523,4,2,54252,54252,54254,0,2,2
15524,2,2,54254,54254,54256,0,2,0
15525,3,2,54257,54257,54259,0,2,1
15526,6,2,54263,54263,54265,0,2,4
15527,1,1,54264,54265,54266,1,2,0
15528,2,3,54266,54266,54269,0,3,0
15529,3,3,54269,54269,54272,0,3,0
15530,3,1,54272,54272,54273,0,1,0
15531,2,2,54274,54274,54276,0,2,1
15532,5,3,54279,54279,54282,0,3,3
15533,5,3,54284,54284,54287,0,3,2
15534,1,1,54285,54287,54288,2,3,0
15535,5,2,54290,54290,54292,0,2,2
15536,2,1,54292,54292,54293,0,1,0
15537,3,1,54295,54295,54296,0,1,2
15538,2,2,54297,54297,54299,0,2,1
15539,5,2,54302,54302,54304,0,2,3
15540,6,3,54308,54308,54311,0,3,4
15541,3,2,54311,54311,54313,0,2,0
15542,5,2,54316,54316,54318,0,2,3
15543,3,3,54319,54319,54322,0,3,1
15544,3,1,54322,54322,54323,0,1,0
15545,4,1,54326,54326,54327,0,1,3
15546,3,1,54329,54329,54330,0,1,2
15547,5,2,54334,54334,54336,0,2,4
15548,2,3,54336,54336,54339,0,3,0
15549,4,3,54340,54340,54343,0,3,1
15550,3,2,54343,54343,54345,0,2,0
15551,1,2,54344,54345,54347,1,3,0
15552,2,2,54346,54347,54349,1,3,0
15553,5,1,54351,54351,54352,0,1,2
15554,4,2,54355,54355,54357,0,2,3
15555,1,2,54356,54357,54359,1,3,0
15556,2,1,54358,54359,54360,1,2,0
15557,4,3,54362,54362,54365,0,3,2
15558,4,2,54366,54366,54368,0,2,1
15559,4,2,54370,54370,54372,0,2,2
15560,6,1,54376,54376,54377,0,1,4
15561,4,2,54380,54380,54382,0,2,3
15562,3,2,54383,54383,54385,0,2,1
15563,5,1,54388,54388,54389,0,1,3
15564,4,1,54392,54392,54393,0,1,3
15565,6,3,54398,54398,54401,0,3,5
15566,3,1,54401,54401,54402,0,1,0
15567,3,3,54404,54404,54407,0,3,2
15568,2,3,54406,54407,54410,1,4,0
15569,4,1,54410,54410,54411,0,1,0
15570,4,3,54414,54414,54417,0,3,3
15571,5,3,54419,54419,54422,0,3,2
15572,6,3,54425,54425,54428,0,3,3
15573,5,2,54430,54430,54432,0,2,2
15574,5,3,54435,54435,54438,0,3,3
15575,2,3,54437,54438,54441,1,4,0
15576,2,1,54439,54441,54442,2,3,0
15577,5,2,54444,54444,54446,0,2,2
15578,2,2,54446,54446,54448,0,2,0
15579,1,3,54447,54448,54451,1,4,0
15580,4,1,54451,54451,54452,0,1,0
15581,3,3,54454,54454,54457,0,3,2
15582,5,2,54459,54459,54461,0,2,2
15583,4,3,54463,54463,54466,0,3,2
15584,2,3,54465,54466,54469,1,4,0
15585,6,1,54471,54471,54472,0,1,2
15586,2,2,54473,54473,54475,0,2,1
15587,2,2,54475,54475,54477,0,2,0
15588,1,1,54476,54477,54478,1,2,0
15589,6,1,54482,54482,54483,0,1,4
15590,1,3,54483,54483,54486,0,3,0
15591,5,1,54488,54488,54489,0,1,2
15592,1,2,54489,54489,54491,0,2,0
15593,6,3,54495,54495,54498,0,3,4
15594,3,2,54498,54498,54500,0,2,0
15595,5,2,54503,54503,54505,0,2,3
15596,3,1,54506,54506,54507,0,1,1
15597,1,2,54507,54507,54509,0,2,0
15598,3,1,54510,54510,54511,0,1,1
15599,5,1,54515,54515,54516,0,1,4
15600,1,3,54516,54516,54519,0,3,0
15601,6,3,54522,54522,54525,0,3,3
15602,2,2,54524,54525,54527,1,3,0
15603,2,2,54526,54527,54529,1,3,0
15604,5,1,54531,54531,54532,0,1,2
15605,2,3,54533,54533,54536,0,3,1
15606,2,1,54535,54536,54537,1,2,0
15607,1,3,54536,54537,54540,1,4,0
15608,5,2,54541,54541,54543,0,2,1
15609,4,2,54545,54545,54547,0,2,2
15610,5,3,54550,54550,54553,0,3,3
15611,1,2,54551,54553,54555,2,4,0
15612,1,1,54552,54555,54556,3,4,0
15613,3,2,54555,54556,54558,1,3,0
15614,3,1,54558,54558,54559,0,1,0
15615,6,3,54564,54564,54567,0,3,5
15616,1,1,54565,54567,54568,2,3,0
15617,3,3,54568,54568,54571,0,3,0
15618,2,3,54570,54571,54574,1,4,0
15619,5,2,54575,54575,54577,0,2,1
15620,5,3,54580,54580,54583,0,3,3
15621,3,1,54583,54583,54584,0,1,0
15622,1,1,54584,54584,54585,0,1,0
15623,5,3,54589,54589,54592,0,3,4
15624,1,2,54590,54592,54594,2,4,0
15625,2,1,54592,54594,54595,2,3,0
15626,2,2,54594,54595,54597,1,3,0
15627,1,1,54595,54597,54598,2,3,0
15628,1,1,54596,54598,54599,2,3,0
15629,1,3,54597,54599,54602,2,5,0
15630,6,1,54603,54603,54604,0,1,1
15631,2,1,54605,54605,54606,0,1,1
15632,2,2,54607,54607,54609,0,2,1
15633,4,1,54611,54611,54612,0,1,2
15634,3,2,54614,54614,54616,0,2,2
15635,6,1,54620,54620,54621,0,1,4
15636,4,1,54624,54624,54625,0,1,3
15637,3,3,54627,54627,54630,0,3,2
15638,6,2,54633,54633,54635,0,2,3
15639,1,1,54634,54635,54636,1,2,0
15640,2,1,54636,54636,54637,0,1,0
15641,1,2,54637,54637,54639,0,2,0
15642,6,2,54643,54643,54645,0,2,4
15643,2,2,54645,54645,54647,0,2,0
15644,3,3,54648,54648,54651,0,3,1
15645,5,1,54653,54653,54654,0,1,2
15646,5,2,54658,54658,54660,0,2,4
15647,4,3,54662,54662,54665,0,3,2
15648,1,2,54663,54665,54667,2,4,0
15649,3,3,54666,54667,54670,1,4,0
15650,4,1,54670,54670,54671,0,1,0
15651,4,2,54674,54674,54676,0,2,3
15652,2,3,54676,54676,54679,0,3,0
15653,4,1,54680,54680,54681,0,1,1
15654,1,2,54681,54681,54683,0,2,0
15655,1,1,54682,54683,54684,1,2,0
15656,3,2,54685,54685,54687,0,2,1
15657,4,3,54689,54689,54692,0,3,2
15658,3,1,54692,54692,54693,0,1,0
15659,1,2,54693,54693,54695,0,2,0
15660,5,1,54698,54698,54699,0,1,3
15661,6,3,54704,54704,54707,0,3,5
15662,4,2,54708,54708,54710,0,2,1
15663,4,3,54712,54712,54715,0,3,2
15664,3,1,54715,54715,54716,0,1,0
15665,5,1,54720,54720,54721,0,1,4
15666,3,3,54723,54723,54726,0,3,2
15667,5,2,54728,54728,54730,0,2,2
15668,4,3,54732,54732,54735,0,3,2
15669,6,2,54738,54738,54740,0,2,3
15670,4,3,54742,54742,54745,0,3,2
15671,4,2,54746,54746,54748,0,2,1
15672,4,2,54750,54750,54752,0,2,2
15673,3,3,54753,54753,54756,0,3,1
15674,2,3,54755,54756,54759,1,4,0
15675,3,2,54758,54759,54761,1,3,0
15676,3,2,54761,54761,54763,0,2,0
15677,1,1,54762,54763,54764,1,2,0
15678,4,1,54766,54766,54767,0,1,2
15679,6,1,54772,54772,54773,0,1,5
15680,4,3,54776,54776,54779,0,3,3
15681,4,2,54780,54780,54782,0,2,1
15682,5,1,54785,54785,54786,0,1,3
15683,1,3,54786,54786,54789,0,3,0
15684,5,2,54791,54791,54793,0,2,2
15685,1,3,54792,54793,54796,1,4,0
15686,3,3,54795,54796,54799,1,4,0
15687,5,2,54800,54800,54802,0,2,1
15688,3,2,54803,54803,54805,0,2,1
15689,5,2,54808,54808,54810,0,2,3
15690,6,3,54814,54814,54817,0,3,4
15691,3,1,54817,54817,54818,0,1,0
15692,5,1,54822,54822,54823,0,1,4
15693,1,2,54823,54823,54825,0,2,0
15694,3,2,54826,54826,54828,0,2,1
15695,1,2,54827,54828,54830,1,3,0
15696,1,3,54828,54830,54833,2,5,0
15697,2,1,54830,54833,54834,3,4,0
15698,2,2,54832,54834,54836,2,4,0
15699,6,3,54838,54838,54841,0,3,2
15700,4,1,54842,54842,54843,0,1,1
15701,4,3,54846,54846,54849,0,3,3
15702,4,3,54850,54850,54853,0,3,1
15703,6,1,54856,54856,54857,0,1,3
15704,1,3,54857,54857,54860,0,3,0
15705,5,3,54862,54862,54865,0,3,2
15706,2,1,54864,54865,54866,1,2,0
15707,3,2,54867,54867,54869,0,2,1
15708,3,2,54870,54870,54872,0,2,1
15709,3,2,54873,54873,54875,0,2,1
15710,6,2,54879,54879,54881,0,2,4
15711,6,3,54885,54885,54888,0,3,4
15712,4,3,54889,54889,54892,0,3,1
15713,5,2,54894,54894,54896,0,2,2
15714,6,2,54900,54900,54902,0,2,4
15715,6,1,54906,54906,54907,0,1,4
15716,6,2,54912,54912,54914,0,2,5
15717,6,1,54918,54918,54919,0,1,4
15718,6,2,54924,54924,54926,0,2,5
15719,3,1,54927,54927,54928,0,1,1
15720,4,2,54931,54931,54933,0,2,3
15721,6,3,54937,54937,54940,0,3,4
15722,6,3,54943,54943,54946,0,3,3
15723,4,1,54947,54947,54948,0,1,1
15724,1,1,54948,54948,54949,0,1,0
15725,3,3,54951,54951,54954,0,3,2
15726,2,3,54953,54954,54957,1,4,0
15727,1,2,54954,54957,54959,3,5,0
15728,6,3,54960,54960,54963,0,3,1
15729,6,1,54966,54966,54967,0,1,3
15730,3,3,54969,54969,54972,0,3,2
15731,4,1,54973,54973,54974,0,1,1
15732,2,1,54975,54975,54976,0,1,1
15733,5,2,54980,54980,54982,0,2,4
15734,3,1,54983,54983,54984,0,1,1
15735,2,2,54985,54985,54987,0,2,1
15736,3,3,54988,54988,54991,0,3,1
15737,3,3,54991,54991,54994,0,3,0
15738,4,1,54995,54995,54996,0,1,1
15739,6,2,55001,55001,55003,0,2,5
15740,2,2,55003,55003,55005,0,2,0
15741,6,3,55009,55009,55012,0,3,4
15742,4,2,55013,55013,55015,0,2,1
15743,3,3,55016,55016,55019,0,3,1
15744,6,1,55022,55022,55023,0,1,3
15745,5,2,55027,55027,55029,0,2,4
15746,5,3,55032,55032,55035,0,3,3
15747,1,1,55033,55035,55036,2,3,0
15748,5,3,55038,55038,55041,0,3,2
15749,5,3,55043,55043,55046,0,3,2
15750,2,3,55045,55046,55049,1,4,0
15751,5,1,55050,55050,55051,0,1,1
15752,3,3,55053,55053,55056,0,3,2
15753,5,2,55058,55058,55060,0,2,2
15754,6,2,55064,55064,55066,0,2,4
15755,2,3,55066,55066,55069,0,3,0
15756,5,1,55071,55071,55072,0,1,2
15757,2,1,55073,55073,55074,0,1,1
15758,2,3,55075,55075,55078,0,3,1
15759,2,1,55077,55078,55079,1,2,0
15760,1,1,55078,55079,55080,1,2,0
15761,2,1,55080,55080,55081,0,1,0
15762,6,3,55086,55086,55089,0,3,5
15763,5,2,55091,55091,55093,0,2,2
15764,5,2,55096,55096,55098,0,2,3
15765,6,2,55102,55102,55104,0,2,4
15766,4,3,55106,55106,55109,0,3,2
15767,3,3,55109,55109,55112,0,3,0
15768,4,3,55113,55113,55116,0,3,1
15769,1,3,55114,55116,55119,2,5,0
15770,1,1,55115,55119,55120,4,5,0
15771,4,2,55119,55120,55122,1,3,0
15772,1,1,55120,55122,55123,2,3,0
15773,6,2,55126,55126,55128,0,2,3
15774,1,2,55127,55128,55130,1,3,0
15775,2,2,55129,55130,55132,1,3,0
15776,4,3,55133,55133,55136,0,3,1
15777,5,2,55138,55138,55140,0,2,2
15778,2,2,55140,55140,55142,0,2,0
15779,3,1,55143,55143,55144,0,1,1
15780,2,3,55145,55145,55148,0,3,1
15781,2,2,55147,55148,55150,1,3,0
15782,1,3,55148,55150,55153,2,5,0
15783,5,1,55153,55153,55154,0,1,0
15784,6,2,55159,55159,55161,0,2,5
15785,4,2,55163,55163,55165,0,2,2
15786,2,1,55165,55165,55166,0,1,0
15787,3,2,55168,55168,55170,0,2,2
15788,2,2,55170,55170,55172,0,2,0
15789,6,1,55176,55176,55177,0,1,4
15790,3,2,55179,55179,55181,0,2,2
15791,5,1,55184,55184,55185,0,1,3
15792,5,1,55189,55189,55190,0,1,4
15793,5,2,55194,55194,55196,0,2,4
15794,3,1,55197,55197,55198,0,1,1
15795,2,2,55199,55199,55201,0,2,1
15796,6,1,55205,55205,55206,0,1,4
15797,2,1,55207,55207,55208,0,1,1
15798,3,3,55210,55210,55213,0,3,2
15799,2,3,55212,55213,55216,1,4,0
15800,4,3,55216,55216,55219,0,3,0
15801,3,1,55219,55219,55220,0,1,0
15802,5,3,55224,55224,55227,0,3,4
15803,1,2,55225,55227,55229,2,4,0
15804,3,2,55228,55229,55231,1,3,0
15805,2,1,55230,55231,55232,1,2,0
15806,3,3,55233,55233,55236,0,3,1
15807,5,1,55238,55238,55239,0,1,2
15808,6,2,55244,55244,55246,0,2,5
15809,4,3,55248,55248,55251,0,3,2
15810,4,2,55252,55252,55254,0,2,1
15811,2,3,55254,55254,55257,0,3,0
15812,4,3,55258,55258,55261,0,3,1
15813,3,3,55261,55261,55264,0,3,0
15814,6,3,55267,55267,55270,0,3,3
15815,2,2,55269,55270,55272,1,3,0
15816,4,3,55273,55273,55276,0,3,1
15817,1,1,55274,55276,55277,2,3,0
15818,5,3,55279,55279,55282,0,3,2
15819,1,2,55280,55282,55284,2,4,0
15820,1,3,55281,55284,55287,3,6,0
15821,6,1,55287,55287,55288,0,1,0
15822,4,3,55291,55291,55294,0,3,3
15823,6,1,55297,55297,55298,0,1,3
15824,3,2,55300,55300,55302,0,2,2
15825,3,3,55303,55303,55306,0,3,1
15826,5,1,55308,55308,55309,0,1,2
15827,4,2,55312,55312,55314,0,2,3
15828,3,1,55315,55315,55316,0,1,1
15829,6,3,55321,55321,55324,0,3,5
15830,3,3,55324,55324,55327,0,3,0
15831,5,3,55329,55329,55332,0,3,2
15832,1,1,55330,55332,55333,2,3,0
15833,6,1,55336,55336,55337,0,1,3
15834,3,3,55339,55339,55342,0,3,2
15835,5,1,55344,55344,55345,0,1,2
15836,5,1,55349,55349,55350,0,1,4
15837,5,3,55354,55354,55357,0,3,4
15838,4,2,55358,55358,55360,0,2,1
15839,6,3,55364,55364,55367,0,3,4
15840,2,3,55366,55367,55370,1,4,0
15841,1,1,55367,55370,55371,3,4,0
15842,1,2,55368,55371,55373,3,5,0
15843,3,3,55371,55373,55376,2,5,0
15844,6,2,55377,55377,55379,0,2,1
15845,3,3,55380,55380,55383,0,3,1
15846,3,2,55383,55383,55385,0,2,0
15847,4,1,55387,55387,55388,0,1,2
15848,4,3,55391,55391,55394,0,3,3
15849,1,2,55392,55394,55396,2,4,0
15850,3,2,55395,55396,55398,1,3,0
15851,4,3,55399,55399,55402,0,3,1
15852,6,2,55405,55405,55407,0,2,3
15853,6,2,55411,55411,55413,0,2,4
15854,1,3,55412,55413,55416,1,4,0
15855,4,2,55416,55416,55418,0,2,0
15856,4,2,55420,55420,55422,0,2,2
15857,5,1,55425,55425,55426,0,1,3
15858,2,3,55427,55427,55430,0,3,1
15859,4,3,55431,55431,55434,0,3,1
15860,5,3,55436,55436,55439,0,3,2
15861,3,3,55439,55439,55442,0,3,0
15862,6,1,55445,55445,55446,0,1,3
15863,5,1,55450,55450,55451,0,1,4
15864,5,2,55455,55455,55457,0,2,4
15865,1,3,55456,55457,55460,1,4,0
15866,2,2,55458,55460,55462,2,4,0
15867,5,3,55463,55463,55466,0,3,1
15868,4,3,55467,55467,55470,0,3,1
15869,6,3,55473,55473,55476,0,3,3
15870,2,2,55475,55476,55478,1,3,0
15871,3,1,55478,55478,55479,0,1,0
15872,5,3,55483,55483,55486,0,3,4
15873,3,3,55486,55486,55489,0,3,0
15874,4,3,55490,55490,55493,0,3,1
15875,5,1,55495,55495,55496,0,1,2
15876,6,2,55501,55501,55503,0,2,5
15877,2,3,55503,55503,55506,0,3,0
15878,5,3,55508,55508,55511,0,3,2
15879,3,3,55511,55511,55514,0,3,0
15880,3,1,55514,55514,55515,0,1,0
15881,1,3,55515,55515,55518,0,3,0
15882,2,1,55517,55518,55519,1,2,0
15883,6,2,55523,55523,55525,0,2,4
15884,4,2,55527,55527,55529,0,2,2
15885,4,2,55531,55531,55533,0,2,2
15886,3,3,55534,55534,55537,0,3,1
15887,5,3,55539,55539,55542,0,3,2
15888,3,2,55542,55542,55544,0,2,0
15889,3,3,55545,55545,55548,0,3,1
15890,5,3,55550,55550,55553,0,3,2
15891,5,3,55555,55555,55558,0,3,2
15892,1,2,55556,55558,55560,2,4,0
15893,6,3,55562,55562,55565,0,3,2
15894,3,2,55565,55565,55567,0,2,0
15895,4,2,55569,55569,55571,0,2,2
15896,3,2,55572,55572,55574,0,2,1
15897,3,1,55575,55575,55576,0,1,1
15898,6,1,55581,55581,55582,0,1,5
15899,5,1,55586,55586,55587,0,1,4
15900,2,3,55588,55588,55591,0,3,1
15901,5,1,55593,55593,55594,0,1,2
15902,5,1,55598,55598,55599,0,1,4
15903,4,2,55602,55602,55604,0,2,3
15904,2,3,55604,55604,55607,0,3,0
15905,1,2,55605,55607,55609,2,4,0
15906,2,3,55607,55609,55612,2,5,0
15907,6,1,55613,55613,55614,0,1,1
15908,3,2,55616,55616,55618,0,2,2
15909,2,2,55618,55618,55620,0,2,0
15910,4,1,55622,55622,55623,0,1,2
15911,6,1,55628,55628,55629,0,1,5
15912,6,1,55634,55634,55635,0,1,5
15913,3,3,55637,55637,55640,0,3,2
15914,3,1,55640,55640,55641,0,1,0
15915,3,1,55643,55643,55644,0,1,2
15916,4,1,55647,55647,55648,0,1,3
15917,1,1,55648,55648,55649,0,1,0
15918,3,3,55651,55651,55654,0,3,2
15919,6,3,55657,55657,55660,0,3,3
15920,5,1,55662,55662,55663,0,1,2
15921,1,3,55663,55663,55666,0,3,0
15922,5,1,55668,55668,55669,0,1,2
15923,5,1,55673,55673,55674,0,1,4
15924,4,3,55677,55677,55680,0,3,3
15925,1,2,55678,55680,55682,2,4,0
15926,5,1,55683,55683,55684,0,1,1
15927,5,1,55688,55688,55689,0,1,4
15928,6,2,55694,55694,55696,0,2,5
15929,3,3,55697,55697,55700,0,3,1
15930,1,3,55698,55700,55703,2,5,0
15931,2,1,55700,55703,55704,3,4,0
15932,2,1,55702,55704,55705,2,3,0
15933,1,3,55703,55705,55708,2,5,0
15934,2,2,55705,55708,55710,3,5,0
15935,1,3,55706,55710,55713,4,7,0
15936,6,3,55712,55713,55716,1,4,0
15937,3,3,55715,55716,55719,1,4,0
15938,5,1,55720,55720,55721,0,1,1
15939,1,3,55721,55721,55724,0,3,0
15940,6,3,55727,55727,55730,0,3,3
15941,6,2,55733,55733,55735,0,2,3
15942,4,3,55737,55737,55740,0,3,2
15943,5,3,55742,55742,55745,0,3,2
15944,4,2,55746,55746,55748,0,2,1
15945,4,3,55750,55750,55753,0,3,2
15946,5,1,55755,55755,55756,0,1,2
15947,4,1,55759,55759,55760,0,1,3
15948,5,1,55764,55764,55765,0,1,4
15949,2,1,55766,55766,55767,0,1,1
15950,5,3,55771,55771,55774,0,3,4
15951,1,1,55772,55774,55775,2,3,0
15952,3,3,55775,55775,55778,0,3,0
15953,1,3,55776,55778,55781,2,5,0
15954,2,2,55778,55781,55783,3,5,0
15955,1,1,55779,55783,55784,4,5,0
15956,4,1,55783,55784,55785,1,2,0
15957,6,3,55789,55789,55792,0,3,4
15958,1,1,55790,55792,55793,2,3,0
15959,5,2,55795,55795,55797,0,2,2
15960,1,2,55796,55797,55799,1,3,0
15961,2,1,55798,55799,55800,1,2,0
15962,3,1,55801,55801,55802,0,1,1
15963,2,1,55803,55803,55804,0,1,1
15964,5,3,55808,55808,55811,0,3,4
15965,5,2,55813,55813,55815,0,2,2
15966,6,3,55819,55819,55822,0,3,4
15967,2,1,55821,55822,55823,1,2,0
15968,3,1,55824,55824,55825,0,1,1
15969,2,1,55826,55826,55827,0,1,1
15970,5,3,55831,55831,55834,0,3,4
15971,3,1,55834,55834,55835,0,1,0
15972,6,3,55840,55840,55843,0,3,5
15973,2,3,55842,55843,55846,1,4,0
15974,1,1,55843,55846,55847,3,4,0
15975,3,3,55846,55847,55850,1,4,0
15976,2,1,55848,55850,55851,2,3,0
15977,5,3,55853,55853,55856,0,3,2
15978,5,3,55858,55858,55861,0,3,2
15979,1,3,55859,55861,55864,2,5,0
15980,5,2,55864,55864,55866,0,2,0
15981,5,2,55869,55869,55871,0,2,3
15982,6,1,55875,55875,55876,0,1,4
15983,2,3,55877,55877,55880,0,3,1
15984,3,3,55880,55880,55883,0,3,0
15985,2,2,55882,55883,55885,1,3,0
15986,1,1,55883,55885,55886,2,3,0
15987,4,1,55887,55887,55888,0,1,1
15988,4,3,55891,55891,55894,0,3,3
15989,2,1,55893,55894,55895,1,2,0
15990,2,1,55895,55895,55896,0,1,0
15991,6,2,55901,55901,55903,0,2,5
15992,2,2,55903,55903,55905,0,2,0
15993,1,2,55904,55905,55907,1,3,0
15994,3,2,55907,55907,55909,0,2,0
15995,1,2,55908,55909,55911,1,3,0
15996,1,2,55909,55911,55913,2,4,0
15997,6,2,55915,55915,55917,0,2,2
15998,4,2,55919,55919,55921,0,2,2
15999,3,3,55922,55922,55925,0,3,1
16000,1,3,55923,55925,55928,2,5,0
16001,6,3,55929,55929,55932,0,3,1
16002,3,1,55932,55932,55933,0,1,0
16003,5,2,55937,55937,55939,0,2,4
16004,3,2,55940,55940,55942,0,2,1
16005,2,2,55942,55942,55944,0,2,0
16006,6,1,55948,55948,55949,0,1,4
16007,4,2,55952,55952,55954,0,2,3
16008,1,1,55953,55954,55955,1,2,0
16009,6,2,55959,55959,55961,0,2,4
16010,4,2,55963,55963,55965,0,2,2
16011,6,2,55969,55969,55971,0,2,4
16012,1,3,55970,55971,55974,1,4,0
16013,4,3,55974,55974,55977,0,3,0
16014,3,1,55977,55977,55978,0,1,0
16015,6,2,55983,55983,55985,0,2,5
16016,2,2,55985,55985,55987,0,2,0
16017,5,1,55990,55990,55991,0,1,3
16018,2,1,55992,55992,55993,0,1,1
16019,4,2,55996,55996,55998,0,2,3
16020,6,3,56002,56002,56005,0,3,4
16021,5,3,56007,56007,56010,0,3,2
16022,4,1,56011,56011,56012,0,1,1
16023,1,1,56012,56012,56013,0,1,0
16024,2,2,56014,56014,56016,0,2,1
16025,2,3,56016,56016,56019,0,3,0
16026,2,3,56018,56019,56022,1,4,0
16027,3,2,56021,56022,56024,1,3,0
16028,1,2,56022,56024,56026,2,4,0
16029,4,1,56026,56026,56027,0,1,0
16030,4,3,56030,56030,56033,0,3,3
16031,3,1,56033,56033,56034,0,1,0
16032,4,2,56037,56037,56039,0,2,3
16033,3,1,56040,56040,56041,0,1,1
16034,6,2,56046,56046,56048,0,2,5
16035,6,1,56052,56052,56053,0,1,4
16036,3,1,56055,56055,56056,0,1,2
16037,1,1,56056,56056,56057,0,1,0
16038,4,1,56060,56060,56061,0,1,3
16039,3,3,56063,56063,56066,0,3,2
16040,4,2,56067,56067,56069,0,2,1
16041,6,3,56073,56073,56076,0,3,4
16042,6,3,56079,56079,56082,0,3,3
16043,2,3,56081,56082,56085,1,4,0
16044,3,2,56084,56085,56087,1,3,0
16045,5,2,56089,56089,56091,0,2,2
16046,4,2,56093,56093,56095,0,2,2
16047,6,3,56099,56099,56102,0,3,4
16048,2,2,56101,56102,56104,1,3,0
16049,1,3,56102,56104,56107,2,5,0
16050,5,1,56107,56107,56108,0,1,0
16051,6,1,56113,56113,56114,0,1,5
16052,4,3,56117,56117,56120,0,3,3
16053,6,2,56123,56123,56125,0,2,3
16054,6,2,56129,56129,56131,0,2,4
16055,3,3,56132,56132,56135,0,3,1
16056,6,2,56138,56138,56140,0,2,3
16057,5,3,56143,56143,56146,0,3,3
16058,5,3,56148,56148,56151,0,3,2
16059,5,2,56153,56153,56155,0,2,2
16060,3,3,56156,56156,56159,0,3,1
16061,3,2,56159,56159,56161,0,2,0
16062,2,3,56161,56161,56164,0,3,0
16063,4,2,56165,56165,56167,0,2,1
16064,5,1,56170,56170,56171,0,1,3
16065,6,3,56176,56176,56179,0,3,5
16066,5,2,56181,56181,56183,0,2,2
16067,5,2,56186,56186,56188,0,2,3
16068,6,3,56192,56192,56195,0,3,4
16069,6,3,56198,56198,56201,0,3,3
16070,4,2,56202,56202,56204,0,2,1
16071,1,1,56203,56204,56205,1,2,0
16072,6,1,56209,56209,56210,0,1,4
16073,5,1,56214,56214,56215,0,1,4
16074,4,3,56218,56218,56221,0,3,3
16075,6,1,56224,56224,56225,0,1,3
16076,3,3,56227,56227,56230,0,3,2
16077,2,3,56229,56230,56233,1,4,0
16078,3,1,56232,56233,56234,1,2,0
16079,3,1,56235,56235,56236,0,1,1
16080,1,3,56236,56236,56239,0,3,0
16081,1,3,56237,56239,56242,2,5,0
16082,3,1,56240,56242,56243,2,3,0
16083,4,1,56244,56244,56245,0,1,1
16084,1,3,56245,56245,56248,0,3,0
16085,1,1,56246,56248,56249,2,3,0
16086,5,3,56251,56251,56254,0,3,2
16087,6,2,56257,56257,56259,0,2,3
16088,1,2,56258,56259,56261,1,3,0
16089,6,1,56264,56264,56265,0,1,3
16090,5,2,56269,56269,56271,0,2,4
16091,1,1,56270,56271,56272,1,2,0
16092,5,1,56275,56275,56276,0,1,3
16093,3,3,56278,56278,56281,0,3,2
16094,4,1,56282,56282,56283,0,1,1
16095,6,1,56288,56288,56289,0,1,5
16096,4,2,56292,56292,56294,0,2,3
16097,5,2,56297,56297,56299,0,2,3
16098,1,3,56298,56299,56302,1,4,0
16099,3,2,56301,56302,56304,1,3,0
16100,1,3,56302,56304,56307,2,5,0
16101,6,2,56308,56308,56310,0,2,1
16102,2,1,56310,56310,56311,0,1,0
16103,5,1,56315,56315,56316,0,1,4
16104,1,2,56316,56316,56318,0,2,0
16105,6,3,56322,56322,56325,0,3,4
16106,1,1,56323,56325,56326,2,3,0
16107,1,1,56324,56326,56327,2,3,0
16108,5,2,56329,56329,56331,0,2,2
16109,6,3,56335,56335,56338,0,3,4
16110,5,3,56340,56340,56343,0,3,2
16111,3,2,56343,56343,56345,0,2,0
16112,3,1,56346,56346,56347,0,1,1
16113,3,2,56349,56349,56351,0,2,2
16114,5,1,56354,56354,56355,0,1,3
16115,6,1,56360,56360,56361,0,1,5
16116,1,2,56361,56361,56363,0,2,0
16117,2,2,56363,56363,56365,0,2,0
16118,1,3,56364,56365,56368,1,4,0
16119,6,1,56370,56370,56371,0,1,2
16120,4,2,56374,56374,56376,0,2,3
16121,6,3,56380,56380,56383,0,3,4
16122,6,2,56386,56386,56388,0,2,3
16123,6,3,56392,56392,56395,0,3,4
16124,6,1,56398,56398,56399,0,1,3
16125,2,3,56400,56400,56403,0,3,1
16126,5,3,56405,56405,56408,0,3,2
16127,2,1,56407,56408,56409,1,2,0
16128,6,3,56413,56413,56416,0,3,4
16129,2,3,56415,56416,56419,1,4,0
16130,4,3,56419,56419,56422,0,3,0
16131,3,2,56422,56422,56424,0,2,0
16132,4,2,56426,56426,56428,0,2,2
16133,2,3,56428,56428,56431,0,3,0
16134,6,3,56434,56434,56437,0,3,3
16135,1,1,56435,56437,56438,2,3,0
16136,5,1,56440,56440,56441,0,1,2
16137,2,3,56442,56442,56445,0,3,1
16138,6,3,56448,56448,56451,0,3,3
16139,1,1,56449,56451,56452,2,3,0
16140,4,2,56453,56453,56455,0,2,1
16141,3,1,56456,56456,56457,0,1,1
16142,6,2,56462,56462,56464,0,2,5
16143,6,3,56468,56468,56471,0,3,4
16144,5,3,56473,56473,56476,0,3,2
16145,5,3,56478,56478,56481,0,3,2
16146,6,1,56484,56484,56485,0,1,3
16147,6,2,56490,56490,56492,0,2,5
16148,6,2,56496,56496,56498,0,2,4
16149,1,1,56497,56498,56499,1,2,0
16150,3,2,56500,56500,56502,0,2,1
16151,5,2,56505,56505,56507,0,2,3
16152,4,2,56509,56509,56511,0,2,2
16153,2,1,56511,56511,56512,0,1,0
16154,2,1,56513,56513,56514,0,1,1
16155,4,2,56517,56517,56519,0,2,3
16156,5,2,56522,56522,56524,0,2,3
16157,3,1,56525,56525,56526,0,1,1
16158,2,3,56527,56527,56530,0,3,1
16159,1,2,56528,56530,56532,2,4,0
16160,1,1,56529,56532,56533,3,4,0
16161,3,2,56532,56533,56535,1,3,0
16162,1,2,56533,56535,56537,2,4,0
16163,5,2,56538,56538,56540,0,2,1
16164,1,2,56539,56540,56542,1,3,0
16165,1,2,56540,56542,56544,2,4,0
16166,2,2,56542,56544,56546,2,4,0
16167,1,3,56543,56546,56549,3,6,0
16168,1,3,56544,56549,56552,5,8,0
16169,3,2,56547,56552,56554,5,7,0
16170,3,1,56550,56554,56555,4,5,0
16171,2,2,56552,56555,56557,3,5,0
16172,1,2,56553,56557,56559,4,6,0
16173,6,3,56559,56559,56562,0,3,0
16174,3,2,56562,56562,56564,0,2,0
16175,6,3,56568,56568,56571,0,3,4
16176,1,2,56569,56571,56573,2,4,0
16177,5,1,56574,56574,56575,0,1,1
16178,4,2,56578,56578,56580,0,2,3
16179,6,3,56584,56584,56587,0,3,4
16180,6,1,56590,56590,56591,0,1,3
16181,5,2,56595,56595,56597,0,2,4
16182,6,2,56601,56601,56603,0,2,4
16183,2,3,56603,56603,56606,0,3,0
16184,5,1,56608,56608,56609,0,1,2
16185,3,3,56611,56611,56614,0,3,2
16186,1,1,56612,56614,56615,2,3,0
16187,2,1,56614,56615,56616,1,2,0
16188,4,1,56618,56618,56619,0,1,2
16189,5,1,56623,56623,56624,0,1,4
16190,4,3,56627,56627,56630,0,3,3
16191,4,1,56631,56631,56632,0,1,1
16192,4,1,56635,56635,56636,0,1,3
16193,1,1,56636,56636,56637,0,1,0
16194,5,3,56641,56641,56644,0,3,4
16195,1,1,56642,56644,56645,2,3,0
16196,3,1,56645,56645,56646,0,1,0
16197,3,2,56648,56648,56650,0,2,2
16198,2,1,56650,56650,56651,0,1,0
16199,2,2,56652,56652,56654,0,2,1
16200,5,3,56657,56657,56660,0,3,3
16201,5,3,56662,56662,56665,0,3,2
16202,2,3,56664,56665,56668,1,4,0
16203,1,2,56665,56668,56670,3,5,0
16204,5,3,56670,56670,56673,0,3,0
16205,4,1,56674,56674,56675,0,1,1
16206,5,3,56679,56679,56682,0,3,4
16207,4,1,56683,56683,56684,0,1,1
16208,5,1,56688,56688,56689,0,1,4
16209,1,1,56689,56689,56690,0,1,0
16210,3,3,56692,56692,56695,0,3,2
16211,6,3,56698,56698,56701,0,3,3
16212,2,1,56700,56701,56702,1,2,0
16213,6,1,56706,56706,56707,0,1,4
16214,2,2,56708,56708,56710,0,2,1
16215,6,3,56714,56714,56717,0,3,4
16216,3,1,56717,56717,56718,0,1,0
16217,4,1,56721,56721,56722,0,1,3
16218,6,1,56727,56727,56728,0,1,5
16219,1,1,56728,56728,56729,0,1,0
16220,2,1,56730,56730,56731,0,1,1
16221,3,2,56733,56733,56735,0,2,2
16222,5,2,56738,56738,56740,0,2,3
16223,3,2,56741,56741,56743,0,2,1
16224,6,2,56747,56747,56749,0,2,4
16225,4,1,56751,56751,56752,0,1,2
16226,2,3,56753,56753,56756,0,3,1
16227,3,2,56756,56756,56758,0,2,0
16228,1,3,56757,56758,56761,1,4,0
16229,4,1,56761,56761,56762,0,1,0
16230,4,2,56765,56765,56767,0,2,3
16231,1,3,56766,56767,56770,1,4,0
16232,4,2,56770,56770,56772,0,2,0
16233,1,3,56771,56772,56775,1,4,0
16234,2,1,56773,56775,56776,2,3,0
16235,5,1,56778,56778,56779,0,1,2
16236,1,3,56779,56779,56782,0,3,0
16237,6,1,56785,56785,56786,0,1,3
16238,6,1,56791,56791,56792,0,1,5
16239,3,2,56794,56794,56796,0,2,2
16240,1,2,56795,56796,56798,1,3,0
16241,5,2,56800,56800,56802,0,2,2
16242,6,3,56806,56806,56809,0,3,4
16243,6,2,56812,56812,56814,0,2,3
16244,1,2,56813,56814,56816,1,3,0
16245,1,1,56814,56816,56817,2,3,0
16246,3,2,56817,56817,56819,0,2,0
16247,1,2,56818,56819,56821,1,3,0
16248,3,3,56821,56821,56824,0,3,0
16249,6,1,56827,56827,56828,0,1,3
16250,3,2,56830,56830,56832,0,2,2
16251,2,3,56832,56832,56835,0,3,0
16252,4,3,56836,56836,56839,0,3,1
16253,2,1,56838,56839,56840,1,2,0
16254,1,2,56839,56840,56842,1,3,0
16255,1,3,56840,56842,56845,2,5,0
16256,4,2,56844,56845,56847,1,3,0
16257,6,2,56850,56850,56852,0,2,3
16258,6,2,56856,56856,56858,0,2,4
16259,4,1,56860,56860,56861,0,1,2
16260,3,1,56863,56863,56864,0,1,2
16261,4,2,56867,56867,56869,0,2,3
16262,5,1,56872,56872,56873,0,1,3
16263,6,2,56878,56878,56880,0,2,5
16264,1,3,56879,56880,56883,1,4,0
16265,1,1,56880,56883,56884,3,4,0
16266,5,3,56885,56885,56888,0,3,1
16267,2,3,56887,56888,56891,1,4,0
16268,2,2,56889,56891,56893,2,4,0
16269,4,1,56893,56893,56894,0,1,0
16270,4,2,56897,56897,56899,0,2,3
16271,3,3,56900,56900,56903,0,3,1
16272,6,1,56906,56906,56907,0,1,3
16273,1,2,56907,56907,56909,0,2,0
16274,2,1,56909,56909,56910,0,1,0
16275,1,3,56910,56910,56913,0,3,0
16276,5,2,56915,56915,56917,0,2,2
16277,3,1,56918,56918,56919,0,1,1
16278,1,3,56919,56919,56922,0,3,0
16279,4,1,56923,56923,56924,0,1,1
16280,6,2,56929,56929,56931,0,2,5
16281,1,3,56930,56931,56934,1,4,0
16282,3,3,56933,56934,56937,1,4,0
16283,5,2,56938,56938,56940,0,2,1
16284,5,2,56943,56943,56945,0,2,3
16285,1,1,56944,56945,56946,1,2,0
16286,2,1,56946,56946,56947,0,1,0
16287,3,3,56949,56949,56952,0,3,2
16288,2,3,56951,56952,56955,1,4,0
16289,1,1,56952,56955,56956,3,4,0
16290,3,2,56955,56956,56958,1,3,0
16291,6,2,56961,56961,56963,0,2,3
16292,1,2,56962,56963,56965,1,3,0
16293,6,2,56968,56968,56970,0,2,3
16294,5,2,56973,56973,56975,0,2,3
16295,3,1,56976,56976,56977,0,1,1
16296,3,2,56979,56979,56981,0,2,2
16297,6,1,56985,56985,56986,0,1,4
16298,1,2,56986,56986,56988,0,2,0
16299,6,2,56992,56992,56994,0,2,4
16300,6,2,56998,56998,57000,0,2,4
16301,3,2,57001,57001,57003,0,2,1
16302,2,3,57003,57003,57006,0,3,0
16303,2,2,57005,57006,57008,1,3,0
16304,6,1,57011,57011,57012,0,1,3
16305,4,3,57015,57015,57018,0,3,3
16306,1,2,57016,57018,57020,2,4,0
16307,1,2,57017,57020,57022,3,5,0
16308,6,2,57023,57023,57025,0,2,1
16309,4,1,57027,57027,57028,0,1,2
16310,6,1,57033,57033,57034,0,1,5
16311,5,2,57038,57038,57040,0,2,4
16312,3,2,57041,57041,57043,0,2,1
16313,4,2,57045,57045,57047,0,2,2
16314,1,3,57046,57047,57050,1,4,0
16315,4,2,57050,57050,57052,0,2,0
16316,2,3,57052,57052,57055,0,3,0
16317,5,2,57057,57057,57059,0,2,2
16318,2,1,57059,57059,57060,0,1,0
16319,2,2,57061,57061,57063,0,2,1
16320,2,2,57063,57063,57065,0,2,0
16321,3,2,57066,57066,57068,0,2,1
16322,5,3,57071,57071,57074,0,3,3
16323,4,1,57075,57075,57076,0,1,1
16324,6,2,57081,57081,57083,0,2,5
16325,6,3,57087,57087,57090,0,3,4
16326,6,1,57093,57093,57094,0,1,3
16327,3,3,57096,57096,57099,0,3,2
16328,6,2,57102,57102,57104,0,2,3
16329,1,3,57103,57104,57107,1,4,0
16330,6,1,57109,57109,57110,0,1,2
16331,4,3,57113,57113,57116,0,3,3
16332,6,2,57119,57119,57121,0,2,3
16333,2,2,57121,57121,57123,0,2,0
16334,2,1,57123,57123,57124,0,1,0
16335,3,1,57126,57126,57127,0,1,2
16336,2,1,57128,57128,57129,0,1,1
16337,4,1,57132,57132,57133,0,1,3
16338,1,1,57133,57133,57134,0,1,0
16339,6,1,57139,57139,57140,0,1,5
16340,1,3,57140,57140,57143,0,3,0
16341,6,1,57146,57146,57147,0,1,3
16342,2,1,57148,57148,57149,0,1,1
16343,6,2,57154,57154,57156,0,2,5
16344,5,1,57159,57159,57160,0,1,3
16345,6,1,57165,57165,57166,0,1,5
16346,1,3,57166,57166,57169,0,3,0
16347,5,2,57171,57171,57173,0,2,2
16348,6,3,57177,57177,57180,0,3,4
16349,3,3,57180,57180,57183,0,3,0
16350,1,2,57181,57183,57185,2,4,0
16351,1,1,57182,57185,57186,3,4,0
16352,5,1,57187,57187,57188,0,1,1
16353,1,1,57188,57188,57189,0,1,0
16354,1,1,57189,57189,57190,0,1,0
16355,6,3,57195,57195,57198,0,3,5
16356,5,2,57200,57200,57202,0,2,2
16357,4,1,57204,57204,57205,0,1,2
16358,4,1,57208,57208,57209,0,1,3
16359,2,2,57210,57210,57212,0,2,1
16360,4,1,57214,57214,57215,0,1,2
16361,1,1,57215,57215,57216,0,1,0
16362,6,1,57221,57221,57222,0,1,5
16363,6,1,57227,57227,57228,0,1,5
16364,5,2,57232,57232,57234,0,2,4
16365,6,1,57238,57238,57239,0,1,4
16366,5,1,57243,57243,57244,0,1,4
16367,6,1,57249,57249,57250,0,1,5
16368,6,2,57255,57255,57257,0,2,5
16369,4,3,57259,57259,57262,0,3,2
16370,2,2,57261,57262,57264,1,3,0
16371,2,2,57263,57264,57266,1,3,0
16372,2,1,57265,57266,57267,1,2,0
16373,3,2,57268,57268,57270,0,2,1
16374,6,1,57274,57274,57275,0,1,4
16375,2,2,57276,57276,57278,0,2,1
16376,4,3,57280,57280,57283,0,3,2
16377,2,3,57282,57283,57286,1,4,0
16378,2,3,57284,57286,57289,2,5,0
16379,6,3,57290,57290,57293,0,3,1
16380,3,1,57293,57293,57294,0,1,0
16381,4,3,57297,57297,57300,0,3,3
16382,3,2,57300,57300,57302,0,2,0
16383,5,1,57305,57305,57306,0,1,3
16384,6,1,57311,57311,57312,0,1,5
16385,4,3,57315,57315,57318,0,3,3
16386,5,1,57320,57320,57321,0,1,2
16387,2,2,57322,57322,57324,0,2,1
16388,3,3,57325,57325,57328,0,3,1
16389,2,3,57327,57328,57331,1,4,0
16390,2,3,57329,57331,57334,2,5,0
16391,4,3,57333,57334,57337,1,4,0
16392,4,1,57337,57337,57338,0,1,0
16393,1,2,57338,57338,57340,0,2,0
16394,3,1,57341,57341,57342,0,1,1
16395,6,1,57347,57347,57348,0,1,5
16396,3,3,57350,57350,57353,0,3,2
16397,4,2,57354,57354,57356,0,2,1
16398,5,2,57359,57359,57361,0,2,3
16399,2,2,57361,57361,57363,0,2,0
16400,1,2,57362,57363,57365,1,3,0
16401,4,3,57366,57366,57369,0,3,1
16402,2,3,57368,57369,57372,1,4,0
16403,1,3,57369,57372,57375,3,6,0
16404,1,3,57370,57375,57378,5,8,0
16405,1,1,57371,57378,57379,7,8,0
16406,5,2,57376,57379,57381,3,5,0
16407,3,3,57379,57381,57384,2,5,0
16408,6,3,57385,57385,57388,0,3,1
16409,5,1,57390,57390,57391,0,1,2
16410,3,3,57393,57393,57396,0,3,2
16411,2,3,57395,57396,57399,1,4,0
16412,4,2,57399,57399,57401,0,2,0
16413,3,2,57402,57402,57404,0,2,1
16414,6,2,57408,57408,57410,0,2,4
16415,5,1,57413,57413,57414,0,1,3
16416,3,2,57416,57416,57418,0,2,2
16417,2,2,57418,57418,57420,0,2,0
16418,2,2,57420,57420,57422,0,2,0
16419,3,1,57423,57423,57424,0,1,1
16420,6,3,57429,57429,57432,0,3,5
16421,4,3,57433,57433,57436,0,3,1
16422,5,3,57438,57438,57441,0,3,2
16423,5,3,57443,57443,57446,0,3,2
16424,2,1,57445,57446,57447,1,2,0
16425,5,1,57450,57450,57451,0,1,3
16426,3,2,57453,57453,57455,0,2,2
16427,6,1,57459,57459,57460,0,1,4
16428,1,3,57460,57460,57463,0,3,0
16429,4,2,57464,57464,57466,0,2,1
16430,1,1,57465,57466,57467,1,2,0
16431,6,1,57471,57471,57472,0,1,4
16432,6,2,57477,57477,57479,0,2,5
16433,1,2,57478,57479,57481,1,3,0
16434,1,2,57479,57481,57483,2,4,0
16435,3,2,57482,57483,57485,1,3,0
16436,5,1,57487,57487,57488,0,1,2
16437,5,3,57492,57492,57495,0,3,4
16438,5,1,57497,57497,57498,0,1,2
16439,3,3,57500,57500,57503,0,3,2
16440,3,3,57503,57503,57506,0,3,0
16441,6,1,57509,57509,57510,0,1,3
16442,6,1,57515,57515,57516,0,1,5
16443,2,3,57517,57517,57520,0,3,1
16444,2,2,57519,57520,57522,1,3,0
16445,4,3,57523,57523,57526,0,3,1
16446,6,3,57529,57529,57532,0,3,3
16447,2,2,57531,57532,57534,1,3,0
16448,6,2,57537,57537,57539,0,2,3
16449,4,2,57541,57541,57543,0,2,2
16450,1,1,57542,57543,57544,1,2,0
16451,4,3,57546,57546,57549,0,3,2
16452,5,2,57551,57551,57553,0,2,2
16453,5,3,57556,57556,57559,0,3,3
16454,2,3,57558,57559,57562,1,4,0
16455,2,2,57560,57562,57564,2,4,0
16456,6,2,57566,57566,57568,0,2,2
16457,1,1,57567,57568,57569,1,2,0
16458,1,3,57568,57569,57572,1,4,0
16459,3,3,57571,57572,57575,1,4,0
16460,4,2,57575,57575,57577,0,2,0
16461,4,3,57579,57579,57582,0,3,2
16462,5,3,57584,57584,57587,0,3,2
16463,4,3,57588,57588,57591,0,3,1
16464,4,1,57592,57592,57593,0,1,1
16465,1,2,57593,57593,57595,0,2,0
16466,1,2,57594,57595,57597,1,3,0
16467,6,1,57600,57600,57601,0,1,3
16468,1,2,57601,57601,57603,0,2,0
16469,4,2,57605,57605,57607,0,2,2
16470,1,3,57606,57607,57610,1,4,0
16471,4,2,57610,57610,57612,0,2,0
16472,6,2,57616,57616,57618,0,2,4
16473,5,1,57621,57621,57622,0,1,3
16474,6,3,57627,57627,57630,0,3,5
16475,1,2,57628,57630,57632,2,4,0
16476,5,1,57633,57633,57634,0,1,1
16477,4,1,57637,57637,57638,0,1,3
16478,1,3,57638,57638,57641,0,3,0
16479,3,1,57641,57641,57642,0,1,0
16480,2,1,57643,57643,57644,0,1,1
16481,5,3,57648,57648,57651,0,3,4
16482,3,1,57651,57651,57652,0,1,0
16483,2,3,57653,57653,57656,0,3,1
16484,4,2,57657,57657,57659,0,2,1
16485,1,2,57658,57659,57661,1,3,0
16486,2,2,57660,57661,57663,1,3,0
16487,6,3,57666,57666,57669,0,3,3
16488,5,2,57671,57671,57673,0,2,2
16489,4,1,57675,57675,57676,0,1,2
16490,5,3,57680,57680,57683,0,3,4
16491,3,1,57683,57683,57684,0,1,0
16492,2,1,57685,57685,57686,0,1,1
16493,3,1,57688,57688,57689,0,1,2
16494,4,3,57692,57692,57695,0,3,3
16495,2,2,57694,57695,57697,1,3,0
16496,4,3,57698,57698,57701,0,3,1
16497,3,3,57701,57701,57704,0,3,0
16498,5,3,57706,57706,57709,0,3,2
16499,2,3,57708,57709,57712,1,4,0
16500,2,1,57710,57712,57713,2,3,0
16501,6,3,57716,57716,57719,0,3,3
16502,2,2,57718,57719,57721,1,3,0
16503,3,1,57721,57721,57722,0,1,0
16504,4,3,57725,57725,57728,0,3,3
16505,3,3,57728,57728,57731,0,3,0
16506,2,2,57730,57731,57733,1,3,0
16507,4,2,57734,57734,57736,0,2,1
16508,2,1,57736,57736,57737,0,1,0
16509,4,3,57740,57740,57743,0,3,3
16510,1,1,57741,57743,57744,2,3,0
16511,2,2,57743,57744,57746,1,3,0
16512,4,1,57747,57747,57748,0,1,1
16513,4,3,57751,57751,57754,0,3,3
16514,5,3,57756,57756,57759,0,3,2
16515,2,1,57758,57759,57760,1,2,0
16516,6,3,57764,57764,57767,0,3,4
16517,2,2,57766,57767,57769,1,3,0
16518,5,2,57771,57771,57773,0,2,2
16519,1,2,57772,57773,57775,1,3,0
16520,6,3,57778,57778,57781,0,3,3
16521,6,1,57784,57784,57785,0,1,3
16522,1,2,57785,57785,57787,0,2,0
16523,6,1,57791,57791,57792,0,1,4
16524,4,3,57795,57795,57798,0,3,3
16525,6,2,57801,57801,57803,0,2,3
16526,3,1,57804,57804,57805,0,1,1
16527,2,2,57806,57806,57808,0,2,1
16528,2,2,57808,57808,57810,0,2,0
16529,1,1,57809,57810,57811,1,2,0
16530,1,3,57810,57811,57814,1,4,0
16531,4,1,57814,57814,57815,0,1,0
16532,1,1,57815,57815,57816,0,1,0
16533,5,3,57820,57820,57823,0,3,4
16534,5,2,57825,57825,57827,0,2,2
16535,4,3,57829,57829,57832,0,3,2
16536,4,2,57833,57833,57835,0,2,1
16537,2,2,57835,57835,57837,0,2,0
16538,3,3,57838,57838,57841,0,3,1
16539,1,3,57839,57841,57844,2,5,0
16540,6,2,57845,57845,57847,0,2,1
16541,4,1,57849,57849,57850,0,1,2
16542,5,3,57854,57854,57857,0,3,4
16543,3,1,57857,57857,57858,0,1,0
16544,3,2,57860,57860,57862,0,2,2
16545,3,2,57863,57863,57865,0,2,1
16546,1,2,57864,57865,57867,1,3,0
16547,2,3,57866,57867,57870,1,4,0
16548,2,3,57868,57870,57873,2,5,0
16549,1,3,57869,57873,57876,4,7,0
16550,5,3,57874,57876,57879,2,5,0
16551,6,2,57880,57880,57882,0,2,1
16552,2,1,57882,57882,57883,0,1,0
16553,5,1,57887,57887,57888,0,1,4
16554,4,3,57891,57891,57894,0,3,3
16555,5,2,57896,57896,57898,0,2,2
16556,3,1,57899,57899,57900,0,1,1
16557,3,3,57902,57902,57905,0,3,2
16558,3,3,57905,57905,57908,0,3,0
16559,1,2,57906,57908,57910,2,4,0
16560,5,2,57911,57911,57913,0,2,1
16561,3,2,57914,57914,57916,0,2,1
16562,3,3,57917,57917,57920,0,3,1
16563,4,2,57921,57921,57923,0,2,1
16564,2,2,57923,57923,57925,0,2,0
16565,1,1,57924,57925,57926,1,2,0
16566,5,3,57929,57929,57932,0,3,3
16567,6,1,57935,57935,57936,0,1,3
16568,4,1,57939,57939,57940,0,1,3
16569,6,1,57945,57945,57946,0,1,5
16570,1,3,57946,57946,57949,0,3,0
16571,5,1,57951,57951,57952,0,1,2
16572,1,1,57952,57952,57953,0,1,0
16573,2,2,57954,57954,57956,0,2,1
16574,4,2,57958,57958,57960,0,2,2
16575,3,2,57961,57961,57963,0,2,1
16576,2,3,57963,57963,57966,0,3,0
16577,5,2,57968,57968,57970,0,2,2
16578,2,3,57970,57970,57973,0,3,0
16579,5,1,57975,57975,57976,0,1,2
16580,5,3,57980,57980,57983,0,3,4
16581,4,2,57984,57984,57986,0,2,1
16582,6,2,57990,57990,57992,0,2,4
16583,3,3,57993,57993,57996,0,3,1
16584,1,3,57994,57996,57999,2,5,0
16585,3,1,57997,57999,58000,2,3,0
16586,2,3,57999,58000,58003,1,4,0
16587,2,1,58001,58003,58004,2,3,0
16588,4,3,58005,58005,58008,0,3,1
16589,4,2,58009,58009,58011,0,2,1
16590,1,3,58010,58011,58014,1,4,0
16591,5,2,58015,58015,58017,0,2,1
16592,2,1,58017,58017,58018,0,1,0
16593,3,1,58020,58020,58021,0,1,2
16594,6,1,58026,58026,58027,0,1,5
16595,2,2,58028,58028,58030,0,2,1
16596,4,2,58032,58032,58034,0,2,2
16597,1,2,58033,58034,58036,1,3,0
16598,5,1,58038,58038,58039,0,1,2
16599,1,1,58039,58039,58040,0,1,0
16600,3,2,58042,58042,58044,0,2,2
16601,1,1,58043,58044,58045,1,2,0
16602,6,3,58049,58049,58052,0,3,4
16603,6,2,58055,58055,58057,0,2,3
16604,5,1,58060,58060,58061,0,1,3
16605,5,1,58065,58065,58066,0,1,4
16606,5,3,58070,58070,58073,0,3,4
16607,4,1,58074,58074,58075,0,1,1
16608,6,1,58080,58080,58081,0,1,5
16609,1,1,58081,58081,58082,0,1,0
16610,2,3,58083,58083,58086,0,3,1
16611,6,1,58089,58089,58090,0,1,3
16612,6,3,58095,58095,58098,0,3,5
16613,2,3,58097,58098,58101,1,4,0
16614,4,3,58101,58101,58104,0,3,0
16615,3,2,58104,58104,58106,0,2,0
16616,3,1,58107,58107,58108,0,1,1
16617,3,3,58110,58110,58113,0,3,2
16618,2,1,58112,58113,58114,1,2,0
16619,3,3,58115,58115,58118,0,3,1
16620,6,1,58121,58121,58122,0,1,3
16621,6,2,58127,58127,58129,0,2,5
16622,4,2,58131,58131,58133,0,2,2
16623,1,3,58132,58133,58136,1,4,0
16624,5,2,58137,58137,58139,0,2,1
16625,6,1,58143,58143,58144,0,1,4
16626,5,2,58148,58148,58150,0,2,4
16627,1,3,58149,58150,58153,1,4,0
16628,6,2,58155,58155,58157,0,2,2
16629,2,1,58157,58157,58158,0,1,0
16630,4,3,58161,58161,58164,0,3,3
16631,6,1,58167,58167,58168,0,1,3
16632,4,1,58171,58171,58172,0,1,3
16633,3,2,58174,58174,58176,0,2,2
16634,4,2,58178,58178,58180,0,2,2
16635,5,2,58183,58183,58185,0,2,3
16636,6,3,58189,58189,58192,0,3,4
16637,2,2,58191,58192,58194,1,3,0
16638,2,1,58193,58194,58195,1,2,0
16639,4,1,58197,58197,58198,0,1,2
16640,1,1,58198,58198,58199,0,1,0
16641,5,3,58203,58203,58206,0,3,4
16642,3,3,58206,58206,58209,0,3,0
16643,5,3,58211,58211,58214,0,3,2
16644,5,1,58216,58216,58217,0,1,2
16645,1,1,58217,58217,58218,0,1,0
16646,3,3,58220,58220,58223,0,3,2
16647,5,3,58225,58225,58228,0,3,2
16648,2,2,58227,58228,58230,1,3,0
16649,4,3,58231,58231,58234,0,3,1
16650,6,3,58237,58237,58240,0,3,3
16651,4,3,58241,58241,58244,0,3,1
16652,3,1,58244,58244,58245,0,1,0
16653,3,3,58247,58247,58250,0,3,2
16654,6,3,58253,58253,58256,0,3,3
16655,5,3,58258,58258,58261,0,3,2
16656,6,3,58264,58264,58267,0,3,3
16657,1,1,58265,58267,58268,2,3,0
16658,5,2,58270,58270,58272,0,2,2
16659,3,3,58273,58273,58276,0,3,1
16660,3,2,58276,58276,58278,0,2,0
16661,1,2,58277,58278,58280,1,3,0
16662,6,2,58283,58283,58285,0,2,3
16663,1,3,58284,58285,58288,1,4,0
16664,4,3,58288,58288,58291,0,3,0
16665,3,3,58291,58291,58294,0,3,0
16666,3,1,58294,58294,58295,0,1,0
16667,6,2,58300,58300,58302,0,2,5
16668,6,2,58306,58306,58308,0,2,4
16669,4,1,58310,58310,58311,0,1,2
16670,5,1,58315,58315,58316,0,1,4
16671,4,2,58319,58319,58321,0,2,3
16672,1,1,58320,58321,58322,1,2,0
16673,4,3,58324,58324,58327,0,3,2
16674,1,2,58325,58327,58329,2,4,0
16675,1,3,58326,58329,58332,3,6,0
16676,6,2,58332,58332,58334,0,2,0
16677,2,2,58334,58334,58336,0,2,0
16678,4,1,58338,58338,58339,0,1,2
16679,2,1,58340,58340,58341,0,1,1
16680,4,2,58344,58344,58346,0,2,3
16681,1,3,58345,58346,58349,1,4,0
16682,2,1,58347,58349,58350,2,3,0
16683,4,3,58351,58351,58354,0,3,1
16684,2,1,58353,58354,58355,1,2,0
16685,2,3,58355,58355,58358,0,3,0
16686,4,2,58359,58359,58361,0,2,1
16687,1,2,58360,58361,58363,1,3,0
16688,1,2,58361,58363,58365,2,4,0
16689,5,2,58366,58366,58368,0,2,1
16690,1,2,58367,58368,58370,1,3,0
16691,3,3,58370,58370,58373,0,3,0
16692,6,1,58376,58376,58377,0,1,3
16693,3,2,58379,58379,58381,0,2,2
16694,6,3,58385,58385,58388,0,3,4
16695,2,3,58387,58388,58391,1,4,0
16696,3,3,58390,58391,58394,1,4,0
16697,6,1,58396,58396,58397,0,1,2
16698,6,1,58402,58402,58403,0,1,5
16699,6,2,58408,58408,58410,0,2,5
16700,4,1,58412,58412,58413,0,1,2
16701,1,3,58413,58413,58416,0,3,0
16702,3,2,58416,58416,58418,0,2,0
16703,1,1,58417,58418,58419,1,2,0
16704,2,2,58419,58419,58421,0,2,0
16705,3,1,58422,58422,58423,0,1,1
16706,6,1,58428,58428,58429,0,1,5
16707,5,3,58433,58433,58436,0,3,4
16708,1,3,58434,58436,58439,2,5,0
16709,6,1,58440,58440,58441,0,1,1
16710,6,2,58446,58446,58448,0,2,5
16711,5,3,58451,58451,58454,0,3,3
16712,2,3,58453,58454,58457,1,4,0
16713,2,1,58455,58457,58458,2,3,0
16714,2,3,58457,58458,58461,1,4,0
16715,1,3,58458,58461,58464,3,6,0
16716,1,1,58459,58464,58465,5,6,0
16717,1,1,58460,58465,58466,5,6,0
16718,5,2,58465,58466,58468,1,3,0
16719,6,2,58471,58471,58473,0,2,3
16720,3,3,58474,58474,58477,0,3,1
16721,6,3,58480,58480,58483,0,3,3
16722,5,3,58485,58485,58488,0,3,2
16723,2,1,58487,58488,58489,1,2,0
16724,5,1,58492,58492,58493,0,1,3
16725,2,2,58494,58494,58496,0,2,1
16726,5,2,58499,58499,58501,0,2,3
16727,4,3,58503,58503,58506,0,3,2
16728,1,1,58504,58506,58507,2,3,0
16729,6,1,58510,58510,58511,0,1,3
16730,4,2,58514,58514,58516,0,2,3
16731,4,3,58518,58518,58521,0,3,2
16732,3,2,58521,58521,58523,0,2,0
16733,3,3,58524,58524,58527,0,3,1
16734,5,2,58529,58529,58531,0,2,2
16735,3,1,58532,58532,58533,0,1,1
16736,4,3,58536,58536,58539,0,3,3
16737,1,1,58537,58539,58540,2,3,0
16738,3,3,58540,58540,58543,0,3,0
16739,2,1,58542,58543,58544,1,2,0
16740,1,2,58543,58544,58546,1,3,0
16741,3,3,58546,58546,58549,0,3,0
16742,4,1,58550,58550,58551,0,1,1
16743,1,2,58551,58551,58553,0,2,0
16744,2,3,58553,58553,58556,0,3,0
16745,6,2,58559,58559,58561,0,2,3
16746,3,1,58562,58562,58563,0,1,1
16747,6,2,58568,58568,58570,0,2,5
16748,6,3,58574,58574,58577,0,3,4
16749,1,3,58575,58577,58580,2,5,0
16750,5,3,58580,58580,58583,0,3,0
16751,1,3,58581,58583,58586,2,5,0
16752,3,1,58584,58586,58587,2,3,0
16753,1,2,58585,58587,58589,2,4,0
16754,5,1,58590,58590,58591,0,1,1
16755,4,1,58594,58594,58595,0,1,3
16756,3,1,58597,58597,58598,0,1,2
16757,6,2,58603,58603,58605,0,2,5
16758,2,3,58605,58605,58608,0,3,0
16759,1,2,58606,58608,58610,2,4,0
16760,4,3,58610,58610,58613,0,3,0
16761,6,2,58616,58616,58618,0,2,3
16762,4,2,58620,58620,58622,0,2,2
16763,6,1,58626,58626,58627,0,1,4
16764,1,3,58627,58627,58630,0,3,0
16765,3,1,58630,58630,58631,0,1,0
16766,3,1,58633,58633,58634,0,1,2
16767,4,2,58637,58637,58639,0,2,3
16768,6,1,58643,58643,58644,0,1,4
16769,4,1,58647,58647,58648,0,1,3
16770,4,3,58651,58651,58654,0,3,3
16771,3,3,58654,58654,58657,0,3,0
16772,1,1,58655,58657,58658,2,3,0
16773,6,2,58661,58661,58663,0,2,3
16774,3,3,58664,58664,58667,0,3,1
16775,5,1,58669,58669,58670,0,1,2
16776,4,2,58673,58673,58675,0,2,3
16777,6,1,58679,58679,58680,0,1,4
16778,5,3,58684,58684,58687,0,3,4
16779,3,3,58687,58687,58690,0,3,0
16780,4,2,58691,58691,58693,0,2,1
16781,1,3,58692,58693,58696,1,4,0
16782,3,3,58695,58696,58699,1,4,0
16783,6,2,58701,58701,58703,0,2,2
16784,6,2,58707,58707,58709,0,2,4
16785,5,3,58712,58712,58715,0,3,3
16786,2,1,58714,58715,58716,1,2,0
16787,6,2,58720,58720,58722,0,2,4
16788,3,1,58723,58723,58724,0,1,1
16789,4,1,58727,58727,58728,0,1,3
16790,6,2,58733,58733,58735,0,2,5
16791,4,3,58737,58737,58740,0,3,2
16792,5,2,58742,58742,58744,0,2,2
16793,1,1,58743,58744,58745,1,2,0
16794,1,2,58744,58745,58747,1,3,0
16795,4,2,58748,58748,58750,0,2,1
16796,6,3,58754,58754,58757,0,3,4
16797,5,2,58759,58759,58761,0,2,2
16798,6,2,58765,58765,58767,0,2,4
16799,1,1,58766,58767,58768,1,2,0
16800,4,1,58770,58770,58771,0,1,2
16801,6,2,58776,58776,58778,0,2,5
16802,1,3,58777,58778,58781,1,4,0
16803,4,2,58781,58781,58783,0,2,0
16804,6,1,58787,58787,58788,0,1,4
16805,3,1,58790,58790,58791,0,1,2
16806,6,1,58796,58796,58797,0,1,5
16807,4,3,58800,58800,58803,0,3,3
16808,6,1,58806,58806,58807,0,1,3
16809,1,2,58807,58807,58809,0,2,0
16810,6,1,58813,58813,58814,0,1,4
16811,2,1,58815,58815,58816,0,1,1
16812,1,2,58816,58816,58818,0,2,0
16813,4,3,58820,58820,58823,0,3,2
16814,1,2,58821,58823,58825,2,4,0
16815,6,2,58827,58827,58829,0,2,2
16816,6,2,58833,58833,58835,0,2,4
16817,6,2,58839,58839,58841,0,2,4
16818,2,2,58841,58841,58843,0,2,0
16819,5,3,58846,58846,58849,0,3,3
16820,5,1,58851,58851,58852,0,1,2
16821,3,1,58854,58854,58855,0,1,2
16822,1,1,58855,58855,58856,0,1,0
16823,4,3,58859,58859,58862,0,3,3
16824,6,1,58865,58865,58866,0,1,3
16825,4,1,58869,58869,58870,0,1,3
16826,6,3,58875,58875,58878,0,3,5
16827,5,2,58880,58880,58882,0,2,2
16828,2,2,58882,58882,58884,0,2,0
16829,6,1,58888,58888,58889,0,1,4
16830,1,2,58889,58889,58891,0,2,0
16831,2,1,58891,58891,58892,0,1,0
16832,6,2,58897,58897,58899,0,2,5
16833,1,3,58898,58899,58902,1,4,0
16834,6,2,58904,58904,58906,0,2,2
16835,4,3,58908,58908,58911,0,3,2
16836,5,1,58913,58913,58914,0,1,2
16837,5,2,58918,58918,58920,0,2,4
16838,4,3,58922,58922,58925,0,3,2
16839,3,1,58925,58925,58926,0,1,0
16840,5,2,58930,58930,58932,0,2,4
16841,1,1,58931,58932,58933,1,2,0
16842,2,2,58933,58933,58935,0,2,0
16843,3,3,58936,58936,58939,0,3,1
16844,6,1,58942,58942,58943,0,1,3
16845,5,3,58947,58947,58950,0,3,4
16846,3,3,58950,58950,58953,0,3,0
16847,3,3,58953,58953,58956,0,3,0
16848,1,3,58954,58956,58959,2,5,0
16849,5,3,58959,58959,58962,0,3,0
16850,5,1,58964,58964,58965,0,1,2
16851,2,2,58966,58966,58968,0,2,1
16852,5,2,58971,58971,58973,0,2,3
16853,1,1,58972,58973,58974,1,2,0
16854,3,2,58975,58975,58977,0,2,1
16855,4,3,58979,58979,58982,0,3,2
16856,4,2,58983,58983,58985,0,2,1
16857,3,2,58986,58986,58988,0,2,1
16858,3,1,58989,58989,58990,0,1,1
16859,6,1,58995,58995,58996,0,1,5
16860,1,2,58996,58996,58998,0,2,0
16861,5,1,59001,59001,59002,0,1,3
16862,4,2,59005,59005,59007,0,2,3
16863,3,1,59008,59008,59009,0,1,1
16864,5,1,59013,59013,59014,0,1,4
16865,1,1,59014,59014,59015,0,1,0
16866,4,3,59018,59018,59021,0,3,3
16867,5,3,59023,59023,59026,0,3,2
16868,3,2,59026,59026,59028,0,2,0
16869,2,2,59028,59028,59030,0,2,0
16870,2,3,59030,59030,59033,0,3,0
16871,6,3,59036,59036,59039,0,3,3
16872,5,2,59041,59041,59043,0,2,2
16873,3,1,59044,59044,59045,0,1,1
16874,6,2,59050,59050,59052,0,2,5
16875,1,1,59051,59052,59053,1,2,0
16876,4,2,59055,59055,59057,0,2,2
16877,6,3,59061,59061,59064,0,3,4
16878,2,1,59063,59064,59065,1,2,0
16879,4,1,59067,59067,59068,0,1,2
16880,5,1,59072,59072,59073,0,1,4
16881,2,1,59074,59074,59075,0,1,1
16882,1,3,59075,59075,59078,0,3,0
16883,4,1,59079,59079,59080,0,1,1
16884,4,1,59083,59083,59084,0,1,3
16885,4,1,59087,59087,59088,0,1,3
16886,2,1,59089,59089,59090,0,1,1
16887,1,1,59090,59090,59091,0,1,0
16888,6,2,59096,59096,59098,0,2,5
16889,4,2,59100,59100,59102,0,2,2
16890,1,3,59101,59102,59105,1,4,0
16891,2,3,59103,59105,59108,2,5,0
16892,6,2,59109,59109,59111,0,2,1
16893,1,1,59110,59111,59112,1,2,0
16894,6,1,59116,59116,59117,0,1,4
16895,4,2,59120,59120,59122,0,2,3
16896,6,2,59126,59126,59128,0,2,4
16897,3,2,59129,59129,59131,0,2,1
16898,6,3,59135,59135,59138,0,3,4
16899,6,1,59141,59141,59142,0,1,3
16900,6,3,59147,59147,59150,0,3,5
16901,2,1,59149,59150,59151,1,2,0
16902,5,2,59154,59154,59156,0,2,3
16903,2,2,59156,59156,59158,0,2,0
16904,3,3,59159,59159,59162,0,3,1
16905,6,2,59165,59165,59167,0,2,3
16906,6,3,59171,59171,59174,0,3,4
16907,2,2,59173,59174,59176,1,3,0
16908,4,3,59177,59177,59180,0,3,1
16909,1,1,59178,59180,59181,2,3,0
16910,4,3,59182,59182,59185,0,3,1
16911,6,2,59188,59188,59190,0,2,3
16912,4,2,59192,59192,59194,0,2,2
16913,4,3,59196,59196,59199,0,3,2
16914,1,3,59197,59199,59202,2,5,0
16915,3,3,59200,59202,59205,2,5,0
16916,2,3,59202,59205,59208,3,6,0
16917,6,2,59208,59208,59210,0,2,0
16918,1,1,59209,59210,59211,1,2,0
16919,6,1,59215,59215,59216,0,1,4
16920,1,1,59216,59216,59217,0,1,0
16921,3,3,59219,59219,59222,0,3,2
16922,4,2,59223,59223,59225,0,2,1
16923,2,2,59225,59225,59227,0,2,0
16924,1,2,59226,59227,59229,1,3,0
16925,6,3,59232,59232,59235,0,3,3
16926,5,3,59237,59237,59240,0,3,2
16927,5,2,59242,59242,59244,0,2,2
16928,6,1,59248,59248,59249,0,1,4
16929,2,3,59250,59250,59253,0,3,1
16930,5,1,59255,59255,59256,0,1,2
16931,3,3,59258,59258,59261,0,3,2
16932,4,3,59262,59262,59265,0,3,1
16933,5,1,59267,59267,59268,0,1,2
16934,1,3,59268,59268,59271,0,3,0
16935,1,2,59269,59271,59273,2,4,0
16936,3,3,59272,59273,59276,1,4,0
16937,3,2,59275,59276,59278,1,3,0
16938,6,2,59281,59281,59283,0,2,3
16939,1,2,59282,59283,59285,1,3,0
16940,5,2,59287,59287,59289,0,2,2
16941,4,3,59291,59291,59294,0,3,2
16942,3,1,59294,59294,59295,0,1,0
16943,4,1,59298,59298,59299,0,1,3
16944,1,1,59299,59299,59300,0,1,0
16945,6,2,59305,59305,59307,0,2,5
16946,4,1,59309,59309,59310,0,1,2
16947,1,3,59310,59310,59313,0,3,0
16948,3,2,59313,59313,59315,0,2,0
16949,4,2,59317,59317,59319,0,2,2
16950,1,3,59318,59319,59322,1,4,0
16951,3,3,59321,59322,59325,1,4,0
16952,3,1,59324,59325,59326,1,2,0
16953,2,1,59326,59326,59327,0,1,0
16954,3,3,59329,59329,59332,0,3,2
16955,1,2,59330,59332,59334,2,4,0
16956,2,1,59332,59334,59335,2,3,0
16957,2,3,59334,59335,59338,1,4,0
16958,5,2,59339,59339,59341,0,2,1
16959,1,3,59340,59341,59344,1,4,0
16960,5,1,59345,59345,59346,0,1,1
16961,6,1,59351,59351,59352,0,1,5
16962,2,3,59353,59353,59356,0,3,1
16963,2,3,59355,59356,59359,1,4,0
16964,6,2,59361,59361,59363,0,2,2
16965,6,1,59367,59367,59368,0,1,4
16966,2,2,59369,59369,59371,0,2,1
16967,4,1,59373,59373,59374,0,1,2
16968,4,3,59377,59377,59380,0,3,3
16969,2,2,59379,59380,59382,1,3,0
16970,6,3,59385,59385,59388,0,3,3
16971,2,3,59387,59388,59391,1,4,0
16972,1,2,59388,59391,59393,3,5,0
16973,3,2,59391,59393,59395,2,4,0
16974,6,3,59397,59397,59400,0,3,2
16975,1,1,59398,59400,59401,2,3,0
16976,3,1,59401,59401,59402,0,1,0
16977,1,2,59402,59402,59404,0,2,0
16978,3,3,59405,59405,59408,0,3,1
16979,6,2,59411,59411,59413,0,2,3
16980,2,1,59413,59413,59414,0,1,0
16981,5,3,59418,59418,59421,0,3,4
16982,3,2,59421,59421,59423,0,2,0
16983,3,2,59424,59424,59426,0,2,1
16984,3,1,59427,59427,59428,0,1,1
16985,2,3,59429,59429,59432,0,3,1
16986,4,1,59433,59433,59434,0,1,1
16987,5,3,59438,59438,59441,0,3,4
16988,1,3,59439,59441,59444,2,5,0
16989,3,1,59442,59444,59445,2,3,0
16990,6,1,59448,59448,59449,0,1,3
16991,5,3,59453,59453,59456,0,3,4
16992,5,2,59458,59458,59460,0,2,2
16993,4,1,59462,59462,59463,0,1,2
16994,3,2,59465,59465,59467,0,2,2
16995,6,1,59471,59471,59472,0,1,4
16996,2,2,59473,59473,59475,0,2,1
16997,2,1,59475,59475,59476,0,1,0
16998,1,2,59476,59476,59478,0,2,0
16999,6,1,59482,59482,59483,0,1,4
17000,1,3,59483,59483,59486,0,3,0
17001,5,3,59488,59488,59491,0,3,2
17002,5,1,59493,59493,59494,0,1,2
17003,1,3,59494,59494,59497,0,3,0
17004,1,2,59495,59497,59499,2,4,0
17005,2,3,59497,59499,59502,2,5,0
17006,2,1,59499,59502,59503,3,4,0
17007,3,3,59502,59503,59506,1,4,0
17008,5,3,59507,59507,59510,0,3,1
17009,5,2,59512,59512,59514,0,2,2
17010,3,3,59515,59515,59518,0,3,1
17011,3,1,59518,59518,59519,0,1,0
17012,2,1,59520,59520,59521,0,1,1
17013,3,3,59523,59523,59526,0,3,2
17014,2,2,59525,59526,59528,1,3,0
17015,5,1,59530,59530,59531,0,1,2
17016,1,1,59531,59531,59532,0,1,0
17017,4,2,59535,59535,59537,0,2,3
17018,2,3,59537,59537,59540,0,3,0
17019,3,3,59540,59540,59543,0,3,0
17020,4,3,59544,59544,59547,0,3,1
17021,4,1,59548,59548,59549,0,1,1
17022,5,1,59553,59553,59554,0,1,4
17023,4,2,59557,59557,59559,0,2,3
17024,3,3,59560,59560,59563,0,3,1
17025,1,2,59561,59563,59565,2,4,0
17026,3,1,59564,59565,59566,1,2,0
17027,6,1,59570,59570,59571,0,1,4
17028,4,1,59574,59574,59575,0,1,3
17029,2,3,59576,59576,59579,0,3,1
17030,2,3,59578,59579,59582,1,4,0
17031,2,2,59580,59582,59584,2,4,0
17032,6,2,59586,59586,59588,0,2,2
17033,3,2,59589,59589,59591,0,2,1
17034,4,1,59593,59593,59594,0,1,2
17035,6,1,59599,59599,59600,0,1,5
17036,3,3,59602,59602,59605,0,3,2
17037,3,1,59605,59605,59606,0,1,0
17038,5,3,59610,59610,59613,0,3,4
17039,2,2,59612,59613,59615,1,3,0
17040,2,1,59614,59615,59616,1,2,0
17041,5,2,59619,59619,59621,0,2,3
17042,1,2,59620,59621,59623,1,3,0
17043,1,2,59621,59623,59625,2,4,0
17044,1,1,59622,59625,59626,3,4,0
17045,6,2,59628,59628,59630,0,2,2
17046,2,1,59630,59630,59631,0,1,0
17047,4,2,59634,59634,59636,0,2,3
17048,1,2,59635,59636,59638,1,3,0
17049,3,2,59638,59638,59640,0,2,0
17050,5,1,59643,59643,59644,0,1,3
17051,3,3,59646,59646,59649,0,3,2
17052,2,1,59648,59649,59650,1,2,0
17053,4,2,59652,59652,59654,0,2,2
17054,5,1,59657,59657,59658,0,1,3
17055,5,2,59662,59662,59664,0,2,4
17056,4,3,59666,59666,59669,0,3,2
17057,5,3,59671,59671,59674,0,3,2
17058,6,2,59677,59677,59679,0,2,3
17059,2,2,59679,59679,59681,0,2,0
17060,5,2,59684,59684,59686,0,2,3
17061,5,1,59689,59689,59690,0,1,3
17062,5,2,59694,59694,59696,0,2,4
17063,5,2,59699,59699,59701,0,2,3
17064,4,1,59703,59703,59704,0,1,2
17065,3,2,59706,59706,59708,0,2,2
17066,3,3,59709,59709,59712,0,3,1
17067,5,3,59714,59714,59717,0,3,2
17068,2,1,59716,59717,59718,1,2,0
17069,3,2,59719,59719,59721,0,2,1
17070,1,1,59720,59721,59722,1,2,0
17071,5,2,59725,59725,59727,0,2,3
17072,6,1,59731,59731,59732,0,1,4
17073,2,2,59733,59733,59735,0,2,1
17074,1,2,59734,59735,59737,1,3,0
17075,2,1,59736,59737,59738,1,2,0
17076,1,2,59737,59738,59740,1,3,0
17077,6,1,59743,59743,59744,0,1,3
17078,6,2,59749,59749,59751,0,2,5
17079,5,3,59754,59754,59757,0,3,3
17080,5,3,59759,59759,59762,0,3,2
17081,5,3,59764,59764,59767,0,3,2
17082,3,3,59767,59767,59770,0,3,0
17083,2,3,59769,59770,59773,1,4,0
17084,6,1,59775,59775,59776,0,1,2
17085,6,3,59781,59781,59784,0,3,5
17086,2,3,59783,59784,59787,1,4,0
17087,3,3,59786,59787,59790,1,4,0
17088,5,2,59791,59791,59793,0,2,1
17089,3,1,59794,59794,59795,0,1,1
17090,4,2,59798,59798,59800,0,2,3
17091,3,3,59801,59801,59804,0,3,1
17092,4,2,59805,59805,59807,0,2,1
17093,3,2,59808,59808,59810,0,2,1
17094,3,1,59811,59811,59812,0,1,1
17095,4,2,59815,59815,59817,0,2,3
17096,2,1,59817,59817,59818,0,1,0
17097,1,1,59818,59818,59819,0,1,0
17098,6,2,59824,59824,59826,0,2,5
17099,4,3,59828,59828,59831,0,3,2
17100,2,3,59830,59831,59834,1,4,0
17101,2,3,59832,59834,59837,2,5,0
17102,4,3,59836,59837,59840,1,4,0
17103,6,1,59842,59842,59843,0,1,2
17104,3,1,59845,59845,59846,0,1,2
17105,4,2,59849,59849,59851,0,2,3
17106,3,2,59852,59852,59854,0,2,1
17107,4,2,59856,59856,59858,0,2,2
17108,3,1,59859,59859,59860,0,1,1
17109,4,1,59863,59863,59864,0,1,3
17110,1,3,59864,59864,59867,0,3,0
17111,3,1,59867,59867,59868,0,1,0
17112,2,3,59869,59869,59872,0,3,1
17113,2,3,59871,59872,59875,1,4,0
17114,4,1,59875,59875,59876,0,1,0
17115,2,1,59877,59877,59878,0,1,1
17116,2,1,59879,59879,59880,0,1,1
17117,1,2,59880,59880,59882,0,2,0
17118,2,2,59882,59882,59884,0,2,0
17119,5,3,59887,59887,59890,0,3,3
17120,5,3,59892,59892,59895,0,3,2
17121,1,3,59893,59895,59898,2,5,0
17122,6,2,59899,59899,59901,0,2,1
17123,1,2,59900,59901,59903,1,3,0
17124,1,1,59901,59903,59904,2,3,0
17125,5,3,59906,59906,59909,0,3,2
17126,5,1,59911,59911,59912,0,1,2
17127,5,3,59916,59916,59919,0,3,4
17128,2,1,59918,59919,59920,1,2,0
17129,6,2,59924,59924,59926,0,2,4
17130,6,2,59930,59930,59932,0,2,4
17131,1,3,59931,59932,59935,1,4,0
17132,4,2,59935,59935,59937,0,2,0
17133,3,2,59938,59938,59940,0,2,1
17134,1,3,59939,59940,59943,1,4,0
17135,6,3,59945,59945,59948,0,3,2
17136,1,1,59946,59948,59949,2,3,0
17137,6,1,59952,59952,59953,0,1,3
17138,3,2,59955,59955,59957,0,2,2
17139,1,3,59956,59957,59960,1,4,0
17140,5,1,59961,59961,59962,0,1,1
17141,6,1,59967,59967,59968,0,1,5
17142,2,1,59969,59969,59970,0,1,1
17143,5,3,59974,59974,59977,0,3,4
17144,3,1,59977,59977,59978,0,1,0
17145,4,3,59981,59981,59984,0,3,3
17146,1,1,59982,59984,59985,2,3,0
17147,3,2,59985,59985,59987,0,2,0
17148,6,3,59991,59991,59994,0,3,4
17149,5,2,59996,59996,59998,0,2,2
17150,1,1,59997,59998,59999,1,2,0
17151,4,3,60001,60001,60004,0,3,2
17152,6,2,60007,60007,60009,0,2,3
17153,2,1,60009,60009,60010,0,1,0
17154,2,3,60011,60011,60014,0,3,1
17155,3,3,60014,60014,60017,0,3,0
17156,1,3,60015,60017,60020,2,5,0
17157,5,2,60020,60020,60022,0,2,0
17158,6,3,60026,60026,60029,0,3,4
17159,5,2,60031,60031,60033,0,2,2
17160,3,1,60034,60034,60035,0,1,1
17161,1,3,60035,60035,60038,0,3,0
17162,4,3,60039,60039,60042,0,3,1
17163,2,3,60041,60042,60045,1,4,0
17164,5,1,60046,60046,60047,0,1,1
17165,1,3,60047,60047,60050,0,3,0
17166,1,1,60048,60050,60051,2,3,0
17167,2,1,60050,60051,60052,1,2,0
17168,1,2,60051,60052,60054,1,3,0
17169,4,2,60055,60055,60057,0,2,1
17170,3,2,60058,60058,60060,0,2,1
17171,3,3,60061,60061,60064,0,3,1
17172,2,1,60063,60064,60065,1,2,0
17173,5,1,60068,60068,60069,0,1,3
17174,6,2,60074,60074,60076,0,2,5
17175,5,2,60079,60079,60081,0,2,3
17176,5,1,60084,60084,60085,0,1,3
17177,6,1,60090,60090,60091,0,1,5
17178,3,2,60093,60093,60095,0,2,2
17179,3,1,60096,60096,60097,0,1,1
17180,6,2,60102,60102,60104,0,2,5
17181,2,1,60104,60104,60105,0,1,0
17182,2,2,60106,60106,60108,0,2,1
17183,6,2,60112,60112,60114,0,2,4
17184,2,1,60114,60114,60115,0,1,0
17185,1,3,60115,60115,60118,0,3,0
17186,5,2,60120,60120,60122,0,2,2
17187,2,3,60122,60122,60125,0,3,0
17188,4,1,60126,60126,60127,0,1,1
17189,6,2,60132,60132,60134,0,2,5
17190,2,3,60134,60134,60137,0,3,0
17191,4,1,60138,60138,60139,0,1,1
17192,2,2,60140,60140,60142,0,2,1
17193,1,3,60141,60142,60145,1,4,0
17194,3,3,60144,60145,60148,1,4,0
17195,1,1,60145,60148,60149,3,4,0
17196,6,1,60151,60151,60152,0,1,2
17197,1,2,60152,60152,60154,0,2,0
17198,1,3,60153,60154,60157,1,4,0
17199,1,1,60154,60157,60158,3,4,0
17200,3,1,60157,60158,60159,1,2,0
17201,2,3,60159,60159,60162,0,3,0
17202,5,3,60164,60164,60167,0,3,2
17203,1,3,60165,60167,60170,2,5,0
17204,1,2,60166,60170,60172,4,6,0
17205,2,3,60168,60172,60175,4,7,0
17206,6,1,60174,60175,60176,1,2,0
17207,6,1,60180,60180,60181,0,1,4
17208,5,2,60185,60185,60187,0,2,4
17209,3,2,60188,60188,60190,0,2,1
17210,3,2,60191,60191,60193,0,2,1
17211,5,1,60196,60196,60197,0,1,3
17212,6,1,60202,60202,60203,0,1,5
17213,1,2,60203,60203,60205,0,2,0
17214,4,3,60207,60207,60210,0,3,2
17215,2,2,60209,60210,60212,1,3,0
17216,1,2,60210,60212,60214,2,4,0
17217,4,1,60214,60214,60215,0,1,0
17218,5,1,60219,60219,60220,0,1,4
17219,1,2,60220,60220,60222,0,2,0
17220,4,2,60224,60224,60226,0,2,2
17221,1,1,60225,60226,60227,1,2,0
17222,1,1,60226,60227,60228,1,2,0
17223,1,1,60227,60228,60229,1,2,0
17224,4,1,60231,60231,60232,0,1,2
17225,6,2,60237,60237,60239,0,2,5
17226,3,2,60240,60240,60242,0,2,1
17227,4,3,60244,60244,60247,0,3,2
17228,1,1,60245,60247,60248,2,3,0
17229,2,3,60247,60248,60251,1,4,0
17230,1,3,60248,60251,60254,3,6,0
17231,1,3,60249,60254,60257,5,8,0
17232,6,2,60255,60257,60259,2,4,0
17233,6,1,60261,60261,60262,0,1,2
17234,2,3,60263,60263,60266,0,3,1
17235,5,3,60268,60268,60271,0,3,2
17236,1,2,60269,60271,60273,2,4,0
17237,4,3,60273,60273,60276,0,3,0
17238,5,3,60278,60278,60281,0,3,2
17239,2,1,60280,60281,60282,1,2,0
17240,6,1,60286,60286,60287,0,1,4
17241,4,2,60290,60290,60292,0,2,3
17242,2,3,60292,60292,60295,0,3,0
17243,4,2,60296,60296,60298,0,2,1
17244,6,2,60302,60302,60304,0,2,4
17245,2,3,60304,60304,60307,0,3,0
17246,2,2,60306,60307,60309,1,3,0
17247,5,3,60311,60311,60314,0,3,2
17248,6,2,60317,60317,60319,0,2,3
17249,2,1,60319,60319,60320,0,1,0
17250,6,2,60325,60325,60327,0,2,5
17251,3,1,60328,60328,60329,0,1,1
17252,4,1,60332,60332,60333,0,1,3
17253,1,3,60333,60333,60336,0,3,0
17254,1,1,60334,60336,60337,2,3,0
17255,4,3,60338,60338,60341,0,3,1
17256,3,1,60341,60341,60342,0,1,0
17257,6,3,60347,60347,60350,0,3,5
17258,2,1,60349,60350,60351,1,2,0
17259,4,1,60353,60353,60354,0,1,2
17260,1,1,60354,60354,60355,0,1,0
17261,3,2,60357,60357,60359,0,2,2
17262,3,1,60360,60360,60361,0,1,1
17263,1,1,60361,60361,60362,0,1,0
17264,3,2,60364,60364,60366,0,2,2
17265,4,1,60368,60368,60369,0,1,2
17266,5,2,60373,60373,60375,0,2,4
17267,3,1,60376,60376,60377,0,1,1
17268,2,1,60378,60378,60379,0,1,1
17269,5,1,60383,60383,60384,0,1,4
17270,4,1,60387,60387,60388,0,1,3
17271,4,2,60391,60391,60393,0,2,3
17272,3,2,60394,60394,60396,0,2,1
17273,3,1,60397,60397,60398,0,1,1
17274,3,2,60400,60400,60402,0,2,2
17275,5,3,60405,60405,60408,0,3,3
17276,4,3,60409,60409,60412,0,3,1
17277,4,3,60413,60413,60416,0,3,1
17278,1,1,60414,60416,60417,2,3,0
17279,1,1,60415,60417,60418,2,3,0
17280,5,2,60420,60420,60422,0,2,2
17281,3,1,60423,60423,60424,0,1,1
17282,3,3,60426,60426,60429,0,3,2
17283,2,1,60428,60429,60430,1,2,0
17284,3,1,60431,60431,60432,0,1,1
17285,1,3,60432,60432,60435,0,3,0
17286,3,3,60435,60435,60438,0,3,0
17287,4,1,60439,60439,60440,0,1,1
17288,1,2,60440,60440,60442,0,2,0
17289,5,2,60445,60445,60447,0,2,3
17290,3,2,60448,60448,60450,0,2,1
17291,1,2,60449,60450,60452,1,3,0
17292,1,2,60450,60452,60454,2,4,0
17293,4,3,60454,60454,60457,0,3,0
17294,2,3,60456,60457,60460,1,4,0
17295,3,2,60459,60460,60462,1,3,0
17296,2,1,60461,60462,60463,1,2,0
17297,4,2,60465,60465,60467,0,2,2
17298,3,3,60468,60468,60471,0,3,1
17299,4,1,60472,60472,60473,0,1,1
17300,2,2,60474,60474,60476,0,2,1
17301,2,1,60476,60476,60477,0,1,0
17302,4,3,60480,60480,60483,0,3,3
17303,1,2,60481,60483,60485,2,4,0
17304,1,1,60482,60485,60486,3,4,0
17305,5,3,60487,60487,60490,0,3,1
17306,6,2,60493,60493,60495,0,2,3
17307,2,2,60495,60495,60497,0,2,0
17308,6,2,60501,60501,60503,0,2,4
17309,6,1,60507,60507,60508,0,1,4
17310,3,3,60510,60510,60513,0,3,2
17311,3,3,60513,60513,60516,0,3,0
17312,3,2,60516,60516,60518,0,2,0
17313,4,2,60520,60520,60522,0,2,2
17314,1,3,60521,60522,60525,1,4,0
17315,1,1,60522,60525,60526,3,4,0
17316,5,2,60527,60527,60529,0,2,1
17317,4,1,60531,60531,60532,0,1,2
17318,6,1,60537,60537,60538,0,1,5
17319,5,2,60542,60542,60544,0,2,4
17320,4,3,60546,60546,60549,0,3,2
17321,5,3,60551,60551,60554,0,3,2
17322,4,2,60555,60555,60557,0,2,1
17323,4,2,60559,60559,60561,0,2,2
17324,5,3,60564,60564,60567,0,3,3
17325,5,3,60569,60569,60572,0,3,2
17326,5,3,60574,60574,60577,0,3,2
17327,3,3,60577,60577,60580,0,3,0
17328,4,3,60581,60581,60584,0,3,1
17329,5,3,60586,60586,60589,0,3,2
17330,5,2,60591,60591,60593,0,2,2
17331,5,1,60596,60596,60597,0,1,3
17332,2,2,60598,60598,60600,0,2,1
17333,2,1,60600,60600,60601,0,1,0
17334,4,1,60604,60604,60605,0,1,3
17335,2,3,60606,60606,60609,0,3,1
17336,4,3,60610,60610,60613,0,3,1
17337,4,3,60614,60614,60617,0,3,1
17338,3,1,60617,60617,60618,0,1,0
17339,4,1,60621,60621,60622,0,1,3
17340,3,2,60624,60624,60626,0,2,2
17341,4,2,60628,60628,60630,0,2,2
17342,2,2,60630,60630,60632,0,2,0
17343,4,3,60634,60634,60637,0,3,2
17344,2,1,60636,60637,60638,1,2,0
17345,4,2,60640,60640,60642,0,2,2
17346,5,2,60645,60645,60647,0,2,3
17347,5,3,60650,60650,60653,0,3,3
17348,1,1,60651,60653,60654,2,3,0
17349,1,3,60652,60654,60657,2,5,0
17350,3,3,60655,60657,60660,2,5,0
17351,4,1,60659,60660,60661,1,2,0
17352,1,3,60660,60661,60664,1,4,0
17353,2,1,60662,60664,60665,2,3,0
17354,5,1,60667,60667,60668,0,1,2
17355,3,1,60670,60670,60671,0,1,2
17356,6,3,60676,60676,60679,0,3,5
17357,6,1,60682,60682,60683,0,1,3
17358,2,3,60684,60684,60687,0,3,1
17359,6,3,60690,60690,60693,0,3,3
17360,1,2,60691,60693,60695,2,4,0
17361,1,3,60692,60695,60698,3,6,0
17362,4,1,60696,60698,60699,2,3,0
17363,3,3,60699,60699,60702,0,3,0
17364,3,1,60702,60702,60703,0,1,0
17365,6,3,60708,60708,60711,0,3,5
17366,3,3,60711,60711,60714,0,3,0
17367,6,3,60717,60717,60720,0,3,3
17368,1,2,60718,60720,60722,2,4,0
17369,4,1,60722,60722,60723,0,1,0
17370,3,1,60725,60725,60726,0,1,2
17371,3,3,60728,60728,60731,0,3,2
17372,3,3,60731,60731,60734,0,3,0
17373,3,2,60734,60734,60736,0,2,0
17374,3,3,60737,60737,60740,0,3,1
17375,4,2,60741,60741,60743,0,2,1
17376,3,1,60744,60744,60745,0,1,1
17377,2,3,60746,60746,60749,0,3,1
17378,5,1,60751,60751,60752,0,1,2
17379,2,2,60753,60753,60755,0,2,1
17380,4,3,60757,60757,60760,0,3,2
17381,1,3,60758,60760,60763,2,5,0
17382,5,1,60763,60763,60764,0,1,0
17383,1,1,60764,60764,60765,0,1,0
17384,4,1,60768,60768,60769,0,1,3
17385,6,1,60774,60774,60775,0,1,5
17386,3,1,60777,60777,60778,0,1,2
17387,5,2,60782,60782,60784,0,2,4
17388,5,3,60787,60787,60790,0,3,3
17389,5,3,60792,60792,60795,0,3,2
17390,4,1,60796,60796,60797,0,1,1
17391,2,3,60798,60798,60801,0,3,1
17392,6,1,60804,60804,60805,0,1,3
17393,2,3,60806,60806,60809,0,3,1
17394,5,1,60811,60811,60812,0,1,2
17395,4,1,60815,60815,60816,0,1,3
17396,5,2,60820,60820,60822,0,2,4
17397,5,2,60825,60825,60827,0,2,3
17398,1,1,60826,60827,60828,1,2,0
17399,3,3,60829,60829,60832,0,3,1
17400,4,3,60833,60833,60836,0,3,1
17401,6,1,60839,60839,60840,0,1,3
17402,2,2,60841,60841,60843,0,2,1
17403,1,3,60842,60843,60846,1,4,0
17404,6,3,60848,60848,60851,0,3,2
17405,1,1,60849,60851,60852,2,3,0
17406,1,1,60850,60852,60853,2,3,0
17407,2,3,60852,60853,60856,1,4,0
17408,1,2,60853,60856,60858,3,5,0
17409,3,2,60856,60858,60860,2,4,0
17410,6,2,60862,60862,60864,0,2,2
17411,1,3,60863,60864,60867,1,4,0
17412,1,3,60864,60867,60870,3,6,0
17413,4,1,60868,60870,60871,2,3,0
17414,1,3,60869,60871,60874,2,5,0
17415,4,1,60873,60874,60875,1,2,0
17416,4,2,60877,60877,60879,0,2,2
17417,1,1,60878,60879,60880,1,2,0
17418,6,1,60884,60884,60885,0,1,4
17419,5,1,60889,60889,60890,0,1,4
17420,4,1,60893,60893,60894,0,1,3
17421,3,3,60896,60896,60899,0,3,2
17422,1,1,60897,60899,60900,2,3,0
17423,4,3,60901,60901,60904,0,3,1
17424,1,2,60902,60904,60906,2,4,0
17425,5,2,60907,60907,60909,0,2,1
17426,1,3,60908,60909,60912,1,4,0
17427,4,3,60912,60912,60915,0,3,0
17428,3,3,60915,60915,60918,0,3,0
17429,2,3,60917,60918,60921,1,4,0
17430,4,2,60921,60921,60923,0,2,0
17431,5,1,60926,60926,60927,0,1,3
17432,3,3,60929,60929,60932,0,3,2
17433,3,3,60932,60932,60935,0,3,0
17434,5,1,60937,60937,60938,0,1,2
17435,2,3,60939,60939,60942,0,3,1
17436,2,3,60941,60942,60945,1,4,0
17437,5,2,60946,60946,60948,0,2,1
17438,6,3,60952,60952,60955,0,3,4
17439,4,1,60956,60956,60957,0,1,1
17440,6,1,60962,60962,60963,0,1,5
17441,4,3,60966,60966,60969,0,3,3
17442,1,2,60967,60969,60971,2,4,0
17443,4,2,60971,60971,60973,0,2,0
17444,2,3,60973,60973,60976,0,3,0
17445,6,2,60979,60979,60981,0,2,3
17446,4,2,60983,60983,60985,0,2,2
17447,6,1,60989,60989,60990,0,1,4
17448,5,3,60994,60994,60997,0,3,4
17449,5,3,60999,60999,61002,0,3,2
17450,4,2,61003,61003,61005,0,2,1
17451,1,3,61004,61005,61008,1,4,0
17452,4,1,61008,61008,61009,0,1,0
17453,4,3,61012,61012,61015,0,3,3
17454,1,1,61013,61015,61016,2,3,0
17455,6,3,61019,61019,61022,0,3,3
17456,2,3,61021,61022,61025,1,4,0
17457,5,2,61026,61026,61028,0,2,1
17458,2,3,61028,61028,61031,0,3,0
17459,5,3,61033,61033,61036,0,3,2
17460,5,1,61038,61038,61039,0,1,2
17461,3,3,61041,61041,61044,0,3,2
17462,5,3,61046,61046,61049,0,3,2
17463,1,2,61047,61049,61051,2,4,0
17464,2,3,61049,61051,61054,2,5,0
17465,3,1,61052,61054,61055,2,3,0
17466,1,2,61053,61055,61057,2,4,0
17467,5,2,61058,61058,61060,0,2,1
17468,2,1,61060,61060,61061,0,1,0
17469,2,1,61062,61062,61063,0,1,1
17470,4,1,61066,61066,61067,0,1,3
17471,1,2,61067,61067,61069,0,2,0
17472,4,3,61071,61071,61074,0,3,2
17473,2,2,61073,61074,61076,1,3,0
17474,2,2,61075,61076,61078,1,3,0
17475,4,3,61079,61079,61082,0,3,1
17476,4,3,61083,61083,61086,0,3,1
17477,4,3,61087,61087,61090,0,3,1
17478,5,1,61092,61092,61093,0,1,2
17479,6,3,61098,61098,61101,0,3,5
17480,5,1,61103,61103,61104,0,1,2
17481,3,2,61106,61106,61108,0,2,2
17482,2,1,61108,61108,61109,0,1,0
17483,1,1,61109,61109,61110,0,1,0
17484,5,1,61114,61114,61115,0,1,4
17485,3,2,61117,61117,61119,0,2,2
17486,3,2,61120,61120,61122,0,2,1
17487,3,3,61123,61123,61126,0,3,1
17488,1,1,61124,61126,61127,2,3,0
17489,6,1,61130,61130,61131,0,1,3
17490,3,2,61133,61133,61135,0,2,2
17491,6,3,61139,61139,61142,0,3,4
17492,5,2,61144,61144,61146,0,2,2
17493,3,3,61147,61147,61150,0,3,1
17494,2,3,61149,61150,61153,1,4,0
17495,6,1,61155,61155,61156,0,1,2
17496,4,1,61159,61159,61160,0,1,3
17497,1,2,61160,61160,61162,0,2,0
17498,3,1,61163,61163,61164,0,1,1
17499,5,2,61168,61168,61170,0,2,4
17500,2,2,61170,61170,61172,0,2,0
17501,3,3,61173,61173,61176,0,3,1
17502,4,2,61177,61177,61179,0,2,1
17503,5,1,61182,61182,61183,0,1,3
17504,5,2,61187,61187,61189,0,2,4
17505,1,1,61188,61189,61190,1,2,0
17506,3,3,61191,61191,61194,0,3,1
17507,5,1,61196,61196,61197,0,1,2
17508,1,1,61197,61197,61198,0,1,0
17509,5,3,61202,61202,61205,0,3,4
17510,5,2,61207,61207,61209,0,2,2
17511,6,2,61213,61213,61215,0,2,4
17512,4,2,61217,61217,61219,0,2,2
17513,4,3,61221,61221,61224,0,3,2
17514,1,3,61222,61224,61227,2,5,0
17515,6,1,61228,61228,61229,0,1,1
17516,3,2,61231,61231,61233,0,2,2
17517,1,3,61232,61233,61236,1,4,0
17518,2,3,61234,61236,61239,2,5,0
17519,2,2,61236,61239,61241,3,5,0
17520,1,2,61237,61241,61243,4,6,0
17521,6,2,61243,61243,61245,0,2,0
17522,3,2,61246,61246,61248,0,2,1
17523,6,1,61252,61252,61253,0,1,4
17524,6,1,61258,61258,61259,0,1,5
17525,6,3,61264,61264,61267,0,3,5
17526,5,1,61269,61269,61270,0,1,2
17527,3,1,61272,61272,61273,0,1,2
17528,5,1,61277,61277,61278,0,1,4
17529,2,3,61279,61279,61282,0,3,1
17530,2,3,61281,61282,61285,1,4,0
17531,1,1,61282,61285,61286,3,4,0
17532,5,3,61287,61287,61290,0,3,1
17533,6,3,61293,61293,61296,0,3,3
17534,1,2,61294,61296,61298,2,4,0
17535,6,1,61300,61300,61301,0,1,2
17536,1,2,61301,61301,61303,0,2,0
17537,1,3,61302,61303,61306,1,4,0
17538,1,2,61303,61306,61308,3,5,0
17539,3,1,61306,61308,61309,2,3,0
17540,2,1,61308,61309,61310,1,2,0
17541,3,2,61311,61311,61313,0,2,1
17542,4,2,61315,61315,61317,0,2,2
17543,5,2,61320,61320,61322,0,2,3
17544,2,1,61322,61322,61323,0,1,0
17545,4,2,61326,61326,61328,0,2,3
17546,6,1,61332,61332,61333,0,1,4
17547,3,1,61335,61335,61336,0,1,2
17548,6,3,61341,61341,61344,0,3,5
17549,4,3,61345,61345,61348,0,3,1
17550,2,3,61347,61348,61351,1,4,0
17551,2,2,61349,61351,61353,2,4,0
17552,6,2,61355,61355,61357,0,2,2
17553,6,3,61361,61361,61364,0,3,4
17554,1,3,61362,61364,61367,2,5,0
17555,6,3,61368,61368,61371,0,3,1
17556,5,3,61373,61373,61376,0,3,2
17557,2,3,61375,61376,61379,1,4,0
17558,4,2,61379,61379,61381,0,2,0
17559,2,3,61381,61381,61384,0,3,0
17560,2,3,61383,61384,61387,1,4,0
17561,4,1,61387,61387,61388,0,1,0
17562,2,1,61389,61389,61390,0,1,1
17563,5,3,61394,61394,61397,0,3,4
17564,6,1,61400,61400,61401,0,1,3
17565,2,2,61402,61402,61404,0,2,1
17566,1,2,61403,61404,61406,1,3,0
17567,4,3,61407,61407,61410,0,3,1
17568,6,2,61413,61413,61415,0,2,3
17569,2,1,61415,61415,61416,0,1,0
17570,6,3,61421,61421,61424,0,3,5
17571,3,1,61424,61424,61425,0,1,0
17572,6,2,61430,61430,61432,0,2,5
17573,5,2,61435,61435,61437,0,2,3
17574,2,2,61437,61437,61439,0,2,0
17575,4,1,61441,61441,61442,0,1,2
17576,6,2,61447,61447,61449,0,2,5
17577,2,3,61449,61449,61452,0,3,0
17578,5,2,61454,61454,61456,0,2,2
17579,3,1,61457,61457,61458,0,1,1
17580,6,3,61463,61463,61466,0,3,5
17581,6,2,61469,61469,61471,0,2,3
17582,2,2,61471,61471,61473,0,2,0
17583,4,3,61475,61475,61478,0,3,2
17584,3,1,61478,61478,61479,0,1,0
17585,4,3,61482,61482,61485,0,3,3
17586,3,3,61485,61485,61488,0,3,0
17587,4,2,61489,61489,61491,0,2,1
17588,3,1,61492,61492,61493,0,1,1
17589,4,1,61496,61496,61497,0,1,3
17590,1,1,61497,61497,61498,0,1,0
17591,6,3,61503,61503,61506,0,3,5
17592,1,2,61504,61506,61508,2,4,0
17593,4,2,61508,61508,61510,0,2,0
17594,2,1,61510,61510,61511,0,1,0
17595,6,2,61516,61516,61518,0,2,5
17596,2,2,61518,61518,61520,0,2,0
17597,5,3,61523,61523,61526,0,3,3
17598,5,3,61528,61528,61531,0,3,2
17599,2,2,61530,61531,61533,1,3,0
17600,6,1,61536,61536,61537,0,1,3
17601,3,1,61539,61539,61540,0,1,2
17602,1,2,61540,61540,61542,0,2,0
17603,1,2,61541,61542,61544,1,3,0
17604,5,3,61546,61546,61549,0,3,2
17605,3,3,61549,61549,61552,0,3,0
17606,6,2,61555,61555,61557,0,2,3
17607,2,3,61557,61557,61560,0,3,0
17608,1,3,61558,61560,61563,2,5,0
17609,6,3,61564,61564,61567,0,3,1
17610,3,3,61567,61567,61570,0,3,0
17611,1,2,61568,61570,61572,2,4,0
17612,4,2,61572,61572,61574,0,2,0
17613,5,2,61577,61577,61579,0,2,3
17614,3,3,61580,61580,61583,0,3,1
17615,5,3,61585,61585,61588,0,3,2
17616,5,3,61590,61590,61593,0,3,2
17617,3,1,61593,61593,61594,0,1,0
17618,1,3,61594,61594,61597,0,3,0
17619,4,3,61598,61598,61601,0,3,1
17620,1,1,61599,61601,61602,2,3,0
17621,6,3,61605,61605,61608,0,3,3
17622,3,1,61608,61608,61609,0,1,0
17623,6,3,61614,61614,61617,0,3,5
17624,2,2,61616,61617,61619,1,3,0
17625,6,1,61622,61622,61623,0,1,3
17626,3,3,61625,61625,61628,0,3,2
17627,3,2,61628,61628,61630,0,2,0
17628,2,3,61630,61630,61633,0,3,0
17629,1,3,61631,61633,61636,2,5,0
17630,4,2,61635,61636,61638,1,3,0
17631,6,3,61641,61641,61644,0,3,3
17632,3,2,61644,61644,61646,0,2,0
17633,1,2,61645,61646,61648,1,3,0
17634,2,2,61647,61648,61650,1,3,0
17635,6,3,61653,61653,61656,0,3,3
17636,5,3,61658,61658,61661,0,3,2
17637,1,3,61659,61661,61664,2,5,0
17638,5,1,61664,61664,61665,0,1,0
17639,5,1,61669,61669,61670,0,1,4
17640,6,3,61675,61675,61678,0,3,5
17641,3,1,61678,61678,61679,0,1,0
17642,4,3,61682,61682,61685,0,3,3
17643,3,3,61685,61685,61688,0,3,0
17644,6,2,61691,61691,61693,0,2,3
17645,2,1,61693,61693,61694,0,1,0
17646,3,1,61696,61696,61697,0,1,2
17647,4,3,61700,61700,61703,0,3,3
17648,5,1,61705,61705,61706,0,1,2
17649,2,3,61707,61707,61710,0,3,1
17650,1,2,61708,61710,61712,2,4,0
17651,1,2,61709,61712,61714,3,5,0
17652,6,2,61715,61715,61717,0,2,1
17653,5,3,61720,61720,61723,0,3,3
17654,3,3,61723,61723,61726,0,3,0
17655,2,3,61725,61726,61729,1,4,0
17656,5,3,61730,61730,61733,0,3,1
17657,5,1,61735,61735,61736,0,1,2
17658,3,1,61738,61738,61739,0,1,2
17659,5,1,61743,61743,61744,0,1,4
17660,5,3,61748,61748,61751,0,3,4
17661,4,2,61752,61752,61754,0,2,1
17662,3,2,61755,61755,61757,0,2,1
17663,6,2,61761,61761,61763,0,2,4
17664,1,3,61762,61763,61766,1,4,0
17665,3,2,61765,61766,61768,1,3,0
17666,6,3,61771,61771,61774,0,3,3
17667,4,2,61775,61775,61777,0,2,1
17668,4,1,61779,61779,61780,0,1,2
17669,1,3,61780,61780,61783,0,3,0
17670,5,1,61785,61785,61786,0,1,2
17671,6,3,61791,61791,61794,0,3,5
17672,3,3,61794,61794,61797,0,3,0
17673,6,3,61800,61800,61803,0,3,3
17674,2,1,61802,61803,61804,1,2,0
17675,6,2,61808,61808,61810,0,2,4
17676,3,1,61811,61811,61812,0,1,1
17677,2,3,61813,61813,61816,0,3,1
17678,4,1,61817,61817,61818,0,1,1
17679,1,2,61818,61818,61820,0,2,0
17680,5,2,61823,61823,61825,0,2,3
17681,4,1,61827,61827,61828,0,1,2
17682,4,3,61831,61831,61834,0,3,3
17683,3,2,61834,61834,61836,0,2,0
17684,5,3,61839,61839,61842,0,3,3
17685,6,3,61845,61845,61848,0,3,3
17686,5,1,61850,61850,61851,0,1,2
17687,5,3,61855,61855,61858,0,3,4
17688,1,3,61856,61858,61861,2,5,0
17689,2,3,61858,61861,61864,3,6,0
17690,4,3,61862,61864,61867,2,5,0
17691,1,1,61863,61867,61868,4,5,0
17692,4,2,61867,61868,61870,1,3,0
17693,4,3,61871,61871,61874,0,3,1
17694,4,2,61875,61875,61877,0,2,1
17695,6,1,61881,61881,61882,0,1,4
17696,1,1,61882,61882,61883,0,1,0
17697,1,2,61883,61883,61885,0,2,0
17698,3,3,61886,61886,61889,0,3,1
17699,4,1,61890,61890,61891,0,1,1
17700,2,2,61892,61892,61894,0,2,1
17701,1,3,61893,61894,61897,1,4,0
17702,4,3,61897,61897,61900,0,3,0
17703,2,2,61899,61900,61902,1,3,0
17704,6,3,61905,61905,61908,0,3,3
17705,2,2,61907,61908,61910,1,3,0
17706,4,2,61911,61911,61913,0,2,1
17707,1,2,61912,61913,61915,1,3,0
17708,2,2,61914,61915,61917,1,3,0
17709,2,3,61916,61917,61920,1,4,0
17710,4,1,61920,61920,61921,0,1,0
17711,5,1,61925,61925,61926,0,1,4
17712,1,2,61926,61926,61928,0,2,0
17713,5,3,61931,61931,61934,0,3,3
17714,3,1,61934,61934,61935,0,1,0
17715,3,3,61937,61937,61940,0,3,2
17716,4,3,61941,61941,61944,0,3,1
17717,1,1,61942,61944,61945,2,3,0
17718,6,1,61948,61948,61949,0,1,3
17719,3,2,61951,61951,61953,0,2,2
17720,1,1,61952,61953,61954,1,2,0
17721,3,2,61955,61955,61957,0,2,1
17722,2,1,61957,61957,61958,0,1,0
17723,6,3,61963,61963,61966,0,3,5
17724,3,3,61966,61966,61969,0,3,0
17725,2,1,61968,61969,61970,1,2,0
17726,2,2,61970,61970,61972,0,2,0
17727,2,3,61972,61972,61975,0,3,0
17728,2,2,61974,61975,61977,1,3,0
17729,3,2,61977,61977,61979,0,2,0
17730,3,1,61980,61980,61981,0,1,1
17731,3,1,61983,61983,61984,0,1,2
17732,4,3,61987,61987,61990,0,3,3
17733,2,2,61989,61990,61992,1,3,0
17734,4,3,61993,61993,61996,0,3,1
17735,6,2,61999,61999,62001,0,2,3
17736,4,2,62003,62003,62005,0,2,2
17737,1,3,62004,62005,62008,1,4,0
17738,3,1,62007,62008,62009,1,2,0
17739,3,1,62010,62010,62011,0,1,1
17740,3,3,62013,62013,62016,0,3,2
17741,3,3,62016,62016,62019,0,3,0
17742,5,1,62021,62021,62022,0,1,2
17743,1,2,62022,62022,62024,0,2,0
17744,3,2,62025,62025,62027,0,2,1
17745,1,1,62026,62027,62028,1,2,0
17746,2,3,62028,62028,62031,0,3,0
17747,2,1,62030,62031,62032,1,2,0
17748,4,3,62034,62034,62037,0,3,2
17749,6,1,62040,62040,62041,0,1,3
17750,5,3,62045,62045,62048,0,3,4
17751,3,3,62048,62048,62051,0,3,0
17752,4,2,62052,62052,62054,0,2,1
17753,1,1,62053,62054,62055,1,2,0
17754,5,1,62058,62058,62059,0,1,3
17755,2,1,62060,62060,62061,0,1,1
17756,6,2,62066,62066,62068,0,2,5
17757,3,1,62069,62069,62070,0,1,1
17758,4,2,62073,62073,62075,0,2,3
17759,3,2,62076,62076,62078,0,2,1
17760,2,3,62078,62078,62081,0,3,0
17761,2,3,62080,62081,62084,1,4,0
17762,3,2,62083,62084,62086,1,3,0
17763,2,1,62085,62086,62087,1,2,0
17764,1,1,62086,62087,62088,1,2,0
17765,3,1,62089,62089,62090,0,1,1
17766,2,1,62091,62091,62092,0,1,1
17767,4,3,62095,62095,62098,0,3,3
17768,3,2,62098,62098,62100,0,2,0
17769,6,1,62104,62104,62105,0,1,4
17770,2,2,62106,62106,62108,0,2,1
17771,6,1,62112,62112,62113,0,1,4
17772,3,3,62115,62115,62118,0,3,2
17773,1,3,62116,62118,62121,2,5,0
17774,6,2,62122,62122,62124,0,2,1
17775,4,3,62126,62126,62129,0,3,2
17776,5,2,62131,62131,62133,0,2,2
17777,4,2,62135,62135,62137,0,2,2
17778,1,2,62136,62137,62139,1,3,0
17779,2,2,62138,62139,62141,1,3,0
17780,2,1,62140,62141,62142,1,2,0
17781,3,3,62143,62143,62146,0,3,1
17782,6,1,62149,62149,62150,0,1,3
17783,6,1,62155,62155,62156,0,1,5
17784,1,2,62156,62156,62158,0,2,0
17785,3,1,62159,62159,62160,0,1,1
17786,1,1,62160,62160,62161,0,1,0
17787,5,1,62165,62165,62166,0,1,4
17788,1,3,62166,62166,62169,0,3,0
17789,2,3,62168,62169,62172,1,4,0
17790,2,2,62170,62172,62174,2,4,0
17791,1,1,62171,62174,62175,3,4,0
17792,5,3,62176,62176,62179,0,3,1
17793,1,3,62177,62179,62182,2,5,0
17794,3,1,62180,62182,62183,2,3,0
17795,1,2,62181,62183,62185,2,4,0
17796,6,3,62187,62187,62190,0,3,2
17797,3,3,62190,62190,62193,0,3,0
17798,3,1,62193,62193,62194,0,1,0
17799,4,2,62197,62197,62199,0,2,3
17800,6,2,62203,62203,62205,0,2,4
17801,6,1,62209,62209,62210,0,1,4
17802,2,3,62211,62211,62214,0,3,1
17803,4,2,62215,62215,62217,0,2,1
17804,4,3,62219,62219,62222,0,3,2
17805,2,1,62221,62222,62223,1,2,0
17806,3,1,62224,62224,62225,0,1,1
17807,4,3,62228,62228,62231,0,3,3
17808,1,1,62229,62231,62232,2,3,0
17809,1,3,62230,62232,62235,2,5,0
17810,3,3,62233,62235,62238,2,5,0
17811,5,2,62238,62238,62240,0,2,0
17812,3,3,62241,62241,62244,0,3,1
17813,2,1,62243,62244,62245,1,2,0
17814,6,2,62249,62249,62251,0,2,4
17815,6,3,62255,62255,62258,0,3,4
17816,6,1,62261,62261,62262,0,1,3
17817,3,3,62264,62264,62267,0,3,2
17818,4,3,62268,62268,62271,0,3,1
17819,1,1,62269,62271,62272,2,3,0
17820,4,3,62273,62273,62276,0,3,1
17821,5,1,62278,62278,62279,0,1,2
17822,3,2,62281,62281,62283,0,2,2
17823,3,2,62284,62284,62286,0,2,1
17824,6,3,62290,62290,62293,0,3,4
17825,3,1,62293,62293,62294,0,1,0
17826,2,2,62295,62295,62297,0,2,1
17827,1,3,62296,62297,62300,1,4,0
17828,2,3,62298,62300,62303,2,5,0
17829,2,3,62300,62303,62306,3,6,0
17830,3,2,62303,62306,62308,3,5,0
17831,4,2,62307,62308,62310,1,3,0
17832,5,3,62312,62312,62315,0,3,2
17833,3,1,62315,62315,62316,0,1,0
17834,6,3,62321,62321,62324,0,3,5
17835,2,1,62323,62324,62325,1,2,0
17836,6,3,62329,62329,62332,0,3,4
17837,4,3,62333,62333,62336,0,3,1
17838,5,2,62338,62338,62340,0,2,2
17839,4,3,62342,62342,62345,0,3,2
17840,6,1,62348,62348,62349,0,1,3
17841,5,3,62353,62353,62356,0,3,4
17842,6,3,62359,62359,62362,0,3,3
17843,6,1,62365,62365,62366,0,1,3
17844,6,1,62371,62371,62372,0,1,5
17845,4,3,62375,62375,62378,0,3,3
17846,1,3,62376,62378,62381,2,5,0
17847,6,3,62382,62382,62385,0,3,1
17848,4,1,62386,62386,62387,0,1,1
17849,5,2,62391,62391,62393,0,2,4
17850,5,2,62396,62396,62398,0,2,3
17851,1,2,62397,62398,62400,1,3,0
17852,2,2,62399,62400,62402,1,3,0
17853,6,3,62405,62405,62408,0,3,3
17854,4,3,62409,62409,62412,0,3,1
17855,3,3,62412,62412,62415,0,3,0
17856,1,3,62413,62415,62418,2,5,0
17857,3,1,62416,62418,62419,2,3,0
17858,4,3,62420,62420,62423,0,3,1
17859,2,3,62422,62423,62426,1,4,0
17860,5,3,62427,62427,62430,0,3,1
17861,2,1,62429,62430,62431,1,2,0
17862,5,3,62434,62434,62437,0,3,3
17863,5,3,62439,62439,62442,0,3,2
17864,6,3,62445,62445,62448,0,3,3
17865,3,2,62448,62448,62450,0,2,0
17866,1,2,62449,62450,62452,1,3,0
17867,5,3,62454,62454,62457,0,3,2
17868,6,1,62460,62460,62461,0,1,3
17869,4,1,62464,62464,62465,0,1,3
17870,4,1,62468,62468,62469,0,1,3
17871,4,2,62472,62472,62474,0,2,3
17872,6,2,62478,62478,62480,0,2,4
17873,2,1,62480,62480,62481,0,1,0
17874,1,2,62481,62481,62483,0,2,0
17875,4,2,62485,62485,62487,0,2,2
17876,6,1,62491,62491,62492,0,1,4
17877,2,2,62493,62493,62495,0,2,1
17878,1,3,62494,62495,62498,1,4,0
17879,5,3,62499,62499,62502,0,3,1
17880,5,2,62504,62504,62506,0,2,2
17881,1,1,62505,62506,62507,1,2,0
17882,3,3,62508,62508,62511,0,3,1
17883,4,3,62512,62512,62515,0,3,1
17884,4,2,62516,62516,62518,0,2,1
17885,5,1,62521,62521,62522,0,1,3
17886,2,1,62523,62523,62524,0,1,1
17887,5,2,62528,62528,62530,0,2,4
17888,4,2,62532,62532,62534,0,2,2
17889,2,2,62534,62534,62536,0,2,0
17890,2,2,62536,62536,62538,0,2,0
17891,3,2,62539,62539,62541,0,2,1
17892,3,2,62542,62542,62544,0,2,1
17893,4,2,62546,62546,62548,0,2,2
17894,5,3,62551,62551,62554,0,3,3
17895,3,3,62554,62554,62557,0,3,0
17896,1,3,62555,62557,62560,2,5,0
17897,5,3,62560,62560,62563,0,3,0
17898,5,2,62565,62565,62567,0,2,2
17899,1,3,62566,62567,62570,1,4,0
17900,1,2,62567,62570,62572,3,5,0
17901,5,2,62572,62572,62574,0,2,0
17902,3,1,62575,62575,62576,0,1,1
17903,5,2,62580,62580,62582,0,2,4
17904,2,3,62582,62582,62585,0,3,0
17905,3,1,62585,62585,62586,0,1,0
17906,5,2,62590,62590,62592,0,2,4
17907,6,3,62596,62596,62599,0,3,4
17908,1,2,62597,62599,62601,2,4,0
17909,1,1,62598,62601,62602,3,4,0
17910,4,2,62602,62602,62604,0,2,0
17911,4,2,62606,62606,62608,0,2,2
17912,5,2,62611,62611,62613,0,2,3
17913,3,2,62614,62614,62616,0,2,1
17914,6,3,62620,62620,62623,0,3,4
17915,4,3,62624,62624,62627,0,3,1
17916,6,1,62630,62630,62631,0,1,3
17917,2,3,62632,62632,62635,0,3,1
17918,1,3,62633,62635,62638,2,5,0
17919,5,1,62638,62638,62639,0,1,0
17920,2,2,62640,62640,62642,0,2,1
17921,2,3,62642,62642,62645,0,3,0
17922,5,1,62647,62647,62648,0,1,2
17923,3,1,62650,62650,62651,0,1,2
17924,5,1,62655,62655,62656,0,1,4
17925,2,1,62657,62657,62658,0,1,1
17926,3,3,62660,62660,62663,0,3,2
17927,1,1,62661,62663,62664,2,3,0
17928,2,1,62663,62664,62665,1,2,0
17929,2,2,62665,62665,62667,0,2,0
17930,5,2,62670,62670,62672,0,2,3
17931,5,1,62675,62675,62676,0,1,3
17932,2,2,62677,62677,62679,0,2,1
17933,5,1,62682,62682,62683,0,1,3
17934,2,2,62684,62684,62686,0,2,1
17935,5,3,62689,62689,62692,0,3,3
17936,4,3,62693,62693,62696,0,3,1
17937,5,3,62698,62698,62701,0,3,2
17938,6,2,62704,62704,62706,0,2,3
17939,4,3,62708,62708,62711,0,3,2
17940,2,2,62710,62711,62713,1,3,0
17941,6,1,62716,62716,62717,0,1,3
17942,5,2,62721,62721,62723,0,2,4
17943,5,3,62726,62726,62729,0,3,3
17944,1,3,62727,62729,62732,2,5,0
17945,4,2,62731,62732,62734,1,3,0
17946,5,1,62736,62736,62737,0,1,2
17947,4,1,62740,62740,62741,0,1,3
17948,4,2,62744,62744,62746,0,2,3
17949,4,2,62748,62748,62750,0,2,2
17950,1,3,62749,62750,62753,1,4,0
17951,6,2,62755,62755,62757,0,2,2
17952,3,1,62758,62758,62759,0,1,1
17953,6,2,62764,62764,62766,0,2,5
17954,4,3,62768,62768,62771,0,3,2
17955,2,2,62770,62771,62773,1,3,0
17956,4,1,62774,62774,62775,0,1,1
17957,5,2,62779,62779,62781,0,2,4
17958,3,3,62782,62782,62785,0,3,1
17959,4,3,62786,62786,62789,0,3,1
17960,6,3,62792,62792,62795,0,3,3
17961,4,1,62796,62796,62797,0,1,1
17962,2,2,62798,62798,62800,0,2,1
17963,3,2,62801,62801,62803,0,2,1
17964,2,3,62803,62803,62806,0,3,0
17965,1,2,62804,62806,62808,2,4,0
17966,6,3,62810,62810,62813,0,3,2
17967,3,2,62813,62813,62815,0,2,0
17968,6,3,62819,62819,62822,0,3,4
17969,3,1,62822,62822,62823,0,1,0
17970,2,2,62824,62824,62826,0,2,1
17971,5,3,62829,62829,62832,0,3,3
17972,1,1,62830,62832,62833,2,3,0
17973,6,3,62836,62836,62839,0,3,3
17974,5,3,62841,62841,62844,0,3,2
17975,3,1,62844,62844,62845,0,1,0
17976,4,3,62848,62848,62851,0,3,3
17977,5,3,62853,62853,62856,0,3,2
17978,1,2,62854,62856,62858,2,4,0
17979,3,3,62857,62858,62861,1,4,0
17980,1,1,62858,62861,62862,3,4,0
17981,2,3,62860,62862,62865,2,5,0
17982,6,3,62866,62866,62869,0,3,1
17983,5,1,62871,62871,62872,0,1,2
17984,3,3,62874,62874,62877,0,3,2
17985,5,3,62879,62879,62882,0,3,2
17986,1,2,62880,62882,62884,2,4,0
17987,2,2,62882,62884,62886,2,4,0
17988,4,2,62886,62886,62888,0,2,0
17989,4,2,62890,62890,62892,0,2,2
17990,1,2,62891,62892,62894,1,3,0
17991,5,2,62896,62896,62898,0,2,2
17992,1,1,62897,62898,62899,1,2,0
17993,1,1,62898,62899,62900,1,2,0
17994,4,2,62902,62902,62904,0,2,2
17995,5,2,62907,62907,62909,0,2,3
17996,2,2,62909,62909,62911,0,2,0
17997,1,2,62910,62911,62913,1,3,0
17998,5,1,62915,62915,62916,0,1,2
17999,3,2,62918,62918,62920,0,2,2
18000,5,1,62923,62923,62924,0,1,3
18001,3,1,62926,62926,62927,0,1,2
18002,2,1,62928,62928,62929,0,1,1
18003,2,1,62930,62930,62931,0,1,1
18004,2,2,62932,62932,62934,0,2,1
18005,6,1,62938,62938,62939,0,1,4
18006,3,3,62941,62941,62944,0,3,2
18007,6,1,62947,62947,62948,0,1,3
18008,2,3,62949,62949,62952,0,3,1
18009,3,2,62952,62952,62954,0,2,0
18010,6,1,62958,62958,62959,0,1,4
18011,4,1,62962,62962,62963,0,1,3
18012,6,3,62968,62968,62971,0,3,5
18013,5,1,62973,62973,62974,0,1,2
18014,1,2,62974,62974,62976,0,2,0
18015,1,1,62975,62976,62977,1,2,0
18016,2,1,62977,62977,62978,0,1,0
18017,4,3,62981,62981,62984,0,3,3
18018,5,3,62986,62986,62989,0,3,2
18019,4,1,62990,62990,62991,0,1,1
18020,6,3,62996,62996,62999,0,3,5
18021,1,1,62997,62999,63000,2,3,0
18022,3,2,63000,63000,63002,0,2,0
18023,4,3,63004,63004,63007,0,3,2
18024,5,2,63009,63009,63011,0,2,2
18025,4,2,63013,63013,63015,0,2,2
18026,3,3,63016,63016,63019,0,3,1
18027,4,1,63020,63020,63021,0,1,1
18028,3,2,63023,63023,63025,0,2,2
18029,4,1,63027,63027,63028,0,1,2
18030,2,3,63029,63029,63032,0,3,1
18031,4,1,63033,63033,63034,0,1,1
18032,5,1,63038,63038,63039,0,1,4
18033,2,2,63040,63040,63042,0,2,1
18034,2,3,63042,63042,63045,0,3,0
18035,3,2,63045,63045,63047,0,2,0
18036,2,1,63047,63047,63048,0,1,0
18037,2,2,63049,63049,63051,0,2,1
18038,4,3,63053,63053,63056,0,3,2
18039,5,2,63058,63058,63060,0,2,2
18040,4,2,63062,63062,63064,0,2,2
18041,5,1,63067,63067,63068,0,1,3
18042,3,2,63070,63070,63072,0,2,2
18043,1,1,63071,63072,63073,1,2,0
18044,1,3,63072,63073,63076,1,4,0
18045,5,1,63077,63077,63078,0,1,1
18046,1,1,63078,63078,63079,0,1,0
18047,4,2,63082,63082,63084,0,2,3
18048,1,1,63083,63084,63085,1,2,0
18049,6,1,63089,63089,63090,0,1,4
18050,4,1,63093,63093,63094,0,1,3
18051,5,3,63098,63098,63101,0,3,4
18052,2,3,63100,63101,63104,1,4,0
18053,1,3,63101,63104,63107,3,6,0
18054,2,2,63103,63107,63109,4,6,0
18055,5,1,63108,63109,63110,1,2,0
18056,2,1,63110,63110,63111,0,1,0
18057,1,1,63111,63111,63112,0,1,0
18058,1,1,63112,63112,63113,0,1,0
18059,4,1,63116,63116,63117,0,1,3
18060,3,3,63119,63119,63122,0,3,2
18061,5,3,63124,63124,63127,0,3,2
18062,5,1,63129,63129,63130,0,1,2
18063,1,2,63130,63130,63132,0,2,0
18064,5,1,63135,63135,63136,0,1,3
18065,2,2,63137,63137,63139,0,2,1
18066,2,1,63139,63139,63140,0,1,0
18067,1,1,63140,63140,63141,0,1,0
18068,1,2,63141,63141,63143,0,2,0
18069,4,1,63145,63145,63146,0,1,2
18070,3,3,63148,63148,63151,0,3,2
18071,3,1,63151,63151,63152,0,1,0
18072,1,1,63152,63152,63153,0,1,0
18073,6,2,63158,63158,63160,0,2,5
18074,1,3,63159,63160,63163,1,4,0
18075,6,2,63165,63165,63167,0,2,2
18076,2,3,63167,63167,63170,0,3,0
18077,3,3,63170,63170,63173,0,3,0
18078,6,2,63176,63176,63178,0,2,3
18079,6,1,63182,63182,63183,0,1,4
18080,1,3,63183,63183,63186,0,3,0
18081,6,2,63189,63189,63191,0,2,3
18082,5,2,63194,63194,63196,0,2,3
18083,1,1,63195,63196,63197,1,2,0
18084,3,1,63198,63198,63199,0,1,1
18085,1,1,63199,63199,63200,0,1,0
18086,4,2,63203,63203,63205,0,2,3
18087,3,1,63206,63206,63207,0,1,1
18088,5,3,63211,63211,63214,0,3,4
18089,3,3,63214,63214,63217,0,3,0
18090,1,1,63215,63217,63218,2,3,0
18091,2,1,63217,63218,63219,1,2,0
18092,6,1,63223,63223,63224,0,1,4
18093,1,1,63224,63224,63225,0,1,0
18094,2,2,63226,63226,63228,0,2,1
18095,4,3,63230,63230,63233,0,3,2
18096,1,1,63231,63233,63234,2,3,0
18097,5,1,63236,63236,63237,0,1,2
18098,1,3,63237,63237,63240,0,3,0
18099,5,3,63242,63242,63245,0,3,2
18100,1,2,63243,63245,63247,2,4,0
18101,4,1,63247,63247,63248,0,1,0
18102,6,3,63253,63253,63256,0,3,5
18103,4,1,63257,63257,63258,0,1,1
18104,2,1,63259,63259,63260,0,1,1
18105,4,3,63263,63263,63266,0,3,3
18106,4,2,63267,63267,63269,0,2,1
18107,3,1,63270,63270,63271,0,1,1
18108,5,3,63275,63275,63278,0,3,4
18109,5,2,63280,63280,63282,0,2,2
18110,3,1,63283,63283,63284,0,1,1
18111,3,1,63286,63286,63287,0,1,2
18112,4,2,63290,63290,63292,0,2,3
18113,5,2,63295,63295,63297,0,2,3
18114,2,2,63297,63297,63299,0,2,0
18115,5,3,63302,63302,63305,0,3,3
18116,4,1,63306,63306,63307,0,1,1
18117,5,3,63311,63311,63314,0,3,4
18118,2,1,63313,63314,63315,1,2,0
18119,1,1,63314,63315,63316,1,2,0
18120,5,3,63319,63319,63322,0,3,3
18121,3,3,63322,63322,63325,0,3,0
18122,3,3,63325,63325,63328,0,3,0
18123,1,2,63326,63328,63330,2,4,0
18124,4,3,63330,63330,63333,0,3,0
18125,1,2,63331,63333,63335,2,4,0
18126,2,1,63333,63335,63336,2,3,0
18127,5,2,63338,63338,63340,0,2,2
18128,2,2,63340,63340,63342,0,2,0
18129,3,2,63343,63343,63345,0,2,1
18130,2,2,63345,63345,63347,0,2,0
18131,1,2,63346,63347,63349,1,3,0
18132,4,2,63350,63350,63352,0,2,1
18133,2,3,63352,63352,63355,0,3,0
18134,4,3,63356,63356,63359,0,3,1
18135,2,3,63358,63359,63362,1,4,0
18136,3,1,63361,63362,63363,1,2,0
18137,2,3,63363,63363,63366,0,3,0
18138,3,1,63366,63366,63367,0,1,0
18139,1,1,63367,63367,63368,0,1,0
18140,4,2,63371,63371,63373,0,2,3
18141,5,2,63376,63376,63378,0,2,3
18142,5,2,63381,63381,63383,0,2,3
18143,3,1,63384,63384,63385,0,1,1
18144,2,3,63386,63386,63389,0,3,1
18145,5,1,63391,63391,63392,0,1,2
18146,4,3,63395,63395,63398,0,3,3
18147,5,2,63400,63400,63402,0,2,2
18148,1,2,63401,63402,63404,1,3,0
18149,3,3,63404,63404,63407,0,3,0
18150,4,1,63408,63408,63409,0,1,1
18151,2,1,63410,63410,63411,0,1,1
18152,2,3,63412,63412,63415,0,3,1
18153,2,3,63414,63415,63418,1,4,0
18154,1,1,63415,63418,63419,3,4,0
18155,5,2,63420,63420,63422,0,2,1
18156,1,1,63421,63422,63423,1,2,0
18157,1,1,63422,63423,63424,1,2,0
18158,3,3,63425,63425,63428,0,3,1
18159,3,3,63428,63428,63431,0,3,0
18160,4,3,63432,63432,63435,0,3,1
18161,4,1,63436,63436,63437,0,1,1
18162,4,3,63440,63440,63443,0,3,3
18163,4,1,63444,63444,63445,0,1,1
18164,6,3,63450,63450,63453,0,3,5
18165,5,1,63455,63455,63456,0,1,2
18166,5,2,63460,63460,63462,0,2,4
18167,6,1,63466,63466,63467,0,1,4
18168,5,2,63471,63471,63473,0,2,4
18169,3,2,63474,63474,63476,0,2,1
18170,5,2,63479,63479,63481,0,2,3
18171,3,2,63482,63482,63484,0,2,1
18172,3,1,63485,63485,63486,0,1,1
18173,2,3,63487,63487,63490,0,3,1
18174,1,3,63488,63490,63493,2,5,0
18175,5,3,63493,63493,63496,0,3,0
18176,6,1,63499,63499,63500,0,1,3
18177,1,3,63500,63500,63503,0,3,0
18178,1,2,63501,63503,63505,2,4,0
18179,3,3,63504,63505,63508,1,4,0
18180,5,3,63509,63509,63512,0,3,1
18181,1,2,63510,63512,63514,2,4,0
18182,4,3,63514,63514,63517,0,3,0
18183,6,3,63520,63520,63523,0,3,3
18184,5,3,63525,63525,63528,0,3,2
18185,2,3,63527,63528,63531,1,4,0
18186,2,2,63529,63531,63533,2,4,0
18187,5,3,63534,63534,63537,0,3,1
18188,1,1,63535,63537,63538,2,3,0
18189,1,1,63536,63538,63539,2,3,0
18190,2,2,63538,63539,63541,1,3,0
18191,4,2,63542,63542,63544,0,2,1
18192,1,2,63543,63544,63546,1,3,0
18193,1,3,63544,63546,63549,2,5,0
18194,6,3,63550,63550,63553,0,3,1
18195,1,1,63551,63553,63554,2,3,0
18196,2,2,63553,63554,63556,1,3,0
18197,2,2,63555,63556,63558,1,3,0
18198,2,3,63557,63558,63561,1,4,0
18199,1,1,63558,63561,63562,3,4,0
18200,4,3,63562,63562,63565,0,3,0
18201,4,2,63566,63566,63568,0,2,1
18202,4,3,63570,63570,63573,0,3,2
18203,2,3,63572,63573,63576,1,4,0
18204,2,2,63574,63576,63578,2,4,0
18205,4,1,63578,63578,63579,0,1,0
18206,1,1,63579,63579,63580,0,1,0
18207,1,1,63580,63580,63581,0,1,0
18208,4,2,63584,63584,63586,0,2,3
18209,2,1,63586,63586,63587,0,1,0
18210,5,3,63591,63591,63594,0,3,4
18211,4,2,63595,63595,63597,0,2,1
18212,5,1,63600,63600,63601,0,1,3
18213,2,2,63602,63602,63604,0,2,1
18214,2,2,63604,63604,63606,0,2,0
18215,5,3,63609,63609,63612,0,3,3
18216,5,3,63614,63614,63617,0,3,2
18217,1,1,63615,63617,63618,2,3,0
18218,3,2,63618,63618,63620,0,2,0
18219,4,2,63622,63622,63624,0,2,2
18220,4,3,63626,63626,63629,0,3,2
18221,1,1,63627,63629,63630,2,3,0
18222,4,1,63631,63631,63632,0,1,1
18223,4,3,63635,63635,63638,0,3,3
18224,4,3,63639,63639,63642,0,3,1
18225,6,1,63645,63645,63646,0,1,3
18226,2,1,63647,63647,63648,0,1,1
18227,2,3,63649,63649,63652,0,3,1
18228,3,1,63652,63652,63653,0,1,0
18229,6,1,63658,63658,63659,0,1,5
18230,5,3,63663,63663,63666,0,3,4
18231,1,2,63664,63666,63668,2,4,0
18232,1,1,63665,63668,63669,3,4,0
18233,5,3,63670,63670,63673,0,3,1
18234,6,2,63676,63676,63678,0,2,3
18235,5,1,63681,63681,63682,0,1,3
18236,6,3,63687,63687,63690,0,3,5
18237,2,1,63689,63690,63691,1,2,0
18238,5,3,63694,63694,63697,0,3,3
18239,4,2,63698,63698,63700,0,2,1
18240,1,2,63699,63700,63702,1,3,0
18241,2,1,63701,63702,63703,1,2,0
18242,1,3,63702,63703,63706,1,4,0
18243,3,3,63705,63706,63709,1,4,0
18244,4,2,63709,63709,63711,0,2,0
18245,1,2,63710,63711,63713,1,3,0
18246,5,3,63715,63715,63718,0,3,2
18247,2,2,63717,63718,63720,1,3,0
18248,5,2,63722,63722,63724,0,2,2
18249,4,3,63726,63726,63729,0,3,2
18250,2,3,63728,63729,63732,1,4,0
18251,2,2,63730,63732,63734,2,4,0
18252,5,3,63735,63735,63738,0,3,1
18253,2,2,63737,63738,63740,1,3,0
18254,4,3,63741,63741,63744,0,3,1
18255,6,3,63747,63747,63750,0,3,3
18256,6,1,63753,63753,63754,0,1,3
18257,3,3,63756,63756,63759,0,3,2
18258,2,3,63758,63759,63762,1,4,0
18259,1,3,63759,63762,63765,3,6,0
18260,6,1,63765,63765,63766,0,1,0
18261,5,1,63770,63770,63771,0,1,4
18262,2,3,63772,63772,63775,0,3,1
18263,1,3,63773,63775,63778,2,5,0
18264,5,3,63778,63778,63781,0,3,0
18265,1,3,63779,63781,63784,2,5,0
18266,2,2,63781,63784,63786,3,5,0
18267,2,2,63783,63786,63788,3,5,0
18268,1,2,63784,63788,63790,4,6,0
18269,6,3,63790,63790,63793,0,3,0
18270,2,2,63792,63793,63795,1,3,0
18271,1,1,63793,63795,63796,2,3,0
18272,1,1,63794,63796,63797,2,3,0
18273,5,1,63799,63799,63800,0,1,2
18274,3,2,63802,63802,63804,0,2,2
18275,4,1,63806,63806,63807,0,1,2
18276,1,1,63807,63807,63808,0,1,0
18277,1,1,63808,63808,63809,0,1,0
18278,5,1,63813,63813,63814,0,1,4
18279,4,2,63817,63817,63819,0,2,3
18280,6,3,63823,63823,63826,0,3,4
18281,1,1,63824,63826,63827,2,3,0
18282,3,2,63827,63827,63829,0,2,0
18283,5,2,63832,63832,63834,0,2,3
18284,3,1,63835,63835,63836,0,1,1
18285,3,3,63838,63838,63841,0,3,2
18286,4,1,63842,63842,63843,0,1,1
18287,4,3,63846,63846,63849,0,3,3
18288,2,3,63848,63849,63852,1,4,0
18289,5,2,63853,63853,63855,0,2,1
18290,1,2,63854,63855,63857,1,3,0
18291,2,2,63856,63857,63859,1,3,0
18292,2,2,63858,63859,63861,1,3,0
18293,5,1,63863,63863,63864,0,1,2
18294,6,3,63869,63869,63872,0,3,5
18295,2,2,63871,63872,63874,1,3,0
18296,3,3,63874,63874,63877,0,3,0
18297,5,2,63879,63879,63881,0,2,2
18298,3,2,63882,63882,63884,0,2,1
18299,4,1,63886,63886,63887,0,1,2
18300,5,2,63891,63891,63893,0,2,4
18301,2,3,63893,63893,63896,0,3,0
18302,5,2,63898,63898,63900,0,2,2
18303,6,2,63904,63904,63906,0,2,4
18304,2,1,63906,63906,63907,0,1,0
18305,2,2,63908,63908,63910,0,2,1
18306,2,2,63910,63910,63912,0,2,0
18307,5,3,63915,63915,63918,0,3,3
18308,5,3,63920,63920,63923,0,3,2
18309,4,2,63924,63924,63926,0,2,1
18310,5,2,63929,63929,63931,0,2,3
18311,3,3,63932,63932,63935,0,3,1
18312,1,3,63933,63935,63938,2,5,0
18313,3,3,63936,63938,63941,2,5,0
18314,2,2,63938,63941,63943,3,5,0
18315,5,2,63943,63943,63945,0,2,0
18316,1,3,63944,63945,63948,1,4,0
18317,6,3,63950,63950,63953,0,3,2
18318,6,2,63956,63956,63958,0,2,3
18319,1,1,63957,63958,63959,1,2,0
18320,2,1,63959,63959,63960,0,1,0
18321,6,1,63965,63965,63966,0,1,5
18322,3,1,63968,63968,63969,0,1,2
18323,3,1,63971,63971,63972,0,1,2
18324,4,3,63975,63975,63978,0,3,3
18325,3,2,63978,63978,63980,0,2,0
18326,4,2,63982,63982,63984,0,2,2
18327,3,1,63985,63985,63986,0,1,1
18328,4,1,63989,63989,63990,0,1,3
18329,2,3,63991,63991,63994,0,3,1
18330,5,3,63996,63996,63999,0,3,2
18331,3,2,63999,63999,64001,0,2,0
18332,6,2,64005,64005,64007,0,2,4
18333,3,3,64008,64008,64011,0,3,1
18334,5,3,64013,64013,64016,0,3,2
18335,6,1,64019,64019,64020,0,1,3
18336,2,2,64021,64021,64023,0,2,1
18337,5,1,64026,64026,64027,0,1,3
18338,4,3,64030,64030,64033,0,3,3
18339,4,2,64034,64034,64036,0,2,1
18340,2,1,64036,64036,64037,0,1,0
18341,1,3,64037,64037,64040,0,3,0
18342,2,3,64039,64040,64043,1,4,0
18343,5,3,64044,64044,64047,0,3,1
18344,5,1,64049,64049,64050,0,1,2
18345,4,1,64053,64053,64054,0,1,3
18346,5,3,64058,64058,64061,0,3,4
18347,4,2,64062,64062,64064,0,2,1
18348,2,2,64064,64064,64066,0,2,0
18349,3,2,64067,64067,64069,0,2,1
18350,2,2,64069,64069,64071,0,2,0
18351,6,1,64075,64075,64076,0,1,4
18352,4,1,64079,64079,64080,0,1,3
18353,5,2,64084,64084,64086,0,2,4
18354,5,1,64089,64089,64090,0,1,3
18355,5,1,64094,64094,64095,0,1,4
18356,6,3,64100,64100,64103,0,3,5
18357,2,2,64102,64103,64105,1,3,0
18358,2,2,64104,64105,64107,1,3,0
18359,6,3,64110,64110,64113,0,3,3
18360,2,2,64112,64113,64115,1,3,0
18361,5,2,64117,64117,64119,0,2,2
18362,1,3,64118,64119,64122,1,4,0
18363,6,3,64124,64124,64127,0,3,2
18364,5,3,64129,64129,64132,0,3,2
18365,3,1,64132,64132,64133,0,1,0
18366,2,1,64134,64134,64135,0,1,1
18367,4,1,64138,64138,64139,0,1,3
18368,5,1,64143,64143,64144,0,1,4
18369,6,3,64149,64149,64152,0,3,5
18370,1,3,64150,64152,64155,2,5,0
18371,5,1,64155,64155,64156,0,1,0
18372,4,3,64159,64159,64162,0,3,3
18373,2,1,64161,64162,64163,1,2,0
18374,4,3,64165,64165,64168,0,3,2
18375,3,3,64168,64168,64171,0,3,0
18376,1,2,64169,64171,64173,2,4,0
18377,3,1,64172,64173,64174,1,2,0
18378,2,1,64174,64174,64175,0,1,0
18379,4,2,64178,64178,64180,0,2,3
18380,1,2,64179,64180,64182,1,3,0
18381,2,2,64181,64182,64184,1,3,0
18382,5,1,64186,64186,64187,0,1,2
18383,5,3,64191,64191,64194,0,3,4
18384,4,2,64195,64195,64197,0,2,1
18385,3,2,64198,64198,64200,0,2,1
18386,6,3,64204,64204,64207,0,3,4
18387,3,1,64207,64207,64208,0,1,0
18388,3,2,64210,64210,64212,0,2,2
18389,4,2,64214,64214,64216,0,2,2
18390,5,2,64219,64219,64221,0,2,3
18391,6,1,64225,64225,64226,0,1,4
18392,4,1,64229,64229,64230,0,1,3
18393,1,1,64230,64230,64231,0,1,0
18394,2,1,64232,64232,64233,0,1,1
18395,2,3,64234,64234,64237,0,3,1
18396,3,1,64237,64237,64238,0,1,0
18397,5,2,64242,64242,64244,0,2,4
18398,2,1,64244,64244,64245,0,1,0
18399,5,1,64249,64249,64250,0,1,4
18400,3,3,64252,64252,64255,0,3,2
18401,5,1,64257,64257,64258,0,1,2
18402,2,2,64259,64259,64261,0,2,1
18403,5,1,64264,64264,64265,0,1,3
18404,6,1,64270,64270,64271,0,1,5
18405,3,2,64273,64273,64275,0,2,2
18406,1,3,64274,64275,64278,1,4,0
18407,5,3,64279,64279,64282,0,3,1
18408,5,3,64284,64284,64287,0,3,2
18409,1,1,64285,64287,64288,2,3,0
18410,2,1,64287,64288,64289,1,2,0
18411,3,2,64290,64290,64292,0,2,1
18412,2,3,64292,64292,64295,0,3,0
18413,1,3,64293,64295,64298,2,5,0
18414,6,1,64299,64299,64300,0,1,1
18415,4,2,64303,64303,64305,0,2,3
18416,6,2,64309,64309,64311,0,2,4
18417,4,1,64313,64313,64314,0,1,2
18418,1,1,64314,64314,64315,0,1,0
18419,4,1,64318,64318,64319,0,1,3
18420,1,1,64319,64319,64320,0,1,0
18421,5,2,64324,64324,64326,0,2,4
18422,2,2,64326,64326,64328,0,2,0
18423,6,3,64332,64332,64335,0,3,4
18424,2,2,64334,64335,64337,1,3,0
18425,4,3,64338,64338,64341,0,3,1
18426,5,2,64343,64343,64345,0,2,2
18427,2,3,64345,64345,64348,0,3,0
18428,2,3,64347,64348,64351,1,4,0
18429,2,1,64349,64351,64352,2,3,0
18430,2,1,64351,64352,64353,1,2,0
18431,6,1,64357,64357,64358,0,1,4
18432,2,2,64359,64359,64361,0,2,1
18433,1,3,64360,64361,64364,1,4,0
18434,5,1,64365,64365,64366,0,1,1
18435,6,2,64371,64371,64373,0,2,5
18436,2,3,64373,64373,64376,0,3,0
18437,1,2,64374,64376,64378,2,4,0
18438,6,2,64380,64380,64382,0,2,2
18439,2,1,64382,64382,64383,0,1,0
18440,4,1,64386,64386,64387,0,1,3
18441,3,1,64389,64389,64390,0,1,2
18442,2,1,64391,64391,64392,0,1,1
18443,3,3,64394,64394,64397,0,3,2
18444,5,2,64399,64399,64401,0,2,2
18445,5,1,64404,64404,64405,0,1,3
18446,5,3,64409,64409,64412,0,3,4
18447,3,2,64412,64412,64414,0,2,0
18448,4,1,64416,64416,64417,0,1,2
18449,2,1,64418,64418,64419,0,1,1
18450,1,1,64419,64419,64420,0,1,0
18451,1,3,64420,64420,64423,0,3,0
18452,6,1,64426,64426,64427,0,1,3
18453,1,1,64427,64427,64428,0,1,0
18454,3,2,64430,64430,64432,0,2,2
18455,6,2,64436,64436,64438,0,2,4
18456,5,1,64441,64441,64442,0,1,3
18457,6,1,64447,64447,64448,0,1,5
18458,1,2,64448,64448,64450,0,2,0
18459,2,3,64450,64450,64453,0,3,0
18460,4,3,64454,64454,64457,0,3,1
18461,3,1,64457,64457,64458,0,1,0
18462,3,2,64460,64460,64462,0,2,2
18463,5,2,64465,64465,64467,0,2,3
18464,6,1,64471,64471,64472,0,1,4
18465,6,3,64477,64477,64480,0,3,5
18466,1,3,64478,64480,64483,2,5,0
18467,1,3,64479,64483,64486,4,7,0
18468,1,1,64480,64486,64487,6,7,0
18469,3,3,64483,64487,64490,4,7,0
18470,4,1,64487,64490,64491,3,4,0
18471,4,1,64491,64491,64492,0,1,0
18472,2,3,64493,64493,64496,0,3,1
18473,1,1,64494,64496,64497,2,3,0
18474,2,1,64496,64497,64498,1,2,0
18475,1,2,64497,64498,64500,1,3,0
18476,2,1,64499,64500,64501,1,2,0
18477,4,2,64503,64503,64505,0,2,2
18478,1,1,64504,64505,64506,1,2,0
18479,5,1,64509,64509,64510,0,1,3
18480,3,2,64512,64512,64514,0,2,2
18481,6,2,64518,64518,64520,0,2,4
18482,2,1,64520,64520,64521,0,1,0
18483,3,1,64523,64523,64524,0,1,2
18484,5,1,64528,64528,64529,0,1,4
18485,2,2,64530,64530,64532,0,2,1
18486,5,2,64535,64535,64537,0,2,3
18487,2,1,64537,64537,64538,0,1,0
18488,5,3,64542,64542,64545,0,3,4
18489,2,3,64544,64545,64548,1,4,0
18490,1,3,64545,64548,64551,3,6,0
18491,4,3,64549,64551,64554,2,5,0
18492,6,3,64555,64555,64558,0,3,1
18493,3,1,64558,64558,64559,0,1,0
18494,1,3,64559,64559,64562,0,3,0
18495,5,2,64564,64564,64566,0,2,2
18496,4,2,64568,64568,64570,0,2,2
18497,6,2,64574,64574,64576,0,2,4
18498,6,1,64580,64580,64581,0,1,4
18499,1,1,64581,64581,64582,0,1,0
18500,4,2,64585,64585,64587,0,2,3
18501,1,3,64586,64587,64590,1,4,0
18502,6,2,64592,64592,64594,0,2,2
18503,5,2,64597,64597,64599,0,2,3
18504,6,1,64603,64603,64604,0,1,4
18505,5,1,64608,64608,64609,0,1,4
18506,2,3,64610,64610,64613,0,3,1
18507,6,3,64616,64616,64619,0,3,3
18508,1,3,64617,64619,64622,2,5,0
18509,4,3,64621,64622,64625,1,4,0
18510,3,2,64624,64625,64627,1,3,0
18511,1,1,64625,64627,64628,2,3,0
18512,6,3,64631,64631,64634,0,3,3
18513,4,1,64635,64635,64636,0,1,1
18514,3,3,64638,64638,64641,0,3,2
18515,2,2,64640,64641,64643,1,3,0
18516,2,3,64642,64643,64646,1,4,0
18517,2,1,64644,64646,64647,2,3,0
18518,1,2,64645,64647,64649,2,4,0
18519,6,3,64651,64651,64654,0,3,2
18520,5,3,64656,64656,64659,0,3,2
18521,5,3,64661,64661,64664,0,3,2
18522,1,2,64662,64664,64666,2,4,0
18523,4,3,64666,64666,64669,0,3,0
18524,4,1,64670,64670,64671,0,1,1
18525,3,3,64673,64673,64676,0,3,2
18526,4,2,64677,64677,64679,0,2,1
18527,4,1,64681,64681,64682,0,1,2
18528,1,2,64682,64682,64684,0,2,0
18529,5,1,64687,64687,64688,0,1,3
18530,2,1,64689,64689,64690,0,1,1
18531,5,1,64694,64694,64695,0,1,4
18532,6,2,64700,64700,64702,0,2,5
18533,3,2,64703,64703,64705,0,2,1
18534,1,2,64704,64705,64707,1,3,0
18535,5,1,64709,64709,64710,0,1,2
18536,5,1,64714,64714,64715,0,1,4
18537,4,3,64718,64718,64721,0,3,3
18538,6,3,64724,64724,64727,0,3,3
18539,5,1,64729,64729,64730,0,1,2
18540,4,3,64733,64733,64736,0,3,3
18541,3,1,64736,64736,64737,0,1,0
18542,5,2,64741,64741,64743,0,2,4
18543,6,2,64747,64747,64749,0,2,4
18544,4,1,64751,64751,64752,0,1,2
18545,3,3,64754,64754,64757,0,3,2
18546,6,2,64760,64760,64762,0,2,3
18547,5,2,64765,64765,64767,0,2,3
18548,2,3,64767,64767,64770,0,3,0
18549,4,1,64771,64771,64772,0,1,1
18550,2,1,64773,64773,64774,0,1,1
18551,1,2,64774,64774,64776,0,2,0
18552,3,2,64777,64777,64779,0,2,1
18553,4,1,64781,64781,64782,0,1,2
18554,2,1,64783,64783,64784,0,1,1
18555,5,3,64788,64788,64791,0,3,4
18556,2,3,64790,64791,64794,1,4,0
18557,3,3,64793,64794,64797,1,4,0
18558,5,3,64798,64798,64801,0,3,1
18559,1,2,64799,64801,64803,2,4,0
18560,2,3,64801,64803,64806,2,5,0
18561,1,2,64802,64806,64808,4,6,0
18562,5,3,64807,64808,64811,1,4,0
18563,3,2,64810,64811,64813,1,3,0
18564,5,3,64815,64815,64818,0,3,2
18565,1,3,64816,64818,64821,2,5,0
18566,3,3,64819,64821,64824,2,5,0
18567,6,2,64825,64825,64827,0,2,1
18568,2,1,64827,64827,64828,0,1,0
18569,3,2,64830,64830,64832,0,2,2
18570,4,3,64834,64834,64837,0,3,2
18571,2,1,64836,64837,64838,1,2,0
18572,3,1,64839,64839,64840,0,1,1
18573,2,3,64841,64841,64844,0,3,1
18574,5,3,64846,64846,64849,0,3,2
18575,5,3,64851,64851,64854,0,3,2
18576,4,2,64855,64855,64857,0,2,1
18577,3,2,64858,64858,64860,0,2,1
18578,5,2,64863,64863,64865,0,2,3
18579,1,2,64864,64865,64867,1,3,0
18580,2,2,64866,64867,64869,1,3,0
18581,2,1,64868,64869,64870,1,2,0
18582,4,1,64872,64872,64873,0,1,2
18583,4,3,64876,64876,64879,0,3,3
18584,2,3,64878,64879,64882,1,4,0
18585,1,1,64879,64882,64883,3,4,0
18586,6,2,64885,64885,64887,0,2,2
18587,3,1,64888,64888,64889,0,1,1
18588,3,3,64891,64891,64894,0,3,2
18589,4,3,64895,64895,64898,0,3,1
18590,1,1,64896,64898,64899,2,3,0
18591,2,2,64898,64899,64901,1,3,0
18592,3,2,64901,64901,64903,0,2,0
18593,4,2,64905,64905,64907,0,2,2
18594,5,3,64910,64910,64913,0,3,3
18595,4,3,64914,64914,64917,0,3,1
18596,5,3,64919,64919,64922,0,3,2
18597,6,2,64925,64925,64927,0,2,3
18598,3,2,64928,64928,64930,0,2,1
18599,5,1,64933,64933,64934,0,1,3
18600,3,2,64936,64936,64938,0,2,2
18601,4,1,64940,64940,64941,0,1,2
18602,5,3,64945,64945,64948,0,3,4
18603,3,3,64948,64948,64951,0,3,0
18604,6,1,64954,64954,64955,0,1,3
18605,2,1,64956,64956,64957,0,1,1
18606,5,2,64961,64961,64963,0,2,4
18607,5,2,64966,64966,64968,0,2,3
18608,6,3,64972,64972,64975,0,3,4
18609,2,3,64974,64975,64978,1,4,0
18610,2,2,64976,64978,64980,2,4,0
18611,1,1,64977,64980,64981,3,4,0
18612,4,2,64981,64981,64983,0,2,0
18613,2,2,64983,64983,64985,0,2,0
18614,4,1,64987,64987,64988,0,1,2
18615,6,3,64993,64993,64996,0,3,5
18616,2,3,64995,64996,64999,1,4,0
18617,1,2,64996,64999,65001,3,5,0
18618,6,1,65002,65002,65003,0,1,1
18619,5,3,65007,65007,65010,0,3,4
18620,5,3,65012,65012,65015,0,3,2
18621,4,3,65016,65016,65019,0,3,1
18622,3,3,65019,65019,65022,0,3,0
18623,6,3,65025,65025,65028,0,3,3
18624,6,2,65031,65031,65033,0,2,3
18625,4,2,65035,65035,65037,0,2,2
18626,5,1,65040,65040,65041,0,1,3
18627,1,1,65041,65041,65042,0,1,0
18628,1,3,65042,65042,65045,0,3,0
18629,5,3,65047,65047,65050,0,3,2
18630,5,3,65052,65052,65055,0,3,2
18631,4,3,65056,65056,65059,0,3,1
18632,2,3,65058,65059,65062,1,4,0
18633,2,3,65060,65062,65065,2,5,0
18634,6,1,65066,65066,65067,0,1,1
18635,4,3,65070,65070,65073,0,3,3
18636,2,1,65072,65073,65074,1,2,0
18637,4,3,65076,65076,65079,0,3,2
18638,6,2,65082,65082,65084,0,2,3
18639,2,2,65084,65084,65086,0,2,0
18640,5,1,65089,65089,65090,0,1,3
18641,3,3,65092,65092,65095,0,3,2
18642,5,1,65097,65097,65098,0,1,2
18643,3,3,65100,65100,65103,0,3,2
18644,6,2,65106,65106,65108,0,2,3
18645,2,3,65108,65108,65111,0,3,0
18646,2,3,65110,65111,65114,1,4,0
18647,3,1,65113,65114,65115,1,2,0
18648,4,3,65117,65117,65120,0,3,2
18649,1,1,65118,65120,65121,2,3,0
18650,2,3,65120,65121,65124,1,4,0
18651,5,2,65125,65125,65127,0,2,1
18652,4,1,65129,65129,65130,0,1,2
18653,3,1,65132,65132,65133,0,1,2
18654,3,1,65135,65135,65136,0,1,2
18655,1,3,65136,65136,65139,0,3,0
18656,4,1,65140,65140,65141,0,1,1
18657,5,2,65145,65145,65147,0,2,4
18658,1,1,65146,65147,65148,1,2,0
18659,3,2,65149,65149,65151,0,2,1
18660,2,1,65151,65151,65152,0,1,0
18661,5,1,65156,65156,65157,0,1,4
18662,6,3,65162,65162,65165,0,3,5
18663,2,1,65164,65165,65166,1,2,0
18664,5,3,65169,65169,65172,0,3,3
18665,3,1,65172,65172,65173,0,1,0
18666,5,1,65177,65177,65178,0,1,4
18667,2,2,65179,65179,65181,0,2,1
18668,1,1,65180,65181,65182,1,2,0
18669,2,3,65182,65182,65185,0,3,0
18670,6,2,65188,65188,65190,0,2,3
18671,4,1,65192,65192,65193,0,1,2
18672,1,1,65193,65193,65194,0,1,0
18673,3,1,65196,65196,65197,0,1,2
18674,4,2,65200,65200,65202,0,2,3
18675,2,3,65202,65202,65205,0,3,0
18676,5,1,65207,65207,65208,0,1,2
18677,5,3,65212,65212,65215,0,3,4
18678,1,1,65213,65215,65216,2,3,0
18679,2,3,65215,65216,65219,1,4,0
18680,2,3,65217,65219,65222,2,5,0
18681,2,1,65219,65222,65223,3,4,0
18682,6,3,65225,65225,65228,0,3,2
18683,2,1,65227,65228,65229,1,2,0
18684,5,1,65232,65232,65233,0,1,3
18685,4,3,65236,65236,65239,0,3,3
18686,1,3,65237,65239,65242,2,5,0
18687,3,3,65240,65242,65245,2,5,0
18688,5,3,65245,65245,65248,0,3,0
18689,6,3,65251,65251,65254,0,3,3
18690,1,3,65252,65254,65257,2,5,0
18691,6,1,65258,65258,65259,0,1,1
18692,1,1,65259,65259,65260,0,1,0
18693,1,3,65260,65260,65263,0,3,0
18694,6,2,65266,65266,65268,0,2,3
18695,1,3,65267,65268,65271,1,4,0
18696,4,1,65271,65271,65272,0,1,0
18697,2,2,65273,65273,65275,0,2,1
18698,4,2,65277,65277,65279,0,2,2
18699,2,2,65279,65279,65281,0,2,0
18700,5,2,65284,65284,65286,0,2,3
18701,2,3,65286,65286,65289,0,3,0
18702,2,3,65288,65289,65292,1,4,0
18703,4,3,65292,65292,65295,0,3,0
18704,4,2,65296,65296,65298,0,2,1
18705,2,2,65298,65298,65300,0,2,0
18706,6,3,65304,65304,65307,0,3,4
18707,3,1,65307,65307,65308,0,1,0
18708,2,3,65309,65309,65312,0,3,1
18709,3,1,65312,65312,65313,0,1,0
18710,4,3,65316,65316,65319,0,3,3
18711,5,2,65321,65321,65323,0,2,2
18712,3,3,65324,65324,65327,0,3,1
18713,2,3,65326,65327,65330,1,4,0
18714,4,2,65330,65330,65332,0,2,0
18715,3,2,65333,65333,65335,0,2,1
18716,6,2,65339,65339,65341,0,2,4
18717,5,3,65344,65344,65347,0,3,3
18718,4,3,65348,65348,65351,0,3,1
18719,5,1,65353,65353,65354,0,1,2
18720,4,1,65357,65357,65358,0,1,3
18721,1,1,65358,65358,65359,0,1,0
18722,1,3,65359,65359,65362,0,3,0
18723,3,3,65362,65362,65365,0,3,0
18724,6,3,65368,65368,65371,0,3,3
18725,2,1,65370,65371,65372,1,2,0
18726,3,1,65373,65373,65374,0,1,1
18727,5,3,65378,65378,65381,0,3,4
18728,5,3,65383,65383,65386,0,3,2
18729,1,2,65384,65386,65388,2,4,0
18730,6,1,65390,65390,65391,0,1,2
18731,4,3,65394,65394,65397,0,3,3
18732,2,3,65396,65397,65400,1,4,0
18733,5,3,65401,65401,65404,0,3,1
18734,5,1,65406,65406,65407,0,1,2
18735,1,2,65407,65407,65409,0,2,0
18736,5,2,65412,65412,65414,0,2,3
18737,1,3,65413,65414,65417,1,4,0
18738,1,1,65414,65417,65418,3,4,0
18739,5,3,65419,65419,65422,0,3,1
18740,4,2,65423,65423,65425,0,2,1
18741,6,3,65429,65429,65432,0,3,4
18742,3,2,65432,65432,65434,0,2,0
18743,3,3,65435,65435,65438,0,3,1
18744,1,1,65436,65438,65439,2,3,0
18745,1,3,65437,65439,65442,2,5,0
18746,1,3,65438,65442,65445,4,7,0
18747,2,2,65440,65445,65447,5,7,0
18748,2,2,65442,65447,65449,5,7,0
18749,3,1,65445,65449,65450,4,5,0
18750,2,1,65447,65450,65451,3,4,0
18751,2,1,65449,65451,65452,2,3,0
18752,6,1,65455,65455,65456,0,1,3
18753,6,3,65461,65461,65464,0,3,5
18754,3,3,65464,65464,65467,0,3,0
18755,3,2,65467,65467,65469,0,2,0
18756,1,2,65468,65469,65471,1,3,0
18757,3,3,65471,65471,65474,0,3,0
18758,5,3,65476,65476,65479,0,3,2
18759,5,3,65481,65481,65484,0,3,2
18760,6,2,65487,65487,65489,0,2,3
18761,6,1,65493,65493,65494,0,1,4
18762,5,3,65498,65498,65501,0,3,4
18763,1,2,65499,65501,65503,2,4,0
18764,2,3,65501,65503,65506,2,5,0
18765,2,3,65503,65506,65509,3,6,0
18766,5,2,65508,65509,65511,1,3,0
18767,6,3,65514,65514,65517,0,3,3
18768,4,3,65518,65518,65521,0,3,1
18769,5,3,65523,65523,65526,0,3,2
18770,6,3,65529,65529,65532,0,3,3
18771,5,1,65534,65534,65535,0,1,2
18772,1,3,65535,65535,65538,0,3,0
18773,3,1,65538,65538,65539,0,1,0
18774,1,2,65539,65539,65541,0,2,0
18775,3,3,65542,65542,65545,0,3,1
18776,3,2,65545,65545,65547,0,2,0
18777,6,2,65551,65551,65553,0,2,4
18778,3,1,65554,65554,65555,0,1,1
18779,1,2,65555,65555,65557,0,2,0
18780,3,1,65558,65558,65559,0,1,1
18781,5,3,65563,65563,65566,0,3,4
18782,1,3,65564,65566,65569,2,5,0
18783,5,3,65569,65569,65572,0,3,0
18784,3,2,65572,65572,65574,0,2,0
18785,5,1,65577,65577,65578,0,1,3
18786,3,3,65580,65580,65583,0,3,2
18787,2,1,65582,65583,65584,1,2,0
18788,5,3,65587,65587,65590,0,3,3
18789,3,2,65590,65590,65592,0,2,0
18790,2,1,65592,65592,65593,0,1,0
18791,6,2,65598,65598,65600,0,2,5
18792,3,1,65601,65601,65602,0,1,1
18793,6,1,65607,65607,65608,0,1,5
18794,1,1,65608,65608,65609,0,1,0
18795,5,3,65613,65613,65616,0,3,4
18796,2,3,65615,65616,65619,1,4,0
18797,4,1,65619,65619,65620,0,1,0
18798,5,1,65624,65624,65625,0,1,4
18799,4,3,65628,65628,65631,0,3,3
18800,4,3,65632,65632,65635,0,3,1
18801,3,1,65635,65635,65636,0,1,0
18802,6,3,65641,65641,65644,0,3,5
18803,5,3,65646,65646,65649,0,3,2
18804,4,2,65650,65650,65652,0,2,1
18805,6,2,65656,65656,65658,0,2,4
18806,6,2,65662,65662,65664,0,2,4
18807,1,2,65663,65664,65666,1,3,0
18808,5,1,65668,65668,65669,0,1,2
18809,4,2,65672,65672,65674,0,2,3
18810,1,3,65673,65674,65677,1,4,0
18811,1,1,65674,65677,65678,3,4,0
18812,6,3,65680,65680,65683,0,3,2
18813,5,2,65685,65685,65687,0,2,2
18814,5,2,65690,65690,65692,0,2,3
18815,1,1,65691,65692,65693,1,2,0
18816,4,2,65695,65695,65697,0,2,2
18817,5,2,65700,65700,65702,0,2,3
18818,4,2,65704,65704,65706,0,2,2
18819,1,3,65705,65706,65709,1,4,0
18820,1,1,65706,65709,65710,3,4,0
18821,3,3,65709,65710,65713,1,4,0
18822,1,1,65710,65713,65714,3,4,0
18823,2,3,65712,65714,65717,2,5,0
18824,1,1,65713,65717,65718,4,5,0
18825,2,3,65715,65718,65721,3,6,0
18826,3,1,65718,65721,65722,3,4,0
18827,6,2,65724,65724,65726,0,2,2
18828,5,1,65729,65729,65730,0,1,3
18829,1,2,65730,65730,65732,0,2,0
18830,5,1,65735,65735,65736,0,1,3
18831,3,3,65738,65738,65741,0,3,2
18832,4,2,65742,65742,65744,0,2,1
18833,1,3,65743,65744,65747,1,4,0
18834,3,2,65746,65747,65749,1,3,0
18835,1,2,65747,65749,65751,2,4,0
18836,4,1,65751,65751,65752,0,1,0
18837,2,2,65753,65753,65755,0,2,1
18838,3,2,65756,65756,65758,0,2,1
18839,5,3,65761,65761,65764,0,3,3
18840,1,2,65762,65764,65766,2,4,0
18841,4,2,65766,65766,65768,0,2,0
18842,1,3,65767,65768,65771,1,4,0
18843,1,1,65768,65771,65772,3,4,0
18844,2,2,65770,65772,65774,2,4,0
18845,2,2,65772,65774,65776,2,4,0
18846,2,3,65774,65776,65779,2,5,0
18847,2,1,65776,65779,65780,3,4,0
18848,3,1,65779,65780,65781,1,2,0
18849,1,1,65780,65781,65782,1,2,0
18850,4,2,65784,65784,65786,0,2,2
18851,1,2,65785,65786,65788,1,3,0
18852,6,2,65791,65791,65793,0,2,3
18853,3,3,65794,65794,65797,0,3,1
18854,4,2,65798,65798,65800,0,2,1
18855,1,1,65799,65800,65801,1,2,0
18856,4,2,65803,65803,65805,0,2,2
18857,1,3,65804,65805,65808,1,4,0
18858,1,2,65805,65808,65810,3,5,0
18859,1,2,65806,65810,65812,4,6,0
18860,6,3,65812,65812,65815,0,3,0
18861,6,2,65818,65818,65820,0,2,3
18862,6,1,65824,65824,65825,0,1,4
18863,2,2,65826,65826,65828,0,2,1
18864,5,1,65831,65831,65832,0,1,3
18865,3,2,65834,65834,65836,0,2,2
18866,6,3,65840,65840,65843,0,3,4
18867,1,1,65841,65843,65844,2,3,0
18868,4,1,65845,65845,65846,0,1,1
18869,3,3,65848,65848,65851,0,3,2
18870,4,1,65852,65852,65853,0,1,1
18871,6,1,65858,65858,65859,0,1,5
18872,4,2,65862,65862,65864,0,2,3
18873,5,3,65867,65867,65870,0,3,3
18874,3,3,65870,65870,65873,0,3,0
18875,5,2,65875,65875,65877,0,2,2
18876,2,2,65877,65877,65879,0,2,0
18877,2,2,65879,65879,65881,0,2,0
18878,6,2,65885,65885,65887,0,2,4
18879,3,1,65888,65888,65889,0,1,1
18880,5,2,65893,65893,65895,0,2,4
18881,1,3,65894,65895,65898,1,4,0
18882,5,3,65899,65899,65902,0,3,1
18883,5,2,65904,65904,65906,0,2,2
18884,2,1,65906,65906,65907,0,1,0
18885,5,2,65911,65911,65913,0,2,4
18886,5,1,65916,65916,65917,0,1,3
18887,2,3,65918,65918,65921,0,3,1
18888,2,1,65920,65921,65922,1,2,0
18889,5,2,65925,65925,65927,0,2,3
18890,3,3,65928,65928,65931,0,3,1
18891,4,3,65932,65932,65935,0,3,1
18892,5,1,65937,65937,65938,0,1,2
18893,6,2,65943,65943,65945,0,2,5
18894,1,3,65944,65945,65948,1,4,0
18895,3,2,65947,65948,65950,1,3,0
18896,4,1,65951,65951,65952,0,1,1
18897,1,1,65952,65952,65953,0,1,0
18898,2,2,65954,65954,65956,0,2,1
18899,2,2,65956,65956,65958,0,2,0
18900,5,3,65961,65961,65964,0,3,3
18901,4,1,65965,65965,65966,0,1,1
18902,5,3,65970,65970,65973,0,3,4
18903,4,3,65974,65974,65977,0,3,1
18904,2,3,65976,65977,65980,1,4,0
18905,3,3,65979,65980,65983,1,4,0
18906,6,3,65985,65985,65988,0,3,2
18907,1,1,65986,65988,65989,2,3,0
18908,5,1,65991,65991,65992,0,1,2
18909,1,2,65992,65992,65994,0,2,0
18910,2,2,65994,65994,65996,0,2,0
18911,3,2,65997,65997,65999,0,2,1
18912,2,2,65999,65999,66001,0,2,0
18913,4,3,66003,66003,66006,0,3,2
18914,2,1,66005,66006,66007,1,2,0
18915,2,3,66007,66007,66010,0,3,0
18916,3,2,66010,66010,66012,0,2,0
18917,2,2,66012,66012,66014,0,2,0
18918,1,1,66013,66014,66015,1,2,0
18919,2,3,66015,66015,66018,0,3,0
18920,6,2,66021,66021,66023,0,2,3
18921,1,2,66022,66023,66025,1,3,0
18922,4,3,66026,66026,66029,0,3,1
18923,3,2,66029,66029,66031,0,2,0
18924,5,1,66034,66034,66035,0,1,3
18925,5,3,66039,66039,66042,0,3,4
18926,1,1,66040,66042,66043,2,3,0
18927,3,3,66043,66043,66046,0,3,0
18928,1,3,66044,66046,66049,2,5,0
18929,1,3,66045,66049,66052,4,7,0
18930,6,3,66051,66052,66055,1,4,0
18931,5,3,66056,66056,66059,0,3,1
18932,2,2,66058,66059,66061,1,3,0
18933,2,1,66060,66061,66062,1,2,0
18934,6,2,66066,66066,66068,0,2,4
18935,3,1,66069,66069,66070,0,1,1
18936,1,1,66070,66070,66071,0,1,0
18937,2,3,66072,66072,66075,0,3,1
18938,5,3,66077,66077,66080,0,3,2
18939,2,2,66079,66080,66082,1,3,0
18940,5,2,66084,66084,66086,0,2,2
18941,6,2,66090,66090,66092,0,2,4
18942,5,3,66095,66095,66098,0,3,3
18943,6,1,66101,66101,66102,0,1,3
18944,3,1,66104,66104,66105,0,1,2
18945,1,1,66105,66105,66106,0,1,0
18946,6,3,66111,66111,66114,0,3,5
18947,4,3,66115,66115,66118,0,3,1
18948,3,3,66118,66118,66121,0,3,0
18949,6,1,66124,66124,66125,0,1,3
18950,5,3,66129,66129,66132,0,3,4
18951,4,2,66133,66133,66135,0,2,1
18952,2,1,66135,66135,66136,0,1,0
18953,1,3,66136,66136,66139,0,3,0
18954,6,3,66142,66142,66145,0,3,3
18955,3,3,66145,66145,66148,0,3,0
18956,6,1,66151,66151,66152,0,1,3
18957,4,3,66155,66155,66158,0,3,3
18958,6,1,66161,66161,66162,0,1,3
18959,4,1,66165,66165,66166,0,1,3
18960,2,3,66167,66167,66170,0,3,1
18961,5,1,66172,66172,66173,0,1,2
18962,2,2,66174,66174,66176,0,2,1
18963,4,3,66178,66178,66181,0,3,2
18964,1,3,66179,66181,66184,2,5,0
18965,1,2,66180,66184,66186,4,6,0
18966,1,1,66181,66186,66187,5,6,0
18967,3,2,66184,66187,66189,3,5,0
18968,4,1,66188,66189,66190,1,2,0
18969,2,1,66190,66190,66191,0,1,0
18970,6,2,66196,66196,66198,0,2,5
18971,2,2,66198,66198,66200,0,2,0
18972,5,2,66203,66203,66205,0,2,3
18973,5,2,66208,66208,66210,0,2,3
18974,3,3,66211,66211,66214,0,3,1
18975,1,1,66212,66214,66215,2,3,0
18976,6,2,66218,66218,66220,0,2,3
18977,4,1,66222,66222,66223,0,1,2
18978,5,1,66227,66227,66228,0,1,4
18979,5,2,66232,66232,66234,0,2,4
18980,2,3,66234,66234,66237,0,3,0
18981,1,1,66235,66237,66238,2,3,0
18982,1,3,66236,66238,66241,2,5,0
18983,6,1,66242,66242,66243,0,1,1
18984,5,1,66247,66247,66248,0,1,4
18985,4,1,66251,66251,66252,0,1,3
18986,4,2,66255,66255,66257,0,2,3
18987,1,1,66256,66257,66258,1,2,0
18988,1,2,66257,66258,66260,1,3,0
18989,6,2,66263,66263,66265,0,2,3
18990,1,2,66264,66265,66267,1,3,0
18991,5,2,66269,66269,66271,0,2,2
18992,4,1,66273,66273,66274,0,1,2
18993,5,2,66278,66278,66280,0,2,4
18994,3,1,66281,66281,66282,0,1,1
18995,6,1,66287,66287,66288,0,1,5
18996,3,3,66290,66290,66293,0,3,2
18997,2,3,66292,66293,66296,1,4,0
18998,5,1,66297,66297,66298,0,1,1
18999,3,3,66300,66300,66303,0,3,2
19000,3,2,66303,66303,66305,0,2,0
19001,6,1,66309,66309,66310,0,1,4
19002,4,1,66313,66313,66314,0,1,3
19003,2,1,66315,66315,66316,0,1,1
19004,6,2,66321,66321,66323,0,2,5
19005,4,1,66325,66325,66326,0,1,2
19006,6,3,66331,66331,66334,0,3,5
19007,5,3,66336,66336,66339,0,3,2
19008,6,2,66342,66342,66344,0,2,3
19009,4,2,66346,66346,66348,0,2,2
19010,2,2,66348,66348,66350,0,2,0
19011,4,2,66352,66352,66354,0,2,2
19012,6,1,66358,66358,66359,0,1,4
19013,6,1,66364,66364,66365,0,1,5
19014,5,2,66369,66369,66371,0,2,4
19015,2,3,66371,66371,66374,0,3,0
19016,3,1,66374,66374,66375,0,1,0
19017,3,2,66377,66377,66379,0,2,2
19018,6,3,66383,66383,66386,0,3,4
19019,1,3,66384,66386,66389,2,5,0
19020,2,1,66386,66389,66390,3,4,0
19021,2,2,66388,66390,66392,2,4,0
19022,5,3,66393,66393,66396,0,3,1
19023,5,1,66398,66398,66399,0,1,2
19024,3,2,66401,66401,66403,0,2,2
19025,4,2,66405,66405,66407,0,2,2
19026,2,1,66407,66407,66408,0,1,0
19027,3,3,66410,66410,66413,0,3,2
19028,1,1,66411,66413,66414,2,3,0
19029,1,2,66412,66414,66416,2,4,0
19030,6,1,66418,66418,66419,0,1,2
19031,4,1,66422,66422,66423,0,1,3
19032,4,3,66426,66426,66429,0,3,3
19033,5,2,66431,66431,66433,0,2,2
19034,5,3,66436,66436,66439,0,3,3
19035,1,2,66437,66439,66441,2,4,0
19036,3,3,66440,66441,66444,1,4,0
19037,6,2,66446,66446,66448,0,2,2
19038,6,3,66452,66452,66455,0,3,4
19039,2,2,66454,66455,66457,1,3,0
19040,2,1,66456,66457,66458,1,2,0
19041,4,3,66460,66460,66463,0,3,2
19042,6,1,66466,66466,66467,0,1,3
19043,3,2,66469,66469,66471,0,2,2
19044,4,2,66473,66473,66475,0,2,2
19045,5,1,66478,66478,66479,0,1,3
19046,6,3,66484,66484,66487,0,3,5
19047,5,1,66489,66489,66490,0,1,2
19048,6,2,66495,66495,66497,0,2,5
19049,6,1,66501,66501,66502,0,1,4
19050,2,1,66503,66503,66504,0,1,1
19051,5,2,66508,66508,66510,0,2,4
19052,6,2,66514,66514,66516,0,2,4
19053,5,1,66519,66519,66520,0,1,3
19054,5,2,66524,66524,66526,0,2,4
19055,5,2,66529,66529,66531,0,2,3
19056,3,2,66532,66532,66534,0,2,1
19057,2,3,66534,66534,66537,0,3,0
19058,5,2,66539,66539,66541,0,2,2
19059,2,2,66541,66541,66543,0,2,0
19060,4,2,66545,66545,66547,0,2,2
19061,2,2,66547,66547,66549,0,2,0
19062,6,1,66553,66553,66554,0,1,4
19063,2,1,66555,66555,66556,0,1,1
19064,5,3,66560,66560,66563,0,3,4
19065,6,3,66566,66566,66569,0,3,3
19066,3,2,66569,66569,66571,0,2,0
19067,5,1,66574,66574,66575,0,1,3
19068,1,1,66575,66575,66576,0,1,0
19069,4,2,66579,66579,66581,0,2,3
19070,1,2,66580,66581,66583,1,3,0
19071,1,3,66581,66583,66586,2,5,0
19072,2,3,66583,66586,66589,3,6,0
19073,2,3,66585,66589,66592,4,7,0
19074,2,2,66587,66592,66594,5,7,0
19075,3,2,66590,66594,66596,4,6,0
19076,2,2,66592,66596,66598,4,6,0
19077,5,2,66597,66598,66600,1,3,0
19078,5,2,66602,66602,66604,0,2,2
19079,1,3,66603,66604,66607,1,4,0
19080,2,1,66605,66607,66608,2,3,0
19081,2,2,66607,66608,66610,1,3,0
19082,5,3,66612,66612,66615,0,3,2
19083,1,1,66613,66615,66616,2,3,0
19084,3,3,66616,66616,66619,0,3,0
19085,3,1,66619,66619,66620,0,1,0
19086,5,3,66624,66624,66627,0,3,4
19087,3,3,66627,66627,66630,0,3,0
19088,5,2,66632,66632,66634,0,2,2
19089,3,2,66635,66635,66637,0,2,1
19090,3,3,66638,66638,66641,0,3,1
19091,5,3,66643,66643,66646,0,3,2
19092,1,3,66644,66646,66649,2,5,0
19093,6,3,66650,66650,66653,0,3,1
19094,3,3,66653,66653,66656,0,3,0
19095,4,2,66657,66657,66659,0,2,1
19096,1,2,66658,66659,66661,1,3,0
19097,3,2,66661,66661,66663,0,2,0
19098,3,2,66664,66664,66666,0,2,1
19099,2,1,66666,66666,66667,0,1,0
19100,2,2,66668,66668,66670,0,2,1
19101,3,2,66671,66671,66673,0,2,1
19102,5,3,66676,66676,66679,0,3,3
19103,1,1,66677,66679,66680,2,3,0
19104,3,3,66680,66680,66683,0,3,0
19105,1,2,66681,66683,66685,2,4,0
19106,6,1,66687,66687,66688,0,1,2
19107,1,2,66688,66688,66690,0,2,0
19108,5,3,66693,66693,66696,0,3,3
19109,6,2,66699,66699,66701,0,2,3
19110,1,2,66700,66701,66703,1,3,0
19111,2,2,66702,66703,66705,1,3,0
19112,3,2,66705,66705,66707,0,2,0
19113,3,2,66708,66708,66710,0,2,1
19114,3,3,66711,66711,66714,0,3,1
19115,4,3,66715,66715,66718,0,3,1
19116,6,1,66721,66721,66722,0,1,3
19117,1,1,66722,66722,66723,0,1,0
19118,1,2,66723,66723,66725,0,2,0
19119,3,1,66726,66726,66727,0,1,1
19120,3,1,66729,66729,66730,0,1,2
19121,3,3,66732,66732,66735,0,3,2
19122,5,1,66737,66737,66738,0,1,2
19123,4,1,66741,66741,66742,0,1,3
19124,5,3,66746,66746,66749,0,3,4
19125,1,2,66747,66749,66751,2,4,0
19126,2,1,66749,66751,66752,2,3,0
19127,2,1,66751,66752,66753,1,2,0
19128,6,3,66757,66757,66760,0,3,4
19129,6,1,66763,66763,66764,0,1,3
19130,4,1,66767,66767,66768,0,1,3
19131,2,1,66769,66769,66770,0,1,1
19132,6,1,66775,66775,66776,0,1,5
19133,5,1,66780,66780,66781,0,1,4
19134,5,1,66785,66785,66786,0,1,4
19135,5,3,66790,66790,66793,0,3,4
19136,4,2,66794,66794,66796,0,2,1
19137,5,2,66799,66799,66801,0,2,3
19138,2,2,66801,66801,66803,0,2,0
19139,4,3,66805,66805,66808,0,3,2
19140,1,3,66806,66808,66811,2,5,0
19141,1,1,66807,66811,66812,4,5,0
19142,1,3,66808,66812,66815,4,7,0
19143,3,2,66811,66815,66817,4,6,0
19144,4,1,66815,66817,66818,2,3,0
19145,6,2,66821,66821,66823,0,2,3
19146,3,2,66824,66824,66826,0,2,1
19147,6,1,66830,66830,66831,0,1,4
19148,6,3,66836,66836,66839,0,3,5
19149,3,1,66839,66839,66840,0,1,0
19150,6,1,66845,66845,66846,0,1,5
19151,3,2,66848,66848,66850,0,2,2
19152,5,1,66853,66853,66854,0,1,3
19153,1,3,66854,66854,66857,0,3,0
19154,6,2,66860,66860,66862,0,2,3
19155,1,1,66861,66862,66863,1,2,0
19156,1,2,66862,66863,66865,1,3,0
19157,3,2,66865,66865,66867,0,2,0
19158,2,1,66867,66867,66868,0,1,0
19159,1,1,66868,66868,66869,0,1,0
19160,6,3,66874,66874,66877,0,3,5
19161,2,3,66876,66877,66880,1,4,0
19162,2,2,66878,66880,66882,2,4,0
19163,4,3,66882,66882,66885,0,3,0
19164,6,3,66888,66888,66891,0,3,3
19165,4,2,66892,66892,66894,0,2,1
19166,4,1,66896,66896,66897,0,1,2
19167,4,2,66900,66900,66902,0,2,3
19168,5,3,66905,66905,66908,0,3,3
19169,1,1,66906,66908,66909,2,3,0
19170,6,2,66912,66912,66914,0,2,3
19171,3,2,66915,66915,66917,0,2,1
19172,1,3,66916,66917,66920,1,4,0
19173,3,2,66919,66920,66922,1,3,0
19174,5,1,66924,66924,66925,0,1,2
19175,1,1,66925,66925,66926,0,1,0
19176,2,3,66927,66927,66930,0,3,1
19177,4,3,66931,66931,66934,0,3,1
19178,1,3,66932,66934,66937,2,5,0
19179,5,2,66937,66937,66939,0,2,0
19180,2,3,66939,66939,66942,0,3,0
19181,5,3,66944,66944,66947,0,3,2
19182,4,3,66948,66948,66951,0,3,1
19183,3,2,66951,66951,66953,0,2,0
19184,3,1,66954,66954,66955,0,1,1
19185,2,3,66956,66956,66959,0,3,1
19186,6,2,66962,66962,66964,0,2,3
19187,5,2,66967,66967,66969,0,2,3
19188,3,2,66970,66970,66972,0,2,1
19189,1,2,66971,66972,66974,1,3,0
19190,5,1,66976,66976,66977,0,1,2
19191,1,2,66977,66977,66979,0,2,0
19192,6,2,66983,66983,66985,0,2,4
19193,5,1,66988,66988,66989,0,1,3
19194,1,3,66989,66989,66992,0,3,0
19195,5,2,66994,66994,66996,0,2,2
19196,3,2,66997,66997,66999,0,2,1
19197,4,2,67001,67001,67003,0,2,2
19198,5,3,67006,67006,67009,0,3,3
19199,6,1,67012,67012,67013,0,1,3
19200,2,3,67014,67014,67017,0,3,1
19201,3,2,67017,67017,67019,0,2,0
19202,1,2,67018,67019,67021,1,3,0
19203,4,2,67022,67022,67024,0,2,1
19204,4,1,67026,67026,67027,0,1,2
19205,5,2,67031,67031,67033,0,2,4
19206,5,1,67036,67036,67037,0,1,3
19207,3,1,67039,67039,67040,0,1,2
19208,5,2,67044,67044,67046,0,2,4
19209,6,3,67050,67050,67053,0,3,4
19210,3,3,67053,67053,67056,0,3,0
19211,6,1,67059,67059,67060,0,1,3
19212,6,3,67065,67065,67068,0,3,5
19213,5,2,67070,67070,67072,0,2,2
19214,6,2,67076,67076,67078,0,2,4
19215,4,2,67080,67080,67082,0,2,2
19216,6,2,67086,67086,67088,0,2,4
19217,6,3,67092,67092,67095,0,3,4
19218,2,1,67094,67095,67096,1,2,0
19219,3,3,67097,67097,67100,0,3,1
19220,3,3,67100,67100,67103,0,3,0
19221,6,1,67106,67106,67107,0,1,3
19222,1,3,67107,67107,67110,0,3,0
19223,1,3,67108,67110,67113,2,5,0
19224,3,2,67111,67113,67115,2,4,0
19225,6,1,67117,67117,67118,0,1,2
19226,5,1,67122,67122,67123,0,1,4
19227,2,2,67124,67124,67126,0,2,1
19228,5,2,67129,67129,67131,0,2,3
19229,6,2,67135,67135,67137,0,2,4
19230,1,2,67136,67137,67139,1,3,0
19231,6,1,67142,67142,67143,0,1,3
19232,5,2,67147,67147,67149,0,2,4
19233,6,2,67153,67153,67155,0,2,4
19234,1,3,67154,67155,67158,1,4,0
19235,6,1,67160,67160,67161,0,1,2
19236,4,1,67164,67164,67165,0,1,3
19237,5,1,67169,67169,67170,0,1,4
19238,6,3,67175,67175,67178,0,3,5
19239,4,2,67179,67179,67181,0,2,1
19240,1,1,67180,67181,67182,1,2,0
19241,1,2,67181,67182,67184,1,3,0
19242,4,2,67185,67185,67187,0,2,1
19243,6,2,67191,67191,67193,0,2,4
19244,2,2,67193,67193,67195,0,2,0
19245,4,2,67197,67197,67199,0,2,2
19246,1,1,67198,67199,67200,1,2,0
19247,3,2,67201,67201,67203,0,2,1
19248,2,3,67203,67203,67206,0,3,0
19249,4,3,67207,67207,67210,0,3,1
19250,4,3,67211,67211,67214,0,3,1
19251,3,3,67214,67214,67217,0,3,0
19252,3,2,67217,67217,67219,0,2,0
19253,2,2,67219,67219,67221,0,2,0
19254,6,1,67225,67225,67226,0,1,4
19255,2,2,67227,67227,67229,0,2,1
19256,4,3,67231,67231,67234,0,3,2
19257,4,3,67235,67235,67238,0,3,1
19258,5,3,67240,67240,67243,0,3,2
19259,2,1,67242,67243,67244,1,2,0
19260,6,2,67248,67248,67250,0,2,4
19261,1,1,67249,67250,67251,1,2,0
19262,1,3,67250,67251,67254,1,4,0
19263,5,1,67255,67255,67256,0,1,1
19264,2,3,67257,67257,67260,0,3,1
19265,2,3,67259,67260,67263,1,4,0
19266,6,1,67265,67265,67266,0,1,2
19267,4,1,67269,67269,67270,0,1,3
19268,1,3,67270,67270,67273,0,3,0
19269,5,1,67275,67275,67276,0,1,2
19270,2,1,67277,67277,67278,0,1,1
19271,2,3,67279,67279,67282,0,3,1
19272,2,2,67281,67282,67284,1,3,0
19273,5,1,67286,67286,67287,0,1,2
19274,1,1,67287,67287,67288,0,1,0
19275,5,1,67292,67292,67293,0,1,4
19276,4,2,67296,67296,67298,0,2,3
19277,1,1,67297,67298,67299,1,2,0
19278,4,3,67301,67301,67304,0,3,2
19279,2,1,67303,67304,67305,1,2,0
19280,5,3,67308,67308,67311,0,3,3
19281,2,1,67310,67311,67312,1,2,0
19282,1,2,67311,67312,67314,1,3,0
19283,2,1,67313,67314,67315,1,2,0
19284,1,1,67314,67315,67316,1,2,0
19285,4,3,67318,67318,67321,0,3,2
19286,4,2,67322,67322,67324,0,2,1
19287,4,3,67326,67326,67329,0,3,2
19288,5,2,67331,67331,67333,0,2,2
19289,1,3,67332,67333,67336,1,4,0
19290,2,2,67334,67336,67338,2,4,0
19291,6,1,67340,67340,67341,0,1,2
19292,4,3,67344,67344,67347,0,3,3
19293,4,1,67348,67348,67349,0,1,1
19294,5,3,67353,67353,67356,0,3,4
19295,5,2,67358,67358,67360,0,2,2
19296,6,1,67364,67364,67365,0,1,4
19297,4,1,67368,67368,67369,0,1,3
19298,4,1,67372,67372,67373,0,1,3
19299,3,1,67375,67375,67376,0,1,2
19300,3,3,67378,67378,67381,0,3,2
19301,3,1,67381,67381,67382,0,1,0
19302,2,3,67383,67383,67386,0,3,1
19303,3,2,67386,67386,67388,0,2,0
19304,5,2,67391,67391,67393,0,2,3
19305,4,3,67395,67395,67398,0,3,2
19306,2,3,67397,67398,67401,1,4,0
19307,3,1,67400,67401,67402,1,2,0
19308,5,2,67405,67405,67407,0,2,3
19309,2,3,67407,67407,67410,0,3,0
19310,5,3,67412,67412,67415,0,3,2
19311,2,1,67414,67415,67416,1,2,0
19312,6,3,67420,67420,67423,0,3,4
19313,5,3,67425,67425,67428,0,3,2
19314,6,3,67431,67431,67434,0,3,3
19315,3,3,67434,67434,67437,0,3,0
19316,6,1,67440,67440,67441,0,1,3
19317,3,2,67443,67443,67445,0,2,2
19318,6,3,67449,67449,67452,0,3,4
19319,3,2,67452,67452,67454,0,2,0
19320,5,2,67457,67457,67459,0,2,3
19321,1,1,67458,67459,67460,1,2,0
19322,6,3,67464,67464,67467,0,3,4
19323,6,2,67470,67470,67472,0,2,3
19324,1,3,67471,67472,67475,1,4,0
19325,6,1,67477,67477,67478,0,1,2
19326,5,3,67482,67482,67485,0,3,4
19327,3,3,67485,67485,67488,0,3,0
19328,6,2,67491,67491,67493,0,2,3
19329,3,3,67494,67494,67497,0,3,1
19330,1,1,67495,67497,67498,2,3,0
19331,5,2,67500,67500,67502,0,2,2
19332,4,1,67504,67504,67505,0,1,2
19333,6,1,67510,67510,67511,0,1,5
19334,3,2,67513,67513,67515,0,2,2
19335,2,3,67515,67515,67518,0,3,0
19336,4,2,67519,67519,67521,0,2,1
19337,4,1,67523,67523,67524,0,1,2
19338,4,1,67527,67527,67528,0,1,3
19339,2,2,67529,67529,67531,0,2,1
19340,1,3,67530,67531,67534,1,4,0
19341,1,2,67531,67534,67536,3,5,0
19342,3,3,67534,67536,67539,2,5,0
19343,1,1,67535,67539,67540,4,5,0
19344,5,1,67540,67540,67541,0,1,0
19345,3,2,67543,67543,67545,0,2,2
19346,6,2,67549,67549,67551,0,2,4
19347,6,3,67555,67555,67558,0,3,4
19348,6,3,67561,67561,67564,0,3,3
19349,3,3,67564,67564,67567,0,3,0
19350,2,2,67566,67567,67569,1,3,0
19351,6,1,67572,67572,67573,0,1,3
19352,4,3,67576,67576,67579,0,3,3
19353,6,2,67582,67582,67584,0,2,3
19354,1,3,67583,67584,67587,1,4,0
19355,3,1,67586,67587,67588,1,2,0
19356,4,3,67590,67590,67593,0,3,2
19357,2,3,67592,67593,67596,1,4,0
19358,2,2,67594,67596,67598,2,4,0
19359,2,1,67596,67598,67599,2,3,0
19360,3,2,67599,67599,67601,0,2,0
19361,2,3,67601,67601,67604,0,3,0
19362,5,1,67606,67606,67607,0,1,2
19363,2,3,67608,67608,67611,0,3,1
19364,3,2,67611,67611,67613,0,2,0
19365,6,2,67617,67617,67619,0,2,4
19366,1,2,67618,67619,67621,1,3,0
19367,5,3,67623,67623,67626,0,3,2
19368,1,2,67624,67626,67628,2,4,0
19369,3,2,67627,67628,67630,1,3,0
19370,1,3,67628,67630,67633,2,5,0
19371,2,2,67630,67633,67635,3,5,0
19372,3,1,67633,67635,67636,2,3,0
19373,4,3,67637,67637,67640,0,3,1
19374,5,3,67642,67642,67645,0,3,2
19375,2,2,67644,67645,67647,1,3,0
19376,2,3,67646,67647,67650,1,4,0
19377,2,3,67648,67650,67653,2,5,0
19378,2,1,67650,67653,67654,3,4,0
19379,4,1,67654,67654,67655,0,1,0
19380,2,3,67656,67656,67659,0,3,1
19381,5,1,67661,67661,67662,0,1,2
19382,2,2,67663,67663,67665,0,2,1
19383,6,3,67669,67669,67672,0,3,4
19384,4,1,67673,67673,67674,0,1,1
19385,2,3,67675,67675,67678,0,3,1
19386,1,1,67676,67678,67679,2,3,0
19387,6,3,67682,67682,67685,0,3,3
19388,4,3,67686,67686,67689,0,3,1
19389,3,3,67689,67689,67692,0,3,0
19390,2,2,67691,67692,67694,1,3,0
19391,5,2,67696,67696,67698,0,2,2
19392,2,3,67698,67698,67701,0,3,0
19393,1,3,67699,67701,67704,2,5,0
19394,4,2,67703,67704,67706,1,3,0
19395,5,1,67708,67708,67709,0,1,2
19396,6,1,67714,67714,67715,0,1,5
19397,5,1,67719,67719,67720,0,1,4
19398,6,2,67725,67725,67727,0,2,5
19399,6,2,67731,67731,67733,0,2,4
19400,4,1,67735,67735,67736,0,1,2
19401,2,2,67737,67737,67739,0,2,1
19402,5,2,67742,67742,67744,0,2,3
19403,6,2,67748,67748,67750,0,2,4
19404,1,2,67749,67750,67752,1,3,0
19405,2,1,67751,67752,67753,1,2,0
19406,5,2,67756,67756,67758,0,2,3
19407,6,2,67762,67762,67764,0,2,4
19408,2,2,67764,67764,67766,0,2,0
19409,3,1,67767,67767,67768,0,1,1
19410,4,3,67771,67771,67774,0,3,3
19411,1,2,67772,67774,67776,2,4,0
19412,1,2,67773,67776,67778,3,5,0
19413,1,1,67774,67778,67779,4,5,0
19414,4,2,67778,67779,67781,1,3,0
19415,1,3,67779,67781,67784,2,5,0
19416,5,1,67784,67784,67785,0,1,0
19417,4,1,67788,67788,67789,0,1,3
19418,3,3,67791,67791,67794,0,3,2
19419,6,3,67797,67797,67800,0,3,3
19420,6,2,67803,67803,67805,0,2,3
19421,2,3,67805,67805,67808,0,3,0
19422,5,3,67810,67810,67813,0,3,2
19423,5,2,67815,67815,67817,0,2,2
19424,4,3,67819,67819,67822,0,3,2
19425,3,3,67822,67822,67825,0,3,0
19426,5,3,67827,67827,67830,0,3,2
19427,1,2,67828,67830,67832,2,4,0
19428,1,3,67829,67832,67835,3,6,0
19429,3,2,67832,67835,67837,3,5,0
19430,3,2,67835,67837,67839,2,4,0
19431,5,2,67840,67840,67842,0,2,1
19432,5,1,67845,67845,67846,0,1,3
19433,2,2,67847,67847,67849,0,2,1
19434,2,1,67849,67849,67850,0,1,0
19435,1,1,67850,67850,67851,0,1,0
19436,5,2,67855,67855,67857,0,2,4
19437,3,1,67858,67858,67859,0,1,1
19438,4,1,67862,67862,67863,0,1,3
19439,4,3,67866,67866,67869,0,3,3
19440,4,3,67870,67870,67873,0,3,1
19441,3,1,67873,67873,67874,0,1,0
19442,2,3,67875,67875,67878,0,3,1
19443,2,3,67877,67878,67881,1,4,0
19444,3,1,67880,67881,67882,1,2,0
19445,1,1,67881,67882,67883,1,2,0
19446,3,2,67884,67884,67886,0,2,1
19447,5,3,67889,67889,67892,0,3,3
19448,3,3,67892,67892,67895,0,3,0
19449,2,1,67894,67895,67896,1,2,0
19450,5,3,67899,67899,67902,0,3,3
19451,4,3,67903,67903,67906,0,3,1
19452,5,1,67908,67908,67909,0,1,2
19453,2,2,67910,67910,67912,0,2,1
19454,4,2,67914,67914,67916,0,2,2
19455,6,1,67920,67920,67921,0,1,4
19456,5,3,67925,67925,67928,0,3,4
19457,6,3,67931,67931,67934,0,3,3
19458,3,1,67934,67934,67935,0,1,0
19459,2,3,67936,67936,67939,0,3,1
19460,3,2,67939,67939,67941,0,2,0
19461,5,2,67944,67944,67946,0,2,3
19462,2,2,67946,67946,67948,0,2,0
19463,1,3,67947,67948,67951,1,4,0
19464,2,3,67949,67951,67954,2,5,0
19465,5,1,67954,67954,67955,0,1,0
19466,2,1,67956,67956,67957,0,1,1
19467,3,3,67959,67959,67962,0,3,2
19468,1,3,67960,67962,67965,2,5,0
19469,2,3,67962,67965,67968,3,6,0
19470,3,1,67965,67968,67969,3,4,0
19471,4,1,67969,67969,67970,0,1,0
19472,2,2,67971,67971,67973,0,2,1
19473,2,1,67973,67973,67974,0,1,0
19474,2,1,67975,67975,67976,0,1,1
19475,4,2,67979,67979,67981,0,2,3
19476,1,2,67980,67981,67983,1,3,0
19477,4,1,67984,67984,67985,0,1,1
19478,6,1,67990,67990,67991,0,1,5
19479,3,2,67993,67993,67995,0,2,2
19480,6,3,67999,67999,68002,0,3,4
19481,4,3,68003,68003,68006,0,3,1
19482,3,1,68006,68006,68007,0,1,0
19483,1,1,68007,68007,68008,0,1,0
19484,2,3,68009,68009,68012,0,3,1
19485,3,2,68012,68012,68014,0,2,0
19486,6,1,68018,68018,68019,0,1,4
19487,2,2,68020,68020,68022,0,2,1
19488,6,1,68026,68026,68027,0,1,4
19489,6,3,68032,68032,68035,0,3,5
19490,5,3,68037,68037,68040,0,3,2
19491,1,2,68038,68040,68042,2,4,0
19492,4,2,68042,68042,68044,0,2,0
19493,2,2,68044,68044,68046,0,2,0
19494,2,1,68046,68046,68047,0,1,0
19495,2,3,68048,68048,68051,0,3,1
19496,1,3,68049,68051,68054,2,5,0
19497,5,2,68054,68054,68056,0,2,0
19498,2,1,68056,68056,68057,0,1,0
19499,4,2,68060,68060,68062,0,2,3
19500,5,2,68065,68065,68067,0,2,3
19501,4,1,68069,68069,68070,0,1,2
19502,4,1,68073,68073,68074,0,1,3
19503,4,3,68077,68077,68080,0,3,3
19504,3,2,68080,68080,68082,0,2,0
19505,5,3,68085,68085,68088,0,3,3
19506,2,3,68087,68088,68091,1,4,0
19507,1,1,68088,68091,68092,3,4,0
19508,4,1,68092,68092,68093,0,1,0
19509,2,3,68094,68094,68097,0,3,1
19510,1,3,68095,68097,68100,2,5,0
19511,1,3,68096,68100,68103,4,7,0
19512,2,1,68098,68103,68104,5,6,0
19513,6,3,68104,68104,68107,0,3,0
19514,3,3,68107,68107,68110,0,3,0
19515,5,3,68112,68112,68115,0,3,2
19516,3,2,68115,68115,68117,0,2,0
19517,5,3,68120,68120,68123,0,3,3
19518,4,3,68124,68124,68127,0,3,1
19519,3,1,68127,68127,68128,0,1,0
19520,2,3,68129,68129,68132,0,3,1
19521,5,3,68134,68134,68137,0,3,2
19522,5,3,68139,68139,68142,0,3,2
19523,6,2,68145,68145,68147,0,2,3
19524,4,2,68149,68149,68151,0,2,2
19525,4,2,68153,68153,68155,0,2,2
19526,2,1,68155,68155,68156,0,1,0
19527,2,3,68157,68157,68160,0,3,1
19528,5,1,68162,68162,68163,0,1,2
19529,6,1,68168,68168,68169,0,1,5
19530,2,1,68170,68170,68171,0,1,1
19531,2,2,68172,68172,68174,0,2,1
19532,5,3,68177,68177,68180,0,3,3
19533,2,2,68179,68180,68182,1,3,0
19534,6,1,68185,68185,68186,0,1,3
19535,2,2,68187,68187,68189,0,2,1
19536,3,3,68190,68190,68193,0,3,1
19537,4,2,68194,68194,68196,0,2,1
19538,6,3,68200,68200,68203,0,3,4
19539,4,3,68204,68204,68207,0,3,1
19540,5,3,68209,68209,68212,0,3,2
19541,2,2,68211,68212,68214,1,3,0
19542,4,2,68215,68215,68217,0,2,1
19543,3,2,68218,68218,68220,0,2,1
19544,1,1,68219,68220,68221,1,2,0
19545,2,3,68221,68221,68224,0,3,0
19546,1,2,68222,68224,68226,2,4,0
19547,4,1,68226,68226,68227,0,1,0
19548,1,1,68227,68227,68228,0,1,0
19549,3,1,68230,68230,68231,0,1,2
19550,6,2,68236,68236,68238,0,2,5
19551,3,3,68239,68239,68242,0,3,1
19552,2,3,68241,68242,68245,1,4,0
19553,5,1,68246,68246,68247,0,1,1
19554,5,1,68251,68251,68252,0,1,4
19555,5,2,68256,68256,68258,0,2,4
19556,3,2,68259,68259,68261,0,2,1
19557,3,2,68262,68262,68264,0,2,1
19558,6,3,68268,68268,68271,0,3,4
19559,6,3,68274,68274,68277,0,3,3
19560,5,3,68279,68279,68282,0,3,2
19561,5,2,68284,68284,68286,0,2,2
19562,6,2,68290,68290,68292,0,2,4
19563,1,1,68291,68292,68293,1,2,0
19564,1,2,68292,68293,68295,1,3,0
19565,1,3,68293,68295,68298,2,5,0
19566,5,3,68298,68298,68301,0,3,0
19567,2,1,68300,68301,68302,1,2,0
19568,6,2,68306,68306,68308,0,2,4
19569,5,1,68311,68311,68312,0,1,3
19570,3,2,68314,68314,68316,0,2,2
19571,2,2,68316,68316,68318,0,2,0
19572,6,3,68322,68322,68325,0,3,4
19573,4,1,68326,68326,68327,0,1,1
19574,6,3,68332,68332,68335,0,3,5
19575,1,2,68333,68335,68337,2,4,0
19576,6,1,68339,68339,68340,0,1,2
19577,4,3,68343,68343,68346,0,3,3
19578,3,2,68346,68346,68348,0,2,0
19579,6,1,68352,68352,68353,0,1,4
19580,6,1,68358,68358,68359,0,1,5
19581,1,2,68359,68359,68361,0,2,0
19582,2,2,68361,68361,68363,0,2,0
19583,6,2,68367,68367,68369,0,2,4
19584,4,1,68371,68371,68372,0,1,2
19585,6,1,68377,68377,68378,0,1,5
19586,6,1,68383,68383,68384,0,1,5
19587,3,1,68386,68386,68387,0,1,2
19588,4,2,68390,68390,68392,0,2,3
19589,5,3,68395,68395,68398,0,3,3
19590,3,1,68398,68398,68399,0,1,0
19591,4,1,68402,68402,68403,0,1,3
19592,3,3,68405,68405,68408,0,3,2
19593,6,3,68411,68411,68414,0,3,3
19594,3,1,68414,68414,68415,0,1,0
19595,1,3,68415,68415,68418,0,3,0
19596,5,1,68420,68420,68421,0,1,2
19597,5,1,68425,68425,68426,0,1,4
19598,4,3,68429,68429,68432,0,3,3
19599,6,3,68435,68435,68438,0,3,3
19600,6,1,68441,68441,68442,0,1,3
19601,5,3,68446,68446,68449,0,3,4
19602,2,3,68448,68449,68452,1,4,0
19603,4,1,68452,68452,68453,0,1,0
19604,1,1,68453,68453,68454,0,1,0
19605,5,2,68458,68458,68460,0,2,4
19606,3,1,68461,68461,68462,0,1,1
19607,1,3,68462,68462,68465,0,3,0
19608,6,2,68468,68468,68470,0,2,3
19609,1,1,68469,68470,68471,1,2,0
19610,6,1,68475,68475,68476,0,1,4
19611,6,2,68481,68481,68483,0,2,5
19612,3,3,68484,68484,68487,0,3,1
19613,3,2,68487,68487,68489,0,2,0
19614,5,1,68492,68492,68493,0,1,3
19615,1,2,68493,68493,68495,0,2,0
19616,1,2,68494,68495,68497,1,3,0
19617,4,2,68498,68498,68500,0,2,1
19618,4,1,68502,68502,68503,0,1,2
19619,6,1,68508,68508,68509,0,1,5
19620,6,2,68514,68514,68516,0,2,5
19621,5,1,68519,68519,68520,0,1,3
19622,3,3,68522,68522,68525,0,3,2
19623,1,1,68523,68525,68526,2,3,0
19624,3,2,68526,68526,68528,0,2,0
19625,4,1,68530,68530,68531,0,1,2
19626,4,2,68534,68534,68536,0,2,3
19627,6,2,68540,68540,68542,0,2,4
19628,2,1,68542,68542,68543,0,1,0
19629,3,3,68545,68545,68548,0,3,2
19630,3,2,68548,68548,68550,0,2,0
19631,3,2,68551,68551,68553,0,2,1
19632,2,2,68553,68553,68555,0,2,0
19633,2,1,68555,68555,68556,0,1,0
19634,6,1,68561,68561,68562,0,1,5
19635,2,1,68563,68563,68564,0,1,1
19636,1,3,68564,68564,68567,0,3,0
19637,3,2,68567,68567,68569,0,2,0
19638,5,1,68572,68572,68573,0,1,3
19639,2,1,68574,68574,68575,0,1,1
19640,1,3,68575,68575,68578,0,3,0
19641,5,3,68580,68580,68583,0,3,2
19642,3,3,68583,68583,68586,0,3,0
19643,5,3,68588,68588,68591,0,3,2
19644,6,3,68594,68594,68597,0,3,3
19645,4,3,68598,68598,68601,0,3,1
19646,1,1,68599,68601,68602,2,3,0
19647,5,2,68604,68604,68606,0,2,2
19648,3,1,68607,68607,68608,0,1,1
19649,4,1,68611,68611,68612,0,1,3
19650,6,1,68617,68617,68618,0,1,5
19651,2,1,68619,68619,68620,0,1,1
19652,3,3,68622,68622,68625,0,3,2
19653,5,2,68627,68627,68629,0,2,2
19654,2,1,68629,68629,68630,0,1,0
19655,3,1,68632,68632,68633,0,1,2
19656,4,3,68636,68636,68639,0,3,3
19657,5,3,68641,68641,68644,0,3,2
19658,2,1,68643,68644,68645,1,2,0
19659,5,1,68648,68648,68649,0,1,3
19660,5,3,68653,68653,68656,0,3,4
19661,4,1,68657,68657,68658,0,1,1
19662,4,3,68661,68661,68664,0,3,3
19663,1,3,68662,68664,68667,2,5,0
19664,5,1,68667,68667,68668,0,1,0
19665,5,1,68672,68672,68673,0,1,4
19666,2,1,68674,68674,68675,0,1,1
19667,4,2,68678,68678,68680,0,2,3
19668,3,1,68681,68681,68682,0,1,1
19669,3,1,68684,68684,68685,0,1,2
19670,2,3,68686,68686,68689,0,3,1
19671,5,3,68691,68691,68694,0,3,2
19672,1,2,68692,68694,68696,2,4,0
19673,5,1,68697,68697,68698,0,1,1
19674,4,2,68701,68701,68703,0,2,3
19675,6,3,68707,68707,68710,0,3,4
19676,3,1,68710,68710,68711,0,1,0
19677,2,1,68712,68712,68713,0,1,1
19678,1,3,68713,68713,68716,0,3,0
19679,6,3,68719,68719,68722,0,3,3
19680,4,1,68723,68723,68724,0,1,1
19681,6,3,68729,68729,68732,0,3,5
19682,4,2,68733,68733,68735,0,2,1
19683,1,3,68734,68735,68738,1,4,0
19684,4,2,68738,68738,68740,0,2,0
19685,5,1,68743,68743,68744,0,1,3
19686,6,2,68749,68749,68751,0,2,5
19687,3,2,68752,68752,68754,0,2,1
19688,6,2,68758,68758,68760,0,2,4
19689,3,1,68761,68761,68762,0,1,1
19690,6,1,68767,68767,68768,0,1,5
19691,4,2,68771,68771,68773,0,2,3
19692,2,2,68773,68773,68775,0,2,0
19693,3,1,68776,68776,68777,0,1,1
19694,2,1,68778,68778,68779,0,1,1
19695,5,2,68783,68783,68785,0,2,4
19696,6,3,68789,68789,68792,0,3,4
19697,2,3,68791,68792,68795,1,4,0
19698,4,1,68795,68795,68796,0,1,0
19699,1,3,68796,68796,68799,0,3,0
19700,5,2,68801,68801,68803,0,2,2
19701,6,1,68807,68807,68808,0,1,4
19702,6,2,68813,68813,68815,0,2,5
19703,6,2,68819,68819,68821,0,2,4
19704,5,1,68824,68824,68825,0,1,3
19705,4,1,68828,68828,68829,0,1,3
19706,6,2,68834,68834,68836,0,2,5
19707,5,3,68839,68839,68842,0,3,3
19708,6,2,68845,68845,68847,0,2,3
19709,3,3,68848,68848,68851,0,3,1
19710,1,3,68849,68851,68854,2,5,0
19711,6,3,68855,68855,68858,0,3,1
19712,6,3,68861,68861,68864,0,3,3
19713,3,1,68864,68864,68865,0,1,0
19714,2,2,68866,68866,68868,0,2,1
19715,6,3,68872,68872,68875,0,3,4
19716,1,1,68873,68875,68876,2,3,0
19717,6,2,68879,68879,68881,0,2,3
19718,5,2,68884,68884,68886,0,2,3
19719,5,3,68889,68889,68892,0,3,3
19720,2,3,68891,68892,68895,1,4,0
19721,2,2,68893,68895,68897,2,4,0
19722,3,1,68896,68897,68898,1,2,0
19723,4,2,68900,68900,68902,0,2,2
19724,4,1,68904,68904,68905,0,1,2
19725,5,1,68909,68909,68910,0,1,4
19726,3,1,68912,68912,68913,0,1,2
19727,3,2,68915,68915,68917,0,2,2
19728,3,3,68918,68918,68921,0,3,1
19729,6,2,68924,68924,68926,0,2,3
19730,3,2,68927,68927,68929,0,2,1
19731,3,2,68930,68930,68932,0,2,1
19732,5,1,68935,68935,68936,0,1,3
19733,3,1,68938,68938,68939,0,1,2
19734,2,3,68940,68940,68943,0,3,1
19735,3,1,68943,68943,68944,0,1,0
19736,6,1,68949,68949,68950,0,1,5
19737,3,1,68952,68952,68953,0,1,2
19738,3,1,68955,68955,68956,0,1,2
19739,2,1,68957,68957,68958,0,1,1
19740,3,2,68960,68960,68962,0,2,2
19741,1,3,68961,68962,68965,1,4,0
19742,6,3,68967,68967,68970,0,3,2
19743,3,3,68970,68970,68973,0,3,0
19744,5,2,68975,68975,68977,0,2,2
19745,6,2,68981,68981,68983,0,2,4
19746,3,3,68984,68984,68987,0,3,1
19747,6,1,68990,68990,68991,0,1,3
19748,6,1,68996,68996,68997,0,1,5
19749,1,1,68997,68997,68998,0,1,0
19750,4,2,69001,69001,69003,0,2,3
19751,2,2,69003,69003,69005,0,2,0
19752,2,1,69005,69005,69006,0,1,0
19753,4,1,69009,69009,69010,0,1,3
19754,4,2,69013,69013,69015,0,2,3
19755,6,2,69019,69019,69021,0,2,4
19756,5,3,69024,69024,69027,0,3,3
19757,2,2,69026,69027,69029,1,3,0
19758,5,3,69031,69031,69034,0,3,2
19759,6,2,69037,69037,69039,0,2,3
19760,4,3,69041,69041,69044,0,3,2
19761,4,1,69045,69045,69046,0,1,1
19762,1,2,69046,69046,69048,0,2,0
19763,3,1,69049,69049,69050,0,1,1
19764,6,1,69055,69055,69056,0,1,5
19765,1,3,69056,69056,69059,0,3,0
19766,2,3,69058,69059,69062,1,4,0
19767,2,1,69060,69062,69063,2,3,0
19768,5,3,69065,69065,69068,0,3,2
19769,3,2,69068,69068,69070,0,2,0
19770,3,2,69071,69071,69073,0,2,1
19771,5,3,69076,69076,69079,0,3,3
19772,4,3,69080,69080,69083,0,3,1
19773,2,3,69082,69083,69086,1,4,0
19774,6,3,69088,69088,69091,0,3,2
19775,6,2,69094,69094,69096,0,2,3
19776,3,1,69097,69097,69098,0,1,1
19777,5,1,69102,69102,69103,0,1,4
19778,2,3,69104,69104,69107,0,3,1
19779,6,2,69110,69110,69112,0,2,3
19780,4,1,69114,69114,69115,0,1,2
19781,2,1,69116,69116,69117,0,1,1
19782,5,1,69121,69121,69122,0,1,4
19783,4,3,69125,69125,69128,0,3,3
19784,5,3,69130,69130,69133,0,3,2
19785,2,2,69132,69133,69135,1,3,0
19786,2,3,69134,69135,69138,1,4,0
19787,3,1,69137,69138,69139,1,2,0
19788,6,2,69143,69143,69145,0,2,4
19789,3,2,69146,69146,69148,0,2,1
19790,2,2,69148,69148,69150,0,2,0
19791,1,2,69149,69150,69152,1,3,0
19792,4,3,69153,69153,69156,0,3,1
19793,4,3,69157,69157,69160,0,3,1
19794,5,1,69162,69162,69163,0,1,2
19795,6,2,69168,69168,69170,0,2,5
19796,5,1,69173,69173,69174,0,1,3
19797,3,2,69176,69176,69178,0,2,2
19798,2,3,69178,69178,69181,0,3,0
19799,1,3,69179,69181,69184,2,5,0
19800,1,1,69180,69184,69185,4,5,0
19801,2,3,69182,69185,69188,3,6,0
19802,4,2,69186,69188,69190,2,4,0
19803,3,2,69189,69190,69192,1,3,0
19804,3,2,69192,69192,69194,0,2,0
19805,3,2,69195,69195,69197,0,2,1
19806,1,1,69196,69197,69198,1,2,0
19807,4,2,69200,69200,69202,0,2,2
19808,4,2,69204,69204,69206,0,2,2
19809,5,2,69209,69209,69211,0,2,3
19810,3,3,69212,69212,69215,0,3,1
19811,3,2,69215,69215,69217,0,2,0
19812,4,1,69219,69219,69220,0,1,2
19813,5,2,69224,69224,69226,0,2,4
19814,5,2,69229,69229,69231,0,2,3
19815,1,3,69230,69231,69234,1,4,0
19816,3,2,69233,69234,69236,1,3,0
19817,2,2,69235,69236,69238,1,3,0
19818,1,2,69236,69238,69240,2,4,0
19819,2,2,69238,69240,69242,2,4,0
19820,3,2,69241,69242,69244,1,3,0
19821,6,2,69247,69247,69249,0,2,3
19822,2,1,69249,69249,69250,0,1,0
19823,2,2,69251,69251,69253,0,2,1
19824,5,3,69256,69256,69259,0,3,3
19825,4,3,69260,69260,69263,0,3,1
19826,1,3,69261,69263,69266,2,5,0
19827,4,2,69265,69266,69268,1,3,0
19828,2,1,69267,69268,69269,1,2,0
19829,1,1,69268,69269,69270,1,2,0
19830,6,1,69274,69274,69275,0,1,4
19831,5,1,69279,69279,69280,0,1,4
19832,2,3,69281,69281,69284,0,3,1
19833,1,3,69282,69284,69287,2,5,0
19834,1,3,69283,69287,69290,4,7,0
19835,2,3,69285,69290,69293,5,8,0
19836,3,2,69288,69293,69295,5,7,0
19837,5,3,69293,69295,69298,2,5,0
19838,1,1,69294,69298,69299,4,5,0
19839,3,2,69297,69299,69301,2,4,0
19840,6,3,69303,69303,69306,0,3,2
19841,5,1,69308,69308,69309,0,1,2
19842,3,3,69311,69311,69314,0,3,2
19843,5,1,69316,69316,69317,0,1,2
19844,6,1,69322,69322,69323,0,1,5
19845,1,1,69323,69323,69324,0,1,0
19846,3,3,69326,69326,69329,0,3,2
19847,1,3,69327,69329,69332,2,5,0
19848,2,3,69329,69332,69335,3,6,0
19849,5,2,69334,69335,69337,1,3,0
19850,2,3,69336,69337,69340,1,4,0
19851,5,1,69341,69341,69342,0,1,1
19852,4,3,69345,69345,69348,0,3,3
19853,2,2,69347,69348,69350,1,3,0
19854,2,3,69349,69350,69353,1,4,0
19855,5,1,69354,69354,69355,0,1,1
19856,5,3,69359,69359,69362,0,3,4
19857,5,3,69364,69364,69367,0,3,2
19858,5,1,69369,69369,69370,0,1,2
19859,2,3,69371,69371,69374,0,3,1
19860,4,3,69375,69375,69378,0,3,1
19861,2,1,69377,69378,69379,1,2,0
19862,1,1,69378,69379,69380,1,2,0
19863,2,3,69380,69380,69383,0,3,0
19864,6,1,69386,69386,69387,0,1,3
19865,5,3,69391,69391,69394,0,3,4
19866,5,2,69396,69396,69398,0,2,2
19867,4,1,69400,69400,69401,0,1,2
19868,4,3,69404,69404,69407,0,3,3
19869,1,2,69405,69407,69409,2,4,0
19870,1,3,69406,69409,69412,3,6,0
19871,3,3,69409,69412,69415,3,6,0
19872,3,3,69412,69415,69418,3,6,0
19873,2,2,69414,69418,69420,4,6,0
19874,4,1,69418,69420,69421,2,3,0
19875,6,1,69424,69424,69425,0,1,3
19876,5,1,69429,69429,69430,0,1,4
19877,3,1,69432,69432,69433,0,1,2
19878,3,1,69435,69435,69436,0,1,2
19879,4,3,69439,69439,69442,0,3,3
19880,3,2,69442,69442,69444,0,2,0
19881,1,2,69443,69444,69446,1,3,0
19882,2,3,69445,69446,69449,1,4,0
19883,3,1,69448,69449,69450,1,2,0
19884,2,2,69450,69450,69452,0,2,0
19885,6,1,69456,69456,69457,0,1,4
19886,4,1,69460,69460,69461,0,1,3
19887,4,1,69464,69464,69465,0,1,3
19888,5,2,69469,69469,69471,0,2,4
19889,6,2,69475,69475,69477,0,2,4
19890,3,3,69478,69478,69481,0,3,1
19891,2,2,69480,69481,69483,1,3,0
19892,5,3,69485,69485,69488,0,3,2
19893,2,2,69487,69488,69490,1,3,0
19894,2,2,69489,69490,69492,1,3,0
19895,6,2,69495,69495,69497,0,2,3
19896,5,2,69500,69500,69502,0,2,3
19897,3,3,69503,69503,69506,0,3,1
19898,1,2,69504,69506,69508,2,4,0
19899,5,2,69509,69509,69511,0,2,1
19900,6,2,69515,69515,69517,0,2,4
19901,1,2,69516,69517,69519,1,3,0
19902,1,1,69517,69519,69520,2,3,0
19903,4,3,69521,69521,69524,0,3,1
19904,2,2,69523,69524,69526,1,3,0
19905,4,2,69527,69527,69529,0,2,1
19906,1,2,69528,69529,69531,1,3,0
19907,6,1,69534,69534,69535,0,1,3
19908,4,2,69538,69538,69540,0,2,3
19909,3,3,69541,69541,69544,0,3,1
19910,4,3,69545,69545,69548,0,3,1
19911,3,1,69548,69548,69549,0,1,0
19912,6,3,69554,69554,69557,0,3,5
19913,4,2,69558,69558,69560,0,2,1
19914,6,1,69564,69564,69565,0,1,4
19915,2,2,69566,69566,69568,0,2,1
19916,4,1,69570,69570,69571,0,1,2
19917,2,1,69572,69572,69573,0,1,1
19918,6,3,69578,69578,69581,0,3,5
19919,1,3,69579,69581,69584,2,5,0
19920,1,2,69580,69584,69586,4,6,0
19921,4,1,69584,69586,69587,2,3,0
19922,3,1,69587,69587,69588,0,1,0
19923,4,2,69591,69591,69593,0,2,3
19924,4,2,69595,69595,69597,0,2,2
19925,3,3,69598,69598,69601,0,3,1
19926,2,2,69600,69601,69603,1,3,0
19927,6,1,69606,69606,69607,0,1,3
19928,3,3,69609,69609,69612,0,3,2
19929,3,3,69612,69612,69615,0,3,0
19930,5,1,69617,69617,69618,0,1,2
19931,3,1,69620,69620,69621,0,1,2
19932,2,3,69622,69622,69625,0,3,1
19933,4,2,69626,69626,69628,0,2,1
19934,5,2,69631,69631,69633,0,2,3
19935,1,2,69632,69633,69635,1,3,0
19936,6,1,69638,69638,69639,0,1,3
19937,3,1,69641,69641,69642,0,1,2
19938,6,1,69647,69647,69648,0,1,5
19939,5,3,69652,69652,69655,0,3,4
19940,2,1,69654,69655,69656,1,2,0
19941,1,3,69655,69656,69659,1,4,0
19942,3,3,69658,69659,69662,1,4,0
19943,6,2,69664,69664,69666,0,2,2
19944,6,2,69670,69670,69672,0,2,4
19945,4,3,69674,69674,69677,0,3,2
19946,3,3,69677,69677,69680,0,3,0
19947,3,2,69680,69680,69682,0,2,0
19948,2,3,69682,69682,69685,0,3,0
19949,6,3,69688,69688,69691,0,3,3
19950,3,1,69691,69691,69692,0,1,0
19951,2,2,69693,69693,69695,0,2,1
19952,5,1,69698,69698,69699,0,1,3
19953,2,1,69700,69700,69701,0,1,1
19954,4,3,69704,69704,69707,0,3,3
19955,3,2,69707,69707,69709,0,2,0
19956,5,1,69712,69712,69713,0,1,3
19957,4,2,69716,69716,69718,0,2,3
19958,4,3,69720,69720,69723,0,3,2
19959,5,1,69725,69725,69726,0,1,2
19960,3,1,69728,69728,69729,0,1,2
19961,2,3,69730,69730,69733,0,3,1
19962,2,2,69732,69733,69735,1,3,0
19963,3,3,69735,69735,69738,0,3,0
19964,3,3,69738,69738,69741,0,3,0
19965,4,1,69742,69742,69743,0,1,1
19966,5,1,69747,69747,69748,0,1,4
19967,1,2,69748,69748,69750,0,2,0
19968,1,1,69749,69750,69751,1,2,0
19969,3,1,69752,69752,69753,0,1,1
19970,4,3,69756,69756,69759,0,3,3
19971,5,3,69761,69761,69764,0,3,2
19972,1,1,69762,69764,69765,2,3,0
19973,1,3,69763,69765,69768,2,5,0
19974,6,1,69769,69769,69770,0,1,1
19975,3,2,69772,69772,69774,0,2,2
19976,3,2,69775,69775,69777,0,2,1
19977,6,1,69781,69781,69782,0,1,4
19978,5,3,69786,69786,69789,0,3,4
19979,4,3,69790,69790,69793,0,3,1
19980,5,2,69795,69795,69797,0,2,2
19981,1,1,69796,69797,69798,1,2,0
19982,4,1,69800,69800,69801,0,1,2
19983,3,1,69803,69803,69804,0,1,2
19984,4,2,69807,69807,69809,0,2,3
19985,4,3,69811,69811,69814,0,3,2
19986,4,1,69815,69815,69816,0,1,1
19987,5,3,69820,69820,69823,0,3,4
19988,2,2,69822,69823,69825,1,3,0
19989,4,1,69826,69826,69827,0,1,1
19990,3,2,69829,69829,69831,0,2,2
19991,1,1,69830,69831,69832,1,2,0
19992,2,3,69832,69832,69835,0,3,0
19993,2,3,69834,69835,69838,1,4,0
19994,3,1,69837,69838,69839,1,2,0
19995,4,2,69841,69841,69843,0,2,2
19996,5,3,69846,69846,69849,0,3,3
19997,2,2,69848,69849,69851,1,3,0
19998,5,1,69853,69853,69854,0,1,2
19999,1,2,69854,69854,69856,0,2,0
20000,2,3,69856,69856,69859,0,3,0
20001,4,2,69860,69860,69862,0,2,1
20002,5,3,69865,69865,69868,0,3,3
20003,3,2,69868,69868,69870,0,2,0
20004,3,3,69871,69871,69874,0,3,1
20005,5,3,69876,69876,69879,0,3,2
20006,3,2,69879,69879,69881,0,2,0
20007,1,2,69880,69881,69883,1,3,0
20008,6,3,69886,69886,69889,0,3,3
20009,4,2,69890,69890,69892,0,2,1
20010,3,3,69893,69893,69896,0,3,1
20011,2,3,69895,69896,69899,1,4,0
20012,3,2,69898,69899,69901,1,3,0
20013,6,3,69904,69904,69907,0,3,3
20014,6,3,69910,69910,69913,0,3,3
20015,1,3,69911,69913,69916,2,5,0
20016,6,3,69917,69917,69920,0,3,1
20017,5,2,69922,69922,69924,0,2,2
20018,4,1,69926,69926,69927,0,1,2
20019,3,2,69929,69929,69931,0,2,2
20020,5,2,69934,69934,69936,0,2,3
20021,5,2,69939,69939,69941,0,2,3
20022,1,3,69940,69941,69944,1,4,0
20023,1,3,69941,69944,69947,3,6,0
20024,2,3,69943,69947,69950,4,7,0
20025,1,2,69944,69950,69952,6,8,0
20026,4,2,69948,69952,69954,4,6,0
20027,6,1,69954,69954,69955,0,1,0
20028,3,2,69957,69957,69959,0,2,2
20029,4,3,69961,69961,69964,0,3,2
20030,2,2,69963,69964,69966,1,3,0
20031,2,3,69965,69966,69969,1,4,0
20032,4,1,69969,69969,69970,0,1,0
20033,3,1,69972,69972,69973,0,1,2
20034,1,1,69973,69973,69974,0,1,0
20035,5,1,69978,69978,69979,0,1,4
20036,3,3,69981,69981,69984,0,3,2
20037,3,1,69984,69984,69985,0,1,0
20038,2,2,69986,69986,69988,0,2,1
20039,5,3,69991,69991,69994,0,3,3
20040,6,1,69997,69997,69998,0,1,3
20041,2,2,69999,69999,70001,0,2,1
20042,1,3,70000,70001,70004,1,4,0
20043,2,2,70002,70004,70006,2,4,0
20044,4,2,70006,70006,70008,0,2,0
20045,1,2,70007,70008,70010,1,3,0
20046,3,3,70010,70010,70013,0,3,0
20047,4,2,70014,70014,70016,0,2,1
20048,6,2,70020,70020,70022,0,2,4
20049,5,1,70025,70025,70026,0,1,3
20050,6,2,70031,70031,70033,0,2,5
20051,5,1,70036,70036,70037,0,1,3
20052,6,2,70042,70042,70044,0,2,5
20053,1,2,70043,70044,70046,1,3,0
20054,4,2,70047,70047,70049,0,2,1
20055,2,3,70049,70049,70052,0,3,0
20056,3,1,70052,70052,70053,0,1,0
20057,1,1,70053,70053,70054,0,1,0
20058,3,3,70056,70056,70059,0,3,2
20059,6,3,70062,70062,70065,0,3,3
20060,6,2,70068,70068,70070,0,2,3
20061,4,2,70072,70072,70074,0,2,2
20062,6,2,70078,70078,70080,0,2,4
20063,4,1,70082,70082,70083,0,1,2
20064,3,1,70085,70085,70086,0,1,2
20065,3,3,70088,70088,70091,0,3,2
20066,2,1,70090,70091,70092,1,2,0
20067,1,3,70091,70092,70095,1,4,0
20068,6,3,70097,70097,70100,0,3,2
20069,2,1,70099,70100,70101,1,2,0
20070,3,2,70102,70102,70104,0,2,1
20071,6,2,70108,70108,70110,0,2,4
20072,5,1,70113,70113,70114,0,1,3
20073,4,1,70117,70117,70118,0,1,3
20074,1,3,70118,70118,70121,0,3,0
20075,4,3,70122,70122,70125,0,3,1
20076,6,3,70128,70128,70131,0,3,3
20077,3,1,70131,70131,70132,0,1,0
20078,2,2,70133,70133,70135,0,2,1
20079,5,3,70138,70138,70141,0,3,3
20080,4,2,70142,70142,70144,0,2,1
20081,2,2,70144,70144,70146,0,2,0
20082,1,1,70145,70146,70147,1,2,0
20083,3,1,70148,70148,70149,0,1,1
20084,5,3,70153,70153,70156,0,3,4
20085,3,2,70156,70156,70158,0,2,0
20086,5,2,70161,70161,70163,0,2,3
20087,6,2,70167,70167,70169,0,2,4
20088,2,2,70169,70169,70171,0,2,0
20089,6,2,70175,70175,70177,0,2,4
20090,5,2,70180,70180,70182,0,2,3
20091,1,1,70181,70182,70183,1,2,0
20092,4,2,70185,70185,70187,0,2,2
20093,1,3,70186,70187,70190,1,4,0
20094,4,2,70190,70190,70192,0,2,0
20095,5,3,70195,70195,70198,0,3,3
20096,6,3,70201,70201,70204,0,3,3
20097,1,3,70202,70204,70207,2,5,0
20098,6,1,70208,70208,70209,0,1,1
20099,5,1,70213,70213,70214,0,1,4
20100,5,2,70218,70218,70220,0,2,4
20101,3,1,70221,70221,70222,0,1,1
20102,6,1,70227,70227,70228,0,1,5
20103,4,2,70231,70231,70233,0,2,3
20104,4,3,70235,70235,70238,0,3,2
20105,2,2,70237,70238,70240,1,3,0
20106,4,1,70241,70241,70242,0,1,1
20107,2,3,70243,70243,70246,0,3,1
20108,5,2,70248,70248,70250,0,2,2
20109,6,3,70254,70254,70257,0,3,4
20110,6,1,70260,70260,70261,0,1,3
20111,1,3,70261,70261,70264,0,3,0
20112,4,1,70265,70265,70266,0,1,1
20113,1,3,70266,70266,70269,0,3,0
20114,2,2,70268,70269,70271,1,3,0
20115,3,2,70271,70271,70273,0,2,0
20116,2,1,70273,70273,70274,0,1,0
20117,5,1,70278,70278,70279,0,1,4
20118,4,1,70282,70282,70283,0,1,3
20119,3,2,70285,70285,70287,0,2,2
20120,1,2,70286,70287,70289,1,3,0
20121,3,1,70289,70289,70290,0,1,0
20122,6,1,70295,70295,70296,0,1,5
20123,2,3,70297,70297,70300,0,3,1
20124,2,1,70299,70300,70301,1,2,0
20125,2,2,70301,70301,70303,0,2,0
20126,6,1,70307,70307,70308,0,1,4
20127,5,2,70312,70312,70314,0,2,4
20128,6,2,70318,70318,70320,0,2,4
20129,2,3,70320,70320,70323,0,3,0
20130,2,3,70322,70323,70326,1,4,0
20131,5,3,70327,70327,70330,0,3,1
20132,1,3,70328,70330,70333,2,5,0
20133,5,3,70333,70333,70336,0,3,0
20134,2,1,70335,70336,70337,1,2,0
20135,6,1,70341,70341,70342,0,1,4
20136,5,1,70346,70346,70347,0,1,4
20137,6,2,70352,70352,70354,0,2,5
20138,5,1,70357,70357,70358,0,1,3
20139,5,2,70362,70362,70364,0,2,4
20140,1,1,70363,70364,70365,1,2,0
20141,2,2,70365,70365,70367,0,2,0
20142,4,1,70369,70369,70370,0,1,2
20143,3,1,70372,70372,70373,0,1,2
20144,5,2,70377,70377,70379,0,2,4
20145,4,3,70381,70381,70384,0,3,2
20146,3,1,70384,70384,70385,0,1,0
20147,1,1,70385,70385,70386,0,1,0
20148,1,3,70386,70386,70389,0,3,0
20149,2,1,70388,70389,70390,1,2,0
20150,1,2,70389,70390,70392,1,3,0
20151,1,2,70390,70392,70394,2,4,0
20152,1,1,70391,70394,70395,3,4,0
20153,4,1,70395,70395,70396,0,1,0
20154,6,3,70401,70401,70404,0,3,5
20155,1,1,70402,70404,70405,2,3,0
20156,3,1,70405,70405,70406,0,1,0
20157,4,2,70409,70409,70411,0,2,3
20158,5,1,70414,70414,70415,0,1,3
20159,2,1,70416,70416,70417,0,1,1
20160,4,1,70420,70420,70421,0,1,3
20161,3,2,70423,70423,70425,0,2,2
20162,6,3,70429,70429,70432,0,3,4
20163,6,3,70435,70435,70438,0,3,3
20164,4,2,70439,70439,70441,0,2,1
20165,2,3,70441,70441,70444,0,3,0
20166,5,1,70446,70446,70447,0,1,2
20167,6,3,70452,70452,70455,0,3,5
20168,2,2,70454,70455,70457,1,3,0
20169,1,1,70455,70457,70458,2,3,0
20170,1,3,70456,70458,70461,2,5,0
20171,1,2,70457,70461,70463,4,6,0
20172,4,3,70461,70463,70466,2,5,0
20173,5,2,70466,70466,70468,0,2,0
20174,1,1,70467,70468,70469,1,2,0
20175,2,1,70469,70469,70470,0,1,0
20176,6,2,70475,70475,70477,0,2,5
20177,1,1,70476,70477,70478,1,2,0
20178,2,2,70478,70478,70480,0,2,0
20179,1,3,70479,70480,70483,1,4,0
20180,5,1,70484,70484,70485,0,1,1
20181,6,3,70490,70490,70493,0,3,5
20182,4,3,70494,70494,70497,0,3,1
20183,6,3,70500,70500,70503,0,3,3
20184,2,2,70502,70503,70505,1,3,0
20185,1,3,70503,70505,70508,2,5,0
20186,5,1,70508,70508,70509,0,1,0
20187,3,1,70511,70511,70512,0,1,2
20188,2,3,70513,70513,70516,0,3,1
20189,4,2,70517,70517,70519,0,2,1
20190,1,2,70518,70519,70521,1,3,0
20191,1,2,70519,70521,70523,2,4,0
20192,3,3,70522,70523,70526,1,4,0
20193,2,3,70524,70526,70529,2,5,0
20194,2,2,70526,70529,70531,3,5,0
20195,4,3,70530,70531,70534,1,4,0
20196,5,1,70535,70535,70536,0,1,1
20197,3,3,70538,70538,70541,0,3,2
20198,1,1,70539,70541,70542,2,3,0
20199,2,2,70541,70542,70544,1,3,0
20200,1,3,70542,70544,70547,2,5,0
20201,5,2,70547,70547,70549,0,2,0
20202,5,1,70552,70552,70553,0,1,3
20203,4,3,70556,70556,70559,0,3,3
20204,4,1,70560,70560,70561,0,1,1
20205,4,2,70564,70564,70566,0,2,3
20206,2,2,70566,70566,70568,0,2,0
20207,2,3,70568,70568,70571,0,3,0
20208,3,2,70571,70571,70573,0,2,0
20209,3,3,70574,70574,70577,0,3,1
20210,3,1,70577,70577,70578,0,1,0
20211,5,1,70582,70582,70583,0,1,4
20212,3,1,70585,70585,70586,0,1,2
20213,6,3,70591,70591,70594,0,3,5
20214,3,2,70594,70594,70596,0,2,0
20215,6,2,70600,70600,70602,0,2,4
20216,1,2,70601,70602,70604,1,3,0
20217,2,1,70603,70604,70605,1,2,0
20218,1,2,70604,70605,70607,1,3,0
20219,6,3,70610,70610,70613,0,3,3
20220,2,2,70612,70613,70615,1,3,0
20221,3,1,70615,70615,70616,0,1,0
20222,2,3,70617,70617,70620,0,3,1
20223,6,3,70623,70623,70626,0,3,3
20224,3,1,70626,70626,70627,0,1,0
20225,1,3,70627,70627,70630,0,3,0
20226,1,2,70628,70630,70632,2,4,0
20227,3,2,70631,70632,70634,1,3,0
20228,3,2,70634,70634,70636,0,2,0
20229,6,3,70640,70640,70643,0,3,4
20230,1,3,70641,70643,70646,2,5,0
20231,1,1,70642,70646,70647,4,5,0
20232,4,1,70646,70647,70648,1,2,0
20233,4,1,70650,70650,70651,0,1,2
20234,5,3,70655,70655,70658,0,3,4
20235,4,1,70659,70659,70660,0,1,1
20236,3,2,70662,70662,70664,0,2,2
20237,3,3,70665,70665,70668,0,3,1
20238,3,2,70668,70668,70670,0,2,0
20239,1,3,70669,70670,70673,1,4,0
20240,4,3,70673,70673,70676,0,3,0
20241,4,3,70677,70677,70680,0,3,1
20242,5,3,70682,70682,70685,0,3,2
20243,6,3,70688,70688,70691,0,3,3
20244,4,3,70692,70692,70695,0,3,1
20245,6,2,70698,70698,70700,0,2,3
20246,2,3,70700,70700,70703,0,3,0
20247,1,2,70701,70703,70705,2,4,0
20248,6,1,70707,70707,70708,0,1,2
20249,1,2,70708,70708,70710,0,2,0
20250,5,3,70713,70713,70716,0,3,3
20251,3,2,70716,70716,70718,0,2,0
20252,1,2,70717,70718,70720,1,3,0
20253,5,1,70722,70722,70723,0,1,2
20254,1,2,70723,70723,70725,0,2,0
20255,3,2,70726,70726,70728,0,2,1
20256,5,1,70731,70731,70732,0,1,3
20257,1,3,70732,70732,70735,0,3,0
20258,2,3,70734,70735,70738,1,4,0
20259,6,1,70740,70740,70741,0,1,2
20260,5,2,70745,70745,70747,0,2,4
20261,2,1,70747,70747,70748,0,1,0
20262,6,3,70753,70753,70756,0,3,5
20263,6,3,70759,70759,70762,0,3,3
20264,1,3,70760,70762,70765,2,5,0
20265,5,2,70765,70765,70767,0,2,0
20266,2,3,70767,70767,70770,0,3,0
20267,6,3,70773,70773,70776,0,3,3
20268,3,2,70776,70776,70778,0,2,0
20269,1,3,70777,70778,70781,1,4,0
20270,2,1,70779,70781,70782,2,3,0
20271,2,1,70781,70782,70783,1,2,0
20272,3,1,70784,70784,70785,0,1,1
20273,5,2,70789,70789,70791,0,2,4
20274,3,1,70792,70792,70793,0,1,1
20275,4,2,70796,70796,70798,0,2,3
20276,6,1,70802,70802,70803,0,1,4
20277,4,3,70806,70806,70809,0,3,3
20278,4,2,70810,70810,70812,0,2,1
20279,1,2,70811,70812,70814,1,3,0
20280,2,1,70813,70814,70815,1,2,0
20281,6,2,70819,70819,70821,0,2,4
20282,1,3,70820,70821,70824,1,4,0
20283,3,3,70823,70824,70827,1,4,0
20284,5,2,70828,70828,70830,0,2,1
20285,6,2,70834,70834,70836,0,2,4
20286,1,1,70835,70836,70837,1,2,0
20287,3,1,70838,70838,70839,0,1,1
20288,3,1,70841,70841,70842,0,1,2
20289,6,3,70847,70847,70850,0,3,5
20290,2,2,70849,70850,70852,1,3,0
20291,5,2,70854,70854,70856,0,2,2
20292,5,3,70859,70859,70862,0,3,3
20293,5,3,70864,70864,70867,0,3,2
20294,5,3,70869,70869,70872,0,3,2
20295,6,1,70875,70875,70876,0,1,3
20296,3,3,70878,70878,70881,0,3,2
20297,1,3,70879,70881,70884,2,5,0
20298,5,1,70884,70884,70885,0,1,0
20299,1,2,70885,70885,70887,0,2,0
20300,4,2,70889,70889,70891,0,2,2
20301,1,1,70890,70891,70892,1,2,0
20302,6,2,70896,70896,70898,0,2,4
20303,3,2,70899,70899,70901,0,2,1
20304,6,2,70905,70905,70907,0,2,4
20305,5,1,70910,70910,70911,0,1,3
20306,4,3,70914,70914,70917,0,3,3
20307,1,3,70915,70917,70920,2,5,0
20308,5,3,70920,70920,70923,0,3,0
20309,5,2,70925,70925,70927,0,2,2
20310,2,3,70927,70927,70930,0,3,0
20311,1,2,70928,70930,70932,2,4,0
20312,2,1,70930,70932,70933,2,3,0
20313,5,2,70935,70935,70937,0,2,2
20314,4,3,70939,70939,70942,0,3,2
20315,5,1,70944,70944,70945,0,1,2
20316,1,2,70945,70945,70947,0,2,0
20317,3,2,70948,70948,70950,0,2,1
20318,6,3,70954,70954,70957,0,3,4
20319,5,2,70959,70959,70961,0,2,2
20320,5,1,70964,70964,70965,0,1,3
20321,2,3,70966,70966,70969,0,3,1
20322,6,2,70972,70972,70974,0,2,3
20323,3,1,70975,70975,70976,0,1,1
20324,3,2,70978,70978,70980,0,2,2
20325,6,1,70984,70984,70985,0,1,4
20326,5,3,70989,70989,70992,0,3,4
20327,1,1,70990,70992,70993,2,3,0
20328,5,3,70995,70995,70998,0,3,2
20329,4,3,70999,70999,71002,0,3,1
20330,1,2,71000,71002,71004,2,4,0
20331,1,1,71001,71004,71005,3,4,0
20332,6,2,71007,71007,71009,0,2,2
20333,5,3,71012,71012,71015,0,3,3
20334,3,3,71015,71015,71018,0,3,0
20335,1,2,71016,71018,71020,2,4,0
20336,5,3,71021,71021,71024,0,3,1
20337,1,3,71022,71024,71027,2,5,0
20338,4,2,71026,71027,71029,1,3,0
20339,4,1,71030,71030,71031,0,1,1
20340,1,3,71031,71031,71034,0,3,0
20341,3,3,71034,71034,71037,0,3,0
20342,5,3,71039,71039,71042,0,3,2
20343,6,3,71045,71045,71048,0,3,3
20344,3,3,71048,71048,71051,0,3,0
20345,4,3,71052,71052,71055,0,3,1
20346,1,1,71053,71055,71056,2,3,0
20347,2,3,71055,71056,71059,1,4,0
20348,3,1,71058,71059,71060,1,2,0
20349,2,1,71060,71060,71061,0,1,0
20350,1,1,71061,71061,71062,0,1,0
20351,5,2,71066,71066,71068,0,2,4
20352,3,1,71069,71069,71070,0,1,1
20353,1,1,71070,71070,71071,0,1,0
20354,3,2,71073,71073,71075,0,2,2
20355,1,3,71074,71075,71078,1,4,0
20356,6,2,71080,71080,71082,0,2,2
20357,2,2,71082,71082,71084,0,2,0
20358,5,1,71087,71087,71088,0,1,3
20359,3,2,71090,71090,71092,0,2,2
20360,5,1,71095,71095,71096,0,1,3
20361,4,1,71099,71099,71100,0,1,3
20362,4,2,71103,71103,71105,0,2,3
20363,2,1,71105,71105,71106,0,1,0
20364,5,1,71110,71110,71111,0,1,4
20365,1,1,71111,71111,71112,0,1,0
20366,4,2,71115,71115,71117,0,2,3
20367,3,2,71118,71118,71120,0,2,1
20368,2,1,71120,71120,71121,0,1,0
20369,4,1,71124,71124,71125,0,1,3
20370,1,1,71125,71125,71126,0,1,0
20371,6,2,71131,71131,71133,0,2,5
20372,5,1,71136,71136,71137,0,1,3
20373,5,3,71141,71141,71144,0,3,4
20374,2,3,71143,71144,71147,1,4,0
20375,4,2,71147,71147,71149,0,2,0
20376,6,1,71153,71153,71154,0,1,4
20377,4,3,71157,71157,71160,0,3,3
20378,1,3,71158,71160,71163,2,5,0
20379,6,1,71164,71164,71165,0,1,1
20380,3,3,71167,71167,71170,0,3,2
20381,5,1,71172,71172,71173,0,1,2
20382,6,2,71178,71178,71180,0,2,5
20383,6,1,71184,71184,71185,0,1,4
20384,5,3,71189,71189,71192,0,3,4
20385,1,3,71190,71192,71195,2,5,0
20386,5,2,71195,71195,71197,0,2,0
20387,2,3,71197,71197,71200,0,3,0
20388,3,3,71200,71200,71203,0,3,0
20389,6,2,71206,71206,71208,0,2,3
20390,6,3,71212,71212,71215,0,3,4
20391,4,3,71216,71216,71219,0,3,1
20392,2,3,71218,71219,71222,1,4,0
20393,4,2,71222,71222,71224,0,2,0
20394,6,1,71228,71228,71229,0,1,4
20395,5,1,71233,71233,71234,0,1,4
20396,1,3,71234,71234,71237,0,3,0
20397,2,3,71236,71237,71240,1,4,0
20398,1,1,71237,71240,71241,3,4,0
20399,6,2,71243,71243,71245,0,2,2
20400,3,2,71246,71246,71248,0,2,1
20401,3,3,71249,71249,71252,0,3,1
20402,4,2,71253,71253,71255,0,2,1
20403,6,3,71259,71259,71262,0,3,4
20404,2,3,71261,71262,71265,1,4,0
20405,3,3,71264,71265,71268,1,4,0
20406,4,3,71268,71268,71271,0,3,0
20407,4,2,71272,71272,71274,0,2,1
20408,6,1,71278,71278,71279,0,1,4
20409,2,3,71280,71280,71283,0,3,1
20410,4,1,71284,71284,71285,0,1,1
20411,4,1,71288,71288,71289,0,1,3
20412,4,2,71292,71292,71294,0,2,3
20413,4,1,71296,71296,71297,0,1,2
20414,2,2,71298,71298,71300,0,2,1
20415,3,3,71301,71301,71304,0,3,1
20416,3,3,71304,71304,71307,0,3,0
20417,5,2,71309,71309,71311,0,2,2
20418,4,1,71313,71313,71314,0,1,2
20419,1,2,71314,71314,71316,0,2,0
20420,2,3,71316,71316,71319,0,3,0
20421,3,2,71319,71319,71321,0,2,0
20422,2,3,71321,71321,71324,0,3,0
20423,2,2,71323,71324,71326,1,3,0
20424,5,3,71328,71328,71331,0,3,2
20425,1,1,71329,71331,71332,2,3,0
20426,2,2,71331,71332,71334,1,3,0
20427,1,2,71332,71334,71336,2,4,0
20428,4,3,71336,71336,71339,0,3,0
20429,1,1,71337,71339,71340,2,3,0
20430,1,3,71338,71340,71343,2,5,0
20431,6,1,71344,71344,71345,0,1,1
20432,5,3,71349,71349,71352,0,3,4
20433,5,1,71354,71354,71355,0,1,2
20434,6,3,71360,71360,71363,0,3,5
20435,1,2,71361,71363,71365,2,4,0
20436,3,2,71364,71365,71367,1,3,0
20437,5,2,71369,71369,71371,0,2,2
20438,3,2,71372,71372,71374,0,2,1
20439,5,3,71377,71377,71380,0,3,3
20440,6,3,71383,71383,71386,0,3,3
20441,2,1,71385,71386,71387,1,2,0
20442,2,1,71387,71387,71388,0,1,0
20443,1,2,71388,71388,71390,0,2,0
20444,5,3,71393,71393,71396,0,3,3
20445,2,1,71395,71396,71397,1,2,0
20446,3,1,71398,71398,71399,0,1,1
20447,5,3,71403,71403,71406,0,3,4
20448,4,2,71407,71407,71409,0,2,1
20449,6,2,71413,71413,71415,0,2,4
20450,6,1,71419,71419,71420,0,1,4
20451,3,1,71422,71422,71423,0,1,2
20452,4,1,71426,71426,71427,0,1,3
20453,6,1,71432,71432,71433,0,1,5
20454,5,1,71437,71437,71438,0,1,4
20455,3,1,71440,71440,71441,0,1,2
20456,5,2,71445,71445,71447,0,2,4
20457,6,2,71451,71451,71453,0,2,4
20458,5,1,71456,71456,71457,0,1,3
20459,4,3,71460,71460,71463,0,3,3
20460,3,2,71463,71463,71465,0,2,0
20461,4,2,71467,71467,71469,0,2,2
20462,3,1,71470,71470,71471,0,1,1
20463,4,3,71474,71474,71477,0,3,3
20464,1,3,71475,71477,71480,2,5,0
20465,3,1,71478,71480,71481,2,3,0
20466,1,3,71479,71481,71484,2,5,0
20467,4,2,71483,71484,71486,1,3,0
20468,3,2,71486,71486,71488,0,2,0
20469,6,2,71492,71492,71494,0,2,4
20470,1,1,71493,71494,71495,1,2,0
20471,4,1,71497,71497,71498,0,1,2
20472,3,3,71500,71500,71503,0,3,2
20473,3,2,71503,71503,71505,0,2,0
20474,6,2,71509,71509,71511,0,2,4
20475,1,3,71510,71511,71514,1,4,0
20476,1,2,71511,71514,71516,3,5,0
20477,1,1,71512,71516,71517,4,5,0
20478,3,1,71515,71517,71518,2,3,0
20479,3,3,71518,71518,71521,0,3,0
20480,5,1,71523,71523,71524,0,1,2
20481,6,3,71529,71529,71532,0,3,5
20482,1,2,71530,71532,71534,2,4,0
20483,4,3,71534,71534,71537,0,3,0
20484,4,1,71538,71538,71539,0,1,1
20485,4,1,71542,71542,71543,0,1,3
20486,3,3,71545,71545,71548,0,3,2
20487,1,3,71546,71548,71551,2,5,0
20488,1,2,71547,71551,71553,4,6,0
20489,6,2,71553,71553,71555,0,2,0
20490,3,3,71556,71556,71559,0,3,1
20491,4,1,71560,71560,71561,0,1,1
20492,1,3,71561,71561,71564,0,3,0
20493,6,2,71567,71567,71569,0,2,3
20494,2,2,71569,71569,71571,0,2,0
20495,6,2,71575,71575,71577,0,2,4
20496,6,3,71581,71581,71584,0,3,4
20497,1,1,71582,71584,71585,2,3,0
20498,6,1,71588,71588,71589,0,1,3
20499,5,3,71593,71593,71596,0,3,4
20500,1,1,71594,71596,71597,2,3,0
20501,1,1,71595,71597,71598,2,3,0
20502,4,1,71599,71599,71600,0,1,1
20503,3,1,71602,71602,71603,0,1,2
20504,2,3,71604,71604,71607,0,3,1
20505,1,3,71605,71607,71610,2,5,0
20506,6,1,71611,71611,71612,0,1,1
20507,6,1,71617,71617,71618,0,1,5
20508,5,1,71622,71622,71623,0,1,4
20509,4,1,71626,71626,71627,0,1,3
20510,1,1,71627,71627,71628,0,1,0
20511,2,3,71629,71629,71632,0,3,1
20512,2,3,71631,71632,71635,1,4,0
20513,2,2,71633,71635,71637,2,4,0
20514,4,2,71637,71637,71639,0,2,0
20515,3,2,71640,71640,71642,0,2,1
20516,6,2,71646,71646,71648,0,2,4
20517,4,2,71650,71650,71652,0,2,2
20518,3,3,71653,71653,71656,0,3,1
20519,3,3,71656,71656,71659,0,3,0
20520,2,1,71658,71659,71660,1,2,0
20521,2,1,71660,71660,71661,0,1,0
20522,3,3,71663,71663,71666,0,3,2
20523,1,1,71664,71666,71667,2,3,0
20524,6,1,71670,71670,71671,0,1,3
20525,2,1,71672,71672,71673,0,1,1
20526,6,2,71678,71678,71680,0,2,5
20527,4,2,71682,71682,71684,0,2,2
20528,3,2,71685,71685,71687,0,2,1
20529,3,2,71688,71688,71690,0,2,1
20530,1,1,71689,71690,71691,1,2,0
20531,5,3,71694,71694,71697,0,3,3
20532,6,2,71700,71700,71702,0,2,3
20533,4,3,71704,71704,71707,0,3,2
20534,3,3,71707,71707,71710,0,3,0
20535,6,3,71713,71713,71716,0,3,3
20536,3,1,71716,71716,71717,0,1,0
20537,6,1,71722,71722,71723,0,1,5
20538,4,2,71726,71726,71728,0,2,3
20539,1,2,71727,71728,71730,1,3,0
20540,3,2,71730,71730,71732,0,2,0
20541,5,1,71735,71735,71736,0,1,3
20542,6,1,71741,71741,71742,0,1,5
20543,3,3,71744,71744,71747,0,3,2
20544,1,2,71745,71747,71749,2,4,0
20545,1,1,71746,71749,71750,3,4,0
20546,5,2,71751,71751,71753,0,2,1
20547,6,1,71757,71757,71758,0,1,4
20548,6,2,71763,71763,71765,0,2,5
20549,1,1,71764,71765,71766,1,2,0
20550,3,3,71767,71767,71770,0,3,1
20551,1,2,71768,71770,71772,2,4,0
20552,6,1,71774,71774,71775,0,1,2
20553,6,3,71780,71780,71783,0,3,5
20554,1,3,71781,71783,71786,2,5,0
20555,4,2,71785,71786,71788,1,3,0
20556,4,3,71789,71789,71792,0,3,1
20557,4,3,71793,71793,71796,0,3,1
20558,2,2,71795,71796,71798,1,3,0
20559,6,3,71801,71801,71804,0,3,3
20560,2,1,71803,71804,71805,1,2,0
20561,2,3,71805,71805,71808,0,3,0
20562,6,3,71811,71811,71814,0,3,3
20563,2,1,71813,71814,71815,1,2,0
20564,3,2,71816,71816,71818,0,2,1
20565,1,3,71817,71818,71821,1,4,0
20566,4,2,71821,71821,71823,0,2,0
20567,2,1,71823,71823,71824,0,1,0
20568,4,2,71827,71827,71829,0,2,3
20569,3,3,71830,71830,71833,0,3,1
20570,3,2,71833,71833,71835,0,2,0
20571,4,1,71837,71837,71838,0,1,2
20572,1,2,71838,71838,71840,0,2,0
20573,1,3,71839,71840,71843,1,4,0
20574,5,2,71844,71844,71846,0,2,1
20575,1,1,71845,71846,71847,1,2,0
20576,5,3,71850,71850,71853,0,3,3
20577,6,2,71856,71856,71858,0,2,3
20578,6,3,71862,71862,71865,0,3,4
20579,1,3,71863,71865,71868,2,5,0
20580,2,1,71865,71868,71869,3,4,0
20581,4,3,71869,71869,71872,0,3,0
20582,4,1,71873,71873,71874,0,1,1
20583,2,3,71875,71875,71878,0,3,1
20584,5,2,71880,71880,71882,0,2,2
20585,3,2,71883,71883,71885,0,2,1
20586,6,3,71889,71889,71892,0,3,4
20587,6,3,71895,71895,71898,0,3,3
20588,5,2,71900,71900,71902,0,2,2
20589,2,3,71902,71902,71905,0,3,0
20590,5,2,71907,71907,71909,0,2,2
20591,2,2,71909,71909,71911,0,2,0
20592,1,2,71910,71911,71913,1,3,0
20593,6,2,71916,71916,71918,0,2,3
20594,1,3,71917,71918,71921,1,4,0
20595,2,2,71919,71921,71923,2,4,0
20596,2,3,71921,71923,71926,2,5,0
20597,3,2,71924,71926,71928,2,4,0
20598,6,3,71930,71930,71933,0,3,2
20599,2,2,71932,71933,71935,1,3,0
20600,4,3,71936,71936,71939,0,3,1
20601,6,1,71942,71942,71943,0,1,3
20602,4,1,71946,71946,71947,0,1,3
20603,1,3,71947,71947,71950,0,3,0
20604,6,2,71953,71953,71955,0,2,3
20605,2,1,71955,71955,71956,0,1,0
20606,3,1,71958,71958,71959,0,1,2
20607,4,3,71962,71962,71965,0,3,3
20608,1,3,71963,71965,71968,2,5,0
20609,3,3,71966,71968,71971,2,5,0
20610,1,1,71967,71971,71972,4,5,0
20611,6,2,71973,71973,71975,0,2,1
20612,4,1,71977,71977,71978,0,1,2
20613,4,2,71981,71981,71983,0,2,3
20614,2,1,71983,71983,71984,0,1,0
20615,5,2,71988,71988,71990,0,2,4
20616,5,1,71993,71993,71994,0,1,3
20617,5,1,71998,71998,71999,0,1,4
20618,4,2,72002,72002,72004,0,2,3
20619,1,2,72003,72004,72006,1,3,0
20620,3,3,72006,72006,72009,0,3,0
20621,2,1,72008,72009,72010,1,2,0
20622,1,3,72009,72010,72013,1,4,0
20623,4,3,72013,72013,72016,0,3,0
20624,3,1,72016,72016,72017,0,1,0
20625,6,1,72022,72022,72023,0,1,5
20626,5,2,72027,72027,72029,0,2,4
20627,1,1,72028,72029,72030,1,2,0
20628,2,3,72030,72030,72033,0,3,0
20629,3,1,72033,72033,72034,0,1,0
20630,2,2,72035,72035,72037,0,2,1
20631,1,1,72036,72037,72038,1,2,0
20632,5,1,72041,72041,72042,0,1,3
20633,5,3,72046,72046,72049,0,3,4
20634,5,3,72051,72051,72054,0,3,2
20635,1,3,72052,72054,72057,2,5,0
20636,5,3,72057,72057,72060,0,3,0
20637,2,2,72059,72060,72062,1,3,0
20638,1,1,72060,72062,72063,2,3,0
20639,3,2,72063,72063,72065,0,2,0
20640,5,1,72068,72068,72069,0,1,3
20641,2,2,72070,72070,72072,0,2,1
20642,2,1,72072,72072,72073,0,1,0
20643,1,3,72073,72073,72076,0,3,0
20644,1,1,72074,72076,72077,2,3,0
20645,5,1,72079,72079,72080,0,1,2
20646,5,2,72084,72084,72086,0,2,4
20647,3,2,72087,72087,72089,0,2,1
20648,2,2,72089,72089,72091,0,2,0
20649,4,2,72093,72093,72095,0,2,2
20650,6,2,72099,72099,72101,0,2,4
20651,5,2,72104,72104,72106,0,2,3
20652,4,1,72108,72108,72109,0,1,2
20653,3,3,72111,72111,72114,0,3,2
20654,2,3,72113,72114,72117,1,4,0
20655,6,2,72119,72119,72121,0,2,2
20656,4,2,72123,72123,72125,0,2,2
20657,4,1,72127,72127,72128,0,1,2
20658,3,1,72130,72130,72131,0,1,2
20659,6,1,72136,72136,72137,0,1,5
20660,5,2,72141,72141,72143,0,2,4
20661,5,2,72146,72146,72148,0,2,3
20662,1,3,72147,72148,72151,1,4,0
20663,6,1,72153,72153,72154,0,1,2
20664,2,3,72155,72155,72158,0,3,1
20665,3,1,72158,72158,72159,0,1,0
20666,2,3,72160,72160,72163,0,3,1
20667,2,3,72162,72163,72166,1,4,0
20668,5,1,72167,72167,72168,0,1,1
20669,2,1,72169,72169,72170,0,1,1
20670,2,1,72171,72171,72172,0,1,1
20671,5,3,72176,72176,72179,0,3,4
20672,1,3,72177,72179,72182,2,5,0
20673,2,3,72179,72182,72185,3,6,0
20674,4,3,72183,72185,72188,2,5,0
20675,5,3,72188,72188,72191,0,3,0
20676,1,2,72189,72191,72193,2,4,0
20677,6,3,72195,72195,72198,0,3,2
20678,5,3,72200,72200,72203,0,3,2
20679,1,2,72201,72203,72205,2,4,0
20680,6,3,72207,72207,72210,0,3,2
20681,4,2,72211,72211,72213,0,2,1
20682,1,3,72212,72213,72216,1,4,0
20683,4,2,72216,72216,72218,0,2,0
20684,5,1,72221,72221,72222,0,1,3
20685,6,3,72227,72227,72230,0,3,5
20686,4,3,72231,72231,72234,0,3,1
20687,6,2,72237,72237,72239,0,2,3
20688,5,3,72242,72242,72245,0,3,3
20689,2,2,72244,72245,72247,1,3,0
20690,6,2,72250,72250,72252,0,2,3
20691,2,1,72252,72252,72253,0,1,0
20692,6,3,72258,72258,72261,0,3,5
20693,6,1,72264,72264,72265,0,1,3
20694,4,3,72268,72268,72271,0,3,3
20695,6,1,72274,72274,72275,0,1,3
20696,3,3,72277,72277,72280,0,3,2
20697,6,3,72283,72283,72286,0,3,3
20698,4,1,72287,72287,72288,0,1,1
20699,2,2,72289,72289,72291,0,2,1
20700,4,1,72293,72293,72294,0,1,2
20701,3,3,72296,72296,72299,0,3,2
20702,2,3,72298,72299,72302,1,4,0
20703,6,3,72304,72304,72307,0,3,2
20704,1,3,72305,72307,72310,2,5,0
20705,6,2,72311,72311,72313,0,2,1
20706,4,1,72315,72315,72316,0,1,2
20707,5,1,72320,72320,72321,0,1,4
20708,6,2,72326,72326,72328,0,2,5
20709,6,2,72332,72332,72334,0,2,4
20710,3,1,72335,72335,72336,0,1,1
20711,5,1,72340,72340,72341,0,1,4
20712,2,2,72342,72342,72344,0,2,1
20713,4,3,72346,72346,72349,0,3,2
20714,3,3,72349,72349,72352,0,3,0
20715,3,2,72352,72352,72354,0,2,0
20716,2,1,72354,72354,72355,0,1,0
20717,5,1,72359,72359,72360,0,1,4
20718,1,2,72360,72360,72362,0,2,0
20719,2,2,72362,72362,72364,0,2,0
20720,6,3,72368,72368,72371,0,3,4
20721,1,3,72369,72371,72374,2,5,0
20722,4,1,72373,72374,72375,1,2,0
20723,6,1,72379,72379,72380,0,1,4
20724,6,2,72385,72385,72387,0,2,5
20725,3,3,72388,72388,72391,0,3,1
20726,6,3,72394,72394,72397,0,3,3
20727,2,2,72396,72397,72399,1,3,0
20728,4,3,72400,72400,72403,0,3,1
20729,4,2,72404,72404,72406,0,2,1
20730,2,3,72406,72406,72409,0,3,0
20731,5,2,72411,72411,72413,0,2,2
20732,2,3,72413,72413,72416,0,3,0
20733,2,3,72415,72416,72419,1,4,0
20734,6,3,72421,72421,72424,0,3,2
20735,1,3,72422,72424,72427,2,5,0
20736,5,3,72427,72427,72430,0,3,0
20737,5,3,72432,72432,72435,0,3,2
20738,6,2,72438,72438,72440,0,2,3
20739,6,3,72444,72444,72447,0,3,4
20740,2,2,72446,72447,72449,1,3,0
20741,6,2,72452,72452,72454,0,2,3
20742,5,2,72457,72457,72459,0,2,3
20743,5,1,72462,72462,72463,0,1,3
20744,3,3,72465,72465,72468,0,3,2
20745,5,2,72470,72470,72472,0,2,2
20746,6,3,72476,72476,72479,0,3,4
20747,5,1,72481,72481,72482,0,1,2
20748,5,1,72486,72486,72487,0,1,4
20749,1,3,72487,72487,72490,0,3,0
20750,3,1,72490,72490,72491,0,1,0
20751,5,3,72495,72495,72498,0,3,4
20752,6,2,72501,72501,72503,0,2,3
20753,1,1,72502,72503,72504,1,2,0
20754,6,2,72508,72508,72510,0,2,4
20755,4,3,72512,72512,72515,0,3,2
20756,6,2,72518,72518,72520,0,2,3
20757,3,3,72521,72521,72524,0,3,1
20758,1,3,72522,72524,72527,2,5,0
20759,3,3,72525,72527,72530,2,5,0
20760,3,3,72528,72530,72533,2,5,0
20761,1,3,72529,72533,72536,4,7,0
20762,6,3,72535,72536,72539,1,4,0
20763,4,1,72539,72539,72540,0,1,0
20764,3,2,72542,72542,72544,0,2,2
20765,5,2,72547,72547,72549,0,2,3
20766,4,2,72551,72551,72553,0,2,2
20767,3,3,72554,72554,72557,0,3,1
20768,1,1,72555,72557,72558,2,3,0
20769,1,2,72556,72558,72560,2,4,0
20770,6,2,72562,72562,72564,0,2,2
20771,3,1,72565,72565,72566,0,1,1
20772,1,2,72566,72566,72568,0,2,0
20773,3,1,72569,72569,72570,0,1,1
20774,6,3,72575,72575,72578,0,3,5
20775,1,3,72576,72578,72581,2,5,0
20776,3,1,72579,72581,72582,2,3,0
20777,2,2,72581,72582,72584,1,3,0
20778,4,1,72585,72585,72586,0,1,1
20779,1,2,72586,72586,72588,0,2,0
20780,4,3,72590,72590,72593,0,3,2
20781,1,1,72591,72593,72594,2,3,0
20782,2,3,72593,72594,72597,1,4,0
20783,2,1,72595,72597,72598,2,3,0
20784,5,3,72600,72600,72603,0,3,2
20785,4,3,72604,72604,72607,0,3,1
20786,3,3,72607,72607,72610,0,3,0
20787,3,1,72610,72610,72611,0,1,0
20788,5,3,72615,72615,72618,0,3,4
20789,1,3,72616,72618,72621,2,5,0
20790,5,2,72621,72621,72623,0,2,0
20791,3,1,72624,72624,72625,0,1,1
20792,3,3,72627,72627,72630,0,3,2
20793,4,3,72631,72631,72634,0,3,1
20794,1,3,72632,72634,72637,2,5,0
20795,2,1,72634,72637,72638,3,4,0
20796,6,1,72640,72640,72641,0,1,2
20797,6,2,72646,72646,72648,0,2,5
20798,6,2,72652,72652,72654,0,2,4
20799,6,1,72658,72658,72659,0,1,4
20800,5,3,72663,72663,72666,0,3,4
20801,1,3,72664,72666,72669,2,5,0
20802,1,1,72665,72669,72670,4,5,0
20803,6,2,72671,72671,72673,0,2,1
20804,6,1,72677,72677,72678,0,1,4
20805,4,2,72681,72681,72683,0,2,3
20806,3,1,72684,72684,72685,0,1,1
20807,1,1,72685,72685,72686,0,1,0
20808,6,3,72691,72691,72694,0,3,5
20809,6,2,72697,72697,72699,0,2,3
20810,5,2,72702,72702,72704,0,2,3
20811,4,1,72706,72706,72707,0,1,2
20812,1,1,72707,72707,72708,0,1,0
20813,2,3,72709,72709,72712,0,3,1
20814,5,2,72714,72714,72716,0,2,2
20815,2,3,72716,72716,72719,0,3,0
20816,2,3,72718,72719,72722,1,4,0
20817,5,1,72723,72723,72724,0,1,1
20818,4,3,72727,72727,72730,0,3,3
20819,1,2,72728,72730,72732,2,4,0
20820,5,2,72733,72733,72735,0,2,1
20821,6,1,72739,72739,72740,0,1,4
20822,2,3,72741,72741,72744,0,3,1
20823,4,3,72745,72745,72748,0,3,1
20824,6,1,72751,72751,72752,0,1,3
20825,2,1,72753,72753,72754,0,1,1
20826,4,1,72757,72757,72758,0,1,3
20827,6,2,72763,72763,72765,0,2,5
20828,4,1,72767,72767,72768,0,1,2
20829,5,2,72772,72772,72774,0,2,4
20830,3,2,72775,72775,72777,0,2,1
20831,2,1,72777,72777,72778,0,1,0
20832,4,1,72781,72781,72782,0,1,3
20833,1,3,72782,72782,72785,0,3,0
20834,3,3,72785,72785,72788,0,3,0
20835,2,3,72787,72788,72791,1,4,0
20836,1,2,72788,72791,72793,3,5,0
20837,4,3,72792,72793,72796,1,4,0
20838,4,3,72796,72796,72799,0,3,0
20839,1,3,72797,72799,72802,2,5,0
20840,5,2,72802,72802,72804,0,2,0
20841,6,3,72808,72808,72811,0,3,4
20842,6,3,72814,72814,72817,0,3,3
20843,5,2,72819,72819,72821,0,2,2
20844,4,1,72823,72823,72824,0,1,2
20845,4,2,72827,72827,72829,0,2,3
20846,2,1,72829,72829,72830,0,1,0
20847,6,3,72835,72835,72838,0,3,5
20848,3,2,72838,72838,72840,0,2,0
20849,5,2,72843,72843,72845,0,2,3
20850,1,3,72844,72845,72848,1,4,0
20851,5,2,72849,72849,72851,0,2,1
20852,3,2,72852,72852,72854,0,2,1
20853,5,3,72857,72857,72860,0,3,3
20854,3,1,72860,72860,72861,0,1,0
20855,6,2,72866,72866,72868,0,2,5
20856,6,2,72872,72872,72874,0,2,4
20857,2,2,72874,72874,72876,0,2,0
20858,2,1,72876,72876,72877,0,1,0
20859,6,3,72882,72882,72885,0,3,5
20860,6,2,72888,72888,72890,0,2,3
20861,5,2,72893,72893,72895,0,2,3
20862,2,3,72895,72895,72898,0,3,0
20863,5,1,72900,72900,72901,0,1,2
20864,4,1,72904,72904,72905,0,1,3
20865,1,1,72905,72905,72906,0,1,0
20866,3,1,72908,72908,72909,0,1,2
20867,6,1,72914,72914,72915,0,1,5
20868,6,3,72920,72920,72923,0,3,5
20869,5,2,72925,72925,72927,0,2,2
20870,2,2,72927,72927,72929,0,2,0
20871,5,3,72932,72932,72935,0,3,3
20872,5,3,72937,72937,72940,0,3,2
20873,3,1,72940,72940,72941,0,1,0
20874,1,1,72941,72941,72942,0,1,0
20875,2,1,72943,72943,72944,0,1,1
20876,5,1,72948,72948,72949,0,1,4
20877,6,3,72954,72954,72957,0,3,5
20878,2,1,72956,72957,72958,1,2,0
20879,2,1,72958,72958,72959,0,1,0
20880,5,1,72963,72963,72964,0,1,4
20881,2,3,72965,72965,72968,0,3,1
20882,3,2,72968,72968,72970,0,2,0
20883,5,2,72973,72973,72975,0,2,3
20884,1,1,72974,72975,72976,1,2,0
20885,4,1,72978,72978,72979,0,1,2
20886,6,3,72984,72984,72987,0,3,5
20887,2,3,72986,72987,72990,1,4,0
20888,3,1,72989,72990,72991,1,2,0
20889,5,3,72994,72994,72997,0,3,3
20890,2,2,72996,72997,72999,1,3,0
20891,3,2,72999,72999,73001,0,2,0
20892,2,3,73001,73001,73004,0,3,0
20893,3,2,73004,73004,73006,0,2,0
20894,4,1,73008,73008,73009,0,1,2
20895,6,1,73014,73014,73015,0,1,5
20896,6,1,73020,73020,73021,0,1,5
20897,3,1,73023,73023,73024,0,1,2
20898,3,1,73026,73026,73027,0,1,2
20899,6,3,73032,73032,73035,0,3,5
20900,4,3,73036,73036,73039,0,3,1
20901,5,1,73041,73041,73042,0,1,2
20902,3,3,73044,73044,73047,0,3,2
20903,2,3,73046,73047,73050,1,4,0
20904,6,1,73052,73052,73053,0,1,2
20905,4,2,73056,73056,73058,0,2,3
20906,2,3,73058,73058,73061,0,3,0
20907,6,3,73064,73064,73067,0,3,3
20908,1,1,73065,73067,73068,2,3,0
20909,4,2,73069,73069,73071,0,2,1
20910,5,2,73074,73074,73076,0,2,3
20911,5,2,73079,73079,73081,0,2,3
20912,6,3,73085,73085,73088,0,3,4
20913,1,3,73086,73088,73091,2,5,0
20914,4,1,73090,73091,73092,1,2,0
20915,5,3,73095,73095,73098,0,3,3
20916,5,1,73100,73100,73101,0,1,2
20917,5,3,73105,73105,73108,0,3,4
20918,2,2,73107,73108,73110,1,3,0
20919,2,1,73109,73110,73111,1,2,0
20920,3,1,73112,73112,73113,0,1,1
20921,3,2,73115,73115,73117,0,2,2
20922,6,2,73121,73121,73123,0,2,4
20923,1,1,73122,73123,73124,1,2,0
20924,3,1,73125,73125,73126,0,1,1
20925,6,2,73131,73131,73133,0,2,5
20926,1,3,73132,73133,73136,1,4,0
20927,6,3,73138,73138,73141,0,3,2
20928,2,2,73140,73141,73143,1,3,0
20929,5,3,73145,73145,73148,0,3,2
20930,1,1,73146,73148,73149,2,3,0
20931,6,2,73152,73152,73154,0,2,3
20932,3,1,73155,73155,73156,0,1,1
20933,1,3,73156,73156,73159,0,3,0
20934,3,3,73159,73159,73162,0,3,0
20935,1,2,73160,73162,73164,2,4,0
20936,6,3,73166,73166,73169,0,3,2
20937,1,3,73167,73169,73172,2,5,0
20938,2,3,73169,73172,73175,3,6,0
20939,1,2,73170,73175,73177,5,7,0
20940,4,2,73174,73177,73179,3,5,0
20941,5,2,73179,73179,73181,0,2,0
20942,1,1,73180,73181,73182,1,2,0
20943,5,2,73185,73185,73187,0,2,3
20944,6,2,73191,73191,73193,0,2,4
20945,6,2,73197,73197,73199,0,2,4
20946,5,1,73202,73202,73203,0,1,3
20947,3,2,73205,73205,73207,0,2,2
20948,1,2,73206,73207,73209,1,3,0
20949,3,3,73209,73209,73212,0,3,0
20950,5,2,73214,73214,73216,0,2,2
20951,5,3,73219,73219,73222,0,3,3
20952,5,1,73224,73224,73225,0,1,2
20953,1,2,73225,73225,73227,0,2,0
20954,2,2,73227,73227,73229,0,2,0
20955,1,1,73228,73229,73230,1,2,0
20956,6,2,73234,73234,73236,0,2,4
20957,1,3,73235,73236,73239,1,4,0
20958,1,2,73236,73239,73241,3,5,0
20959,4,3,73240,73241,73244,1,4,0
20960,6,3,73246,73246,73249,0,3,2
20961,3,3,73249,73249,73252,0,3,0
20962,5,3,73254,73254,73257,0,3,2
20963,6,3,73260,73260,73263,0,3,3
20964,4,2,73264,73264,73266,0,2,1
20965,3,3,73267,73267,73270,0,3,1
20966,1,2,73268,73270,73272,2,4,0
20967,3,1,73271,73272,73273,1,2,0
20968,2,1,73273,73273,73274,0,1,0
20969,2,2,73275,73275,73277,0,2,1
20970,1,3,73276,73277,73280,1,4,0
20971,1,1,73277,73280,73281,3,4,0
20972,1,2,73278,73281,73283,3,5,0
20973,6,1,73284,73284,73285,0,1,1
20974,3,1,73287,73287,73288,0,1,2
20975,5,1,73292,73292,73293,0,1,4
20976,4,2,73296,73296,73298,0,2,3
20977,2,1,73298,73298,73299,0,1,0
20978,5,2,73303,73303,73305,0,2,4
20979,5,2,73308,73308,73310,0,2,3
20980,6,3,73314,73314,73317,0,3,4
20981,6,1,73320,73320,73321,0,1,3
20982,6,1,73326,73326,73327,0,1,5
20983,5,3,73331,73331,73334,0,3,4
20984,4,1,73335,73335,73336,0,1,1
20985,1,3,73336,73336,73339,0,3,0
20986,6,1,73342,73342,73343,0,1,3
20987,5,2,73347,73347,73349,0,2,4
20988,3,1,73350,73350,73351,0,1,1
20989,3,3,73353,73353,73356,0,3,2
20990,3,3,73356,73356,73359,0,3,0
20991,3,1,73359,73359,73360,0,1,0
20992,4,2,73363,73363,73365,0,2,3
20993,3,2,73366,73366,73368,0,2,1
20994,3,3,73369,73369,73372,0,3,1
20995,3,2,73372,73372,73374,0,2,0
20996,5,2,73377,73377,73379,0,2,3
20997,4,2,73381,73381,73383,0,2,2
20998,3,1,73384,73384,73385,0,1,1
20999,3,3,73387,73387,73390,0,3,2
21000,2,2,73389,73390,73392,1,3,0
21001,5,1,73394,73394,73395,0,1,2
21002,4,2,73398,73398,73400,0,2,3
21003,2,3,73400,73400,73403,0,3,0
21004,5,2,73405,73405,73407,0,2,2
21005,1,2,73406,73407,73409,1,3,0
21006,4,2,73410,73410,73412,0,2,1
21007,2,2,73412,73412,73414,0,2,0
21008,3,1,73415,73415,73416,0,1,1
21009,5,2,73420,73420,73422,0,2,4
21010,4,1,73424,73424,73425,0,1,2
21011,5,2,73429,73429,73431,0,2,4
21012,6,2,73435,73435,73437,0,2,4
21013,1,3,73436,73437,73440,1,4,0
21014,3,3,73439,73440,73443,1,4,0
21015,2,3,73441,73443,73446,2,5,0
21016,6,3,73447,73447,73450,0,3,1
21017,2,3,73449,73450,73453,1,4,0
21018,5,2,73454,73454,73456,0,2,1
21019,6,2,73460,73460,73462,0,2,4
21020,4,1,73464,73464,73465,0,1,2
21021,3,1,73467,73467,73468,0,1,2
21022,1,2,73468,73468,73470,0,2,0
21023,5,2,73473,73473,73475,0,2,3
21024,5,2,73478,73478,73480,0,2,3
21025,1,3,73479,73480,73483,1,4,0
21026,4,1,73483,73483,73484,0,1,0
21027,5,3,73488,73488,73491,0,3,4
21028,5,2,73493,73493,73495,0,2,2
21029,6,1,73499,73499,73500,0,1,4
21030,3,3,73502,73502,73505,0,3,2
21031,2,2,73504,73505,73507,1,3,0
21032,5,1,73509,73509,73510,0,1,2
21033,4,2,73513,73513,73515,0,2,3
21034,6,1,73519,73519,73520,0,1,4
21035,3,3,73522,73522,73525,0,3,2
21036,6,2,73528,73528,73530,0,2,3
21037,1,2,73529,73530,73532,1,3,0
21038,6,1,73535,73535,73536,0,1,3
21039,4,1,73539,73539,73540,0,1,3
21040,5,3,73544,73544,73547,0,3,4
21041,6,1,73550,73550,73551,0,1,3
21042,1,1,73551,73551,73552,0,1,0
21043,6,3,73557,73557,73560,0,3,5
21044,1,2,73558,73560,73562,2,4,0
21045,2,2,73560,73562,73564,2,4,0
21046,2,3,73562,73564,73567,2,5,0
21047,1,3,73563,73567,73570,4,7,0
21048,2,3,73565,73570,73573,5,8,0
21049,5,3,73570,73573,73576,3,6,0
21050,4,2,73574,73576,73578,2,4,0
21051,2,2,73576,73578,73580,2,4,0
21052,6,3,73582,73582,73585,0,3,2
21053,3,2,73585,73585,73587,0,2,0
21054,2,2,73587,73587,73589,0,2,0
21055,6,1,73593,73593,73594,0,1,4
21056,6,2,73599,73599,73601,0,2,5
21057,6,3,73605,73605,73608,0,3,4
21058,1,2,73606,73608,73610,2,4,0
21059,4,3,73610,73610,73613,0,3,0
21060,5,1,73615,73615,73616,0,1,2
21061,3,1,73618,73618,73619,0,1,2
21062,1,1,73619,73619,73620,0,1,0
21063,1,3,73620,73620,73623,0,3,0
21064,6,2,73626,73626,73628,0,2,3
21065,1,2,73627,73628,73630,1,3,0
21066,6,3,73633,73633,73636,0,3,3
21067,5,2,73638,73638,73640,0,2,2
21068,3,1,73641,73641,73642,0,1,1
21069,3,3,73644,73644,73647,0,3,2
21070,5,3,73649,73649,73652,0,3,2
21071,2,1,73651,73652,73653,1,2,0
21072,3,3,73654,73654,73657,0,3,1
21073,5,1,73659,73659,73660,0,1,2
21074,4,2,73663,73663,73665,0,2,3
21075,6,2,73669,73669,73671,0,2,4
21076,6,1,73675,73675,73676,0,1,4
21077,6,1,73681,73681,73682,0,1,5
21078,6,2,73687,73687,73689,0,2,5
21079,1,1,73688,73689,73690,1,2,0
21080,6,2,73694,73694,73696,0,2,4
21081,6,3,73700,73700,73703,0,3,4
21082,5,3,73705,73705,73708,0,3,2
21083,4,2,73709,73709,73711,0,2,1
21084,4,3,73713,73713,73716,0,3,2
21085,4,2,73717,73717,73719,0,2,1
21086,6,2,73723,73723,73725,0,2,4
21087,5,1,73728,73728,73729,0,1,3
21088,3,3,73731,73731,73734,0,3,2
21089,2,3,73733,73734,73737,1,4,0
21090,1,3,73734,73737,73740,3,6,0
21091,4,1,73738,73740,73741,2,3,0
21092,4,3,73742,73742,73745,0,3,1
21093,1,1,73743,73745,73746,2,3,0
21094,5,2,73748,73748,73750,0,2,2
21095,4,1,73752,73752,73753,0,1,2
21096,5,1,73757,73757,73758,0,1,4
21097,4,3,73761,73761,73764,0,3,3
21098,6,2,73767,73767,73769,0,2,3
21099,3,3,73770,73770,73773,0,3,1
21100,1,1,73771,73773,73774,2,3,0
21101,2,1,73773,73774,73775,1,2,0
21102,6,3,73779,73779,73782,0,3,4
21103,5,3,73784,73784,73787,0,3,2
21104,1,3,73785,73787,73790,2,5,0
21105,1,1,73786,73790,73791,4,5,0
21106,5,2,73791,73791,73793,0,2,0
21107,6,1,73797,73797,73798,0,1,4
21108,2,2,73799,73799,73801,0,2,1
21109,3,1,73802,73802,73803,0,1,1
21110,1,2,73803,73803,73805,0,2,0
21111,4,3,73807,73807,73810,0,3,2
21112,5,2,73812,73812,73814,0,2,2
21113,1,3,73813,73814,73817,1,4,0
21114,5,3,73818,73818,73821,0,3,1
21115,5,1,73823,73823,73824,0,1,2
21116,4,1,73827,73827,73828,0,1,3
21117,1,1,73828,73828,73829,0,1,0
21118,6,2,73834,73834,73836,0,2,5
21119,4,3,73838,73838,73841,0,3,2
21120,1,3,73839,73841,73844,2,5,0
21121,2,3,73841,73844,73847,3,6,0
21122,4,3,73845,73847,73850,2,5,0
21123,5,1,73850,73850,73851,0,1,0
21124,4,1,73854,73854,73855,0,1,3
21125,5,3,73859,73859,73862,0,3,4
21126,6,1,73865,73865,73866,0,1,3
21127,3,1,73868,73868,73869,0,1,2
21128,1,2,73869,73869,73871,0,2,0
21129,5,3,73874,73874,73877,0,3,3
21130,4,1,73878,73878,73879,0,1,1
21131,6,1,73884,73884,73885,0,1,5
21132,6,2,73890,73890,73892,0,2,5
21133,4,1,73894,73894,73895,0,1,2
21134,4,1,73898,73898,73899,0,1,3
21135,4,3,73902,73902,73905,0,3,3
21136,2,2,73904,73905,73907,1,3,0
21137,4,3,73908,73908,73911,0,3,1
21138,4,3,73912,73912,73915,0,3,1
21139,3,1,73915,73915,73916,0,1,0
21140,6,3,73921,73921,73924,0,3,5
21141,5,2,73926,73926,73928,0,2,2
21142,4,1,73930,73930,73931,0,1,2
21143,3,2,73933,73933,73935,0,2,2
21144,3,2,73936,73936,73938,0,2,1
21145,3,2,73939,73939,73941,0,2,1
21146,2,3,73941,73941,73944,0,3,0
21147,6,1,73947,73947,73948,0,1,3
21148,6,1,73953,73953,73954,0,1,5
21149,4,1,73957,73957,73958,0,1,3
21150,4,1,73961,73961,73962,0,1,3
21151,6,2,73967,73967,73969,0,2,5
21152,3,3,73970,73970,73973,0,3,1
21153,2,2,73972,73973,73975,1,3,0
21154,5,3,73977,73977,73980,0,3,2
21155,2,1,73979,73980,73981,1,2,0
21156,4,3,73983,73983,73986,0,3,2
21157,1,1,73984,73986,73987,2,3,0
21158,3,3,73987,73987,73990,0,3,0
21159,4,1,73991,73991,73992,0,1,1
21160,6,2,73997,73997,73999,0,2,5
21161,3,1,74000,74000,74001,0,1,1
21162,1,2,74001,74001,74003,0,2,0
21163,5,3,74006,74006,74009,0,3,3
21164,5,1,74011,74011,74012,0,1,2
21165,3,2,74014,74014,74016,0,2,2
21166,5,3,74019,74019,74022,0,3,3
21167,4,2,74023,74023,74025,0,2,1
21168,1,1,74024,74025,74026,1,2,0
21169,4,1,74028,74028,74029,0,1,2
21170,2,1,74030,74030,74031,0,1,1
21171,2,3,74032,74032,74035,0,3,1
21172,4,3,74036,74036,74039,0,3,1
21173,6,2,74042,74042,74044,0,2,3
21174,3,1,74045,74045,74046,0,1,1
21175,3,3,74048,74048,74051,0,3,2
21176,3,1,74051,74051,74052,0,1,0
21177,4,2,74055,74055,74057,0,2,3
21178,2,1,74057,74057,74058,0,1,0
21179,6,1,74063,74063,74064,0,1,5
21180,3,1,74066,74066,74067,0,1,2
21181,5,1,74071,74071,74072,0,1,4
21182,5,3,74076,74076,74079,0,3,4
21183,1,1,74077,74079,74080,2,3,0
21184,5,2,74082,74082,74084,0,2,2
21185,1,1,74083,74084,74085,1,2,0
21186,4,3,74087,74087,74090,0,3,2
21187,4,3,74091,74091,74094,0,3,1
21188,6,3,74097,74097,74100,0,3,3
21189,6,3,74103,74103,74106,0,3,3
21190,2,3,74105,74106,74109,1,4,0
21191,4,1,74109,74109,74110,0,1,0
21192,4,1,74113,74113,74114,0,1,3
21193,1,1,74114,74114,74115,0,1,0
21194,5,1,74119,74119,74120,0,1,4
21195,4,2,74123,74123,74125,0,2,3
21196,4,3,74127,74127,74130,0,3,2
21197,5,2,74132,74132,74134,0,2,2
21198,3,1,74135,74135,74136,0,1,1
21199,4,2,74139,74139,74141,0,2,3
21200,3,2,74142,74142,74144,0,2,1
21201,1,1,74143,74144,74145,1,2,0
21202,2,2,74145,74145,74147,0,2,0
21203,4,1,74149,74149,74150,0,1,2
21204,5,2,74154,74154,74156,0,2,4
21205,6,1,74160,74160,74161,0,1,4
21206,2,2,74162,74162,74164,0,2,1
21207,6,1,74168,74168,74169,0,1,4
21208,6,2,74174,74174,74176,0,2,5
21209,6,2,74180,74180,74182,0,2,4
21210,1,3,74181,74182,74185,1,4,0
21211,6,1,74187,74187,74188,0,1,2
21212,1,2,74188,74188,74190,0,2,0
21213,6,2,74194,74194,74196,0,2,4
21214,5,3,74199,74199,74202,0,3,3
21215,3,2,74202,74202,74204,0,2,0
21216,2,2,74204,74204,74206,0,2,0
21217,1,3,74205,74206,74209,1,4,0
21218,6,3,74211,74211,74214,0,3,2
21219,1,1,74212,74214,74215,2,3,0
21220,3,3,74215,74215,74218,0,3,0
21221,6,2,74221,74221,74223,0,2,3
21222,5,2,74226,74226,74228,0,2,3
21223,4,1,74230,74230,74231,0,1,2
21224,1,1,74231,74231,74232,0,1,0
21225,6,2,74237,74237,74239,0,2,5
21226,6,3,74243,74243,74246,0,3,4
21227,6,2,74249,74249,74251,0,2,3
21228,5,1,74254,74254,74255,0,1,3
21229,1,2,74255,74255,74257,0,2,0
21230,5,1,74260,74260,74261,0,1,3
21231,6,1,74266,74266,74267,0,1,5
21232,2,1,74268,74268,74269,0,1,1
21233,2,3,74270,74270,74273,0,3,1
21234,6,1,74276,74276,74277,0,1,3
21235,2,2,74278,74278,74280,0,2,1
21236,1,1,74279,74280,74281,1,2,0
21237,2,2,74281,74281,74283,0,2,0
21238,4,2,74285,74285,74287,0,2,2
21239,2,3,74287,74287,74290,0,3,0
21240,4,2,74291,74291,74293,0,2,1
21241,1,1,74292,74293,74294,1,2,0
21242,4,3,74296,74296,74299,0,3,2
21243,3,3,74299,74299,74302,0,3,0
21244,3,2,74302,74302,74304,0,2,0
21245,3,1,74305,74305,74306,0,1,1
21246,4,1,74309,74309,74310,0,1,3
21247,5,2,74314,74314,74316,0,2,4
21248,4,2,74318,74318,74320,0,2,2
21249,3,3,74321,74321,74324,0,3,1
21250,5,1,74326,74326,74327,0,1,2
21251,3,2,74329,74329,74331,0,2,2
21252,3,1,74332,74332,74333,0,1,1
21253,5,2,74337,74337,74339,0,2,4
21254,3,3,74340,74340,74343,0,3,1
21255,1,3,74341,74343,74346,2,5,0
21256,1,1,74342,74346,74347,4,5,0
21257,3,1,74345,74347,74348,2,3,0
21258,3,2,74348,74348,74350,0,2,0
21259,6,1,74354,74354,74355,0,1,4
21260,6,3,74360,74360,74363,0,3,5
21261,4,2,74364,74364,74366,0,2,1
21262,5,1,74369,74369,74370,0,1,3
21263,3,3,74372,74372,74375,0,3,2
21264,3,2,74375,74375,74377,0,2,0
21265,2,2,74377,74377,74379,0,2,0
21266,2,2,74379,74379,74381,0,2,0
21267,2,3,74381,74381,74384,0,3,0
21268,1,2,74382,74384,74386,2,4,0
21269,1,1,74383,74386,74387,3,4,0
21270,3,2,74386,74387,74389,1,3,0
21271,4,1,74390,74390,74391,0,1,1
21272,4,2,74394,74394,74396,0,2,3
21273,5,1,74399,74399,74400,0,1,3
21274,2,2,74401,74401,74403,0,2,1
21275,5,3,74406,74406,74409,0,3,3
21276,3,2,74409,74409,74411,0,2,0
21277,3,2,74412,74412,74414,0,2,1
21278,6,3,74418,74418,74421,0,3,4
21279,1,1,74419,74421,74422,2,3,0
21280,2,3,74421,74422,74425,1,4,0
21281,1,1,74422,74425,74426,3,4,0
21282,5,2,74427,74427,74429,0,2,1
21283,1,2,74428,74429,74431,1,3,0
21284,5,3,74433,74433,74436,0,3,2
21285,5,3,74438,74438,74441,0,3,2
21286,6,3,74444,74444,74447,0,3,3
21287,6,3,74450,74450,74453,0,3,3
21288,3,2,74453,74453,74455,0,2,0
21289,2,2,74455,74455,74457,0,2,0
21290,4,1,74459,74459,74460,0,1,2
21291,4,3,74463,74463,74466,0,3,3
21292,1,1,74464,74466,74467,2,3,0
21293,4,3,74468,74468,74471,0,3,1
21294,6,1,74474,74474,74475,0,1,3
21295,4,3,74478,74478,74481,0,3,3
21296,3,3,74481,74481,74484,0,3,0
21297,1,2,74482,74484,74486,2,4,0
21298,4,2,74486,74486,74488,0,2,0
21299,4,3,74490,74490,74493,0,3,2
21300,4,1,74494,74494,74495,0,1,1
21301,4,3,74498,74498,74501,0,3,3
21302,2,1,74500,74501,74502,1,2,0
21303,1,3,74501,74502,74505,1,4,0
21304,2,2,74503,74505,74507,2,4,0
21305,6,2,74509,74509,74511,0,2,2
21306,1,3,74510,74511,74514,1,4,0
21307,6,3,74516,74516,74519,0,3,2
21308,3,3,74519,74519,74522,0,3,0
21309,6,3,74525,74525,74528,0,3,3
21310,6,2,74531,74531,74533,0,2,3
21311,6,2,74537,74537,74539,0,2,4
21312,1,3,74538,74539,74542,1,4,0
21313,3,2,74541,74542,74544,1,3,0
21314,3,3,74544,74544,74547,0,3,0
21315,5,3,74549,74549,74552,0,3,2
21316,5,3,74554,74554,74557,0,3,2
21317,4,3,74558,74558,74561,0,3,1
21318,4,3,74562,74562,74565,0,3,1
21319,2,2,74564,74565,74567,1,3,0
21320,1,3,74565,74567,74570,2,5,0
21321,6,2,74571,74571,74573,0,2,1
21322,6,2,74577,74577,74579,0,2,4
21323,1,3,74578,74579,74582,1,4,0
21324,4,1,74582,74582,74583,0,1,0
21325,5,1,74587,74587,74588,0,1,4
21326,2,3,74589,74589,74592,0,3,1
21327,1,2,74590,74592,74594,2,4,0
21328,1,3,74591,74594,74597,3,6,0
21329,3,3,74594,74597,74600,3,6,0
21330,4,3,74598,74600,74603,2,5,0
21331,5,1,74603,74603,74604,0,1,0
21332,1,1,74604,74604,74605,0,1,0
21333,3,2,74607,74607,74609,0,2,2
21334,3,3,74610,74610,74613,0,3,1
21335,5,2,74615,74615,74617,0,2,2
21336,4,2,74619,74619,74621,0,2,2
21337,1,1,74620,74621,74622,1,2,0
21338,2,3,74622,74622,74625,0,3,0
21339,4,2,74626,74626,74628,0,2,1
21340,5,2,74631,74631,74633,0,2,3
21341,1,3,74632,74633,74636,1,4,0
21342,2,3,74634,74636,74639,2,5,0
21343,6,2,74640,74640,74642,0,2,1
21344,6,2,74646,74646,74648,0,2,4
21345,3,3,74649,74649,74652,0,3,1
21346,2,3,74651,74652,74655,1,4,0
21347,5,3,74656,74656,74659,0,3,1
21348,5,1,74661,74661,74662,0,1,2
21349,1,2,74662,74662,74664,0,2,0
21350,6,1,74668,74668,74669,0,1,4
21351,1,1,74669,74669,74670,0,1,0
21352,4,2,74673,74673,74675,0,2,3
21353,4,3,74677,74677,74680,0,3,2
21354,4,1,74681,74681,74682,0,1,1
21355,4,2,74685,74685,74687,0,2,3
21356,1,1,74686,74687,74688,1,2,0
21357,3,3,74689,74689,74692,0,3,1
21358,4,3,74693,74693,74696,0,3,1
21359,6,3,74699,74699,74702,0,3,3
21360,6,3,74705,74705,74708,0,3,3
21361,5,2,74710,74710,74712,0,2,2
21362,5,3,74715,74715,74718,0,3,3
21363,3,2,74718,74718,74720,0,2,0
21364,2,1,74720,74720,74721,0,1,0
21365,4,2,74724,74724,74726,0,2,3
21366,6,1,74730,74730,74731,0,1,4
21367,3,1,74733,74733,74734,0,1,2
21368,1,2,74734,74734,74736,0,2,0
21369,1,2,74735,74736,74738,1,3,0
21370,3,3,74738,74738,74741,0,3,0
21371,4,2,74742,74742,74744,0,2,1
21372,6,3,74748,74748,74751,0,3,4
21373,1,2,74749,74751,74753,2,4,0
21374,2,2,74751,74753,74755,2,4,0
21375,5,2,74756,74756,74758,0,2,1
21376,3,3,74759,74759,74762,0,3,1
21377,1,3,74760,74762,74765,2,5,0
21378,3,3,74763,74765,74768,2,5,0
21379,2,2,74765,74768,74770,3,5,0
21380,4,1,74769,74770,74771,1,2,0
21381,5,2,74774,74774,74776,0,2,3
21382,1,1,74775,74776,74777,1,2,0
21383,4,1,74779,74779,74780,0,1,2
21384,2,2,74781,74781,74783,0,2,1
21385,5,1,74786,74786,74787,0,1,3
21386,6,3,74792,74792,74795,0,3,5
21387,2,1,74794,74795,74796,1,2,0
21388,1,2,74795,74796,74798,1,3,0
21389,1,2,74796,74798,74800,2,4,0
21390,2,3,74798,74800,74803,2,5,0
21391,4,3,74802,74803,74806,1,4,0
21392,5,3,74807,74807,74810,0,3,1
21393,2,1,74809,74810,74811,1,2,0
21394,1,1,74810,74811,74812,1,2,0
21395,2,1,74812,74812,74813,0,1,0
21396,2,2,74814,74814,74816,0,2,1
21397,5,1,74819,74819,74820,0,1,3
21398,3,2,74822,74822,74824,0,2,2
21399,3,3,74825,74825,74828,0,3,1
21400,6,3,74831,74831,74834,0,3,3
21401,3,1,74834,74834,74835,0,1,0
21402,2,1,74836,74836,74837,0,1,1
21403,2,3,74838,74838,74841,0,3,1
21404,1,2,74839,74841,74843,2,4,0
21405,3,2,74842,74843,74845,1,3,0
21406,1,2,74843,74845,74847,2,4,0
21407,1,2,74844,74847,74849,3,5,0
21408,3,1,74847,74849,74850,2,3,0
21409,6,2,74853,74853,74855,0,2,3
21410,1,2,74854,74855,74857,1,3,0
21411,5,1,74859,74859,74860,0,1,2
21412,4,1,74863,74863,74864,0,1,3
21413,2,2,74865,74865,74867,0,2,1
21414,3,1,74868,74868,74869,0,1,1
21415,2,1,74870,74870,74871,0,1,1
21416,1,2,74871,74871,74873,0,2,0
21417,4,1,74875,74875,74876,0,1,2
21418,1,1,74876,74876,74877,0,1,0
21419,6,2,74882,74882,74884,0,2,5
21420,6,3,74888,74888,74891,0,3,4
21421,3,3,74891,74891,74894,0,3,0
21422,6,1,74897,74897,74898,0,1,3
21423,3,3,74900,74900,74903,0,3,2
21424,1,1,74901,74903,74904,2,3,0
21425,6,2,74907,74907,74909,0,2,3
21426,2,2,74909,74909,74911,0,2,0
21427,4,3,74913,74913,74916,0,3,2
21428,5,2,74918,74918,74920,0,2,2
21429,4,3,74922,74922,74925,0,3,2
21430,3,2,74925,74925,74927,0,2,0
21431,5,2,74930,74930,74932,0,2,3
21432,5,1,74935,74935,74936,0,1,3
21433,6,3,74941,74941,74944,0,3,5
21434,2,1,74943,74944,74945,1,2,0
21435,6,2,74949,74949,74951,0,2,4
21436,5,1,74954,74954,74955,0,1,3
21437,1,2,74955,74955,74957,0,2,0
21438,5,2,74960,74960,74962,0,2,3
21439,1,3,74961,74962,74965,1,4,0
21440,5,2,74966,74966,74968,0,2,1
21441,2,3,74968,74968,74971,0,3,0
21442,2,3,74970,74971,74974,1,4,0
21443,5,1,74975,74975,74976,0,1,1
21444,4,3,74979,74979,74982,0,3,3
21445,2,2,74981,74982,74984,1,3,0
21446,2,1,74983,74984,74985,1,2,0
21447,1,3,74984,74985,74988,1,4,0
21448,3,2,74987,74988,74990,1,3,0
21449,2,1,74989,74990,74991,1,2,0
21450,3,3,74992,74992,74995,0,3,1
21451,6,2,74998,74998,75000,0,2,3
21452,3,2,75001,75001,75003,0,2,1
21453,6,1,75007,75007,75008,0,1,4
21454,4,1,75011,75011,75012,0,1,3
21455,4,2,75015,75015,75017,0,2,3
21456,6,2,75021,75021,75023,0,2,4
21457,5,1,75026,75026,75027,0,1,3
21458,4,2,75030,75030,75032,0,2,3
21459,1,1,75031,75032,75033,1,2,0
21460,5,2,75036,75036,75038,0,2,3
21461,2,3,75038,75038,75041,0,3,0
21462,1,3,75039,75041,75044,2,5,0
21463,6,2,75045,75045,75047,0,2,1
21464,3,1,75048,75048,75049,0,1,1
21465,3,3,75051,75051,75054,0,3,2
21466,1,3,75052,75054,75057,2,5,0
21467,2,3,75054,75057,75060,3,6,0
21468,5,3,75059,75060,75063,1,4,0
21469,1,2,75060,75063,75065,3,5,0
21470,1,1,75061,75065,75066,4,5,0
21471,3,3,75064,75066,75069,2,5,0
21472,6,3,75070,75070,75073,0,3,1
21473,4,1,75074,75074,75075,0,1,1
21474,4,1,75078,75078,75079,0,1,3
21475,2,2,75080,75080,75082,0,2,1
21476,6,1,75086,75086,75087,0,1,4
21477,2,1,75088,75088,75089,0,1,1
21478,4,1,75092,75092,75093,0,1,3
21479,5,1,75097,75097,75098,0,1,4
21480,3,1,75100,75100,75101,0,1,2
21481,2,3,75102,75102,75105,0,3,1
21482,3,2,75105,75105,75107,0,2,0
21483,4,2,75109,75109,75111,0,2,2
21484,1,1,75110,75111,75112,1,2,0
21485,2,2,75112,75112,75114,0,2,0
21486,3,3,75115,75115,75118,0,3,1
21487,3,3,75118,75118,75121,0,3,0
21488,6,1,75124,75124,75125,0,1,3
21489,2,2,75126,75126,75128,0,2,1
21490,3,2,75129,75129,75131,0,2,1
21491,4,2,75133,75133,75135,0,2,2
21492,1,2,75134,75135,75137,1,3,0
21493,4,3,75138,75138,75141,0,3,1
21494,2,1,75140,75141,75142,1,2,0
21495,5,3,75145,75145,75148,0,3,3
21496,6,3,75151,75151,75154,0,3,3
21497,6,1,75157,75157,75158,0,1,3
21498,6,3,75163,75163,75166,0,3,5
21499,4,1,75167,75167,75168,0,1,1
21500,6,2,75173,75173,75175,0,2,5
21501,2,3,75175,75175,75178,0,3,0
21502,5,3,75180,75180,75183,0,3,2
21503,1,1,75181,75183,75184,2,3,0
21504,6,3,75187,75187,75190,0,3,3
21505,5,3,75192,75192,75195,0,3,2
21506,1,1,75193,75195,75196,2,3,0
21507,6,1,75199,75199,75200,0,1,3
21508,1,1,75200,75200,75201,0,1,0
21509,6,2,75206,75206,75208,0,2,5
21510,3,1,75209,75209,75210,0,1,1
21511,3,1,75212,75212,75213,0,1,2
21512,2,3,75214,75214,75217,0,3,1
21513,5,3,75219,75219,75222,0,3,2
21514,6,1,75225,75225,75226,0,1,3
21515,1,2,75226,75226,75228,0,2,0
21516,4,2,75230,75230,75232,0,2,2
21517,3,3,75233,75233,75236,0,3,1
21518,1,1,75234,75236,75237,2,3,0
21519,5,1,75239,75239,75240,0,1,2
21520,6,1,75245,75245,75246,0,1,5
21521,3,1,75248,75248,75249,0,1,2
21522,6,3,75254,75254,75257,0,3,5
21523,4,1,75258,75258,75259,0,1,1
21524,3,2,75261,75261,75263,0,2,2
21525,4,1,75265,75265,75266,0,1,2
21526,3,2,75268,75268,75270,0,2,2
21527,1,1,75269,75270,75271,1,2,0
21528,5,3,75274,75274,75277,0,3,3
21529,1,2,75275,75277,75279,2,4,0
21530,2,2,75277,75279,75281,2,4,0
21531,6,1,75283,75283,75284,0,1,2
21532,3,3,75286,75286,75289,0,3,2
21533,1,3,75287,75289,75292,2,5,0
21534,1,2,75288,75292,75294,4,6,0
21535,2,1,75290,75294,75295,4,5,0
21536,6,3,75296,75296,75299,0,3,1
21537,2,3,75298,75299,75302,1,4,0
21538,1,1,75299,75302,75303,3,4,0
21539,2,2,75301,75303,75305,2,4,0
21540,6,3,75307,75307,75310,0,3,2
21541,6,3,75313,75313,75316,0,3,3
21542,5,2,75318,75318,75320,0,2,2
21543,5,2,75323,75323,75325,0,2,3
21544,6,2,75329,75329,75331,0,2,4
21545,1,3,75330,75331,75334,1,4,0
21546,4,2,75334,75334,75336,0,2,0
21547,3,1,75337,75337,75338,0,1,1
21548,6,2,75343,75343,75345,0,2,5
21549,1,1,75344,75345,75346,1,2,0
21550,4,1,75348,75348,75349,0,1,2
21551,5,3,75353,75353,75356,0,3,4
21552,6,1,75359,75359,75360,0,1,3
21553,6,1,75365,75365,75366,0,1,5
21554,5,3,75370,75370,75373,0,3,4
21555,5,3,75375,75375,75378,0,3,2
21556,2,1,75377,75378,75379,1,2,0
21557,4,2,75381,75381,75383,0,2,2
21558,4,3,75385,75385,75388,0,3,2
21559,2,3,75387,75388,75391,1,4,0
21560,1,3,75388,75391,75394,3,6,0
21561,5,2,75393,75394,75396,1,3,0
21562,3,2,75396,75396,75398,0,2,0
21563,2,3,75398,75398,75401,0,3,0
21564,2,1,75400,75401,75402,1,2,0
21565,5,1,75405,75405,75406,0,1,3
21566,1,3,75406,75406,75409,0,3,0
21567,6,1,75412,75412,75413,0,1,3
21568,3,1,75415,75415,75416,0,1,2
21569,6,3,75421,75421,75424,0,3,5
21570,4,1,75425,75425,75426,0,1,1
21571,6,1,75431,75431,75432,0,1,5
21572,2,3,75433,75433,75436,0,3,1
21573,4,3,75437,75437,75440,0,3,1
21574,1,1,75438,75440,75441,2,3,0
21575,1,1,75439,75441,75442,2,3,0
21576,6,3,75445,75445,75448,0,3,3
21577,5,2,75450,75450,75452,0,2,2
21578,4,1,75454,75454,75455,0,1,2
21579,2,3,75456,75456,75459,0,3,1
21580,5,2,75461,75461,75463,0,2,2
21581,4,1,75465,75465,75466,0,1,2
21582,4,2,75469,75469,75471,0,2,3
21583,4,2,75473,75473,75475,0,2,2
21584,5,3,75478,75478,75481,0,3,3
21585,4,1,75482,75482,75483,0,1,1
21586,4,3,75486,75486,75489,0,3,3
21587,4,3,75490,75490,75493,0,3,1
21588,3,3,75493,75493,75496,0,3,0
21589,3,2,75496,75496,75498,0,2,0
21590,1,1,75497,75498,75499,1,2,0
21591,4,1,75501,75501,75502,0,1,2
21592,2,3,75503,75503,75506,0,3,1
21593,6,1,75509,75509,75510,0,1,3
21594,5,1,75514,75514,75515,0,1,4
21595,4,1,75518,75518,75519,0,1,3
21596,1,2,75519,75519,75521,0,2,0
21597,3,3,75522,75522,75525,0,3,1
21598,5,1,75527,75527,75528,0,1,2
21599,1,2,75528,75528,75530,0,2,0
21600,3,2,75531,75531,75533,0,2,1
21601,3,3,75534,75534,75537,0,3,1
21602,3,3,75537,75537,75540,0,3,0
21603,5,2,75542,75542,75544,0,2,2
21604,1,1,75543,75544,75545,1,2,0
21605,4,3,75547,75547,75550,0,3,2
21606,1,1,75548,75550,75551,2,3,0
21607,5,1,75553,75553,75554,0,1,2
21608,6,3,75559,75559,75562,0,3,5
21609,5,3,75564,75564,75567,0,3,2
21610,5,1,75569,75569,75570,0,1,2
21611,1,3,75570,75570,75573,0,3,0
21612,5,3,75575,75575,75578,0,3,2
21613,3,1,75578,75578,75579,0,1,0
21614,6,1,75584,75584,75585,0,1,5
21615,4,3,75588,75588,75591,0,3,3
21616,2,3,75590,75591,75594,1,4,0
21617,2,3,75592,75594,75597,2,5,0
21618,6,3,75598,75598,75601,0,3,1
21619,3,2,75601,75601,75603,0,2,0
21620,4,3,75605,75605,75608,0,3,2
21621,6,2,75611,75611,75613,0,2,3
21622,6,2,75617,75617,75619,0,2,4
21623,4,3,75621,75621,75624,0,3,2
21624,6,3,75627,75627,75630,0,3,3
21625,5,2,75632,75632,75634,0,2,2
21626,1,1,75633,75634,75635,1,2,0
21627,6,3,75639,75639,75642,0,3,4
21628,1,2,75640,75642,75644,2,4,0
21629,2,1,75642,75644,75645,2,3,0
21630,2,1,75644,75645,75646,1,2,0
21631,3,3,75647,75647,75650,0,3,1
21632,1,3,75648,75650,75653,2,5,0
21633,5,2,75653,75653,75655,0,2,0
21634,6,2,75659,75659,75661,0,2,4
21635,2,2,75661,75661,75663,0,2,0
21636,3,1,75664,75664,75665,0,1,1
21637,1,1,75665,75665,75666,0,1,0
21638,1,3,75666,75666,75669,0,3,0
21639,1,1,75667,75669,75670,2,3,0
21640,3,1,75670,75670,75671,0,1,0
21641,3,2,75673,75673,75675,0,2,2
21642,1,3,75674,75675,75678,1,4,0
21643,2,1,75676,75678,75679,2,3,0
21644,3,1,75679,75679,75680,0,1,0
21645,6,2,75685,75685,75687,0,2,5
21646,3,1,75688,75688,75689,0,1,1
21647,1,1,75689,75689,75690,0,1,0
21648,4,1,75693,75693,75694,0,1,3
21649,5,2,75698,75698,75700,0,2,4
21650,6,1,75704,75704,75705,0,1,4
21651,3,2,75707,75707,75709,0,2,2
21652,4,2,75711,75711,75713,0,2,2
21653,3,2,75714,75714,75716,0,2,1
21654,4,2,75718,75718,75720,0,2,2
21655,3,1,75721,75721,75722,0,1,1
21656,3,1,75724,75724,75725,0,1,2
21657,3,1,75727,75727,75728,0,1,2
21658,4,2,75731,75731,75733,0,2,3
21659,2,1,75733,75733,75734,0,1,0
21660,2,1,75735,75735,75736,0,1,1
21661,6,1,75741,75741,75742,0,1,5
21662,6,3,75747,75747,75750,0,3,5
21663,1,3,75748,75750,75753,2,5,0
21664,2,2,75750,75753,75755,3,5,0
21665,2,3,75752,75755,75758,3,6,0
21666,1,3,75753,75758,75761,5,8,0
21667,4,3,75757,75761,75764,4,7,0
21668,5,3,75762,75764,75767,2,5,0
21669,4,1,75766,75767,75768,1,2,0
21670,5,1,75771,75771,75772,0,1,3
21671,3,2,75774,75774,75776,0,2,2
21672,6,1,75780,75780,75781,0,1,4
21673,3,1,75783,75783,75784,0,1,2
21674,2,3,75785,75785,75788,0,3,1
21675,6,3,75791,75791,75794,0,3,3
21676,5,1,75796,75796,75797,0,1,2
21677,2,3,75798,75798,75801,0,3,1
21678,2,2,75800,75801,75803,1,3,0
21679,6,1,75806,75806,75807,0,1,3
21680,3,1,75809,75809,75810,0,1,2
21681,2,3,75811,75811,75814,0,3,1
21682,5,1,75816,75816,75817,0,1,2
21683,4,1,75820,75820,75821,0,1,3
21684,2,1,75822,75822,75823,0,1,1
21685,1,3,75823,75823,75826,0,3,0
21686,1,3,75824,75826,75829,2,5,0
21687,4,3,75828,75829,75832,1,4,0
21688,6,3,75834,75834,75837,0,3,2
21689,1,3,75835,75837,75840,2,5,0
21690,1,2,75836,75840,75842,4,6,0
21691,4,3,75840,75842,75845,2,5,0
21692,5,3,75845,75845,75848,0,3,0
21693,4,2,75849,75849,75851,0,2,1
21694,1,2,75850,75851,75853,1,3,0
21695,5,1,75855,75855,75856,0,1,2
21696,6,1,75861,75861,75862,0,1,5
21697,6,1,75867,75867,75868,0,1,5
21698,5,1,75872,75872,75873,0,1,4
21699,2,2,75874,75874,75876,0,2,1
21700,1,2,75875,75876,75878,1,3,0
21701,2,3,75877,75878,75881,1,4,0
21702,6,2,75883,75883,75885,0,2,2
21703,2,3,75885,75885,75888,0,3,0
21704,6,3,75891,75891,75894,0,3,3
21705,2,1,75893,75894,75895,1,2,0
21706,4,3,75897,75897,75900,0,3,2
21707,4,3,75901,75901,75904,0,3,1
21708,1,3,75902,75904,75907,2,5,0
21709,3,3,75905,75907,75910,2,5,0
21710,1,1,75906,75910,75911,4,5,0
21711,4,1,75910,75911,75912,1,2,0
21712,3,3,75913,75913,75916,0,3,1
21713,3,1,75916,75916,75917,0,1,0
21714,6,3,75922,75922,75925,0,3,5
21715,6,2,75928,75928,75930,0,2,3
21716,1,1,75929,75930,75931,1,2,0
21717,3,3,75932,75932,75935,0,3,1
21718,4,2,75936,75936,75938,0,2,1
21719,1,1,75937,75938,75939,1,2,0
21720,3,2,75940,75940,75942,0,2,1
21721,4,2,75944,75944,75946,0,2,2
21722,4,2,75948,75948,75950,0,2,2
21723,2,1,75950,75950,75951,0,1,0
21724,2,3,75952,75952,75955,0,3,1
21725,2,3,75954,75955,75958,1,4,0
21726,1,2,75955,75958,75960,3,5,0
21727,4,3,75959,75960,75963,1,4,0
21728,4,1,75963,75963,75964,0,1,0
21729,2,3,75965,75965,75968,0,3,1
21730,5,1,75970,75970,75971,0,1,2
21731,5,2,75975,75975,75977,0,2,4
21732,1,1,75976,75977,75978,1,2,0
21733,3,2,75979,75979,75981,0,2,1
21734,6,1,75985,75985,75986,0,1,4
21735,5,3,75990,75990,75993,0,3,4
21736,2,2,75992,75993,75995,1,3,0
21737,6,3,75998,75998,76001,0,3,3
21738,2,3,76000,76001,76004,1,4,0
21739,2,3,76002,76004,76007,2,5,0
21740,3,3,76005,76007,76010,2,5,0
21741,3,3,76008,76010,76013,2,5,0
21742,1,2,76009,76013,76015,4,6,0
21743,2,3,76011,76015,76018,4,7,0
21744,1,3,76012,76018,76021,6,9,0
21745,6,1,76018,76021,76022,3,4,0
21746,6,3,76024,76024,76027,0,3,2
21747,1,3,76025,76027,76030,2,5,0
21748,4,3,76029,76030,76033,1,4,0
21749,5,3,76034,76034,76037,0,3,1
21750,2,2,76036,76037,76039,1,3,0
21751,4,1,76040,76040,76041,0,1,1
21752,6,2,76046,76046,76048,0,2,5
21753,2,1,76048,76048,76049,0,1,0
21754,3,3,76051,76051,76054,0,3,2
21755,4,1,76055,76055,76056,0,1,1
21756,4,1,76059,76059,76060,0,1,3
21757,4,1,76063,76063,76064,0,1,3
21758,3,2,76066,76066,76068,0,2,2
21759,2,2,76068,76068,76070,0,2,0
21760,1,2,76069,76070,76072,1,3,0
21761,4,2,76073,76073,76075,0,2,1
21762,4,3,76077,76077,76080,0,3,2
21763,4,2,76081,76081,76083,0,2,1
21764,5,2,76086,76086,76088,0,2,3
21765,2,2,76088,76088,76090,0,2,0
21766,2,1,76090,76090,76091,0,1,0
21767,2,2,76092,76092,76094,0,2,1
21768,5,3,76097,76097,76100,0,3,3
21769,4,3,76101,76101,76104,0,3,1
21770,4,3,76105,76105,76108,0,3,1
21771,5,3,76110,76110,76113,0,3,2
21772,5,3,76115,76115,76118,0,3,2
21773,6,3,76121,76121,76124,0,3,3
21774,6,2,76127,76127,76129,0,2,3
21775,2,1,76129,76129,76130,0,1,0
21776,3,1,76132,76132,76133,0,1,2
21777,1,2,76133,76133,76135,0,2,0
21778,5,3,76138,76138,76141,0,3,3
21779,2,2,76140,76141,76143,1,3,0
21780,2,2,76142,76143,76145,1,3,0
21781,1,2,76143,76145,76147,2,4,0
21782,6,2,76149,76149,76151,0,2,2
21783,4,3,76153,76153,76156,0,3,2
21784,6,1,76159,76159,76160,0,1,3
21785,6,1,76165,76165,76166,0,1,5
21786,2,2,76167,76167,76169,0,2,1
21787,3,2,76170,76170,76172,0,2,1
21788,4,2,76174,76174,76176,0,2,2
21789,4,3,76178,76178,76181,0,3,2
21790,1,3,76179,76181,76184,2,5,0
21791,4,3,76183,76184,76187,1,4,0
21792,6,1,76189,76189,76190,0,1,2
21793,1,3,76190,76190,76193,0,3,0
21794,5,1,76195,76195,76196,0,1,2
21795,6,1,76201,76201,76202,0,1,5
21796,6,1,76207,76207,76208,0,1,5
21797,2,2,76209,76209,76211,0,2,1
21798,6,1,76215,76215,76216,0,1,4
21799,2,2,76217,76217,76219,0,2,1
21800,5,3,76222,76222,76225,0,3,3
21801,6,2,76228,76228,76230,0,2,3
21802,4,2,76232,76232,76234,0,2,2
21803,2,3,76234,76234,76237,0,3,0
21804,3,2,76237,76237,76239,0,2,0
21805,6,1,76243,76243,76244,0,1,4
21806,5,2,76248,76248,76250,0,2,4
21807,5,2,76253,76253,76255,0,2,3
21808,6,1,76259,76259,76260,0,1,4
21809,6,2,76265,76265,76267,0,2,5
21810,5,2,76270,76270,76272,0,2,3
21811,6,3,76276,76276,76279,0,3,4
21812,6,1,76282,76282,76283,0,1,3
21813,2,3,76284,76284,76287,0,3,1
21814,4,3,76288,76288,76291,0,3,1
21815,4,3,76292,76292,76295,0,3,1
21816,4,1,76296,76296,76297,0,1,1
21817,3,1,76299,76299,76300,0,1,2
21818,2,3,76301,76301,76304,0,3,1
21819,1,3,76302,76304,76307,2,5,0
21820,6,3,76308,76308,76311,0,3,1
21821,4,1,76312,76312,76313,0,1,1
21822,5,1,76317,76317,76318,0,1,4
21823,2,3,76319,76319,76322,0,3,1
21824,2,1,76321,76322,76323,1,2,0
21825,5,1,76326,76326,76327,0,1,3
21826,3,3,76329,76329,76332,0,3,2
21827,2,1,76331,76332,76333,1,2,0
21828,4,3,76335,76335,76338,0,3,2
21829,3,1,76338,76338,76339,0,1,0
21830,5,3,76343,76343,76346,0,3,4
21831,6,3,76349,76349,76352,0,3,3
21832,5,1,76354,76354,76355,0,1,2
21833,6,1,76360,76360,76361,0,1,5
21834,4,2,76364,76364,76366,0,2,3
21835,3,2,76367,76367,76369,0,2,1
21836,5,2,76372,76372,76374,0,2,3
21837,6,3,76378,76378,76381,0,3,4
21838,6,3,76384,76384,76387,0,3,3
21839,4,3,76388,76388,76391,0,3,1
21840,2,3,76390,76391,76394,1,4,0
21841,5,3,76395,76395,76398,0,3,1
21842,2,1,76397,76398,76399,1,2,0
21843,5,3,76402,76402,76405,0,3,3
21844,6,3,76408,76408,76411,0,3,3
21845,6,1,76414,76414,76415,0,1,3
21846,1,1,76415,76415,76416,0,1,0
21847,5,3,76420,76420,76423,0,3,4
21848,4,1,76424,76424,76425,0,1,1
21849,4,2,76428,76428,76430,0,2,3
21850,6,3,76434,76434,76437,0,3,4
21851,6,1,76440,76440,76441,0,1,3
21852,2,1,76442,76442,76443,0,1,1
21853,1,1,76443,76443,76444,0,1,0
21854,2,2,76445,76445,76447,0,2,1
21855,5,3,76450,76450,76453,0,3,3
21856,6,3,76456,76456,76459,0,3,3
21857,1,3,76457,76459,76462,2,5,0
21858,4,2,76461,76462,76464,1,3,0
21859,4,2,76465,76465,76467,0,2,1
21860,4,2,76469,76469,76471,0,2,2
21861,1,2,76470,76471,76473,1,3,0
21862,1,1,76471,76473,76474,2,3,0
21863,6,1,76477,76477,76478,0,1,3
21864,6,3,76483,76483,76486,0,3,5
21865,2,3,76485,76486,76489,1,4,0
21866,6,1,76491,76491,76492,0,1,2
21867,1,2,76492,76492,76494,0,2,0
21868,1,3,76493,76494,76497,1,4,0
21869,5,1,76498,76498,76499,0,1,1
21870,3,2,76501,76501,76503,0,2,2
21871,2,1,76503,76503,76504,0,1,0
21872,1,3,76504,76504,76507,0,3,0
21873,1,3,76505,76507,76510,2,5,0
21874,2,2,76507,76510,76512,3,5,0
21875,2,1,76509,76512,76513,3,4,0
21876,5,1,76514,76514,76515,0,1,1
21877,6,2,76520,76520,76522,0,2,5
21878,1,1,76521,76522,76523,1,2,0
21879,1,1,76522,76523,76524,1,2,0
21880,6,3,76528,76528,76531,0,3,4
21881,1,3,76529,76531,76534,2,5,0
21882,4,3,76533,76534,76537,1,4,0
21883,1,1,76534,76537,76538,3,4,0
21884,3,2,76537,76538,76540,1,3,0
21885,1,1,76538,76540,76541,2,3,0
21886,6,2,76544,76544,76546,0,2,3
21887,1,1,76545,76546,76547,1,2,0
21888,6,3,76551,76551,76554,0,3,4
21889,3,2,76554,76554,76556,0,2,0
21890,5,3,76559,76559,76562,0,3,3
21891,6,3,76565,76565,76568,0,3,3
21892,1,2,76566,76568,76570,2,4,0
21893,5,1,76571,76571,76572,0,1,1
21894,3,2,76574,76574,76576,0,2,2
21895,1,1,76575,76576,76577,1,2,0
21896,4,2,76579,76579,76581,0,2,2
21897,1,1,76580,76581,76582,1,2,0
21898,3,1,76583,76583,76584,0,1,1
21899,4,3,76587,76587,76590,0,3,3
21900,1,2,76588,76590,76592,2,4,0
21901,5,1,76593,76593,76594,0,1,1
21902,3,1,76596,76596,76597,0,1,2
21903,4,1,76600,76600,76601,0,1,3
21904,5,2,76605,76605,76607,0,2,4
21905,1,3,76606,76607,76610,1,4,0
21906,1,1,76607,76610,76611,3,4,0
21907,3,3,76610,76611,76614,1,4,0
21908,3,3,76613,76614,76617,1,4,0
21909,4,3,76617,76617,76620,0,3,0
21910,4,2,76621,76621,76623,0,2,1
21911,4,1,76625,76625,76626,0,1,2
21912,1,3,76626,76626,76629,0,3,0
21913,3,2,76629,76629,76631,0,2,0
21914,4,1,76633,76633,76634,0,1,2
21915,4,2,76637,76637,76639,0,2,3
21916,2,2,76639,76639,76641,0,2,0
21917,3,3,76642,76642,76645,0,3,1
21918,3,2,76645,76645,76647,0,2,0
21919,4,1,76649,76649,76650,0,1,2
21920,2,1,76651,76651,76652,0,1,1
21921,3,3,76654,76654,76657,0,3,2
21922,2,2,76656,76657,76659,1,3,0
21923,3,1,76659,76659,76660,0,1,0
21924,6,2,76665,76665,76667,0,2,5
21925,6,1,76671,76671,76672,0,1,4
21926,3,3,76674,76674,76677,0,3,2
21927,5,1,76679,76679,76680,0,1,2
21928,5,2,76684,76684,76686,0,2,4
21929,3,3,76687,76687,76690,0,3,1
21930,6,2,76693,76693,76695,0,2,3
21931,3,2,76696,76696,76698,0,2,1
21932,1,1,76697,76698,76699,1,2,0
21933,6,2,76703,76703,76705,0,2,4
21934,6,1,76709,76709,76710,0,1,4
21935,4,1,76713,76713,76714,0,1,3
21936,2,1,76715,76715,76716,0,1,1
21937,3,2,76718,76718,76720,0,2,2
21938,5,3,76723,76723,76726,0,3,3
21939,1,3,76724,76726,76729,2,5,0
21940,6,3,76730,76730,76733,0,3,1
21941,5,3,76735,76735,76738,0,3,2
21942,4,3,76739,76739,76742,0,3,1
21943,1,1,76740,76742,76743,2,3,0
21944,6,1,76746,76746,76747,0,1,3
21945,2,1,76748,76748,76749,0,1,1
21946,3,1,76751,76751,76752,0,1,2
21947,5,3,76756,76756,76759,0,3,4
21948,1,2,76757,76759,76761,2,4,0
21949,5,3,76762,76762,76765,0,3,1
21950,3,3,76765,76765,76768,0,3,0
21951,1,3,76766,76768,76771,2,5,0
21952,5,1,76771,76771,76772,0,1,0
21953,2,3,76773,76773,76776,0,3,1
21954,4,2,76777,76777,76779,0,2,1
21955,4,1,76781,76781,76782,0,1,2
21956,5,3,76786,76786,76789,0,3,4
21957,2,2,76788,76789,76791,1,3,0
21958,2,1,76790,76791,76792,1,2,0
21959,4,2,76794,76794,76796,0,2,2
21960,6,1,76800,76800,76801,0,1,4
21961,1,3,76801,76801,76804,0,3,0
21962,2,1,76803,76804,76805,1,2,0
21963,4,3,76807,76807,76810,0,3,2
21964,2,1,76809,76810,76811,1,2,0
21965,6,2,76815,76815,76817,0,2,4
21966,1,3,76816,76817,76820,1,4,0
21967,5,2,76821,76821,76823,0,2,1
21968,1,3,76822,76823,76826,1,4,0
21969,2,1,76824,76826,76827,2,3,0
21970,3,3,76827,76827,76830,0,3,0
21971,3,3,76830,76830,76833,0,3,0
21972,5,2,76835,76835,76837,0,2,2
21973,2,1,76837,76837,76838,0,1,0
21974,6,1,76843,76843,76844,0,1,5
21975,6,1,76849,76849,76850,0,1,5
21976,6,3,76855,76855,76858,0,3,5
21977,3,1,76858,76858,76859,0,1,0
21978,6,1,76864,76864,76865,0,1,5
21979,1,2,76865,76865,76867,0,2,0
21980,5,2,76870,76870,76872,0,2,3
21981,3,2,76873,76873,76875,0,2,1
21982,2,2,76875,76875,76877,0,2,0
21983,6,2,76881,76881,76883,0,2,4
21984,3,3,76884,76884,76887,0,3,1
21985,6,3,76890,76890,76893,0,3,3
21986,1,1,76891,76893,76894,2,3,0
21987,5,1,76896,76896,76897,0,1,2
21988,2,2,76898,76898,76900,0,2,1
21989,1,3,76899,76900,76903,1,4,0
21990,1,2,76900,76903,76905,3,5,0
21991,6,3,76906,76906,76909,0,3,1
21992,5,1,76911,76911,76912,0,1,2
21993,2,3,76913,76913,76916,0,3,1
21994,6,3,76919,76919,76922,0,3,3
21995,2,2,76921,76922,76924,1,3,0
21996,1,1,76922,76924,76925,2,3,0
21997,5,3,76927,76927,76930,0,3,2
21998,5,1,76932,76932,76933,0,1,2
21999,3,2,76935,76935,76937,0,2,2
22000,3,1,76938,76938,76939,0,1,1
22001,2,2,76940,76940,76942,0,2,1
22002,6,3,76946,76946,76949,0,3,4
22003,5,3,76951,76951,76954,0,3,2
22004,3,1,76954,76954,76955,0,1,0
22005,2,1,76956,76956,76957,0,1,1
22006,6,3,76962,76962,76965,0,3,5
22007,2,2,76964,76965,76967,1,3,0
22008,5,1,76969,76969,76970,0,1,2
22009,6,2,76975,76975,76977,0,2,5
22010,3,1,76978,76978,76979,0,1,1
22011,6,1,76984,76984,76985,0,1,5
22012,4,1,76988,76988,76989,0,1,3
22013,4,1,76992,76992,76993,0,1,3
22014,4,2,76996,76996,76998,0,2,3
22015,6,3,77002,77002,77005,0,3,4
22016,5,1,77007,77007,77008,0,1,2
22017,1,1,77008,77008,77009,0,1,0
22018,5,1,77013,77013,77014,0,1,4
22019,1,2,77014,77014,77016,0,2,0
22020,3,2,77017,77017,77019,0,2,1
22021,5,2,77022,77022,77024,0,2,3
22022,2,2,77024,77024,77026,0,2,0
22023,6,1,77030,77030,77031,0,1,4
22024,4,2,77034,77034,77036,0,2,3
22025,3,1,77037,77037,77038,0,1,1
22026,2,1,77039,77039,77040,0,1,1
22027,3,2,77042,77042,77044,0,2,2
22028,1,2,77043,77044,77046,1,3,0
22029,5,1,77048,77048,77049,0,1,2
22030,4,1,77052,77052,77053,0,1,3
22031,1,3,77053,77053,77056,0,3,0
22032,3,1,77056,77056,77057,0,1,0
22033,3,1,77059,77059,77060,0,1,2
22034,5,1,77064,77064,77065,0,1,4
22035,1,3,77065,77065,77068,0,3,0
22036,4,1,77069,77069,77070,0,1,1
22037,1,3,77070,77070,77073,0,3,0
22038,2,3,77072,77073,77076,1,4,0
22039,1,3,77073,77076,77079,3,6,0
22040,1,1,77074,77079,77080,5,6,0
22041,6,1,77080,77080,77081,0,1,0
22042,2,1,77082,77082,77083,0,1,1
22043,4,1,77086,77086,77087,0,1,3
22044,5,3,77091,77091,77094,0,3,4
22045,1,2,77092,77094,77096,2,4,0
22046,6,2,77098,77098,77100,0,2,2
22047,6,1,77104,77104,77105,0,1,4
22048,1,2,77105,77105,77107,0,2,0
22049,2,3,77107,77107,77110,0,3,0
22050,5,3,77112,77112,77115,0,3,2
22051,5,2,77117,77117,77119,0,2,2
22052,1,3,77118,77119,77122,1,4,0
22053,2,2,77120,77122,77124,2,4,0
22054,4,3,77124,77124,77127,0,3,0
22055,4,1,77128,77128,77129,0,1,1
22056,3,3,77131,77131,77134,0,3,2
22057,3,1,77134,77134,77135,0,1,0
22058,2,2,77136,77136,77138,0,2,1
22059,6,1,77142,77142,77143,0,1,4
22060,2,1,77144,77144,77145,0,1,1
22061,3,3,77147,77147,77150,0,3,2
22062,3,3,77150,77150,77153,0,3,0
22063,1,1,77151,77153,77154,2,3,0
22064,5,2,77156,77156,77158,0,2,2
22065,3,3,77159,77159,77162,0,3,1
22066,6,3,77165,77165,77168,0,3,3
22067,5,1,77170,77170,77171,0,1,2
22068,1,2,77171,77171,77173,0,2,0
22069,1,2,77172,77173,77175,1,3,0
22070,1,2,77173,77175,77177,2,4,0
22071,6,2,77179,77179,77181,0,2,2
22072,2,1,77181,77181,77182,0,1,0
22073,3,1,77184,77184,77185,0,1,2
22074,6,1,77190,77190,77191,0,1,5
22075,3,1,77193,77193,77194,0,1,2
22076,2,2,77195,77195,77197,0,2,1
22077,5,3,77200,77200,77203,0,3,3
22078,5,3,77205,77205,77208,0,3,2
22079,2,2,77207,77208,77210,1,3,0
22080,2,3,77209,77210,77213,1,4,0
22081,2,1,77211,77213,77214,2,3,0
22082,6,3,77217,77217,77220,0,3,3
22083,6,1,77223,77223,77224,0,1,3
22084,6,1,77229,77229,77230,0,1,5
22085,5,1,77234,77234,77235,0,1,4
22086,3,2,77237,77237,77239,0,2,2
22087,1,2,77238,77239,77241,1,3,0
22088,1,2,77239,77241,77243,2,4,0
22089,2,3,77241,77243,77246,2,5,0
22090,6,2,77247,77247,77249,0,2,1
22091,4,1,77251,77251,77252,0,1,2
22092,4,2,77255,77255,77257,0,2,3
22093,2,3,77257,77257,77260,0,3,0
22094,5,1,77262,77262,77263,0,1,2
22095,5,3,77267,77267,77270,0,3,4
22096,3,3,77270,77270,77273,0,3,0
22097,2,2,77272,77273,77275,1,3,0
22098,2,1,77274,77275,77276,1,2,0
22099,3,1,77277,77277,77278,0,1,1
22100,2,2,77279,77279,77281,0,2,1
22101,2,3,77281,77281,77284,0,3,0
22102,5,1,77286,77286,77287,0,1,2
22103,5,1,77291,77291,77292,0,1,4
22104,6,1,77297,77297,77298,0,1,5
22105,6,2,77303,77303,77305,0,2,5
22106,2,1,77305,77305,77306,0,1,0
22107,6,1,77311,77311,77312,0,1,5
22108,6,1,77317,77317,77318,0,1,5
22109,4,2,77321,77321,77323,0,2,3
22110,4,1,77325,77325,77326,0,1,2
22111,2,1,77327,77327,77328,0,1,1
22112,4,2,77331,77331,77333,0,2,3
22113,4,3,77335,77335,77338,0,3,2
22114,2,2,77337,77338,77340,1,3,0
22115,1,3,77338,77340,77343,2,5,0
22116,5,3,77343,77343,77346,0,3,0
22117,1,2,77344,77346,77348,2,4,0
22118,2,1,77346,77348,77349,2,3,0
22119,1,2,77347,77349,77351,2,4,0
22120,4,1,77351,77351,77352,0,1,0
22121,2,1,77353,77353,77354,0,1,1
22122,1,1,77354,77354,77355,0,1,0
22123,5,3,77359,77359,77362,0,3,4
22124,1,3,77360,77362,77365,2,5,0
22125,6,3,77366,77366,77369,0,3,1
22126,3,3,77369,77369,77372,0,3,0
22127,6,3,77375,77375,77378,0,3,3
22128,3,3,77378,77378,77381,0,3,0
22129,1,2,77379,77381,77383,2,4,0
22130,3,2,77382,77383,77385,1,3,0
22131,3,1,77385,77385,77386,0,1,0
22132,6,2,77391,77391,77393,0,2,5
22133,4,1,77395,77395,77396,0,1,2
22134,1,3,77396,77396,77399,0,3,0
22135,2,2,77398,77399,77401,1,3,0
22136,2,2,77400,77401,77403,1,3,0
22137,6,3,77406,77406,77409,0,3,3
22138,1,1,77407,77409,77410,2,3,0
22139,1,2,77408,77410,77412,2,4,0
22140,2,1,77410,77412,77413,2,3,0
22141,2,1,77412,77413,77414,1,2,0
22142,2,1,77414,77414,77415,0,1,0
22143,6,2,77420,77420,77422,0,2,5
22144,4,2,77424,77424,77426,0,2,2
22145,4,1,77428,77428,77429,0,1,2
22146,1,2,77429,77429,77431,0,2,0
22147,1,1,77430,77431,77432,1,2,0
22148,5,1,77435,77435,77436,0,1,3
22149,2,2,77437,77437,77439,0,2,1
22150,1,2,77438,77439,77441,1,3,0
22151,1,1,77439,77441,77442,2,3,0
22152,5,3,77444,77444,77447,0,3,2
22153,4,3,77448,77448,77451,0,3,1
22154,3,1,77451,77451,77452,0,1,0
22155,2,1,77453,77453,77454,0,1,1
22156,5,1,77458,77458,77459,0,1,4
22157,4,3,77462,77462,77465,0,3,3
22158,3,2,77465,77465,77467,0,2,0
22159,6,2,77471,77471,77473,0,2,4
22160,6,1,77477,77477,77478,0,1,4
22161,5,1,77482,77482,77483,0,1,4
22162,5,3,77487,77487,77490,0,3,4
22163,4,1,77491,77491,77492,0,1,1
22164,5,1,77496,77496,77497,0,1,4
22165,6,3,77502,77502,77505,0,3,5
22166,4,3,77506,77506,77509,0,3,1
22167,1,1,77507,77509,77510,2,3,0
22168,4,2,77511,77511,77513,0,2,1
22169,2,2,77513,77513,77515,0,2,0
22170,6,1,77519,77519,77520,0,1,4
22171,2,3,77521,77521,77524,0,3,1
22172,5,3,77526,77526,77529,0,3,2
22173,6,3,77532,77532,77535,0,3,3
22174,1,3,77533,77535,77538,2,5,0
22175,5,2,77538,77538,77540,0,2,0
22176,1,2,77539,77540,77542,1,3,0
22177,4,1,77543,77543,77544,0,1,1
22178,3,3,77546,77546,77549,0,3,2
22179,3,2,77549,77549,77551,0,2,0
22180,6,2,77555,77555,77557,0,2,4
22181,6,1,77561,77561,77562,0,1,4
22182,1,2,77562,77562,77564,0,2,0
22183,4,1,77566,77566,77567,0,1,2
22184,3,1,77569,77569,77570,0,1,2
22185,4,3,77573,77573,77576,0,3,3
22186,2,3,77575,77576,77579,1,4,0
22187,1,2,77576,77579,77581,3,5,0
22188,4,3,77580,77581,77584,1,4,0
22189,5,1,77585,77585,77586,0,1,1
22190,4,3,77589,77589,77592,0,3,3
22191,3,1,77592,77592,77593,0,1,0
22192,2,1,77594,77594,77595,0,1,1
22193,3,1,77597,77597,77598,0,1,2
22194,2,2,77599,77599,77601,0,2,1
22195,6,1,77605,77605,77606,0,1,4
22196,4,1,77609,77609,77610,0,1,3
22197,5,1,77614,77614,77615,0,1,4
22198,6,3,77620,77620,77623,0,3,5
22199,2,1,77622,77623,77624,1,2,0
22200,5,3,77627,77627,77630,0,3,3
22201,3,2,77630,77630,77632,0,2,0
22202,4,1,77634,77634,77635,0,1,2
22203,6,3,77640,77640,77643,0,3,5
22204,2,3,77642,77643,77646,1,4,0
22205,5,3,77647,77647,77650,0,3,1
22206,5,1,77652,77652,77653,0,1,2
22207,2,3,77654,77654,77657,0,3,1
22208,1,1,77655,77657,77658,2,3,0
22209,4,3,77659,77659,77662,0,3,1
22210,3,2,77662,77662,77664,0,2,0
22211,6,3,77668,77668,77671,0,3,4
22212,4,3,77672,77672,77675,0,3,1
22213,6,2,77678,77678,77680,0,2,3
22214,5,1,77683,77683,77684,0,1,3
22215,4,3,77687,77687,77690,0,3,3
22216,1,1,77688,77690,77691,2,3,0
22217,2,3,77690,77691,77694,1,4,0
22218,3,3,77693,77694,77697,1,4,0
22219,1,3,77694,77697,77700,3,6,0
22220,1,2,77695,77700,77702,5,7,0
22221,3,1,77698,77702,77703,4,5,0
22222,2,1,77700,77703,77704,3,4,0
22223,4,3,77704,77704,77707,0,3,0
22224,1,2,77705,77707,77709,2,4,0
22225,1,3,77706,77709,77712,3,6,0
22226,6,1,77712,77712,77713,0,1,0
22227,5,1,77717,77717,77718,0,1,4
22228,3,2,77720,77720,77722,0,2,2
22229,3,2,77723,77723,77725,0,2,1
22230,2,1,77725,77725,77726,0,1,0
22231,1,1,77726,77726,77727,0,1,0
22232,2,1,77728,77728,77729,0,1,1
22233,2,2,77730,77730,77732,0,2,1
22234,2,1,77732,77732,77733,0,1,0
22235,2,2,77734,77734,77736,0,2,1
22236,4,3,77738,77738,77741,0,3,2
22237,6,3,77744,77744,77747,0,3,3
22238,3,2,77747,77747,77749,0,2,0
22239,6,2,77753,77753,77755,0,2,4
22240,4,2,77757,77757,77759,0,2,2
22241,6,2,77763,77763,77765,0,2,4
22242,6,2,77769,77769,77771,0,2,4
22243,1,2,77770,77771,77773,1,3,0
22244,5,1,77775,77775,77776,0,1,2
22245,5,2,77780,77780,77782,0,2,4
22246,2,2,77782,77782,77784,0,2,0
22247,2,1,77784,77784,77785,0,1,0
22248,5,3,77789,77789,77792,0,3,4
22249,1,2,77790,77792,77794,2,4,0
22250,6,3,77796,77796,77799,0,3,2
22251,1,1,77797,77799,77800,2,3,0
22252,5,3,77802,77802,77805,0,3,2
22253,6,1,77808,77808,77809,0,1,3
22254,2,2,77810,77810,77812,0,2,1
22255,4,1,77814,77814,77815,0,1,2
22256,3,3,77817,77817,77820,0,3,2
22257,3,3,77820,77820,77823,0,3,0
22258,3,1,77823,77823,77824,0,1,0
22259,1,1,77824,77824,77825,0,1,0
22260,6,1,77830,77830,77831,0,1,5
22261,5,1,77835,77835,77836,0,1,4
22262,5,2,77840,77840,77842,0,2,4
22263,1,2,77841,77842,77844,1,3,0
22264,6,1,77847,77847,77848,0,1,3
22265,4,3,77851,77851,77854,0,3,3
22266,4,2,77855,77855,77857,0,2,1
22267,3,1,77858,77858,77859,0,1,1
22268,3,3,77861,77861,77864,0,3,2
22269,6,2,77867,77867,77869,0,2,3
22270,5,1,77872,77872,77873,0,1,3
22271,2,1,77874,77874,77875,0,1,1
22272,3,1,77877,77877,77878,0,1,2
22273,4,1,77881,77881,77882,0,1,3
22274,1,2,77882,77882,77884,0,2,0
22275,3,2,77885,77885,77887,0,2,1
22276,6,1,77891,77891,77892,0,1,4
22277,4,2,77895,77895,77897,0,2,3
22278,1,2,77896,77897,77899,1,3,0
22279,6,2,77902,77902,77904,0,2,3
22280,4,3,77906,77906,77909,0,3,2
22281,6,2,77912,77912,77914,0,2,3
22282,3,1,77915,77915,77916,0,1,1
22283,2,2,77917,77917,77919,0,2,1
22284,2,3,77919,77919,77922,0,3,0
22285,4,2,77923,77923,77925,0,2,1
22286,3,1,77926,77926,77927,0,1,1
22287,1,3,77927,77927,77930,0,3,0
22288,3,1,77930,77930,77931,0,1,0
22289,2,3,77932,77932,77935,0,3,1
22290,1,2,77933,77935,77937,2,4,0
22291,4,2,77937,77937,77939,0,2,0
22292,1,3,77938,77939,77942,1,4,0
22293,3,3,77941,77942,77945,1,4,0
22294,3,1,77944,77945,77946,1,2,0
22295,1,3,77945,77946,77949,1,4,0
22296,3,1,77948,77949,77950,1,2,0
22297,3,1,77951,77951,77952,0,1,1
22298,6,1,77957,77957,77958,0,1,5
22299,4,2,77961,77961,77963,0,2,3
22300,1,1,77962,77963,77964,1,2,0
22301,1,2,77963,77964,77966,1,3,0
22302,6,1,77969,77969,77970,0,1,3
22303,4,1,77973,77973,77974,0,1,3
22304,5,1,77978,77978,77979,0,1,4
22305,6,1,77984,77984,77985,0,1,5
22306,3,1,77987,77987,77988,0,1,2
22307,1,1,77988,77988,77989,0,1,0
22308,6,2,77994,77994,77996,0,2,5
22309,3,1,77997,77997,77998,0,1,1
22310,5,3,78002,78002,78005,0,3,4
22311,1,1,78003,78005,78006,2,3,0
22312,1,1,78004,78006,78007,2,3,0
22313,4,3,78008,78008,78011,0,3,1
22314,3,3,78011,78011,78014,0,3,0
22315,1,1,78012,78014,78015,2,3,0
22316,1,3,78013,78015,78018,2,5,0
22317,3,1,78016,78018,78019,2,3,0
22318,5,1,78021,78021,78022,0,1,2
22319,1,1,78022,78022,78023,0,1,0
22320,6,2,78028,78028,78030,0,2,5
22321,2,2,78030,78030,78032,0,2,0
22322,4,1,78034,78034,78035,0,1,2
22323,6,1,78040,78040,78041,0,1,5
22324,1,2,78041,78041,78043,0,2,0
22325,2,1,78043,78043,78044,0,1,0
22326,3,3,78046,78046,78049,0,3,2
22327,5,3,78051,78051,78054,0,3,2
22328,6,1,78057,78057,78058,0,1,3
22329,5,1,78062,78062,78063,0,1,4
22330,1,2,78063,78063,78065,0,2,0
22331,5,2,78068,78068,78070,0,2,3
22332,4,3,78072,78072,78075,0,3,2
22333,4,1,78076,78076,78077,0,1,1
22334,6,1,78082,78082,78083,0,1,5
22335,4,3,78086,78086,78089,0,3,3
22336,4,1,78090,78090,78091,0,1,1
22337,3,3,78093,78093,78096,0,3,2
22338,3,2,78096,78096,78098,0,2,0
22339,5,2,78101,78101,78103,0,2,3
22340,5,3,78106,78106,78109,0,3,3
22341,4,2,78110,78110,78112,0,2,1
22342,4,3,78114,78114,78117,0,3,2
22343,5,1,78119,78119,78120,0,1,2
22344,2,1,78121,78121,78122,0,1,1
22345,1,3,78122,78122,78125,0,3,0
22346,3,1,78125,78125,78126,0,1,0
22347,6,2,78131,78131,78133,0,2,5
22348,3,3,78134,78134,78137,0,3,1
22349,4,3,78138,78138,78141,0,3,1
22350,4,1,78142,78142,78143,0,1,1
22351,2,3,78144,78144,78147,0,3,1
22352,3,3,78147,78147,78150,0,3,0
22353,4,2,78151,78151,78153,0,2,1
22354,2,2,78153,78153,78155,0,2,0
22355,4,3,78157,78157,78160,0,3,2
22356,2,3,78159,78160,78163,1,4,0
22357,4,3,78163,78163,78166,0,3,0
22358,4,1,78167,78167,78168,0,1,1
22359,3,1,78170,78170,78171,0,1,2
22360,4,3,78174,78174,78177,0,3,3
22361,5,2,78179,78179,78181,0,2,2
22362,1,1,78180,78181,78182,1,2,0
22363,4,3,78184,78184,78187,0,3,2
22364,4,3,78188,78188,78191,0,3,1
22365,1,2,78189,78191,78193,2,4,0
22366,2,1,78191,78193,78194,2,3,0
22367,5,3,78196,78196,78199,0,3,2
22368,2,2,78198,78199,78201,1,3,0
22369,5,3,78203,78203,78206,0,3,2
22370,2,3,78205,78206,78209,1,4,0
22371,4,3,78209,78209,78212,0,3,0
22372,3,2,78212,78212,78214,0,2,0
22373,6,2,78218,78218,78220,0,2,4
22374,6,1,78224,78224,78225,0,1,4
22375,1,3,78225,78225,78228,0,3,0
22376,1,2,78226,78228,78230,2,4,0
22377,1,3,78227,78230,78233,3,6,0
22378,2,2,78229,78233,78235,4,6,0
22379,6,1,78235,78235,78236,0,1,0
22380,2,3,78237,78237,78240,0,3,1
22381,1,1,78238,78240,78241,2,3,0
22382,1,2,78239,78241,78243,2,4,0
22383,4,2,78243,78243,78245,0,2,0
22384,1,3,78244,78245,78248,1,4,0
22385,2,2,78246,78248,78250,2,4,0
22386,3,2,78249,78250,78252,1,3,0
22387,1,2,78250,78252,78254,2,4,0
22388,5,2,78255,78255,78257,0,2,1
22389,6,2,78261,78261,78263,0,2,4
22390,6,2,78267,78267,78269,0,2,4
22391,3,2,78270,78270,78272,0,2,1
22392,3,3,78273,78273,78276,0,3,1
22393,4,1,78277,78277,78278,0,1,1
22394,1,2,78278,78278,78280,0,2,0
22395,1,2,78279,78280,78282,1,3,0
22396,3,3,78282,78282,78285,0,3,0
22397,2,2,78284,78285,78287,1,3,0
22398,1,3,78285,78287,78290,2,5,0
22399,1,1,78286,78290,78291,4,5,0
22400,4,2,78290,78291,78293,1,3,0
22401,5,2,78295,78295,78297,0,2,2
22402,5,3,78300,78300,78303,0,3,3
22403,4,3,78304,78304,78307,0,3,1
22404,4,1,78308,78308,78309,0,1,1
22405,1,2,78309,78309,78311,0,2,0
22406,3,1,78312,78312,78313,0,1,1
22407,3,1,78315,78315,78316,0,1,2
22408,5,3,78320,78320,78323,0,3,4
22409,6,1,78326,78326,78327,0,1,3
22410,5,3,78331,78331,78334,0,3,4
22411,4,1,78335,78335,78336,0,1,1
22412,6,1,78341,78341,78342,0,1,5
22413,6,1,78347,78347,78348,0,1,5
22414,2,3,78349,78349,78352,0,3,1
22415,3,3,78352,78352,78355,0,3,0
22416,4,2,78356,78356,78358,0,2,1
22417,2,1,78358,78358,78359,0,1,0
22418,3,2,78361,78361,78363,0,2,2
22419,6,3,78367,78367,78370,0,3,4
22420,2,2,78369,78370,78372,1,3,0
22421,4,2,78373,78373,78375,0,2,1
22422,1,3,78374,78375,78378,1,4,0
22423,4,1,78378,78378,78379,0,1,0
22424,6,1,78384,78384,78385,0,1,5
22425,5,2,78389,78389,78391,0,2,4
22426,5,2,78394,78394,78396,0,2,3
22427,6,3,78400,78400,78403,0,3,4
22428,3,3,78403,78403,78406,0,3,0
22429,2,3,78405,78406,78409,1,4,0
22430,5,1,78410,78410,78411,0,1,1
22431,1,3,78411,78411,78414,0,3,0
22432,4,1,78415,78415,78416,0,1,1
22433,2,1,78417,78417,78418,0,1,1
22434,4,3,78421,78421,78424,0,3,3
22435,3,2,78424,78424,78426,0,2,0
22436,6,1,78430,78430,78431,0,1,4
22437,6,2,78436,78436,78438,0,2,5
22438,5,3,78441,78441,78444,0,3,3
22439,3,2,78444,78444,78446,0,2,0
22440,6,2,78450,78450,78452,0,2,4
22441,4,1,78454,78454,78455,0,1,2
22442,2,3,78456,78456,78459,0,3,1
22443,5,2,78461,78461,78463,0,2,2
22444,2,2,78463,78463,78465,0,2,0
22445,3,2,78466,78466,78468,0,2,1
22446,1,3,78467,78468,78471,1,4,0
22447,1,3,78468,78471,78474,3,6,0
22448,4,2,78472,78474,78476,2,4,0
22449,6,1,78478,78478,78479,0,1,2
22450,1,1,78479,78479,78480,0,1,0
22451,5,1,78484,78484,78485,0,1,4
22452,6,3,78490,78490,78493,0,3,5
22453,3,1,78493,78493,78494,0,1,0
22454,4,3,78497,78497,78500,0,3,3
22455,6,2,78503,78503,78505,0,2,3
22456,2,3,78505,78505,78508,0,3,0
22457,4,2,78509,78509,78511,0,2,1
22458,3,3,78512,78512,78515,0,3,1
22459,1,3,78513,78515,78518,2,5,0
22460,5,2,78518,78518,78520,0,2,0
22461,1,2,78519,78520,78522,1,3,0
22462,1,3,78520,78522,78525,2,5,0
22463,5,2,78525,78525,78527,0,2,0
22464,5,2,78530,78530,78532,0,2,3
22465,3,3,78533,78533,78536,0,3,1
22466,6,3,78539,78539,78542,0,3,3
22467,1,3,78540,78542,78545,2,5,0
22468,3,2,78543,78545,78547,2,4,0
22469,3,2,78546,78547,78549,1,3,0
22470,3,3,78549,78549,78552,0,3,0
22471,3,2,78552,78552,78554,0,2,0
22472,1,1,78553,78554,78555,1,2,0
22473,1,2,78554,78555,78557,1,3,0
22474,4,2,78558,78558,78560,0,2,1
22475,2,2,78560,78560,78562,0,2,0
22476,2,2,78562,78562,78564,0,2,0
22477,6,3,78568,78568,78571,0,3,4
22478,3,3,78571,78571,78574,0,3,0
22479,1,1,78572,78574,78575,2,3,0
22480,1,3,78573,78575,78578,2,5,0
22481,1,2,78574,78578,78580,4,6,0
22482,6,1,78580,78580,78581,0,1,0
22483,5,1,78585,78585,78586,0,1,4
22484,4,3,78589,78589,78592,0,3,3
22485,3,3,78592,78592,78595,0,3,0
22486,1,1,78593,78595,78596,2,3,0
22487,3,3,78596,78596,78599,0,3,0
22488,6,1,78602,78602,78603,0,1,3
22489,6,2,78608,78608,78610,0,2,5
22490,2,1,78610,78610,78611,0,1,0
22491,3,3,78613,78613,78616,0,3,2
22492,1,3,78614,78616,78619,2,5,0
22493,5,1,78619,78619,78620,0,1,0
22494,2,1,78621,78621,78622,0,1,1
22495,5,3,78626,78626,78629,0,3,4
22496,3,3,78629,78629,78632,0,3,0
22497,3,2,78632,78632,78634,0,2,0
22498,5,3,78637,78637,78640,0,3,3
22499,5,3,78642,78642,78645,0,3,2
22500,2,3,78644,78645,78648,1,4,0
22501,1,2,78645,78648,78650,3,5,0
22502,1,3,78646,78650,78653,4,7,0
22503,6,3,78652,78653,78656,1,4,0
22504,6,1,78658,78658,78659,0,1,2
22505,3,1,78661,78661,78662,0,1,2
22506,5,3,78666,78666,78669,0,3,4
22507,3,1,78669,78669,78670,0,1,0
22508,2,2,78671,78671,78673,0,2,1
22509,6,2,78677,78677,78679,0,2,4
22510,5,1,78682,78682,78683,0,1,3
22511,2,2,78684,78684,78686,0,2,1
22512,5,3,78689,78689,78692,0,3,3
22513,1,2,78690,78692,78694,2,4,0
22514,6,3,78696,78696,78699,0,3,2
22515,1,3,78697,78699,78702,2,5,0
22516,6,3,78703,78703,78706,0,3,1
22517,4,3,78707,78707,78710,0,3,1
22518,1,3,78708,78710,78713,2,5,0
22519,1,3,78709,78713,78716,4,7,0
22520,2,2,78711,78716,78718,5,7,0
22521,6,3,78717,78718,78721,1,4,0
22522,4,3,78721,78721,78724,0,3,0
22523,5,2,78726,78726,78728,0,2,2
22524,5,2,78731,78731,78733,0,2,3
22525,4,1,78735,78735,78736,0,1,2
22526,2,2,78737,78737,78739,0,2,1
22527,3,1,78740,78740,78741,0,1,1
22528,1,3,78741,78741,78744,0,3,0
22529,3,3,78744,78744,78747,0,3,0
22530,5,2,78749,78749,78751,0,2,2
22531,6,1,78755,78755,78756,0,1,4
22532,3,3,78758,78758,78761,0,3,2
22533,2,3,78760,78761,78764,1,4,0
22534,2,1,78762,78764,78765,2,3,0
22535,6,3,78768,78768,78771,0,3,3
22536,3,1,78771,78771,78772,0,1,0
22537,3,1,78774,78774,78775,0,1,2
22538,3,1,78777,78777,78778,0,1,2
22539,4,3,78781,78781,78784,0,3,3
22540,4,1,78785,78785,78786,0,1,1
22541,5,2,78790,78790,78792,0,2,4
22542,6,3,78796,78796,78799,0,3,4
22543,1,2,78797,78799,78801,2,4,0
22544,6,1,78803,78803,78804,0,1,2
22545,1,1,78804,78804,78805,0,1,0
22546,5,3,78809,78809,78812,0,3,4
22547,3,2,78812,78812,78814,0,2,0
22548,3,2,78815,78815,78817,0,2,1
22549,4,3,78819,78819,78822,0,3,2
22550,2,1,78821,78822,78823,1,2,0
22551,3,1,78824,78824,78825,0,1,1
22552,4,2,78828,78828,78830,0,2,3
22553,5,1,78833,78833,78834,0,1,3
22554,6,1,78839,78839,78840,0,1,5
22555,5,3,78844,78844,78847,0,3,4
22556,1,1,78845,78847,78848,2,3,0
22557,2,2,78847,78848,78850,1,3,0
22558,5,1,78852,78852,78853,0,1,2
22559,4,3,78856,78856,78859,0,3,3
22560,4,2,78860,78860,78862,0,2,1
22561,5,1,78865,78865,78866,0,1,3
22562,4,1,78869,78869,78870,0,1,3
22563,4,3,78873,78873,78876,0,3,3
22564,6,3,78879,78879,78882,0,3,3
22565,5,1,78884,78884,78885,0,1,2
22566,3,3,78887,78887,78890,0,3,2
22567,5,3,78892,78892,78895,0,3,2
22568,5,1,78897,78897,78898,0,1,2
22569,6,3,78903,78903,78906,0,3,5
22570,3,2,78906,78906,78908,0,2,0
22571,4,3,78910,78910,78913,0,3,2
22572,5,1,78915,78915,78916,0,1,2
22573,5,1,78920,78920,78921,0,1,4
22574,3,2,78923,78923,78925,0,2,2
22575,6,1,78929,78929,78930,0,1,4
22576,3,3,78932,78932,78935,0,3,2
22577,5,3,78937,78937,78940,0,3,2
22578,1,2,78938,78940,78942,2,4,0
22579,4,2,78942,78942,78944,0,2,0
22580,6,3,78948,78948,78951,0,3,4
22581,1,1,78949,78951,78952,2,3,0
22582,6,2,78955,78955,78957,0,2,3
22583,1,2,78956,78957,78959,1,3,0
22584,3,2,78959,78959,78961,0,2,0
22585,6,1,78965,78965,78966,0,1,4
22586,6,2,78971,78971,78973,0,2,5
22587,3,2,78974,78974,78976,0,2,1
22588,5,2,78979,78979,78981,0,2,3
22589,6,3,78985,78985,78988,0,3,4
22590,1,3,78986,78988,78991,2,5,0
22591,3,2,78989,78991,78993,2,4,0
22592,5,3,78994,78994,78997,0,3,1
22593,6,3,79000,79000,79003,0,3,3
22594,3,1,79003,79003,79004,0,1,0
22595,1,2,79004,79004,79006,0,2,0
22596,1,3,79005,79006,79009,1,4,0
22597,6,1,79011,79011,79012,0,1,2
22598,1,1,79012,79012,79013,0,1,0
22599,4,2,79016,79016,79018,0,2,3
22600,1,2,79017,79018,79020,1,3,0
22601,2,3,79019,79020,79023,1,4,0
22602,5,2,79024,79024,79026,0,2,1
22603,5,3,79029,79029,79032,0,3,3
22604,5,1,79034,79034,79035,0,1,2
22605,1,1,79035,79035,79036,0,1,0
22606,2,2,79037,79037,79039,0,2,1
22607,3,1,79040,79040,79041,0,1,1
22608,2,3,79042,79042,79045,0,3,1
22609,6,1,79048,79048,79049,0,1,3
22610,3,1,79051,79051,79052,0,1,2
22611,3,1,79054,79054,79055,0,1,2
22612,3,2,79057,79057,79059,0,2,2
22613,6,1,79063,79063,79064,0,1,4
22614,6,2,79069,79069,79071,0,2,5
22615,5,1,79074,79074,79075,0,1,3
22616,2,2,79076,79076,79078,0,2,1
22617,3,1,79079,79079,79080,0,1,1
22618,4,1,79083,79083,79084,0,1,3
22619,2,1,79085,79085,79086,0,1,1
22620,3,3,79088,79088,79091,0,3,2
22621,4,1,79092,79092,79093,0,1,1
22622,5,1,79097,79097,79098,0,1,4
22623,6,1,79103,79103,79104,0,1,5
22624,2,1,79105,79105,79106,0,1,1
22625,5,2,79110,79110,79112,0,2,4
22626,4,1,79114,79114,79115,0,1,2
22627,5,2,79119,79119,79121,0,2,4
22628,6,3,79125,79125,79128,0,3,4
22629,2,3,79127,79128,79131,1,4,0
22630,5,3,79132,79132,79135,0,3,1
22631,6,3,79138,79138,79141,0,3,3
22632,3,2,79141,79141,79143,0,2,0
22633,2,1,79143,79143,79144,0,1,0
22634,3,2,79146,79146,79148,0,2,2
22635,2,1,79148,79148,79149,0,1,0
22636,6,1,79154,79154,79155,0,1,5
22637,1,3,79155,79155,79158,0,3,0
22638,1,2,79156,79158,79160,2,4,0
22639,1,3,79157,79160,79163,3,6,0
22640,4,3,79161,79163,79166,2,5,0
22641,5,2,79166,79166,79168,0,2,0
22642,3,2,79169,79169,79171,0,2,1
22643,6,1,79175,79175,79176,0,1,4
22644,6,2,79181,79181,79183,0,2,5
22645,1,3,79182,79183,79186,1,4,0
22646,5,2,79187,79187,79189,0,2,1
22647,5,3,79192,79192,79195,0,3,3
22648,5,1,79197,79197,79198,0,1,2
22649,6,1,79203,79203,79204,0,1,5
22650,3,1,79206,79206,79207,0,1,2
22651,2,3,79208,79208,79211,0,3,1
22652,2,3,79210,79211,79214,1,4,0
22653,1,2,79211,79214,79216,3,5,0
22654,1,1,79212,79216,79217,4,5,0
22655,6,2,79218,79218,79220,0,2,1
22656,3,1,79221,79221,79222,0,1,1
22657,1,2,79222,79222,79224,0,2,0
22658,3,1,79225,79225,79226,0,1,1
22659,2,3,79227,79227,79230,0,3,1
22660,5,3,79232,79232,79235,0,3,2
22661,1,3,79233,79235,79238,2,5,0
22662,6,3,79239,79239,79242,0,3,1
22663,3,2,79242,79242,79244,0,2,0
22664,6,2,79248,79248,79250,0,2,4
22665,3,2,79251,79251,79253,0,2,1
22666,3,2,79254,79254,79256,0,2,1
22667,4,1,79258,79258,79259,0,1,2
22668,3,3,79261,79261,79264,0,3,2
22669,4,3,79265,79265,79268,0,3,1
22670,4,2,79269,79269,79271,0,2,1
22671,3,3,79272,79272,79275,0,3,1
22672,1,2,79273,79275,79277,2,4,0
22673,3,3,79276,79277,79280,1,4,0
22674,5,3,79281,79281,79284,0,3,1
22675,5,1,79286,79286,79287,0,1,2
22676,5,3,79291,79291,79294,0,3,4
22677,5,1,79296,79296,79297,0,1,2
22678,5,3,79301,79301,79304,0,3,4
22679,6,2,79307,79307,79309,0,2,3
22680,4,1,79311,79311,79312,0,1,2
22681,5,2,79316,79316,79318,0,2,4
22682,3,3,79319,79319,79322,0,3,1
22683,6,2,79325,79325,79327,0,2,3
22684,2,3,79327,79327,79330,0,3,0
22685,4,2,79331,79331,79333,0,2,1
22686,1,1,79332,79333,79334,1,2,0
22687,5,2,79337,79337,79339,0,2,3
22688,2,3,79339,79339,79342,0,3,0
22689,1,3,79340,79342,79345,2,5,0
22690,5,1,79345,79345,79346,0,1,0
22691,1,1,79346,79346,79347,0,1,0
22692,2,2,79348,79348,79350,0,2,1
22693,4,1,79352,79352,79353,0,1,2
22694,3,1,79355,79355,79356,0,1,2
22695,6,3,79361,79361,79364,0,3,5
22696,4,3,79365,79365,79368,0,3,1
22697,4,3,79369,79369,79372,0,3,1
22698,5,1,79374,79374,79375,0,1,2
22699,2,2,79376,79376,79378,0,2,1
22700,4,1,79380,79380,79381,0,1,2
22701,2,2,79382,79382,79384,0,2,1
22702,5,2,79387,79387,79389,0,2,3
22703,6,1,79393,79393,79394,0,1,4
22704,5,3,79398,79398,79401,0,3,4
22705,2,2,79400,79401,79403,1,3,0
22706,5,1,79405,79405,79406,0,1,2
22707,2,3,79407,79407,79410,0,3,1
22708,2,3,79409,79410,79413,1,4,0
22709,3,3,79412,79413,79416,1,4,0
22710,6,1,79418,79418,79419,0,1,2
22711,4,1,79422,79422,79423,0,1,3
22712,1,1,79423,79423,79424,0,1,0
22713,1,3,79424,79424,79427,0,3,0
22714,4,1,79428,79428,79429,0,1,1
22715,4,3,79432,79432,79435,0,3,3
22716,5,1,79437,79437,79438,0,1,2
22717,3,2,79440,79440,79442,0,2,2
22718,2,3,79442,79442,79445,0,3,0
22719,5,2,79447,79447,79449,0,2,2
22720,6,2,79453,79453,79455,0,2,4
22721,5,3,79458,79458,79461,0,3,3
22722,3,1,79461,79461,79462,0,1,0
22723,2,3,79463,79463,79466,0,3,1
22724,4,3,79467,79467,79470,0,3,1
22725,6,3,79473,79473,79476,0,3,3
22726,4,1,79477,79477,79478,0,1,1
22727,6,3,79483,79483,79486,0,3,5
22728,4,1,79487,79487,79488,0,1,1
22729,4,2,79491,79491,79493,0,2,3
22730,3,1,79494,79494,79495,0,1,1
22731,1,1,79495,79495,79496,0,1,0
22732,6,3,79501,79501,79504,0,3,5
22733,5,2,79506,79506,79508,0,2,2
22734,4,2,79510,79510,79512,0,2,2
22735,5,1,79515,79515,79516,0,1,3
22736,2,1,79517,79517,79518,0,1,1
22737,5,3,79522,79522,79525,0,3,4
22738,6,3,79528,79528,79531,0,3,3
22739,1,3,79529,79531,79534,2,5,0
22740,4,1,79533,79534,79535,1,2,0
22741,4,2,79537,79537,79539,0,2,2
22742,4,1,79541,79541,79542,0,1,2
22743,6,3,79547,79547,79550,0,3,5
22744,1,2,79548,79550,79552,2,4,0
22745,6,2,79554,79554,79556,0,2,2
22746,3,3,79557,79557,79560,0,3,1
22747,3,2,79560,79560,79562,0,2,0
22748,4,1,79564,79564,79565,0,1,2
22749,3,3,79567,79567,79570,0,3,2
22750,2,2,79569,79570,79572,1,3,0
22751,1,3,79570,79572,79575,2,5,0
22752,2,2,79572,79575,79577,3,5,0
22753,2,1,79574,79577,79578,3,4,0
22754,6,3,79580,79580,79583,0,3,2
22755,1,1,79581,79583,79584,2,3,0
22756,6,2,79587,79587,79589,0,2,3
22757,5,2,79592,79592,79594,0,2,3
22758,4,3,79596,79596,79599,0,3,2
22759,6,2,79602,79602,79604,0,2,3
22760,3,1,79605,79605,79606,0,1,1
22761,2,1,79607,79607,79608,0,1,1
22762,5,1,79612,79612,79613,0,1,4
22763,1,1,79613,79613,79614,0,1,0
22764,6,1,79619,79619,79620,0,1,5
22765,3,3,79622,79622,79625,0,3,2
22766,2,2,79624,79625,79627,1,3,0
22767,3,3,79627,79627,79630,0,3,0
22768,1,1,79628,79630,79631,2,3,0
22769,4,2,79632,79632,79634,0,2,1
22770,4,1,79636,79636,79637,0,1,2
22771,5,1,79641,79641,79642,0,1,4
22772,4,1,79645,79645,79646,0,1,3
22773,3,2,79648,79648,79650,0,2,2
22774,1,2,79649,79650,79652,1,3,0
22775,5,2,79654,79654,79656,0,2,2
22776,5,1,79659,79659,79660,0,1,3
22777,3,2,79662,79662,79664,0,2,2
22778,6,1,79668,79668,79669,0,1,4
22779,6,2,79674,79674,79676,0,2,5
22780,1,2,79675,79676,79678,1,3,0
22781,3,2,79678,79678,79680,0,2,0
22782,4,1,79682,79682,79683,0,1,2
22783,5,1,79687,79687,79688,0,1,4
22784,6,2,79693,79693,79695,0,2,5
22785,5,2,79698,79698,79700,0,2,3
22786,2,1,79700,79700,79701,0,1,0
22787,2,1,79702,79702,79703,0,1,1
22788,3,1,79705,79705,79706,0,1,2
22789,1,3,79706,79706,79709,0,3,0
22790,4,1,79710,79710,79711,0,1,1
22791,3,1,79713,79713,79714,0,1,2
22792,5,1,79718,79718,79719,0,1,4
22793,1,3,79719,79719,79722,0,3,0
22794,3,2,79722,79722,79724,0,2,0
22795,1,3,79723,79724,79727,1,4,0
22796,5,2,79728,79728,79730,0,2,1
22797,3,3,79731,79731,79734,0,3,1
22798,4,1,79735,79735,79736,0,1,1
22799,3,2,79738,79738,79740,0,2,2
22800,5,3,79743,79743,79746,0,3,3
22801,4,3,79747,79747,79750,0,3,1
22802,3,3,79750,79750,79753,0,3,0
22803,5,1,79755,79755,79756,0,1,2
22804,2,1,79757,79757,79758,0,1,1
22805,4,3,79761,79761,79764,0,3,3
22806,3,3,79764,79764,79767,0,3,0
22807,3,1,79767,79767,79768,0,1,0
22808,3,2,79770,79770,79772,0,2,2
22809,4,3,79774,79774,79777,0,3,2
22810,2,3,79776,79777,79780,1,4,0
22811,6,1,79782,79782,79783,0,1,2
22812,6,1,79788,79788,79789,0,1,5
22813,2,3,79790,79790,79793,0,3,1
22814,6,1,79796,79796,79797,0,1,3
22815,2,1,79798,79798,79799,0,1,1
22816,1,1,79799,79799,79800,0,1,0
22817,2,3,79801,79801,79804,0,3,1
22818,2,1,79803,79804,79805,1,2,0
22819,2,1,79805,79805,79806,0,1,0
22820,4,3,79809,79809,79812,0,3,3
22821,5,1,79814,79814,79815,0,1,2
22822,1,2,79815,79815,79817,0,2,0
22823,3,1,79818,79818,79819,0,1,1
22824,4,3,79822,79822,79825,0,3,3
22825,2,2,79824,79825,79827,1,3,0
22826,3,3,79827,79827,79830,0,3,0
22827,5,1,79832,79832,79833,0,1,2
22828,6,2,79838,79838,79840,0,2,5
22829,3,2,79841,79841,79843,0,2,1
22830,2,1,79843,79843,79844,0,1,0
22831,1,2,79844,79844,79846,0,2,0
22832,6,1,79850,79850,79851,0,1,4
22833,3,3,79853,79853,79856,0,3,2
22834,3,2,79856,79856,79858,0,2,0
22835,6,1,79862,79862,79863,0,1,4
22836,4,1,79866,79866,79867,0,1,3
22837,2,3,79868,79868,79871,0,3,1
22838,4,3,79872,79872,79875,0,3,1
22839,5,2,79877,79877,79879,0,2,2
22840,3,2,79880,79880,79882,0,2,1
22841,2,1,79882,79882,79883,0,1,0
22842,1,3,79883,79883,79886,0,3,0
22843,3,2,79886,79886,79888,0,2,0
22844,1,2,79887,79888,79890,1,3,0
22845,3,3,79890,79890,79893,0,3,0
22846,1,3,79891,79893,79896,2,5,0
22847,3,2,79894,79896,79898,2,4,0
22848,6,2,79900,79900,79902,0,2,2
22849,6,3,79906,79906,79909,0,3,4
22850,2,2,79908,79909,79911,1,3,0
22851,6,2,79914,79914,79916,0,2,3
22852,4,1,79918,79918,79919,0,1,2
22853,4,3,79922,79922,79925,0,3,3
22854,3,3,79925,79925,79928,0,3,0
22855,3,3,79928,79928,79931,0,3,0
22856,1,1,79929,79931,79932,2,3,0
22857,4,1,79933,79933,79934,0,1,1
22858,1,1,79934,79934,79935,0,1,0
22859,6,2,79940,79940,79942,0,2,5
22860,6,1,79946,79946,79947,0,1,4
22861,6,2,79952,79952,79954,0,2,5
22862,2,2,79954,79954,79956,0,2,0
22863,5,3,79959,79959,79962,0,3,3
22864,4,1,79963,79963,79964,0,1,1
22865,3,3,79966,79966,79969,0,3,2
22866,3,2,79969,79969,79971,0,2,0
22867,1,2,79970,79971,79973,1,3,0
22868,2,3,79972,79973,79976,1,4,0
22869,6,1,79978,79978,79979,0,1,2
22870,4,3,79982,79982,79985,0,3,3
22871,3,3,79985,79985,79988,0,3,0
22872,3,3,79988,79988,79991,0,3,0
22873,1,1,79989,79991,79992,2,3,0
22874,5,3,79994,79994,79997,0,3,2
22875,3,2,79997,79997,79999,0,2,0
22876,5,2,80002,80002,80004,0,2,3
22877,2,3,80004,80004,80007,0,3,0
22878,2,2,80006,80007,80009,1,3,0
22879,2,1,80008,80009,80010,1,2,0
22880,1,3,80009,80010,80013,1,4,0
22881,5,2,80014,80014,80016,0,2,1
22882,3,2,80017,80017,80019,0,2,1
22883,3,3,80020,80020,80023,0,3,1
22884,4,2,80024,80024,80026,0,2,1
22885,4,1,80028,80028,80029,0,1,2
22886,1,1,80029,80029,80030,0,1,0
22887,2,2,80031,80031,80033,0,2,1
22888,4,2,80035,80035,80037,0,2,2
22889,2,1,80037,80037,80038,0,1,0
22890,2,3,80039,80039,80042,0,3,1
22891,2,1,80041,80042,80043,1,2,0
22892,5,1,80046,80046,80047,0,1,3
22893,6,2,80052,80052,80054,0,2,5
22894,5,3,80057,80057,80060,0,3,3
22895,1,3,80058,80060,80063,2,5,0
22896,5,2,80063,80063,80065,0,2,0
22897,2,2,80065,80065,80067,0,2,0
22898,6,2,80071,80071,80073,0,2,4
22899,5,3,80076,80076,80079,0,3,3
22900,4,3,80080,80080,80083,0,3,1
22901,1,1,80081,80083,80084,2,3,0
22902,4,1,80085,80085,80086,0,1,1
22903,5,3,80090,80090,80093,0,3,4
22904,1,1,80091,80093,80094,2,3,0
22905,4,3,80095,80095,80098,0,3,1
22906,1,3,80096,80098,80101,2,5,0
22907,4,2,80100,80101,80103,1,3,0
22908,4,1,80104,80104,80105,0,1,1
22909,5,1,80109,80109,80110,0,1,4
22910,1,2,80110,80110,80112,0,2,0
22911,4,2,80114,80114,80116,0,2,2
22912,3,3,80117,80117,80120,0,3,1
22913,3,3,80120,80120,80123,0,3,0
22914,1,3,80121,80123,80126,2,5,0
22915,2,1,80123,80126,80127,3,4,0
22916,5,2,80128,80128,80130,0,2,1
22917,2,1,80130,80130,80131,0,1,0
22918,6,1,80136,80136,80137,0,1,5
22919,1,1,80137,80137,80138,0,1,0
22920,6,1,80143,80143,80144,0,1,5
22921,1,3,80144,80144,80147,0,3,0
22922,5,1,80149,80149,80150,0,1,2
22923,2,3,80151,80151,80154,0,3,1
22924,6,3,80157,80157,80160,0,3,3
22925,5,3,80162,80162,80165,0,3,2
22926,3,3,80165,80165,80168,0,3,0
22927,1,3,80166,80168,80171,2,5,0
22928,3,3,80169,80171,80174,2,5,0
22929,5,1,80174,80174,80175,0,1,0
22930,4,2,80178,80178,80180,0,2,3
22931,4,1,80182,80182,80183,0,1,2
22932,2,1,80184,80184,80185,0,1,1
22933,1,1,80185,80185,80186,0,1,0
22934,2,1,80187,80187,80188,0,1,1
22935,5,1,80192,80192,80193,0,1,4
22936,3,1,80195,80195,80196,0,1,2
22937,4,2,80199,80199,80201,0,2,3
22938,6,3,80205,80205,80208,0,3,4
22939,5,1,80210,80210,80211,0,1,2
22940,3,3,80213,80213,80216,0,3,2
22941,2,1,80215,80216,80217,1,2,0
22942,6,1,80221,80221,80222,0,1,4
22943,6,1,80227,80227,80228,0,1,5
22944,4,3,80231,80231,80234,0,3,3
22945,1,3,80232,80234,80237,2,5,0
22946,6,3,80238,80238,80241,0,3,1
22947,3,1,80241,80241,80242,0,1,0
22948,6,2,80247,80247,80249,0,2,5
22949,1,3,80248,80249,80252,1,4,0
22950,6,1,80254,80254,80255,0,1,2
22951,1,2,80255,80255,80257,0,2,0
22952,6,1,80261,80261,80262,0,1,4
22953,5,1,80266,80266,80267,0,1,4
22954,2,3,80268,80268,80271,0,3,1
22955,4,2,80272,80272,80274,0,2,1
22956,4,3,80276,80276,80279,0,3,2
22957,4,1,80280,80280,80281,0,1,1
22958,1,2,80281,80281,80283,0,2,0
22959,1,2,80282,80283,80285,1,3,0
22960,3,1,80285,80285,80286,0,1,0
22961,6,3,80291,80291,80294,0,3,5
22962,1,1,80292,80294,80295,2,3,0
22963,3,3,80295,80295,80298,0,3,0
22964,3,1,80298,80298,80299,0,1,0
22965,6,3,80304,80304,80307,0,3,5
22966,2,1,80306,80307,80308,1,2,0
22967,2,2,80308,80308,80310,0,2,0
22968,2,3,80310,80310,80313,0,3,0
22969,2,2,80312,80313,80315,1,3,0
22970,6,3,80318,80318,80321,0,3,3
22971,3,3,80321,80321,80324,0,3,0
22972,6,1,80327,80327,80328,0,1,3
22973,3,3,80330,80330,80333,0,3,2
22974,2,1,80332,80333,80334,1,2,0
22975,1,2,80333,80334,80336,1,3,0
22976,1,1,80334,80336,80337,2,3,0
22977,2,3,80336,80337,80340,1,4,0
22978,3,3,80339,80340,80343,1,4,0
22979,2,3,80341,80343,80346,2,5,0
22980,1,2,80342,80346,80348,4,6,0
22981,5,1,80347,80348,80349,1,2,0
22982,1,2,80348,80349,80351,1,3,0
22983,3,2,80351,80351,80353,0,2,0
22984,3,2,80354,80354,80356,0,2,1
22985,2,1,80356,80356,80357,0,1,0
22986,3,3,80359,80359,80362,0,3,2
22987,5,2,80364,80364,80366,0,2,2
22988,6,2,80370,80370,80372,0,2,4
22989,5,3,80375,80375,80378,0,3,3
22990,4,1,80379,80379,80380,0,1,1
22991,2,3,80381,80381,80384,0,3,1
22992,4,2,80385,80385,80387,0,2,1
22993,3,1,80388,80388,80389,0,1,1
22994,3,1,80391,80391,80392,0,1,2
22995,4,2,80395,80395,80397,0,2,3
22996,3,1,80398,80398,80399,0,1,1
22997,1,1,80399,80399,80400,0,1,0
22998,2,3,80401,80401,80404,0,3,1
22999,3,3,80404,80404,80407,0,3,0
23000,3,3,80407,80407,80410,0,3,0
23001,5,1,80412,80412,80413,0,1,2
23002,6,2,80418,80418,80420,0,2,5
23003,1,2,80419,80420,80422,1,3,0
23004,1,2,80420,80422,80424,2,4,0
23005,3,3,80423,80424,80427,1,4,0
23006,5,3,80428,80428,80431,0,3,1
23007,3,3,80431,80431,80434,0,3,0
23008,6,3,80437,80437,80440,0,3,3
23009,6,1,80443,80443,80444,0,1,3
23010,1,2,80444,80444,80446,0,2,0
23011,5,1,80449,80449,80450,0,1,3
23012,4,1,80453,80453,80454,0,1,3
23013,2,1,80455,80455,80456,0,1,1
23014,1,2,80456,80456,80458,0,2,0
23015,6,3,80462,80462,80465,0,3,4
23016,3,1,80465,80465,80466,0,1,0
23017,1,2,80466,80466,80468,0,2,0
23018,3,3,80469,80469,80472,0,3,1
23019,2,1,80471,80472,80473,1,2,0
23020,6,3,80477,80477,80480,0,3,4
23021,6,1,80483,80483,80484,0,1,3
23022,5,3,80488,80488,80491,0,3,4
23023,5,1,80493,80493,80494,0,1,2
23024,2,3,80495,80495,80498,0,3,1
23025,6,3,80501,80501,80504,0,3,3
23026,2,2,80503,80504,80506,1,3,0
23027,3,1,80506,80506,80507,0,1,0
23028,5,3,80511,80511,80514,0,3,4
23029,6,2,80517,80517,80519,0,2,3
23030,6,1,80523,80523,80524,0,1,4
23031,2,3,80525,80525,80528,0,3,1
23032,2,1,80527,80528,80529,1,2,0
23033,1,1,80528,80529,80530,1,2,0
23034,4,3,80532,80532,80535,0,3,2
23035,6,1,80538,80538,80539,0,1,3
23036,6,1,80544,80544,80545,0,1,5
23037,4,3,80548,80548,80551,0,3,3
23038,6,3,80554,80554,80557,0,3,3
23039,5,1,80559,80559,80560,0,1,2
23040,3,1,80562,80562,80563,0,1,2
23041,4,2,80566,80566,80568,0,2,3
23042,2,1,80568,80568,80569,0,1,0
23043,6,1,80574,80574,80575,0,1,5
23044,2,2,80576,80576,80578,0,2,1
23045,3,1,80579,80579,80580,0,1,1
23046,2,1,80581,80581,80582,0,1,1
23047,1,3,80582,80582,80585,0,3,0
23048,6,2,80588,80588,80590,0,2,3
23049,5,1,80593,80593,80594,0,1,3
23050,4,3,80597,80597,80600,0,3,3
23051,6,1,80603,80603,80604,0,1,3
23052,5,1,80608,80608,80609,0,1,4
23053,4,1,80612,80612,80613,0,1,3
23054,5,2,80617,80617,80619,0,2,4
23055,5,3,80622,80622,80625,0,3,3
23056,3,3,80625,80625,80628,0,3,0
23057,2,1,80627,80628,80629,1,2,0
23058,1,1,80628,80629,80630,1,2,0
23059,3,1,80631,80631,80632,0,1,1
23060,5,2,80636,80636,80638,0,2,4
23061,6,3,80642,80642,80645,0,3,4
23062,2,1,80644,80645,80646,1,2,0
23063,3,2,80647,80647,80649,0,2,1
23064,6,1,80653,80653,80654,0,1,4
23065,3,2,80656,80656,80658,0,2,2
23066,3,1,80659,80659,80660,0,1,1
23067,2,1,80661,80661,80662,0,1,1
23068,6,3,80667,80667,80670,0,3,5
23069,1,1,80668,80670,80671,2,3,0
23070,3,2,80671,80671,80673,0,2,0
23071,6,3,80677,80677,80680,0,3,4
23072,2,3,80679,80680,80683,1,4,0
23073,1,3,80680,80683,80686,3,6,0
23074,2,1,80682,80686,80687,4,5,0
23075,4,3,80686,80687,80690,1,4,0
23076,2,3,80688,80690,80693,2,5,0
23077,5,2,80693,80693,80695,0,2,0
23078,3,3,80696,80696,80699,0,3,1
23079,3,3,80699,80699,80702,0,3,0
23080,1,2,80700,80702,80704,2,4,0
23081,1,2,80701,80704,80706,3,5,0
23082,6,3,80707,80707,80710,0,3,1
23083,1,1,80708,80710,80711,2,3,0
23084,1,1,80709,80711,80712,2,3,0
23085,6,3,80715,80715,80718,0,3,3
23086,6,3,80721,80721,80724,0,3,3
23087,1,1,80722,80724,80725,2,3,0
23088,2,3,80724,80725,80728,1,4,0
23089,1,1,80725,80728,80729,3,4,0
23090,4,2,80729,80729,80731,0,2,0
23091,2,2,80731,80731,80733,0,2,0
23092,4,2,80735,80735,80737,0,2,2
23093,3,3,80738,80738,80741,0,3,1
23094,6,2,80744,80744,80746,0,2,3
23095,2,2,80746,80746,80748,0,2,0
23096,2,1,80748,80748,80749,0,1,0
23097,1,3,80749,80749,80752,0,3,0
23098,6,3,80755,80755,80758,0,3,3
23099,4,3,80759,80759,80762,0,3,1
23100,4,1,80763,80763,80764,0,1,1
23101,2,2,80765,80765,80767,0,2,1
23102,6,1,80771,80771,80772,0,1,4
23103,6,2,80777,80777,80779,0,2,5
23104,1,1,80778,80779,80780,1,2,0
23105,3,1,80781,80781,80782,0,1,1
23106,3,3,80784,80784,80787,0,3,2
23107,1,3,80785,80787,80790,2,5,0
23108,6,3,80791,80791,80794,0,3,1
23109,2,2,80793,80794,80796,1,3,0
23110,3,1,80796,80796,80797,0,1,0
23111,2,1,80798,80798,80799,0,1,1
23112,5,2,80803,80803,80805,0,2,4
23113,1,2,80804,80805,80807,1,3,0
23114,4,2,80808,80808,80810,0,2,1
23115,1,1,80809,80810,80811,1,2,0
23116,6,2,80815,80815,80817,0,2,4
23117,3,1,80818,80818,80819,0,1,1
23118,3,3,80821,80821,80824,0,3,2
23119,4,3,80825,80825,80828,0,3,1
23120,2,3,80827,80828,80831,1,4,0
23121,1,2,80828,80831,80833,3,5,0
23122,2,1,80830,80833,80834,3,4,0
23123,1,2,80831,80834,80836,3,5,0
23124,5,3,80836,80836,80839,0,3,0
23125,6,2,80842,80842,80844,0,2,3
23126,5,2,80847,80847,80849,0,2,3
23127,5,1,80852,80852,80853,0,1,3
23128,4,1,80856,80856,80857,0,1,3
23129,6,2,80862,80862,80864,0,2,5
23130,3,1,80865,80865,80866,0,1,1
23131,5,2,80870,80870,80872,0,2,4
23132,2,3,80872,80872,80875,0,3,0
23133,6,2,80878,80878,80880,0,2,3
23134,1,3,80879,80880,80883,1,4,0
23135,5,1,80884,80884,80885,0,1,1
23136,3,1,80887,80887,80888,0,1,2
23137,2,3,80889,80889,80892,0,3,1
23138,1,2,80890,80892,80894,2,4,0
23139,2,1,80892,80894,80895,2,3,0
23140,1,2,80893,80895,80897,2,4,0
23141,2,3,80895,80897,80900,2,5,0
23142,1,1,80896,80900,80901,4,5,0
23143,3,1,80899,80901,80902,2,3,0
23144,3,3,80902,80902,80905,0,3,0
23145,1,3,80903,80905,80908,2,5,0
23146,1,3,80904,80908,80911,4,7,0
23147,1,3,80905,80911,80914,6,9,0
23148,3,2,80908,80914,80916,6,8,0
23149,2,3,80910,80916,80919,6,9,0
23150,3,3,80913,80919,80922,6,9,0
23151,4,2,80917,80922,80924,5,7,0
23152,4,1,80921,80924,80925,3,4,0
23153,2,1,80923,80925,80926,2,3,0
23154,6,2,80929,80929,80931,0,2,3
23155,1,2,80930,80931,80933,1,3,0
23156,2,3,80932,80933,80936,1,4,0
23157,3,2,80935,80936,80938,1,3,0
23158,3,3,80938,80938,80941,0,3,0
23159,3,3,80941,80941,80944,0,3,0
23160,3,1,80944,80944,80945,0,1,0
23161,1,2,80945,80945,80947,0,2,0
23162,5,2,80950,80950,80952,0,2,3
23163,1,1,80951,80952,80953,1,2,0
23164,1,2,80952,80953,80955,1,3,0
23165,2,2,80954,80955,80957,1,3,0
23166,4,3,80958,80958,80961,0,3,1
23167,6,3,80964,80964,80967,0,3,3
23168,2,1,80966,80967,80968,1,2,0
23169,3,2,80969,80969,80971,0,2,1
23170,3,1,80972,80972,80973,0,1,1
23171,5,3,80977,80977,80980,0,3,4
23172,1,3,80978,80980,80983,2,5,0
23173,3,1,80981,80983,80984,2,3,0
23174,3,3,80984,80984,80987,0,3,0
23175,4,2,80988,80988,80990,0,2,1
23176,4,1,80992,80992,80993,0,1,2
23177,2,3,80994,80994,80997,0,3,1
23178,6,2,81000,81000,81002,0,2,3
23179,6,1,81006,81006,81007,0,1,4
23180,1,2,81007,81007,81009,0,2,0
23181,5,2,81012,81012,81014,0,2,3
23182,2,3,81014,81014,81017,0,3,0
23183,2,3,81016,81017,81020,1,4,0
23184,6,2,81022,81022,81024,0,2,2
23185,6,2,81028,81028,81030,0,2,4
23186,3,2,81031,81031,81033,0,2,1
23187,2,1,81033,81033,81034,0,1,0
23188,5,1,81038,81038,81039,0,1,4
23189,1,2,81039,81039,81041,0,2,0
23190,4,3,81043,81043,81046,0,3,2
23191,5,2,81048,81048,81050,0,2,2
23192,2,3,81050,81050,81053,0,3,0
23193,4,1,81054,81054,81055,0,1,1
23194,6,3,81060,81060,81063,0,3,5
23195,3,3,81063,81063,81066,0,3,0
23196,5,2,81068,81068,81070,0,2,2
23197,6,3,81074,81074,81077,0,3,4
23198,4,3,81078,81078,81081,0,3,1
23199,2,1,81080,81081,81082,1,2,0
23200,1,2,81081,81082,81084,1,3,0
23201,4,1,81085,81085,81086,0,1,1
23202,2,1,81087,81087,81088,0,1,1
23203,1,1,81088,81088,81089,0,1,0
23204,4,2,81092,81092,81094,0,2,3
23205,2,3,81094,81094,81097,0,3,0
23206,5,1,81099,81099,81100,0,1,2
23207,4,3,81103,81103,81106,0,3,3
23208,4,2,81107,81107,81109,0,2,1
23209,6,3,81113,81113,81116,0,3,4
23210,2,3,81115,81116,81119,1,4,0
23211,2,1,81117,81119,81120,2,3,0
23212,3,3,81120,81120,81123,0,3,0
23213,6,3,81126,81126,81129,0,3,3
23214,5,2,81131,81131,81133,0,2,2
23215,6,2,81137,81137,81139,0,2,4
23216,3,3,81140,81140,81143,0,3,1
23217,3,1,81143,81143,81144,0,1,0
23218,1,2,81144,81144,81146,0,2,0
23219,5,1,81149,81149,81150,0,1,3
23220,6,1,81155,81155,81156,0,1,5
23221,1,3,81156,81156,81159,0,3,0
23222,2,1,81158,81159,81160,1,2,0
23223,1,1,81159,81160,81161,1,2,0
23224,2,3,81161,81161,81164,0,3,0
23225,6,3,81167,81167,81170,0,3,3
23226,6,1,81173,81173,81174,0,1,3
23227,4,3,81177,81177,81180,0,3,3
23228,1,1,81178,81180,81181,2,3,0
23229,5,3,81183,81183,81186,0,3,2
23230,2,1,81185,81186,81187,1,2,0
23231,1,1,81186,81187,81188,1,2,0
23232,2,3,81188,81188,81191,0,3,0
23233,5,1,81193,81193,81194,0,1,2
23234,3,2,81196,81196,81198,0,2,2
23235,6,1,81202,81202,81203,0,1,4
23236,2,3,81204,81204,81207,0,3,1
23237,1,2,81205,81207,81209,2,4,0
23238,1,2,81206,81209,81211,3,5,0
23239,4,2,81210,81211,81213,1,3,0
23240,4,2,81214,81214,81216,0,2,1
23241,3,3,81217,81217,81220,0,3,1
23242,4,1,81221,81221,81222,0,1,1
23243,2,3,81223,81223,81226,0,3,1
23244,3,3,81226,81226,81229,0,3,0
23245,2,1,81228,81229,81230,1,2,0
23246,5,3,81233,81233,81236,0,3,3
23247,5,2,81238,81238,81240,0,2,2
23248,2,2,81240,81240,81242,0,2,0
23249,4,1,81244,81244,81245,0,1,2
23250,2,1,81246,81246,81247,0,1,1
23251,5,1,81251,81251,81252,0,1,4
23252,5,3,81256,81256,81259,0,3,4
23253,2,1,81258,81259,81260,1,2,0
23254,6,2,81264,81264,81266,0,2,4
23255,6,3,81270,81270,81273,0,3,4
23256,4,3,81274,81274,81277,0,3,1
23257,1,3,81275,81277,81280,2,5,0
23258,3,1,81278,81280,81281,2,3,0
23259,4,1,81282,81282,81283,0,1,1
23260,4,2,81286,81286,81288,0,2,3
23261,5,2,81291,81291,81293,0,2,3
23262,6,2,81297,81297,81299,0,2,4
23263,4,3,81301,81301,81304,0,3,2
23264,6,3,81307,81307,81310,0,3,3
23265,3,1,81310,81310,81311,0,1,0
23266,6,2,81316,81316,81318,0,2,5
23267,5,1,81321,81321,81322,0,1,3
23268,5,1,81326,81326,81327,0,1,4
23269,2,1,81328,81328,81329,0,1,1
23270,6,3,81334,81334,81337,0,3,5
23271,6,3,81340,81340,81343,0,3,3
23272,5,1,81345,81345,81346,0,1,2
23273,5,3,81350,81350,81353,0,3,4
23274,1,1,81351,81353,81354,2,3,0
23275,4,2,81355,81355,81357,0,2,1
23276,6,2,81361,81361,81363,0,2,4
23277,3,2,81364,81364,81366,0,2,1
23278,2,1,81366,81366,81367,0,1,0
23279,1,2,81367,81367,81369,0,2,0
23280,5,2,81372,81372,81374,0,2,3
23281,4,1,81376,81376,81377,0,1,2
23282,6,1,81382,81382,81383,0,1,5
23283,2,1,81384,81384,81385,0,1,1
23284,1,3,81385,81385,81388,0,3,0
23285,1,1,81386,81388,81389,2,3,0
23286,5,3,81391,81391,81394,0,3,2
23287,4,2,81395,81395,81397,0,2,1
23288,4,3,81399,81399,81402,0,3,2
23289,1,2,81400,81402,81404,2,4,0
23290,1,1,81401,81404,81405,3,4,0
23291,3,1,81404,81405,81406,1,2,0
23292,3,2,81407,81407,81409,0,2,1
23293,1,3,81408,81409,81412,1,4,0
23294,4,1,81412,81412,81413,0,1,0
23295,1,3,81413,81413,81416,0,3,0
23296,3,3,81416,81416,81419,0,3,0
23297,3,3,81419,81419,81422,0,3,0
23298,4,1,81423,81423,81424,0,1,1
23299,1,3,81424,81424,81427,0,3,0
23300,1,3,81425,81427,81430,2,5,0
23301,6,3,81431,81431,81434,0,3,1
23302,1,1,81432,81434,81435,2,3,0
23303,2,2,81434,81435,81437,1,3,0
23304,5,3,81439,81439,81442,0,3,2
23305,3,3,81442,81442,81445,0,3,0
23306,1,1,81443,81445,81446,2,3,0
23307,2,1,81445,81446,81447,1,2,0
23308,6,3,81451,81451,81454,0,3,4
23309,2,1,81453,81454,81455,1,2,0
23310,4,2,81457,81457,81459,0,2,2
23311,3,1,81460,81460,81461,0,1,1
23312,4,3,81464,81464,81467,0,3,3
23313,1,1,81465,81467,81468,2,3,0
23314,1,3,81466,81468,81471,2,5,0
23315,3,1,81469,81471,81472,2,3,0
23316,2,3,81471,81472,81475,1,4,0
23317,2,2,81473,81475,81477,2,4,0
23318,1,3,81474,81477,81480,3,6,0
23319,5,3,81479,81480,81483,1,4,0
23320,1,3,81480,81483,81486,3,6,0
23321,1,1,81481,81486,81487,5,6,0
23322,4,1,81485,81487,81488,2,3,0
23323,1,2,81486,81488,81490,2,4,0
23324,6,3,81492,81492,81495,0,3,2
23325,6,1,81498,81498,81499,0,1,3
23326,2,3,81500,81500,81503,0,3,1
23327,5,1,81505,81505,81506,0,1,2
23328,5,2,81510,81510,81512,0,2,4
23329,1,3,81511,81512,81515,1,4,0
23330,2,1,81513,81515,81516,2,3,0
23331,3,2,81516,81516,81518,0,2,0
23332,4,1,81520,81520,81521,0,1,2
23333,6,3,81526,81526,81529,0,3,5
23334,1,3,81527,81529,81532,2,5,0
23335,1,1,81528,81532,81533,4,5,0
23336,5,2,81533,81533,81535,0,2,0
23337,1,1,81534,81535,81536,1,2,0
23338,2,1,81536,81536,81537,0,1,0
23339,3,2,81539,81539,81541,0,2,2
23340,2,3,81541,81541,81544,0,3,0
23341,3,2,81544,81544,81546,0,2,0
23342,2,2,81546,81546,81548,0,2,0
23343,2,1,81548,81548,81549,0,1,0
23344,1,2,81549,81549,81551,0,2,0
23345,6,3,81555,81555,81558,0,3,4
23346,4,2,81559,81559,81561,0,2,1
23347,4,1,81563,81563,81564,0,1,2
23348,1,3,81564,81564,81567,0,3,0
23349,3,1,81567,81567,81568,0,1,0
23350,6,3,81573,81573,81576,0,3,5
23351,2,2,81575,81576,81578,1,3,0
23352,2,1,81577,81578,81579,1,2,0
23353,1,3,81578,81579,81582,1,4,0
23354,2,2,81580,81582,81584,2,4,0
23355,5,3,81585,81585,81588,0,3,1
23356,4,3,81589,81589,81592,0,3,1
23357,2,1,81591,81592,81593,1,2,0
23358,4,2,81595,81595,81597,0,2,2
23359,6,3,81601,81601,81604,0,3,4
23360,3,1,81604,81604,81605,0,1,0
23361,6,2,81610,81610,81612,0,2,5
23362,4,3,81614,81614,81617,0,3,2
23363,4,3,81618,81618,81621,0,3,1
23364,4,3,81622,81622,81625,0,3,1
23365,3,1,81625,81625,81626,0,1,0
23366,2,1,81627,81627,81628,0,1,1
23367,2,3,81629,81629,81632,0,3,1
23368,5,3,81634,81634,81637,0,3,2
23369,3,2,81637,81637,81639,0,2,0
23370,2,1,81639,81639,81640,0,1,0
23371,4,1,81643,81643,81644,0,1,3
23372,6,1,81649,81649,81650,0,1,5
23373,1,3,81650,81650,81653,0,3,0
23374,4,3,81654,81654,81657,0,3,1
23375,1,2,81655,81657,81659,2,4,0
23376,5,3,81660,81660,81663,0,3,1
23377,5,3,81665,81665,81668,0,3,2
23378,3,2,81668,81668,81670,0,2,0
23379,5,1,81673,81673,81674,0,1,3
23380,6,3,81679,81679,81682,0,3,5
23381,6,3,81685,81685,81688,0,3,3
23382,6,2,81691,81691,81693,0,2,3
23383,4,3,81695,81695,81698,0,3,2
23384,5,3,81700,81700,81703,0,3,2
23385,3,3,81703,81703,81706,0,3,0
23386,1,1,81704,81706,81707,2,3,0
23387,4,2,81708,81708,81710,0,2,1
23388,3,3,81711,81711,81714,0,3,1
23389,5,3,81716,81716,81719,0,3,2
23390,1,3,81717,81719,81722,2,5,0
23391,4,3,81721,81722,81725,1,4,0
23392,5,1,81726,81726,81727,0,1,1
23393,5,1,81731,81731,81732,0,1,4
23394,3,1,81734,81734,81735,0,1,2
23395,4,3,81738,81738,81741,0,3,3
23396,5,1,81743,81743,81744,0,1,2
23397,5,1,81748,81748,81749,0,1,4
23398,1,3,81749,81749,81752,0,3,0
23399,1,1,81750,81752,81753,2,3,0
23400,2,2,81752,81753,81755,1,3,0
23401,1,1,81753,81755,81756,2,3,0
23402,3,3,81756,81756,81759,0,3,0
23403,2,2,81758,81759,81761,1,3,0
23404,6,2,81764,81764,81766,0,2,3
23405,3,3,81767,81767,81770,0,3,1
23406,5,3,81772,81772,81775,0,3,2
23407,4,2,81776,81776,81778,0,2,1
23408,1,1,81777,81778,81779,1,2,0
23409,6,3,81783,81783,81786,0,3,4
23410,6,1,81789,81789,81790,0,1,3
23411,4,1,81793,81793,81794,0,1,3
23412,5,2,81798,81798,81800,0,2,4
23413,4,2,81802,81802,81804,0,2,2
23414,2,2,81804,81804,81806,0,2,0
23415,5,1,81809,81809,81810,0,1,3
23416,1,2,81810,81810,81812,0,2,0
23417,1,3,81811,81812,81815,1,4,0
23418,3,1,81814,81815,81816,1,2,0
23419,6,3,81820,81820,81823,0,3,4
23420,4,1,81824,81824,81825,0,1,1
23421,4,3,81828,81828,81831,0,3,3
23422,2,3,81830,81831,81834,1,4,0
23423,1,1,81831,81834,81835,3,4,0
23424,5,3,81836,81836,81839,0,3,1
23425,2,3,81838,81839,81842,1,4,0
23426,2,2,81840,81842,81844,2,4,0
23427,2,2,81842,81844,81846,2,4,0
23428,4,2,81846,81846,81848,0,2,0
23429,1,3,81847,81848,81851,1,4,0
23430,4,1,81851,81851,81852,0,1,0
23431,2,1,81853,81853,81854,0,1,1
23432,6,1,81859,81859,81860,0,1,5
23433,5,1,81864,81864,81865,0,1,4
23434,6,1,81870,81870,81871,0,1,5
23435,4,3,81874,81874,81877,0,3,3
23436,5,2,81879,81879,81881,0,2,2
23437,1,1,81880,81881,81882,1,2,0
23438,3,2,81883,81883,81885,0,2,1
23439,5,1,81888,81888,81889,0,1,3
23440,6,3,81894,81894,81897,0,3,5
23441,4,2,81898,81898,81900,0,2,1
23442,2,2,81900,81900,81902,0,2,0
23443,2,1,81902,81902,81903,0,1,0
23444,1,3,81903,81903,81906,0,3,0
23445,4,3,81907,81907,81910,0,3,1
23446,5,1,81912,81912,81913,0,1,2
23447,2,3,81914,81914,81917,0,3,1
23448,5,3,81919,81919,81922,0,3,2
23449,6,2,81925,81925,81927,0,2,3
23450,5,2,81930,81930,81932,0,2,3
23451,4,1,81934,81934,81935,0,1,2
23452,1,2,81935,81935,81937,0,2,0
23453,3,1,81938,81938,81939,0,1,1
23454,3,2,81941,81941,81943,0,2,2
23455,4,1,81945,81945,81946,0,1,2
23456,5,1,81950,81950,81951,0,1,4
23457,5,3,81955,81955,81958,0,3,4
23458,5,2,81960,81960,81962,0,2,2
23459,2,1,81962,81962,81963,0,1,0
23460,1,3,81963,81963,81966,0,3,0
23461,4,3,81967,81967,81970,0,3,1
23462,6,2,81973,81973,81975,0,2,3
23463,5,1,81978,81978,81979,0,1,3
23464,1,1,81979,81979,81980,0,1,0
23465,6,2,81985,81985,81987,0,2,5
23466,6,3,81991,81991,81994,0,3,4
23467,4,2,81995,81995,81997,0,2,1
23468,2,1,81997,81997,81998,0,1,0
23469,5,1,82002,82002,82003,0,1,4
23470,3,2,82005,82005,82007,0,2,2
23471,1,1,82006,82007,82008,1,2,0
23472,3,3,82009,82009,82012,0,3,1
23473,3,2,82012,82012,82014,0,2,0
23474,6,2,82018,82018,82020,0,2,4
23475,3,2,82021,82021,82023,0,2,1
23476,3,3,82024,82024,82027,0,3,1
23477,1,2,82025,82027,82029,2,4,0
23478,5,1,82030,82030,82031,0,1,1
23479,4,3,82034,82034,82037,0,3,3
23480,1,3,82035,82037,82040,2,5,0
23481,6,3,82041,82041,82044,0,3,1
23482,1,3,82042,82044,82047,2,5,0
23483,3,3,82045,82047,82050,2,5,0
23484,4,3,82049,82050,82053,1,4,0
23485,2,3,82051,82053,82056,2,5,0
23486,6,2,82057,82057,82059,0,2,1
23487,6,3,82063,82063,82066,0,3,4
23488,3,1,82066,82066,82067,0,1,0
23489,1,1,82067,82067,82068,0,1,0
23490,3,3,82070,82070,82073,0,3,2
23491,5,3,82075,82075,82078,0,3,2
23492,3,3,82078,82078,82081,0,3,0
23493,4,2,82082,82082,82084,0,2,1
23494,5,1,82087,82087,82088,0,1,3
23495,6,1,82093,82093,82094,0,1,5
23496,6,2,82099,82099,82101,0,2,5
23497,3,2,82102,82102,82104,0,2,1
23498,2,2,82104,82104,82106,0,2,0
23499,5,3,82109,82109,82112,0,3,3
23500,4,1,82113,82113,82114,0,1,1
23501,1,1,82114,82114,82115,0,1,0
23502,6,2,82120,82120,82122,0,2,5
23503,3,1,82123,82123,82124,0,1,1
23504,1,3,82124,82124,82127,0,3,0
23505,5,1,82129,82129,82130,0,1,2
23506,1,3,82130,82130,82133,0,3,0
23507,6,1,82136,82136,82137,0,1,3
23508,3,1,82139,82139,82140,0,1,2
23509,3,3,82142,82142,82145,0,3,2
23510,1,1,82143,82145,82146,2,3,0
23511,4,3,82147,82147,82150,0,3,1
23512,6,1,82153,82153,82154,0,1,3
23513,2,2,82155,82155,82157,0,2,1
23514,2,3,82157,82157,82160,0,3,0
23515,3,1,82160,82160,82161,0,1,0
23516,4,2,82164,82164,82166,0,2,3
23517,5,3,82169,82169,82172,0,3,3
23518,3,3,82172,82172,82175,0,3,0
23519,5,2,82177,82177,82179,0,2,2
23520,1,3,82178,82179,82182,1,4,0
23521,6,2,82184,82184,82186,0,2,2
23522,3,2,82187,82187,82189,0,2,1
23523,1,2,82188,82189,82191,1,3,0
23524,6,2,82194,82194,82196,0,2,3
23525,1,2,82195,82196,82198,1,3,0
23526,5,2,82200,82200,82202,0,2,2
23527,3,2,82203,82203,82205,0,2,1
23528,3,3,82206,82206,82209,0,3,1
23529,2,3,82208,82209,82212,1,4,0
23530,3,1,82211,82212,82213,1,2,0
23531,3,1,82214,82214,82215,0,1,1
23532,5,1,82219,82219,82220,0,1,4
23533,5,2,82224,82224,82226,0,2,4
23534,4,1,82228,82228,82229,0,1,2
23535,1,3,82229,82229,82232,0,3,0
23536,4,2,82233,82233,82235,0,2,1
23537,2,3,82235,82235,82238,0,3,0
23538,5,1,82240,82240,82241,0,1,2
23539,2,2,82242,82242,82244,0,2,1
23540,2,2,82244,82244,82246,0,2,0
23541,6,1,82250,82250,82251,0,1,4
23542,4,3,82254,82254,82257,0,3,3
23543,6,2,82260,82260,82262,0,2,3
23544,6,1,82266,82266,82267,0,1,4
23545,3,1,82269,82269,82270,0,1,2
23546,2,2,82271,82271,82273,0,2,1
23547,1,2,82272,82273,82275,1,3,0
23548,4,2,82276,82276,82278,0,2,1
23549,2,2,82278,82278,82280,0,2,0
23550,3,1,82281,82281,82282,0,1,1
23551,4,2,82285,82285,82287,0,2,3
23552,3,2,82288,82288,82290,0,2,1
23553,4,1,82292,82292,82293,0,1,2
23554,3,1,82295,82295,82296,0,1,2
23555,3,3,82298,82298,82301,0,3,2
23556,3,2,82301,82301,82303,0,2,0
23557,2,1,82303,82303,82304,0,1,0
23558,1,1,82304,82304,82305,0,1,0
23559,5,3,82309,82309,82312,0,3,4
23560,3,1,82312,82312,82313,0,1,0
23561,1,1,82313,82313,82314,0,1,0
23562,3,3,82316,82316,82319,0,3,2
23563,6,3,82322,82322,82325,0,3,3
23564,4,1,82326,82326,82327,0,1,1
23565,1,1,82327,82327,82328,0,1,0
23566,6,2,82333,82333,82335,0,2,5
23567,5,3,82338,82338,82341,0,3,3
23568,5,2,82343,82343,82345,0,2,2
23569,6,1,82349,82349,82350,0,1,4
23570,5,2,82354,82354,82356,0,2,4
23571,4,1,82358,82358,82359,0,1,2
23572,3,2,82361,82361,82363,0,2,2
23573,6,3,82367,82367,82370,0,3,4
23574,5,1,82372,82372,82373,0,1,2
23575,6,3,82378,82378,82381,0,3,5
23576,3,1,82381,82381,82382,0,1,0
23577,4,3,82385,82385,82388,0,3,3
23578,1,3,82386,82388,82391,2,5,0
23579,5,3,82391,82391,82394,0,3,0
23580,1,2,82392,82394,82396,2,4,0
23581,3,1,82395,82396,82397,1,2,0
23582,3,3,82398,82398,82401,0,3,1
23583,1,1,82399,82401,82402,2,3,0
23584,2,1,82401,82402,82403,1,2,0
23585,5,3,82406,82406,82409,0,3,3
23586,6,2,82412,82412,82414,0,2,3
23587,5,2,82417,82417,82419,0,2,3
23588,5,1,82422,82422,82423,0,1,3
23589,3,3,82425,82425,82428,0,3,2
23590,6,2,82431,82431,82433,0,2,3
23591,2,2,82433,82433,82435,0,2,0
23592,5,2,82438,82438,82440,0,2,3
23593,1,3,82439,82440,82443,1,4,0
23594,5,1,82444,82444,82445,0,1,1
23595,2,3,82446,82446,82449,0,3,1
23596,1,1,82447,82449,82450,2,3,0
23597,2,1,82449,82450,82451,1,2,0
23598,4,2,82453,82453,82455,0,2,2
23599,2,3,82455,82455,82458,0,3,0
23600,1,2,82456,82458,82460,2,4,0
23601,2,2,82458,82460,82462,2,4,0
23602,3,1,82461,82462,82463,1,2,0
23603,4,1,82465,82465,82466,0,1,2
23604,2,1,82467,82467,82468,0,1,1
23605,4,2,82471,82471,82473,0,2,3
23606,6,3,82477,82477,82480,0,3,4
23607,3,2,82480,82480,82482,0,2,0
23608,2,1,82482,82482,82483,0,1,0
23609,2,3,82484,82484,82487,0,3,1
23610,5,2,82489,82489,82491,0,2,2
23611,1,2,82490,82491,82493,1,3,0
23612,2,1,82492,82493,82494,1,2,0
23613,3,1,82495,82495,82496,0,1,1
23614,6,2,82501,82501,82503,0,2,5
23615,5,1,82506,82506,82507,0,1,3
23616,3,1,82509,82509,82510,0,1,2
23617,1,3,82510,82510,82513,0,3,0
23618,1,1,82511,82513,82514,2,3,0
23619,4,2,82515,82515,82517,0,2,1
23620,1,1,82516,82517,82518,1,2,0
23621,6,3,82522,82522,82525,0,3,4
23622,6,2,82528,82528,82530,0,2,3
23623,3,2,82531,82531,82533,0,2,1
23624,1,2,82532,82533,82535,1,3,0
23625,1,1,82533,82535,82536,2,3,0
23626,4,1,82537,82537,82538,0,1,1
23627,5,3,82542,82542,82545,0,3,4
23628,6,1,82548,82548,82549,0,1,3
23629,4,1,82552,82552,82553,0,1,3
23630,6,2,82558,82558,82560,0,2,5
23631,2,3,82560,82560,82563,0,3,0
23632,5,3,82565,82565,82568,0,3,2
23633,4,1,82569,82569,82570,0,1,1
23634,3,3,82572,82572,82575,0,3,2
23635,1,2,82573,82575,82577,2,4,0
23636,6,3,82579,82579,82582,0,3,2
23637,5,2,82584,82584,82586,0,2,2
23638,1,2,82585,82586,82588,1,3,0
23639,2,3,82587,82588,82591,1,4,0
23640,1,3,82588,82591,82594,3,6,0
23641,5,1,82593,82594,82595,1,2,0
23642,4,1,82597,82597,82598,0,1,2
23643,2,3,82599,82599,82602,0,3,1
23644,1,3,82600,82602,82605,2,5,0
23645,6,2,82606,82606,82608,0,2,1
23646,3,2,82609,82609,82611,0,2,1
23647,6,2,82615,82615,82617,0,2,4
23648,3,2,82618,82618,82620,0,2,1
23649,2,1,82620,82620,82621,0,1,0
23650,5,2,82625,82625,82627,0,2,4
23651,2,1,82627,82627,82628,0,1,0
23652,1,1,82628,82628,82629,0,1,0
23653,1,1,82629,82629,82630,0,1,0
23654,6,1,82635,82635,82636,0,1,5
23655,6,3,82641,82641,82644,0,3,5
23656,3,1,82644,82644,82645,0,1,0
23657,1,1,82645,82645,82646,0,1,0
23658,1,3,82646,82646,82649,0,3,0
23659,4,2,82650,82650,82652,0,2,1
23660,3,2,82653,82653,82655,0,2,1
23661,2,2,82655,82655,82657,0,2,0
23662,1,3,82656,82657,82660,1,4,0
23663,6,2,82662,82662,82664,0,2,2
23664,6,3,82668,82668,82671,0,3,4
23665,2,1,82670,82671,82672,1,2,0
23666,6,3,82676,82676,82679,0,3,4
23667,4,3,82680,82680,82683,0,3,1
23668,6,3,82686,82686,82689,0,3,3
23669,3,1,82689,82689,82690,0,1,0
23670,1,2,82690,82690,82692,0,2,0
23671,2,2,82692,82692,82694,0,2,0
23672,5,2,82697,82697,82699,0,2,3
23673,5,1,82702,82702,82703,0,1,3
23674,4,2,82706,82706,82708,0,2,3
23675,1,3,82707,82708,82711,1,4,0
23676,6,1,82713,82713,82714,0,1,2
23677,1,3,82714,82714,82717,0,3,0
23678,1,3,82715,82717,82720,2,5,0
23679,5,2,82720,82720,82722,0,2,0
23680,5,1,82725,82725,82726,0,1,3
23681,4,1,82729,82729,82730,0,1,3
23682,4,1,82733,82733,82734,0,1,3
23683,2,1,82735,82735,82736,0,1,1
23684,4,1,82739,82739,82740,0,1,3
23685,6,2,82745,82745,82747,0,2,5
23686,6,2,82751,82751,82753,0,2,4
23687,1,3,82752,82753,82756,1,4,0
23688,1,1,82753,82756,82757,3,4,0
23689,6,1,82759,82759,82760,0,1,2
23690,2,3,82761,82761,82764,0,3,1
23691,1,2,82762,82764,82766,2,4,0
23692,2,1,82764,82766,82767,2,3,0
23693,5,3,82769,82769,82772,0,3,2
23694,5,2,82774,82774,82776,0,2,2
23695,1,1,82775,82776,82777,1,2,0
23696,5,3,82780,82780,82783,0,3,3
23697,5,3,82785,82785,82788,0,3,2
23698,2,3,82787,82788,82791,1,4,0
23699,5,3,82792,82792,82795,0,3,1
23700,3,2,82795,82795,82797,0,2,0
23701,5,3,82800,82800,82803,0,3,3
23702,3,3,82803,82803,82806,0,3,0
23703,4,1,82807,82807,82808,0,1,1
23704,5,1,82812,82812,82813,0,1,4
23705,1,2,82813,82813,82815,0,2,0
23706,3,2,82816,82816,82818,0,2,1
23707,5,2,82821,82821,82823,0,2,3
23708,1,2,82822,82823,82825,1,3,0
23709,1,3,82823,82825,82828,2,5,0
23710,5,2,82828,82828,82830,0,2,0
23711,5,3,82833,82833,82836,0,3,3
23712,3,3,82836,82836,82839,0,3,0
23713,6,3,82842,82842,82845,0,3,3
23714,6,1,82848,82848,82849,0,1,3
23715,3,2,82851,82851,82853,0,2,2
23716,6,1,82857,82857,82858,0,1,4
23717,5,1,82862,82862,82863,0,1,4
23718,2,1,82864,82864,82865,0,1,1
23719,4,3,82868,82868,82871,0,3,3
23720,2,1,82870,82871,82872,1,2,0
23721,5,2,82875,82875,82877,0,2,3
23722,4,2,82879,82879,82881,0,2,2
23723,1,1,82880,82881,82882,1,2,0
23724,4,2,82884,82884,82886,0,2,2
23725,4,3,82888,82888,82891,0,3,2
23726,4,1,82892,82892,82893,0,1,1
23727,3,2,82895,82895,82897,0,2,2
23728,2,1,82897,82897,82898,0,1,0
23729,1,3,82898,82898,82901,0,3,0
23730,5,2,82903,82903,82905,0,2,2
23731,1,3,82904,82905,82908,1,4,0
23732,1,3,82905,82908,82911,3,6,0
23733,4,3,82909,82911,82914,2,5,0
23734,2,2,82911,82914,82916,3,5,0
23735,2,3,82913,82916,82919,3,6,0
23736,5,2,82918,82919,82921,1,3,0
23737,5,2,82923,82923,82925,0,2,2
23738,4,3,82927,82927,82930,0,3,2
23739,4,3,82931,82931,82934,0,3,1
23740,2,2,82933,82934,82936,1,3,0
23741,1,2,82934,82936,82938,2,4,0
23742,1,2,82935,82938,82940,3,5,0
23743,4,3,82939,82940,82943,1,4,0
23744,1,3,82940,82943,82946,3,6,0
23745,4,1,82944,82946,82947,2,3,0
23746,2,2,82946,82947,82949,1,3,0
23747,5,2,82951,82951,82953,0,2,2
23748,5,2,82956,82956,82958,0,2,3
23749,2,1,82958,82958,82959,0,1,0
23750,4,2,82962,82962,82964,0,2,3
23751,2,3,82964,82964,82967,0,3,0
23752,4,2,82968,82968,82970,0,2,1
23753,4,3,82972,82972,82975,0,3,2
23754,2,2,82974,82975,82977,1,3,0
23755,3,3,82977,82977,82980,0,3,0
23756,6,1,82983,82983,82984,0,1,3
23757,6,2,82989,82989,82991,0,2,5
23758,5,1,82994,82994,82995,0,1,3
23759,5,1,82999,82999,83000,0,1,4
23760,2,1,83001,83001,83002,0,1,1
23761,2,2,83003,83003,83005,0,2,1
23762,6,1,83009,83009,83010,0,1,4
23763,4,3,83013,83013,83016,0,3,3
23764,2,1,83015,83016,83017,1,2,0
23765,4,1,83019,83019,83020,0,1,2
23766,6,3,83025,83025,83028,0,3,5
23767,5,2,83030,83030,83032,0,2,2
23768,6,3,83036,83036,83039,0,3,4
23769,5,2,83041,83041,83043,0,2,2
23770,1,3,83042,83043,83046,1,4,0
23771,3,2,83045,83046,83048,1,3,0
23772,6,1,83051,83051,83052,0,1,3
23773,6,2,83057,83057,83059,0,2,5
23774,2,3,83059,83059,83062,0,3,0
23775,3,3,83062,83062,83065,0,3,0
23776,5,2,83067,83067,83069,0,2,2
23777,6,1,83073,83073,83074,0,1,4
23778,2,1,83075,83075,83076,0,1,1
23779,6,2,83081,83081,83083,0,2,5
23780,2,3,83083,83083,83086,0,3,0
23781,3,3,83086,83086,83089,0,3,0
23782,5,3,83091,83091,83094,0,3,2
23783,2,1,83093,83094,83095,1,2,0
23784,2,3,83095,83095,83098,0,3,0
23785,1,2,83096,83098,83100,2,4,0
23786,6,1,83102,83102,83103,0,1,2
23787,3,3,83105,83105,83108,0,3,2
23788,1,2,83106,83108,83110,2,4,0
23789,6,2,83112,83112,83114,0,2,2
23790,1,1,83113,83114,83115,1,2,0
23791,6,2,83119,83119,83121,0,2,4
23792,6,1,83125,83125,83126,0,1,4
23793,2,2,83127,83127,83129,0,2,1
23794,4,3,83131,83131,83134,0,3,2
23795,6,2,83137,83137,83139,0,2,3
23796,3,3,83140,83140,83143,0,3,1
23797,3,3,83143,83143,83146,0,3,0
23798,3,3,83146,83146,83149,0,3,0
23799,4,2,83150,83150,83152,0,2,1
23800,4,3,83154,83154,83157,0,3,2
23801,4,2,83158,83158,83160,0,2,1
23802,5,2,83163,83163,83165,0,2,3
23803,1,2,83164,83165,83167,1,3,0
23804,5,2,83169,83169,83171,0,2,2
23805,4,2,83173,83173,83175,0,2,2
23806,3,1,83176,83176,83177,0,1,1
23807,4,3,83180,83180,83183,0,3,3
23808,3,2,83183,83183,83185,0,2,0
23809,6,2,83189,83189,83191,0,2,4
23810,1,1,83190,83191,83192,1,2,0
23811,1,2,83191,83192,83194,1,3,0
23812,3,1,83194,83194,83195,0,1,0
23813,6,1,83200,83200,83201,0,1,5
23814,4,3,83204,83204,83207,0,3,3
23815,6,1,83210,83210,83211,0,1,3
23816,1,3,83211,83211,83214,0,3,0
23817,5,2,83216,83216,83218,0,2,2
23818,6,2,83222,83222,83224,0,2,4
23819,6,2,83228,83228,83230,0,2,4
23820,5,1,83233,83233,83234,0,1,3
23821,6,2,83239,83239,83241,0,2,5
23822,5,2,83244,83244,83246,0,2,3
23823,5,3,83249,83249,83252,0,3,3
23824,4,3,83253,83253,83256,0,3,1
23825,5,2,83258,83258,83260,0,2,2
23826,3,2,83261,83261,83263,0,2,1
23827,2,1,83263,83263,83264,0,1,0
23828,1,3,83264,83264,83267,0,3,0
23829,4,1,83268,83268,83269,0,1,1
23830,1,2,83269,83269,83271,0,2,0
23831,3,3,83272,83272,83275,0,3,1
23832,1,3,83273,83275,83278,2,5,0
23833,2,1,83275,83278,83279,3,4,0
23834,3,3,83278,83279,83282,1,4,0
23835,6,2,83284,83284,83286,0,2,2
23836,4,3,83288,83288,83291,0,3,2
23837,3,1,83291,83291,83292,0,1,0
23838,2,1,83293,83293,83294,0,1,1
23839,2,2,83295,83295,83297,0,2,1
23840,1,3,83296,83297,83300,1,4,0
23841,4,1,83300,83300,83301,0,1,0
23842,6,2,83306,83306,83308,0,2,5
23843,4,1,83310,83310,83311,0,1,2
23844,5,1,83315,83315,83316,0,1,4
23845,1,3,83316,83316,83319,0,3,0
23846,4,1,83320,83320,83321,0,1,1
23847,5,3,83325,83325,83328,0,3,4
23848,4,3,83329,83329,83332,0,3,1
23849,5,2,83334,83334,83336,0,2,2
23850,6,2,83340,83340,83342,0,2,4
23851,4,1,83344,83344,83345,0,1,2
23852,5,2,83349,83349,83351,0,2,4
23853,1,1,83350,83351,83352,1,2,0
23854,6,3,83356,83356,83359,0,3,4
23855,5,3,83361,83361,83364,0,3,2
23856,6,1,83367,83367,83368,0,1,3
23857,2,1,83369,83369,83370,0,1,1
23858,5,1,83374,83374,83375,0,1,4
23859,3,1,83377,83377,83378,0,1,2
23860,2,2,83379,83379,83381,0,2,1
23861,6,1,83385,83385,83386,0,1,4
23862,1,3,83386,83386,83389,0,3,0
23863,1,2,83387,83389,83391,2,4,0
23864,4,1,83391,83391,83392,0,1,0
23865,5,3,83396,83396,83399,0,3,4
23866,1,1,83397,83399,83400,2,3,0
23867,5,1,83402,83402,83403,0,1,2
23868,5,3,83407,83407,83410,0,3,4
23869,3,3,83410,83410,83413,0,3,0
23870,1,1,83411,83413,83414,2,3,0
23871,2,1,83413,83414,83415,1,2,0
23872,1,3,83414,83415,83418,1,4,0
23873,6,1,83420,83420,83421,0,1,2
23874,3,2,83423,83423,83425,0,2,2
23875,3,2,83426,83426,83428,0,2,1
23876,4,1,83430,83430,83431,0,1,2
23877,2,3,83432,83432,83435,0,3,1
23878,5,3,83437,83437,83440,0,3,2
23879,6,3,83443,83443,83446,0,3,3
23880,5,1,83448,83448,83449,0,1,2
23881,2,2,83450,83450,83452,0,2,1
23882,5,3,83455,83455,83458,0,3,3
23883,1,1,83456,83458,83459,2,3,0
23884,3,1,83459,83459,83460,0,1,0
23885,3,1,83462,83462,83463,0,1,2
23886,4,1,83466,83466,83467,0,1,3
23887,3,3,83469,83469,83472,0,3,2
23888,6,2,83475,83475,83477,0,2,3
23889,2,1,83477,83477,83478,0,1,0
23890,4,1,83481,83481,83482,0,1,3
23891,2,1,83483,83483,83484,0,1,1
23892,2,2,83485,83485,83487,0,2,1
23893,5,1,83490,83490,83491,0,1,3
23894,4,1,83494,83494,83495,0,1,3
23895,3,1,83497,83497,83498,0,1,2
23896,1,1,83498,83498,83499,0,1,0
23897,3,2,83501,83501,83503,0,2,2
23898,2,2,83503,83503,83505,0,2,0
23899,2,2,83505,83505,83507,0,2,0
23900,6,2,83511,83511,83513,0,2,4
23901,5,2,83516,83516,83518,0,2,3
23902,6,3,83522,83522,83525,0,3,4
23903,4,2,83526,83526,83528,0,2,1
23904,1,3,83527,83528,83531,1,4,0
23905,3,3,83530,83531,83534,1,4,0
23906,3,2,83533,83534,83536,1,3,0
23907,4,2,83537,83537,83539,0,2,1
23908,2,2,83539,83539,83541,0,2,0
23909,5,2,83544,83544,83546,0,2,3
23910,4,2,83548,83548,83550,0,2,2
23911,6,3,83554,83554,83557,0,3,4
23912,4,2,83558,83558,83560,0,2,1
23913,6,3,83564,83564,83567,0,3,4
23914,6,1,83570,83570,83571,0,1,3
23915,5,1,83575,83575,83576,0,1,4
23916,6,1,83581,83581,83582,0,1,5
23917,6,3,83587,83587,83590,0,3,5
23918,5,1,83592,83592,83593,0,1,2
23919,5,3,83597,83597,83600,0,3,4
23920,3,3,83600,83600,83603,0,3,0
23921,6,2,83606,83606,83608,0,2,3
23922,3,1,83609,83609,83610,0,1,1
23923,4,2,83613,83613,83615,0,2,3
23924,4,1,83617,83617,83618,0,1,2
23925,6,1,83623,83623,83624,0,1,5
23926,4,3,83627,83627,83630,0,3,3
23927,4,2,83631,83631,83633,0,2,1
23928,6,3,83637,83637,83640,0,3,4
23929,2,2,83639,83640,83642,1,3,0
23930,1,1,83640,83642,83643,2,3,0
23931,6,3,83646,83646,83649,0,3,3
23932,5,1,83651,83651,83652,0,1,2
23933,5,3,83656,83656,83659,0,3,4
23934,1,2,83657,83659,83661,2,4,0
23935,4,2,83661,83661,83663,0,2,0
23936,2,2,83663,83663,83665,0,2,0
23937,2,1,83665,83665,83666,0,1,0
23938,3,2,83668,83668,83670,0,2,2
23939,2,3,83670,83670,83673,0,3,0
23940,6,1,83676,83676,83677,0,1,3
23941,3,1,83679,83679,83680,0,1,2
23942,3,1,83682,83682,83683,0,1,2
23943,1,1,83683,83683,83684,0,1,0
23944,5,1,83688,83688,83689,0,1,4
23945,6,2,83694,83694,83696,0,2,5
23946,1,1,83695,83696,83697,1,2,0
23947,5,3,83700,83700,83703,0,3,3
23948,2,2,83702,83703,83705,1,3,0
23949,6,2,83708,83708,83710,0,2,3
23950,2,3,83710,83710,83713,0,3,0
23951,5,1,83715,83715,83716,0,1,2
23952,1,2,83716,83716,83718,0,2,0
23953,6,3,83722,83722,83725,0,3,4
23954,1,3,83723,83725,83728,2,5,0
23955,6,1,83729,83729,83730,0,1,1
23956,4,2,83733,83733,83735,0,2,3
23957,5,3,83738,83738,83741,0,3,3
23958,3,3,83741,83741,83744,0,3,0
23959,5,2,83746,83746,83748,0,2,2
23960,3,3,83749,83749,83752,0,3,1
23961,2,1,83751,83752,83753,1,2,0
23962,6,3,83757,83757,83760,0,3,4
23963,5,2,83762,83762,83764,0,2,2
23964,2,1,83764,83764,83765,0,1,0
23965,6,3,83770,83770,83773,0,3,5
23966,2,3,83772,83773,83776,1,4,0
23967,3,2,83775,83776,83778,1,3,0
23968,4,2,83779,83779,83781,0,2,1
23969,5,3,83784,83784,83787,0,3,3
23970,2,1,83786,83787,83788,1,2,0
23971,6,3,83792,83792,83795,0,3,4
23972,1,3,83793,83795,83798,2,5,0
23973,3,3,83796,83798,83801,2,5,0
23974,2,3,83798,83801,83804,3,6,0
23975,1,2,83799,83804,83806,5,7,0
23976,3,1,83802,83806,83807,4,5,0
23977,3,2,83805,83807,83809,2,4,0
23978,2,1,83807,83809,83810,2,3,0
23979,3,3,83810,83810,83813,0,3,0
23980,5,2,83815,83815,83817,0,2,2
23981,3,2,83818,83818,83820,0,2,1
23982,3,3,83821,83821,83824,0,3,1
23983,6,1,83827,83827,83828,0,1,3
23984,4,1,83831,83831,83832,0,1,3
23985,2,1,83833,83833,83834,0,1,1
23986,6,3,83839,83839,83842,0,3,5
23987,5,1,83844,83844,83845,0,1,2
23988,6,2,83850,83850,83852,0,2,5
23989,2,2,83852,83852,83854,0,2,0
23990,1,1,83853,83854,83855,1,2,0
23991,1,3,83854,83855,83858,1,4,0
23992,3,1,83857,83858,83859,1,2,0
23993,5,1,83862,83862,83863,0,1,3
23994,6,1,83868,83868,83869,0,1,5
23995,3,3,83871,83871,83874,0,3,2
23996,2,3,83873,83874,83877,1,4,0
23997,4,2,83877,83877,83879,0,2,0
23998,3,2,83880,83880,83882,0,2,1
23999,6,3,83886,83886,83889,0,3,4
24000,3,2,83889,83889,83891,0,2,0
24001,3,1,83892,83892,83893,0,1,1
24002,1,3,83893,83893,83896,0,3,0
24003,6,2,83899,83899,83901,0,2,3
24004,2,2,83901,83901,83903,0,2,0
24005,2,3,83903,83903,83906,0,3,0
24006,1,2,83904,83906,83908,2,4,0
24007,2,3,83906,83908,83911,2,5,0
24008,1,2,83907,83911,83913,4,6,0
24009,4,2,83911,83913,83915,2,4,0
24010,5,3,83916,83916,83919,0,3,1
24011,2,1,83918,83919,83920,1,2,0
24012,6,1,83924,83924,83925,0,1,4
24013,1,3,83925,83925,83928,0,3,0
24014,4,3,83929,83929,83932,0,3,1
24015,2,2,83931,83932,83934,1,3,0
24016,2,2,83933,83934,83936,1,3,0
24017,6,3,83939,83939,83942,0,3,3
24018,4,3,83943,83943,83946,0,3,1
24019,2,3,83945,83946,83949,1,4,0
24020,1,1,83946,83949,83950,3,4,0
24021,1,1,83947,83950,83951,3,4,0
24022,5,2,83952,83952,83954,0,2,1
24023,4,2,83956,83956,83958,0,2,2
24024,5,2,83961,83961,83963,0,2,3
24025,4,1,83965,83965,83966,0,1,2
24026,5,2,83970,83970,83972,0,2,4
24027,6,3,83976,83976,83979,0,3,4
24028,1,1,83977,83979,83980,2,3,0
24029,1,3,83978,83980,83983,2,5,0
24030,5,2,83983,83983,83985,0,2,0
24031,1,2,83984,83985,83987,1,3,0
24032,6,3,83990,83990,83993,0,3,3
24033,5,2,83995,83995,83997,0,2,2
24034,6,2,84001,84001,84003,0,2,4
24035,1,3,84002,84003,84006,1,4,0
24036,1,2,84003,84006,84008,3,5,0
24037,6,2,84009,84009,84011,0,2,1
24038,1,1,84010,84011,84012,1,2,0
24039,2,3,84012,84012,84015,0,3,0
24040,6,3,84018,84018,84021,0,3,3
24041,5,2,84023,84023,84025,0,2,2
24042,2,2,84025,84025,84027,0,2,0
24043,6,1,84031,84031,84032,0,1,4
24044,6,3,84037,84037,84040,0,3,5
24045,4,3,84041,84041,84044,0,3,1
24046,3,3,84044,84044,84047,0,3,0
24047,4,3,84048,84048,84051,0,3,1
24048,3,1,84051,84051,84052,0,1,0
24049,2,2,84053,84053,84055,0,2,1
24050,5,2,84058,84058,84060,0,2,3
24051,6,1,84064,84064,84065,0,1,4
24052,5,3,84069,84069,84072,0,3,4
24053,3,2,84072,84072,84074,0,2,0
24054,2,3,84074,84074,84077,0,3,0
24055,3,3,84077,84077,84080,0,3,0
24056,5,1,84082,84082,84083,0,1,2
24057,2,3,84084,84084,84087,0,3,1
24058,4,3,84088,84088,84091,0,3,1
24059,5,1,84093,84093,84094,0,1,2
24060,5,2,84098,84098,84100,0,2,4
24061,2,2,84100,84100,84102,0,2,0
24062,4,1,84104,84104,84105,0,1,2
24063,5,3,84109,84109,84112,0,3,4
24064,5,1,84114,84114,84115,0,1,2
24065,3,3,84117,84117,84120,0,3,2
24066,4,3,84121,84121,84124,0,3,1
24067,6,3,84127,84127,84130,0,3,3
24068,4,3,84131,84131,84134,0,3,1
24069,2,3,84133,84134,84137,1,4,0
24070,5,1,84138,84138,84139,0,1,1
24071,5,2,84143,84143,84145,0,2,4
24072,6,1,84149,84149,84150,0,1,4
24073,2,2,84151,84151,84153,0,2,1
24074,6,1,84157,84157,84158,0,1,4
24075,6,2,84163,84163,84165,0,2,5
24076,5,2,84168,84168,84170,0,2,3
24077,5,1,84173,84173,84174,0,1,3
24078,1,1,84174,84174,84175,0,1,0
24079,6,2,84180,84180,84182,0,2,5
24080,5,1,84185,84185,84186,0,1,3
24081,6,3,84191,84191,84194,0,3,5
24082,3,3,84194,84194,84197,0,3,0
24083,3,1,84197,84197,84198,0,1,0
24084,4,2,84201,84201,84203,0,2,3
24085,3,3,84204,84204,84207,0,3,1
24086,1,3,84205,84207,84210,2,5,0
24087,3,1,84208,84210,84211,2,3,0
24088,2,1,84210,84211,84212,1,2,0
24089,1,1,84211,84212,84213,1,2,0
24090,4,3,84215,84215,84218,0,3,2
24091,2,2,84217,84218,84220,1,3,0
24092,3,1,84220,84220,84221,0,1,0
24093,1,1,84221,84221,84222,0,1,0
24094,4,2,84225,84225,84227,0,2,3
24095,5,2,84230,84230,84232,0,2,3
24096,6,3,84236,84236,84239,0,3,4
24097,1,2,84237,84239,84241,2,4,0
24098,6,2,84243,84243,84245,0,2,2
24099,4,2,84247,84247,84249,0,2,2
24100,2,3,84249,84249,84252,0,3,0
24101,5,3,84254,84254,84257,0,3,2
24102,3,3,84257,84257,84260,0,3,0
24103,3,2,84260,84260,84262,0,2,0
24104,6,3,84266,84266,84269,0,3,4
24105,4,1,84270,84270,84271,0,1,1
24106,3,1,84273,84273,84274,0,1,2
24107,1,1,84274,84274,84275,0,1,0
24108,2,1,84276,84276,84277,0,1,1
24109,6,2,84282,84282,84284,0,2,5
24110,1,2,84283,84284,84286,1,3,0
24111,5,3,84288,84288,84291,0,3,2
24112,3,3,84291,84291,84294,0,3,0
24113,6,1,84297,84297,84298,0,1,3
24114,5,1,84302,84302,84303,0,1,4
24115,2,3,84304,84304,84307,0,3,1
24116,3,1,84307,84307,84308,0,1,0
24117,4,1,84311,84311,84312,0,1,3
24118,4,3,84315,84315,84318,0,3,3
24119,1,1,84316,84318,84319,2,3,0
24120,3,3,84319,84319,84322,0,3,0
24121,6,2,84325,84325,84327,0,2,3
24122,4,1,84329,84329,84330,0,1,2
24123,1,3,84330,84330,84333,0,3,0
24124,2,3,84332,84333,84336,1,4,0
24125,1,2,84333,84336,84338,3,5,0
24126,2,2,84335,84338,84340,3,5,0
24127,6,2,84341,84341,84343,0,2,1
24128,5,2,84346,84346,84348,0,2,3
24129,1,2,84347,84348,84350,1,3,0
24130,4,1,84351,84351,84352,0,1,1
24131,4,1,84355,84355,84356,0,1,3
24132,2,2,84357,84357,84359,0,2,1
24133,4,2,84361,84361,84363,0,2,2
24134,3,2,84364,84364,84366,0,2,1
24135,1,2,84365,84366,84368,1,3,0
24136,1,2,84366,84368,84370,2,4,0
24137,5,1,84371,84371,84372,0,1,1
24138,2,2,84373,84373,84375,0,2,1
24139,4,3,84377,84377,84380,0,3,2
24140,1,2,84378,84380,84382,2,4,0
24141,1,1,84379,84382,84383,3,4,0
24142,4,1,84383,84383,84384,0,1,0
24143,2,3,84385,84385,84388,0,3,1
24144,6,1,84391,84391,84392,0,1,3
24145,1,1,84392,84392,84393,0,1,0
24146,3,3,84395,84395,84398,0,3,2
24147,2,2,84397,84398,84400,1,3,0
24148,5,3,84402,84402,84405,0,3,2
24149,3,3,84405,84405,84408,0,3,0
24150,1,1,84406,84408,84409,2,3,0
24151,2,1,84408,84409,84410,1,2,0
24152,3,3,84411,84411,84414,0,3,1
24153,6,2,84417,84417,84419,0,2,3
24154,1,2,84418,84419,84421,1,3,0
24155,5,3,84423,84423,84426,0,3,2
24156,3,1,84426,84426,84427,0,1,0
24157,6,2,84432,84432,84434,0,2,5
24158,4,1,84436,84436,84437,0,1,2
24159,1,3,84437,84437,84440,0,3,0
24160,1,1,84438,84440,84441,2,3,0
24161,1,1,84439,84441,84442,2,3,0
24162,4,2,84443,84443,84445,0,2,1
24163,5,2,84448,84448,84450,0,2,3
24164,3,3,84451,84451,84454,0,3,1
24165,4,2,84455,84455,84457,0,2,1
24166,6,3,84461,84461,84464,0,3,4
24167,5,2,84466,84466,84468,0,2,2
24168,1,3,84467,84468,84471,1,4,0
24169,3,2,84470,84471,84473,1,3,0
24170,5,2,84475,84475,84477,0,2,2
24171,1,1,84476,84477,84478,1,2,0
24172,4,2,84480,84480,84482,0,2,2
24173,2,2,84482,84482,84484,0,2,0
24174,5,3,84487,84487,84490,0,3,3
24175,5,2,84492,84492,84494,0,2,2
24176,6,3,84498,84498,84501,0,3,4
24177,6,1,84504,84504,84505,0,1,3
24178,2,1,84506,84506,84507,0,1,1
24179,4,2,84510,84510,84512,0,2,3
24180,5,3,84515,84515,84518,0,3,3
24181,6,2,84521,84521,84523,0,2,3
24182,6,2,84527,84527,84529,0,2,4
24183,1,3,84528,84529,84532,1,4,0
24184,4,1,84532,84532,84533,0,1,0
24185,5,1,84537,84537,84538,0,1,4
24186,3,1,84540,84540,84541,0,1,2
24187,6,3,84546,84546,84549,0,3,5
24188,4,2,84550,84550,84552,0,2,1
24189,5,1,84555,84555,84556,0,1,3
24190,4,3,84559,84559,84562,0,3,3
24191,2,2,84561,84562,84564,1,3,0
24192,3,2,84564,84564,84566,0,2,0
24193,3,2,84567,84567,84569,0,2,1
24194,5,2,84572,84572,84574,0,2,3
24195,1,3,84573,84574,84577,1,4,0
24196,5,1,84578,84578,84579,0,1,1
24197,3,2,84581,84581,84583,0,2,2
24198,3,3,84584,84584,84587,0,3,1
24199,3,3,84587,84587,84590,0,3,0
24200,2,3,84589,84590,84593,1,4,0
24201,4,3,84593,84593,84596,0,3,0
24202,5,2,84598,84598,84600,0,2,2
24203,3,3,84601,84601,84604,0,3,1
24204,4,3,84605,84605,84608,0,3,1
24205,3,2,84608,84608,84610,0,2,0
24206,6,2,84614,84614,84616,0,2,4
24207,6,3,84620,84620,84623,0,3,4
24208,1,3,84621,84623,84626,2,5,0
24209,4,1,84625,84626,84627,1,2,0
24210,3,1,84628,84628,84629,0,1,1
24211,6,2,84634,84634,84636,0,2,5
24212,3,2,84637,84637,84639,0,2,1
24213,6,3,84643,84643,84646,0,3,4
24214,4,3,84647,84647,84650,0,3,1
24215,3,3,84650,84650,84653,0,3,0
24216,6,1,84656,84656,84657,0,1,3
24217,1,2,84657,84657,84659,0,2,0
24218,3,2,84660,84660,84662,0,2,1
24219,2,2,84662,84662,84664,0,2,0
24220,1,1,84663,84664,84665,1,2,0
24221,5,2,84668,84668,84670,0,2,3
24222,4,1,84672,84672,84673,0,1,2
24223,2,1,84674,84674,84675,0,1,1
24224,5,1,84679,84679,84680,0,1,4
24225,3,1,84682,84682,84683,0,1,2
24226,4,1,84686,84686,84687,0,1,3
24227,3,3,84689,84689,84692,0,3,2
24228,5,3,84694,84694,84697,0,3,2
24229,4,2,84698,84698,84700,0,2,1
24230,4,2,84702,84702,84704,0,2,2
24231,1,2,84703,84704,84706,1,3,0
24232,5,1,84708,84708,84709,0,1,2
24233,3,2,84711,84711,84713,0,2,2
24234,2,3,84713,84713,84716,0,3,0
24235,4,3,84717,84717,84720,0,3,1
24236,3,2,84720,84720,84722,0,2,0
24237,3,2,84723,84723,84725,0,2,1
24238,6,3,84729,84729,84732,0,3,4
24239,4,1,84733,84733,84734,0,1,1
24240,2,2,84735,84735,84737,0,2,1
24241,6,2,84741,84741,84743,0,2,4
24242,1,3,84742,84743,84746,1,4,0
24243,4,2,84746,84746,84748,0,2,0
24244,3,2,84749,84749,84751,0,2,1
24245,4,2,84753,84753,84755,0,2,2
24246,5,1,84758,84758,84759,0,1,3
24247,4,1,84762,84762,84763,0,1,3
24248,6,3,84768,84768,84771,0,3,5
24249,2,1,84770,84771,84772,1,2,0
24250,3,1,84773,84773,84774,0,1,1
24251,4,2,84777,84777,84779,0,2,3
24252,2,3,84779,84779,84782,0,3,0
24253,2,3,84781,84782,84785,1,4,0
24254,1,3,84782,84785,84788,3,6,0
24255,4,1,84786,84788,84789,2,3,0
24256,4,1,84790,84790,84791,0,1,1
24257,4,2,84794,84794,84796,0,2,3
24258,1,3,84795,84796,84799,1,4,0
24259,1,1,84796,84799,84800,3,4,0
24260,2,2,84798,84800,84802,2,4,0
24261,4,2,84802,84802,84804,0,2,0
24262,3,3,84805,84805,84808,0,3,1
24263,5,2,84810,84810,84812,0,2,2
24264,3,2,84813,84813,84815,0,2,1
24265,3,2,84816,84816,84818,0,2,1
24266,3,2,84819,84819,84821,0,2,1
24267,5,1,84824,84824,84825,0,1,3
24268,6,2,84830,84830,84832,0,2,5
24269,5,1,84835,84835,84836,0,1,3
24270,6,2,84841,84841,84843,0,2,5
24271,4,1,84845,84845,84846,0,1,2
24272,3,2,84848,84848,84850,0,2,2
24273,3,3,84851,84851,84854,0,3,1
24274,6,2,84857,84857,84859,0,2,3
24275,6,3,84863,84863,84866,0,3,4
24276,6,1,84869,84869,84870,0,1,3
24277,4,1,84873,84873,84874,0,1,3
24278,5,3,84878,84878,84881,0,3,4
24279,6,3,84884,84884,84887,0,3,3
24280,6,2,84890,84890,84892,0,2,3
24281,5,1,84895,84895,84896,0,1,3
24282,5,3,84900,84900,84903,0,3,4
24283,3,3,84903,84903,84906,0,3,0
24284,3,1,84906,84906,84907,0,1,0
24285,1,2,84907,84907,84909,0,2,0
24286,3,1,84910,84910,84911,0,1,1
24287,3,1,84913,84913,84914,0,1,2
24288,6,1,84919,84919,84920,0,1,5
24289,6,1,84925,84925,84926,0,1,5
24290,5,3,84930,84930,84933,0,3,4
24291,4,1,84934,84934,84935,0,1,1
24292,5,1,84939,84939,84940,0,1,4
24293,2,2,84941,84941,84943,0,2,1
24294,2,2,84943,84943,84945,0,2,0
24295,1,2,84944,84945,84947,1,3,0
24296,6,1,84950,84950,84951,0,1,3
24297,4,1,84954,84954,84955,0,1,3
24298,2,3,84956,84956,84959,0,3,1
24299,6,2,84962,84962,84964,0,2,3
24300,4,3,84966,84966,84969,0,3,2
24301,5,3,84971,84971,84974,0,3,2
24302,6,3,84977,84977,84980,0,3,3
24303,3,2,84980,84980,84982,0,2,0
24304,1,3,84981,84982,84985,1,4,0
24305,4,3,84985,84985,84988,0,3,0
24306,3,1,84988,84988,84989,0,1,0
24307,1,1,84989,84989,84990,0,1,0
24308,3,1,84992,84992,84993,0,1,2
24309,5,2,84997,84997,84999,0,2,4
24310,2,3,84999,84999,85002,0,3,0
24311,5,3,85004,85004,85007,0,3,2
24312,1,3,85005,85007,85010,2,5,0
24313,2,2,85007,85010,85012,3,5,0
24314,6,1,85013,85013,85014,0,1,1
24315,3,1,85016,85016,85017,0,1,2
24316,1,3,85017,85017,85020,0,3,0
24317,1,3,85018,85020,85023,2,5,0
24318,2,1,85020,85023,85024,3,4,0
24319,5,1,85025,85025,85026,0,1,1
24320,5,2,85030,85030,85032,0,2,4
24321,1,3,85031,85032,85035,1,4,0
24322,1,2,85032,85035,85037,3,5,0
24323,2,2,85034,85037,85039,3,5,0
24324,1,3,85035,85039,85042,4,7,0
24325,5,2,85040,85042,85044,2,4,0
24326,2,3,85042,85044,85047,2,5,0
24327,6,2,85048,85048,85050,0,2,1
24328,1,1,85049,85050,85051,1,2,0
24329,3,3,85052,85052,85055,0,3,1
24330,3,3,85055,85055,85058,0,3,0
24331,4,3,85059,85059,85062,0,3,1
24332,4,3,85063,85063,85066,0,3,1
24333,3,1,85066,85066,85067,0,1,0
24334,4,2,85070,85070,85072,0,2,3
24335,3,2,85073,85073,85075,0,2,1
24336,6,1,85079,85079,85080,0,1,4
24337,2,2,85081,85081,85083,0,2,1
24338,4,3,85085,85085,85088,0,3,2
24339,1,2,85086,85088,85090,2,4,0
24340,2,3,85088,85090,85093,2,5,0
24341,3,3,85091,85093,85096,2,5,0
24342,2,1,85093,85096,85097,3,4,0
24343,1,3,85094,85097,85100,3,6,0
24344,3,1,85097,85100,85101,3,4,0
24345,1,1,85098,85101,85102,3,4,0
24346,6,1,85104,85104,85105,0,1,2
24347,4,1,85108,85108,85109,0,1,3
24348,6,1,85114,85114,85115,0,1,5
24349,4,2,85118,85118,85120,0,2,3
24350,2,1,85120,85120,85121,0,1,0
24351,5,2,85125,85125,85127,0,2,4
24352,5,2,85130,85130,85132,0,2,3
24353,1,1,85131,85132,85133,1,2,0
24354,1,1,85132,85133,85134,1,2,0
24355,6,3,85138,85138,85141,0,3,4
24356,2,1,85140,85141,85142,1,2,0
24357,6,2,85146,85146,85148,0,2,4
24358,3,2,85149,85149,85151,0,2,1
24359,6,3,85155,85155,85158,0,3,4
24360,3,3,85158,85158,85161,0,3,0
24361,2,3,85160,85161,85164,1,4,0
24362,1,1,85161,85164,85165,3,4,0
24363,5,2,85166,85166,85168,0,2,1
24364,1,2,85167,85168,85170,1,3,0
24365,5,1,85172,85172,85173,0,1,2
24366,4,1,85176,85176,85177,0,1,3
24367,5,2,85181,85181,85183,0,2,4
24368,1,1,85182,85183,85184,1,2,0
24369,3,2,85185,85185,85187,0,2,1
24370,1,3,85186,85187,85190,1,4,0
24371,3,1,85189,85190,85191,1,2,0
24372,3,2,85192,85192,85194,0,2,1
24373,4,3,85196,85196,85199,0,3,2
24374,3,2,85199,85199,85201,0,2,0
24375,4,2,85203,85203,85205,0,2,2
24376,6,1,85209,85209,85210,0,1,4
24377,1,2,85210,85210,85212,0,2,0
24378,5,3,85215,85215,85218,0,3,3
24379,1,3,85216,85218,85221,2,5,0
24380,1,3,85217,85221,85224,4,7,0
24381,2,3,85219,85224,85227,5,8,0
24382,4,2,85223,85227,85229,4,6,0
24383,2,1,85225,85229,85230,4,5,0
24384,6,3,85231,85231,85234,0,3,1
24385,5,3,85236,85236,85239,0,3,2
24386,2,2,85238,85239,85241,1,3,0
24387,2,1,85240,85241,85242,1,2,0
24388,4,3,85244,85244,85247,0,3,2
24389,6,1,85250,85250,85251,0,1,3
24390,6,1,85256,85256,85257,0,1,5
24391,6,3,85262,85262,85265,0,3,5
24392,6,2,85268,85268,85270,0,2,3
24393,3,1,85271,85271,85272,0,1,1
24394,1,2,85272,85272,85274,0,2,0
24395,1,2,85273,85274,85276,1,3,0
24396,5,2,85278,85278,85280,0,2,2
24397,1,3,85279,85280,85283,1,4,0
24398,1,3,85280,85283,85286,3,6,0
24399,2,1,85282,85286,85287,4,5,0
24400,2,1,85284,85287,85288,3,4,0
24401,2,1,85286,85288,85289,2,3,0
24402,6,3,85292,85292,85295,0,3,3
24403,2,3,85294,85295,85298,1,4,0
24404,5,3,85299,85299,85302,0,3,1
24405,3,1,85302,85302,85303,0,1,0
24406,2,2,85304,85304,85306,0,2,1
24407,1,1,85305,85306,85307,1,2,0
24408,6,2,85311,85311,85313,0,2,4
24409,4,2,85315,85315,85317,0,2,2
24410,4,1,85319,85319,85320,0,1,2
24411,4,2,85323,85323,85325,0,2,3
24412,2,3,85325,85325,85328,0,3,0
24413,5,2,85330,85330,85332,0,2,2
24414,3,3,85333,85333,85336,0,3,1
24415,1,2,85334,85336,85338,2,4,0
24416,1,3,85335,85338,85341,3,6,0
24417,6,2,85341,85341,85343,0,2,0
24418,6,2,85347,85347,85349,0,2,4
24419,1,1,85348,85349,85350,1,2,0
24420,4,3,85352,85352,85355,0,3,2
24421,4,1,85356,85356,85357,0,1,1
24422,6,1,85362,85362,85363,0,1,5
24423,3,2,85365,85365,85367,0,2,2
24424,1,2,85366,85367,85369,1,3,0
24425,6,2,85372,85372,85374,0,2,3
24426,5,3,85377,85377,85380,0,3,3
24427,5,2,85382,85382,85384,0,2,2
24428,2,2,85384,85384,85386,0,2,0
24429,2,3,85386,85386,85389,0,3,0
24430,3,1,85389,85389,85390,0,1,0
24431,5,3,85394,85394,85397,0,3,4
24432,2,3,85396,85397,85400,1,4,0
24433,4,3,85400,85400,85403,0,3,0
24434,6,2,85406,85406,85408,0,2,3
24435,6,3,85412,85412,85415,0,3,4
24436,1,1,85413,85415,85416,2,3,0
24437,2,1,85415,85416,85417,1,2,0
24438,6,2,85421,85421,85423,0,2,4
24439,6,1,85427,85427,85428,0,1,4
24440,6,2,85433,85433,85435,0,2,5
24441,6,1,85439,85439,85440,0,1,4
24442,1,3,85440,85440,85443,0,3,0
24443,5,3,85445,85445,85448,0,3,2
24444,1,1,85446,85448,85449,2,3,0
24445,4,1,85450,85450,85451,0,1,1
24446,6,1,85456,85456,85457,0,1,5
24447,3,1,85459,85459,85460,0,1,2
24448,3,3,85462,85462,85465,0,3,2
24449,3,3,85465,85465,85468,0,3,0
24450,2,1,85467,85468,85469,1,2,0
24451,4,2,85471,85471,85473,0,2,2
24452,1,3,85472,85473,85476,1,4,0
24453,6,1,85478,85478,85479,0,1,2
24454,2,1,85480,85480,85481,0,1,1
24455,4,1,85484,85484,85485,0,1,3
24456,6,3,85490,85490,85493,0,3,5
24457,6,3,85496,85496,85499,0,3,3
24458,1,1,85497,85499,85500,2,3,0
24459,6,3,85503,85503,85506,0,3,3
24460,5,1,85508,85508,85509,0,1,2
24461,2,1,85510,85510,85511,0,1,1
24462,1,2,85511,85511,85513,0,2,0
24463,2,1,85513,85513,85514,0,1,0
24464,5,1,85518,85518,85519,0,1,4
24465,1,3,85519,85519,85522,0,3,0
24466,3,2,85522,85522,85524,0,2,0
24467,3,2,85525,85525,85527,0,2,1
24468,5,3,85530,85530,85533,0,3,3
24469,3,3,85533,85533,85536,0,3,0
24470,5,2,85538,85538,85540,0,2,2
24471,5,3,85543,85543,85546,0,3,3
24472,1,3,85544,85546,85549,2,5,0
24473,3,1,85547,85549,85550,2,3,0
24474,1,1,85548,85550,85551,2,3,0
24475,1,3,85549,85551,85554,2,5,0
24476,4,2,85553,85554,85556,1,3,0
24477,5,2,85558,85558,85560,0,2,2
24478,3,3,85561,85561,85564,0,3,1
24479,2,1,85563,85564,85565,1,2,0
24480,1,3,85564,85565,85568,1,4,0
24481,4,1,85568,85568,85569,0,1,0
24482,1,3,85569,85569,85572,0,3,0
24483,1,2,85570,85572,85574,2,4,0
24484,4,3,85574,85574,85577,0,3,0
24485,6,3,85580,85580,85583,0,3,3
24486,4,3,85584,85584,85587,0,3,1
24487,3,3,85587,85587,85590,0,3,0
24488,6,2,85593,85593,85595,0,2,3
24489,2,1,85595,85595,85596,0,1,0
24490,6,1,85601,85601,85602,0,1,5
24491,2,3,85603,85603,85606,0,3,1
24492,2,1,85605,85606,85607,1,2,0
24493,6,2,85611,85611,85613,0,2,4
24494,5,3,85616,85616,85619,0,3,3
24495,2,2,85618,85619,85621,1,3,0
24496,6,2,85624,85624,85626,0,2,3
24497,6,1,85630,85630,85631,0,1,4
24498,5,3,85635,85635,85638,0,3,4
24499,6,3,85641,85641,85644,0,3,3
24500,1,3,85642,85644,85647,2,5,0
24501,4,1,85646,85647,85648,1,2,0
24502,1,2,85647,85648,85650,1,3,0
24503,4,1,85651,85651,85652,0,1,1
24504,3,1,85654,85654,85655,0,1,2
24505,3,2,85657,85657,85659,0,2,2
24506,4,1,85661,85661,85662,0,1,2
24507,2,3,85663,85663,85666,0,3,1
24508,6,1,85669,85669,85670,0,1,3
24509,4,3,85673,85673,85676,0,3,3
24510,3,3,85676,85676,85679,0,3,0
24511,6,3,85682,85682,85685,0,3,3
24512,2,1,85684,85685,85686,1,2,0
24513,5,2,85689,85689,85691,0,2,3
24514,1,1,85690,85691,85692,1,2,0
24515,4,3,85694,85694,85697,0,3,2
24516,4,1,85698,85698,85699,0,1,1
24517,5,3,85703,85703,85706,0,3,4
24518,2,1,85705,85706,85707,1,2,0
24519,1,2,85706,85707,85709,1,3,0
24520,3,1,85709,85709,85710,0,1,0
24521,4,2,85713,85713,85715,0,2,3
24522,4,3,85717,85717,85720,0,3,2
24523,5,1,85722,85722,85723,0,1,2
24524,4,1,85726,85726,85727,0,1,3
24525,1,2,85727,85727,85729,0,2,0
24526,2,3,85729,85729,85732,0,3,0
24527,3,3,85732,85732,85735,0,3,0
24528,5,3,85737,85737,85740,0,3,2
24529,4,1,85741,85741,85742,0,1,1
24530,5,3,85746,85746,85749,0,3,4
24531,2,1,85748,85749,85750,1,2,0
24532,4,3,85752,85752,85755,0,3,2
24533,5,2,85757,85757,85759,0,2,2
24534,3,1,85760,85760,85761,0,1,1
24535,2,1,85762,85762,85763,0,1,1
24536,3,3,85765,85765,85768,0,3,2
24537,6,3,85771,85771,85774,0,3,3
24538,2,3,85773,85774,85777,1,4,0
24539,1,1,85774,85777,85778,3,4,0
24540,6,1,85780,85780,85781,0,1,2
24541,4,3,85784,85784,85787,0,3,3
24542,6,1,85790,85790,85791,0,1,3
24543,1,3,85791,85791,85794,0,3,0
24544,1,2,85792,85794,85796,2,4,0
24545,1,1,85793,85796,85797,3,4,0
24546,1,2,85794,85797,85799,3,5,0
24547,2,1,85796,85799,85800,3,4,0
24548,4,3,85800,85800,85803,0,3,0
24549,5,2,85805,85805,85807,0,2,2
24550,6,1,85811,85811,85812,0,1,4
24551,6,2,85817,85817,85819,0,2,5
24552,5,2,85822,85822,85824,0,2,3
24553,3,1,85825,85825,85826,0,1,1
24554,3,3,85828,85828,85831,0,3,2
24555,2,1,85830,85831,85832,1,2,0
24556,1,2,85831,85832,85834,1,3,0
24557,6,3,85837,85837,85840,0,3,3
24558,4,1,85841,85841,85842,0,1,1
24559,1,2,85842,85842,85844,0,2,0
24560,1,3,85843,85844,85847,1,4,0
24561,2,1,85845,85847,85848,2,3,0
24562,2,2,85847,85848,85850,1,3,0
24563,1,2,85848,85850,85852,2,4,0
24564,3,2,85851,85852,85854,1,3,0
24565,4,2,85855,85855,85857,0,2,1
24566,5,2,85860,85860,85862,0,2,3
24567,1,2,85861,85862,85864,1,3,0
24568,1,1,85862,85864,85865,2,3,0
24569,4,3,85866,85866,85869,0,3,1
24570,3,3,85869,85869,85872,0,3,0
24571,6,2,85875,85875,85877,0,2,3
24572,1,1,85876,85877,85878,1,2,0
24573,3,1,85879,85879,85880,0,1,1
24574,4,2,85883,85883,85885,0,2,3
24575,6,3,85889,85889,85892,0,3,4
24576,1,2,85890,85892,85894,2,4,0
24577,5,3,85895,85895,85898,0,3,1
24578,5,2,85900,85900,85902,0,2,2
24579,3,3,85903,85903,85906,0,3,1
24580,6,3,85909,85909,85912,0,3,3
24581,3,3,85912,85912,85915,0,3,0
24582,3,1,85915,85915,85916,0,1,0
24583,1,3,85916,85916,85919,0,3,0
24584,3,2,85919,85919,85921,0,2,0
24585,2,2,85921,85921,85923,0,2,0
24586,4,3,85925,85925,85928,0,3,2
24587,4,1,85929,85929,85930,0,1,1
24588,5,1,85934,85934,85935,0,1,4
24589,3,1,85937,85937,85938,0,1,2
24590,4,2,85941,85941,85943,0,2,3
24591,6,3,85947,85947,85950,0,3,4
24592,1,3,85948,85950,85953,2,5,0
24593,6,3,85954,85954,85957,0,3,1
24594,5,2,85959,85959,85961,0,2,2
24595,1,3,85960,85961,85964,1,4,0
24596,6,2,85966,85966,85968,0,2,2
24597,5,1,85971,85971,85972,0,1,3
24598,6,2,85977,85977,85979,0,2,5
24599,4,2,85981,85981,85983,0,2,2
24600,3,3,85984,85984,85987,0,3,1
24601,6,1,85990,85990,85991,0,1,3
24602,3,2,85993,85993,85995,0,2,2
24603,4,1,85997,85997,85998,0,1,2
24604,2,1,85999,85999,86000,0,1,1
24605,4,2,86003,86003,86005,0,2,3
24606,6,1,86009,86009,86010,0,1,4
24607,1,1,86010,86010,86011,0,1,0
24608,3,3,86013,86013,86016,0,3,2
24609,4,2,86017,86017,86019,0,2,1
24610,4,2,86021,86021,86023,0,2,2
24611,6,2,86027,86027,86029,0,2,4
24612,4,2,86031,86031,86033,0,2,2
24613,3,1,86034,86034,86035,0,1,1
24614,1,2,86035,86035,86037,0,2,0
24615,1,2,86036,86037,86039,1,3,0
24616,2,1,86038,86039,86040,1,2,0
24617,6,3,86044,86044,86047,0,3,4
24618,4,1,86048,86048,86049,0,1,1
24619,4,3,86052,86052,86055,0,3,3
24620,5,1,86057,86057,86058,0,1,2
24621,5,2,86062,86062,86064,0,2,4
24622,4,1,86066,86066,86067,0,1,2
24623,5,3,86071,86071,86074,0,3,4
24624,5,1,86076,86076,86077,0,1,2
24625,4,1,86080,86080,86081,0,1,3
24626,2,1,86082,86082,86083,0,1,1
24627,4,2,86086,86086,86088,0,2,3
24628,5,2,86091,86091,86093,0,2,3
24629,3,2,86094,86094,86096,0,2,1
24630,1,2,86095,86096,86098,1,3,0
24631,2,1,86097,86098,86099,1,2,0
24632,5,2,86102,86102,86104,0,2,3
24633,4,3,86106,86106,86109,0,3,2
24634,4,3,86110,86110,86113,0,3,1
24635,5,1,86115,86115,86116,0,1,2
24636,6,2,86121,86121,86123,0,2,5
24637,5,1,86126,86126,86127,0,1,3
24638,6,3,86132,86132,86135,0,3,5
24639,1,3,86133,86135,86138,2,5,0
24640,5,2,86138,86138,86140,0,2,0
24641,4,3,86142,86142,86145,0,3,2
24642,1,3,86143,86145,86148,2,5,0
24643,3,1,86146,86148,86149,2,3,0
24644,4,1,86150,86150,86151,0,1,1
24645,5,2,86155,86155,86157,0,2,4
24646,4,3,86159,86159,86162,0,3,2
24647,3,1,86162,86162,86163,0,1,0
24648,3,2,86165,86165,86167,0,2,2
24649,2,1,86167,86167,86168,0,1,0
24650,4,3,86171,86171,86174,0,3,3
24651,1,1,86172,86174,86175,2,3,0
24652,5,1,86177,86177,86178,0,1,2
24653,5,3,86182,86182,86185,0,3,4
24654,2,3,86184,86185,86188,1,4,0
24655,1,2,86185,86188,86190,3,5,0
24656,1,3,86186,86190,86193,4,7,0
24657,6,2,86192,86193,86195,1,3,0
24658,2,1,86194,86195,86196,1,2,0
24659,5,2,86199,86199,86201,0,2,3
24660,4,1,86203,86203,86204,0,1,2
24661,2,1,86205,86205,86206,0,1,1
24662,3,3,86208,86208,86211,0,3,2
24663,3,2,86211,86211,86213,0,2,0
24664,2,3,86213,86213,86216,0,3,0
24665,3,1,86216,86216,86217,0,1,0
24666,6,3,86222,86222,86225,0,3,5
24667,1,3,86223,86225,86228,2,5,0
24668,6,2,86229,86229,86231,0,2,1
24669,4,1,86233,86233,86234,0,1,2
24670,5,1,86238,86238,86239,0,1,4
24671,6,1,86244,86244,86245,0,1,5
24672,2,1,86246,86246,86247,0,1,1
24673,4,2,86250,86250,86252,0,2,3
24674,1,2,86251,86252,86254,1,3,0
24675,4,2,86255,86255,86257,0,2,1
24676,3,3,86258,86258,86261,0,3,1
24677,6,3,86264,86264,86267,0,3,3
24678,6,3,86270,86270,86273,0,3,3
24679,1,1,86271,86273,86274,2,3,0
24680,2,2,86273,86274,86276,1,3,0
24681,4,3,86277,86277,86280,0,3,1
24682,4,1,86281,86281,86282,0,1,1
24683,5,3,86286,86286,86289,0,3,4
24684,1,3,86287,86289,86292,2,5,0
24685,6,2,86293,86293,86295,0,2,1
24686,3,1,86296,86296,86297,0,1,1
24687,2,3,86298,86298,86301,0,3,1
24688,3,1,86301,86301,86302,0,1,0
24689,2,2,86303,86303,86305,0,2,1
24690,1,2,86304,86305,86307,1,3,0
24691,4,2,86308,86308,86310,0,2,1
24692,6,3,86314,86314,86317,0,3,4
24693,4,1,86318,86318,86319,0,1,1
24694,1,2,86319,86319,86321,0,2,0
24695,1,2,86320,86321,86323,1,3,0
24696,5,2,86325,86325,86327,0,2,2
24697,6,2,86331,86331,86333,0,2,4
24698,4,2,86335,86335,86337,0,2,2
24699,4,1,86339,86339,86340,0,1,2
24700,3,2,86342,86342,86344,0,2,2
24701,5,2,86347,86347,86349,0,2,3
24702,6,3,86353,86353,86356,0,3,4
24703,3,1,86356,86356,86357,0,1,0
24704,4,3,86360,86360,86363,0,3,3
24705,5,3,86365,86365,86368,0,3,2
24706,5,2,86370,86370,86372,0,2,2
24707,5,3,86375,86375,86378,0,3,3
24708,2,1,86377,86378,86379,1,2,0
24709,2,1,86379,86379,86380,0,1,0
24710,1,3,86380,86380,86383,0,3,0
24711,4,2,86384,86384,86386,0,2,1
24712,4,3,86388,86388,86391,0,3,2
24713,3,1,86391,86391,86392,0,1,0
24714,3,2,86394,86394,86396,0,2,2
24715,4,3,86398,86398,86401,0,3,2
24716,1,2,86399,86401,86403,2,4,0
24717,3,1,86402,86403,86404,1,2,0
24718,6,1,86408,86408,86409,0,1,4
24719,2,1,86410,86410,86411,0,1,1
24720,2,2,86412,86412,86414,0,2,1
24721,6,2,86418,86418,86420,0,2,4
24722,4,1,86422,86422,86423,0,1,2
24723,3,3,86425,86425,86428,0,3,2
24724,4,3,86429,86429,86432,0,3,1
24725,5,2,86434,86434,86436,0,2,2
24726,2,2,86436,86436,86438,0,2,0
24727,4,3,86440,86440,86443,0,3,2
24728,6,3,86446,86446,86449,0,3,3
24729,6,1,86452,86452,86453,0,1,3
24730,3,3,86455,86455,86458,0,3,2
24731,4,3,86459,86459,86462,0,3,1
24732,2,2,86461,86462,86464,1,3,0
24733,3,3,86464,86464,86467,0,3,0
24734,1,2,86465,86467,86469,2,4,0
24735,1,2,86466,86469,86471,3,5,0
24736,1,3,86467,86471,86474,4,7,0
24737,1,1,86468,86474,86475,6,7,0
24738,2,1,86470,86475,86476,5,6,0
24739,1,1,86471,86476,86477,5,6,0
24740,4,1,86475,86477,86478,2,3,0
24741,4,2,86479,86479,86481,0,2,1
24742,5,2,86484,86484,86486,0,2,3
24743,2,1,86486,86486,86487,0,1,0
24744,6,1,86492,86492,86493,0,1,5
24745,2,1,86494,86494,86495,0,1,1
24746,6,2,86500,86500,86502,0,2,5
24747,5,1,86505,86505,86506,0,1,3
24748,4,3,86509,86509,86512,0,3,3
24749,3,1,86512,86512,86513,0,1,0
24750,3,1,86515,86515,86516,0,1,2
24751,1,1,86516,86516,86517,0,1,0
24752,6,1,86522,86522,86523,0,1,5
24753,4,2,86526,86526,86528,0,2,3
24754,6,3,86532,86532,86535,0,3,4
24755,5,1,86537,86537,86538,0,1,2
24756,3,3,86540,86540,86543,0,3,2
24757,4,1,86544,86544,86545,0,1,1
24758,3,1,86547,86547,86548,0,1,2
24759,2,1,86549,86549,86550,0,1,1
24760,4,2,86553,86553,86555,0,2,3
24761,6,3,86559,86559,86562,0,3,4
24762,6,1,86565,86565,86566,0,1,3
24763,1,1,86566,86566,86567,0,1,0
24764,5,2,86571,86571,86573,0,2,4
24765,5,1,86576,86576,86577,0,1,3
24766,3,3,86579,86579,86582,0,3,2
24767,2,1,86581,86582,86583,1,2,0
24768,5,1,86586,86586,86587,0,1,3
24769,5,2,86591,86591,86593,0,2,4
24770,4,3,86595,86595,86598,0,3,2
24771,4,1,86599,86599,86600,0,1,1
24772,1,1,86600,86600,86601,0,1,0
24773,6,1,86606,86606,86607,0,1,5
24774,4,3,86610,86610,86613,0,3,3
24775,2,2,86612,86613,86615,1,3,0
24776,1,3,86613,86615,86618,2,5,0
24777,5,1,86618,86618,86619,0,1,0
24778,1,2,86619,86619,86621,0,2,0
24779,6,1,86625,86625,86626,0,1,4
24780,5,1,86630,86630,86631,0,1,4
24781,4,3,86634,86634,86637,0,3,3
24782,1,1,86635,86637,86638,2,3,0
24783,3,2,86638,86638,86640,0,2,0
24784,6,2,86644,86644,86646,0,2,4
24785,2,3,86646,86646,86649,0,3,0
24786,1,1,86647,86649,86650,2,3,0
24787,1,2,86648,86650,86652,2,4,0
24788,1,3,86649,86652,86655,3,6,0
24789,2,2,86651,86655,86657,4,6,0
24790,5,1,86656,86657,86658,1,2,0
24791,2,2,86658,86658,86660,0,2,0
24792,6,2,86664,86664,86666,0,2,4
24793,4,3,86668,86668,86671,0,3,2
24794,1,1,86669,86671,86672,2,3,0
24795,3,3,86672,86672,86675,0,3,0
24796,5,2,86677,86677,86679,0,2,2
24797,2,2,86679,86679,86681,0,2,0
24798,2,1,86681,86681,86682,0,1,0
24799,1,3,86682,86682,86685,0,3,0
24800,2,1,86684,86685,86686,1,2,0
24801,1,2,86685,86686,86688,1,3,0
24802,3,1,86688,86688,86689,0,1,0
24803,5,2,86693,86693,86695,0,2,4
24804,6,2,86699,86699,86701,0,2,4
24805,2,3,86701,86701,86704,0,3,0
24806,4,3,86705,86705,86708,0,3,1
24807,4,1,86709,86709,86710,0,1,1
24808,5,3,86714,86714,86717,0,3,4
24809,5,3,86719,86719,86722,0,3,2
24810,6,1,86725,86725,86726,0,1,3
24811,3,2,86728,86728,86730,0,2,2
24812,5,3,86733,86733,86736,0,3,3
24813,3,3,86736,86736,86739,0,3,0
24814,4,2,86740,86740,86742,0,2,1
24815,3,1,86743,86743,86744,0,1,1
24816,6,2,86749,86749,86751,0,2,5
24817,4,1,86753,86753,86754,0,1,2
24818,4,2,86757,86757,86759,0,2,3
24819,3,1,86760,86760,86761,0,1,1
24820,4,3,86764,86764,86767,0,3,3
24821,6,3,86770,86770,86773,0,3,3
24822,6,1,86776,86776,86777,0,1,3
24823,4,3,86780,86780,86783,0,3,3
24824,5,2,86785,86785,86787,0,2,2
24825,1,2,86786,86787,86789,1,3,0
24826,5,3,86791,86791,86794,0,3,2
24827,3,2,86794,86794,86796,0,2,0
24828,2,1,86796,86796,86797,0,1,0
24829,4,3,86800,86800,86803,0,3,3
24830,2,2,86802,86803,86805,1,3,0
24831,1,2,86803,86805,86807,2,4,0
24832,3,1,86806,86807,86808,1,2,0
24833,5,1,86811,86811,86812,0,1,3
24834,2,2,86813,86813,86815,0,2,1
24835,6,1,86819,86819,86820,0,1,4
24836,5,3,86824,86824,86827,0,3,4
24837,5,2,86829,86829,86831,0,2,2
24838,1,2,86830,86831,86833,1,3,0
24839,6,2,86836,86836,86838,0,2,3
24840,5,3,86841,86841,86844,0,3,3
24841,3,3,86844,86844,86847,0,3,0
24842,4,1,86848,86848,86849,0,1,1
24843,4,2,86852,86852,86854,0,2,3
24844,6,2,86858,86858,86860,0,2,4
24845,6,1,86864,86864,86865,0,1,4
24846,6,1,86870,86870,86871,0,1,5
24847,6,3,86876,86876,86879,0,3,5
24848,1,3,86877,86879,86882,2,5,0
24849,5,2,86882,86882,86884,0,2,0
24850,5,2,86887,86887,86889,0,2,3
24851,5,2,86892,86892,86894,0,2,3
24852,4,1,86896,86896,86897,0,1,2
24853,6,2,86902,86902,86904,0,2,5
24854,5,3,86907,86907,86910,0,3,3
24855,2,3,86909,86910,86913,1,4,0
24856,4,2,86913,86913,86915,0,2,0
24857,5,1,86918,86918,86919,0,1,3
24858,6,2,86924,86924,86926,0,2,5
24859,4,2,86928,86928,86930,0,2,2
24860,4,1,86932,86932,86933,0,1,2
24861,6,1,86938,86938,86939,0,1,5
24862,1,2,86939,86939,86941,0,2,0
24863,1,2,86940,86941,86943,1,3,0
24864,6,3,86946,86946,86949,0,3,3
24865,6,3,86952,86952,86955,0,3,3
24866,2,3,86954,86955,86958,1,4,0
24867,5,2,86959,86959,86961,0,2,1
24868,5,1,86964,86964,86965,0,1,3
24869,5,1,86969,86969,86970,0,1,4
24870,3,1,86972,86972,86973,0,1,2
24871,4,3,86976,86976,86979,0,3,3
24872,4,3,86980,86980,86983,0,3,1
24873,5,1,86985,86985,86986,0,1,2
24874,2,2,86987,86987,86989,0,2,1
24875,3,1,86990,86990,86991,0,1,1
24876,6,1,86996,86996,86997,0,1,5
24877,4,3,87000,87000,87003,0,3,3
24878,3,1,87003,87003,87004,0,1,0
24879,4,1,87007,87007,87008,0,1,3
24880,1,3,87008,87008,87011,0,3,0
24881,3,2,87011,87011,87013,0,2,0
24882,3,2,87014,87014,87016,0,2,1
24883,5,2,87019,87019,87021,0,2,3
24884,2,1,87021,87021,87022,0,1,0
24885,2,3,87023,87023,87026,0,3,1
24886,3,3,87026,87026,87029,0,3,0
24887,4,3,87030,87030,87033,0,3,1
24888,2,3,87032,87033,87036,1,4,0
24889,2,3,87034,87036,87039,2,5,0
24890,4,1,87038,87039,87040,1,2,0
24891,6,1,87044,87044,87045,0,1,4
24892,4,3,87048,87048,87051,0,3,3
24893,2,3,87050,87051,87054,1,4,0
24894,2,2,87052,87054,87056,2,4,0
24895,6,3,87058,87058,87061,0,3,2
24896,4,3,87062,87062,87065,0,3,1
24897,5,2,87067,87067,87069,0,2,2
24898,3,1,87070,87070,87071,0,1,1
24899,1,1,87071,87071,87072,0,1,0
24900,3,1,87074,87074,87075,0,1,2
24901,1,2,87075,87075,87077,0,2,0
24902,4,3,87079,87079,87082,0,3,2
24903,4,1,87083,87083,87084,0,1,1
24904,3,2,87086,87086,87088,0,2,2
24905,2,1,87088,87088,87089,0,1,0
24906,6,3,87094,87094,87097,0,3,5
24907,6,3,87100,87100,87103,0,3,3
24908,5,3,87105,87105,87108,0,3,2
24909,5,1,87110,87110,87111,0,1,2
24910,6,1,87116,87116,87117,0,1,5
24911,3,3,87119,87119,87122,0,3,2
24912,5,3,87124,87124,87127,0,3,2
24913,2,1,87126,87127,87128,1,2,0
24914,4,3,87130,87130,87133,0,3,2
24915,1,3,87131,87133,87136,2,5,0
24916,6,3,87137,87137,87140,0,3,1
24917,5,3,87142,87142,87145,0,3,2
24918,1,2,87143,87145,87147,2,4,0
24919,1,1,87144,87147,87148,3,4,0
24920,4,3,87148,87148,87151,0,3,0
24921,1,1,87149,87151,87152,2,3,0
24922,4,2,87153,87153,87155,0,2,1
24923,1,2,87154,87155,87157,1,3,0
24924,3,2,87157,87157,87159,0,2,0
24925,5,1,87162,87162,87163,0,1,3
24926,3,1,87165,87165,87166,0,1,2
24927,1,3,87166,87166,87169,0,3,0
24928,4,3,87170,87170,87173,0,3,1
24929,6,2,87176,87176,87178,0,2,3
24930,5,2,87181,87181,87183,0,2,3
24931,2,1,87183,87183,87184,0,1,0
24932,4,2,87187,87187,87189,0,2,3
24933,5,2,87192,87192,87194,0,2,3
24934,2,2,87194,87194,87196,0,2,0
24935,3,1,87197,87197,87198,0,1,1
24936,5,2,87202,87202,87204,0,2,4
24937,5,2,87207,87207,87209,0,2,3
24938,1,2,87208,87209,87211,1,3,0
24939,6,1,87214,87214,87215,0,1,3
24940,3,3,87217,87217,87220,0,3,2
24941,6,3,87223,87223,87226,0,3,3
24942,5,1,87228,87228,87229,0,1,2
24943,3,1,87231,87231,87232,0,1,2
24944,2,1,87233,87233,87234,0,1,1
24945,4,2,87237,87237,87239,0,2,3
24946,2,3,87239,87239,87242,0,3,0
24947,2,3,87241,87242,87245,1,4,0
24948,2,1,87243,87245,87246,2,3,0
24949,6,1,87249,87249,87250,0,1,3
24950,1,3,87250,87250,87253,0,3,0
24951,6,3,87256,87256,87259,0,3,3
24952,5,1,87261,87261,87262,0,1,2
24953,2,2,87263,87263,87265,0,2,1
24954,6,2,87269,87269,87271,0,2,4
24955,6,3,87275,87275,87278,0,3,4
24956,6,2,87281,87281,87283,0,2,3
24957,1,2,87282,87283,87285,1,3,0
24958,4,3,87286,87286,87289,0,3,1
24959,1,3,87287,87289,87292,2,5,0
24960,4,1,87291,87292,87293,1,2,0
24961,2,2,87293,87293,87295,0,2,0
24962,6,1,87299,87299,87300,0,1,4
24963,3,3,87302,87302,87305,0,3,2
24964,4,2,87306,87306,87308,0,2,1
24965,2,3,87308,87308,87311,0,3,0
24966,3,3,87311,87311,87314,0,3,0
24967,4,2,87315,87315,87317,0,2,1
24968,6,1,87321,87321,87322,0,1,4
24969,4,2,87325,87325,87327,0,2,3
24970,1,3,87326,87327,87330,1,4,0
24971,3,1,87329,87330,87331,1,2,0
24972,3,2,87332,87332,87334,0,2,1
24973,6,3,87338,87338,87341,0,3,4
24974,3,1,87341,87341,87342,0,1,0
24975,4,2,87345,87345,87347,0,2,3
24976,3,2,87348,87348,87350,0,2,1
24977,2,1,87350,87350,87351,0,1,0
24978,5,1,87355,87355,87356,0,1,4
24979,2,3,87357,87357,87360,0,3,1
24980,1,1,87358,87360,87361,2,3,0
24981,5,3,87363,87363,87366,0,3,2
24982,5,2,87368,87368,87370,0,2,2
24983,1,1,87369,87370,87371,1,2,0
24984,5,3,87374,87374,87377,0,3,3
24985,5,1,87379,87379,87380,0,1,2
24986,5,3,87384,87384,87387,0,3,4
24987,2,1,87386,87387,87388,1,2,0
24988,1,3,87387,87388,87391,1,4,0
24989,1,1,87388,87391,87392,3,4,0
24990,2,3,87390,87392,87395,2,5,0
24991,3,1,87393,87395,87396,2,3,0
24992,2,1,87395,87396,87397,1,2,0
24993,5,2,87400,87400,87402,0,2,3
24994,2,1,87402,87402,87403,0,1,0
24995,3,1,87405,87405,87406,0,1,2
24996,4,1,87409,87409,87410,0,1,3
24997,4,1,87413,87413,87414,0,1,3
24998,2,2,87415,87415,87417,0,2,1
24999,1,2,87416,87417,87419,1,3,0
25000,4,1,87420,87420,87421,0,1,1
25001,4,2,87424,87424,87426,0,2,3
25002,5,2,87429,87429,87431,0,2,3
25003,2,1,87431,87431,87432,0,1,0
25004,2,3,87433,87433,87436,0,3,1
25005,1,3,87434,87436,87439,2,5,0
25006,4,1,87438,87439,87440,1,2,0
25007,1,3,87439,87440,87443,1,4,0
25008,1,1,87440,87443,87444,3,4,0
25009,1,1,87441,87444,87445,3,4,0
25010,2,3,87443,87445,87448,2,5,0
25011,2,1,87445,87448,87449,3,4,0
25012,1,1,87446,87449,87450,3,4,0
25013,2,3,87448,87450,87453,2,5,0
25014,6,1,87454,87454,87455,0,1,1
25015,5,3,87459,87459,87462,0,3,4
25016,4,3,87463,87463,87466,0,3,1
25017,4,1,87467,87467,87468,0,1,1
25018,2,1,87469,87469,87470,0,1,1
25019,5,3,87474,87474,87477,0,3,4
25020,3,1,87477,87477,87478,0,1,0
25021,3,2,87480,87480,87482,0,2,2
25022,6,3,87486,87486,87489,0,3,4
25023,5,2,87491,87491,87493,0,2,2
25024,1,3,87492,87493,87496,1,4,0
25025,2,1,87494,87496,87497,2,3,0
25026,1,2,87495,87497,87499,2,4,0
25027,1,3,87496,87499,87502,3,6,0
25028,3,3,87499,87502,87505,3,6,0
25029,3,2,87502,87505,87507,3,5,0
25030,4,2,87506,87507,87509,1,3,0
25031,2,2,87508,87509,87511,1,3,0
25032,6,1,87514,87514,87515,0,1,3
25033,3,3,87517,87517,87520,0,3,2
25034,3,3,87520,87520,87523,0,3,0
25035,4,2,87524,87524,87526,0,2,1
25036,2,3,87526,87526,87529,0,3,0
25037,6,1,87532,87532,87533,0,1,3
25038,1,3,87533,87533,87536,0,3,0
25039,3,1,87536,87536,87537,0,1,0
25040,5,3,87541,87541,87544,0,3,4
25041,2,1,87543,87544,87545,1,2,0
25042,1,1,87544,87545,87546,1,2,0
25043,2,3,87546,87546,87549,0,3,0
25044,3,3,87549,87549,87552,0,3,0
25045,2,1,87551,87552,87553,1,2,0
25046,5,2,87556,87556,87558,0,2,3
25047,5,3,87561,87561,87564,0,3,3
25048,3,2,87564,87564,87566,0,2,0
25049,4,2,87568,87568,87570,0,2,2
25050,5,1,87573,87573,87574,0,1,3
25051,3,1,87576,87576,87577,0,1,2
25052,1,3,87577,87577,87580,0,3,0
25053,4,3,87581,87581,87584,0,3,1
25054,6,3,87587,87587,87590,0,3,3
25055,2,3,87589,87590,87593,1,4,0
25056,3,3,87592,87593,87596,1,4,0
25057,2,1,87594,87596,87597,2,3,0
25058,3,3,87597,87597,87600,0,3,0
25059,6,1,87603,87603,87604,0,1,3
25060,2,3,87605,87605,87608,0,3,1
25061,4,2,87609,87609,87611,0,2,1
25062,3,1,87612,87612,87613,0,1,1
25063,2,1,87614,87614,87615,0,1,1
25064,2,1,87616,87616,87617,0,1,1
25065,1,3,87617,87617,87620,0,3,0
25066,6,2,87623,87623,87625,0,2,3
25067,5,3,87628,87628,87631,0,3,3
25068,6,1,87634,87634,87635,0,1,3
25069,5,2,87639,87639,87641,0,2,4
25070,3,2,87642,87642,87644,0,2,1
25071,3,2,87645,87645,87647,0,2,1
25072,3,3,87648,87648,87651,0,3,1
25073,2,1,87650,87651,87652,1,2,0
25074,6,3,87656,87656,87659,0,3,4
25075,2,1,87658,87659,87660,1,2,0
25076,6,1,87664,87664,87665,0,1,4
25077,2,1,87666,87666,87667,0,1,1
25078,1,1,87667,87667,87668,0,1,0
25079,6,1,87673,87673,87674,0,1,5
25080,3,1,87676,87676,87677,0,1,2
25081,2,3,87678,87678,87681,0,3,1
25082,4,3,87682,87682,87685,0,3,1
25083,1,3,87683,87685,87688,2,5,0
25084,6,1,87689,87689,87690,0,1,1
25085,2,1,87691,87691,87692,0,1,1
25086,6,3,87697,87697,87700,0,3,5
25087,5,2,87702,87702,87704,0,2,2
25088,4,3,87706,87706,87709,0,3,2
25089,4,3,87710,87710,87713,0,3,1
25090,3,3,87713,87713,87716,0,3,0
25091,2,3,87715,87716,87719,1,4,0
25092,2,2,87717,87719,87721,2,4,0
25093,3,2,87720,87721,87723,1,3,0
25094,3,1,87723,87723,87724,0,1,0
25095,5,3,87728,87728,87731,0,3,4
25096,6,1,87734,87734,87735,0,1,3
25097,6,2,87740,87740,87742,0,2,5
25098,4,1,87744,87744,87745,0,1,2
25099,6,1,87750,87750,87751,0,1,5
25100,2,1,87752,87752,87753,0,1,1
25101,1,1,87753,87753,87754,0,1,0
25102,5,2,87758,87758,87760,0,2,4
25103,2,2,87760,87760,87762,0,2,0
25104,2,1,87762,87762,87763,0,1,0
25105,1,1,87763,87763,87764,0,1,0
25106,4,3,87767,87767,87770,0,3,3
25107,4,2,87771,87771,87773,0,2,1
25108,3,1,87774,87774,87775,0,1,1
25109,2,1,87776,87776,87777,0,1,1
25110,5,3,87781,87781,87784,0,3,4
25111,2,1,87783,87784,87785,1,2,0
25112,5,2,87788,87788,87790,0,2,3
25113,4,1,87792,87792,87793,0,1,2
25114,2,1,87794,87794,87795,0,1,1
25115,3,2,87797,87797,87799,0,2,2
25116,5,1,87802,87802,87803,0,1,3
25117,1,2,87803,87803,87805,0,2,0
25118,4,1,87807,87807,87808,0,1,2
25119,6,1,87813,87813,87814,0,1,5
25120,3,1,87816,87816,87817,0,1,2
25121,5,2,87821,87821,87823,0,2,4
25122,6,1,87827,87827,87828,0,1,4
25123,1,3,87828,87828,87831,0,3,0
25124,3,1,87831,87831,87832,0,1,0
25125,5,1,87836,87836,87837,0,1,4
25126,1,3,87837,87837,87840,0,3,0
25127,3,2,87840,87840,87842,0,2,0
25128,1,1,87841,87842,87843,1,2,0
25129,2,3,87843,87843,87846,0,3,0
25130,1,3,87844,87846,87849,2,5,0
25131,3,2,87847,87849,87851,2,4,0
25132,3,1,87850,87851,87852,1,2,0
25133,6,2,87856,87856,87858,0,2,4
25134,6,1,87862,87862,87863,0,1,4
25135,2,2,87864,87864,87866,0,2,1
25136,5,2,87869,87869,87871,0,2,3
25137,6,2,87875,87875,87877,0,2,4
25138,4,1,87879,87879,87880,0,1,2
25139,2,1,87881,87881,87882,0,1,1
25140,1,3,87882,87882,87885,0,3,0
25141,5,2,87887,87887,87889,0,2,2
25142,2,3,87889,87889,87892,0,3,0
25143,4,2,87893,87893,87895,0,2,1
25144,2,1,87895,87895,87896,0,1,0
25145,6,1,87901,87901,87902,0,1,5
25146,6,3,87907,87907,87910,0,3,5
25147,5,3,87912,87912,87915,0,3,2
25148,2,2,87914,87915,87917,1,3,0
25149,2,2,87916,87917,87919,1,3,0
25150,2,2,87918,87919,87921,1,3,0
25151,5,3,87923,87923,87926,0,3,2
25152,2,1,87925,87926,87927,1,2,0
25153,2,1,87927,87927,87928,0,1,0
25154,6,3,87933,87933,87936,0,3,5
25155,4,3,87937,87937,87940,0,3,1
25156,2,1,87939,87940,87941,1,2,0
25157,6,3,87945,87945,87948,0,3,4
25158,1,3,87946,87948,87951,2,5,0
25159,1,3,87947,87951,87954,4,7,0
25160,5,3,87952,87954,87957,2,5,0
25161,6,1,87958,87958,87959,0,1,1
25162,4,2,87962,87962,87964,0,2,3
25163,2,3,87964,87964,87967,0,3,0
25164,4,3,87968,87968,87971,0,3,1
25165,4,3,87972,87972,87975,0,3,1
25166,2,2,87974,87975,87977,1,3,0
25167,2,3,87976,87977,87980,1,4,0
25168,1,3,87977,87980,87983,3,6,0
25169,5,1,87982,87983,87984,1,2,0
25170,5,3,87987,87987,87990,0,3,3
25171,2,3,87989,87990,87993,1,4,0
25172,4,1,87993,87993,87994,0,1,0
25173,3,3,87996,87996,87999,0,3,2
25174,6,2,88002,88002,88004,0,2,3
25175,5,3,88007,88007,88010,0,3,3
25176,6,3,88013,88013,88016,0,3,3
25177,1,1,88014,88016,88017,2,3,0
25178,6,1,88020,88020,88021,0,1,3
25179,4,1,88024,88024,88025,0,1,3
25180,3,2,88027,88027,88029,0,2,2
25181,1,3,88028,88029,88032,1,4,0
25182,4,2,88032,88032,88034,0,2,0
25183,6,1,88038,88038,88039,0,1,4
25184,2,2,88040,88040,88042,0,2,1
25185,3,2,88043,88043,88045,0,2,1
25186,4,3,88047,88047,88050,0,3,2
25187,2,1,88049,88050,88051,1,2,0
25188,6,3,88055,88055,88058,0,3,4
25189,3,3,88058,88058,88061,0,3,0
25190,2,1,88060,88061,88062,1,2,0
25191,4,3,88064,88064,88067,0,3,2
25192,1,3,88065,88067,88070,2,5,0
25193,2,3,88067,88070,88073,3,6,0
25194,6,1,88073,88073,88074,0,1,0
25195,6,2,88079,88079,88081,0,2,5
25196,3,2,88082,88082,88084,0,2,1
25197,5,3,88087,88087,88090,0,3,3
25198,3,2,88090,88090,88092,0,2,0
25199,1,2,88091,88092,88094,1,3,0
25200,1,1,88092,88094,88095,2,3,0
25201,5,2,88097,88097,88099,0,2,2
25202,1,1,88098,88099,88100,1,2,0
25203,3,3,88101,88101,88104,0,3,1
25204,5,3,88106,88106,88109,0,3,2
25205,2,1,88108,88109,88110,1,2,0
25206,2,3,88110,88110,88113,0,3,0
25207,6,2,88116,88116,88118,0,2,3
25208,5,2,88121,88121,88123,0,2,3
25209,1,3,88122,88123,88126,1,4,0
25210,3,3,88125,88126,88129,1,4,0
25211,2,3,88127,88129,88132,2,5,0
25212,5,2,88132,88132,88134,0,2,0
25213,1,2,88133,88134,88136,1,3,0
25214,4,2,88137,88137,88139,0,2,1
25215,2,1,88139,88139,88140,0,1,0
25216,1,3,88140,88140,88143,0,3,0
25217,3,1,88143,88143,88144,0,1,0
25218,4,2,88147,88147,88149,0,2,3
25219,2,3,88149,88149,88152,0,3,0
25220,1,1,88150,88152,88153,2,3,0
25221,1,1,88151,88153,88154,2,3,0
25222,4,2,88155,88155,88157,0,2,1
25223,6,3,88161,88161,88164,0,3,4
25224,4,1,88165,88165,88166,0,1,1
25225,1,2,88166,88166,88168,0,2,0
25226,4,3,88170,88170,88173,0,3,2
25227,1,1,88171,88173,88174,2,3,0
25228,6,3,88177,88177,88180,0,3,3
25229,5,2,88182,88182,88184,0,2,2
25230,5,1,88187,88187,88188,0,1,3
25231,2,2,88189,88189,88191,0,2,1
25232,2,3,88191,88191,88194,0,3,0
25233,3,3,88194,88194,88197,0,3,0
25234,2,3,88196,88197,88200,1,4,0
25235,1,1,88197,88200,88201,3,4,0
25236,3,3,88200,88201,88204,1,4,0
25237,4,2,88204,88204,88206,0,2,0
25238,4,1,88208,88208,88209,0,1,2
25239,2,1,88210,88210,88211,0,1,1
25240,3,3,88213,88213,88216,0,3,2
25241,3,1,88216,88216,88217,0,1,0
25242,5,2,88221,88221,88223,0,2,4
25243,3,2,88224,88224,88226,0,2,1
25244,4,3,88228,88228,88231,0,3,2
25245,4,2,88232,88232,88234,0,2,1
25246,4,2,88236,88236,88238,0,2,2
25247,2,2,88238,88238,88240,0,2,0
25248,5,1,88243,88243,88244,0,1,3
25249,1,1,88244,88244,88245,0,1,0
25250,4,2,88248,88248,88250,0,2,3
25251,5,3,88253,88253,88256,0,3,3
25252,1,2,88254,88256,88258,2,4,0
25253,1,1,88255,88258,88259,3,4,0
25254,3,2,88258,88259,88261,1,3,0
25255,1,3,88259,88261,88264,2,5,0
25256,2,3,88261,88264,88267,3,6,0
25257,5,2,88266,88267,88269,1,3,0
25258,2,3,88268,88269,88272,1,4,0
25259,4,1,88272,88272,88273,0,1,0
25260,4,2,88276,88276,88278,0,2,3
25261,6,3,88282,88282,88285,0,3,4
25262,2,2,88284,88285,88287,1,3,0
25263,1,1,88285,88287,88288,2,3,0
25264,2,3,88287,88288,88291,1,4,0
25265,4,2,88291,88291,88293,0,2,0
25266,5,2,88296,88296,88298,0,2,3
25267,5,2,88301,88301,88303,0,2,3
25268,3,1,88304,88304,88305,0,1,1
25269,1,1,88305,88305,88306,0,1,0
25270,4,2,88309,88309,88311,0,2,3
25271,2,1,88311,88311,88312,0,1,0
25272,3,3,88314,88314,88317,0,3,2
25273,3,3,88317,88317,88320,0,3,0
25274,3,1,88320,88320,88321,0,1,0
25275,3,3,88323,88323,88326,0,3,2
25276,4,1,88327,88327,88328,0,1,1
25277,6,2,88333,88333,88335,0,2,5
25278,5,3,88338,88338,88341,0,3,3
25279,4,3,88342,88342,88345,0,3,1
25280,4,1,88346,88346,88347,0,1,1
25281,6,1,88352,88352,88353,0,1,5
25282,5,1,88357,88357,88358,0,1,4
25283,5,1,88362,88362,88363,0,1,4
25284,5,3,88367,88367,88370,0,3,4
25285,5,2,88372,88372,88374,0,2,2
25286,3,1,88375,88375,88376,0,1,1
25287,6,2,88381,88381,88383,0,2,5
25288,2,2,88383,88383,88385,0,2,0
25289,2,3,88385,88385,88388,0,3,0
25290,1,1,88386,88388,88389,2,3,0
25291,3,1,88389,88389,88390,0,1,0
25292,2,2,88391,88391,88393,0,2,1
25293,5,2,88396,88396,88398,0,2,3
25294,1,1,88397,88398,88399,1,2,0
25295,1,2,88398,88399,88401,1,3,0
25296,3,1,88401,88401,88402,0,1,0
25297,1,3,88402,88402,88405,0,3,0
25298,4,3,88406,88406,88409,0,3,1
25299,2,2,88408,88409,88411,1,3,0
25300,2,2,88410,88411,88413,1,3,0
25301,6,1,88416,88416,88417,0,1,3
25302,4,2,88420,88420,88422,0,2,3
25303,2,1,88422,88422,88423,0,1,0
25304,2,3,88424,88424,88427,0,3,1
25305,4,1,88428,88428,88429,0,1,1
25306,2,2,88430,88430,88432,0,2,1
25307,1,2,88431,88432,88434,1,3,0
25308,2,3,88433,88434,88437,1,4,0
25309,3,2,88436,88437,88439,1,3,0
25310,2,3,88438,88439,88442,1,4,0
25311,3,2,88441,88442,88444,1,3,0
25312,5,3,88446,88446,88449,0,3,2
25313,4,2,88450,88450,88452,0,2,1
25314,5,3,88455,88455,88458,0,3,3
25315,3,1,88458,88458,88459,0,1,0
25316,6,3,88464,88464,88467,0,3,5
25317,5,2,88469,88469,88471,0,2,2
25318,6,2,88475,88475,88477,0,2,4
25319,2,1,88477,88477,88478,0,1,0
25320,3,2,88480,88480,88482,0,2,2
25321,4,1,88484,88484,88485,0,1,2
25322,5,3,88489,88489,88492,0,3,4
25323,3,2,88492,88492,88494,0,2,0
25324,6,3,88498,88498,88501,0,3,4
25325,4,1,88502,88502,88503,0,1,1
25326,3,3,88505,88505,88508,0,3,2
25327,5,3,88510,88510,88513,0,3,2
25328,4,1,88514,88514,88515,0,1,1
25329,6,3,88520,88520,88523,0,3,5
25330,4,2,88524,88524,88526,0,2,1
25331,5,1,88529,88529,88530,0,1,3
25332,2,2,88531,88531,88533,0,2,1
25333,3,3,88534,88534,88537,0,3,1
25334,4,2,88538,88538,88540,0,2,1
25335,6,2,88544,88544,88546,0,2,4
25336,5,1,88549,88549,88550,0,1,3
25337,2,1,88551,88551,88552,0,1,1
25338,5,2,88556,88556,88558,0,2,4
25339,1,1,88557,88558,88559,1,2,0
25340,5,1,88562,88562,88563,0,1,3
25341,4,2,88566,88566,88568,0,2,3
25342,3,3,88569,88569,88572,0,3,1
25343,1,3,88570,88572,88575,2,5,0
25344,1,3,88571,88575,88578,4,7,0
25345,5,2,88576,88578,88580,2,4,0
25346,2,3,88578,88580,88583,2,5,0
25347,5,1,88583,88583,88584,0,1,0
25348,2,2,88585,88585,88587,0,2,1
25349,2,1,88587,88587,88588,0,1,0
25350,2,3,88589,88589,88592,0,3,1
25351,4,3,88593,88593,88596,0,3,1
25352,4,1,88597,88597,88598,0,1,1
25353,3,3,88600,88600,88603,0,3,2
25354,2,2,88602,88603,88605,1,3,0
25355,3,1,88605,88605,88606,0,1,0
25356,5,3,88610,88610,88613,0,3,4
25357,5,2,88615,88615,88617,0,2,2
25358,1,1,88616,88617,88618,1,2,0
25359,6,2,88622,88622,88624,0,2,4
25360,2,3,88624,88624,88627,0,3,0
25361,5,3,88629,88629,88632,0,3,2
25362,6,1,88635,88635,88636,0,1,3
25363,1,1,88636,88636,88637,0,1,0
25364,2,1,88638,88638,88639,0,1,1
25365,5,2,88643,88643,88645,0,2,4
25366,2,2,88645,88645,88647,0,2,0
25367,1,2,88646,88647,88649,1,3,0
25368,3,2,88649,88649,88651,0,2,0
25369,4,2,88653,88653,88655,0,2,2
25370,4,1,88657,88657,88658,0,1,2
25371,4,1,88661,88661,88662,0,1,3
25372,4,3,88665,88665,88668,0,3,3
25373,3,1,88668,88668,88669,0,1,0
25374,1,1,88669,88669,88670,0,1,0
25375,6,2,88675,88675,88677,0,2,5
25376,3,3,88678,88678,88681,0,3,1
25377,5,3,88683,88683,88686,0,3,2
25378,6,2,88689,88689,88691,0,2,3
25379,3,3,88692,88692,88695,0,3,1
25380,2,1,88694,88695,88696,1,2,0
25381,2,2,88696,88696,88698,0,2,0
25382,1,2,88697,88698,88700,1,3,0
25383,6,2,88703,88703,88705,0,2,3
25384,3,2,88706,88706,88708,0,2,1
25385,6,2,88712,88712,88714,0,2,4
25386,2,1,88714,88714,88715,0,1,0
25387,6,1,88720,88720,88721,0,1,5
25388,6,2,88726,88726,88728,0,2,5
25389,3,3,88729,88729,88732,0,3,1
25390,3,1,88732,88732,88733,0,1,0
25391,1,2,88733,88733,88735,0,2,0
25392,3,2,88736,88736,88738,0,2,1
25393,4,1,88740,88740,88741,0,1,2
25394,5,3,88745,88745,88748,0,3,4
25395,5,2,88750,88750,88752,0,2,2
25396,1,1,88751,88752,88753,1,2,0
25397,2,3,88753,88753,88756,0,3,0
25398,6,3,88759,88759,88762,0,3,3
25399,3,3,88762,88762,88765,0,3,0
25400,6,2,88768,88768,88770,0,2,3
25401,4,2,88772,88772,88774,0,2,2
25402,4,1,88776,88776,88777,0,1,2
25403,6,2,88782,88782,88784,0,2,5
25404,4,2,88786,88786,88788,0,2,2
25405,2,3,88788,88788,88791,0,3,0
25406,6,3,88794,88794,88797,0,3,3
25407,4,2,88798,88798,88800,0,2,1
25408,5,1,88803,88803,88804,0,1,3
25409,2,2,88805,88805,88807,0,2,1
25410,5,1,88810,88810,88811,0,1,3
25411,4,1,88814,88814,88815,0,1,3
25412,4,1,88818,88818,88819,0,1,3
25413,5,3,88823,88823,88826,0,3,4
25414,6,1,88829,88829,88830,0,1,3
25415,6,3,88835,88835,88838,0,3,5
25416,3,2,88838,88838,88840,0,2,0
25417,3,3,88841,88841,88844,0,3,1
25418,6,2,88847,88847,88849,0,2,3
25419,6,2,88853,88853,88855,0,2,4
25420,1,1,88854,88855,88856,1,2,0
25421,1,2,88855,88856,88858,1,3,0
25422,3,2,88858,88858,88860,0,2,0
25423,3,2,88861,88861,88863,0,2,1
25424,4,2,88865,88865,88867,0,2,2
25425,1,2,88866,88867,88869,1,3,0
25426,6,3,88872,88872,88875,0,3,3
25427,3,2,88875,88875,88877,0,2,0
25428,6,1,88881,88881,88882,0,1,4
25429,5,1,88886,88886,88887,0,1,4
25430,6,2,88892,88892,88894,0,2,5
25431,1,3,88893,88894,88897,1,4,0
25432,1,3,88894,88897,88900,3,6,0
25433,2,3,88896,88900,88903,4,7,0
25434,4,2,88900,88903,88905,3,5,0
25435,4,2,88904,88905,88907,1,3,0
25436,4,1,88908,88908,88909,0,1,1
25437,1,1,88909,88909,88910,0,1,0
25438,1,1,88910,88910,88911,0,1,0
25439,1,3,88911,88911,88914,0,3,0
25440,4,2,88915,88915,88917,0,2,1
25441,5,3,88920,88920,88923,0,3,3
25442,1,3,88921,88923,88926,2,5,0
25443,6,3,88927,88927,88930,0,3,1
25444,5,1,88932,88932,88933,0,1,2
25445,3,1,88935,88935,88936,0,1,2
25446,4,2,88939,88939,88941,0,2,3
25447,5,1,88944,88944,88945,0,1,3
25448,4,2,88948,88948,88950,0,2,3
25449,6,3,88954,88954,88957,0,3,4
25450,6,1,88960,88960,88961,0,1,3
25451,1,2,88961,88961,88963,0,2,0
25452,2,3,88963,88963,88966,0,3,0
25453,4,3,88967,88967,88970,0,3,1
25454,1,2,88968,88970,88972,2,4,0
25455,6,1,88974,88974,88975,0,1,2
25456,5,1,88979,88979,88980,0,1,4
25457,6,3,88985,88985,88988,0,3,5
25458,6,3,88991,88991,88994,0,3,3
25459,3,3,88994,88994,88997,0,3,0
25460,6,3,89000,89000,89003,0,3,3
25461,4,2,89004,89004,89006,0,2,1
25462,6,2,89010,89010,89012,0,2,4
25463,2,1,89012,89012,89013,0,1,0
25464,2,3,89014,89014,89017,0,3,1
25465,5,1,89019,89019,89020,0,1,2
25466,2,2,89021,89021,89023,0,2,1
25467,5,3,89026,89026,89029,0,3,3
25468,1,2,89027,89029,89031,2,4,0
25469,3,3,89030,89031,89034,1,4,0
25470,1,3,89031,89034,89037,3,6,0
25471,6,2,89037,89037,89039,0,2,0
25472,3,2,89040,89040,89042,0,2,1
25473,2,2,89042,89042,89044,0,2,0
25474,5,1,89047,89047,89048,0,1,3
25475,3,3,89050,89050,89053,0,3,2
25476,3,1,89053,89053,89054,0,1,0
25477,5,1,89058,89058,89059,0,1,4
25478,3,2,89061,89061,89063,0,2,2
25479,4,3,89065,89065,89068,0,3,2
25480,6,2,89071,89071,89073,0,2,3
25481,4,1,89075,89075,89076,0,1,2
25482,5,3,89080,89080,89083,0,3,4
25483,4,3,89084,89084,89087,0,3,1
25484,3,3,89087,89087,89090,0,3,0
25485,1,1,89088,89090,89091,2,3,0
25486,4,2,89092,89092,89094,0,2,1
25487,5,3,89097,89097,89100,0,3,3
25488,3,2,89100,89100,89102,0,2,0
25489,4,3,89104,89104,89107,0,3,2
25490,1,3,89105,89107,89110,2,5,0
25491,6,3,89111,89111,89114,0,3,1
25492,3,3,89114,89114,89117,0,3,0
25493,1,3,89115,89117,89120,2,5,0
25494,1,1,89116,89120,89121,4,5,0
25495,4,3,89120,89121,89124,1,4,0
25496,5,1,89125,89125,89126,0,1,1
25497,4,2,89129,89129,89131,0,2,3
25498,2,1,89131,89131,89132,0,1,0
25499,2,2,89133,89133,89135,0,2,1
25500,1,3,89134,89135,89138,1,4,0
25501,6,3,89140,89140,89143,0,3,2
25502,2,3,89142,89143,89146,1,4,0
25503,3,2,89145,89146,89148,1,3,0
25504,4,1,89149,89149,89150,0,1,1
25505,3,3,89152,89152,89155,0,3,2
25506,6,2,89158,89158,89160,0,2,3
25507,4,2,89162,89162,89164,0,2,2
25508,2,3,89164,89164,89167,0,3,0
25509,6,3,89170,89170,89173,0,3,3
25510,3,3,89173,89173,89176,0,3,0
25511,3,3,89176,89176,89179,0,3,0
25512,2,2,89178,89179,89181,1,3,0
25513,6,3,89184,89184,89187,0,3,3
25514,4,3,89188,89188,89191,0,3,1
25515,3,3,89191,89191,89194,0,3,0
25516,1,3,89192,89194,89197,2,5,0
25517,5,2,89197,89197,89199,0,2,0
25518,5,3,89202,89202,89205,0,3,3
25519,3,1,89205,89205,89206,0,1,0
25520,4,1,89209,89209,89210,0,1,3
25521,1,2,89210,89210,89212,0,2,0
25522,1,2,89211,89212,89214,1,3,0
25523,2,2,89213,89214,89216,1,3,0
25524,6,2,89219,89219,89221,0,2,3
25525,1,3,89220,89221,89224,1,4,0
25526,4,1,89224,89224,89225,0,1,0
25527,6,3,89230,89230,89233,0,3,5
25528,3,2,89233,89233,89235,0,2,0
25529,2,1,89235,89235,89236,0,1,0
25530,4,1,89239,89239,89240,0,1,3
25531,5,1,89244,89244,89245,0,1,4
25532,5,1,89249,89249,89250,0,1,4
25533,2,1,89251,89251,89252,0,1,1
25534,4,1,89255,89255,89256,0,1,3
25535,1,1,89256,89256,89257,0,1,0
25536,2,3,89258,89258,89261,0,3,1
25537,3,2,89261,89261,89263,0,2,0
25538,6,2,89267,89267,89269,0,2,4
25539,1,3,89268,89269,89272,1,4,0
25540,5,3,89273,89273,89276,0,3,1
25541,3,3,89276,89276,89279,0,3,0
25542,4,2,89280,89280,89282,0,2,1
25543,4,2,89284,89284,89286,0,2,2
25544,5,3,89289,89289,89292,0,3,3
25545,1,1,89290,89292,89293,2,3,0
25546,6,3,89296,89296,89299,0,3,3
25547,1,1,89297,89299,89300,2,3,0
25548,6,3,89303,89303,89306,0,3,3
25549,5,3,89308,89308,89311,0,3,2
25550,4,3,89312,89312,89315,0,3,1
25551,6,1,89318,89318,89319,0,1,3
25552,6,1,89324,89324,89325,0,1,5
25553,2,2,89326,89326,89328,0,2,1
25554,6,3,89332,89332,89335,0,3,4
25555,1,1,89333,89335,89336,2,3,0
25556,6,2,89339,89339,89341,0,2,3
25557,3,3,89342,89342,89345,0,3,1
25558,2,1,89344,89345,89346,1,2,0
25559,6,1,89350,89350,89351,0,1,4
25560,1,2,89351,89351,89353,0,2,0
25561,5,3,89356,89356,89359,0,3,3
25562,2,2,89358,89359,89361,1,3,0
25563,5,2,89363,89363,89365,0,2,2
25564,3,2,89366,89366,89368,0,2,1
25565,2,2,89368,89368,89370,0,2,0
25566,3,3,89371,89371,89374,0,3,1
25567,1,2,89372,89374,89376,2,4,0
25568,1,3,89373,89376,89379,3,6,0
25569,1,2,89374,89379,89381,5,7,0
25570,6,2,89380,89381,89383,1,3,0
25571,3,1,89383,89383,89384,0,1,0
25572,5,2,89388,89388,89390,0,2,4
25573,2,1,89390,89390,89391,0,1,0
25574,3,2,89393,89393,89395,0,2,2
25575,3,1,89396,89396,89397,0,1,1
25576,1,2,89397,89397,89399,0,2,0
25577,3,1,89400,89400,89401,0,1,1
25578,4,2,89404,89404,89406,0,2,3
25579,3,3,89407,89407,89410,0,3,1
25580,5,3,89412,89412,89415,0,3,2
25581,2,3,89414,89415,89418,1,4,0
25582,2,2,89416,89418,89420,2,4,0
25583,2,2,89418,89420,89422,2,4,0
25584,6,1,89424,89424,89425,0,1,2
25585,6,3,89430,89430,89433,0,3,5
25586,4,1,89434,89434,89435,0,1,1
25587,4,2,89438,89438,89440,0,2,3
25588,4,1,89442,89442,89443,0,1,2
25589,2,1,89444,89444,89445,0,1,1
25590,3,3,89447,89447,89450,0,3,2
25591,6,1,89453,89453,89454,0,1,3
25592,6,1,89459,89459,89460,0,1,5
25593,6,1,89465,89465,89466,0,1,5
25594,6,3,89471,89471,89474,0,3,5
25595,4,2,89475,89475,89477,0,2,1
25596,3,3,89478,89478,89481,0,3,1
25597,5,2,89483,89483,89485,0,2,2
25598,6,1,89489,89489,89490,0,1,4
25599,3,2,89492,89492,89494,0,2,2
25600,6,1,89498,89498,89499,0,1,4
25601,2,2,89500,89500,89502,0,2,1
25602,4,1,89504,89504,89505,0,1,2
25603,6,1,89510,89510,89511,0,1,5
25604,5,2,89515,89515,89517,0,2,4
25605,3,3,89518,89518,89521,0,3,1
25606,4,2,89522,89522,89524,0,2,1
25607,1,3,89523,89524,89527,1,4,0
25608,2,1,89525,89527,89528,2,3,0
25609,5,2,89530,89530,89532,0,2,2
25610,3,3,89533,89533,89536,0,3,1
25611,1,3,89534,89536,89539,2,5,0
25612,2,1,89536,89539,89540,3,4,0
25613,4,2,89540,89540,89542,0,2,0
25614,5,3,89545,89545,89548,0,3,3
25615,1,2,89546,89548,89550,2,4,0
25616,3,2,89549,89550,89552,1,3,0
25617,5,3,89554,89554,89557,0,3,2
25618,3,3,89557,89557,89560,0,3,0
25619,2,1,89559,89560,89561,1,2,0
25620,3,3,89562,89562,89565,0,3,1
25621,1,1,89563,89565,89566,2,3,0
25622,2,2,89565,89566,89568,1,3,0
25623,1,3,89566,89568,89571,2,5,0
25624,2,3,89568,89571,89574,3,6,0
25625,1,2,89569,89574,89576,5,7,0
25626,2,3,89571,89576,89579,5,8,0
25627,5,1,89576,89579,89580,3,4,0
25628,4,3,89580,89580,89583,0,3,0
25629,5,2,89585,89585,89587,0,2,2
25630,6,3,89591,89591,89594,0,3,4
25631,3,2,89594,89594,89596,0,2,0
25632,2,3,89596,89596,89599,0,3,0
25633,4,1,89600,89600,89601,0,1,1
25634,1,1,89601,89601,89602,0,1,0
25635,3,1,89604,89604,89605,0,1,2
25636,6,3,89610,89610,89613,0,3,5
25637,6,2,89616,89616,89618,0,2,3
25638,1,3,89617,89618,89621,1,4,0
25639,2,3,89619,89621,89624,2,5,0
25640,3,1,89622,89624,89625,2,3,0
25641,3,3,89625,89625,89628,0,3,0
25642,4,2,89629,89629,89631,0,2,1
25643,3,1,89632,89632,89633,0,1,1
25644,4,3,89636,89636,89639,0,3,3
25645,2,1,89638,89639,89640,1,2,0
25646,6,1,89644,89644,89645,0,1,4
25647,2,2,89646,89646,89648,0,2,1
25648,5,3,89651,89651,89654,0,3,3
25649,5,1,89656,89656,89657,0,1,2
25650,6,1,89662,89662,89663,0,1,5
25651,1,2,89663,89663,89665,0,2,0
25652,3,2,89666,89666,89668,0,2,1
25653,3,3,89669,89669,89672,0,3,1
25654,6,3,89675,89675,89678,0,3,3
25655,1,1,89676,89678,89679,2,3,0
25656,5,2,89681,89681,89683,0,2,2
25657,1,1,89682,89683,89684,1,2,0
25658,1,2,89683,89684,89686,1,3,0
25659,2,2,89685,89686,89688,1,3,0
25660,3,3,89688,89688,89691,0,3,0
25661,1,1,89689,89691,89692,2,3,0
25662,4,1,89693,89693,89694,0,1,1
25663,3,1,89696,89696,89697,0,1,2
25664,4,3,89700,89700,89703,0,3,3
25665,2,1,89702,89703,89704,1,2,0
25666,5,2,89707,89707,89709,0,2,3
25667,1,1,89708,89709,89710,1,2,0
25668,2,1,89710,89710,89711,0,1,0
25669,1,2,89711,89711,89713,0,2,0
25670,5,1,89716,89716,89717,0,1,3
25671,4,3,89720,89720,89723,0,3,3
25672,5,3,89725,89725,89728,0,3,2
25673,3,2,89728,89728,89730,0,2,0
25674,5,2,89733,89733,89735,0,2,3
25675,1,2,89734,89735,89737,1,3,0
25676,3,1,89737,89737,89738,0,1,0
25677,1,1,89738,89738,89739,0,1,0
25678,2,3,89740,89740,89743,0,3,1
25679,4,1,89744,89744,89745,0,1,1
25680,4,3,89748,89748,89751,0,3,3
25681,3,2,89751,89751,89753,0,2,0
25682,4,3,89755,89755,89758,0,3,2
25683,6,3,89761,89761,89764,0,3,3
25684,5,2,89766,89766,89768,0,2,2
25685,1,1,89767,89768,89769,1,2,0
25686,3,3,89770,89770,89773,0,3,1
25687,1,3,89771,89773,89776,2,5,0
25688,2,2,89773,89776,89778,3,5,0
25689,5,2,89778,89778,89780,0,2,0
25690,3,1,89781,89781,89782,0,1,1
25691,2,1,89783,89783,89784,0,1,1
25692,2,2,89785,89785,89787,0,2,1
25693,1,3,89786,89787,89790,1,4,0
25694,6,3,89792,89792,89795,0,3,2
25695,5,1,89797,89797,89798,0,1,2
25696,4,1,89801,89801,89802,0,1,3
25697,2,1,89803,89803,89804,0,1,1
25698,4,3,89807,89807,89810,0,3,3
25699,4,2,89811,89811,89813,0,2,1
25700,2,3,89813,89813,89816,0,3,0
25701,2,1,89815,89816,89817,1,2,0
25702,2,1,89817,89817,89818,0,1,0
25703,2,2,89819,89819,89821,0,2,1
25704,2,3,89821,89821,89824,0,3,0
25705,4,3,89825,89825,89828,0,3,1
25706,4,1,89829,89829,89830,0,1,1
25707,1,3,89830,89830,89833,0,3,0
25708,3,2,89833,89833,89835,0,2,0
25709,6,2,89839,89839,89841,0,2,4
25710,5,2,89844,89844,89846,0,2,3
25711,4,3,89848,89848,89851,0,3,2
25712,5,3,89853,89853,89856,0,3,2
25713,1,1,89854,89856,89857,2,3,0
25714,1,1,89855,89857,89858,2,3,0
25715,1,2,89856,89858,89860,2,4,0
25716,3,3,89859,89860,89863,1,4,0
25717,4,1,89863,89863,89864,0,1,0
25718,4,2,89867,89867,89869,0,2,3
25719,5,3,89872,89872,89875,0,3,3
25720,4,1,89876,89876,89877,0,1,1
25721,5,3,89881,89881,89884,0,3,4
25722,4,2,89885,89885,89887,0,2,1
25723,6,1,89891,89891,89892,0,1,4
25724,5,2,89896,89896,89898,0,2,4
25725,1,3,89897,89898,89901,1,4,0
25726,6,2,89903,89903,89905,0,2,2
25727,1,2,89904,89905,89907,1,3,0
25728,5,3,89909,89909,89912,0,3,2
25729,1,2,89910,89912,89914,2,4,0
25730,1,1,89911,89914,89915,3,4,0
25731,2,2,89913,89915,89917,2,4,0
25732,5,2,89918,89918,89920,0,2,1
25733,1,1,89919,89920,89921,1,2,0
25734,4,3,89923,89923,89926,0,3,2
25735,4,1,89927,89927,89928,0,1,1
25736,5,1,89932,89932,89933,0,1,4
25737,1,3,89933,89933,89936,0,3,0
25738,2,1,89935,89936,89937,1,2,0
25739,4,1,89939,89939,89940,0,1,2
25740,2,3,89941,89941,89944,0,3,1
25741,3,3,89944,89944,89947,0,3,0
25742,4,2,89948,89948,89950,0,2,1
25743,4,2,89952,89952,89954,0,2,2
25744,4,1,89956,89956,89957,0,1,2
25745,2,1,89958,89958,89959,0,1,1
25746,1,2,89959,89959,89961,0,2,0
25747,3,1,89962,89962,89963,0,1,1
25748,3,1,89965,89965,89966,0,1,2
25749,4,3,89969,89969,89972,0,3,3
25750,1,2,89970,89972,89974,2,4,0
25751,4,1,89974,89974,89975,0,1,0
25752,5,1,89979,89979,89980,0,1,4
25753,5,1,89984,89984,89985,0,1,4
25754,5,2,89989,89989,89991,0,2,4
25755,1,1,89990,89991,89992,1,2,0
25756,4,2,89994,89994,89996,0,2,2
25757,5,1,89999,89999,90000,0,1,3
25758,5,2,90004,90004,90006,0,2,4
25759,2,1,90006,90006,90007,0,1,0
25760,1,1,90007,90007,90008,0,1,0
25761,5,3,90012,90012,90015,0,3,4
25762,2,1,90014,90015,90016,1,2,0
25763,4,1,90018,90018,90019,0,1,2
25764,3,2,90021,90021,90023,0,2,2
25765,6,1,90027,90027,90028,0,1,4
25766,6,3,90033,90033,90036,0,3,5
25767,6,3,90039,90039,90042,0,3,3
25768,4,3,90043,90043,90046,0,3,1
25769,4,1,90047,90047,90048,0,1,1
25770,5,2,90052,90052,90054,0,2,4
25771,2,2,90054,90054,90056,0,2,0
25772,3,2,90057,90057,90059,0,2,1
25773,6,3,90063,90063,90066,0,3,4
25774,6,1,90069,90069,90070,0,1,3
25775,5,3,90074,90074,90077,0,3,4
25776,3,2,90077,90077,90079,0,2,0
25777,5,3,90082,90082,90085,0,3,3
25778,2,3,90084,90085,90088,1,4,0
25779,2,2,90086,90088,90090,2,4,0
25780,2,3,90088,90090,90093,2,5,0
25781,5,1,90093,90093,90094,0,1,0
25782,1,1,90094,90094,90095,0,1,0
25783,3,1,90097,90097,90098,0,1,2
25784,1,3,90098,90098,90101,0,3,0
25785,3,1,90101,90101,90102,0,1,0
25786,4,2,90105,90105,90107,0,2,3
25787,1,2,90106,90107,90109,1,3,0
25788,4,1,90110,90110,90111,0,1,1
25789,5,1,90115,90115,90116,0,1,4
25790,1,1,90116,90116,90117,0,1,0
25791,2,2,90118,90118,90120,0,2,1
25792,2,2,90120,90120,90122,0,2,0
25793,2,1,90122,90122,90123,0,1,0
25794,1,1,90123,90123,90124,0,1,0
25795,3,3,90126,90126,90129,0,3,2
25796,6,1,90132,90132,90133,0,1,3
25797,4,1,90136,90136,90137,0,1,3
25798,6,2,90142,90142,90144,0,2,5
25799,2,1,90144,90144,90145,0,1,0
25800,6,2,90150,90150,90152,0,2,5
25801,3,3,90153,90153,90156,0,3,1
25802,5,2,90158,90158,90160,0,2,2
25803,6,2,90164,90164,90166,0,2,4
25804,2,1,90166,90166,90167,0,1,0
25805,4,2,90170,90170,90172,0,2,3
25806,5,2,90175,90175,90177,0,2,3
25807,6,2,90181,90181,90183,0,2,4
25808,2,1,90183,90183,90184,0,1,0
25809,4,1,90187,90187,90188,0,1,3
25810,2,1,90189,90189,90190,0,1,1
25811,4,3,90193,90193,90196,0,3,3
25812,5,2,90198,90198,90200,0,2,2
25813,2,2,90200,90200,90202,0,2,0
25814,2,2,90202,90202,90204,0,2,0
25815,3,2,90205,90205,90207,0,2,1
25816,6,1,90211,90211,90212,0,1,4
25817,1,3,90212,90212,90215,0,3,0
25818,1,3,90213,90215,90218,2,5,0
25819,6,2,90219,90219,90221,0,2,1
25820,5,2,90224,90224,90226,0,2,3
25821,3,3,90227,90227,90230,0,3,1
25822,4,3,90231,90231,90234,0,3,1
25823,6,1,90237,90237,90238,0,1,3
25824,3,3,90240,90240,90243,0,3,2
25825,3,2,90243,90243,90245,0,2,0
25826,4,3,90247,90247,90250,0,3,2
25827,3,2,90250,90250,90252,0,2,0
25828,4,3,90254,90254,90257,0,3,2
25829,1,2,90255,90257,90259,2,4,0
25830,5,2,90260,90260,90262,0,2,1
25831,6,2,90266,90266,90268,0,2,4
25832,6,2,90272,90272,90274,0,2,4
25833,4,1,90276,90276,90277,0,1,2
25834,4,2,90280,90280,90282,0,2,3
25835,1,3,90281,90282,90285,1,4,0
25836,3,1,90284,90285,90286,1,2,0
25837,2,3,90286,90286,90289,0,3,0
25838,2,1,90288,90289,90290,1,2,0
25839,3,3,90291,90291,90294,0,3,1
25840,5,3,90296,90296,90299,0,3,2
25841,5,3,90301,90301,90304,0,3,2
25842,2,3,90303,90304,90307,1,4,0
25843,6,3,90309,90309,90312,0,3,2
25844,3,1,90312,90312,90313,0,1,0
25845,1,2,90313,90313,90315,0,2,0
25846,4,3,90317,90317,90320,0,3,2
25847,2,1,90319,90320,90321,1,2,0
25848,6,2,90325,90325,90327,0,2,4
25849,5,2,90330,90330,90332,0,2,3
25850,2,2,90332,90332,90334,0,2,0
25851,4,2,90336,90336,90338,0,2,2
25852,2,3,90338,90338,90341,0,3,0
25853,4,1,90342,90342,90343,0,1,1
25854,3,2,90345,90345,90347,0,2,2
25855,2,1,90347,90347,90348,0,1,0
25856,5,3,90352,90352,90355,0,3,4
25857,5,3,90357,90357,90360,0,3,2
25858,4,3,90361,90361,90364,0,3,1
25859,6,1,90367,90367,90368,0,1,3
25860,6,1,90373,90373,90374,0,1,5
25861,6,3,90379,90379,90382,0,3,5
25862,1,1,90380,90382,90383,2,3,0
25863,6,2,90386,90386,90388,0,2,3
25864,5,3,90391,90391,90394,0,3,3
25865,3,2,90394,90394,90396,0,2,0
25866,4,3,90398,90398,90401,0,3,2
25867,2,3,90400,90401,90404,1,4,0
25868,5,3,90405,90405,90408,0,3,1
25869,1,3,90406,90408,90411,2,5,0
25870,2,2,90408,90411,90413,3,5,0
25871,1,1,90409,90413,90414,4,5,0
25872,1,2,90410,90414,90416,4,6,0
25873,4,3,90414,90416,90419,2,5,0
25874,2,2,90416,90419,90421,3,5,0
25875,3,1,90419,90421,90422,2,3,0
25876,1,1,90420,90422,90423,2,3,0
25877,1,1,90421,90423,90424,2,3,0
25878,1,2,90422,90424,90426,2,4,0
25879,4,1,90426,90426,90427,0,1,0
25880,1,2,90427,90427,90429,0,2,0
25881,2,2,90429,90429,90431,0,2,0
25882,1,2,90430,90431,90433,1,3,0
25883,5,3,90435,90435,90438,0,3,2
25884,3,2,90438,90438,90440,0,2,0
25885,3,1,90441,90441,90442,0,1,1
25886,5,1,90446,90446,90447,0,1,4
25887,4,3,90450,90450,90453,0,3,3
25888,6,3,90456,90456,90459,0,3,3
25889,1,1,90457,90459,90460,2,3,0
25890,4,3,90461,90461,90464,0,3,1
25891,5,3,90466,90466,90469,0,3,2
25892,2,1,90468,90469,90470,1,2,0
25893,4,1,90472,90472,90473,0,1,2
25894,3,2,90475,90475,90477,0,2,2
25895,3,2,90478,90478,90480,0,2,1
25896,1,2,90479,90480,90482,1,3,0
25897,4,2,90483,90483,90485,0,2,1
25898,6,3,90489,90489,90492,0,3,4
25899,2,3,90491,90492,90495,1,4,0
25900,4,2,90495,90495,90497,0,2,0
25901,2,2,90497,90497,90499,0,2,0
25902,4,1,90501,90501,90502,0,1,2
25903,2,2,90503,90503,90505,0,2,1
25904,4,1,90507,90507,90508,0,1,2
25905,3,2,90510,90510,90512,0,2,2
25906,5,2,90515,90515,90517,0,2,3
25907,3,2,90518,90518,90520,0,2,1
25908,2,2,90520,90520,90522,0,2,0
25909,6,3,90526,90526,90529,0,3,4
25910,3,2,90529,90529,90531,0,2,0
25911,1,3,90530,90531,90534,1,4,0
25912,4,2,90534,90534,90536,0,2,0
25913,6,3,90540,90540,90543,0,3,4
25914,6,3,90546,90546,90549,0,3,3
25915,1,3,90547,90549,90552,2,5,0
25916,6,1,90553,90553,90554,0,1,1
25917,6,1,90559,90559,90560,0,1,5
25918,2,2,90561,90561,90563,0,2,1
25919,6,2,90567,90567,90569,0,2,4
25920,4,2,90571,90571,90573,0,2,2
25921,6,1,90577,90577,90578,0,1,4
25922,4,3,90581,90581,90584,0,3,3
25923,5,2,90586,90586,90588,0,2,2
25924,3,2,90589,90589,90591,0,2,1
25925,4,1,90593,90593,90594,0,1,2
25926,5,2,90598,90598,90600,0,2,4
25927,4,1,90602,90602,90603,0,1,2
25928,4,2,90606,90606,90608,0,2,3
25929,4,1,90610,90610,90611,0,1,2
25930,6,2,90616,90616,90618,0,2,5
25931,1,3,90617,90618,90621,1,4,0
25932,1,1,90618,90621,90622,3,4,0
25933,2,2,90620,90622,90624,2,4,0
25934,1,1,90621,90624,90625,3,4,0
25935,1,2,90622,90625,90627,3,5,0
25936,4,2,90626,90627,90629,1,3,0
25937,5,2,90631,90631,90633,0,2,2
25938,5,2,90636,90636,90638,0,2,3
25939,2,3,90638,90638,90641,0,3,0
25940,3,2,90641,90641,90643,0,2,0
25941,1,2,90642,90643,90645,1,3,0
25942,6,1,90648,90648,90649,0,1,3
25943,3,2,90651,90651,90653,0,2,2
25944,6,3,90657,90657,90660,0,3,4
25945,4,2,90661,90661,90663,0,2,1
25946,5,3,90666,90666,90669,0,3,3
25947,6,3,90672,90672,90675,0,3,3
25948,6,2,90678,90678,90680,0,2,3
25949,2,3,90680,90680,90683,0,3,0
25950,1,3,90681,90683,90686,2,5,0
25951,1,1,90682,90686,90687,4,5,0
25952,2,1,90684,90687,90688,3,4,0
25953,1,2,90685,90688,90690,3,5,0
25954,5,3,90690,90690,90693,0,3,0
25955,3,2,90693,90693,90695,0,2,0
25956,2,3,90695,90695,90698,0,3,0
25957,5,3,90700,90700,90703,0,3,2
25958,2,3,90702,90703,90706,1,4,0
25959,2,2,90704,90706,90708,2,4,0
25960,3,1,90707,90708,90709,1,2,0
25961,4,1,90711,90711,90712,0,1,2
25962,2,2,90713,90713,90715,0,2,1
25963,2,1,90715,90715,90716,0,1,0
25964,1,2,90716,90716,90718,0,2,0
25965,4,3,90720,90720,90723,0,3,2
25966,1,3,90721,90723,90726,2,5,0
25967,3,1,90724,90726,90727,2,3,0
25968,1,2,90725,90727,90729,2,4,0
25969,1,2,90726,90729,90731,3,5,0
25970,1,2,90727,90731,90733,4,6,0
25971,1,3,90728,90733,90736,5,8,0
25972,6,3,90734,90736,90739,2,5,0
25973,4,3,90738,90739,90742,1,4,0
25974,4,1,90742,90742,90743,0,1,0
25975,6,1,90748,90748,90749,0,1,5
25976,1,1,90749,90749,90750,0,1,0
25977,5,3,90754,90754,90757,0,3,4
25978,1,2,90755,90757,90759,2,4,0
25979,3,2,90758,90759,90761,1,3,0
25980,5,3,90763,90763,90766,0,3,2
25981,5,1,90768,90768,90769,0,1,2
25982,1,3,90769,90769,90772,0,3,0
25983,4,1,90773,90773,90774,0,1,1
25984,1,3,90774,90774,90777,0,3,0
25985,1,1,90775,90777,90778,2,3,0
25986,3,1,90778,90778,90779,0,1,0
25987,2,1,90780,90780,90781,0,1,1
25988,4,3,90784,90784,90787,0,3,3
25989,5,3,90789,90789,90792,0,3,2
25990,4,1,90793,90793,90794,0,1,1
25991,6,1,90799,90799,90800,0,1,5
25992,1,3,90800,90800,90803,0,3,0
25993,5,2,90805,90805,90807,0,2,2
25994,4,3,90809,90809,90812,0,3,2
25995,1,1,90810,90812,90813,2,3,0
25996,1,3,90811,90813,90816,2,5,0
25997,6,2,90817,90817,90819,0,2,1
25998,5,2,90822,90822,90824,0,2,3
25999,4,2,90826,90826,90828,0,2,2
26000,3,3,90829,90829,90832,0,3,1
26001,6,1,90835,90835,90836,0,1,3
26002,1,3,90836,90836,90839,0,3,0
26003,4,3,90840,90840,90843,0,3,1
26004,2,2,90842,90843,90845,1,3,0
26005,1,1,90843,90845,90846,2,3,0
26006,5,1,90848,90848,90849,0,1,2
26007,1,3,90849,90849,90852,0,3,0
26008,2,3,90851,90852,90855,1,4,0
26009,4,2,90855,90855,90857,0,2,0
26010,2,1,90857,90857,90858,0,1,0
26011,6,2,90863,90863,90865,0,2,5
26012,3,2,90866,90866,90868,0,2,1
26013,6,3,90872,90872,90875,0,3,4
26014,6,2,90878,90878,90880,0,2,3
26015,2,1,90880,90880,90881,0,1,0
26016,5,2,90885,90885,90887,0,2,4
26017,4,2,90889,90889,90891,0,2,2
26018,6,1,90895,90895,90896,0,1,4
26019,4,2,90899,90899,90901,0,2,3
26020,1,1,90900,90901,90902,1,2,0
26021,5,1,90905,90905,90906,0,1,3
26022,6,1,90911,90911,90912,0,1,5
26023,3,3,90914,90914,90917,0,3,2
26024,4,3,90918,90918,90921,0,3,1
26025,1,2,90919,90921,90923,2,4,0
26026,6,3,90925,90925,90928,0,3,2
26027,6,3,90931,90931,90934,0,3,3
26028,3,1,90934,90934,90935,0,1,0
26029,3,3,90937,90937,90940,0,3,2
26030,4,1,90941,90941,90942,0,1,1
26031,2,2,90943,90943,90945,0,2,1
26032,6,2,90949,90949,90951,0,2,4
26033,4,3,90953,90953,90956,0,3,2
26034,2,1,90955,90956,90957,1,2,0
26035,3,3,90958,90958,90961,0,3,1
26036,2,3,90960,90961,90964,1,4,0
26037,2,1,90962,90964,90965,2,3,0
26038,3,1,90965,90965,90966,0,1,0
26039,2,2,90967,90967,90969,0,2,1
26040,5,3,90972,90972,90975,0,3,3
26041,6,1,90978,90978,90979,0,1,3
26042,6,2,90984,90984,90986,0,2,5
26043,6,3,90990,90990,90993,0,3,4
26044,2,3,90992,90993,90996,1,4,0
26045,6,3,90998,90998,91001,0,3,2
26046,5,2,91003,91003,91005,0,2,2
26047,6,2,91009,91009,91011,0,2,4
26048,2,2,91011,91011,91013,0,2,0
26049,6,2,91017,91017,91019,0,2,4
26050,5,3,91022,91022,91025,0,3,3
26051,4,1,91026,91026,91027,0,1,1
26052,3,3,91029,91029,91032,0,3,2
26053,1,3,91030,91032,91035,2,5,0
26054,1,1,91031,91035,91036,4,5,0
26055,3,2,91034,91036,91038,2,4,0
26056,6,1,91040,91040,91041,0,1,2
26057,6,3,91046,91046,91049,0,3,5
26058,4,1,91050,91050,91051,0,1,1
26059,4,3,91054,91054,91057,0,3,3
26060,6,2,91060,91060,91062,0,2,3
26061,6,3,91066,91066,91069,0,3,4
26062,4,2,91070,91070,91072,0,2,1
26063,6,3,91076,91076,91079,0,3,4
26064,4,3,91080,91080,91083,0,3,1
26065,5,2,91085,91085,91087,0,2,2
26066,4,3,91089,91089,91092,0,3,2
26067,4,3,91093,91093,91096,0,3,1
26068,6,3,91099,91099,91102,0,3,3
26069,6,3,91105,91105,91108,0,3,3
26070,4,3,91109,91109,91112,0,3,1
26071,3,1,91112,91112,91113,0,1,0
26072,4,3,91116,91116,91119,0,3,3
26073,4,3,91120,91120,91123,0,3,1
26074,5,1,91125,91125,91126,0,1,2
26075,6,3,91131,91131,91134,0,3,5
26076,1,3,91132,91134,91137,2,5,0
26077,4,1,91136,91137,91138,1,2,0
26078,4,3,91140,91140,91143,0,3,2
26079,4,3,91144,91144,91147,0,3,1
26080,4,2,91148,91148,91150,0,2,1
26081,4,2,91152,91152,91154,0,2,2
26082,3,3,91155,91155,91158,0,3,1
26083,6,3,91161,91161,91164,0,3,3
26084,4,1,91165,91165,91166,0,1,1
26085,5,1,91170,91170,91171,0,1,4
26086,6,2,91176,91176,91178,0,2,5
26087,6,1,91182,91182,91183,0,1,4
26088,2,2,91184,91184,91186,0,2,1
26089,2,3,91186,91186,91189,0,3,0
26090,2,1,91188,91189,91190,1,2,0
26091,1,2,91189,91190,91192,1,3,0
26092,2,3,91191,91192,91195,1,4,0
26093,2,1,91193,91195,91196,2,3,0
26094,6,2,91199,91199,91201,0,2,3
26095,6,3,91205,91205,91208,0,3,4
26096,5,1,91210,91210,91211,0,1,2
26097,5,3,91215,91215,91218,0,3,4
26098,1,3,91216,91218,91221,2,5,0
26099,4,1,91220,91221,91222,1,2,0
26100,5,2,91225,91225,91227,0,2,3
26101,3,2,91228,91228,91230,0,2,1
26102,2,3,91230,91230,91233,0,3,0
26103,5,3,91235,91235,91238,0,3,2
26104,5,3,91240,91240,91243,0,3,2
26105,4,3,91244,91244,91247,0,3,1
26106,6,3,91250,91250,91253,0,3,3
26107,5,3,91255,91255,91258,0,3,2
26108,2,3,91257,91258,91261,1,4,0
26109,3,1,91260,91261,91262,1,2,0
26110,2,2,91262,91262,91264,0,2,0
26111,3,3,91265,91265,91268,0,3,1
26112,4,1,91269,91269,91270,0,1,1
26113,5,1,91274,91274,91275,0,1,4
26114,1,2,91275,91275,91277,0,2,0
26115,5,1,91280,91280,91281,0,1,3
26116,3,2,91283,91283,91285,0,2,2
26117,2,3,91285,91285,91288,0,3,0
26118,3,1,91288,91288,91289,0,1,0
26119,6,3,91294,91294,91297,0,3,5
26120,4,3,91298,91298,91301,0,3,1
26121,6,2,91304,91304,91306,0,2,3
26122,3,3,91307,91307,91310,0,3,1
26123,1,2,91308,91310,91312,2,4,0
26124,3,2,91311,91312,91314,1,3,0
26125,5,3,91316,91316,91319,0,3,2
26126,6,3,91322,91322,91325,0,3,3
26127,1,2,91323,91325,91327,2,4,0
26128,2,1,91325,91327,91328,2,3,0
26129,4,1,91329,91329,91330,0,1,1
26130,5,3,91334,91334,91337,0,3,4
26131,3,2,91337,91337,91339,0,2,0
26132,5,1,91342,91342,91343,0,1,3
26133,6,2,91348,91348,91350,0,2,5
26134,6,2,91354,91354,91356,0,2,4
26135,4,2,91358,91358,91360,0,2,2
26136,2,2,91360,91360,91362,0,2,0
26137,4,2,91364,91364,91366,0,2,2
26138,4,3,91368,91368,91371,0,3,2
26139,5,1,91373,91373,91374,0,1,2
26140,1,1,91374,91374,91375,0,1,0
26141,1,1,91375,91375,91376,0,1,0
26142,4,1,91379,91379,91380,0,1,3
26143,1,1,91380,91380,91381,0,1,0
26144,1,3,91381,91381,91384,0,3,0
26145,2,2,91383,91384,91386,1,3,0
26146,5,2,91388,91388,91390,0,2,2
26147,6,2,91394,91394,91396,0,2,4
26148,3,1,91397,91397,91398,0,1,1
26149,2,2,91399,91399,91401,0,2,1
26150,3,3,91402,91402,91405,0,3,1
26151,3,1,91405,91405,91406,0,1,0
26152,6,1,91411,91411,91412,0,1,5
26153,3,2,91414,91414,91416,0,2,2
26154,2,2,91416,91416,91418,0,2,0
26155,4,1,91420,91420,91421,0,1,2
26156,5,1,91425,91425,91426,0,1,4
26157,2,3,91427,91427,91430,0,3,1
26158,4,2,91431,91431,91433,0,2,1
26159,1,3,91432,91433,91436,1,4,0
26160,5,1,91437,91437,91438,0,1,1
26161,6,2,91443,91443,91445,0,2,5
26162,6,1,91449,91449,91450,0,1,4
26163,5,1,91454,91454,91455,0,1,4
26164,1,3,91455,91455,91458,0,3,0
26165,3,1,91458,91458,91459,0,1,0
26166,5,2,91463,91463,91465,0,2,4
26167,3,1,91466,91466,91467,0,1,1
26168,2,1,91468,91468,91469,0,1,1
26169,5,3,91473,91473,91476,0,3,4
26170,3,2,91476,91476,91478,0,2,0
26171,5,2,91481,91481,91483,0,2,3
26172,5,3,91486,91486,91489,0,3,3
26173,2,2,91488,91489,91491,1,3,0
26174,4,3,91492,91492,91495,0,3,1
26175,4,1,91496,91496,91497,0,1,1
26176,4,3,91500,91500,91503,0,3,3
26177,2,3,91502,91503,91506,1,4,0
26178,3,3,91505,91506,91509,1,4,0
26179,3,2,91508,91509,91511,1,3,0
26180,2,1,91510,91511,91512,1,2,0
26181,1,1,91511,91512,91513,1,2,0
26182,2,2,91513,91513,91515,0,2,0
26183,1,3,91514,91515,91518,1,4,0
26184,5,1,91519,91519,91520,0,1,1
26185,1,3,91520,91520,91523,0,3,0
26186,6,3,91526,91526,91529,0,3,3
26187,3,1,91529,91529,91530,0,1,0
26188,5,2,91534,91534,91536,0,2,4
26189,3,3,91537,91537,91540,0,3,1
26190,4,1,91541,91541,91542,0,1,1
26191,4,2,91545,91545,91547,0,2,3
26192,4,3,91549,91549,91552,0,3,2
26193,3,2,91552,91552,91554,0,2,0
26194,4,3,91556,91556,91559,0,3,2
26195,3,1,91559,91559,91560,0,1,0
26196,2,2,91561,91561,91563,0,2,1
26197,1,3,91562,91563,91566,1,4,0
26198,5,2,91567,91567,91569,0,2,1
26199,1,2,91568,91569,91571,1,3,0
26200,6,2,91574,91574,91576,0,2,3
26201,4,3,91578,91578,91581,0,3,2
26202,2,1,91580,91581,91582,1,2,0
26203,1,3,91581,91582,91585,1,4,0
26204,3,2,91584,91585,91587,1,3,0
26205,5,2,91589,91589,91591,0,2,2
26206,5,2,91594,91594,91596,0,2,3
26207,4,3,91598,91598,91601,0,3,2
26208,6,1,91604,91604,91605,0,1,3
26209,5,3,91609,91609,91612,0,3,4
26210,3,3,91612,91612,91615,0,3,0
26211,1,1,91613,91615,91616,2,3,0
26212,1,2,91614,91616,91618,2,4,0
26213,4,1,91618,91618,91619,0,1,0
26214,6,2,91624,91624,91626,0,2,5
26215,3,1,91627,91627,91628,0,1,1
26216,1,2,91628,91628,91630,0,2,0
26217,4,2,91632,91632,91634,0,2,2
26218,4,3,91636,91636,91639,0,3,2
26219,4,1,91640,91640,91641,0,1,1
26220,6,2,91646,91646,91648,0,2,5
26221,4,2,91650,91650,91652,0,2,2
26222,6,1,91656,91656,91657,0,1,4
26223,6,3,91662,91662,91665,0,3,5
26224,5,3,91667,91667,91670,0,3,2
26225,6,3,91673,91673,91676,0,3,3
26226,3,3,91676,91676,91679,0,3,0
26227,4,3,91680,91680,91683,0,3,1
26228,5,3,91685,91685,91688,0,3,2
26229,4,2,91689,91689,91691,0,2,1
26230,5,2,91694,91694,91696,0,2,3
26231,4,2,91698,91698,91700,0,2,2
26232,6,1,91704,91704,91705,0,1,4
26233,2,1,91706,91706,91707,0,1,1
26234,2,2,91708,91708,91710,0,2,1
26235,6,3,91714,91714,91717,0,3,4
26236,6,1,91720,91720,91721,0,1,3
26237,4,1,91724,91724,91725,0,1,3
26238,6,3,91730,91730,91733,0,3,5
26239,4,3,91734,91734,91737,0,3,1
26240,5,3,91739,91739,91742,0,3,2
26241,6,2,91745,91745,91747,0,2,3
26242,6,3,91751,91751,91754,0,3,4
26243,2,1,91753,91754,91755,1,2,0
26244,1,3,91754,91755,91758,1,4,0
26245,6,2,91760,91760,91762,0,2,2
26246,6,1,91766,91766,91767,0,1,4
26247,5,2,91771,91771,91773,0,2,4
26248,2,1,91773,91773,91774,0,1,0
26249,4,1,91777,91777,91778,0,1,3
26250,5,1,91782,91782,91783,0,1,4
26251,1,1,91783,91783,91784,0,1,0
26252,5,2,91788,91788,91790,0,2,4
26253,5,2,91793,91793,91795,0,2,3
26254,4,2,91797,91797,91799,0,2,2
26255,1,2,91798,91799,91801,1,3,0
26256,3,1,91801,91801,91802,0,1,0
26257,4,1,91805,91805,91806,0,1,3
26258,3,3,91808,91808,91811,0,3,2
26259,1,1,91809,91811,91812,2,3,0
26260,3,2,91812,91812,91814,0,2,0
26261,5,3,91817,91817,91820,0,3,3
26262,3,2,91820,91820,91822,0,2,0
26263,1,1,91821,91822,91823,1,2,0
26264,6,2,91827,91827,91829,0,2,4
26265,5,2,91832,91832,91834,0,2,3
26266,6,2,91838,91838,91840,0,2,4
26267,5,2,91843,91843,91845,0,2,3
26268,5,2,91848,91848,91850,0,2,3
26269,5,1,91853,91853,91854,0,1,3
26270,6,1,91859,91859,91860,0,1,5
26271,5,1,91864,91864,91865,0,1,4
26272,4,3,91868,91868,91871,0,3,3
26273,1,1,91869,91871,91872,2,3,0
26274,4,2,91873,91873,91875,0,2,1
26275,6,1,91879,91879,91880,0,1,4
26276,2,3,91881,91881,91884,0,3,1
26277,1,2,91882,91884,91886,2,4,0
26278,4,1,91886,91886,91887,0,1,0
26279,4,1,91890,91890,91891,0,1,3
26280,2,2,91892,91892,91894,0,2,1
26281,5,3,91897,91897,91900,0,3,3
26282,1,1,91898,91900,91901,2,3,0
26283,1,1,91899,91901,91902,2,3,0
26284,1,1,91900,91902,91903,2,3,0
26285,4,3,91904,91904,91907,0,3,1
26286,6,3,91910,91910,91913,0,3,3
26287,2,3,91912,91913,91916,1,4,0
26288,5,2,91917,91917,91919,0,2,1
26289,3,3,91920,91920,91923,0,3,1
26290,4,3,91924,91924,91927,0,3,1
26291,5,2,91929,91929,91931,0,2,2
26292,5,3,91934,91934,91937,0,3,3
26293,2,3,91936,91937,91940,1,4,0
26294,2,2,91938,91940,91942,2,4,0
26295,6,1,91944,91944,91945,0,1,2
26296,1,3,91945,91945,91948,0,3,0
26297,2,3,91947,91948,91951,1,4,0
26298,6,2,91953,91953,91955,0,2,2
26299,4,3,91957,91957,91960,0,3,2
26300,2,2,91959,91960,91962,1,3,0
26301,3,3,91962,91962,91965,0,3,0
26302,3,3,91965,91965,91968,0,3,0
26303,5,2,91970,91970,91972,0,2,2
26304,3,3,91973,91973,91976,0,3,1
26305,1,1,91974,91976,91977,2,3,0
26306,2,3,91976,91977,91980,1,4,0
26307,6,3,91982,91982,91985,0,3,2
26308,1,2,91983,91985,91987,2,4,0
26309,4,1,91987,91987,91988,0,1,0
26310,3,3,91990,91990,91993,0,3,2
26311,5,1,91995,91995,91996,0,1,2
26312,6,2,92001,92001,92003,0,2,5
26313,5,3,92006,92006,92009,0,3,3
26314,5,1,92011,92011,92012,0,1,2
26315,6,2,92017,92017,92019,0,2,5
26316,2,1,92019,92019,92020,0,1,0
26317,4,3,92023,92023,92026,0,3,3
26318,6,3,92029,92029,92032,0,3,3
26319,1,3,92030,92032,92035,2,5,0
26320,2,2,92032,92035,92037,3,5,0
26321,3,1,92035,92037,92038,2,3,0
26322,3,1,92038,92038,92039,0,1,0
26323,6,3,92044,92044,92047,0,3,5
26324,5,2,92049,92049,92051,0,2,2
26325,1,2,92050,92051,92053,1,3,0
26326,4,1,92054,92054,92055,0,1,1
26327,2,1,92056,92056,92057,0,1,1
26328,3,2,92059,92059,92061,0,2,2
26329,4,3,92063,92063,92066,0,3,2
26330,4,3,92067,92067,92070,0,3,1
26331,2,2,92069,92070,92072,1,3,0
26332,5,1,92074,92074,92075,0,1,2
26333,5,2,92079,92079,92081,0,2,4
26334,1,1,92080,92081,92082,1,2,0
26335,5,1,92085,92085,92086,0,1,3
26336,4,2,92089,92089,92091,0,2,3
26337,5,3,92094,92094,92097,0,3,3
26338,2,2,92096,92097,92099,1,3,0
26339,4,1,92100,92100,92101,0,1,1
26340,2,2,92102,92102,92104,0,2,1
26341,6,3,92108,92108,92111,0,3,4
26342,3,2,92111,92111,92113,0,2,0
26343,1,3,92112,92113,92116,1,4,0
26344,4,1,92116,92116,92117,0,1,0
26345,4,3,92120,92120,92123,0,3,3
26346,2,2,92122,92123,92125,1,3,0
26347,6,2,92128,92128,92130,0,2,3
26348,1,1,92129,92130,92131,1,2,0
26349,6,1,92135,92135,92136,0,1,4
26350,2,2,92137,92137,92139,0,2,1
26351,6,3,92143,92143,92146,0,3,4
26352,1,2,92144,92146,92148,2,4,0
26353,6,2,92150,92150,92152,0,2,2
26354,6,3,92156,92156,92159,0,3,4
26355,6,1,92162,92162,92163,0,1,3
26356,4,1,92166,92166,92167,0,1,3
26357,6,3,92172,92172,92175,0,3,5
26358,1,3,92173,92175,92178,2,5,0
26359,2,3,92175,92178,92181,3,6,0
26360,1,3,92176,92181,92184,5,8,0
26361,1,3,92177,92184,92187,7,10,0
26362,4,3,92181,92187,92190,6,9,0
26363,1,2,92182,92190,92192,8,10,0
26364,6,3,92188,92192,92195,4,7,0
26365,2,2,92190,92195,92197,5,7,0
26366,1,2,92191,92197,92199,6,8,0
26367,4,1,92195,92199,92200,4,5,0
26368,3,1,92198,92200,92201,2,3,0
26369,4,3,92202,92202,92205,0,3,1
26370,6,2,92208,92208,92210,0,2,3
26371,1,2,92209,92210,92212,1,3,0
26372,1,2,92210,92212,92214,2,4,0
26373,3,2,92213,92214,92216,1,3,0
26374,3,2,92216,92216,92218,0,2,0
26375,6,3,92222,92222,92225,0,3,4
26376,6,3,92228,92228,92231,0,3,3
26377,5,2,92233,92233,92235,0,2,2
26378,4,3,92237,92237,92240,0,3,2
26379,5,1,92242,92242,92243,0,1,2
26380,5,2,92247,92247,92249,0,2,4
26381,4,2,92251,92251,92253,0,2,2
26382,5,3,92256,92256,92259,0,3,3
26383,5,1,92261,92261,92262,0,1,2
26384,2,1,92263,92263,92264,0,1,1
26385,5,1,92268,92268,92269,0,1,4
26386,1,1,92269,92269,92270,0,1,0
26387,5,2,92274,92274,92276,0,2,4
26388,3,3,92277,92277,92280,0,3,1
26389,1,2,92278,92280,92282,2,4,0
26390,2,1,92280,92282,92283,2,3,0
26391,2,1,92282,92283,92284,1,2,0
26392,1,3,92283,92284,92287,1,4,0
26393,4,1,92287,92287,92288,0,1,0
26394,3,2,92290,92290,92292,0,2,2
26395,3,2,92293,92293,92295,0,2,1
26396,1,1,92294,92295,92296,1,2,0
26397,2,3,92296,92296,92299,0,3,0
26398,6,2,92302,92302,92304,0,2,3
26399,1,2,92303,92304,92306,1,3,0
26400,2,2,92305,92306,92308,1,3,0
26401,3,2,92308,92308,92310,0,2,0
26402,5,1,92313,92313,92314,0,1,3
26403,3,3,92316,92316,92319,0,3,2
26404,2,3,92318,92319,92322,1,4,0
26405,4,1,92322,92322,92323,0,1,0
26406,1,3,92323,92323,92326,0,3,0
26407,2,1,92325,92326,92327,1,2,0
26408,1,3,92326,92327,92330,1,4,0
26409,1,3,92327,92330,92333,3,6,0
26410,2,1,92329,92333,92334,4,5,0
26411,2,2,92331,92334,92336,3,5,0
26412,2,1,92333,92336,92337,3,4,0
26413,3,1,92336,92337,92338,1,2,0
26414,4,1,92340,92340,92341,0,1,2
26415,2,2,92342,92342,92344,0,2,1
26416,4,1,92346,92346,92347,0,1,2
26417,3,2,92349,92349,92351,0,2,2
26418,4,2,92353,92353,92355,0,2,2
26419,5,1,92358,92358,92359,0,1,3
26420,6,2,92364,92364,92366,0,2,5
26421,6,2,92370,92370,92372,0,2,4
26422,4,3,92374,92374,92377,0,3,2
26423,6,1,92380,92380,92381,0,1,3
26424,4,1,92384,92384,92385,0,1,3
26425,5,1,92389,92389,92390,0,1,4
26426,2,2,92391,92391,92393,0,2,1
26427,1,2,92392,92393,92395,1,3,0
26428,2,1,92394,92395,92396,1,2,0
26429,6,1,92400,92400,92401,0,1,4
26430,4,3,92404,92404,92407,0,3,3
26431,5,3,92409,92409,92412,0,3,2
26432,5,3,92414,92414,92417,0,3,2
26433,2,1,92416,92417,92418,1,2,0
26434,1,2,92417,92418,92420,1,3,0
26435,6,3,92423,92423,92426,0,3,3
26436,6,1,92429,92429,92430,0,1,3
26437,3,2,92432,92432,92434,0,2,2
26438,4,2,92436,92436,92438,0,2,2
26439,3,1,92439,92439,92440,0,1,1
26440,6,1,92445,92445,92446,0,1,5
26441,4,3,92449,92449,92452,0,3,3
26442,4,2,92453,92453,92455,0,2,1
26443,6,3,92459,92459,92462,0,3,4
26444,2,3,92461,92462,92465,1,4,0
26445,3,3,92464,92465,92468,1,4,0
26446,5,3,92469,92469,92472,0,3,1
26447,4,3,92473,92473,92476,0,3,1
26448,4,1,92477,92477,92478,0,1,1
26449,3,3,92480,92480,92483,0,3,2
26450,6,1,92486,92486,92487,0,1,3
26451,2,2,92488,92488,92490,0,2,1
26452,3,2,92491,92491,92493,0,2,1
26453,2,1,92493,92493,92494,0,1,0
26454,1,2,92494,92494,92496,0,2,0
26455,6,3,92500,92500,92503,0,3,4
26456,3,1,92503,92503,92504,0,1,0
26457,3,1,92506,92506,92507,0,1,2
26458,4,2,92510,92510,92512,0,2,3
26459,4,3,92514,92514,92517,0,3,2
26460,1,2,92515,92517,92519,2,4,0
26461,6,3,92521,92521,92524,0,3,2
26462,3,2,92524,92524,92526,0,2,0
26463,2,1,92526,92526,92527,0,1,0
26464,6,2,92532,92532,92534,0,2,5
26465,5,3,92537,92537,92540,0,3,3
26466,3,2,92540,92540,92542,0,2,0
26467,2,3,92542,92542,92545,0,3,0
26468,2,2,92544,92545,92547,1,3,0
26469,5,1,92549,92549,92550,0,1,2
26470,1,2,92550,92550,92552,0,2,0
26471,4,2,92554,92554,92556,0,2,2
26472,3,1,92557,92557,92558,0,1,1
26473,3,2,92560,92560,92562,0,2,2
26474,2,1,92562,92562,92563,0,1,0
26475,2,3,92564,92564,92567,0,3,1
26476,5,1,92569,92569,92570,0,1,2
26477,2,3,92571,92571,92574,0,3,1
26478,3,1,92574,92574,92575,0,1,0
26479,6,2,92580,92580,92582,0,2,5
26480,1,1,92581,92582,92583,1,2,0
26481,4,2,92585,92585,92587,0,2,2
26482,2,3,92587,92587,92590,0,3,0
26483,3,3,92590,92590,92593,0,3,0
26484,6,2,92596,92596,92598,0,2,3
26485,5,2,92601,92601,92603,0,2,3
26486,2,1,92603,92603,92604,0,1,0
26487,1,1,92604,92604,92605,0,1,0
26488,4,2,92608,92608,92610,0,2,3
26489,1,3,92609,92610,92613,1,4,0
26490,3,3,92612,92613,92616,1,4,0
26491,4,3,92616,92616,92619,0,3,0
26492,1,2,92617,92619,92621,2,4,0
26493,4,2,92621,92621,92623,0,2,0
26494,2,1,92623,92623,92624,0,1,0
26495,2,1,92625,92625,92626,0,1,1
26496,2,1,92627,92627,92628,0,1,1
26497,3,2,92630,92630,92632,0,2,2
26498,1,1,92631,92632,92633,1,2,0
26499,5,3,92636,92636,92639,0,3,3
26500,6,3,92642,92642,92645,0,3,3
26501,5,2,92647,92647,92649,0,2,2
26502,3,3,92650,92650,92653,0,3,1
26503,5,3,92655,92655,92658,0,3,2
26504,1,3,92656,92658,92661,2,5,0
26505,3,3,92659,92661,92664,2,5,0
26506,2,1,92661,92664,92665,3,4,0
26507,4,3,92665,92665,92668,0,3,0
26508,1,2,92666,92668,92670,2,4,0
26509,3,3,92669,92670,92673,1,4,0
26510,6,3,92675,92675,92678,0,3,2
26511,4,2,92679,92679,92681,0,2,1
26512,5,1,92684,92684,92685,0,1,3
26513,1,2,92685,92685,92687,0,2,0
26514,5,2,92690,92690,92692,0,2,3
26515,6,1,92696,92696,92697,0,1,4
26516,2,2,92698,92698,92700,0,2,1
26517,3,2,92701,92701,92703,0,2,1
26518,1,3,92702,92703,92706,1,4,0
26519,6,3,92708,92708,92711,0,3,2
26520,5,1,92713,92713,92714,0,1,2
26521,2,3,92715,92715,92718,0,3,1
26522,4,3,92719,92719,92722,0,3,1
26523,5,2,92724,92724,92726,0,2,2
26524,3,1,92727,92727,92728,0,1,1
26525,2,2,92729,92729,92731,0,2,1
26526,4,1,92733,92733,92734,0,1,2
26527,3,1,92736,92736,92737,0,1,2
26528,3,1,92739,92739,92740,0,1,2
26529,3,1,92742,92742,92743,0,1,2
26530,1,3,92743,92743,92746,0,3,0
26531,5,1,92748,92748,92749,0,1,2
26532,4,3,92752,92752,92755,0,3,3
26533,5,2,92757,92757,92759,0,2,2
26534,2,1,92759,92759,92760,0,1,0
26535,4,3,92763,92763,92766,0,3,3
26536,2,3,92765,92766,92769,1,4,0
26537,3,2,92768,92769,92771,1,3,0
26538,4,2,92772,92772,92774,0,2,1
26539,5,2,92777,92777,92779,0,2,3
26540,1,1,92778,92779,92780,1,2,0
26541,6,2,92784,92784,92786,0,2,4
26542,4,3,92788,92788,92791,0,3,2
26543,2,1,92790,92791,92792,1,2,0
26544,6,1,92796,92796,92797,0,1,4
26545,6,2,92802,92802,92804,0,2,5
26546,4,3,92806,92806,92809,0,3,2
26547,5,2,92811,92811,92813,0,2,2
26548,6,1,92817,92817,92818,0,1,4
26549,1,3,92818,92818,92821,0,3,0
26550,4,2,92822,92822,92824,0,2,1
26551,4,3,92826,92826,92829,0,3,2
26552,2,1,92828,92829,92830,1,2,0
26553,3,2,92831,92831,92833,0,2,1
26554,4,2,92835,92835,92837,0,2,2
26555,2,1,92837,92837,92838,0,1,0
26556,4,2,92841,92841,92843,0,2,3
26557,5,1,92846,92846,92847,0,1,3
26558,3,1,92849,92849,92850,0,1,2
26559,4,1,92853,92853,92854,0,1,3
26560,3,3,92856,92856,92859,0,3,2
26561,1,1,92857,92859,92860,2,3,0
26562,2,2,92859,92860,92862,1,3,0
26563,4,3,92863,92863,92866,0,3,1
26564,1,1,92864,92866,92867,2,3,0
26565,6,1,92870,92870,92871,0,1,3
26566,2,1,92872,92872,92873,0,1,1
26567,3,3,92875,92875,92878,0,3,2
26568,1,3,92876,92878,92881,2,5,0
26569,1,2,92877,92881,92883,4,6,0
26570,3,3,92880,92883,92886,3,6,0
26571,4,3,92884,92886,92889,2,5,0
26572,5,3,92889,92889,92892,0,3,0
26573,1,2,92890,92892,92894,2,4,0
26574,3,1,92893,92894,92895,1,2,0
26575,1,3,92894,92895,92898,1,4,0
26576,4,3,92898,92898,92901,0,3,0
26577,1,3,92899,92901,92904,2,5,0
26578,6,1,92905,92905,92906,0,1,1
26579,4,2,92909,92909,92911,0,2,3
26580,4,1,92913,92913,92914,0,1,2
26581,6,1,92919,92919,92920,0,1,5
26582,3,3,92922,92922,92925,0,3,2
26583,5,2,92927,92927,92929,0,2,2
26584,5,3,92932,92932,92935,0,3,3
26585,1,2,92933,92935,92937,2,4,0
26586,2,3,92935,92937,92940,2,5,0
26587,5,3,92940,92940,92943,0,3,0
26588,1,2,92941,92943,92945,2,4,0
26589,6,1,92947,92947,92948,0,1,2
26590,6,2,92953,92953,92955,0,2,5
26591,5,3,92958,92958,92961,0,3,3
26592,5,2,92963,92963,92965,0,2,2
26593,3,3,92966,92966,92969,0,3,1
26594,6,1,92972,92972,92973,0,1,3
26595,2,1,92974,92974,92975,0,1,1
26596,4,1,92978,92978,92979,0,1,3
26597,6,3,92984,92984,92987,0,3,5
26598,1,2,92985,92987,92989,2,4,0
26599,3,2,92988,92989,92991,1,3,0
26600,3,2,92991,92991,92993,0,2,0
26601,1,3,92992,92993,92996,1,4,0
26602,4,2,92996,92996,92998,0,2,0
26603,2,1,92998,92998,92999,0,1,0
26604,2,3,93000,93000,93003,0,3,1
26605,6,2,93006,93006,93008,0,2,3
26606,6,1,93012,93012,93013,0,1,4
26607,2,3,93014,93014,93017,0,3,1
26608,2,3,93016,93017,93020,1,4,0
26609,1,3,93017,93020,93023,3,6,0
26610,3,1,93020,93023,93024,3,4,0
26611,5,2,93025,93025,93027,0,2,1
26612,3,1,93028,93028,93029,0,1,1
26613,6,2,93034,93034,93036,0,2,5
26614,1,3,93035,93036,93039,1,4,0
26615,3,2,93038,93039,93041,1,3,0
26616,1,3,93039,93041,93044,2,5,0
26617,4,2,93043,93044,93046,1,3,0
26618,4,2,93047,93047,93049,0,2,1
26619,5,3,93052,93052,93055,0,3,3
26620,5,3,93057,93057,93060,0,3,2
26621,2,2,93059,93060,93062,1,3,0
26622,6,2,93065,93065,93067,0,2,3
26623,3,3,93068,93068,93071,0,3,1
26624,1,2,93069,93071,93073,2,4,0
26625,6,3,93075,93075,93078,0,3,2
26626,3,3,93078,93078,93081,0,3,0
26627,2,2,93080,93081,93083,1,3,0
26628,5,3,93085,93085,93088,0,3,2
26629,6,2,93091,93091,93093,0,2,3
26630,1,2,93092,93093,93095,1,3,0
26631,3,3,93095,93095,93098,0,3,0
26632,1,1,93096,93098,93099,2,3,0
26633,5,3,93101,93101,93104,0,3,2
26634,3,1,93104,93104,93105,0,1,0
26635,1,1,93105,93105,93106,0,1,0
26636,5,3,93110,93110,93113,0,3,4
26637,5,3,93115,93115,93118,0,3,2
26638,5,3,93120,93120,93123,0,3,2
26639,1,3,93121,93123,93126,2,5,0
26640,4,2,93125,93126,93128,1,3,0
26641,3,3,93128,93128,93131,0,3,0
26642,5,1,93133,93133,93134,0,1,2
26643,5,3,93138,93138,93141,0,3,4
26644,6,1,93144,93144,93145,0,1,3
26645,6,3,93150,93150,93153,0,3,5
26646,3,1,93153,93153,93154,0,1,0
26647,4,2,93157,93157,93159,0,2,3
26648,6,2,93163,93163,93165,0,2,4
26649,1,3,93164,93165,93168,1,4,0
26650,2,1,93166,93168,93169,2,3,0
26651,1,3,93167,93169,93172,2,5,0
26652,5,2,93172,93172,93174,0,2,0
26653,6,1,93178,93178,93179,0,1,4
26654,6,1,93184,93184,93185,0,1,5
26655,4,2,93188,93188,93190,0,2,3
26656,4,2,93192,93192,93194,0,2,2
26657,6,1,93198,93198,93199,0,1,4
26658,4,1,93202,93202,93203,0,1,3
26659,3,3,93205,93205,93208,0,3,2
26660,1,1,93206,93208,93209,2,3,0
26661,2,3,93208,93209,93212,1,4,0
26662,5,2,93213,93213,93215,0,2,1
26663,2,3,93215,93215,93218,0,3,0
26664,6,2,93221,93221,93223,0,2,3
26665,3,1,93224,93224,93225,0,1,1
26666,4,3,93228,93228,93231,0,3,3
26667,3,1,93231,93231,93232,0,1,0
26668,1,3,93232,93232,93235,0,3,0
26669,1,1,93233,93235,93236,2,3,0
26670,3,2,93236,93236,93238,0,2,0
26671,3,2,93239,93239,93241,0,2,1
26672,2,1,93241,93241,93242,0,1,0
26673,1,3,93242,93242,93245,0,3,0
26674,6,3,93248,93248,93251,0,3,3
26675,1,3,93249,93251,93254,2,5,0
26676,3,2,93252,93254,93256,2,4,0
26677,1,2,93253,93256,93258,3,5,0
26678,6,2,93259,93259,93261,0,2,1
26679,5,1,93264,93264,93265,0,1,3
26680,6,3,93270,93270,93273,0,3,5
26681,6,1,93276,93276,93277,0,1,3
26682,1,1,93277,93277,93278,0,1,0
26683,4,2,93281,93281,93283,0,2,3
26684,2,1,93283,93283,93284,0,1,0
26685,6,1,93289,93289,93290,0,1,5
26686,6,3,93295,93295,93298,0,3,5
26687,3,3,93298,93298,93301,0,3,0
26688,2,2,93300,93301,93303,1,3,0
26689,3,2,93303,93303,93305,0,2,0
26690,2,2,93305,93305,93307,0,2,0
26691,5,3,93310,93310,93313,0,3,3
26692,1,2,93311,93313,93315,2,4,0
26693,3,1,93314,93315,93316,1,2,0
26694,3,3,93317,93317,93320,0,3,1
26695,6,1,93323,93323,93324,0,1,3
26696,3,1,93326,93326,93327,0,1,2
26697,1,3,93327,93327,93330,0,3,0
26698,6,3,93333,93333,93336,0,3,3
26699,2,3,93335,93336,93339,1,4,0
26700,3,2,93338,93339,93341,1,3,0
26701,5,2,93343,93343,93345,0,2,2
26702,6,3,93349,93349,93352,0,3,4
26703,2,3,93351,93352,93355,1,4,0
26704,5,1,93356,93356,93357,0,1,1
26705,1,3,93357,93357,93360,0,3,0
26706,4,2,93361,93361,93363,0,2,1
26707,5,1,93366,93366,93367,0,1,3
26708,6,3,93372,93372,93375,0,3,5
26709,5,1,93377,93377,93378,0,1,2
26710,1,2,93378,93378,93380,0,2,0
26711,2,1,93380,93380,93381,0,1,0
26712,3,3,93383,93383,93386,0,3,2
26713,1,1,93384,93386,93387,2,3,0
26714,4,1,93388,93388,93389,0,1,1
26715,6,2,93394,93394,93396,0,2,5
26716,1,2,93395,93396,93398,1,3,0
26717,1,2,93396,93398,93400,2,4,0
26718,2,1,93398,93400,93401,2,3,0
26719,3,2,93401,93401,93403,0,2,0
26720,6,1,93407,93407,93408,0,1,4
26721,6,3,93413,93413,93416,0,3,5
26722,1,1,93414,93416,93417,2,3,0
26723,2,2,93416,93417,93419,1,3,0
26724,4,1,93420,93420,93421,0,1,1
26725,2,3,93422,93422,93425,0,3,1
26726,1,2,93423,93425,93427,2,4,0
26727,4,3,93427,93427,93430,0,3,0
26728,5,2,93432,93432,93434,0,2,2
26729,1,1,93433,93434,93435,1,2,0
26730,1,1,93434,93435,93436,1,2,0
26731,4,1,93438,93438,93439,0,1,2
26732,1,1,93439,93439,93440,0,1,0
26733,4,2,93443,93443,93445,0,2,3
26734,4,3,93447,93447,93450,0,3,2
26735,2,1,93449,93450,93451,1,2,0
26736,4,2,93453,93453,93455,0,2,2
26737,1,1,93454,93455,93456,1,2,0
26738,1,2,93455,93456,93458,1,3,0
26739,3,2,93458,93458,93460,0,2,0
26740,4,3,93462,93462,93465,0,3,2
26741,2,3,93464,93465,93468,1,4,0
26742,5,1,93469,93469,93470,0,1,1
26743,4,3,93473,93473,93476,0,3,3
26744,2,3,93475,93476,93479,1,4,0
26745,4,3,93479,93479,93482,0,3,0
26746,5,3,93484,93484,93487,0,3,2
26747,4,3,93488,93488,93491,0,3,1
26748,6,2,93494,93494,93496,0,2,3
26749,2,1,93496,93496,93497,0,1,0
26750,2,2,93498,93498,93500,0,2,1
26751,4,3,93502,93502,93505,0,3,2
26752,3,1,93505,93505,93506,0,1,0
26753,1,1,93506,93506,93507,0,1,0
26754,1,1,93507,93507,93508,0,1,0
26755,1,3,93508,93508,93511,0,3,0
26756,6,2,93514,93514,93516,0,2,3
26757,6,1,93520,93520,93521,0,1,4
26758,3,2,93523,93523,93525,0,2,2
26759,5,3,93528,93528,93531,0,3,3
26760,3,1,93531,93531,93532,0,1,0
26761,4,3,93535,93535,93538,0,3,3
26762,4,3,93539,93539,93542,0,3,1
26763,3,3,93542,93542,93545,0,3,0
26764,6,3,93548,93548,93551,0,3,3
26765,4,3,93552,93552,93555,0,3,1
26766,6,2,93558,93558,93560,0,2,3
26767,4,2,93562,93562,93564,0,2,2
26768,3,2,93565,93565,93567,0,2,1
26769,5,2,93570,93570,93572,0,2,3
26770,6,3,93576,93576,93579,0,3,4
26771,3,2,93579,93579,93581,0,2,0
26772,3,3,93582,93582,93585,0,3,1
26773,5,1,93587,93587,93588,0,1,2
26774,4,3,93591,93591,93594,0,3,3
26775,4,1,93595,93595,93596,0,1,1
26776,5,2,93600,93600,93602,0,2,4
26777,1,2,93601,93602,93604,1,3,0
26778,2,2,93603,93604,93606,1,3,0
26779,3,2,93606,93606,93608,0,2,0
26780,1,2,93607,93608,93610,1,3,0
26781,2,1,93609,93610,93611,1,2,0
26782,6,3,93615,93615,93618,0,3,4
26783,4,2,93619,93619,93621,0,2,1
26784,2,1,93621,93621,93622,0,1,0
26785,3,1,93624,93624,93625,0,1,2
26786,2,2,93626,93626,93628,0,2,1
26787,2,3,93628,93628,93631,0,3,0
26788,4,3,93632,93632,93635,0,3,1
26789,3,3,93635,93635,93638,0,3,0
26790,2,2,93637,93638,93640,1,3,0
26791,4,3,93641,93641,93644,0,3,1
26792,6,1,93647,93647,93648,0,1,3
26793,3,2,93650,93650,93652,0,2,2
26794,5,1,93655,93655,93656,0,1,3
26795,3,3,93658,93658,93661,0,3,2
26796,1,1,93659,93661,93662,2,3,0
26797,3,2,93662,93662,93664,0,2,0
26798,3,2,93665,93665,93667,0,2,1
26799,2,2,93667,93667,93669,0,2,0
26800,3,2,93670,93670,93672,0,2,1
26801,3,2,93673,93673,93675,0,2,1
26802,3,3,93676,93676,93679,0,3,1
26803,6,3,93682,93682,93685,0,3,3
26804,4,3,93686,93686,93689,0,3,1
26805,5,3,93691,93691,93694,0,3,2
26806,5,2,93696,93696,93698,0,2,2
26807,2,2,93698,93698,93700,0,2,0
26808,3,1,93701,93701,93702,0,1,1
26809,1,3,93702,93702,93705,0,3,0
26810,4,3,93706,93706,93709,0,3,1
26811,4,1,93710,93710,93711,0,1,1
26812,5,2,93715,93715,93717,0,2,4
26813,5,1,93720,93720,93721,0,1,3
26814,4,2,93724,93724,93726,0,2,3
26815,5,1,93729,93729,93730,0,1,3
26816,4,1,93733,93733,93734,0,1,3
26817,1,3,93734,93734,93737,0,3,0
26818,5,3,93739,93739,93742,0,3,2
26819,4,1,93743,93743,93744,0,1,1
26820,3,3,93746,93746,93749,0,3,2
26821,3,3,93749,93749,93752,0,3,0
26822,1,2,93750,93752,93754,2,4,0
26823,4,3,93754,93754,93757,0,3,0
26824,3,3,93757,93757,93760,0,3,0
26825,4,3,93761,93761,93764,0,3,1
26826,6,3,93767,93767,93770,0,3,3
26827,1,2,93768,93770,93772,2,4,0
26828,2,1,93770,93772,93773,2,3,0
26829,4,2,93774,93774,93776,0,2,1
26830,3,3,93777,93777,93780,0,3,1
26831,5,3,93782,93782,93785,0,3,2
26832,1,3,93783,93785,93788,2,5,0
26833,2,1,93785,93788,93789,3,4,0
26834,4,2,93789,93789,93791,0,2,0
26835,4,2,93793,93793,93795,0,2,2
26836,2,3,93795,93795,93798,0,3,0
26837,4,1,93799,93799,93800,0,1,1
26838,3,2,93802,93802,93804,0,2,2
26839,4,3,93806,93806,93809,0,3,2
26840,1,1,93807,93809,93810,2,3,0
26841,2,3,93809,93810,93813,1,4,0
26842,5,2,93814,93814,93816,0,2,1
26843,5,3,93819,93819,93822,0,3,3
26844,3,1,93822,93822,93823,0,1,0
26845,1,3,93823,93823,93826,0,3,0
26846,1,3,93824,93826,93829,2,5,0
26847,3,1,93827,93829,93830,2,3,0
26848,2,3,93829,93830,93833,1,4,0
26849,5,2,93834,93834,93836,0,2,1
26850,4,2,93838,93838,93840,0,2,2
26851,6,2,93844,93844,93846,0,2,4
26852,6,1,93850,93850,93851,0,1,4
26853,2,3,93852,93852,93855,0,3,1
26854,4,3,93856,93856,93859,0,3,1
26855,3,2,93859,93859,93861,0,2,0
26856,4,2,93863,93863,93865,0,2,2
26857,3,1,93866,93866,93867,0,1,1
26858,1,3,93867,93867,93870,0,3,0
26859,1,3,93868,93870,93873,2,5,0
26860,5,2,93873,93873,93875,0,2,0
26861,3,3,93876,93876,93879,0,3,1
26862,5,1,93881,93881,93882,0,1,2
26863,2,2,93883,93883,93885,0,2,1
26864,5,3,93888,93888,93891,0,3,3
26865,4,2,93892,93892,93894,0,2,1
26866,1,3,93893,93894,93897,1,4,0
26867,1,1,93894,93897,93898,3,4,0
26868,2,2,93896,93898,93900,2,4,0
26869,1,2,93897,93900,93902,3,5,0
26870,3,2,93900,93902,93904,2,4,0
26871,3,2,93903,93904,93906,1,3,0
26872,3,1,93906,93906,93907,0,1,0
26873,1,3,93907,93907,93910,0,3,0
26874,3,1,93910,93910,93911,0,1,0
26875,3,3,93913,93913,93916,0,3,2
26876,2,3,93915,93916,93919,1,4,0
26877,6,1,93921,93921,93922,0,1,2
26878,5,1,93926,93926,93927,0,1,4
26879,6,1,93932,93932,93933,0,1,5
26880,6,1,93938,93938,93939,0,1,5
26881,2,3,93940,93940,93943,0,3,1
26882,1,1,93941,93943,93944,2,3,0
26883,3,3,93944,93944,93947,0,3,0
26884,6,3,93950,93950,93953,0,3,3
26885,6,2,93956,93956,93958,0,2,3
26886,2,1,93958,93958,93959,0,1,0
26887,1,1,93959,93959,93960,0,1,0
26888,2,1,93961,93961,93962,0,1,1
26889,2,2,93963,93963,93965,0,2,1
26890,2,3,93965,93965,93968,0,3,0
26891,1,2,93966,93968,93970,2,4,0
26892,4,1,93970,93970,93971,0,1,0
26893,2,1,93972,93972,93973,0,1,1
26894,4,1,93976,93976,93977,0,1,3
26895,6,2,93982,93982,93984,0,2,5
26896,6,1,93988,93988,93989,0,1,4
26897,5,3,93993,93993,93996,0,3,4
26898,3,1,93996,93996,93997,0,1,0
26899,1,1,93997,93997,93998,0,1,0
26900,5,1,94002,94002,94003,0,1,4
26901,6,2,94008,94008,94010,0,2,5
26902,5,1,94013,94013,94014,0,1,3
26903,4,3,94017,94017,94020,0,3,3
26904,3,2,94020,94020,94022,0,2,0
26905,4,3,94024,94024,94027,0,3,2
26906,6,2,94030,94030,94032,0,2,3
26907,4,1,94034,94034,94035,0,1,2
26908,6,2,94040,94040,94042,0,2,5
26909,4,2,94044,94044,94046,0,2,2
26910,5,3,94049,94049,94052,0,3,3
26911,1,1,94050,94052,94053,2,3,0
26912,3,1,94053,94053,94054,0,1,0
26913,1,2,94054,94054,94056,0,2,0
26914,1,1,94055,94056,94057,1,2,0
26915,6,1,94061,94061,94062,0,1,4
26916,5,1,94066,94066,94067,0,1,4
26917,4,3,94070,94070,94073,0,3,3
26918,5,2,94075,94075,94077,0,2,2
26919,2,2,94077,94077,94079,0,2,0
26920,3,3,94080,94080,94083,0,3,1
26921,4,1,94084,94084,94085,0,1,1
26922,3,2,94087,94087,94089,0,2,2
26923,4,2,94091,94091,94093,0,2,2
26924,1,2,94092,94093,94095,1,3,0
26925,5,3,94097,94097,94100,0,3,2
26926,6,2,94103,94103,94105,0,2,3
26927,5,2,94108,94108,94110,0,2,3
26928,6,1,94114,94114,94115,0,1,4
26929,2,2,94116,94116,94118,0,2,1
26930,3,1,94119,94119,94120,0,1,1
26931,1,1,94120,94120,94121,0,1,0
26932,5,3,94125,94125,94128,0,3,4
26933,5,2,94130,94130,94132,0,2,2
26934,6,2,94136,94136,94138,0,2,4
26935,2,3,94138,94138,94141,0,3,0
26936,4,3,94142,94142,94145,0,3,1
26937,4,2,94146,94146,94148,0,2,1
26938,1,1,94147,94148,94149,1,2,0
26939,2,2,94149,94149,94151,0,2,0
26940,3,1,94152,94152,94153,0,1,1
26941,5,2,94157,94157,94159,0,2,4
26942,2,3,94159,94159,94162,0,3,0
26943,2,1,94161,94162,94163,1,2,0
26944,3,2,94164,94164,94166,0,2,1
26945,3,3,94167,94167,94170,0,3,1
26946,4,3,94171,94171,94174,0,3,1
26947,2,3,94173,94174,94177,1,4,0
26948,5,1,94178,94178,94179,0,1,1
26949,4,3,94182,94182,94185,0,3,3
26950,1,1,94183,94185,94186,2,3,0
26951,4,2,94187,94187,94189,0,2,1
26952,3,2,94190,94190,94192,0,2,1
26953,6,2,94196,94196,94198,0,2,4
26954,5,3,94201,94201,94204,0,3,3
26955,6,2,94207,94207,94209,0,2,3
26956,1,1,94208,94209,94210,1,2,0
26957,5,2,94213,94213,94215,0,2,3
26958,3,1,94216,94216,94217,0,1,1
26959,4,2,94220,94220,94222,0,2,3
26960,6,2,94226,94226,94228,0,2,4
26961,5,3,94231,94231,94234,0,3,3
26962,4,1,94235,94235,94236,0,1,1
26963,5,3,94240,94240,94243,0,3,4
26964,6,1,94246,94246,94247,0,1,3
26965,1,2,94247,94247,94249,0,2,0
26966,2,1,94249,94249,94250,0,1,0
26967,1,1,94250,94250,94251,0,1,0
26968,1,1,94251,94251,94252,0,1,0
26969,4,1,94255,94255,94256,0,1,3
26970,5,2,94260,94260,94262,0,2,4
26971,6,2,94266,94266,94268,0,2,4
26972,3,2,94269,94269,94271,0,2,1
26973,1,3,94270,94271,94274,1,4,0
26974,5,2,94275,94275,94277,0,2,1
26975,5,1,94280,94280,94281,0,1,3
26976,4,3,94284,94284,94287,0,3,3
26977,2,2,94286,94287,94289,1,3,0
26978,6,1,94292,94292,94293,0,1,3
26979,4,2,94296,94296,94298,0,2,3
26980,2,1,94298,94298,94299,0,1,0
26981,2,3,94300,94300,94303,0,3,1
26982,2,1,94302,94303,94304,1,2,0
26983,3,3,94305,94305,94308,0,3,1
26984,1,3,94306,94308,94311,2,5,0
26985,4,2,94310,94311,94313,1,3,0
26986,3,1,94313,94313,94314,0,1,0
26987,3,3,94316,94316,94319,0,3,2
26988,6,2,94322,94322,94324,0,2,3
26989,4,1,94326,94326,94327,0,1,2
26990,6,1,94332,94332,94333,0,1,5
26991,6,3,94338,94338,94341,0,3,5
26992,6,1,94344,94344,94345,0,1,3
26993,6,1,94350,94350,94351,0,1,5
26994,6,3,94356,94356,94359,0,3,5
26995,6,2,94362,94362,94364,0,2,3
26996,5,3,94367,94367,94370,0,3,3
26997,6,2,94373,94373,94375,0,2,3
26998,6,3,94379,94379,94382,0,3,4
26999,6,2,94385,94385,94387,0,2,3
27000,4,1,94389,94389,94390,0,1,2
27001,1,2,94390,94390,94392,0,2,0
27002,6,3,94396,94396,94399,0,3,4
27003,3,1,94399,94399,94400,0,1,0
27004,5,2,94404,94404,94406,0,2,4
27005,4,3,94408,94408,94411,0,3,2
27006,1,2,94409,94411,94413,2,4,0
27007,6,2,94415,94415,94417,0,2,2
27008,1,1,94416,94417,94418,1,2,0
27009,3,3,94419,94419,94422,0,3,1
27010,5,2,94424,94424,94426,0,2,2
27011,6,2,94430,94430,94432,0,2,4
27012,4,3,94434,94434,94437,0,3,2
27013,2,1,94436,94437,94438,1,2,0
27014,6,3,94442,94442,94445,0,3,4
27015,5,3,94447,94447,94450,0,3,2
27016,1,3,94448,94450,94453,2,5,0
27017,5,1,94453,94453,94454,0,1,0
27018,5,2,94458,94458,94460,0,2,4
27019,4,1,94462,94462,94463,0,1,2
27020,5,1,94467,94467,94468,0,1,4
27021,2,3,94469,94469,94472,0,3,1
27022,5,2,94474,94474,94476,0,2,2
27023,6,1,94480,94480,94481,0,1,4
27024,3,3,94483,94483,94486,0,3,2
27025,3,2,94486,94486,94488,0,2,0
27026,1,2,94487,94488,94490,1,3,0
27027,4,3,94491,94491,94494,0,3,1
27028,6,2,94497,94497,94499,0,2,3
27029,6,3,94503,94503,94506,0,3,4
27030,3,1,94506,94506,94507,0,1,0
27031,2,1,94508,94508,94509,0,1,1
27032,4,1,94512,94512,94513,0,1,3
27033,5,1,94517,94517,94518,0,1,4
27034,5,3,94522,94522,94525,0,3,4
27035,1,1,94523,94525,94526,2,3,0
27036,1,3,94524,94526,94529,2,5,0
27037,2,1,94526,94529,94530,3,4,0
27038,4,1,94530,94530,94531,0,1,0
27039,2,1,94532,94532,94533,0,1,1
27040,6,1,94538,94538,94539,0,1,5
27041,6,1,94544,94544,94545,0,1,5
27042,6,3,94550,94550,94553,0,3,5
27043,3,3,94553,94553,94556,0,3,0
27044,5,2,94558,94558,94560,0,2,2
27045,3,1,94561,94561,94562,0,1,1
27046,4,3,94565,94565,94568,0,3,3
27047,5,2,94570,94570,94572,0,2,2
27048,1,2,94571,94572,94574,1,3,0
27049,4,3,94575,94575,94578,0,3,1
27050,2,1,94577,94578,94579,1,2,0
27051,2,1,94579,94579,94580,0,1,0
27052,6,3,94585,94585,94588,0,3,5
27053,6,3,94591,94591,94594,0,3,3
27054,5,3,94596,94596,94599,0,3,2
27055,4,2,94600,94600,94602,0,2,1
27056,2,1,94602,94602,94603,0,1,0
27057,1,2,94603,94603,94605,0,2,0
27058,6,3,94609,94609,94612,0,3,4
27059,1,2,94610,94612,94614,2,4,0
27060,3,1,94613,94614,94615,1,2,0
27061,3,1,94616,94616,94617,0,1,1
27062,3,1,94619,94619,94620,0,1,2
27063,3,1,94622,94622,94623,0,1,2
27064,3,2,94625,94625,94627,0,2,2
27065,2,2,94627,94627,94629,0,2,0
27066,1,2,94628,94629,94631,1,3,0
27067,4,2,94632,94632,94634,0,2,1
27068,6,3,94638,94638,94641,0,3,4
27069,3,2,94641,94641,94643,0,2,0
27070,1,2,94642,94643,94645,1,3,0
27071,2,2,94644,94645,94647,1,3,0
27072,4,2,94648,94648,94650,0,2,1
27073,4,2,94652,94652,94654,0,2,2
27074,4,3,94656,94656,94659,0,3,2
27075,6,3,94662,94662,94665,0,3,3
27076,5,1,94667,94667,94668,0,1,2
27077,4,2,94671,94671,94673,0,2,3
27078,6,1,94677,94677,94678,0,1,4
27079,4,3,94681,94681,94684,0,3,3
27080,5,3,94686,94686,94689,0,3,2
27081,5,3,94691,94691,94694,0,3,2
27082,5,3,94696,94696,94699,0,3,2
27083,6,3,94702,94702,94705,0,3,3
27084,3,2,94705,94705,94707,0,2,0
27085,1,2,94706,94707,94709,1,3,0
27086,5,1,94711,94711,94712,0,1,2
27087,6,1,94717,94717,94718,0,1,5
27088,1,3,94718,94718,94721,0,3,0
27089,5,3,94723,94723,94726,0,3,2
27090,4,3,94727,94727,94730,0,3,1
27091,2,3,94729,94730,94733,1,4,0
27092,1,1,94730,94733,94734,3,4,0
27093,4,1,94734,94734,94735,0,1,0
27094,1,1,94735,94735,94736,0,1,0
27095,1,1,94736,94736,94737,0,1,0
27096,2,1,94738,94738,94739,0,1,1
27097,2,2,94740,94740,94742,0,2,1
27098,3,1,94743,94743,94744,0,1,1
27099,2,1,94745,94745,94746,0,1,1
27100,5,2,94750,94750,94752,0,2,4
27101,6,1,94756,94756,94757,0,1,4
27102,6,2,94762,94762,94764,0,2,5
27103,2,1,94764,94764,94765,0,1,0
27104,4,2,94768,94768,94770,0,2,3
27105,1,2,94769,94770,94772,1,3,0
27106,5,3,94774,94774,94777,0,3,2
27107,2,2,94776,94777,94779,1,3,0
27108,3,3,94779,94779,94782,0,3,0
27109,1,2,94780,94782,94784,2,4,0
27110,2,1,94782,94784,94785,2,3,0
27111,2,3,94784,94785,94788,1,4,0
27112,1,3,94785,94788,94791,3,6,0
27113,4,1,94789,94791,94792,2,3,0
27114,6,1,94795,94795,94796,0,1,3
27115,6,1,94801,94801,94802,0,1,5
27116,1,2,94802,94802,94804,0,2,0
27117,5,3,94807,94807,94810,0,3,3
27118,1,1,94808,94810,94811,2,3,0
27119,6,2,94814,94814,94816,0,2,3
27120,4,2,94818,94818,94820,0,2,2
27121,6,3,94824,94824,94827,0,3,4
27122,4,1,94828,94828,94829,0,1,1
27123,4,3,94832,94832,94835,0,3,3
27124,5,2,94837,94837,94839,0,2,2
27125,5,1,94842,94842,94843,0,1,3
27126,3,1,94845,94845,94846,0,1,2
27127,6,1,94851,94851,94852,0,1,5
27128,3,2,94854,94854,94856,0,2,2
27129,1,2,94855,94856,94858,1,3,0
27130,4,3,94859,94859,94862,0,3,1
27131,1,3,94860,94862,94865,2,5,0
27132,6,3,94866,94866,94869,0,3,1
27133,5,3,94871,94871,94874,0,3,2
27134,6,2,94877,94877,94879,0,2,3
27135,6,2,94883,94883,94885,0,2,4
27136,6,2,94889,94889,94891,0,2,4
27137,6,1,94895,94895,94896,0,1,4
27138,6,2,94901,94901,94903,0,2,5
27139,1,2,94902,94903,94905,1,3,0
27140,6,1,94908,94908,94909,0,1,3
27141,5,1,94913,94913,94914,0,1,4
27142,6,1,94919,94919,94920,0,1,5
27143,2,3,94921,94921,94924,0,3,1
27144,3,1,94924,94924,94925,0,1,0
27145,1,1,94925,94925,94926,0,1,0
27146,2,3,94927,94927,94930,0,3,1
27147,6,2,94933,94933,94935,0,2,3
27148,4,2,94937,94937,94939,0,2,2
27149,3,2,94940,94940,94942,0,2,1
27150,5,2,94945,94945,94947,0,2,3
27151,3,3,94948,94948,94951,0,3,1
27152,4,2,94952,94952,94954,0,2,1
27153,3,2,94955,94955,94957,0,2,1
27154,2,3,94957,94957,94960,0,3,0
27155,6,3,94963,94963,94966,0,3,3
27156,5,1,94968,94968,94969,0,1,2
27157,1,3,94969,94969,94972,0,3,0
27158,3,2,94972,94972,94974,0,2,0
27159,4,3,94976,94976,94979,0,3,2
27160,3,3,94979,94979,94982,0,3,0
27161,3,1,94982,94982,94983,0,1,0
27162,4,2,94986,94986,94988,0,2,3
27163,3,3,94989,94989,94992,0,3,1
27164,2,3,94991,94992,94995,1,4,0
27165,1,1,94992,94995,94996,3,4,0
27166,6,2,94998,94998,95000,0,2,2
27167,3,3,95001,95001,95004,0,3,1
27168,2,1,95003,95004,95005,1,2,0
27169,3,3,95006,95006,95009,0,3,1
27170,4,1,95010,95010,95011,0,1,1
27171,6,3,95016,95016,95019,0,3,5
27172,4,1,95020,95020,95021,0,1,1
27173,1,3,95021,95021,95024,0,3,0
27174,1,3,95022,95024,95027,2,5,0
27175,3,3,95025,95027,95030,2,5,0
27176,1,2,95026,95030,95032,4,6,0
27177,3,1,95029,95032,95033,3,4,0
27178,5,1,95034,95034,95035,0,1,1
27179,4,3,95038,95038,95041,0,3,3
27180,5,1,95043,95043,95044,0,1,2
27181,5,2,95048,95048,95050,0,2,4
27182,5,2,95053,95053,95055,0,2,3
27183,3,1,95056,95056,95057,0,1,1
27184,3,1,95059,95059,95060,0,1,2
27185,3,3,95062,95062,95065,0,3,2
27186,1,3,95063,95065,95068,2,5,0
27187,2,2,95065,95068,95070,3,5,0
27188,4,1,95069,95070,95071,1,2,0
27189,5,3,95074,95074,95077,0,3,3
27190,4,3,95078,95078,95081,0,3,1
27191,1,3,95079,95081,95084,2,5,0
27192,5,1,95084,95084,95085,0,1,0
27193,4,2,95088,95088,95090,0,2,3
27194,6,3,95094,95094,95097,0,3,4
27195,1,3,95095,95097,95100,2,5,0
27196,2,1,95097,95100,95101,3,4,0
27197,2,3,95099,95101,95104,2,5,0
27198,6,2,95105,95105,95107,0,2,1
27199,4,3,95109,95109,95112,0,3,2
27200,4,2,95113,95113,95115,0,2,1
27201,2,2,95115,95115,95117,0,2,0
27202,6,1,95121,95121,95122,0,1,4
27203,5,1,95126,95126,95127,0,1,4
27204,2,2,95128,95128,95130,0,2,1
27205,3,2,95131,95131,95133,0,2,1
27206,4,2,95135,95135,95137,0,2,2
27207,6,1,95141,95141,95142,0,1,4
27208,2,2,95143,95143,95145,0,2,1
27209,1,1,95144,95145,95146,1,2,0
27210,3,2,95147,95147,95149,0,2,1
27211,4,1,95151,95151,95152,0,1,2
27212,5,3,95156,95156,95159,0,3,4
27213,4,2,95160,95160,95162,0,2,1
27214,2,1,95162,95162,95163,0,1,0
27215,3,1,95165,95165,95166,0,1,2
27216,3,1,95168,95168,95169,0,1,2
27217,4,1,95172,95172,95173,0,1,3
27218,4,2,95176,95176,95178,0,2,3
27219,6,1,95182,95182,95183,0,1,4
27220,1,3,95183,95183,95186,0,3,0
27221,5,2,95188,95188,95190,0,2,2
27222,6,3,95194,95194,95197,0,3,4
27223,5,3,95199,95199,95202,0,3,2
27224,1,1,95200,95202,95203,2,3,0
27225,6,1,95206,95206,95207,0,1,3
27226,4,1,95210,95210,95211,0,1,3
27227,2,1,95212,95212,95213,0,1,1
27228,6,2,95218,95218,95220,0,2,5
27229,6,1,95224,95224,95225,0,1,4
27230,6,1,95230,95230,95231,0,1,5
27231,6,1,95236,95236,95237,0,1,5
27232,2,2,95238,95238,95240,0,2,1
27233,5,1,95243,95243,95244,0,1,3
27234,4,2,95247,95247,95249,0,2,3
27235,1,3,95248,95249,95252,1,4,0
27236,3,1,95251,95252,95253,1,2,0
27237,1,3,95252,95253,95256,1,4,0
27238,2,3,95254,95256,95259,2,5,0
27239,1,3,95255,95259,95262,4,7,0
27240,2,2,95257,95262,95264,5,7,0
27241,5,1,95262,95264,95265,2,3,0
27242,2,1,95264,95265,95266,1,2,0
27243,1,2,95265,95266,95268,1,3,0
27244,5,2,95270,95270,95272,0,2,2
27245,4,3,95274,95274,95277,0,3,2
27246,1,1,95275,95277,95278,2,3,0
27247,3,2,95278,95278,95280,0,2,0
27248,6,1,95284,95284,95285,0,1,4
27249,6,3,95290,95290,95293,0,3,5
27250,6,3,95296,95296,95299,0,3,3
27251,6,2,95302,95302,95304,0,2,3
27252,2,2,95304,95304,95306,0,2,0
27253,2,1,95306,95306,95307,0,1,0
27254,5,2,95311,95311,95313,0,2,4
27255,6,3,95317,95317,95320,0,3,4
27256,2,1,95319,95320,95321,1,2,0
27257,6,1,95325,95325,95326,0,1,4
27258,3,3,95328,95328,95331,0,3,2
27259,3,3,95331,95331,95334,0,3,0
27260,4,2,95335,95335,95337,0,2,1
27261,2,2,95337,95337,95339,0,2,0
27262,2,2,95339,95339,95341,0,2,0
27263,5,2,95344,95344,95346,0,2,3
27264,1,3,95345,95346,95349,1,4,0
27265,2,2,95347,95349,95351,2,4,0
27266,5,1,95352,95352,95353,0,1,1
27267,2,2,95354,95354,95356,0,2,1
27268,2,3,95356,95356,95359,0,3,0
27269,4,1,95360,95360,95361,0,1,1
27270,1,3,95361,95361,95364,0,3,0
27271,2,2,95363,95364,95366,1,3,0
27272,1,3,95364,95366,95369,2,5,0
27273,6,3,95370,95370,95373,0,3,1
27274,3,3,95373,95373,95376,0,3,0
27275,6,2,95379,95379,95381,0,2,3
27276,1,1,95380,95381,95382,1,2,0
27277,1,3,95381,95382,95385,1,4,0
27278,2,2,95383,95385,95387,2,4,0
27279,1,1,95384,95387,95388,3,4,0
27280,2,3,95386,95388,95391,2,5,0
27281,5,2,95391,95391,95393,0,2,0
27282,6,1,95397,95397,95398,0,1,4
27283,3,3,95400,95400,95403,0,3,2
27284,2,3,95402,95403,95406,1,4,0
27285,2,1,95404,95406,95407,2,3,0
27286,6,2,95410,95410,95412,0,2,3
27287,4,2,95414,95414,95416,0,2,2
27288,2,2,95416,95416,95418,0,2,0
27289,6,1,95422,95422,95423,0,1,4
27290,5,3,95427,95427,95430,0,3,4
27291,5,1,95432,95432,95433,0,1,2
27292,3,1,95435,95435,95436,0,1,2
27293,4,2,95439,95439,95441,0,2,3
27294,5,1,95444,95444,95445,0,1,3
27295,4,1,95448,95448,95449,0,1,3
27296,2,2,95450,95450,95452,0,2,1
27297,3,2,95453,95453,95455,0,2,1
27298,3,3,95456,95456,95459,0,3,1
27299,5,1,95461,95461,95462,0,1,2
27300,3,2,95464,95464,95466,0,2,2
27301,4,3,95468,95468,95471,0,3,2
27302,3,2,95471,95471,95473,0,2,0
27303,2,3,95473,95473,95476,0,3,0
27304,6,1,95479,95479,95480,0,1,3
27305,2,1,95481,95481,95482,0,1,1
27306,4,3,95485,95485,95488,0,3,3
27307,3,3,95488,95488,95491,0,3,0
27308,2,3,95490,95491,95494,1,4,0
27309,5,3,95495,95495,95498,0,3,1
27310,6,3,95501,95501,95504,0,3,3
27311,5,3,95506,95506,95509,0,3,2
27312,3,3,95509,95509,95512,0,3,0
27313,5,2,95514,95514,95516,0,2,2
27314,3,1,95517,95517,95518,0,1,1
27315,3,3,95520,95520,95523,0,3,2
27316,1,2,95521,95523,95525,2,4,0
27317,2,1,95523,95525,95526,2,3,0
27318,5,3,95528,95528,95531,0,3,2
27319,3,3,95531,95531,95534,0,3,0
27320,4,2,95535,95535,95537,0,2,1
27321,4,3,95539,95539,95542,0,3,2
27322,4,3,95543,95543,95546,0,3,1
27323,2,3,95545,95546,95549,1,4,0
27324,5,2,95550,95550,95552,0,2,1
27325,4,1,95554,95554,95555,0,1,2
27326,6,1,95560,95560,95561,0,1,5
27327,4,3,95564,95564,95567,0,3,3
27328,4,2,95568,95568,95570,0,2,1
27329,2,1,95570,95570,95571,0,1,0
27330,2,1,95572,95572,95573,0,1,1
27331,3,1,95575,95575,95576,0,1,2
27332,6,2,95581,95581,95583,0,2,5
27333,6,2,95587,95587,95589,0,2,4
27334,6,2,95593,95593,95595,0,2,4
27335,5,3,95598,95598,95601,0,3,3
27336,4,3,95602,95602,95605,0,3,1
27337,1,3,95603,95605,95608,2,5,0
27338,5,3,95608,95608,95611,0,3,0
27339,4,3,95612,95612,95615,0,3,1
27340,6,1,95618,95618,95619,0,1,3
27341,5,2,95623,95623,95625,0,2,4
27342,4,3,95627,95627,95630,0,3,2
27343,5,1,95632,95632,95633,0,1,2
27344,4,2,95636,95636,95638,0,2,3
27345,6,1,95642,95642,95643,0,1,4
27346,2,3,95644,95644,95647,0,3,1
27347,1,1,95645,95647,95648,2,3,0
27348,1,3,95646,95648,95651,2,5,0
27349,5,1,95651,95651,95652,0,1,0
27350,3,3,95654,95654,95657,0,3,2
27351,1,3,95655,95657,95660,2,5,0
27352,1,1,95656,95660,95661,4,5,0
27353,3,3,95659,95661,95664,2,5,0
27354,6,2,95665,95665,95667,0,2,1
27355,3,3,95668,95668,95671,0,3,1
27356,6,3,95674,95674,95677,0,3,3
27357,1,1,95675,95677,95678,2,3,0
27358,3,3,95678,95678,95681,0,3,0
27359,3,2,95681,95681,95683,0,2,0
27360,2,3,95683,95683,95686,0,3,0
27361,6,3,95689,95689,95692,0,3,3
27362,2,1,95691,95692,95693,1,2,0
27363,2,2,95693,95693,95695,0,2,0
27364,3,1,95696,95696,95697,0,1,1
27365,6,1,95702,95702,95703,0,1,5
27366,5,2,95707,95707,95709,0,2,4
27367,3,2,95710,95710,95712,0,2,1
27368,6,1,95716,95716,95717,0,1,4
27369,1,2,95717,95717,95719,0,2,0
27370,5,1,95722,95722,95723,0,1,3
27371,4,3,95726,95726,95729,0,3,3
27372,3,1,95729,95729,95730,0,1,0
27373,1,2,95730,95730,95732,0,2,0
27374,6,3,95736,95736,95739,0,3,4
27375,6,2,95742,95742,95744,0,2,3
27376,5,3,95747,95747,95750,0,3,3
27377,4,2,95751,95751,95753,0,2,1
27378,3,1,95754,95754,95755,0,1,1
27379,4,3,95758,95758,95761,0,3,3
27380,2,2,95760,95761,95763,1,3,0
27381,6,3,95766,95766,95769,0,3,3
27382,5,3,95771,95771,95774,0,3,2
27383,1,2,95772,95774,95776,2,4,0
27384,2,1,95774,95776,95777,2,3,0
27385,5,3,95779,95779,95782,0,3,2
27386,5,2,95784,95784,95786,0,2,2
27387,5,3,95789,95789,95792,0,3,3
27388,5,1,95794,95794,95795,0,1,2
27389,2,1,95796,95796,95797,0,1,1
27390,5,1,95801,95801,95802,0,1,4
27391,4,2,95805,95805,95807,0,2,3
27392,5,3,95810,95810,95813,0,3,3
27393,2,3,95812,95813,95816,1,4,0
27394,1,3,95813,95816,95819,3,6,0
27395,3,1,95816,95819,95820,3,4,0
27396,4,1,95820,95820,95821,0,1,0
27397,3,1,95823,95823,95824,0,1,2
27398,5,2,95828,95828,95830,0,2,4
27399,4,2,95832,95832,95834,0,2,2
27400,1,2,95833,95834,95836,1,3,0
27401,2,2,95835,95836,95838,1,3,0
27402,4,1,95839,95839,95840,0,1,1
27403,2,2,95841,95841,95843,0,2,1
27404,4,2,95845,95845,95847,0,2,2
27405,2,3,95847,95847,95850,0,3,0
27406,6,3,95853,95853,95856,0,3,3
27407,4,3,95857,95857,95860,0,3,1
27408,5,1,95862,95862,95863,0,1,2
27409,4,2,95866,95866,95868,0,2,3
27410,6,1,95872,95872,95873,0,1,4
27411,5,1,95877,95877,95878,0,1,4
27412,2,2,95879,95879,95881,0,2,1
27413,3,3,95882,95882,95885,0,3,1
27414,1,3,95883,95885,95888,2,5,0
27415,2,3,95885,95888,95891,3,6,0
27416,4,1,95889,95891,95892,2,3,0
27417,5,3,95894,95894,95897,0,3,2
27418,3,2,95897,95897,95899,0,2,0
27419,4,1,95901,95901,95902,0,1,2
27420,5,1,95906,95906,95907,0,1,4
27421,3,2,95909,95909,95911,0,2,2
27422,5,1,95914,95914,95915,0,1,3
27423,1,1,95915,95915,95916,0,1,0
27424,4,1,95919,95919,95920,0,1,3
27425,4,3,95923,95923,95926,0,3,3
27426,4,2,95927,95927,95929,0,2,1
27427,3,2,95930,95930,95932,0,2,1
27428,6,1,95936,95936,95937,0,1,4
27429,6,1,95942,95942,95943,0,1,5
27430,3,3,95945,95945,95948,0,3,2
27431,1,2,95946,95948,95950,2,4,0
27432,2,3,95948,95950,95953,2,5,0
27433,4,2,95952,95953,95955,1,3,0
27434,1,1,95953,95955,95956,2,3,0
27435,1,1,95954,95956,95957,2,3,0
27436,5,3,95959,95959,95962,0,3,2
27437,2,2,95961,95962,95964,1,3,0
27438,1,1,95962,95964,95965,2,3,0
27439,5,1,95967,95967,95968,0,1,2
27440,4,1,95971,95971,95972,0,1,3
27441,4,1,95975,95975,95976,0,1,3
27442,2,3,95977,95977,95980,0,3,1
27443,4,3,95981,95981,95984,0,3,1
27444,6,1,95987,95987,95988,0,1,3
27445,5,2,95992,95992,95994,0,2,4
27446,3,2,95995,95995,95997,0,2,1
27447,4,1,95999,95999,96000,0,1,2
27448,1,2,96000,96000,96002,0,2,0
27449,6,1,96006,96006,96007,0,1,4
27450,2,2,96008,96008,96010,0,2,1
27451,3,3,96011,96011,96014,0,3,1
27452,2,1,96013,96014,96015,1,2,0
27453,4,2,96017,96017,96019,0,2,2
27454,3,3,96020,96020,96023,0,3,1
27455,1,2,96021,96023,96025,2,4,0
27456,3,2,96024,96025,96027,1,3,0
27457,6,1,96030,96030,96031,0,1,3
27458,3,3,96033,96033,96036,0,3,2
27459,2,3,96035,96036,96039,1,4,0
27460,2,2,96037,96039,96041,2,4,0
27461,1,3,96038,96041,96044,3,6,0
27462,5,2,96043,96044,96046,1,3,0
27463,3,2,96046,96046,96048,0,2,0
27464,3,1,96049,96049,96050,0,1,1
27465,5,3,96054,96054,96057,0,3,4
27466,4,3,96058,96058,96061,0,3,1
27467,2,3,96060,96061,96064,1,4,0
27468,6,1,96066,96066,96067,0,1,2
27469,4,3,96070,96070,96073,0,3,3
27470,1,2,96071,96073,96075,2,4,0
27471,3,1,96074,96075,96076,1,2,0
27472,6,3,96080,96080,96083,0,3,4
27473,1,1,96081,96083,96084,2,3,0
27474,2,1,96083,96084,96085,1,2,0
27475,6,3,96089,96089,96092,0,3,4
27476,2,1,96091,96092,96093,1,2,0
27477,6,1,96097,96097,96098,0,1,4
27478,4,3,96101,96101,96104,0,3,3
27479,6,1,96107,96107,96108,0,1,3
27480,5,1,96112,96112,96113,0,1,4
27481,6,2,96118,96118,96120,0,2,5
27482,3,2,96121,96121,96123,0,2,1
27483,4,3,96125,96125,96128,0,3,2
27484,1,3,96126,96128,96131,2,5,0
27485,1,1,96127,96131,96132,4,5,0
27486,2,3,96129,96132,96135,3,6,0
27487,5,2,96134,96135,96137,1,3,0
27488,5,3,96139,96139,96142,0,3,2
27489,6,1,96145,96145,96146,0,1,3
27490,6,3,96151,96151,96154,0,3,5
27491,3,1,96154,96154,96155,0,1,0
27492,2,2,96156,96156,96158,0,2,1
27493,5,3,96161,96161,96164,0,3,3
27494,2,2,96163,96164,96166,1,3,0
27495,3,3,96166,96166,96169,0,3,0
27496,2,2,96168,96169,96171,1,3,0
27497,2,3,96170,96171,96174,1,4,0
27498,1,2,96171,96174,96176,3,5,0
27499,5,2,96176,96176,96178,0,2,0
27500,5,1,96181,96181,96182,0,1,3
27501,5,2,96186,96186,96188,0,2,4
27502,4,2,96190,96190,96192,0,2,2
27503,3,1,96193,96193,96194,0,1,1
27504,3,3,96196,96196,96199,0,3,2
27505,4,1,96200,96200,96201,0,1,1
27506,5,2,96205,96205,96207,0,2,4
27507,6,3,96211,96211,96214,0,3,4
27508,3,2,96214,96214,96216,0,2,0
27509,3,3,96217,96217,96220,0,3,1
27510,6,3,96223,96223,96226,0,3,3
27511,2,1,96225,96226,96227,1,2,0
27512,3,1,96228,96228,96229,0,1,1
27513,4,1,96232,96232,96233,0,1,3
27514,3,1,96235,96235,96236,0,1,2
27515,6,3,96241,96241,96244,0,3,5
27516,1,3,96242,96244,96247,2,5,0
27517,3,2,96245,96247,96249,2,4,0
27518,2,1,96247,96249,96250,2,3,0
27519,1,3,96248,96250,96253,2,5,0
27520,2,3,96250,96253,96256,3,6,0
27521,2,1,96252,96256,96257,4,5,0
27522,5,2,96257,96257,96259,0,2,0
27523,6,2,96263,96263,96265,0,2,4
27524,2,2,96265,96265,96267,0,2,0
27525,4,2,96269,96269,96271,0,2,2
27526,3,1,96272,96272,96273,0,1,1
27527,6,3,96278,96278,96281,0,3,5
27528,3,3,96281,96281,96284,0,3,0
27529,4,1,96285,96285,96286,0,1,1
27530,1,3,96286,96286,96289,0,3,0
27531,5,3,96291,96291,96294,0,3,2
27532,3,2,96294,96294,96296,0,2,0
27533,3,2,96297,96297,96299,0,2,1
27534,1,1,96298,96299,96300,1,2,0
27535,5,3,96303,96303,96306,0,3,3
27536,1,1,96304,96306,96307,2,3,0
27537,3,1,96307,96307,96308,0,1,0
27538,4,2,96311,96311,96313,0,2,3
27539,6,1,96317,96317,96318,0,1,4
27540,2,3,96319,96319,96322,0,3,1
27541,2,2,96321,96322,96324,1,3,0
27542,3,2,96324,96324,96326,0,2,0
27543,6,3,96330,96330,96333,0,3,4
27544,5,2,96335,96335,96337,0,2,2
27545,3,1,96338,96338,96339,0,1,1
27546,5,3,96343,96343,96346,0,3,4
27547,1,1,96344,96346,96347,2,3,0
27548,3,3,96347,96347,96350,0,3,0
27549,1,1,96348,96350,96351,2,3,0
27550,5,2,96353,96353,96355,0,2,2
27551,3,1,96356,96356,96357,0,1,1
27552,4,1,96360,96360,96361,0,1,3
27553,1,2,96361,96361,96363,0,2,0
27554,1,2,96362,96363,96365,1,3,0
27555,3,1,96365,96365,96366,0,1,0
27556,1,3,96366,96366,96369,0,3,0
27557,6,2,96372,96372,96374,0,2,3
27558,3,2,96375,96375,96377,0,2,1
27559,4,3,96379,96379,96382,0,3,2
27560,2,1,96381,96382,96383,1,2,0
27561,1,1,96382,96383,96384,1,2,0
27562,2,2,96384,96384,96386,0,2,0
27563,6,3,96390,96390,96393,0,3,4
27564,1,3,96391,96393,96396,2,5,0
27565,3,1,96394,96396,96397,2,3,0
27566,3,2,96397,96397,96399,0,2,0
27567,2,1,96399,96399,96400,0,1,0
27568,1,1,96400,96400,96401,0,1,0
27569,4,2,96404,96404,96406,0,2,3
27570,5,1,96409,96409,96410,0,1,3
27571,4,3,96413,96413,96416,0,3,3
27572,5,1,96418,96418,96419,0,1,2
27573,2,1,96420,96420,96421,0,1,1
27574,4,1,96424,96424,96425,0,1,3
27575,4,1,96428,96428,96429,0,1,3
27576,6,1,96434,96434,96435,0,1,5
27577,3,3,96437,96437,96440,0,3,2
27578,2,3,96439,96440,96443,1,4,0
27579,3,1,96442,96443,96444,1,2,0
27580,6,3,96448,96448,96451,0,3,4
27581,6,1,96454,96454,96455,0,1,3
27582,4,1,96458,96458,96459,0,1,3
27583,2,1,96460,96460,96461,0,1,1
27584,1,1,96461,96461,96462,0,1,0
27585,4,2,96465,96465,96467,0,2,3
27586,6,3,96471,96471,96474,0,3,4
27587,4,2,96475,96475,96477,0,2,1
27588,6,3,96481,96481,96484,0,3,4
27589,2,3,96483,96484,96487,1,4,0
27590,6,2,96489,96489,96491,0,2,2
27591,2,2,96491,96491,96493,0,2,0
27592,5,1,96496,96496,96497,0,1,3
27593,6,3,96502,96502,96505,0,3,5
27594,6,1,96508,96508,96509,0,1,3
27595,2,1,96510,96510,96511,0,1,1
27596,3,3,96513,96513,96516,0,3,2
27597,5,1,96518,96518,96519,0,1,2
27598,3,3,96521,96521,96524,0,3,2
27599,2,3,96523,96524,96527,1,4,0
27600,4,1,96527,96527,96528,0,1,0
27601,4,3,96531,96531,96534,0,3,3
27602,1,3,96532,96534,96537,2,5,0
27603,3,1,96535,96537,96538,2,3,0
27604,1,2,96536,96538,96540,2,4,0
27605,4,1,96540,96540,96541,0,1,0
27606,3,2,96543,96543,96545,0,2,2
27607,4,3,96547,96547,96550,0,3,2
27608,6,3,96553,96553,96556,0,3,3
27609,5,2,96558,96558,96560,0,2,2
27610,6,3,96564,96564,96567,0,3,4
27611,4,3,96568,96568,96571,0,3,1
27612,1,1,96569,96571,96572,2,3,0
27613,3,2,96572,96572,96574,0,2,0
27614,2,3,96574,96574,96577,0,3,0
27615,5,2,96579,96579,96581,0,2,2
27616,2,3,96581,96581,96584,0,3,0
27617,3,2,96584,96584,96586,0,2,0
27618,3,1,96587,96587,96588,0,1,1
27619,1,3,96588,96588,96591,0,3,0
27620,6,2,96594,96594,96596,0,2,3
27621,4,2,96598,96598,96600,0,2,2
27622,5,3,96603,96603,96606,0,3,3
27623,6,1,96609,96609,96610,0,1,3
27624,2,2,96611,96611,96613,0,2,1
27625,1,3,96612,96613,96616,1,4,0
27626,2,1,96614,96616,96617,2,3,0
27627,2,2,96616,96617,96619,1,3,0
27628,3,1,96619,96619,96620,0,1,0
27629,4,3,96623,96623,96626,0,3,3
27630,2,3,96625,96626,96629,1,4,0
27631,3,2,96628,96629,96631,1,3,0
27632,1,3,96629,96631,96634,2,5,0
27633,1,3,96630,96634,96637,4,7,0
27634,6,3,96636,96637,96640,1,4,0
27635,5,1,96641,96641,96642,0,1,1
27636,2,2,96643,96643,96645,0,2,1
27637,5,1,96648,96648,96649,0,1,3
27638,4,1,96652,96652,96653,0,1,3
27639,3,2,96655,96655,96657,0,2,2
27640,3,1,96658,96658,96659,0,1,1
27641,4,1,96662,96662,96663,0,1,3
27642,4,3,96666,96666,96669,0,3,3
27643,3,2,96669,96669,96671,0,2,0
27644,4,3,96673,96673,96676,0,3,2
27645,1,2,96674,96676,96678,2,4,0
27646,2,2,96676,96678,96680,2,4,0
27647,4,1,96680,96680,96681,0,1,0
27648,2,2,96682,96682,96684,0,2,1
27649,3,2,96685,96685,96687,0,2,1
27650,6,2,96691,96691,96693,0,2,4
27651,3,1,96694,96694,96695,0,1,1
27652,3,3,96697,96697,96700,0,3,2
27653,1,3,96698,96700,96703,2,5,0
27654,6,1,96704,96704,96705,0,1,1
27655,6,2,96710,96710,96712,0,2,5
27656,4,2,96714,96714,96716,0,2,2
27657,5,1,96719,96719,96720,0,1,3
27658,1,2,96720,96720,96722,0,2,0
27659,4,3,96724,96724,96727,0,3,2
27660,4,1,96728,96728,96729,0,1,1
27661,5,1,96733,96733,96734,0,1,4
27662,6,1,96739,96739,96740,0,1,5
27663,2,3,96741,96741,96744,0,3,1
27664,6,3,96747,96747,96750,0,3,3
27665,2,1,96749,96750,96751,1,2,0
27666,1,1,96750,96751,96752,1,2,0
27667,4,3,96754,96754,96757,0,3,2
27668,1,1,96755,96757,96758,2,3,0
27669,3,1,96758,96758,96759,0,1,0
27670,1,1,96759,96759,96760,0,1,0
27671,5,2,96764,96764,96766,0,2,4
27672,4,2,96768,96768,96770,0,2,2
27673,3,2,96771,96771,96773,0,2,1
27674,4,2,96775,96775,96777,0,2,2
27675,1,1,96776,96777,96778,1,2,0
27676,4,1,96780,96780,96781,0,1,2
27677,1,1,96781,96781,96782,0,1,0
27678,2,1,96783,96783,96784,0,1,1
27679,2,2,96785,96785,96787,0,2,1
27680,1,2,96786,96787,96789,1,3,0
27681,4,3,96790,96790,96793,0,3,1
27682,2,1,96792,96793,96794,1,2,0
27683,5,3,96797,96797,96800,0,3,3
27684,2,1,96799,96800,96801,1,2,0
27685,3,2,96802,96802,96804,0,2,1
27686,1,2,96803,96804,96806,1,3,0
27687,2,2,96805,96806,96808,1,3,0
27688,2,2,96807,96808,96810,1,3,0
27689,4,3,96811,96811,96814,0,3,1
27690,4,2,96815,96815,96817,0,2,1
27691,4,2,96819,96819,96821,0,2,2
27692,6,1,96825,96825,96826,0,1,4
27693,6,2,96831,96831,96833,0,2,5
27694,6,3,96837,96837,96840,0,3,4
27695,4,1,96841,96841,96842,0,1,1
27696,2,2,96843,96843,96845,0,2,1
27697,4,3,96847,96847,96850,0,3,2
27698,5,1,96852,96852,96853,0,1,2
27699,4,1,96856,96856,96857,0,1,3
27700,5,3,96861,96861,96864,0,3,4
27701,4,2,96865,96865,96867,0,2,1
27702,4,3,96869,96869,96872,0,3,2
27703,5,3,96874,96874,96877,0,3,2
27704,2,3,96876,96877,96880,1,4,0
27705,4,2,96880,96880,96882,0,2,0
27706,5,2,96885,96885,96887,0,2,3
27707,6,2,96891,96891,96893,0,2,4
27708,4,1,96895,96895,96896,0,1,2
27709,2,2,96897,96897,96899,0,2,1
27710,3,3,96900,96900,96903,0,3,1
27711,3,2,96903,96903,96905,0,2,0
27712,5,1,96908,96908,96909,0,1,3
27713,4,1,96912,96912,96913,0,1,3
27714,3,3,96915,96915,96918,0,3,2
27715,1,3,96916,96918,96921,2,5,0
27716,2,3,96918,96921,96924,3,6,0
27717,2,3,96920,96924,96927,4,7,0
27718,3,2,96923,96927,96929,4,6,0
27719,1,2,96924,96929,96931,5,7,0
27720,1,1,96925,96931,96932,6,7,0
27721,4,1,96929,96932,96933,3,4,0
27722,5,2,96934,96934,96936,0,2,1
27723,2,1,96936,96936,96937,0,1,0
27724,1,2,96937,96937,96939,0,2,0
27725,1,2,96938,96939,96941,1,3,0
27726,6,1,96944,96944,96945,0,1,3
27727,4,2,96948,96948,96950,0,2,3
27728,2,2,96950,96950,96952,0,2,0
27729,3,3,96953,96953,96956,0,3,1
27730,3,2,96956,96956,96958,0,2,0
27731,5,2,96961,96961,96963,0,2,3
27732,1,1,96962,96963,96964,1,2,0
27733,6,2,96968,96968,96970,0,2,4
27734,5,2,96973,96973,96975,0,2,3
27735,6,1,96979,96979,96980,0,1,4
27736,6,2,96985,96985,96987,0,2,5
27737,5,1,96990,96990,96991,0,1,3
27738,6,2,96996,96996,96998,0,2,5
27739,3,2,96999,96999,97001,0,2,1
27740,5,2,97004,97004,97006,0,2,3
27741,5,1,97009,97009,97010,0,1,3
27742,4,1,97013,97013,97014,0,1,3
27743,4,2,97017,97017,97019,0,2,3
27744,5,1,97022,97022,97023,0,1,3
27745,2,3,97024,97024,97027,0,3,1
27746,5,3,97029,97029,97032,0,3,2
27747,1,2,97030,97032,97034,2,4,0
27748,5,1,97035,97035,97036,0,1,1
27749,2,1,97037,97037,97038,0,1,1
27750,5,3,97042,97042,97045,0,3,4
27751,5,1,97047,97047,97048,0,1,2
27752,5,1,97052,97052,97053,0,1,4
27753,2,2,97054,97054,97056,0,2,1
27754,6,3,97060,97060,97063,0,3,4
27755,5,1,97065,97065,97066,0,1,2
27756,3,3,97068,97068,97071,0,3,2
27757,6,3,97074,97074,97077,0,3,3
27758,1,1,97075,97077,97078,2,3,0
27759,2,2,97077,97078,97080,1,3,0
27760,3,3,97080,97080,97083,0,3,0
27761,2,2,97082,97083,97085,1,3,0
27762,5,2,97087,97087,97089,0,2,2
27763,5,3,97092,97092,97095,0,3,3
27764,2,3,97094,97095,97098,1,4,0
27765,6,1,97100,97100,97101,0,1,2
27766,2,2,97102,97102,97104,0,2,1
27767,4,2,97106,97106,97108,0,2,2
27768,4,3,97110,97110,97113,0,3,2
27769,6,1,97116,97116,97117,0,1,3
27770,6,1,97122,97122,97123,0,1,5
27771,4,2,97126,97126,97128,0,2,3
27772,6,2,97132,97132,97134,0,2,4
27773,2,1,97134,97134,97135,0,1,0
27774,6,3,97140,97140,97143,0,3,5
27775,5,3,97145,97145,97148,0,3,2
27776,5,1,97150,97150,97151,0,1,2
27777,6,3,97156,97156,97159,0,3,5
27778,2,1,97158,97159,97160,1,2,0
27779,5,1,97163,97163,97164,0,1,3
27780,1,3,97164,97164,97167,0,3,0
27781,4,1,97168,97168,97169,0,1,1
27782,5,1,97173,97173,97174,0,1,4
27783,1,2,97174,97174,97176,0,2,0
27784,2,1,97176,97176,97177,0,1,0
27785,2,2,97178,97178,97180,0,2,1
27786,5,1,97183,97183,97184,0,1,3
27787,4,2,97187,97187,97189,0,2,3
27788,2,1,97189,97189,97190,0,1,0
27789,4,2,97193,97193,97195,0,2,3
27790,5,3,97198,97198,97201,0,3,3
27791,5,2,97203,97203,97205,0,2,2
27792,1,1,97204,97205,97206,1,2,0
27793,3,1,97207,97207,97208,0,1,1
27794,6,3,97213,97213,97216,0,3,5
27795,5,2,97218,97218,97220,0,2,2
27796,4,1,97222,97222,97223,0,1,2
27797,1,3,97223,97223,97226,0,3,0
27798,6,1,97229,97229,97230,0,1,3
27799,3,1,97232,97232,97233,0,1,2
27800,6,2,97238,97238,97240,0,2,5
27801,4,1,97242,97242,97243,0,1,2
27802,3,1,97245,97245,97246,0,1,2
27803,3,1,97248,97248,97249,0,1,2
27804,1,3,97249,97249,97252,0,3,0
27805,6,3,97255,97255,97258,0,3,3
27806,3,1,97258,97258,97259,0,1,0
27807,4,2,97262,97262,97264,0,2,3
27808,4,3,97266,97266,97269,0,3,2
27809,2,2,97268,97269,97271,1,3,0
27810,2,2,97270,97271,97273,1,3,0
27811,1,3,97271,97273,97276,2,5,0
27812,2,2,97273,97276,97278,3,5,0
27813,2,3,97275,97278,97281,3,6,0
27814,6,3,97281,97281,97284,0,3,0
27815,2,3,97283,97284,97287,1,4,0
27816,4,1,97287,97287,97288,0,1,0
27817,4,2,97291,97291,97293,0,2,3
27818,5,1,97296,97296,97297,0,1,3
27819,5,3,97301,97301,97304,0,3,4
27820,2,1,97303,97304,97305,1,2,0
27821,3,1,97306,97306,97307,0,1,1
27822,3,3,97309,97309,97312,0,3,2
27823,1,3,97310,97312,97315,2,5,0
27824,2,2,97312,97315,97317,3,5,0
27825,3,1,97315,97317,97318,2,3,0
27826,1,3,97316,97318,97321,2,5,0
27827,6,3,97322,97322,97325,0,3,1
27828,4,1,97326,97326,97327,0,1,1
27829,5,3,97331,97331,97334,0,3,4
27830,1,2,97332,97334,97336,2,4,0
27831,5,3,97337,97337,97340,0,3,1
27832,6,1,97343,97343,97344,0,1,3
27833,3,3,97346,97346,97349,0,3,2
27834,5,1,97351,97351,97352,0,1,2
27835,6,2,97357,97357,97359,0,2,5
27836,3,3,97360,97360,97363,0,3,1
27837,2,3,97362,97363,97366,1,4,0
27838,3,1,97365,97366,97367,1,2,0
27839,4,1,97369,97369,97370,0,1,2
27840,4,2,97373,97373,97375,0,2,3
27841,2,2,97375,97375,97377,0,2,0
27842,3,2,97378,97378,97380,0,2,1
27843,4,2,97382,97382,97384,0,2,2
27844,5,1,97387,97387,97388,0,1,3
27845,2,3,97389,97389,97392,0,3,1
27846,1,3,97390,97392,97395,2,5,0
27847,5,3,97395,97395,97398,0,3,0
27848,2,2,97397,97398,97400,1,3,0
27849,3,2,97400,97400,97402,0,2,0
27850,2,1,97402,97402,97403,0,1,0
27851,5,2,97407,97407,97409,0,2,4
27852,4,1,97411,97411,97412,0,1,2
27853,4,3,97415,97415,97418,0,3,3
27854,2,2,97417,97418,97420,1,3,0
27855,6,2,97423,97423,97425,0,2,3
27856,4,3,97427,97427,97430,0,3,2
27857,1,2,97428,97430,97432,2,4,0
27858,4,1,97432,97432,97433,0,1,0
27859,1,1,97433,97433,97434,0,1,0
27860,4,2,97437,97437,97439,0,2,3
27861,6,3,97443,97443,97446,0,3,4
27862,5,3,97448,97448,97451,0,3,2
27863,2,3,97450,97451,97454,1,4,0
27864,1,1,97451,97454,97455,3,4,0
27865,3,2,97454,97455,97457,1,3,0
27866,3,2,97457,97457,97459,0,2,0
27867,2,1,97459,97459,97460,0,1,0
27868,6,2,97465,97465,97467,0,2,5
27869,6,1,97471,97471,97472,0,1,4
27870,1,2,97472,97472,97474,0,2,0
27871,6,1,97478,97478,97479,0,1,4
27872,5,3,97483,97483,97486,0,3,4
27873,5,1,97488,97488,97489,0,1,2
27874,4,1,97492,97492,97493,0,1,3
27875,3,3,97495,97495,97498,0,3,2
27876,2,1,97497,97498,97499,1,2,0
27877,3,1,97500,97500,97501,0,1,1
27878,5,3,97505,97505,97508,0,3,4
27879,1,1,97506,97508,97509,2,3,0
27880,1,2,97507,97509,97511,2,4,0
27881,1,1,97508,97511,97512,3,4,0
27882,3,3,97511,97512,97515,1,4,0
27883,5,2,97516,97516,97518,0,2,1
27884,2,1,97518,97518,97519,0,1,0
27885,1,1,97519,97519,97520,0,1,0
27886,6,3,97525,97525,97528,0,3,5
27887,4,1,97529,97529,97530,0,1,1
27888,1,1,97530,97530,97531,0,1,0
27889,4,2,97534,97534,97536,0,2,3
27890,5,1,97539,97539,97540,0,1,3
27891,5,1,97544,97544,97545,0,1,4
27892,6,3,97550,97550,97553,0,3,5
27893,5,3,97555,97555,97558,0,3,2
27894,2,1,97557,97558,97559,1,2,0
27895,3,3,97560,97560,97563,0,3,1
27896,5,2,97565,97565,97567,0,2,2
27897,6,3,97571,97571,97574,0,3,4
27898,2,2,97573,97574,97576,1,3,0
27899,6,3,97579,97579,97582,0,3,3
27900,1,2,97580,97582,97584,2,4,0
27901,4,2,97584,97584,97586,0,2,0
27902,6,3,97590,97590,97593,0,3,4
27903,6,3,97596,97596,97599,0,3,3
27904,1,3,97597,97599,97602,2,5,0
27905,5,3,97602,97602,97605,0,3,0
27906,6,2,97608,97608,97610,0,2,3
27907,1,3,97609,97610,97613,1,4,0
27908,1,1,97610,97613,97614,3,4,0
27909,4,1,97614,97614,97615,0,1,0
27910,5,1,97619,97619,97620,0,1,4
27911,1,2,97620,97620,97622,0,2,0
27912,3,2,97623,97623,97625,0,2,1
27913,3,3,97626,97626,97629,0,3,1
27914,1,1,97627,97629,97630,2,3,0
27915,5,3,97632,97632,97635,0,3,2
27916,6,2,97638,97638,97640,0,2,3
27917,4,2,97642,97642,97644,0,2,2
27918,6,2,97648,97648,97650,0,2,4
27919,4,2,97652,97652,97654,0,2,2
27920,4,2,97656,97656,97658,0,2,2
27921,1,3,97657,97658,97661,1,4,0
27922,6,3,97663,97663,97666,0,3,2
27923,1,3,97664,97666,97669,2,5,0
27924,4,3,97668,97669,97672,1,4,0
27925,5,1,97673,97673,97674,0,1,1
27926,3,2,97676,97676,97678,0,2,2
27927,2,2,97678,97678,97680,0,2,0
27928,1,2,97679,97680,97682,1,3,0
27929,5,2,97684,97684,97686,0,2,2
27930,1,1,97685,97686,97687,1,2,0
27931,1,3,97686,97687,97690,1,4,0
27932,4,1,97690,97690,97691,0,1,0
27933,5,2,97695,97695,97697,0,2,4
27934,6,3,97701,97701,97704,0,3,4
27935,5,1,97706,97706,97707,0,1,2
27936,1,3,97707,97707,97710,0,3,0
27937,4,3,97711,97711,97714,0,3,1
27938,2,3,97713,97714,97717,1,4,0
27939,4,2,97717,97717,97719,0,2,0
27940,6,1,97723,97723,97724,0,1,4
27941,3,1,97726,97726,97727,0,1,2
27942,3,3,97729,97729,97732,0,3,2
27943,2,1,97731,97732,97733,1,2,0
27944,6,2,97737,97737,97739,0,2,4
27945,5,3,97742,97742,97745,0,3,3
27946,4,1,97746,97746,97747,0,1,1
27947,3,3,97749,97749,97752,0,3,2
27948,3,2,97752,97752,97754,0,2,0
27949,4,2,97756,97756,97758,0,2,2
27950,1,1,97757,97758,97759,1,2,0
27951,6,1,97763,97763,97764,0,1,4
27952,3,1,97766,97766,97767,0,1,2
27953,3,2,97769,97769,97771,0,2,2
27954,6,3,97775,97775,97778,0,3,4
27955,4,2,97779,97779,97781,0,2,1
27956,4,2,97783,97783,97785,0,2,2
27957,6,3,97789,97789,97792,0,3,4
27958,4,2,97793,97793,97795,0,2,1
27959,6,2,97799,97799,97801,0,2,4
27960,1,1,97800,97801,97802,1,2,0
27961,1,2,97801,97802,97804,1,3,0
27962,6,3,97807,97807,97810,0,3,3
27963,1,3,97808,97810,97813,2,5,0
27964,5,1,97813,97813,97814,0,1,0
27965,6,2,97819,97819,97821,0,2,5
27966,2,3,97821,97821,97824,0,3,0
27967,3,1,97824,97824,97825,0,1,0
27968,3,1,97827,97827,97828,0,1,2
27969,6,1,97833,97833,97834,0,1,5
27970,5,1,97838,97838,97839,0,1,4
27971,4,3,97842,97842,97845,0,3,3
27972,6,3,97848,97848,97851,0,3,3
27973,2,2,97850,97851,97853,1,3,0
27974,3,3,97853,97853,97856,0,3,0
27975,3,3,97856,97856,97859,0,3,0
27976,3,1,97859,97859,97860,0,1,0
27977,5,2,97864,97864,97866,0,2,4
27978,4,1,97868,97868,97869,0,1,2
27979,5,3,97873,97873,97876,0,3,4
27980,4,3,97877,97877,97880,0,3,1
27981,6,3,97883,97883,97886,0,3,3
27982,4,1,97887,97887,97888,0,1,1
27983,2,1,97889,97889,97890,0,1,1
27984,6,2,97895,97895,97897,0,2,5
27985,2,1,97897,97897,97898,0,1,0
27986,5,3,97902,97902,97905,0,3,4
27987,4,2,97906,97906,97908,0,2,1
27988,2,2,97908,97908,97910,0,2,0
27989,1,3,97909,97910,97913,1,4,0
27990,2,3,97911,97913,97916,2,5,0
27991,3,3,97914,97916,97919,2,5,0
27992,3,3,97917,97919,97922,2,5,0
27993,5,1,97922,97922,97923,0,1,0
27994,2,1,97924,97924,97925,0,1,1
27995,4,3,97928,97928,97931,0,3,3
27996,3,3,97931,97931,97934,0,3,0
27997,5,3,97936,97936,97939,0,3,2
27998,2,1,97938,97939,97940,1,2,0
27999,5,3,97943,97943,97946,0,3,3
28000,5,2,97948,97948,97950,0,2,2
28001,2,1,97950,97950,97951,0,1,0
28002,5,3,97955,97955,97958,0,3,4
28003,5,3,97960,97960,97963,0,3,2
28004,6,2,97966,97966,97968,0,2,3
28005,5,3,97971,97971,97974,0,3,3
28006,3,2,97974,97974,97976,0,2,0
28007,4,1,97978,97978,97979,0,1,2
28008,1,2,97979,97979,97981,0,2,0
28009,2,1,97981,97981,97982,0,1,0
28010,2,2,97983,97983,97985,0,2,1
28011,5,3,97988,97988,97991,0,3,3
28012,6,1,97994,97994,97995,0,1,3
28013,4,2,97998,97998,98000,0,2,3
28014,3,2,98001,98001,98003,0,2,1
28015,6,1,98007,98007,98008,0,1,4
28016,1,2,98008,98008,98010,0,2,0
28017,1,3,98009,98010,98013,1,4,0
28018,5,3,98014,98014,98017,0,3,1
28019,1,3,98015,98017,98020,2,5,0
28020,5,3,98020,98020,98023,0,3,0
28021,3,1,98023,98023,98024,0,1,0
28022,2,3,98025,98025,98028,0,3,1
28023,5,3,98030,98030,98033,0,3,2
28024,5,1,98035,98035,98036,0,1,2
28025,3,1,98038,98038,98039,0,1,2
28026,1,2,98039,98039,98041,0,2,0
28027,2,2,98041,98041,98043,0,2,0
28028,3,1,98044,98044,98045,0,1,1
28029,2,1,98046,98046,98047,0,1,1
28030,6,3,98052,98052,98055,0,3,5
28031,2,3,98054,98055,98058,1,4,0
28032,5,1,98059,98059,98060,0,1,1
28033,1,1,98060,98060,98061,0,1,0
28034,3,1,98063,98063,98064,0,1,2
28035,3,3,98066,98066,98069,0,3,2
28036,2,3,98068,98069,98072,1,4,0
28037,3,3,98071,98072,98075,1,4,0
28038,6,2,98077,98077,98079,0,2,2
28039,2,3,98079,98079,98082,0,3,0
28040,2,3,98081,98082,98085,1,4,0
28041,1,1,98082,98085,98086,3,4,0
28042,3,1,98085,98086,98087,1,2,0
28043,1,1,98086,98087,98088,1,2,0
28044,4,1,98090,98090,98091,0,1,2
28045,4,2,98094,98094,98096,0,2,3
28046,6,1,98100,98100,98101,0,1,4
28047,1,3,98101,98101,98104,0,3,0
28048,4,2,98105,98105,98107,0,2,1
28049,4,3,98109,98109,98112,0,3,2
28050,4,1,98113,98113,98114,0,1,1
28051,3,3,98116,98116,98119,0,3,2
28052,4,1,98120,98120,98121,0,1,1
28053,1,3,98121,98121,98124,0,3,0
28054,6,2,98127,98127,98129,0,2,3
28055,5,1,98132,98132,98133,0,1,3
28056,5,3,98137,98137,98140,0,3,4
28057,5,1,98142,98142,98143,0,1,2
28058,5,3,98147,98147,98150,0,3,4
28059,1,2,98148,98150,98152,2,4,0
28060,3,3,98151,98152,98155,1,4,0
28061,3,2,98154,98155,98157,1,3,0
28062,3,3,98157,98157,98160,0,3,0
28063,5,2,98162,98162,98164,0,2,2
28064,4,1,98166,98166,98167,0,1,2
28065,4,1,98170,98170,98171,0,1,3
28066,3,1,98173,98173,98174,0,1,2
28067,1,3,98174,98174,98177,0,3,0
28068,6,3,98180,98180,98183,0,3,3
28069,1,1,98181,98183,98184,2,3,0
28070,3,2,98184,98184,98186,0,2,0
28071,1,2,98185,98186,98188,1,3,0
28072,2,1,98187,98188,98189,1,2,0
28073,2,3,98189,98189,98192,0,3,0
28074,2,3,98191,98192,98195,1,4,0
28075,2,2,98193,98195,98197,2,4,0
28076,6,1,98199,98199,98200,0,1,2
28077,4,1,98203,98203,98204,0,1,3
28078,6,3,98209,98209,98212,0,3,5
28079,3,2,98212,98212,98214,0,2,0
28080,1,1,98213,98214,98215,1,2,0
28081,3,2,98216,98216,98218,0,2,1
28082,6,3,98222,98222,98225,0,3,4
28083,6,2,98228,98228,98230,0,2,3
28084,6,2,98234,98234,98236,0,2,4
28085,5,3,98239,98239,98242,0,3,3
28086,4,1,98243,98243,98244,0,1,1
28087,4,1,98247,98247,98248,0,1,3
28088,5,1,98252,98252,98253,0,1,4
28089,3,1,98255,98255,98256,0,1,2
28090,5,2,98260,98260,98262,0,2,4
28091,2,1,98262,98262,98263,0,1,0
28092,4,2,98266,98266,98268,0,2,3
28093,1,3,98267,98268,98271,1,4,0
28094,3,3,98270,98271,98274,1,4,0
28095,6,1,98276,98276,98277,0,1,2
28096,2,1,98278,98278,98279,0,1,1
28097,3,3,98281,98281,98284,0,3,2
28098,2,2,98283,98284,98286,1,3,0
28099,3,2,98286,98286,98288,0,2,0
28100,6,3,98292,98292,98295,0,3,4
28101,6,1,98298,98298,98299,0,1,3
28102,3,1,98301,98301,98302,0,1,2
28103,5,1,98306,98306,98307,0,1,4
28104,6,2,98312,98312,98314,0,2,5
28105,5,2,98317,98317,98319,0,2,3
28106,6,2,98323,98323,98325,0,2,4
28107,1,2,98324,98325,98327,1,3,0
28108,4,2,98328,98328,98330,0,2,1
28109,6,1,98334,98334,98335,0,1,4
28110,1,1,98335,98335,98336,0,1,0
28111,4,1,98339,98339,98340,0,1,3
28112,4,3,98343,98343,98346,0,3,3
28113,4,2,98347,98347,98349,0,2,1
28114,1,2,98348,98349,98351,1,3,0
28115,3,3,98351,98351,98354,0,3,0
28116,1,3,98352,98354,98357,2,5,0
28117,4,2,98356,98357,98359,1,3,0
28118,6,3,98362,98362,98365,0,3,3
28119,2,3,98364,98365,98368,1,4,0
28120,6,3,98370,98370,98373,0,3,2
28121,3,2,98373,98373,98375,0,2,0
28122,4,1,98377,98377,98378,0,1,2
28123,1,1,98378,98378,98379,0,1,0
28124,1,1,98379,98379,98380,0,1,0
28125,1,2,98380,98380,98382,0,2,0
28126,2,3,98382,98382,98385,0,3,0
28127,4,1,98386,98386,98387,0,1,1
28128,1,1,98387,98387,98388,0,1,0
28129,3,3,98390,98390,98393,0,3,2
28130,4,2,98394,98394,98396,0,2,1
28131,6,3,98400,98400,98403,0,3,4
28132,4,2,98404,98404,98406,0,2,1
28133,1,1,98405,98406,98407,1,2,0
28134,4,1,98409,98409,98410,0,1,2
28135,1,3,98410,98410,98413,0,3,0
28136,2,1,98412,98413,98414,1,2,0
28137,5,3,98417,98417,98420,0,3,3
28138,6,3,98423,98423,98426,0,3,3
28139,2,1,98425,98426,98427,1,2,0
28140,6,1,98431,98431,98432,0,1,4
28141,6,3,98437,98437,98440,0,3,5
28142,6,1,98443,98443,98444,0,1,3
28143,3,2,98446,98446,98448,0,2,2
28144,6,1,98452,98452,98453,0,1,4
28145,6,3,98458,98458,98461,0,3,5
28146,5,2,98463,98463,98465,0,2,2
28147,6,1,98469,98469,98470,0,1,4
28148,4,3,98473,98473,98476,0,3,3
28149,4,2,98477,98477,98479,0,2,1
28150,2,3,98479,98479,98482,0,3,0
28151,4,1,98483,98483,98484,0,1,1
28152,2,1,98485,98485,98486,0,1,1
28153,5,2,98490,98490,98492,0,2,4
28154,4,3,98494,98494,98497,0,3,2
28155,6,2,98500,98500,98502,0,2,3
28156,6,1,98506,98506,98507,0,1,4
28157,1,1,98507,98507,98508,0,1,0
28158,2,2,98509,98509,98511,0,2,1
28159,5,1,98514,98514,98515,0,1,3
28160,1,1,98515,98515,98516,0,1,0
28161,3,2,98518,98518,98520,0,2,2
28162,1,2,98519,98520,98522,1,3,0
28163,3,1,98522,98522,98523,0,1,0
28164,6,2,98528,98528,98530,0,2,5
28165,6,3,98534,98534,98537,0,3,4
28166,6,2,98540,98540,98542,0,2,3
28167,2,2,98542,98542,98544,0,2,0
28168,6,1,98548,98548,98549,0,1,4
28169,5,3,98553,98553,98556,0,3,4
28170,6,3,98559,98559,98562,0,3,3
28171,4,3,98563,98563,98566,0,3,1
28172,3,2,98566,98566,98568,0,2,0
28173,6,3,98572,98572,98575,0,3,4
28174,1,3,98573,98575,98578,2,5,0
28175,6,2,98579,98579,98581,0,2,1
28176,2,1,98581,98581,98582,0,1,0
28177,4,3,98585,98585,98588,0,3,3
28178,4,2,98589,98589,98591,0,2,1
28179,2,3,98591,98591,98594,0,3,0
28180,6,2,98597,98597,98599,0,2,3
28181,4,2,98601,98601,98603,0,2,2
28182,3,1,98604,98604,98605,0,1,1
28183,1,1,98605,98605,98606,0,1,0
28184,1,3,98606,98606,98609,0,3,0
28185,2,1,98608,98609,98610,1,2,0
28186,5,1,98613,98613,98614,0,1,3
28187,5,2,98618,98618,98620,0,2,4
28188,2,1,98620,98620,98621,0,1,0
28189,2,3,98622,98622,98625,0,3,1
28190,4,2,98626,98626,98628,0,2,1
28191,2,1,98628,98628,98629,0,1,0
28192,6,3,98634,98634,98637,0,3,5
28193,5,2,98639,98639,98641,0,2,2
28194,5,1,98644,98644,98645,0,1,3
28195,5,3,98649,98649,98652,0,3,4
28196,6,2,98655,98655,98657,0,2,3
28197,3,2,98658,98658,98660,0,2,1
28198,1,1,98659,98660,98661,1,2,0
28199,2,1,98661,98661,98662,0,1,0
28200,5,2,98666,98666,98668,0,2,4
28201,5,1,98671,98671,98672,0,1,3
28202,2,2,98673,98673,98675,0,2,1
28203,5,2,98678,98678,98680,0,2,3
28204,5,3,98683,98683,98686,0,3,3
28205,5,3,98688,98688,98691,0,3,2
28206,4,1,98692,98692,98693,0,1,1
28207,6,1,98698,98698,98699,0,1,5
28208,6,2,98704,98704,98706,0,2,5
28209,5,1,98709,98709,98710,0,1,3
28210,3,2,98712,98712,98714,0,2,2
28211,6,2,98718,98718,98720,0,2,4
28212,1,3,98719,98720,98723,1,4,0
28213,6,2,98725,98725,98727,0,2,2
28214,2,2,98727,98727,98729,0,2,0
28215,6,3,98733,98733,98736,0,3,4
28216,1,1,98734,98736,98737,2,3,0
28217,4,2,98738,98738,98740,0,2,1
28218,6,1,98744,98744,98745,0,1,4
28219,1,3,98745,98745,98748,0,3,0
28220,4,3,98749,98749,98752,0,3,1
28221,6,1,98755,98755,98756,0,1,3
28222,6,1,98761,98761,98762,0,1,5
28223,2,1,98763,98763,98764,0,1,1
28224,5,3,98768,98768,98771,0,3,4
28225,6,3,98774,98774,98777,0,3,3
28226,1,3,98775,98777,98780,2,5,0
28227,6,1,98781,98781,98782,0,1,1
28228,5,2,98786,98786,98788,0,2,4
28229,5,1,98791,98791,98792,0,1,3
28230,6,1,98797,98797,98798,0,1,5
28231,6,2,98803,98803,98805,0,2,5
28232,2,3,98805,98805,98808,0,3,0
28233,2,2,98807,98808,98810,1,3,0
28234,1,1,98808,98810,98811,2,3,0
28235,4,2,98812,98812,98814,0,2,1
28236,5,2,98817,98817,98819,0,2,3
28237,5,3,98822,98822,98825,0,3,3
28238,3,1,98825,98825,98826,0,1,0
28239,4,1,98829,98829,98830,0,1,3
28240,2,2,98831,98831,98833,0,2,1
28241,3,2,98834,98834,98836,0,2,1
28242,5,3,98839,98839,98842,0,3,3
28243,3,3,98842,98842,98845,0,3,0
28244,2,2,98844,98845,98847,1,3,0
28245,1,1,98845,98847,98848,2,3,0
28246,2,1,98847,98848,98849,1,2,0
28247,4,1,98851,98851,98852,0,1,2
28248,6,3,98857,98857,98860,0,3,5
28249,2,3,98859,98860,98863,1,4,0
28250,2,1,98861,98863,98864,2,3,0
28251,1,1,98862,98864,98865,2,3,0
28252,4,3,98866,98866,98869,0,3,1
28253,5,3,98871,98871,98874,0,3,2
28254,3,1,98874,98874,98875,0,1,0
28255,6,1,98880,98880,98881,0,1,5
28256,3,1,98883,98883,98884,0,1,2
28257,4,3,98887,98887,98890,0,3,3
28258,1,2,98888,98890,98892,2,4,0
28259,1,1,98889,98892,98893,3,4,0
28260,3,1,98892,98893,98894,1,2,0
28261,4,1,98896,98896,98897,0,1,2
28262,1,2,98897,98897,98899,0,2,0
28263,2,3,98899,98899,98902,0,3,0
28264,2,1,98901,98902,98903,1,2,0
28265,5,1,98906,98906,98907,0,1,3
28266,2,2,98908,98908,98910,0,2,1
28267,1,3,98909,98910,98913,1,4,0
28268,4,2,98913,98913,98915,0,2,0
28269,5,3,98918,98918,98921,0,3,3
28270,3,1,98921,98921,98922,0,1,0
28271,4,2,98925,98925,98927,0,2,3
28272,6,3,98931,98931,98934,0,3,4
28273,3,2,98934,98934,98936,0,2,0
28274,2,2,98936,98936,98938,0,2,0
28275,1,2,98937,98938,98940,1,3,0
28276,2,3,98939,98940,98943,1,4,0
28277,2,3,98941,98943,98946,2,5,0
28278,3,1,98944,98946,98947,2,3,0
28279,2,3,98946,98947,98950,1,4,0
28280,6,1,98952,98952,98953,0,1,2
28281,2,3,98954,98954,98957,0,3,1
28282,4,3,98958,98958,98961,0,3,1
28283,4,1,98962,98962,98963,0,1,1
28284,4,2,98966,98966,98968,0,2,3
28285,1,2,98967,98968,98970,1,3,0
28286,6,2,98973,98973,98975,0,2,3
28287,2,2,98975,98975,98977,0,2,0
28288,6,3,98981,98981,98984,0,3,4
28289,2,3,98983,98984,98987,1,4,0
28290,4,1,98987,98987,98988,0,1,0
28291,1,1,98988,98988,98989,0,1,0
28292,3,3,98991,98991,98994,0,3,2
28293,5,3,98996,98996,98999,0,3,2
28294,6,2,99002,99002,99004,0,2,3
28295,2,3,99004,99004,99007,0,3,0
28296,1,3,99005,99007,99010,2,5,0
28297,2,1,99007,99010,99011,3,4,0
28298,3,1,99010,99011,99012,1,2,0
28299,6,3,99016,99016,99019,0,3,4
28300,1,3,99017,99019,99022,2,5,0
28301,6,1,99023,99023,99024,0,1,1
28302,5,2,99028,99028,99030,0,2,4
28303,2,1,99030,99030,99031,0,1,0
28304,4,3,99034,99034,99037,0,3,3
28305,6,3,99040,99040,99043,0,3,3
28306,4,2,99044,99044,99046,0,2,1
28307,4,3,99048,99048,99051,0,3,2
28308,4,2,99052,99052,99054,0,2,1
28309,1,1,99053,99054,99055,1,2,0
28310,5,2,99058,99058,99060,0,2,3
28311,3,3,99061,99061,99064,0,3,1
28312,4,2,99065,99065,99067,0,2,1
28313,5,2,99070,99070,99072,0,2,3
28314,6,3,99076,99076,99079,0,3,4
28315,3,3,99079,99079,99082,0,3,0
28316,2,1,99081,99082,99083,1,2,0
28317,6,2,99087,99087,99089,0,2,4
28318,1,1,99088,99089,99090,1,2,0
28319,6,1,99094,99094,99095,0,1,4
28320,1,1,99095,99095,99096,0,1,0
28321,6,2,99101,99101,99103,0,2,5
28322,1,1,99102,99103,99104,1,2,0
28323,1,1,99103,99104,99105,1,2,0
28324,6,3,99109,99109,99112,0,3,4
28325,4,2,99113,99113,99115,0,2,1
28326,3,1,99116,99116,99117,0,1,1
28327,6,3,99122,99122,99125,0,3,5
28328,2,1,99124,99125,99126,1,2,0
28329,1,1,99125,99126,99127,1,2,0
28330,2,2,99127,99127,99129,0,2,0
28331,6,2,99133,99133,99135,0,2,4
28332,6,3,99139,99139,99142,0,3,4
28333,5,1,99144,99144,99145,0,1,2
28334,2,2,99146,99146,99148,0,2,1
28335,3,2,99149,99149,99151,0,2,1
28336,1,1,99150,99151,99152,1,2,0
28337,1,1,99151,99152,99153,1,2,0
28338,3,3,99154,99154,99157,0,3,1
28339,3,1,99157,99157,99158,0,1,0
28340,5,2,99162,99162,99164,0,2,4
28341,3,1,99165,99165,99166,0,1,1
28342,5,2,99170,99170,99172,0,2,4
28343,5,3,99175,99175,99178,0,3,3
28344,2,2,99177,99178,99180,1,3,0
28345,6,2,99183,99183,99185,0,2,3
28346,5,3,99188,99188,99191,0,3,3
28347,5,2,99193,99193,99195,0,2,2
28348,6,1,99199,99199,99200,0,1,4
28349,5,1,99204,99204,99205,0,1,4
28350,2,2,99206,99206,99208,0,2,1
28351,1,2,99207,99208,99210,1,3,0
28352,3,2,99210,99210,99212,0,2,0
28353,2,1,99212,99212,99213,0,1,0
28354,4,2,99216,99216,99218,0,2,3
28355,5,3,99221,99221,99224,0,3,3
28356,1,1,99222,99224,99225,2,3,0
28357,1,1,99223,99225,99226,2,3,0
28358,5,3,99228,99228,99231,0,3,2
28359,5,1,99233,99233,99234,0,1,2
28360,5,1,99238,99238,99239,0,1,4
28361,6,1,99244,99244,99245,0,1,5
28362,5,2,99249,99249,99251,0,2,4
28363,5,2,99254,99254,99256,0,2,3
28364,4,3,99258,99258,99261,0,3,2
28365,4,3,99262,99262,99265,0,3,1
28366,2,2,99264,99265,99267,1,3,0
28367,5,1,99269,99269,99270,0,1,2
28368,3,3,99272,99272,99275,0,3,2
28369,6,3,99278,99278,99281,0,3,3
28370,5,2,99283,99283,99285,0,2,2
28371,6,2,99289,99289,99291,0,2,4
28372,4,1,99293,99293,99294,0,1,2
28373,2,2,99295,99295,99297,0,2,1
28374,5,3,99300,99300,99303,0,3,3
28375,1,3,99301,99303,99306,2,5,0
28376,6,3,99307,99307,99310,0,3,1
28377,3,3,99310,99310,99313,0,3,0
28378,5,1,99315,99315,99316,0,1,2
28379,3,2,99318,99318,99320,0,2,2
28380,4,3,99322,99322,99325,0,3,2
28381,6,1,99328,99328,99329,0,1,3
28382,3,2,99331,99331,99333,0,2,2
28383,1,2,99332,99333,99335,1,3,0
28384,4,3,99336,99336,99339,0,3,1
28385,5,2,99341,99341,99343,0,2,2
28386,4,3,99345,99345,99348,0,3,2
28387,2,1,99347,99348,99349,1,2,0
28388,2,3,99349,99349,99352,0,3,0
28389,5,3,99354,99354,99357,0,3,2
28390,1,3,99355,99357,99360,2,5,0
28391,5,2,99360,99360,99362,0,2,0
28392,2,3,99362,99362,99365,0,3,0
28393,3,1,99365,99365,99366,0,1,0
28394,6,1,99371,99371,99372,0,1,5
28395,1,3,99372,99372,99375,0,3,0
28396,3,2,99375,99375,99377,0,2,0
28397,5,2,99380,99380,99382,0,2,3
28398,3,3,99383,99383,99386,0,3,1
28399,3,1,99386,99386,99387,0,1,0
28400,3,1,99389,99389,99390,0,1,2
28401,5,2,99394,99394,99396,0,2,4
28402,1,2,99395,99396,99398,1,3,0
28403,2,1,99397,99398,99399,1,2,0
28404,3,1,99400,99400,99401,0,1,1
28405,3,3,99403,99403,99406,0,3,2
28406,1,1,99404,99406,99407,2,3,0
28407,3,1,99407,99407,99408,0,1,0
28408,2,2,99409,99409,99411,0,2,1
28409,1,3,99410,99411,99414,1,4,0
28410,1,3,99411,99414,99417,3,6,0
28411,3,1,99414,99417,99418,3,4,0
28412,5,3,99419,99419,99422,0,3,1
28413,6,3,99425,99425,99428,0,3,3
28414,2,3,99427,99428,99431,1,4,0
28415,6,3,99433,99433,99436,0,3,2
28416,3,3,99436,99436,99439,0,3,0
28417,6,2,99442,99442,99444,0,2,3
28418,5,3,99447,99447,99450,0,3,3
28419,6,1,99453,99453,99454,0,1,3
28420,1,3,99454,99454,99457,0,3,0
28421,4,3,99458,99458,99461,0,3,1
28422,6,1,99464,99464,99465,0,1,3
28423,4,3,99468,99468,99471,0,3,3
28424,1,3,99469,99471,99474,2,5,0
28425,6,3,99475,99475,99478,0,3,1
28426,3,3,99478,99478,99481,0,3,0
28427,2,3,99480,99481,99484,1,4,0
28428,2,3,99482,99484,99487,2,5,0
28429,5,3,99487,99487,99490,0,3,0
28430,6,2,99493,99493,99495,0,2,3
28431,3,3,99496,99496,99499,0,3,1
28432,3,2,99499,99499,99501,0,2,0
28433,3,3,99502,99502,99505,0,3,1
28434,1,3,99503,99505,99508,2,5,0
28435,4,2,99507,99508,99510,1,3,0
28436,6,2,99513,99513,99515,0,2,3
28437,3,2,99516,99516,99518,0,2,1
28438,6,3,99522,99522,99525,0,3,4
28439,1,2,99523,99525,99527,2,4,0
28440,2,2,99525,99527,99529,2,4,0
28441,1,1,99526,99529,99530,3,4,0
28442,3,3,99529,99530,99533,1,4,0
28443,6,1,99535,99535,99536,0,1,2
28444,2,1,99537,99537,99538,0,1,1
28445,5,2,99542,99542,99544,0,2,4
28446,6,3,99548,99548,99551,0,3,4
28447,2,2,99550,99551,99553,1,3,0
28448,1,1,99551,99553,99554,2,3,0
28449,2,2,99553,99554,99556,1,3,0
28450,5,1,99558,99558,99559,0,1,2
28451,5,3,99563,99563,99566,0,3,4
28452,5,1,99568,99568,99569,0,1,2
28453,6,2,99574,99574,99576,0,2,5
28454,6,3,99580,99580,99583,0,3,4
28455,3,1,99583,99583,99584,0,1,0
28456,4,3,99587,99587,99590,0,3,3
28457,5,2,99592,99592,99594,0,2,2
28458,4,3,99596,99596,99599,0,3,2
28459,3,3,99599,99599,99602,0,3,0
28460,3,1,99602,99602,99603,0,1,0
28461,5,2,99607,99607,99609,0,2,4
28462,4,2,99611,99611,99613,0,2,2
28463,2,1,99613,99613,99614,0,1,0
28464,5,3,99618,99618,99621,0,3,4
28465,4,1,99622,99622,99623,0,1,1
28466,2,1,99624,99624,99625,0,1,1
28467,2,3,99626,99626,99629,0,3,1
28468,3,1,99629,99629,99630,0,1,0
28469,4,3,99633,99633,99636,0,3,3
28470,5,3,99638,99638,99641,0,3,2
28471,6,2,99644,99644,99646,0,2,3
28472,1,1,99645,99646,99647,1,2,0
28473,6,3,99651,99651,99654,0,3,4
28474,3,1,99654,99654,99655,0,1,0
28475,6,1,99660,99660,99661,0,1,5
28476,5,3,99665,99665,99668,0,3,4
28477,5,1,99670,99670,99671,0,1,2
28478,5,2,99675,99675,99677,0,2,4
28479,5,2,99680,99680,99682,0,2,3
28480,3,2,99683,99683,99685,0,2,1
28481,2,3,99685,99685,99688,0,3,0
28482,1,1,99686,99688,99689,2,3,0
28483,2,2,99688,99689,99691,1,3,0
28484,4,1,99692,99692,99693,0,1,1
28485,2,1,99694,99694,99695,0,1,1
28486,1,2,99695,99695,99697,0,2,0
28487,6,2,99701,99701,99703,0,2,4
28488,6,2,99707,99707,99709,0,2,4
28489,2,1,99709,99709,99710,0,1,0
28490,2,1,99711,99711,99712,0,1,1
28491,6,3,99717,99717,99720,0,3,5
28492,5,2,99722,99722,99724,0,2,2
28493,2,2,99724,99724,99726,0,2,0
28494,6,2,99730,99730,99732,0,2,4
28495,2,3,99732,99732,99735,0,3,0
28496,6,3,99738,99738,99741,0,3,3
28497,6,1,99744,99744,99745,0,1,3
28498,5,1,99749,99749,99750,0,1,4
28499,6,1,99755,99755,99756,0,1,5
28500,6,1,99761,99761,99762,0,1,5
28501,1,1,99762,99762,99763,0,1,0
28502,3,3,99765,99765,99768,0,3,2
28503,3,3,99768,99768,99771,0,3,0
28504,3,1,99771,99771,99772,0,1,0
28505,1,2,99772,99772,99774,0,2,0
28506,1,1,99773,99774,99775,1,2,0
28507,5,1,99778,99778,99779,0,1,3
28508,6,1,99784,99784,99785,0,1,5
28509,3,2,99787,99787,99789,0,2,2
28510,4,1,99791,99791,99792,0,1,2
28511,6,3,99797,99797,99800,0,3,5
28512,4,3,99801,99801,99804,0,3,1
28513,5,2,99806,99806,99808,0,2,2
28514,4,2,99810,99810,99812,0,2,2
28515,3,2,99813,99813,99815,0,2,1
28516,4,3,99817,99817,99820,0,3,2
28517,6,1,99823,99823,99824,0,1,3
28518,6,2,99829,99829,99831,0,2,5
28519,3,3,99832,99832,99835,0,3,1
28520,3,1,99835,99835,99836,0,1,0
28521,5,1,99840,99840,99841,0,1,4
28522,3,3,99843,99843,99846,0,3,2
28523,1,3,99844,99846,99849,2,5,0
28524,5,1,99849,99849,99850,0,1,0
28525,2,2,99851,99851,99853,0,2,1
28526,2,2,99853,99853,99855,0,2,0
28527,4,2,99857,99857,99859,0,2,2
28528,5,1,99862,99862,99863,0,1,3
28529,5,2,99867,99867,99869,0,2,4
28530,1,1,99868,99869,99870,1,2,0
28531,3,1,99871,99871,99872,0,1,1
28532,5,1,99876,99876,99877,0,1,4
28533,4,1,99880,99880,99881,0,1,3
28534,4,1,99884,99884,99885,0,1,3
28535,2,3,99886,99886,99889,0,3,1
28536,5,1,99891,99891,99892,0,1,2
28537,3,1,99894,99894,99895,0,1,2
28538,2,3,99896,99896,99899,0,3,1
28539,5,1,99901,99901,99902,0,1,2
28540,6,1,99907,99907,99908,0,1,5
28541,2,3,99909,99909,99912,0,3,1
28542,1,3,99910,99912,99915,2,5,0
28543,4,3,99914,99915,99918,1,4,0
28544,1,3,99915,99918,99921,3,6,0
28545,3,3,99918,99921,99924,3,6,0
28546,3,2,99921,99924,99926,3,5,0
28547,1,1,99922,99926,99927,4,5,0
28548,4,1,99926,99927,99928,1,2,0
28549,1,3,99927,99928,99931,1,4,0
28550,6,3,99933,99933,99936,0,3,2
28551,6,2,99939,99939,99941,0,2,3
28552,5,1,99944,99944,99945,0,1,3
28553,3,3,99947,99947,99950,0,3,2
28554,4,1,99951,99951,99952,0,1,1
28555,1,2,99952,99952,99954,0,2,0
28556,3,1,99955,99955,99956,0,1,1
28557,6,1,99961,99961,99962,0,1,5
28558,5,2,99966,99966,99968,0,2,4
28559,3,3,99969,99969,99972,0,3,1
28560,4,2,99973,99973,99975,0,2,1
28561,3,1,99976,99976,99977,0,1,1
28562,3,3,99979,99979,99982,0,3,2
28563,1,2,99980,99982,99984,2,4,0
28564,5,1,99985,99985,99986,0,1,1
28565,4,1,99989,99989,99990,0,1,3
28566,3,3,99992,99992,99995,0,3,2
28567,3,3,99995,99995,99998,0,3,0
28568,6,3,100001,100001,100004,0,3,3
28569,5,1,100006,100006,100007,0,1,2
28570,5,2,100011,100011,100013,0,2,4
28571,4,1,100015,100015,100016,0,1,2
28572,3,1,100018,100018,100019,0,1,2
28573,6,2,100024,100024,100026,0,2,5
28574,5,2,100029,100029,100031,0,2,3
28575,1,2,100030,100031,100033,1,3,0
28576,2,3,100032,100033,100036,1,4,0
28577,6,2,100038,100038,100040,0,2,2
28578,3,3,100041,100041,100044,0,3,1
28579,5,2,100046,100046,100048,0,2,2
28580,3,3,100049,100049,100052,0,3,1
28581,2,2,100051,100052,100054,1,3,0
28582,2,2,100053,100054,100056,1,3,0
28583,3,1,100056,100056,100057,0,1,0
28584,6,2,100062,100062,100064,0,2,5
28585,4,3,100066,100066,100069,0,3,2
28586,4,1,100070,100070,100071,0,1,1
28587,1,1,100071,100071,100072,0,1,0
28588,4,3,100075,100075,100078,0,3,3
28589,1,1,100076,100078,100079,2,3,0
28590,1,1,100077,100079,100080,2,3,0
28591,1,3,100078,100080,100083,2,5,0
28592,1,1,100079,100083,100084,4,5,0
28593,5,1,100084,100084,100085,0,1,0
28594,5,2,100089,100089,100091,0,2,4
28595,4,3,100093,100093,100096,0,3,2
28596,1,1,100094,100096,100097,2,3,0
28597,2,2,100096,100097,100099,1,3,0
28598,5,3,100101,100101,100104,0,3,2
28599,5,3,100106,100106,100109,0,3,2
28600,5,2,100111,100111,100113,0,2,2
28601,5,3,100116,100116,100119,0,3,3
28602,1,1,100117,100119,100120,2,3,0
28603,4,3,100121,100121,100124,0,3,1
28604,1,2,100122,100124,100126,2,4,0
28605,3,1,100125,100126,100127,1,2,0
28606,3,3,100128,100128,100131,0,3,1
28607,3,3,100131,100131,100134,0,3,0
28608,5,3,100136,100136,100139,0,3,2
28609,3,3,100139,100139,100142,0,3,0
28610,5,3,100144,100144,100147,0,3,2
28611,4,2,100148,100148,100150,0,2,1
28612,3,2,100151,100151,100153,0,2,1
28613,3,2,100154,100154,100156,0,2,1
28614,2,1,100156,100156,100157,0,1,0
28615,1,2,100157,100157,100159,0,2,0
28616,1,1,100158,100159,100160,1,2,0
28617,3,1,100161,100161,100162,0,1,1
28618,6,1,100167,100167,100168,0,1,5
28619,3,1,100170,100170,100171,0,1,2
28620,1,3,100171,100171,100174,0,3,0
28621,1,3,100172,100174,100177,2,5,0
28622,1,2,100173,100177,100179,4,6,0
28623,5,1,100178,100179,100180,1,2,0
28624,2,2,100180,100180,100182,0,2,0
28625,6,2,100186,100186,100188,0,2,4
28626,3,1,100189,100189,100190,0,1,1
28627,1,2,100190,100190,100192,0,2,0
28628,2,1,100192,100192,100193,0,1,0
28629,4,1,100196,100196,100197,0,1,3
28630,2,2,100198,100198,100200,0,2,1
28631,1,3,100199,100200,100203,1,4,0
28632,3,3,100202,100203,100206,1,4,0
28633,2,2,100204,100206,100208,2,4,0
28634,4,3,100208,100208,100211,0,3,0
28635,3,2,100211,100211,100213,0,2,0
28636,3,3,100214,100214,100217,0,3,1
28637,1,2,100215,100217,100219,2,4,0
28638,3,3,100218,100219,100222,1,4,0
28639,2,2,100220,100222,100224,2,4,0
28640,4,2,100224,100224,100226,0,2,0
28641,3,1,100227,100227,100228,0,1,1
28642,6,3,100233,100233,100236,0,3,5
28643,1,2,100234,100236,100238,2,4,0
28644,2,3,100236,100238,100241,2,5,0
28645,5,2,100241,100241,100243,0,2,0
28646,2,2,100243,100243,100245,0,2,0
28647,2,1,100245,100245,100246,0,1,0
28648,1,3,100246,100246,100249,0,3,0
28649,6,3,100252,100252,100255,0,3,3
28650,2,1,100254,100255,100256,1,2,0
28651,4,2,100258,100258,100260,0,2,2
28652,4,3,100262,100262,100265,0,3,2
28653,6,3,100268,100268,100271,0,3,3
28654,4,3,100272,100272,100275,0,3,1
28655,2,1,100274,100275,100276,1,2,0
28656,1,3,100275,100276,100279,1,4,0
28657,1,3,100276,100279,100282,3,6,0
28658,1,3,100277,100282,100285,5,8,0
28659,2,3,100279,100285,100288,6,9,0
28660,1,2,100280,100288,100290,8,10,0
28661,4,2,100284,100290,100292,6,8,0
28662,1,1,100285,100292,100293,7,8,0
28663,4,2,100289,100293,100295,4,6,0
28664,5,2,100294,100295,100297,1,3,0
28665,5,2,100299,100299,100301,0,2,2
28666,6,1,100305,100305,100306,0,1,4
28667,4,3,100309,100309,100312,0,3,3
28668,3,2,100312,100312,100314,0,2,0
28669,2,2,100314,100314,100316,0,2,0
28670,3,2,100317,100317,100319,0,2,1
28671,4,2,100321,100321,100323,0,2,2
28672,4,1,100325,100325,100326,0,1,2
28673,4,3,100329,100329,100332,0,3,3
28674,3,1,100332,100332,100333,0,1,0
28675,4,3,100336,100336,100339,0,3,3
28676,5,3,100341,100341,100344,0,3,2
28677,1,2,100342,100344,100346,2,4,0
28678,4,2,100346,100346,100348,0,2,0
28679,2,2,100348,100348,100350,0,2,0
28680,6,2,100354,100354,100356,0,2,4
28681,1,2,100355,100356,100358,1,3,0
28682,4,3,100359,100359,100362,0,3,1
28683,3,2,100362,100362,100364,0,2,0
28684,1,1,100363,100364,100365,1,2,0
28685,6,1,100369,100369,100370,0,1,4
28686,4,3,100373,100373,100376,0,3,3
28687,6,3,100379,100379,100382,0,3,3
28688,2,3,100381,100382,100385,1,4,0
28689,4,1,100385,100385,100386,0,1,0
28690,3,2,100388,100388,100390,0,2,2
28691,1,2,100389,100390,100392,1,3,0
28692,3,3,100392,100392,100395,0,3,0
28693,6,2,100398,100398,100400,0,2,3
28694,2,1,100400,100400,100401,0,1,0
28695,6,2,100406,100406,100408,0,2,5
28696,3,3,100409,100409,100412,0,3,1
28697,6,1,100415,100415,100416,0,1,3
28698,6,1,100421,100421,100422,0,1,5
28699,4,1,100425,100425,100426,0,1,3
28700,3,2,100428,100428,100430,0,2,2
28701,1,2,100429,100430,100432,1,3,0
28702,2,3,100431,100432,100435,1,4,0
28703,3,3,100434,100435,100438,1,4,0
28704,4,3,100438,100438,100441,0,3,0
28705,1,1,100439,100441,100442,2,3,0
28706,5,2,100444,100444,100446,0,2,2
28707,5,1,100449,100449,100450,0,1,3
28708,2,2,100451,100451,100453,0,2,1
28709,3,2,100454,100454,100456,0,2,1
28710,6,3,100460,100460,100463,0,3,4
28711,6,1,100466,100466,100467,0,1,3
28712,1,2,100467,100467,100469,0,2,0
28713,5,2,100472,100472,100474,0,2,3
28714,2,2,100474,100474,100476,0,2,0
28715,4,3,100478,100478,100481,0,3,2
28716,3,2,100481,100481,100483,0,2,0
28717,3,1,100484,100484,100485,0,1,1
28718,2,1,100486,100486,100487,0,1,1
28719,4,2,100490,100490,100492,0,2,3
28720,3,2,100493,100493,100495,0,2,1
28721,3,2,100496,100496,100498,0,2,1
28722,2,2,100498,100498,100500,0,2,0
28723,4,2,100502,100502,100504,0,2,2
28724,2,1,100504,100504,100505,0,1,0
28725,5,2,100509,100509,100511,0,2,4
28726,4,3,100513,100513,100516,0,3,2
28727,6,3,100519,100519,100522,0,3,3
28728,4,3,100523,100523,100526,0,3,1
28729,6,1,100529,100529,100530,0,1,3
28730,4,1,100533,100533,100534,0,1,3
28731,3,2,100536,100536,100538,0,2,2
28732,6,2,100542,100542,100544,0,2,4
28733,4,3,100546,100546,100549,0,3,2
28734,6,2,100552,100552,100554,0,2,3
28735,1,3,100553,100554,100557,1,4,0
28736,5,1,100558,100558,100559,0,1,1
28737,2,3,100560,100560,100563,0,3,1
28738,1,2,100561,100563,100565,2,4,0
28739,5,1,100566,100566,100567,0,1,1
28740,1,2,100567,100567,100569,0,2,0
28741,4,1,100571,100571,100572,0,1,2
28742,5,2,100576,100576,100578,0,2,4
28743,3,2,100579,100579,100581,0,2,1
28744,1,2,100580,100581,100583,1,3,0
28745,4,2,100584,100584,100586,0,2,1
28746,1,2,100585,100586,100588,1,3,0
28747,2,1,100587,100588,100589,1,2,0
28748,6,1,100593,100593,100594,0,1,4
28749,2,2,100595,100595,100597,0,2,1
28750,2,1,100597,100597,100598,0,1,0
28751,4,2,100601,100601,100603,0,2,3
28752,1,3,100602,100603,100606,1,4,0
28753,1,3,100603,100606,100609,3,6,0
28754,4,1,100607,100609,100610,2,3,0
28755,2,3,100609,100610,100613,1,4,0
28756,5,3,100614,100614,100617,0,3,1
28757,4,2,100618,100618,100620,0,2,1
28758,5,2,100623,100623,100625,0,2,3
28759,2,1,100625,100625,100626,0,1,0
28760,4,1,100629,100629,100630,0,1,3
28761,6,3,100635,100635,100638,0,3,5
28762,2,1,100637,100638,100639,1,2,0
28763,2,3,100639,100639,100642,0,3,0
28764,4,2,100643,100643,100645,0,2,1
28765,5,2,100648,100648,100650,0,2,3
28766,4,3,100652,100652,100655,0,3,2
28767,1,1,100653,100655,100656,2,3,0
28768,6,1,100659,100659,100660,0,1,3
28769,4,1,100663,100663,100664,0,1,3
28770,2,3,100665,100665,100668,0,3,1
28771,2,1,100667,100668,100669,1,2,0
28772,5,1,100672,100672,100673,0,1,3
28773,3,3,100675,100675,100678,0,3,2
28774,2,3,100677,100678,100681,1,4,0
28775,6,2,100683,100683,100685,0,2,2
28776,1,2,100684,100685,100687,1,3,0
28777,1,2,100685,100687,100689,2,4,0
28778,5,1,100690,100690,100691,0,1,1
28779,6,2,100696,100696,100698,0,2,5
28780,1,1,100697,100698,100699,1,2,0
28781,4,3,100701,100701,100704,0,3,2
28782,5,1,100706,100706,100707,0,1,2
28783,1,2,100707,100707,100709,0,2,0
28784,3,1,100710,100710,100711,0,1,1
28785,5,2,100715,100715,100717,0,2,4
28786,5,3,100720,100720,100723,0,3,3
28787,4,2,100724,100724,100726,0,2,1
28788,2,2,100726,100726,100728,0,2,0
28789,4,2,100730,100730,100732,0,2,2
28790,6,1,100736,100736,100737,0,1,4
28791,2,1,100738,100738,100739,0,1,1
28792,3,1,100741,100741,100742,0,1,2
28793,1,3,100742,100742,100745,0,3,0
28794,4,2,100746,100746,100748,0,2,1
28795,4,2,100750,100750,100752,0,2,2
28796,2,1,100752,100752,100753,0,1,0
28797,1,1,100753,100753,100754,0,1,0
28798,5,2,100758,100758,100760,0,2,4
28799,6,3,100764,100764,100767,0,3,4
28800,2,3,100766,100767,100770,1,4,0
28801,2,2,100768,100770,100772,2,4,0
28802,4,1,100772,100772,100773,0,1,0
28803,1,2,100773,100773,100775,0,2,0
28804,5,3,100778,100778,100781,0,3,3
28805,5,2,100783,100783,100785,0,2,2
28806,1,3,100784,100785,100788,1,4,0
28807,4,2,100788,100788,100790,0,2,0
28808,2,1,100790,100790,100791,0,1,0
28809,2,2,100792,100792,100794,0,2,1
28810,3,2,100795,100795,100797,0,2,1
28811,5,3,100800,100800,100803,0,3,3
28812,3,2,100803,100803,100805,0,2,0
28813,5,2,100808,100808,100810,0,2,3
28814,1,3,100809,100810,100813,1,4,0
28815,2,1,100811,100813,100814,2,3,0
28816,5,2,100816,100816,100818,0,2,2
28817,3,2,100819,100819,100821,0,2,1
28818,3,2,100822,100822,100824,0,2,1
28819,5,3,100827,100827,100830,0,3,3
28820,3,1,100830,100830,100831,0,1,0
28821,1,1,100831,100831,100832,0,1,0
28822,6,2,100837,100837,100839,0,2,5
28823,2,3,100839,100839,100842,0,3,0
28824,3,3,100842,100842,100845,0,3,0
28825,4,1,100846,100846,100847,0,1,1
28826,1,2,100847,100847,100849,0,2,0
28827,4,1,100851,100851,100852,0,1,2
28828,1,1,100852,100852,100853,0,1,0
28829,6,3,100858,100858,100861,0,3,5
28830,5,3,100863,100863,100866,0,3,2
28831,1,3,100864,100866,100869,2,5,0
28832,6,2,100870,100870,100872,0,2,1
28833,6,3,100876,100876,100879,0,3,4
28834,1,2,100877,100879,100881,2,4,0
28835,1,3,100878,100881,100884,3,6,0
28836,5,1,100883,100884,100885,1,2,0
28837,4,2,100887,100887,100889,0,2,2
28838,6,1,100893,100893,100894,0,1,4
28839,1,2,100894,100894,100896,0,2,0
28840,6,2,100900,100900,100902,0,2,4
28841,4,3,100904,100904,100907,0,3,2
28842,1,3,100905,100907,100910,2,5,0
28843,6,1,100911,100911,100912,0,1,1
28844,2,2,100913,100913,100915,0,2,1
28845,4,3,100917,100917,100920,0,3,2
28846,6,3,100923,100923,100926,0,3,3
28847,6,1,100929,100929,100930,0,1,3
28848,1,3,100930,100930,100933,0,3,0
28849,3,3,100933,100933,100936,0,3,0
28850,2,1,100935,100936,100937,1,2,0
28851,5,2,100940,100940,100942,0,2,3
28852,3,1,100943,100943,100944,0,1,1
28853,1,3,100944,100944,100947,0,3,0
28854,1,1,100945,100947,100948,2,3,0
28855,2,3,100947,100948,100951,1,4,0
28856,1,2,100948,100951,100953,3,5,0
28857,3,2,100951,100953,100955,2,4,0
28858,4,3,100955,100955,100958,0,3,0
28859,1,2,100956,100958,100960,2,4,0
28860,4,1,100960,100960,100961,0,1,0
28861,3,1,100963,100963,100964,0,1,2
28862,3,1,100966,100966,100967,0,1,2
28863,6,1,100972,100972,100973,0,1,5
28864,5,1,100977,100977,100978,0,1,4
28865,4,1,100981,100981,100982,0,1,3
28866,5,1,100986,100986,100987,0,1,4
28867,2,1,100988,100988,100989,0,1,1
28868,2,1,100990,100990,100991,0,1,1
28869,5,2,100995,100995,100997,0,2,4
28870,2,2,100997,100997,100999,0,2,0
28871,2,2,100999,100999,101001,0,2,0
28872,5,1,101004,101004,101005,0,1,3
28873,2,1,101006,101006,101007,0,1,1
28874,1,2,101007,101007,101009,0,2,0
28875,5,1,101012,101012,101013,0,1,3
28876,3,1,101015,101015,101016,0,1,2
28877,3,1,101018,101018,101019,0,1,2
28878,1,1,101019,101019,101020,0,1,0
28879,5,3,101024,101024,101027,0,3,4
28880,4,2,101028,101028,101030,0,2,1
28881,3,2,101031,101031,101033,0,2,1
28882,4,2,101035,101035,101037,0,2,2
28883,5,3,101040,101040,101043,0,3,3
28884,6,1,101046,101046,101047,0,1,3
28885,4,3,101050,101050,101053,0,3,3
28886,2,3,101052,101053,101056,1,4,0
28887,5,3,101057,101057,101060,0,3,1
28888,6,3,101063,101063,101066,0,3,3
28889,2,1,101065,101066,101067,1,2,0
28890,5,2,101070,101070,101072,0,2,3
28891,3,1,101073,101073,101074,0,1,1
28892,2,2,101075,101075,101077,0,2,1
28893,2,2,101077,101077,101079,0,2,0
28894,3,2,101080,101080,101082,0,2,1
28895,3,1,101083,101083,101084,0,1,1
28896,4,3,101087,101087,101090,0,3,3
28897,2,3,101089,101090,101093,1,4,0
28898,4,1,101093,101093,101094,0,1,0
28899,5,2,101098,101098,101100,0,2,4
28900,3,3,101101,101101,101104,0,3,1
28901,4,1,101105,101105,101106,0,1,1
28902,1,1,101106,101106,101107,0,1,0
28903,1,2,101107,101107,101109,0,2,0
28904,5,1,101112,101112,101113,0,1,3
28905,3,2,101115,101115,101117,0,2,2
28906,2,2,101117,101117,101119,0,2,0
28907,3,2,101120,101120,101122,0,2,1
28908,3,3,101123,101123,101126,0,3,1
28909,4,2,101127,101127,101129,0,2,1
28910,3,2,101130,101130,101132,0,2,1
28911,1,1,101131,101132,101133,1,2,0
28912,4,1,101135,101135,101136,0,1,2
28913,1,2,101136,101136,101138,0,2,0
28914,3,1,101139,101139,101140,0,1,1
28915,5,3,101144,101144,101147,0,3,4
28916,6,1,101150,101150,101151,0,1,3
28917,3,2,101153,101153,101155,0,2,2
28918,6,2,101159,101159,101161,0,2,4
28919,5,1,101164,101164,101165,0,1,3
28920,5,2,101169,101169,101171,0,2,4
28921,2,1,101171,101171,101172,0,1,0
28922,6,3,101177,101177,101180,0,3,5
28923,6,1,101183,101183,101184,0,1,3
28924,6,2,101189,101189,101191,0,2,5
28925,2,3,101191,101191,101194,0,3,0
28926,2,2,101193,101194,101196,1,3,0
28927,6,1,101199,101199,101200,0,1,3
28928,6,1,101205,101205,101206,0,1,5
28929,6,3,101211,101211,101214,0,3,5
28930,5,3,101216,101216,101219,0,3,2
28931,1,1,101217,101219,101220,2,3,0
28932,5,2,101222,101222,101224,0,2,2
28933,5,3,101227,101227,101230,0,3,3
28934,4,3,101231,101231,101234,0,3,1
28935,6,1,101237,101237,101238,0,1,3
28936,2,3,101239,101239,101242,0,3,1
28937,2,1,101241,101242,101243,1,2,0
28938,4,2,101245,101245,101247,0,2,2
28939,6,1,101251,101251,101252,0,1,4
28940,3,2,101254,101254,101256,0,2,2
28941,2,3,101256,101256,101259,0,3,0
28942,6,2,101262,101262,101264,0,2,3
28943,2,1,101264,101264,101265,0,1,0
28944,6,1,101270,101270,101271,0,1,5
28945,1,1,101271,101271,101272,0,1,0
28946,4,3,101275,101275,101278,0,3,3
28947,1,3,101276,101278,101281,2,5,0
28948,4,2,101280,101281,101283,1,3,0
28949,5,1,101285,101285,101286,0,1,2
28950,6,2,101291,101291,101293,0,2,5
28951,1,3,101292,101293,101296,1,4,0
28952,6,1,101298,101298,101299,0,1,2
28953,5,2,101303,101303,101305,0,2,4
28954,6,2,101309,101309,101311,0,2,4
28955,1,1,101310,101311,101312,1,2,0
28956,4,1,101314,101314,101315,0,1,2
28957,2,1,101316,101316,101317,0,1,1
28958,1,1,101317,101317,101318,0,1,0
28959,5,3,101322,101322,101325,0,3,4
28960,5,2,101327,101327,101329,0,2,2
28961,3,2,101330,101330,101332,0,2,1
28962,4,3,101334,101334,101337,0,3,2
28963,3,2,101337,101337,101339,0,2,0
28964,5,2,101342,101342,101344,0,2,3
28965,3,2,101345,101345,101347,0,2,1
28966,2,2,101347,101347,101349,0,2,0
28967,3,3,101350,101350,101353,0,3,1
28968,3,3,101353,101353,101356,0,3,0
28969,3,3,101356,101356,101359,0,3,0
28970,4,1,101360,101360,101361,0,1,1
28971,6,2,101366,101366,101368,0,2,5
28972,5,2,101371,101371,101373,0,2,3
28973,4,1,101375,101375,101376,0,1,2
28974,6,1,101381,101381,101382,0,1,5
28975,3,1,101384,101384,101385,0,1,2
28976,5,1,101389,101389,101390,0,1,4
28977,2,1,101391,101391,101392,0,1,1
28978,1,1,101392,101392,101393,0,1,0
28979,6,2,101398,101398,101400,0,2,5
28980,5,2,101403,101403,101405,0,2,3
28981,6,3,101409,101409,101412,0,3,4
28982,1,1,101410,101412,101413,2,3,0
28983,5,1,101415,101415,101416,0,1,2
28984,2,2,101417,101417,101419,0,2,1
28985,4,1,101421,101421,101422,0,1,2
28986,4,1,101425,101425,101426,0,1,3
28987,6,1,101431,101431,101432,0,1,5
28988,1,1,101432,101432,101433,0,1,0
28989,5,2,101437,101437,101439,0,2,4
28990,1,1,101438,101439,101440,1,2,0
28991,1,3,101439,101440,101443,1,4,0
28992,6,3,101445,101445,101448,0,3,2
28993,6,1,101451,101451,101452,0,1,3
28994,5,2,101456,101456,101458,0,2,4
28995,6,3,101462,101462,101465,0,3,4
28996,4,1,101466,101466,101467,0,1,1
28997,3,2,101469,101469,101471,0,2,2
28998,6,1,101475,101475,101476,0,1,4
28999,4,2,101479,101479,101481,0,2,3
29000,5,3,101484,101484,101487,0,3,3
29001,6,3,101490,101490,101493,0,3,3
29002,2,1,101492,101493,101494,1,2,0
29003,6,3,101498,101498,101501,0,3,4
29004,4,2,101502,101502,101504,0,2,1
29005,6,2,101508,101508,101510,0,2,4
29006,2,2,101510,101510,101512,0,2,0
29007,6,2,101516,101516,101518,0,2,4
29008,4,3,101520,101520,101523,0,3,2
29009,4,2,101524,101524,101526,0,2,1
29010,2,1,101526,101526,101527,0,1,0
29011,5,2,101531,101531,101533,0,2,4
29012,4,3,101535,101535,101538,0,3,2
29013,5,3,101540,101540,101543,0,3,2
29014,3,2,101543,101543,101545,0,2,0
29015,4,2,101547,101547,101549,0,2,2
29016,4,2,101551,101551,101553,0,2,2
29017,5,1,101556,101556,101557,0,1,3
29018,2,2,101558,101558,101560,0,2,1
29019,1,3,101559,101560,101563,1,4,0
29020,2,3,101561,101563,101566,2,5,0
29021,3,3,101564,101566,101569,2,5,0
29022,3,3,101567,101569,101572,2,5,0
29023,5,3,101572,101572,101575,0,3,0
29024,6,3,101578,101578,101581,0,3,3
29025,3,2,101581,101581,101583,0,2,0
29026,1,2,101582,101583,101585,1,3,0
29027,4,3,101586,101586,101589,0,3,1
29028,5,1,101591,101591,101592,0,1,2
29029,1,1,101592,101592,101593,0,1,0
29030,5,3,101597,101597,101600,0,3,4
29031,2,3,101599,101600,101603,1,4,0
29032,1,3,101600,101603,101606,3,6,0
29033,1,1,101601,101606,101607,5,6,0
29034,6,1,101607,101607,101608,0,1,0
29035,4,3,101611,101611,101614,0,3,3
29036,4,3,101615,101615,101618,0,3,1
29037,1,1,101616,101618,101619,2,3,0
29038,1,1,101617,101619,101620,2,3,0
29039,6,3,101623,101623,101626,0,3,3
29040,2,3,101625,101626,101629,1,4,0
29041,2,3,101627,101629,101632,2,5,0
29042,3,1,101630,101632,101633,2,3,0
29043,3,2,101633,101633,101635,0,2,0
29044,4,3,101637,101637,101640,0,3,2
29045,4,1,101641,101641,101642,0,1,1
29046,2,2,101643,101643,101645,0,2,1
29047,2,1,101645,101645,101646,0,1,0
29048,2,1,101647,101647,101648,0,1,1
29049,6,1,101653,101653,101654,0,1,5
29050,3,1,101656,101656,101657,0,1,2
29051,1,2,101657,101657,101659,0,2,0
29052,3,3,101660,101660,101663,0,3,1
29053,1,3,101661,101663,101666,2,5,0
29054,2,2,101663,101666,101668,3,5,0
29055,1,3,101664,101668,101671,4,7,0
29056,5,3,101669,101671,101674,2,5,0
29057,1,1,101670,101674,101675,4,5,0
29058,3,2,101673,101675,101677,2,4,0
29059,1,3,101674,101677,101680,3,6,0
29060,5,3,101679,101680,101683,1,4,0
29061,5,1,101684,101684,101685,0,1,1
29062,3,1,101687,101687,101688,0,1,2
29063,4,2,101691,101691,101693,0,2,3
29064,6,2,101697,101697,101699,0,2,4
29065,5,1,101702,101702,101703,0,1,3
29066,3,2,101705,101705,101707,0,2,2
29067,4,1,101709,101709,101710,0,1,2
29068,4,1,101713,101713,101714,0,1,3
29069,6,2,101719,101719,101721,0,2,5
29070,5,3,101724,101724,101727,0,3,3
29071,5,1,101729,101729,101730,0,1,2
29072,3,3,101732,101732,101735,0,3,2
29073,6,1,101738,101738,101739,0,1,3
29074,1,1,101739,101739,101740,0,1,0
29075,5,1,101744,101744,101745,0,1,4
29076,6,1,101750,101750,101751,0,1,5
29077,6,1,101756,101756,101757,0,1,5
29078,1,3,101757,101757,101760,0,3,0
29079,2,1,101759,101760,101761,1,2,0
29080,4,3,101763,101763,101766,0,3,2
29081,4,3,101767,101767,101770,0,3,1
29082,1,3,101768,101770,101773,2,5,0
29083,3,3,101771,101773,101776,2,5,0
29084,5,3,101776,101776,101779,0,3,0
29085,4,2,101780,101780,101782,0,2,1
29086,6,1,101786,101786,101787,0,1,4
29087,1,1,101787,101787,101788,0,1,0
29088,6,3,101793,101793,101796,0,3,5
29089,1,3,101794,101796,101799,2,5,0
29090,4,3,101798,101799,101802,1,4,0
29091,4,1,101802,101802,101803,0,1,0
29092,5,1,101807,101807,101808,0,1,4
29093,6,2,101813,101813,101815,0,2,5
29094,4,3,101817,101817,101820,0,3,2
29095,2,3,101819,101820,101823,1,4,0
29096,4,1,101823,101823,101824,0,1,0
29097,5,3,101828,101828,101831,0,3,4
29098,3,2,101831,101831,101833,0,2,0
29099,4,2,101835,101835,101837,0,2,2
29100,6,1,101841,101841,101842,0,1,4
29101,2,1,101843,101843,101844,0,1,1
29102,5,2,101848,101848,101850,0,2,4
29103,4,1,101852,101852,101853,0,1,2
29104,3,3,101855,101855,101858,0,3,2
29105,2,1,101857,101858,101859,1,2,0
29106,4,1,101861,101861,101862,0,1,2
29107,3,3,101864,101864,101867,0,3,2
29108,5,1,101869,101869,101870,0,1,2
29109,5,3,101874,101874,101877,0,3,4
29110,3,1,101877,101877,101878,0,1,0
29111,4,2,101881,101881,101883,0,2,3
29112,5,2,101886,101886,101888,0,2,3
29113,1,1,101887,101888,101889,1,2,0
29114,4,1,101891,101891,101892,0,1,2
29115,5,3,101896,101896,101899,0,3,4
29116,2,3,101898,101899,101902,1,4,0
29117,1,3,101899,101902,101905,3,6,0
29118,6,1,101905,101905,101906,0,1,0
29119,3,3,101908,101908,101911,0,3,2
29120,3,1,101911,101911,101912,0,1,0
29121,4,1,101915,101915,101916,0,1,3
29122,5,1,101920,101920,101921,0,1,4
29123,5,1,101925,101925,101926,0,1,4
29124,2,3,101927,101927,101930,0,3,1
29125,5,1,101932,101932,101933,0,1,2
29126,3,1,101935,101935,101936,0,1,2
29127,2,2,101937,101937,101939,0,2,1
29128,4,2,101941,101941,101943,0,2,2
29129,5,2,101946,101946,101948,0,2,3
29130,6,3,101952,101952,101955,0,3,4
29131,3,1,101955,101955,101956,0,1,0
29132,5,2,101960,101960,101962,0,2,4
29133,5,1,101965,101965,101966,0,1,3
29134,4,2,101969,101969,101971,0,2,3
29135,6,3,101975,101975,101978,0,3,4
29136,6,3,101981,101981,101984,0,3,3
29137,4,2,101985,101985,101987,0,2,1
29138,1,1,101986,101987,101988,1,2,0
29139,6,1,101992,101992,101993,0,1,4
29140,6,2,101998,101998,102000,0,2,5
29141,6,3,102004,102004,102007,0,3,4
29142,5,2,102009,102009,102011,0,2,2
29143,3,2,102012,102012,102014,0,2,1
29144,5,3,102017,102017,102020,0,3,3
29145,3,3,102020,102020,102023,0,3,0
29146,5,2,102025,102025,102027,0,2,2
29147,2,3,102027,102027,102030,0,3,0
29148,4,2,102031,102031,102033,0,2,1
29149,1,1,102032,102033,102034,1,2,0
29150,3,3,102035,102035,102038,0,3,1
29151,3,1,102038,102038,102039,0,1,0
29152,3,2,102041,102041,102043,0,2,2
29153,4,2,102045,102045,102047,0,2,2
29154,3,2,102048,102048,102050,0,2,1
29155,2,3,102050,102050,102053,0,3,0
29156,4,2,102054,102054,102056,0,2,1
29157,1,3,102055,102056,102059,1,4,0
29158,2,2,102057,102059,102061,2,4,0
29159,4,1,102061,102061,102062,0,1,0
29160,6,1,102067,102067,102068,0,1,5
29161,6,3,102073,102073,102076,0,3,5
29162,3,3,102076,102076,102079,0,3,0
29163,3,2,102079,102079,102081,0,2,0
29164,6,1,102085,102085,102086,0,1,4
29165,4,1,102089,102089,102090,0,1,3
29166,4,2,102093,102093,102095,0,2,3
29167,6,1,102099,102099,102100,0,1,4
29168,2,1,102101,102101,102102,0,1,1
29169,5,3,102106,102106,102109,0,3,4
29170,1,1,102107,102109,102110,2,3,0
29171,5,1,102112,102112,102113,0,1,2
29172,4,3,102116,102116,102119,0,3,3
29173,3,2,102119,102119,102121,0,2,0
29174,5,1,102124,102124,102125,0,1,3
29175,2,3,102126,102126,102129,0,3,1
29176,5,2,102131,102131,102133,0,2,2
29177,2,3,102133,102133,102136,0,3,0
29178,6,1,102139,102139,102140,0,1,3
29179,1,1,102140,102140,102141,0,1,0
29180,1,2,102141,102141,102143,0,2,0
29181,6,2,102147,102147,102149,0,2,4
29182,2,1,102149,102149,102150,0,1,0
29183,5,2,102154,102154,102156,0,2,4
29184,4,1,102158,102158,102159,0,1,2
29185,4,2,102162,102162,102164,0,2,3
29186,3,1,102165,102165,102166,0,1,1
29187,6,2,102171,102171,102173,0,2,5
29188,3,3,102174,102174,102177,0,3,1
29189,6,1,102180,102180,102181,0,1,3
29190,1,1,102181,102181,102182,0,1,0
29191,4,2,102185,102185,102187,0,2,3
29192,3,3,102188,102188,102191,0,3,1
29193,1,3,102189,102191,102194,2,5,0
29194,4,2,102193,102194,102196,1,3,0
29195,6,3,102199,102199,102202,0,3,3
29196,5,3,102204,102204,102207,0,3,2
29197,1,3,102205,102207,102210,2,5,0
29198,2,2,102207,102210,102212,3,5,0
29199,3,2,102210,102212,102214,2,4,0
29200,1,2,102211,102214,102216,3,5,0
29201,5,3,102216,102216,102219,0,3,0
29202,5,2,102221,102221,102223,0,2,2
29203,3,3,102224,102224,102227,0,3,1
29204,6,2,102230,102230,102232,0,2,3
29205,1,1,102231,102232,102233,1,2,0
29206,2,2,102233,102233,102235,0,2,0
29207,1,2,102234,102235,102237,1,3,0
29208,3,2,102237,102237,102239,0,2,0
29209,4,1,102241,102241,102242,0,1,2
29210,3,2,102244,102244,102246,0,2,2
29211,6,1,102250,102250,102251,0,1,4
29212,3,1,102253,102253,102254,0,1,2
29213,6,1,102259,102259,102260,0,1,5
29214,4,2,102263,102263,102265,0,2,3
29215,4,2,102267,102267,102269,0,2,2
29216,4,3,102271,102271,102274,0,3,2
29217,2,3,102273,102274,102277,1,4,0
29218,6,3,102279,102279,102282,0,3,2
29219,2,3,102281,102282,102285,1,4,0
29220,5,2,102286,102286,102288,0,2,1
29221,3,1,102289,102289,102290,0,1,1
29222,1,3,102290,102290,102293,0,3,0
29223,6,1,102296,102296,102297,0,1,3
29224,4,3,102300,102300,102303,0,3,3
29225,4,2,102304,102304,102306,0,2,1
29226,4,2,102308,102308,102310,0,2,2
29227,5,3,102313,102313,102316,0,3,3
29228,5,2,102318,102318,102320,0,2,2
29229,2,3,102320,102320,102323,0,3,0
29230,4,3,102324,102324,102327,0,3,1
29231,5,2,102329,102329,102331,0,2,2
29232,6,3,102335,102335,102338,0,3,4
29233,4,3,102339,102339,102342,0,3,1
29234,3,3,102342,102342,102345,0,3,0
29235,2,2,102344,102345,102347,1,3,0
29236,5,2,102349,102349,102351,0,2,2
29237,5,2,102354,102354,102356,0,2,3
29238,3,3,102357,102357,102360,0,3,1
29239,6,3,102363,102363,102366,0,3,3
29240,5,1,102368,102368,102369,0,1,2
29241,4,2,102372,102372,102374,0,2,3
29242,5,1,102377,102377,102378,0,1,3
29243,2,2,102379,102379,102381,0,2,1
29244,3,1,102382,102382,102383,0,1,1
29245,5,1,102387,102387,102388,0,1,4
29246,3,1,102390,102390,102391,0,1,2
29247,2,2,102392,102392,102394,0,2,1
29248,3,1,102395,102395,102396,0,1,1
29249,4,1,102399,102399,102400,0,1,3
29250,3,3,102402,102402,102405,0,3,2
29251,1,3,102403,102405,102408,2,5,0
29252,4,3,102407,102408,102411,1,4,0
29253,5,1,102412,102412,102413,0,1,1
29254,2,2,102414,102414,102416,0,2,1
29255,6,2,102420,102420,102422,0,2,4
29256,3,1,102423,102423,102424,0,1,1
29257,2,2,102425,102425,102427,0,2,1
29258,1,3,102426,102427,102430,1,4,0
29259,2,1,102428,102430,102431,2,3,0
29260,5,3,102433,102433,102436,0,3,2
29261,6,2,102439,102439,102441,0,2,3
29262,3,1,102442,102442,102443,0,1,1
29263,2,2,102444,102444,102446,0,2,1
29264,4,1,102448,102448,102449,0,1,2
29265,2,1,102450,102450,102451,0,1,1
29266,5,3,102455,102455,102458,0,3,4
29267,3,2,102458,102458,102460,0,2,0
29268,5,3,102463,102463,102466,0,3,3
29269,3,1,102466,102466,102467,0,1,0
29270,5,2,102471,102471,102473,0,2,4
29271,1,1,102472,102473,102474,1,2,0
29272,1,2,102473,102474,102476,1,3,0
29273,5,2,102478,102478,102480,0,2,2
29274,6,3,102484,102484,102487,0,3,4
29275,6,1,102490,102490,102491,0,1,3
29276,1,2,102491,102491,102493,0,2,0
29277,1,2,102492,102493,102495,1,3,0
29278,6,3,102498,102498,102501,0,3,3
29279,6,3,102504,102504,102507,0,3,3
29280,3,3,102507,102507,102510,0,3,0
29281,1,2,102508,102510,102512,2,4,0
29282,4,3,102512,102512,102515,0,3,0
29283,4,2,102516,102516,102518,0,2,1
29284,4,3,102520,102520,102523,0,3,2
29285,1,1,102521,102523,102524,2,3,0
29286,2,3,102523,102524,102527,1,4,0
29287,3,1,102526,102527,102528,1,2,0
29288,5,2,102531,102531,102533,0,2,3
29289,3,2,102534,102534,102536,0,2,1
29290,3,3,102537,102537,102540,0,3,1
29291,2,2,102539,102540,102542,1,3,0
29292,4,2,102543,102543,102545,0,2,1
29293,1,2,102544,102545,102547,1,3,0
29294,4,3,102548,102548,102551,0,3,1
29295,4,3,102552,102552,102555,0,3,1
29296,6,2,102558,102558,102560,0,2,3
29297,2,3,102560,102560,102563,0,3,0
29298,2,1,102562,102563,102564,1,2,0
29299,2,2,102564,102564,102566,0,2,0
29300,2,3,102566,102566,102569,0,3,0
29301,4,3,102570,102570,102573,0,3,1
29302,4,1,102574,102574,102575,0,1,1
29303,4,1,102578,102578,102579,0,1,3
29304,6,1,102584,102584,102585,0,1,5
29305,1,1,102585,102585,102586,0,1,0
29306,5,1,102590,102590,102591,0,1,4
29307,6,3,102596,102596,102599,0,3,5
29308,5,3,102601,102601,102604,0,3,2
29309,2,2,102603,102604,102606,1,3,0
29310,3,3,102606,102606,102609,0,3,0
29311,5,2,102611,102611,102613,0,2,2
29312,4,2,102615,102615,102617,0,2,2
29313,5,1,102620,102620,102621,0,1,3
29314,2,2,102622,102622,102624,0,2,1
29315,6,3,102628,102628,102631,0,3,4
29316,5,1,102633,102633,102634,0,1,2
29317,6,2,102639,102639,102641,0,2,5
29318,2,3,102641,102641,102644,0,3,0
29319,1,2,102642,102644,102646,2,4,0
29320,6,1,102648,102648,102649,0,1,2
29321,5,3,102653,102653,102656,0,3,4
29322,6,2,102659,102659,102661,0,2,3
29323,6,2,102665,102665,102667,0,2,4
29324,5,1,102670,102670,102671,0,1,3
29325,2,3,102672,102672,102675,0,3,1
29326,3,3,102675,102675,102678,0,3,0
29327,2,1,102677,102678,102679,1,2,0
29328,2,1,102679,102679,102680,0,1,0
29329,4,2,102683,102683,102685,0,2,3
29330,3,1,102686,102686,102687,0,1,1
29331,5,1,102691,102691,102692,0,1,4
29332,6,2,102697,102697,102699,0,2,5
29333,3,3,102700,102700,102703,0,3,1
29334,2,3,102702,102703,102706,1,4,0
29335,4,2,102706,102706,102708,0,2,0
29336,5,1,102711,102711,102712,0,1,3
29337,4,2,102715,102715,102717,0,2,3
29338,5,2,102720,102720,102722,0,2,3
29339,4,2,102724,102724,102726,0,2,2
29340,2,2,102726,102726,102728,0,2,0
29341,3,3,102729,102729,102732,0,3,1
29342,1,1,102730,102732,102733,2,3,0
29343,1,1,102731,102733,102734,2,3,0
29344,4,2,102735,102735,102737,0,2,1
29345,5,2,102740,102740,102742,0,2,3
29346,1,2,102741,102742,102744,1,3,0
29347,6,2,102747,102747,102749,0,2,3
29348,3,3,102750,102750,102753,0,3,1
29349,3,2,102753,102753,102755,0,2,0
29350,4,3,102757,102757,102760,0,3,2
29351,4,2,102761,102761,102763,0,2,1
29352,1,3,102762,102763,102766,1,4,0
29353,5,1,102767,102767,102768,0,1,1
29354,1,2,102768,102768,102770,0,2,0
29355,1,2,102769,102770,102772,1,3,0
29356,4,2,102773,102773,102775,0,2,1
29357,1,1,102774,102775,102776,1,2,0
29358,3,1,102777,102777,102778,0,1,1
29359,1,2,102778,102778,102780,0,2,0
29360,5,3,102783,102783,102786,0,3,3
29361,3,1,102786,102786,102787,0,1,0
29362,6,1,102792,102792,102793,0,1,5
29363,2,1,102794,102794,102795,0,1,1
29364,1,3,102795,102795,102798,0,3,0
29365,1,3,102796,102798,102801,2,5,0
29366,5,2,102801,102801,102803,0,2,0
29367,5,1,102806,102806,102807,0,1,3
29368,3,3,102809,102809,102812,0,3,2
29369,6,2,102815,102815,102817,0,2,3
29370,2,1,102817,102817,102818,0,1,0
29371,6,3,102823,102823,102826,0,3,5
29372,3,1,102826,102826,102827,0,1,0
29373,6,3,102832,102832,102835,0,3,5
29374,3,2,102835,102835,102837,0,2,0
29375,4,1,102839,102839,102840,0,1,2
29376,4,2,102843,102843,102845,0,2,3
29377,6,2,102849,102849,102851,0,2,4
29378,1,1,102850,102851,102852,1,2,0
29379,6,2,102856,102856,102858,0,2,4
29380,3,3,102859,102859,102862,0,3,1
29381,2,3,102861,102862,102865,1,4,0
29382,1,1,102862,102865,102866,3,4,0
29383,4,3,102866,102866,102869,0,3,0
29384,1,2,102867,102869,102871,2,4,0
29385,2,1,102869,102871,102872,2,3,0
29386,2,3,102871,102872,102875,1,4,0
29387,2,2,102873,102875,102877,2,4,0
29388,5,1,102878,102878,102879,0,1,1
29389,2,1,102880,102880,102881,0,1,1
29390,6,1,102886,102886,102887,0,1,5
29391,5,3,102891,102891,102894,0,3,4
29392,1,2,102892,102894,102896,2,4,0
29393,1,1,102893,102896,102897,3,4,0
29394,1,3,102894,102897,102900,3,6,0
29395,1,1,102895,102900,102901,5,6,0
29396,4,2,102899,102901,102903,2,4,0
29397,2,1,102901,102903,102904,2,3,0
29398,1,3,102902,102904,102907,2,5,0
29399,5,2,102907,102907,102909,0,2,0
29400,2,3,102909,102909,102912,0,3,0
29401,5,2,102914,102914,102916,0,2,2
29402,4,1,102918,102918,102919,0,1,2
29403,1,3,102919,102919,102922,0,3,0
29404,2,2,102921,102922,102924,1,3,0
29405,6,3,102927,102927,102930,0,3,3
29406,2,1,102929,102930,102931,1,2,0
29407,2,3,102931,102931,102934,0,3,0
29408,3,2,102934,102934,102936,0,2,0
29409,5,3,102939,102939,102942,0,3,3
29410,1,2,102940,102942,102944,2,4,0
29411,5,3,102945,102945,102948,0,3,1
29412,2,2,102947,102948,102950,1,3,0
29413,2,3,102949,102950,102953,1,4,0
29414,5,1,102954,102954,102955,0,1,1
29415,1,2,102955,102955,102957,0,2,0
29416,1,1,102956,102957,102958,1,2,0
29417,1,1,102957,102958,102959,1,2,0
29418,6,1,102963,102963,102964,0,1,4
29419,2,2,102965,102965,102967,0,2,1
29420,1,3,102966,102967,102970,1,4,0
29421,2,1,102968,102970,102971,2,3,0
29422,5,3,102973,102973,102976,0,3,2
29423,1,2,102974,102976,102978,2,4,0
29424,2,1,102976,102978,102979,2,3,0
29425,4,2,102980,102980,102982,0,2,1
29426,5,3,102985,102985,102988,0,3,3
29427,6,3,102991,102991,102994,0,3,3
29428,5,3,102996,102996,102999,0,3,2
29429,1,2,102997,102999,103001,2,4,0
29430,4,2,103001,103001,103003,0,2,0
29431,6,1,103007,103007,103008,0,1,4
29432,5,1,103012,103012,103013,0,1,4
29433,5,2,103017,103017,103019,0,2,4
29434,3,2,103020,103020,103022,0,2,1
29435,2,2,103022,103022,103024,0,2,0
29436,2,1,103024,103024,103025,0,1,0
29437,4,3,103028,103028,103031,0,3,3
29438,4,3,103032,103032,103035,0,3,1
29439,2,1,103034,103035,103036,1,2,0
29440,6,1,103040,103040,103041,0,1,4
29441,1,2,103041,103041,103043,0,2,0
29442,2,2,103043,103043,103045,0,2,0
29443,1,3,103044,103045,103048,1,4,0
29444,4,1,103048,103048,103049,0,1,0
29445,6,2,103054,103054,103056,0,2,5
29446,2,2,103056,103056,103058,0,2,0
29447,5,3,103061,103061,103064,0,3,3
29448,6,2,103067,103067,103069,0,2,3
29449,4,2,103071,103071,103073,0,2,2
29450,2,3,103073,103073,103076,0,3,0
29451,2,2,103075,103076,103078,1,3,0
29452,6,1,103081,103081,103082,0,1,3
29453,1,1,103082,103082,103083,0,1,0
29454,1,3,103083,103083,103086,0,3,0
29455,4,2,103087,103087,103089,0,2,1
29456,1,2,103088,103089,103091,1,3,0
29457,2,2,103090,103091,103093,1,3,0
29458,6,3,103096,103096,103099,0,3,3
29459,1,3,103097,103099,103102,2,5,0
29460,2,1,103099,103102,103103,3,4,0
29461,6,3,103105,103105,103108,0,3,2
29462,5,3,103110,103110,103113,0,3,2
29463,2,3,103112,103113,103116,1,4,0
29464,2,3,103114,103116,103119,2,5,0
29465,5,1,103119,103119,103120,0,1,0
29466,6,1,103125,103125,103126,0,1,5
29467,2,2,103127,103127,103129,0,2,1
29468,5,3,103132,103132,103135,0,3,3
29469,4,1,103136,103136,103137,0,1,1
29470,4,3,103140,103140,103143,0,3,3
29471,4,3,103144,103144,103147,0,3,1
29472,6,3,103150,103150,103153,0,3,3
29473,2,3,103152,103153,103156,1,4,0
29474,2,2,103154,103156,103158,2,4,0
29475,4,2,103158,103158,103160,0,2,0
29476,4,1,103162,103162,103163,0,1,2
29477,3,2,103165,103165,103167,0,2,2
29478,2,2,103167,103167,103169,0,2,0
29479,4,2,103171,103171,103173,0,2,2
29480,4,2,103175,103175,103177,0,2,2
29481,6,3,103181,103181,103184,0,3,4
29482,5,3,103186,103186,103189,0,3,2
29483,2,2,103188,103189,103191,1,3,0
29484,6,2,103194,103194,103196,0,2,3
29485,4,2,103198,103198,103200,0,2,2
29486,1,1,103199,103200,103201,1,2,0
29487,4,2,103203,103203,103205,0,2,2
29488,2,3,103205,103205,103208,0,3,0
29489,1,2,103206,103208,103210,2,4,0
29490,4,1,103210,103210,103211,0,1,0
29491,2,1,103212,103212,103213,0,1,1
29492,4,1,103216,103216,103217,0,1,3
29493,3,1,103219,103219,103220,0,1,2
29494,3,2,103222,103222,103224,0,2,2
29495,2,2,103224,103224,103226,0,2,0
29496,6,1,103230,103230,103231,0,1,4
29497,5,1,103235,103235,103236,0,1,4
29498,1,3,103236,103236,103239,0,3,0
29499,2,3,103238,103239,103242,1,4,0
29500,5,2,103243,103243,103245,0,2,1
29501,1,3,103244,103245,103248,1,4,0
29502,2,2,103246,103248,103250,2,4,0
29503,2,1,103248,103250,103251,2,3,0
29504,3,1,103251,103251,103252,0,1,0
29505,3,1,103254,103254,103255,0,1,2
29506,1,3,103255,103255,103258,0,3,0
29507,2,3,103257,103258,103261,1,4,0
29508,5,1,103262,103262,103263,0,1,1
29509,1,3,103263,103263,103266,0,3,0
29510,5,1,103268,103268,103269,0,1,2
29511,5,1,103273,103273,103274,0,1,4
29512,1,2,103274,103274,103276,0,2,0
29513,2,3,103276,103276,103279,0,3,0
29514,4,1,103280,103280,103281,0,1,1
29515,2,3,103282,103282,103285,0,3,1
29516,1,2,103283,103285,103287,2,4,0
29517,3,1,103286,103287,103288,1,2,0
29518,6,1,103292,103292,103293,0,1,4
29519,1,3,103293,103293,103296,0,3,0
29520,2,2,103295,103296,103298,1,3,0
29521,4,3,103299,103299,103302,0,3,1
29522,2,1,103301,103302,103303,1,2,0
29523,2,3,103303,103303,103306,0,3,0
29524,3,2,103306,103306,103308,0,2,0
29525,2,2,103308,103308,103310,0,2,0
29526,2,3,103310,103310,103313,0,3,0
29527,4,3,103314,103314,103317,0,3,1
29528,6,1,103320,103320,103321,0,1,3
29529,5,3,103325,103325,103328,0,3,4
29530,2,1,103327,103328,103329,1,2,0
29531,6,2,103333,103333,103335,0,2,4
29532,5,2,103338,103338,103340,0,2,3
29533,1,1,103339,103340,103341,1,2,0
29534,3,2,103342,103342,103344,0,2,1
29535,1,2,103343,103344,103346,1,3,0
29536,2,2,103345,103346,103348,1,3,0
29537,1,3,103346,103348,103351,2,5,0
29538,3,3,103349,103351,103354,2,5,0
29539,2,3,103351,103354,103357,3,6,0
29540,2,3,103353,103357,103360,4,7,0
29541,3,3,103356,103360,103363,4,7,0
29542,3,1,103359,103363,103364,4,5,0
29543,5,2,103364,103364,103366,0,2,0
29544,4,3,103368,103368,103371,0,3,2
29545,6,2,103374,103374,103376,0,2,3
29546,3,2,103377,103377,103379,0,2,1
29547,2,1,103379,103379,103380,0,1,0
29548,2,1,103381,103381,103382,0,1,1
29549,3,3,103384,103384,103387,0,3,2
29550,1,3,103385,103387,103390,2,5,0
29551,2,2,103387,103390,103392,3,5,0
29552,2,2,103389,103392,103394,3,5,0
29553,5,1,103394,103394,103395,0,1,0
29554,4,3,103398,103398,103401,0,3,3
29555,3,2,103401,103401,103403,0,2,0
29556,1,3,103402,103403,103406,1,4,0
29557,6,2,103408,103408,103410,0,2,2
29558,3,3,103411,103411,103414,0,3,1
29559,1,1,103412,103414,103415,2,3,0
29560,3,3,103415,103415,103418,0,3,0
29561,6,3,103421,103421,103424,0,3,3
29562,4,2,103425,103425,103427,0,2,1
29563,4,1,103429,103429,103430,0,1,2
29564,3,3,103432,103432,103435,0,3,2
29565,1,2,103433,103435,103437,2,4,0
29566,2,3,103435,103437,103440,2,5,0
29567,5,3,103440,103440,103443,0,3,0
29568,3,3,103443,103443,103446,0,3,0
29569,6,2,103449,103449,103451,0,2,3
29570,6,3,103455,103455,103458,0,3,4
29571,5,3,103460,103460,103463,0,3,2
29572,1,2,103461,103463,103465,2,4,0
29573,2,1,103463,103465,103466,2,3,0
29574,5,2,103468,103468,103470,0,2,2
29575,1,2,103469,103470,103472,1,3,0
29576,4,2,103473,103473,103475,0,2,1
29577,1,2,103474,103475,103477,1,3,0
29578,5,1,103479,103479,103480,0,1,2
29579,3,2,103482,103482,103484,0,2,2
29580,1,1,103483,103484,103485,1,2,0
29581,4,3,103487,103487,103490,0,3,2
29582,3,1,103490,103490,103491,0,1,0
29583,2,3,103492,103492,103495,0,3,1
29584,3,3,103495,103495,103498,0,3,0
29585,5,2,103500,103500,103502,0,2,2
29586,4,3,103504,103504,103507,0,3,2
29587,5,2,103509,103509,103511,0,2,2
29588,6,1,103515,103515,103516,0,1,4
29589,1,1,103516,103516,103517,0,1,0
29590,1,2,103517,103517,103519,0,2,0
29591,6,2,103523,103523,103525,0,2,4
29592,5,2,103528,103528,103530,0,2,3
29593,3,3,103531,103531,103534,0,3,1
29594,3,2,103534,103534,103536,0,2,0
29595,6,2,103540,103540,103542,0,2,4
29596,4,3,103544,103544,103547,0,3,2
29597,4,3,103548,103548,103551,0,3,1
29598,3,1,103551,103551,103552,0,1,0
29599,5,1,103556,103556,103557,0,1,4
29600,2,2,103558,103558,103560,0,2,1
29601,4,1,103562,103562,103563,0,1,2
29602,3,3,103565,103565,103568,0,3,2
29603,3,1,103568,103568,103569,0,1,0
29604,5,2,103573,103573,103575,0,2,4
29605,2,3,103575,103575,103578,0,3,0
29606,2,2,103577,103578,103580,1,3,0
29607,2,3,103579,103580,103583,1,4,0
29608,1,2,103580,103583,103585,3,5,0
29609,1,2,103581,103585,103587,4,6,0
29610,5,2,103586,103587,103589,1,3,0
29611,4,2,103590,103590,103592,0,2,1
29612,1,2,103591,103592,103594,1,3,0
29613,4,3,103595,103595,103598,0,3,1
29614,1,1,103596,103598,103599,2,3,0
29615,2,3,103598,103599,103602,1,4,0
29616,2,3,103600,103602,103605,2,5,0
29617,1,2,103601,103605,103607,4,6,0
29618,5,2,103606,103607,103609,1,3,0
29619,1,2,103607,103609,103611,2,4,0
29620,3,1,103610,103611,103612,1,2,0
29621,5,2,103615,103615,103617,0,2,3
29622,5,1,103620,103620,103621,0,1,3
29623,6,1,103626,103626,103627,0,1,5
29624,6,2,103632,103632,103634,0,2,5
29625,1,1,103633,103634,103635,1,2,0
29626,2,2,103635,103635,103637,0,2,0
29627,6,1,103641,103641,103642,0,1,4
29628,3,1,103644,103644,103645,0,1,2
29629,3,1,103647,103647,103648,0,1,2
29630,3,3,103650,103650,103653,0,3,2
29631,2,3,103652,103653,103656,1,4,0
29632,6,1,103658,103658,103659,0,1,2
29633,4,1,103662,103662,103663,0,1,3
29634,1,3,103663,103663,103666,0,3,0
29635,1,2,103664,103666,103668,2,4,0
29636,6,2,103670,103670,103672,0,2,2
29637,3,2,103673,103673,103675,0,2,1
29638,5,3,103678,103678,103681,0,3,3
29639,2,1,103680,103681,103682,1,2,0
29640,4,1,103684,103684,103685,0,1,2
29641,6,1,103690,103690,103691,0,1,5
29642,3,1,103693,103693,103694,0,1,2
29643,5,1,103698,103698,103699,0,1,4
29644,6,3,103704,103704,103707,0,3,5
29645,5,2,103709,103709,103711,0,2,2
29646,5,2,103714,103714,103716,0,2,3
29647,2,1,103716,103716,103717,0,1,0
29648,1,1,103717,103717,103718,0,1,0
29649,4,1,103721,103721,103722,0,1,3
29650,3,3,103724,103724,103727,0,3,2
29651,2,2,103726,103727,103729,1,3,0
29652,1,2,103727,103729,103731,2,4,0
29653,4,1,103731,103731,103732,0,1,0
29654,5,2,103736,103736,103738,0,2,4
29655,1,1,103737,103738,103739,1,2,0
29656,6,1,103743,103743,103744,0,1,4
29657,4,2,103747,103747,103749,0,2,3
29658,6,3,103753,103753,103756,0,3,4
29659,5,1,103758,103758,103759,0,1,2
29660,4,1,103762,103762,103763,0,1,3
29661,5,2,103767,103767,103769,0,2,4
29662,4,2,103771,103771,103773,0,2,2
29663,2,1,103773,103773,103774,0,1,0
29664,6,3,103779,103779,103782,0,3,5
29665,2,3,103781,103782,103785,1,4,0
29666,3,3,103784,103785,103788,1,4,0
29667,5,1,103789,103789,103790,0,1,1
29668,1,3,103790,103790,103793,0,3,0
29669,2,3,103792,103793,103796,1,4,0
29670,6,2,103798,103798,103800,0,2,2
29671,1,2,103799,103800,103802,1,3,0
29672,1,2,103800,103802,103804,2,4,0
29673,5,2,103805,103805,103807,0,2,1
29674,3,3,103808,103808,103811,0,3,1
29675,3,1,103811,103811,103812,0,1,0
29676,1,3,103812,103812,103815,0,3,0
29677,5,2,103817,103817,103819,0,2,2
29678,2,2,103819,103819,103821,0,2,0
29679,4,1,103823,103823,103824,0,1,2
29680,6,2,103829,103829,103831,0,2,5
29681,5,1,103834,103834,103835,0,1,3
29682,1,1,103835,103835,103836,0,1,0
29683,6,3,103841,103841,103844,0,3,5
29684,3,3,103844,103844,103847,0,3,0
29685,6,2,103850,103850,103852,0,2,3
29686,3,2,103853,103853,103855,0,2,1
29687,6,2,103859,103859,103861,0,2,4
29688,6,2,103865,103865,103867,0,2,4
29689,1,1,103866,103867,103868,1,2,0
29690,1,2,103867,103868,103870,1,3,0
29691,5,1,103872,103872,103873,0,1,2
29692,3,3,103875,103875,103878,0,3,2
29693,2,3,103877,103878,103881,1,4,0
29694,1,1,103878,103881,103882,3,4,0
29695,4,1,103882,103882,103883,0,1,0
29696,2,1,103884,103884,103885,0,1,1
29697,5,3,103889,103889,103892,0,3,4
29698,2,1,103891,103892,103893,1,2,0
29699,6,3,103897,103897,103900,0,3,4
29700,4,1,103901,103901,103902,0,1,1
29701,1,2,103902,103902,103904,0,2,0
29702,4,2,103906,103906,103908,0,2,2
29703,4,3,103910,103910,103913,0,3,2
29704,2,1,103912,103913,103914,1,2,0
29705,5,1,103917,103917,103918,0,1,3
29706,6,2,103923,103923,103925,0,2,5
29707,6,2,103929,103929,103931,0,2,4
29708,6,2,103935,103935,103937,0,2,4
29709,3,3,103938,103938,103941,0,3,1
29710,5,1,103943,103943,103944,0,1,2
29711,3,2,103946,103946,103948,0,2,2
29712,1,2,103947,103948,103950,1,3,0
29713,1,2,103948,103950,103952,2,4,0
29714,1,2,103949,103952,103954,3,5,0
29715,1,2,103950,103954,103956,4,6,0
29716,1,1,103951,103956,103957,5,6,0
29717,5,1,103956,103957,103958,1,2,0
29718,6,3,103962,103962,103965,0,3,4
29719,5,1,103967,103967,103968,0,1,2
29720,4,1,103971,103971,103972,0,1,3
29721,5,3,103976,103976,103979,0,3,4
29722,4,1,103980,103980,103981,0,1,1
29723,3,2,103983,103983,103985,0,2,2
29724,1,2,103984,103985,103987,1,3,0
29725,2,1,103986,103987,103988,1,2,0
29726,2,2,103988,103988,103990,0,2,0
29727,4,2,103992,103992,103994,0,2,2
29728,3,3,103995,103995,103998,0,3,1
29729,2,1,103997,103998,103999,1,2,0
29730,1,1,103998,103999,104000,1,2,0
29731,1,3,103999,104000,104003,1,4,0
29732,4,1,104003,104003,104004,0,1,0
29733,6,2,104009,104009,104011,0,2,5
29734,6,1,104015,104015,104016,0,1,4
29735,6,2,104021,104021,104023,0,2,5
29736,4,2,104025,104025,104027,0,2,2
29737,2,1,104027,104027,104028,0,1,0
29738,6,2,104033,104033,104035,0,2,5
29739,1,3,104034,104035,104038,1,4,0
29740,6,2,104040,104040,104042,0,2,2
29741,3,2,104043,104043,104045,0,2,1
29742,2,2,104045,104045,104047,0,2,0
29743,4,2,104049,104049,104051,0,2,2
29744,4,1,104053,104053,104054,0,1,2
29745,2,3,104055,104055,104058,0,3,1
29746,1,2,104056,104058,104060,2,4,0
29747,6,3,104062,104062,104065,0,3,2
29748,5,3,104067,104067,104070,0,3,2
29749,2,3,104069,104070,104073,1,4,0
29750,3,3,104072,104073,104076,1,4,0
29751,1,3,104073,104076,104079,3,6,0
29752,6,2,104079,104079,104081,0,2,0
29753,5,3,104084,104084,104087,0,3,3
29754,6,1,104090,104090,104091,0,1,3
29755,2,2,104092,104092,104094,0,2,1
29756,3,1,104095,104095,104096,0,1,1
29757,4,3,104099,104099,104102,0,3,3
29758,1,1,104100,104102,104103,2,3,0
29759,1,2,104101,104103,104105,2,4,0
29760,4,2,104105,104105,104107,0,2,0
29761,2,3,104107,104107,104110,0,3,0
29762,3,1,104110,104110,104111,0,1,0
29763,5,3,104115,104115,104118,0,3,4
29764,2,2,104117,104118,104120,1,3,0
29765,4,1,104121,104121,104122,0,1,1
29766,1,3,104122,104122,104125,0,3,0
29767,3,2,104125,104125,104127,0,2,0
29768,1,1,104126,104127,104128,1,2,0
29769,5,2,104131,104131,104133,0,2,3
29770,3,3,104134,104134,104137,0,3,1
29771,3,1,104137,104137,104138,0,1,0
29772,5,3,104142,104142,104145,0,3,4
29773,3,2,104145,104145,104147,0,2,0
29774,5,2,104150,104150,104152,0,2,3
29775,2,1,104152,104152,104153,0,1,0
29776,1,1,104153,104153,104154,0,1,0
29777,6,2,104159,104159,104161,0,2,5
29778,3,3,104162,104162,104165,0,3,1
29779,6,3,104168,104168,104171,0,3,3
29780,4,2,104172,104172,104174,0,2,1
29781,6,1,104178,104178,104179,0,1,4
29782,3,3,104181,104181,104184,0,3,2
29783,5,1,104186,104186,104187,0,1,2
29784,6,2,104192,104192,104194,0,2,5
29785,5,3,104197,104197,104200,0,3,3
29786,3,3,104200,104200,104203,0,3,0
29787,2,1,104202,104203,104204,1,2,0
29788,6,2,104208,104208,104210,0,2,4
29789,3,1,104211,104211,104212,0,1,1
29790,6,1,104217,104217,104218,0,1,5
29791,4,3,104221,104221,104224,0,3,3
29792,5,3,104226,104226,104229,0,3,2
29793,5,2,104231,104231,104233,0,2,2
29794,3,3,104234,104234,104237,0,3,1
29795,2,3,104236,104237,104240,1,4,0
29796,3,3,104239,104240,104243,1,4,0
29797,5,3,104244,104244,104247,0,3,1
29798,1,3,104245,104247,104250,2,5,0
29799,6,2,104251,104251,104253,0,2,1
29800,3,2,104254,104254,104256,0,2,1
29801,5,2,104259,104259,104261,0,2,3
29802,2,1,104261,104261,104262,0,1,0
29803,2,1,104263,104263,104264,0,1,1
29804,1,1,104264,104264,104265,0,1,0
29805,5,2,104269,104269,104271,0,2,4
29806,2,1,104271,104271,104272,0,1,0
29807,4,3,104275,104275,104278,0,3,3
29808,1,2,104276,104278,104280,2,4,0
29809,4,3,104280,104280,104283,0,3,0
29810,2,2,104282,104283,104285,1,3,0
29811,5,2,104287,104287,104289,0,2,2
29812,1,2,104288,104289,104291,1,3,0
29813,2,1,104290,104291,104292,1,2,0
29814,5,2,104295,104295,104297,0,2,3
29815,3,3,104298,104298,104301,0,3,1
29816,6,1,104304,104304,104305,0,1,3
29817,1,1,104305,104305,104306,0,1,0
29818,3,1,104308,104308,104309,0,1,2
29819,6,2,104314,104314,104316,0,2,5
29820,3,2,104317,104317,104319,0,2,1
29821,4,3,104321,104321,104324,0,3,2
29822,4,3,104325,104325,104328,0,3,1
29823,4,1,104329,104329,104330,0,1,1
29824,6,2,104335,104335,104337,0,2,5
29825,3,2,104338,104338,104340,0,2,1
29826,6,3,104344,104344,104347,0,3,4
29827,5,1,104349,104349,104350,0,1,2
29828,3,1,104352,104352,104353,0,1,2
29829,6,2,104358,104358,104360,0,2,5
29830,6,1,104364,104364,104365,0,1,4
29831,6,3,104370,104370,104373,0,3,5
29832,4,3,104374,104374,104377,0,3,1
29833,4,1,104378,104378,104379,0,1,1
29834,6,2,104384,104384,104386,0,2,5
29835,6,1,104390,104390,104391,0,1,4
29836,2,1,104392,104392,104393,0,1,1
29837,3,1,104395,104395,104396,0,1,2
29838,5,3,104400,104400,104403,0,3,4
29839,1,1,104401,104403,104404,2,3,0
29840,1,3,104402,104404,104407,2,5,0
29841,3,2,104405,104407,104409,2,4,0
29842,3,3,104408,104409,104412,1,4,0
29843,2,1,104410,104412,104413,2,3,0
29844,4,1,104414,104414,104415,0,1,1
29845,5,2,104419,104419,104421,0,2,4
29846,1,3,104420,104421,104424,1,4,0
29847,4,2,104424,104424,104426,0,2,0
29848,5,2,104429,104429,104431,0,2,3
29849,2,1,104431,104431,104432,0,1,0
29850,6,3,104437,104437,104440,0,3,5
29851,2,1,104439,104440,104441,1,2,0
29852,2,1,104441,104441,104442,0,1,0
29853,6,2,104447,104447,104449,0,2,5
29854,5,3,104452,104452,104455,0,3,3
29855,6,1,104458,104458,104459,0,1,3
29856,5,2,104463,104463,104465,0,2,4
29857,4,2,104467,104467,104469,0,2,2
29858,2,3,104469,104469,104472,0,3,0
29859,1,1,104470,104472,104473,2,3,0
29860,1,3,104471,104473,104476,2,5,0
29861,3,3,104474,104476,104479,2,5,0
29862,1,1,104475,104479,104480,4,5,0
29863,1,2,104476,104480,104482,4,6,0
29864,4,2,104480,104482,104484,2,4,0
29865,5,2,104485,104485,104487,0,2,1
29866,3,3,104488,104488,104491,0,3,1
29867,4,2,104492,104492,104494,0,2,1
29868,4,2,104496,104496,104498,0,2,2
29869,4,3,104500,104500,104503,0,3,2
29870,5,2,104505,104505,104507,0,2,2
29871,1,1,104506,104507,104508,1,2,0
29872,4,1,104510,104510,104511,0,1,2
29873,4,1,104514,104514,104515,0,1,3
29874,6,1,104520,104520,104521,0,1,5
29875,1,2,104521,104521,104523,0,2,0
29876,1,2,104522,104523,104525,1,3,0
29877,4,3,104526,104526,104529,0,3,1
29878,6,3,104532,104532,104535,0,3,3
29879,6,2,104538,104538,104540,0,2,3
29880,2,1,104540,104540,104541,0,1,0
29881,5,3,104545,104545,104548,0,3,4
29882,2,1,104547,104548,104549,1,2,0
29883,5,3,104552,104552,104555,0,3,3
29884,4,2,104556,104556,104558,0,2,1
29885,5,3,104561,104561,104564,0,3,3
29886,4,3,104565,104565,104568,0,3,1
29887,4,3,104569,104569,104572,0,3,1
29888,4,3,104573,104573,104576,0,3,1
29889,6,2,104579,104579,104581,0,2,3
29890,4,3,104583,104583,104586,0,3,2
29891,1,3,104584,104586,104589,2,5,0
29892,4,2,104588,104589,104591,1,3,0
29893,3,2,104591,104591,104593,0,2,0
29894,6,3,104597,104597,104600,0,3,4
29895,4,2,104601,104601,104603,0,2,1
29896,1,3,104602,104603,104606,1,4,0
29897,2,2,104604,104606,104608,2,4,0
29898,2,2,104606,104608,104610,2,4,0
29899,5,2,104611,104611,104613,0,2,1
29900,2,2,104613,104613,104615,0,2,0
29901,4,3,104617,104617,104620,0,3,2
29902,3,2,104620,104620,104622,0,2,0
29903,1,2,104621,104622,104624,1,3,0
29904,2,2,104623,104624,104626,1,3,0
29905,6,1,104629,104629,104630,0,1,3
29906,4,2,104633,104633,104635,0,2,3
29907,3,3,104636,104636,104639,0,3,1
29908,1,2,104637,104639,104641,2,4,0
29909,1,1,104638,104641,104642,3,4,0
29910,4,2,104642,104642,104644,0,2,0
29911,6,3,104648,104648,104651,0,3,4
29912,6,2,104654,104654,104656,0,2,3
29913,6,3,104660,104660,104663,0,3,4
29914,1,1,104661,104663,104664,2,3,0
29915,1,1,104662,104664,104665,2,3,0
29916,2,3,104664,104665,104668,1,4,0
29917,2,3,104666,104668,104671,2,5,0
29918,1,2,104667,104671,104673,4,6,0
29919,1,2,104668,104673,104675,5,7,0
29920,3,2,104671,104675,104677,4,6,0
29921,2,2,104673,104677,104679,4,6,0
29922,2,3,104675,104679,104682,4,7,0
29923,6,1,104681,104682,104683,1,2,0
29924,3,1,104684,104684,104685,0,1,1
29925,2,3,104686,104686,104689,0,3,1
29926,5,1,104691,104691,104692,0,1,2
29927,1,3,104692,104692,104695,0,3,0
29928,6,3,104698,104698,104701,0,3,3
29929,2,1,104700,104701,104702,1,2,0
29930,5,3,104705,104705,104708,0,3,3
29931,4,3,104709,104709,104712,0,3,1
29932,6,2,104715,104715,104717,0,2,3
29933,3,3,104718,104718,104721,0,3,1
29934,5,1,104723,104723,104724,0,1,2
29935,4,3,104727,104727,104730,0,3,3
29936,1,3,104728,104730,104733,2,5,0
29937,5,1,104733,104733,104734,0,1,0
29938,4,2,104737,104737,104739,0,2,3
29939,4,2,104741,104741,104743,0,2,2
29940,2,1,104743,104743,104744,0,1,0
29941,6,1,104749,104749,104750,0,1,5
29942,2,1,104751,104751,104752,0,1,1
29943,2,3,104753,104753,104756,0,3,1
29944,1,1,104754,104756,104757,2,3,0
29945,6,1,104760,104760,104761,0,1,3
29946,2,3,104762,104762,104765,0,3,1
29947,2,1,104764,104765,104766,1,2,0
29948,1,1,104765,104766,104767,1,2,0
29949,3,2,104768,104768,104770,0,2,1
29950,1,3,104769,104770,104773,1,4,0
29951,6,1,104775,104775,104776,0,1,2
29952,5,3,104780,104780,104783,0,3,4
29953,4,3,104784,104784,104787,0,3,1
29954,6,1,104790,104790,104791,0,1,3
29955,6,2,104796,104796,104798,0,2,5
29956,6,3,104802,104802,104805,0,3,4
29957,4,2,104806,104806,104808,0,2,1
29958,4,1,104810,104810,104811,0,1,2
29959,3,1,104813,104813,104814,0,1,2
29960,1,3,104814,104814,104817,0,3,0
29961,1,1,104815,104817,104818,2,3,0
29962,6,3,104821,104821,104824,0,3,3
29963,6,1,104827,104827,104828,0,1,3
29964,3,3,104830,104830,104833,0,3,2
29965,4,2,104834,104834,104836,0,2,1
29966,6,1,104840,104840,104841,0,1,4
29967,5,2,104845,104845,104847,0,2,4
29968,3,1,104848,104848,104849,0,1,1
29969,4,3,104852,104852,104855,0,3,3
29970,2,1,104854,104855,104856,1,2,0
29971,6,2,104860,104860,104862,0,2,4
29972,5,1,104865,104865,104866,0,1,3
29973,4,2,104869,104869,104871,0,2,3
29974,3,2,104872,104872,104874,0,2,1
29975,1,3,104873,104874,104877,1,4,0
29976,3,3,104876,104877,104880,1,4,0
29977,6,3,104882,104882,104885,0,3,2
29978,2,3,104884,104885,104888,1,4,0
29979,3,1,104887,104888,104889,1,2,0
29980,1,2,104888,104889,104891,1,3,0
29981,4,3,104892,104892,104895,0,3,1
29982,2,1,104894,104895,104896,1,2,0
29983,5,2,104899,104899,104901,0,2,3
29984,2,2,104901,104901,104903,0,2,0
29985,5,3,104906,104906,104909,0,3,3
29986,5,1,104911,104911,104912,0,1,2
29987,4,1,104915,104915,104916,0,1,3
29988,6,1,104921,104921,104922,0,1,5
29989,4,2,104925,104925,104927,0,2,3
29990,4,1,104929,104929,104930,0,1,2
29991,5,3,104934,104934,104937,0,3,4
29992,5,1,104939,104939,104940,0,1,2
29993,1,2,104940,104940,104942,0,2,0
29994,6,2,104946,104946,104948,0,2,4
29995,1,3,104947,104948,104951,1,4,0
29996,3,2,104950,104951,104953,1,3,0
29997,1,3,104951,104953,104956,2,5,0
29998,3,1,104954,104956,104957,2,3,0
29999,6,3,104960,104960,104963,0,3,3
30000,1,2,104961,104963,104965,2,4,0
30001,5,1,104966,104966,104967,0,1,1
30002,6,2,104972,104972,104974,0,2,5
30003,4,2,104976,104976,104978,0,2,2
30004,3,1,104979,104979,104980,0,1,1
30005,1,3,104980,104980,104983,0,3,0
30006,6,1,104986,104986,104987,0,1,3
30007,2,3,104988,104988,104991,0,3,1
30008,6,2,104994,104994,104996,0,2,3
30009,2,2,104996,104996,104998,0,2,0
30010,1,1,104997,104998,104999,1,2,0
30011,6,2,105003,105003,105005,0,2,4
30012,2,3,105005,105005,105008,0,3,0
30013,4,2,105009,105009,105011,0,2,1
30014,3,2,105012,105012,105014,0,2,1
30015,4,1,105016,105016,105017,0,1,2
30016,2,1,105018,105018,105019,0,1,1
30017,5,3,105023,105023,105026,0,3,4
30018,2,2,105025,105026,105028,1,3,0
30019,6,1,105031,105031,105032,0,1,3
30020,3,3,105034,105034,105037,0,3,2
30021,4,1,105038,105038,105039,0,1,1
30022,2,2,105040,105040,105042,0,2,1
30023,6,3,105046,105046,105049,0,3,4
30024,6,1,105052,105052,105053,0,1,3
30025,4,1,105056,105056,105057,0,1,3
30026,5,2,105061,105061,105063,0,2,4
30027,4,1,105065,105065,105066,0,1,2
30028,5,3,105070,105070,105073,0,3,4
30029,5,1,105075,105075,105076,0,1,2
30030,2,1,105077,105077,105078,0,1,1
30031,6,1,105083,105083,105084,0,1,5
30032,6,1,105089,105089,105090,0,1,5
30033,6,3,105095,105095,105098,0,3,5
30034,3,3,105098,105098,105101,0,3,0
30035,2,1,105100,105101,105102,1,2,0
30036,2,3,105102,105102,105105,0,3,0
30037,1,3,105103,105105,105108,2,5,0
30038,6,2,105109,105109,105111,0,2,1
30039,3,2,105112,105112,105114,0,2,1
30040,6,1,105118,105118,105119,0,1,4
30041,5,1,105123,105123,105124,0,1,4
30042,5,3,105128,105128,105131,0,3,4
30043,3,3,105131,105131,105134,0,3,0
30044,5,3,105136,105136,105139,0,3,2
30045,6,1,105142,105142,105143,0,1,3
30046,2,3,105144,105144,105147,0,3,1
30047,3,1,105147,105147,105148,0,1,0
30048,6,3,105153,105153,105156,0,3,5
30049,6,3,105159,105159,105162,0,3,3
30050,2,3,105161,105162,105165,1,4,0
30051,1,2,105162,105165,105167,3,5,0
30052,5,3,105167,105167,105170,0,3,0
30053,5,3,105172,105172,105175,0,3,2
30054,2,3,105174,105175,105178,1,4,0
30055,1,2,105175,105178,105180,3,5,0
30056,1,2,105176,105180,105182,4,6,0
30057,1,3,105177,105182,105185,5,8,0
30058,5,1,105182,105185,105186,3,4,0
30059,1,1,105183,105186,105187,3,4,0
30060,4,3,105187,105187,105190,0,3,0
30061,2,1,105189,105190,105191,1,2,0
30062,6,2,105195,105195,105197,0,2,4
30063,1,1,105196,105197,105198,1,2,0
30064,4,3,105200,105200,105203,0,3,2
30065,6,3,105206,105206,105209,0,3,3
30066,5,2,105211,105211,105213,0,2,2
30067,6,1,105217,105217,105218,0,1,4
30068,1,2,105218,105218,105220,0,2,0
30069,6,2,105224,105224,105226,0,2,4
30070,6,1,105230,105230,105231,0,1,4
30071,4,3,105234,105234,105237,0,3,3
30072,1,3,105235,105237,105240,2,5,0
30073,6,3,105241,105241,105244,0,3,1
30074,6,3,105247,105247,105250,0,3,3
30075,1,1,105248,105250,105251,2,3,0
30076,4,2,105252,105252,105254,0,2,1
30077,3,1,105255,105255,105256,0,1,1
30078,6,2,105261,105261,105263,0,2,5
30079,4,1,105265,105265,105266,0,1,2
30080,1,3,105266,105266,105269,0,3,0
30081,2,2,105268,105269,105271,1,3,0
30082,2,2,105270,105271,105273,1,3,0
30083,5,3,105275,105275,105278,0,3,2
30084,3,1,105278,105278,105279,0,1,0
30085,1,1,105279,105279,105280,0,1,0
30086,5,2,105284,105284,105286,0,2,4
30087,6,3,105290,105290,105293,0,3,4
30088,4,3,105294,105294,105297,0,3,1
30089,4,3,105298,105298,105301,0,3,1
30090,1,3,105299,105301,105304,2,5,0
30091,1,2,105300,105304,105306,4,6,0
30092,1,2,105301,105306,105308,5,7,0
30093,6,3,105307,105308,105311,1,4,0
30094,5,1,105312,105312,105313,0,1,1
30095,2,1,105314,105314,105315,0,1,1
30096,5,3,105319,105319,105322,0,3,4
30097,4,2,105323,105323,105325,0,2,1
30098,3,2,105326,105326,105328,0,2,1
30099,6,2,105332,105332,105334,0,2,4
30100,4,3,105336,105336,105339,0,3,2
30101,3,2,105339,105339,105341,0,2,0
30102,5,2,105344,105344,105346,0,2,3
30103,6,1,105350,105350,105351,0,1,4
30104,6,2,105356,105356,105358,0,2,5
30105,1,2,105357,105358,105360,1,3,0
30106,3,1,105360,105360,105361,0,1,0
30107,6,1,105366,105366,105367,0,1,5
30108,4,2,105370,105370,105372,0,2,3
30109,2,1,105372,105372,105373,0,1,0
30110,5,2,105377,105377,105379,0,2,4
30111,5,3,105382,105382,105385,0,3,3
30112,2,1,105384,105385,105386,1,2,0
30113,3,1,105387,105387,105388,0,1,1
30114,5,1,105392,105392,105393,0,1,4
30115,6,2,105398,105398,105400,0,2,5
30116,2,1,105400,105400,105401,0,1,0
30117,5,2,105405,105405,105407,0,2,4
30118,2,2,105407,105407,105409,0,2,0
30119,4,2,105411,105411,105413,0,2,2
30120,2,1,105413,105413,105414,0,1,0
30121,3,3,105416,105416,105419,0,3,2
30122,1,3,105417,105419,105422,2,5,0
30123,6,3,105423,105423,105426,0,3,1
30124,2,2,105425,105426,105428,1,3,0
30125,1,1,105426,105428,105429,2,3,0
30126,2,3,105428,105429,105432,1,4,0
30127,1,1,105429,105432,105433,3,4,0
30128,2,3,105431,105433,105436,2,5,0
30129,1,3,105432,105436,105439,4,7,0
30130,6,2,105438,105439,105441,1,3,0
30131,6,3,105444,105444,105447,0,3,3
30132,3,2,105447,105447,105449,0,2,0
30133,1,2,105448,105449,105451,1,3,0
30134,6,1,105454,105454,105455,0,1,3
30135,4,1,105458,105458,105459,0,1,3
30136,6,2,105464,105464,105466,0,2,5
30137,2,1,105466,105466,105467,0,1,0
30138,5,1,105471,105471,105472,0,1,4
30139,1,2,105472,105472,105474,0,2,0
30140,5,3,105477,105477,105480,0,3,3
30141,5,2,105482,105482,105484,0,2,2
30142,2,2,105484,105484,105486,0,2,0
30143,4,3,105488,105488,105491,0,3,2
30144,5,3,105493,105493,105496,0,3,2
30145,6,1,105499,105499,105500,0,1,3
30146,6,1,105505,105505,105506,0,1,5
30147,5,1,105510,105510,105511,0,1,4
30148,4,3,105514,105514,105517,0,3,3
30149,5,3,105519,105519,105522,0,3,2
30150,6,2,105525,105525,105527,0,2,3
30151,2,2,105527,105527,105529,0,2,0
30152,4,2,105531,105531,105533,0,2,2
30153,3,1,105534,105534,105535,0,1,1
30154,6,3,105540,105540,105543,0,3,5
30155,1,3,105541,105543,105546,2,5,0
30156,6,1,105547,105547,105548,0,1,1
30157,5,2,105552,105552,105554,0,2,4
30158,1,2,105553,105554,105556,1,3,0
30159,6,3,105559,105559,105562,0,3,3
30160,6,1,105565,105565,105566,0,1,3
30161,3,2,105568,105568,105570,0,2,2
30162,3,1,105571,105571,105572,0,1,1
30163,6,1,105577,105577,105578,0,1,5
30164,5,1,105582,105582,105583,0,1,4
30165,3,3,105585,105585,105588,0,3,2
30166,1,2,105586,105588,105590,2,4,0
30167,5,2,105591,105591,105593,0,2,1
30168,1,2,105592,105593,105595,1,3,0
30169,3,1,105595,105595,105596,0,1,0
30170,6,2,105601,105601,105603,0,2,5
30171,6,3,105607,105607,105610,0,3,4
30172,3,2,105610,105610,105612,0,2,0
30173,5,3,105615,105615,105618,0,3,3
30174,6,2,105621,105621,105623,0,2,3
30175,4,1,105625,105625,105626,0,1,2
30176,6,3,105631,105631,105634,0,3,5
30177,3,1,105634,105634,105635,0,1,0
30178,5,2,105639,105639,105641,0,2,4
30179,3,3,105642,105642,105645,0,3,1
30180,6,1,105648,105648,105649,0,1,3
30181,6,3,105654,105654,105657,0,3,5
30182,6,3,105660,105660,105663,0,3,3
30183,5,3,105665,105665,105668,0,3,2
30184,2,2,105667,105668,105670,1,3,0
30185,2,2,105669,105670,105672,1,3,0
30186,5,1,105674,105674,105675,0,1,2
30187,3,2,105677,105677,105679,0,2,2
30188,5,2,105682,105682,105684,0,2,3
30189,4,1,105686,105686,105687,0,1,2
30190,6,2,105692,105692,105694,0,2,5
30191,4,1,105696,105696,105697,0,1,2
30192,2,2,105698,105698,105700,0,2,1
30193,1,2,105699,105700,105702,1,3,0
30194,6,3,105705,105705,105708,0,3,3
30195,3,1,105708,105708,105709,0,1,0
30196,1,2,105709,105709,105711,0,2,0
30197,3,1,105712,105712,105713,0,1,1
30198,2,1,105714,105714,105715,0,1,1
30199,4,2,105718,105718,105720,0,2,3
30200,1,2,105719,105720,105722,1,3,0
30201,1,2,105720,105722,105724,2,4,0
30202,5,1,105725,105725,105726,0,1,1
30203,5,3,105730,105730,105733,0,3,4
30204,4,1,105734,105734,105735,0,1,1
30205,1,2,105735,105735,105737,0,2,0
30206,6,3,105741,105741,105744,0,3,4
30207,5,3,105746,105746,105749,0,3,2
30208,5,2,105751,105751,105753,0,2,2
30209,3,1,105754,105754,105755,0,1,1
30210,5,2,105759,105759,105761,0,2,4
30211,6,3,105765,105765,105768,0,3,4
30212,2,2,105767,105768,105770,1,3,0
30213,3,2,105770,105770,105772,0,2,0
30214,3,1,105773,105773,105774,0,1,1
30215,4,1,105777,105777,105778,0,1,3
30216,4,2,105781,105781,105783,0,2,3
30217,3,3,105784,105784,105787,0,3,1
30218,4,3,105788,105788,105791,0,3,1
30219,4,1,105792,105792,105793,0,1,1
30220,2,3,105794,105794,105797,0,3,1
30221,2,1,105796,105797,105798,1,2,0
30222,5,1,105801,105801,105802,0,1,3
30223,3,3,105804,105804,105807,0,3,2
30224,5,2,105809,105809,105811,0,2,2
30225,5,1,105814,105814,105815,0,1,3
30226,6,3,105820,105820,105823,0,3,5
30227,6,2,105826,105826,105828,0,2,3
30228,4,1,105830,105830,105831,0,1,2
30229,6,3,105836,105836,105839,0,3,5
30230,2,1,105838,105839,105840,1,2,0
30231,6,1,105844,105844,105845,0,1,4
30232,4,2,105848,105848,105850,0,2,3
30233,3,1,105851,105851,105852,0,1,1
30234,3,2,105854,105854,105856,0,2,2
30235,1,3,105855,105856,105859,1,4,0
30236,5,1,105860,105860,105861,0,1,1
30237,6,3,105866,105866,105869,0,3,5
30238,2,2,105868,105869,105871,1,3,0
30239,2,1,105870,105871,105872,1,2,0
30240,6,3,105876,105876,105879,0,3,4
30241,6,2,105882,105882,105884,0,2,3
30242,6,3,105888,105888,105891,0,3,4
30243,4,1,105892,105892,105893,0,1,1
30244,3,3,105895,105895,105898,0,3,2
30245,2,3,105897,105898,105901,1,4,0
30246,6,1,105903,105903,105904,0,1,2
30247,5,2,105908,105908,105910,0,2,4
30248,6,1,105914,105914,105915,0,1,4
30249,1,2,105915,105915,105917,0,2,0
30250,2,1,105917,105917,105918,0,1,0
30251,5,3,105922,105922,105925,0,3,4
30252,6,3,105928,105928,105931,0,3,3
30253,3,1,105931,105931,105932,0,1,0
30254,2,1,105933,105933,105934,0,1,1
30255,5,1,105938,105938,105939,0,1,4
30256,1,3,105939,105939,105942,0,3,0
30257,5,2,105944,105944,105946,0,2,2
30258,4,1,105948,105948,105949,0,1,2
30259,3,3,105951,105951,105954,0,3,2
30260,3,2,105954,105954,105956,0,2,0
30261,4,2,105958,105958,105960,0,2,2
30262,5,1,105963,105963,105964,0,1,3
30263,1,2,105964,105964,105966,0,2,0
30264,2,1,105966,105966,105967,0,1,0
30265,5,1,105971,105971,105972,0,1,4
30266,6,1,105977,105977,105978,0,1,5
30267,1,2,105978,105978,105980,0,2,0
30268,5,3,105983,105983,105986,0,3,3
30269,5,1,105988,105988,105989,0,1,2
30270,4,3,105992,105992,105995,0,3,3
30271,4,1,105996,105996,105997,0,1,1
30272,4,3,106000,106000,106003,0,3,3
30273,6,3,106006,106006,106009,0,3,3
30274,2,1,106008,106009,106010,1,2,0
30275,6,1,106014,106014,106015,0,1,4
30276,6,2,106020,106020,106022,0,2,5
30277,3,3,106023,106023,106026,0,3,1
30278,6,3,106029,106029,106032,0,3,3
30279,2,2,106031,106032,106034,1,3,0
30280,2,3,106033,106034,106037,1,4,0
30281,4,3,106037,106037,106040,0,3,0
30282,3,2,106040,106040,106042,0,2,0
30283,4,2,106044,106044,106046,0,2,2
30284,3,1,106047,106047,106048,0,1,1
30285,4,1,106051,106051,106052,0,1,3
30286,2,2,106053,106053,106055,0,2,1
30287,4,1,106057,106057,106058,0,1,2
30288,2,2,106059,106059,106061,0,2,1
30289,6,3,106065,106065,106068,0,3,4
30290,4,1,106069,106069,106070,0,1,1
30291,4,1,106073,106073,106074,0,1,3
30292,1,2,106074,106074,106076,0,2,0
30293,2,3,106076,106076,106079,0,3,0
30294,4,3,106080,106080,106083,0,3,1
30295,6,2,106086,106086,106088,0,2,3
30296,2,3,106088,106088,106091,0,3,0
30297,1,3,106089,106091,106094,2,5,0
30298,1,2,106090,106094,106096,4,6,0
30299,1,1,106091,106096,106097,5,6,0
30300,6,3,106097,106097,106100,0,3,0
30301,1,1,106098,106100,106101,2,3,0
30302,4,2,106102,106102,106104,0,2,1
30303,4,2,106106,106106,106108,0,2,2
30304,2,3,106108,106108,106111,0,3,0
30305,1,1,106109,106111,106112,2,3,0
30306,3,1,106112,106112,106113,0,1,0
30307,4,3,106116,106116,106119,0,3,3
30308,1,1,106117,106119,106120,2,3,0
30309,2,3,106119,106120,106123,1,4,0
30310,3,2,106122,106123,106125,1,3,0
30311,1,3,106123,106125,106128,2,5,0
30312,2,2,106125,106128,106130,3,5,0
30313,1,2,106126,106130,106132,4,6,0
30314,6,3,106132,106132,106135,0,3,0
30315,2,2,106134,106135,106137,1,3,0
30316,1,1,106135,106137,106138,2,3,0
30317,4,2,106139,106139,106141,0,2,1
30318,1,1,106140,106141,106142,1,2,0
30319,5,2,106145,106145,106147,0,2,3
30320,3,1,106148,106148,106149,0,1,1
30321,6,2,106154,106154,106156,0,2,5
30322,2,2,106156,106156,106158,0,2,0
30323,1,1,106157,106158,106159,1,2,0
30324,1,1,106158,106159,106160,1,2,0
30325,4,1,106162,106162,106163,0,1,2
30326,6,2,106168,106168,106170,0,2,5
30327,2,3,106170,106170,106173,0,3,0
30328,3,2,106173,106173,106175,0,2,0
30329,1,3,106174,106175,106178,1,4,0
30330,6,3,106180,106180,106183,0,3,2
30331,5,2,106185,106185,106187,0,2,2
30332,5,2,106190,106190,106192,0,2,3
30333,4,1,106194,106194,106195,0,1,2
30334,1,3,106195,106195,106198,0,3,0
30335,6,1,106201,106201,106202,0,1,3
30336,6,3,106207,106207,106210,0,3,5
30337,1,2,106208,106210,106212,2,4,0
30338,2,2,106210,106212,106214,2,4,0
30339,4,1,106214,106214,106215,0,1,0
30340,1,1,106215,106215,106216,0,1,0
30341,4,3,106219,106219,106222,0,3,3
30342,1,2,106220,106222,106224,2,4,0
30343,5,1,106225,106225,106226,0,1,1
30344,2,3,106227,106227,106230,0,3,1
30345,2,2,106229,106230,106232,1,3,0
30346,2,2,106231,106232,106234,1,3,0
30347,1,1,106232,106234,106235,2,3,0
30348,6,1,106238,106238,106239,0,1,3
30349,6,3,106244,106244,106247,0,3,5
30350,6,3,106250,106250,106253,0,3,3
30351,4,3,106254,106254,106257,0,3,1
30352,5,2,106259,106259,106261,0,2,2
30353,5,1,106264,106264,106265,0,1,3
30354,3,2,106267,106267,106269,0,2,2
30355,1,2,106268,106269,106271,1,3,0
30356,2,2,106270,106271,106273,1,3,0
30357,2,2,106272,106273,106275,1,3,0
30358,1,2,106273,106275,106277,2,4,0
30359,5,3,106278,106278,106281,0,3,1
30360,1,3,106279,106281,106284,2,5,0
30361,4,2,106283,106284,106286,1,3,0
30362,2,1,106285,106286,106287,1,2,0
30363,3,1,106288,106288,106289,0,1,1
30364,2,3,106290,106290,106293,0,3,1
30365,6,1,106296,106296,106297,0,1,3
30366,1,3,106297,106297,106300,0,3,0
30367,3,1,106300,106300,106301,0,1,0
30368,6,1,106306,106306,106307,0,1,5
30369,3,3,106309,106309,106312,0,3,2
30370,6,2,106315,106315,106317,0,2,3
30371,2,1,106317,106317,106318,0,1,0
30372,4,3,106321,106321,106324,0,3,3
30373,4,1,106325,106325,106326,0,1,1
30374,3,2,106328,106328,106330,0,2,2
30375,5,2,106333,106333,106335,0,2,3
30376,6,3,106339,106339,106342,0,3,4
30377,5,1,106344,106344,106345,0,1,2
30378,5,3,106349,106349,106352,0,3,4
30379,4,3,106353,106353,106356,0,3,1
30380,5,1,106358,106358,106359,0,1,2
30381,5,2,106363,106363,106365,0,2,4
30382,2,1,106365,106365,106366,0,1,0
30383,3,2,106368,106368,106370,0,2,2
30384,2,2,106370,106370,106372,0,2,0
30385,1,1,106371,106372,106373,1,2,0
30386,4,2,106375,106375,106377,0,2,2
30387,5,2,106380,106380,106382,0,2,3
30388,2,1,106382,106382,106383,0,1,0
30389,4,2,106386,106386,106388,0,2,3
30390,4,2,106390,106390,106392,0,2,2
30391,5,1,106395,106395,106396,0,1,3
30392,2,1,106397,106397,106398,0,1,1
30393,2,1,106399,106399,106400,0,1,1
30394,4,2,106403,106403,106405,0,2,3
30395,3,1,106406,106406,106407,0,1,1
30396,3,2,106409,106409,106411,0,2,2
30397,6,1,106415,106415,106416,0,1,4
30398,1,3,106416,106416,106419,0,3,0
30399,5,3,106421,106421,106424,0,3,2
30400,2,3,106423,106424,106427,1,4,0
30401,4,2,106427,106427,106429,0,2,0
30402,4,1,106431,106431,106432,0,1,2
30403,5,2,106436,106436,106438,0,2,4
30404,4,1,106440,106440,106441,0,1,2
30405,2,1,106442,106442,106443,0,1,1
30406,3,2,106445,106445,106447,0,2,2
30407,4,2,106449,106449,106451,0,2,2
30408,6,1,106455,106455,106456,0,1,4
30409,5,2,106460,106460,106462,0,2,4
30410,2,1,106462,106462,106463,0,1,0
30411,4,3,106466,106466,106469,0,3,3
30412,2,2,106468,106469,106471,1,3,0
30413,4,1,106472,106472,106473,0,1,1
30414,3,1,106475,106475,106476,0,1,2
30415,6,3,106481,106481,106484,0,3,5
30416,5,3,106486,106486,106489,0,3,2
30417,4,3,106490,106490,106493,0,3,1
30418,4,3,106494,106494,106497,0,3,1
30419,5,2,106499,106499,106501,0,2,2
30420,2,2,106501,106501,106503,0,2,0
30421,2,2,106503,106503,106505,0,2,0
30422,3,3,106506,106506,106509,0,3,1
30423,1,3,106507,106509,106512,2,5,0
30424,3,2,106510,106512,106514,2,4,0
30425,3,2,106513,106514,106516,1,3,0
30426,3,1,106516,106516,106517,0,1,0
30427,2,1,106518,106518,106519,0,1,1
30428,1,1,106519,106519,106520,0,1,0
30429,1,3,106520,106520,106523,0,3,0
30430,4,3,106524,106524,106527,0,3,1
30431,2,1,106526,106527,106528,1,2,0
30432,1,3,106527,106528,106531,1,4,0
30433,1,2,106528,106531,106533,3,5,0
30434,3,1,106531,106533,106534,2,3,0
30435,3,2,106534,106534,106536,0,2,0
30436,2,3,106536,106536,106539,0,3,0
30437,3,2,106539,106539,106541,0,2,0
30438,3,2,106542,106542,106544,0,2,1
30439,6,2,106548,106548,106550,0,2,4
30440,6,1,106554,106554,106555,0,1,4
30441,4,1,106558,106558,106559,0,1,3
30442,2,1,106560,106560,106561,0,1,1
30443,1,1,106561,106561,106562,0,1,0
30444,2,1,106563,106563,106564,0,1,1
30445,3,3,106566,106566,106569,0,3,2
30446,2,1,106568,106569,106570,1,2,0
30447,5,1,106573,106573,106574,0,1,3
30448,4,3,106577,106577,106580,0,3,3
30449,1,3,106578,106580,106583,2,5,0
30450,3,1,106581,106583,106584,2,3,0
30451,5,1,106586,106586,106587,0,1,2
30452,5,1,106591,106591,106592,0,1,4
30453,1,2,106592,106592,106594,0,2,0
30454,6,3,106598,106598,106601,0,3,4
30455,1,3,106599,106601,106604,2,5,0
30456,1,1,106600,106604,106605,4,5,0
30457,3,1,106603,106605,106606,2,3,0
30458,3,2,106606,106606,106608,0,2,0
30459,6,3,106612,106612,106615,0,3,4
30460,1,2,106613,106615,106617,2,4,0
30461,3,3,106616,106617,106620,1,4,0
30462,1,1,106617,106620,106621,3,4,0
30463,3,2,106620,106621,106623,1,3,0
30464,5,2,106625,106625,106627,0,2,2
30465,2,3,106627,106627,106630,0,3,0
30466,5,1,106632,106632,106633,0,1,2
30467,3,1,106635,106635,106636,0,1,2
30468,3,2,106638,106638,106640,0,2,2
30469,2,1,106640,106640,106641,0,1,0
30470,5,2,106645,106645,106647,0,2,4
30471,6,1,106651,106651,106652,0,1,4
30472,6,2,106657,106657,106659,0,2,5
30473,1,1,106658,106659,106660,1,2,0
30474,5,1,106663,106663,106664,0,1,3
30475,1,3,106664,106664,106667,0,3,0
30476,1,3,106665,106667,106670,2,5,0
30477,6,3,106671,106671,106674,0,3,1
30478,2,2,106673,106674,106676,1,3,0
30479,3,3,106676,106676,106679,0,3,0
30480,1,2,106677,106679,106681,2,4,0
30481,5,3,106682,106682,106685,0,3,1
30482,5,3,106687,106687,106690,0,3,2
30483,1,2,106688,106690,106692,2,4,0
30484,6,3,106694,106694,106697,0,3,2
30485,4,2,106698,106698,106700,0,2,1
30486,1,1,106699,106700,106701,1,2,0
30487,3,3,106702,106702,106705,0,3,1
30488,3,3,106705,106705,106708,0,3,0
30489,4,3,106709,106709,106712,0,3,1
30490,1,3,106710,106712,106715,2,5,0
30491,6,2,106716,106716,106718,0,2,1
30492,6,1,106722,106722,106723,0,1,4
30493,1,2,106723,106723,106725,0,2,0
30494,1,2,106724,106725,106727,1,3,0
30495,6,2,106730,106730,106732,0,2,3
30496,3,3,106733,106733,106736,0,3,1
30497,5,2,106738,106738,106740,0,2,2
30498,5,3,106743,106743,106746,0,3,3
30499,6,2,106749,106749,106751,0,2,3
30500,4,1,106753,106753,106754,0,1,2
30501,6,3,106759,106759,106762,0,3,5
30502,2,1,106761,106762,106763,1,2,0
30503,2,2,106763,106763,106765,0,2,0
30504,4,1,106767,106767,106768,0,1,2
30505,4,3,106771,106771,106774,0,3,3
30506,6,2,106777,106777,106779,0,2,3
30507,4,3,106781,106781,106784,0,3,2
30508,6,3,106787,106787,106790,0,3,3
30509,6,3,106793,106793,106796,0,3,3
30510,1,1,106794,106796,106797,2,3,0
30511,1,1,106795,106797,106798,2,3,0
30512,5,2,106800,106800,106802,0,2,2
30513,1,2,106801,106802,106804,1,3,0
30514,2,2,106803,106804,106806,1,3,0
30515,2,1,106805,106806,106807,1,2,0
30516,6,3,106811,106811,106814,0,3,4
30517,5,1,106816,106816,106817,0,1,2
30518,2,2,106818,106818,106820,0,2,1
30519,1,1,106819,106820,106821,1,2,0
30520,5,2,106824,106824,106826,0,2,3
30521,3,2,106827,106827,106829,0,2,1
30522,6,2,106833,106833,106835,0,2,4
30523,2,2,106835,106835,106837,0,2,0
30524,4,2,106839,106839,106841,0,2,2
30525,5,1,106844,106844,106845,0,1,3
30526,1,2,106845,106845,106847,0,2,0
30527,4,1,106849,106849,106850,0,1,2
30528,1,1,106850,106850,106851,0,1,0
30529,4,1,106854,106854,106855,0,1,3
30530,3,3,106857,106857,106860,0,3,2
30531,1,3,106858,106860,106863,2,5,0
30532,4,3,106862,106863,106866,1,4,0
30533,3,3,106865,106866,106869,1,4,0
30534,3,2,106868,106869,106871,1,3,0
30535,3,3,106871,106871,106874,0,3,0
30536,1,3,106872,106874,106877,2,5,0
30537,6,1,106878,106878,106879,0,1,1
30538,1,1,106879,106879,106880,0,1,0
30539,4,3,106883,106883,106886,0,3,3
30540,1,1,106884,106886,106887,2,3,0
30541,2,2,106886,106887,106889,1,3,0
30542,6,1,106892,106892,106893,0,1,3
30543,3,2,106895,106895,106897,0,2,2
30544,3,2,106898,106898,106900,0,2,1
30545,5,1,106903,106903,106904,0,1,3
30546,3,2,106906,106906,106908,0,2,2
30547,4,2,106910,106910,106912,0,2,2
30548,4,3,106914,106914,106917,0,3,2
30549,1,1,106915,106917,106918,2,3,0
30550,3,2,106918,106918,106920,0,2,0
30551,1,3,106919,106920,106923,1,4,0
30552,1,3,106920,106923,106926,3,6,0
30553,1,3,106921,106926,106929,5,8,0
30554,3,1,106924,106929,106930,5,6,0
30555,5,2,106929,106930,106932,1,3,0
30556,3,2,106932,106932,106934,0,2,0
30557,2,3,106934,106934,106937,0,3,0
30558,3,3,106937,106937,106940,0,3,0
30559,1,1,106938,106940,106941,2,3,0
30560,5,1,106943,106943,106944,0,1,2
30561,6,1,106949,106949,106950,0,1,5
30562,4,1,106953,106953,106954,0,1,3
30563,4,2,106957,106957,106959,0,2,3
30564,1,2,106958,106959,106961,1,3,0
30565,4,1,106962,106962,106963,0,1,1
30566,2,3,106964,106964,106967,0,3,1
30567,4,3,106968,106968,106971,0,3,1
30568,4,3,106972,106972,106975,0,3,1
30569,6,1,106978,106978,106979,0,1,3
30570,5,2,106983,106983,106985,0,2,4
30571,1,3,106984,106985,106988,1,4,0
30572,1,1,106985,106988,106989,3,4,0
30573,1,1,106986,106989,106990,3,4,0
30574,5,2,106991,106991,106993,0,2,1
30575,1,3,106992,106993,106996,1,4,0
30576,1,2,106993,106996,106998,3,5,0
30577,1,2,106994,106998,107000,4,6,0
30578,3,1,106997,107000,107001,3,4,0
30579,5,3,107002,107002,107005,0,3,1
30580,5,3,107007,107007,107010,0,3,2
30581,6,3,107013,107013,107016,0,3,3
30582,2,1,107015,107016,107017,1,2,0
30583,1,3,107016,107017,107020,1,4,0
30584,5,2,107021,107021,107023,0,2,1
30585,1,2,107022,107023,107025,1,3,0
30586,4,2,107026,107026,107028,0,2,1
30587,1,3,107027,107028,107031,1,4,0
30588,6,1,107033,107033,107034,0,1,2
30589,1,1,107034,107034,107035,0,1,0
30590,2,3,107036,107036,107039,0,3,1
30591,6,3,107042,107042,107045,0,3,3
30592,6,2,107048,107048,107050,0,2,3
30593,3,1,107051,107051,107052,0,1,1
30594,5,3,107056,107056,107059,0,3,4
30595,5,2,107061,107061,107063,0,2,2
30596,6,1,107067,107067,107068,0,1,4
30597,5,3,107072,107072,107075,0,3,4
30598,6,2,107078,107078,107080,0,2,3
30599,1,1,107079,107080,107081,1,2,0
30600,6,3,107085,107085,107088,0,3,4
30601,4,1,107089,107089,107090,0,1,1
30602,3,1,107092,107092,107093,0,1,2
30603,6,2,107098,107098,107100,0,2,5
30604,5,2,107103,107103,107105,0,2,3
30605,4,3,107107,107107,107110,0,3,2
30606,6,1,107113,107113,107114,0,1,3
30607,3,1,107116,107116,107117,0,1,2
30608,3,3,107119,107119,107122,0,3,2
30609,5,2,107124,107124,107126,0,2,2
30610,2,1,107126,107126,107127,0,1,0
30611,4,3,107130,107130,107133,0,3,3
30612,4,3,107134,107134,107137,0,3,1
30613,6,1,107140,107140,107141,0,1,3
30614,4,1,107144,107144,107145,0,1,3
30615,5,2,107149,107149,107151,0,2,4
30616,1,3,107150,107151,107154,1,4,0
30617,3,3,107153,107154,107157,1,4,0
30618,6,2,107159,107159,107161,0,2,2
30619,4,1,107163,107163,107164,0,1,2
30620,6,2,107169,107169,107171,0,2,5
30621,4,3,107173,107173,107176,0,3,2
30622,3,1,107176,107176,107177,0,1,0
30623,5,2,107181,107181,107183,0,2,4
30624,6,1,107187,107187,107188,0,1,4
30625,4,2,107191,107191,107193,0,2,3
30626,4,2,107195,107195,107197,0,2,2
30627,1,3,107196,107197,107200,1,4,0
30628,4,2,107200,107200,107202,0,2,0
30629,1,1,107201,107202,107203,1,2,0
30630,6,3,107207,107207,107210,0,3,4
30631,6,1,107213,107213,107214,0,1,3
30632,2,2,107215,107215,107217,0,2,1
30633,2,2,107217,107217,107219,0,2,0
30634,6,1,107223,107223,107224,0,1,4
30635,2,2,107225,107225,107227,0,2,1
30636,1,1,107226,107227,107228,1,2,0
30637,4,2,107230,107230,107232,0,2,2
30638,3,2,107233,107233,107235,0,2,1
30639,1,1,107234,107235,107236,1,2,0
30640,4,1,107238,107238,107239,0,1,2
30641,4,2,107242,107242,107244,0,2,3
30642,3,1,107245,107245,107246,0,1,1
30643,1,1,107246,107246,107247,0,1,0
30644,1,3,107247,107247,107250,0,3,0
30645,3,1,107250,107250,107251,0,1,0
30646,3,3,107253,107253,107256,0,3,2
30647,1,1,107254,107256,107257,2,3,0
30648,5,3,107259,107259,107262,0,3,2
30649,6,1,107265,107265,107266,0,1,3
30650,3,2,107268,107268,107270,0,2,2
30651,4,2,107272,107272,107274,0,2,2
30652,2,3,107274,107274,107277,0,3,0
30653,1,1,107275,107277,107278,2,3,0
30654,2,2,107277,107278,107280,1,3,0
30655,2,1,107279,107280,107281,1,2,0
30656,1,3,107280,107281,107284,1,4,0
30657,5,2,107285,107285,107287,0,2,1
30658,6,2,107291,107291,107293,0,2,4
30659,2,1,107293,107293,107294,0,1,0
30660,6,1,107299,107299,107300,0,1,5
30661,2,2,107301,107301,107303,0,2,1
30662,2,3,107303,107303,107306,0,3,0
30663,1,3,107304,107306,107309,2,5,0
30664,4,2,107308,107309,107311,1,3,0
30665,2,2,107310,107311,107313,1,3,0
30666,5,3,107315,107315,107318,0,3,2
30667,6,1,107321,107321,107322,0,1,3
30668,5,3,107326,107326,107329,0,3,4
30669,5,3,107331,107331,107334,0,3,2
30670,1,2,107332,107334,107336,2,4,0
30671,5,1,107337,107337,107338,0,1,1
30672,1,2,107338,107338,107340,0,2,0
30673,6,3,107344,107344,107347,0,3,4
30674,3,3,107347,107347,107350,0,3,0
30675,6,3,107353,107353,107356,0,3,3
30676,5,3,107358,107358,107361,0,3,2
30677,4,2,107362,107362,107364,0,2,1
30678,1,3,107363,107364,107367,1,4,0
30679,3,3,107366,107367,107370,1,4,0
30680,1,1,107367,107370,107371,3,4,0
30681,3,1,107370,107371,107372,1,2,0
30682,1,3,107371,107372,107375,1,4,0
30683,2,3,107373,107375,107378,2,5,0
30684,2,2,107375,107378,107380,3,5,0
30685,6,3,107381,107381,107384,0,3,1
30686,3,2,107384,107384,107386,0,2,0
30687,3,1,107387,107387,107388,0,1,1
30688,3,1,107390,107390,107391,0,1,2
30689,3,2,107393,107393,107395,0,2,2
30690,1,3,107394,107395,107398,1,4,0
30691,4,3,107398,107398,107401,0,3,0
30692,6,3,107404,107404,107407,0,3,3
30693,5,1,107409,107409,107410,0,1,2
30694,6,2,107415,107415,107417,0,2,5
30695,2,2,107417,107417,107419,0,2,0
30696,3,3,107420,107420,107423,0,3,1
30697,2,3,107422,107423,107426,1,4,0
30698,6,1,107428,107428,107429,0,1,2
30699,2,2,107430,107430,107432,0,2,1
30700,1,2,107431,107432,107434,1,3,0
30701,4,2,107435,107435,107437,0,2,1
30702,4,2,107439,107439,107441,0,2,2
30703,2,3,107441,107441,107444,0,3,0
30704,5,3,107446,107446,107449,0,3,2
30705,4,3,107450,107450,107453,0,3,1
30706,4,2,107454,107454,107456,0,2,1
30707,1,3,107455,107456,107459,1,4,0
30708,5,3,107460,107460,107463,0,3,1
30709,2,2,107462,107463,107465,1,3,0
30710,2,1,107464,107465,107466,1,2,0
30711,6,2,107470,107470,107472,0,2,4
30712,3,2,107473,107473,107475,0,2,1
30713,6,2,107479,107479,107481,0,2,4
30714,4,1,107483,107483,107484,0,1,2
30715,3,1,107486,107486,107487,0,1,2
30716,1,2,107487,107487,107489,0,2,0
30717,6,1,107493,107493,107494,0,1,4
30718,6,1,107499,107499,107500,0,1,5
30719,4,2,107503,107503,107505,0,2,3
30720,3,3,107506,107506,107509,0,3,1
30721,3,3,107509,107509,107512,0,3,0
30722,3,1,107512,107512,107513,0,1,0
30723,5,1,107517,107517,107518,0,1,4
30724,3,1,107520,107520,107521,0,1,2
30725,3,1,107523,107523,107524,0,1,2
30726,4,2,107527,107527,107529,0,2,3
30727,5,3,107532,107532,107535,0,3,3
30728,3,2,107535,107535,107537,0,2,0
30729,4,1,107539,107539,107540,0,1,2
30730,2,2,107541,107541,107543,0,2,1
30731,1,3,107542,107543,107546,1,4,0
30732,4,3,107546,107546,107549,0,3,0
30733,5,1,107551,107551,107552,0,1,2
30734,3,2,107554,107554,107556,0,2,2
30735,6,3,107560,107560,107563,0,3,4
30736,5,2,107565,107565,107567,0,2,2
30737,2,3,107567,107567,107570,0,3,0
30738,2,1,107569,107570,107571,1,2,0
30739,6,3,107575,107575,107578,0,3,4
30740,3,1,107578,107578,107579,0,1,0
30741,1,2,107579,107579,107581,0,2,0
30742,1,2,107580,107581,107583,1,3,0
30743,1,3,107581,107583,107586,2,5,0
30744,1,2,107582,107586,107588,4,6,0
30745,6,3,107588,107588,107591,0,3,0
30746,3,1,107591,107591,107592,0,1,0
30747,6,1,107597,107597,107598,0,1,5
30748,2,1,107599,107599,107600,0,1,1
30749,5,3,107604,107604,107607,0,3,4
30750,5,1,107609,107609,107610,0,1,2
30751,4,3,107613,107613,107616,0,3,3
30752,5,3,107618,107618,107621,0,3,2
30753,3,2,107621,107621,107623,0,2,0
30754,1,2,107622,107623,107625,1,3,0
30755,2,2,107624,107625,107627,1,3,0
30756,5,3,107629,107629,107632,0,3,2
30757,5,3,107634,107634,107637,0,3,2
30758,3,2,107637,107637,107639,0,2,0
30759,4,3,107641,107641,107644,0,3,2
30760,2,2,107643,107644,107646,1,3,0
30761,3,3,107646,107646,107649,0,3,0
30762,3,1,107649,107649,107650,0,1,0
30763,2,2,107651,107651,107653,0,2,1
30764,2,3,107653,107653,107656,0,3,0
30765,1,3,107654,107656,107659,2,5,0
30766,5,1,107659,107659,107660,0,1,0
30767,5,3,107664,107664,107667,0,3,4
30768,3,1,107667,107667,107668,0,1,0
30769,4,2,107671,107671,107673,0,2,3
30770,5,2,107676,107676,107678,0,2,3
30771,6,1,107682,107682,107683,0,1,4
30772,3,1,107685,107685,107686,0,1,2
30773,1,2,107686,107686,107688,0,2,0
30774,4,3,107690,107690,107693,0,3,2
30775,2,1,107692,107693,107694,1,2,0
30776,5,3,107697,107697,107700,0,3,3
30777,3,2,107700,107700,107702,0,2,0
30778,5,1,107705,107705,107706,0,1,3
30779,3,2,107708,107708,107710,0,2,2
30780,4,2,107712,107712,107714,0,2,2
30781,2,2,107714,107714,107716,0,2,0
30782,1,2,107715,107716,107718,1,3,0
30783,5,2,107720,107720,107722,0,2,2
30784,2,3,107722,107722,107725,0,3,0
30785,4,3,107726,107726,107729,0,3,1
30786,3,3,107729,107729,107732,0,3,0
30787,2,1,107731,107732,107733,1,2,0
30788,4,1,107735,107735,107736,0,1,2
30789,4,3,107739,107739,107742,0,3,3
30790,5,1,107744,107744,107745,0,1,2
30791,3,3,107747,107747,107750,0,3,2
30792,3,3,107750,107750,107753,0,3,0
30793,6,3,107756,107756,107759,0,3,3
30794,6,1,107762,107762,107763,0,1,3
30795,1,2,107763,107763,107765,0,2,0
30796,6,1,107769,107769,107770,0,1,4
30797,3,3,107772,107772,107775,0,3,2
30798,5,1,107777,107777,107778,0,1,2
30799,4,3,107781,107781,107784,0,3,3
30800,3,3,107784,107784,107787,0,3,0
30801,1,1,107785,107787,107788,2,3,0
30802,2,1,107787,107788,107789,1,2,0
30803,1,1,107788,107789,107790,1,2,0
30804,6,2,107794,107794,107796,0,2,4
30805,4,2,107798,107798,107800,0,2,2
30806,3,3,107801,107801,107804,0,3,1
30807,6,3,107807,107807,107810,0,3,3
30808,6,3,107813,107813,107816,0,3,3
30809,4,2,107817,107817,107819,0,2,1
30810,2,1,107819,107819,107820,0,1,0
30811,6,2,107825,107825,107827,0,2,5
30812,5,1,107830,107830,107831,0,1,3
30813,5,2,107835,107835,107837,0,2,4
30814,6,3,107841,107841,107844,0,3,4
30815,3,1,107844,107844,107845,0,1,0
30816,3,1,107847,107847,107848,0,1,2
30817,3,1,107850,107850,107851,0,1,2
30818,4,2,107854,107854,107856,0,2,3
30819,6,2,107860,107860,107862,0,2,4
30820,4,1,107864,107864,107865,0,1,2
30821,5,1,107869,107869,107870,0,1,4
30822,1,2,107870,107870,107872,0,2,0
30823,1,2,107871,107872,107874,1,3,0
30824,3,1,107874,107874,107875,0,1,0
30825,3,2,107877,107877,107879,0,2,2
30826,2,2,107879,107879,107881,0,2,0
30827,3,2,107882,107882,107884,0,2,1
30828,6,3,107888,107888,107891,0,3,4
30829,2,2,107890,107891,107893,1,3,0
30830,2,3,107892,107893,107896,1,4,0
30831,4,3,107896,107896,107899,0,3,0
30832,5,2,107901,107901,107903,0,2,2
30833,5,3,107906,107906,107909,0,3,3
30834,2,3,107908,107909,107912,1,4,0
30835,5,3,107913,107913,107916,0,3,1
30836,2,2,107915,107916,107918,1,3,0
30837,6,2,107921,107921,107923,0,2,3
30838,4,2,107925,107925,107927,0,2,2
30839,1,1,107926,107927,107928,1,2,0
30840,6,1,107932,107932,107933,0,1,4
30841,1,3,107933,107933,107936,0,3,0
30842,4,1,107937,107937,107938,0,1,1
30843,5,1,107942,107942,107943,0,1,4
30844,1,3,107943,107943,107946,0,3,0
30845,5,2,107948,107948,107950,0,2,2
30846,6,1,107954,107954,107955,0,1,4
30847,4,2,107958,107958,107960,0,2,3
30848,3,3,107961,107961,107964,0,3,1
30849,5,1,107966,107966,107967,0,1,2
30850,1,3,107967,107967,107970,0,3,0
30851,2,1,107969,107970,107971,1,2,0
30852,4,2,107973,107973,107975,0,2,2
30853,1,3,107974,107975,107978,1,4,0
30854,4,2,107978,107978,107980,0,2,0
30855,2,2,107980,107980,107982,0,2,0
30856,6,2,107986,107986,107988,0,2,4
30857,4,3,107990,107990,107993,0,3,2
30858,3,2,107993,107993,107995,0,2,0
30859,2,1,107995,107995,107996,0,1,0
30860,4,1,107999,107999,108000,0,1,3
30861,3,1,108002,108002,108003,0,1,2
30862,2,2,108004,108004,108006,0,2,1
30863,1,3,108005,108006,108009,1,4,0
30864,6,3,108011,108011,108014,0,3,2
30865,3,2,108014,108014,108016,0,2,0
30866,1,1,108015,108016,108017,1,2,0
30867,3,1,108018,108018,108019,0,1,1
30868,6,3,108024,108024,108027,0,3,5
30869,4,3,108028,108028,108031,0,3,1
30870,6,3,108034,108034,108037,0,3,3
30871,2,1,108036,108037,108038,1,2,0
30872,2,1,108038,108038,108039,0,1,0
30873,2,3,108040,108040,108043,0,3,1
30874,4,3,108044,108044,108047,0,3,1
30875,4,1,108048,108048,108049,0,1,1
30876,2,2,108050,108050,108052,0,2,1
30877,4,3,108054,108054,108057,0,3,2
30878,4,1,108058,108058,108059,0,1,1
30879,5,3,108063,108063,108066,0,3,4
30880,6,1,108069,108069,108070,0,1,3
30881,6,2,108075,108075,108077,0,2,5
30882,4,3,108079,108079,108082,0,3,2
30883,2,1,108081,108082,108083,1,2,0
30884,3,3,108084,108084,108087,0,3,1
30885,1,3,108085,108087,108090,2,5,0
30886,2,2,108087,108090,108092,3,5,0
30887,4,2,108091,108092,108094,1,3,0
30888,2,2,108093,108094,108096,1,3,0
30889,6,1,108099,108099,108100,0,1,3
30890,5,1,108104,108104,108105,0,1,4
30891,6,2,108110,108110,108112,0,2,5
30892,2,1,108112,108112,108113,0,1,0
30893,6,3,108118,108118,108121,0,3,5
30894,6,1,108124,108124,108125,0,1,3
30895,6,3,108130,108130,108133,0,3,5
30896,4,2,108134,108134,108136,0,2,1
30897,6,1,108140,108140,108141,0,1,4
30898,3,1,108143,108143,108144,0,1,2
30899,1,2,108144,108144,108146,0,2,0
30900,2,1,108146,108146,108147,0,1,0
30901,5,3,108151,108151,108154,0,3,4
30902,3,2,108154,108154,108156,0,2,0
30903,5,3,108159,108159,108162,0,3,3
30904,5,1,108164,108164,108165,0,1,2
30905,1,2,108165,108165,108167,0,2,0
30906,1,3,108166,108167,108170,1,4,0
30907,4,3,108170,108170,108173,0,3,0
30908,6,3,108176,108176,108179,0,3,3
30909,1,3,108177,108179,108182,2,5,0
30910,4,3,108181,108182,108185,1,4,0
30911,2,3,108183,108185,108188,2,5,0
30912,3,1,108186,108188,108189,2,3,0
30913,6,1,108192,108192,108193,0,1,3
30914,4,2,108196,108196,108198,0,2,3
30915,4,2,108200,108200,108202,0,2,2
30916,2,1,108202,108202,108203,0,1,0
30917,6,3,108208,108208,108211,0,3,5
30918,5,3,108213,108213,108216,0,3,2
30919,1,2,108214,108216,108218,2,4,0
30920,1,1,108215,108218,108219,3,4,0
30921,2,2,108217,108219,108221,2,4,0
30922,1,1,108218,108221,108222,3,4,0
30923,1,2,108219,108222,108224,3,5,0
30924,4,2,108223,108224,108226,1,3,0
30925,1,3,108224,108226,108229,2,5,0
30926,6,1,108230,108230,108231,0,1,1
30927,3,1,108233,108233,108234,0,1,2
30928,6,3,108239,108239,108242,0,3,5
30929,3,1,108242,108242,108243,0,1,0
30930,4,2,108246,108246,108248,0,2,3
30931,5,2,108251,108251,108253,0,2,3
30932,3,2,108254,108254,108256,0,2,1
30933,3,3,108257,108257,108260,0,3,1
30934,5,2,108262,108262,108264,0,2,2
30935,1,1,108263,108264,108265,1,2,0
30936,3,2,108266,108266,108268,0,2,1
30937,1,3,108267,108268,108271,1,4,0
30938,4,3,108271,108271,108274,0,3,0
30939,2,2,108273,108274,108276,1,3,0
30940,3,1,108276,108276,108277,0,1,0
30941,6,1,108282,108282,108283,0,1,5
30942,1,2,108283,108283,108285,0,2,0
30943,1,2,108284,108285,108287,1,3,0
30944,6,1,108290,108290,108291,0,1,3
30945,2,2,108292,108292,108294,0,2,1
30946,5,2,108297,108297,108299,0,2,3
30947,5,2,108302,108302,108304,0,2,3
30948,6,1,108308,108308,108309,0,1,4
30949,3,1,108311,108311,108312,0,1,2
30950,3,1,108314,108314,108315,0,1,2
30951,6,2,108320,108320,108322,0,2,5
30952,2,3,108322,108322,108325,0,3,0
30953,2,2,108324,108325,108327,1,3,0
30954,1,3,108325,108327,108330,2,5,0
30955,5,2,108330,108330,108332,0,2,0
30956,3,3,108333,108333,108336,0,3,1
30957,6,2,108339,108339,108341,0,2,3
30958,3,1,108342,108342,108343,0,1,1
30959,3,3,108345,108345,108348,0,3,2
30960,5,1,108350,108350,108351,0,1,2
30961,2,3,108352,108352,108355,0,3,1
30962,1,1,108353,108355,108356,2,3,0
30963,2,2,108355,108356,108358,1,3,0
30964,6,1,108361,108361,108362,0,1,3
30965,3,1,108364,108364,108365,0,1,2
30966,3,3,108367,108367,108370,0,3,2
30967,3,2,108370,108370,108372,0,2,0
30968,2,3,108372,108372,108375,0,3,0
30969,5,2,108377,108377,108379,0,2,2
30970,3,3,108380,108380,108383,0,3,1
30971,4,1,108384,108384,108385,0,1,1
30972,2,2,108386,108386,108388,0,2,1
30973,4,2,108390,108390,108392,0,2,2
30974,3,2,108393,108393,108395,0,2,1
30975,2,1,108395,108395,108396,0,1,0
30976,4,1,108399,108399,108400,0,1,3
30977,3,2,108402,108402,108404,0,2,2
30978,3,1,108405,108405,108406,0,1,1
30979,5,2,108410,108410,108412,0,2,4
30980,3,1,108413,108413,108414,0,1,1
30981,2,3,108415,108415,108418,0,3,1
30982,1,1,108416,108418,108419,2,3,0
30983,2,3,108418,108419,108422,1,4,0
30984,2,2,108420,108422,108424,2,4,0
30985,3,1,108423,108424,108425,1,2,0
30986,1,3,108424,108425,108428,1,4,0
30987,3,2,108427,108428,108430,1,3,0
30988,3,2,108430,108430,108432,0,2,0
30989,3,2,108433,108433,108435,0,2,1
30990,2,3,108435,108435,108438,0,3,0
30991,1,3,108436,108438,108441,2,5,0
30992,3,1,108439,108441,108442,2,3,0
30993,5,3,108444,108444,108447,0,3,2
30994,4,1,108448,108448,108449,0,1,1
30995,5,2,108453,108453,108455,0,2,4
30996,2,1,108455,108455,108456,0,1,0
30997,2,2,108457,108457,108459,0,2,1
30998,6,2,108463,108463,108465,0,2,4
30999,3,3,108466,108466,108469,0,3,1
31000,6,1,108472,108472,108473,0,1,3
31001,1,1,108473,108473,108474,0,1,0
31002,2,2,108475,108475,108477,0,2,1
31003,2,3,108477,108477,108480,0,3,0
31004,3,3,108480,108480,108483,0,3,0
31005,1,3,108481,108483,108486,2,5,0
31006,4,3,108485,108486,108489,1,4,0
31007,1,1,108486,108489,108490,3,4,0
31008,3,2,108489,108490,108492,1,3,0
31009,4,2,108493,108493,108495,0,2,1
31010,3,1,108496,108496,108497,0,1,1
31011,2,2,108498,108498,108500,0,2,1
31012,4,2,108502,108502,108504,0,2,2
31013,6,1,108508,108508,108509,0,1,4
31014,1,1,108509,108509,108510,0,1,0
31015,6,2,108515,108515,108517,0,2,5
31016,1,1,108516,108517,108518,1,2,0
31017,5,2,108521,108521,108523,0,2,3
31018,2,2,108523,108523,108525,0,2,0
31019,5,1,108528,108528,108529,0,1,3
31020,6,3,108534,108534,108537,0,3,5
31021,4,2,108538,108538,108540,0,2,1
31022,4,1,108542,108542,108543,0,1,2
31023,5,1,108547,108547,108548,0,1,4
31024,6,3,108553,108553,108556,0,3,5
31025,3,1,108556,108556,108557,0,1,0
31026,2,2,108558,108558,108560,0,2,1
31027,5,1,108563,108563,108564,0,1,3
31028,5,1,108568,108568,108569,0,1,4
31029,6,1,108574,108574,108575,0,1,5
31030,6,2,108580,108580,108582,0,2,5
31031,2,2,108582,108582,108584,0,2,0
31032,2,1,108584,108584,108585,0,1,0
31033,4,2,108588,108588,108590,0,2,3
31034,3,2,108591,108591,108593,0,2,1
31035,5,3,108596,108596,108599,0,3,3
31036,3,1,108599,108599,108600,0,1,0
31037,4,1,108603,108603,108604,0,1,3
31038,6,3,108609,108609,108612,0,3,5
31039,2,2,108611,108612,108614,1,3,0
31040,3,3,108614,108614,108617,0,3,0
31041,5,1,108619,108619,108620,0,1,2
31042,3,2,108622,108622,108624,0,2,2
31043,3,1,108625,108625,108626,0,1,1
31044,4,3,108629,108629,108632,0,3,3
31045,6,2,108635,108635,108637,0,2,3
31046,6,3,108641,108641,108644,0,3,4
31047,5,3,108646,108646,108649,0,3,2
31048,5,3,108651,108651,108654,0,3,2
31049,5,3,108656,108656,108659,0,3,2
31050,2,1,108658,108659,108660,1,2,0
31051,3,1,108661,108661,108662,0,1,1
31052,3,3,108664,108664,108667,0,3,2
31053,4,1,108668,108668,108669,0,1,1
31054,6,2,108674,108674,108676,0,2,5
31055,1,1,108675,108676,108677,1,2,0
31056,3,1,108678,108678,108679,0,1,1
31057,1,3,108679,108679,108682,0,3,0
31058,1,2,108680,108682,108684,2,4,0
31059,1,2,108681,108684,108686,3,5,0
31060,1,3,108682,108686,108689,4,7,0
31061,4,2,108686,108689,108691,3,5,0
31062,1,2,108687,108691,108693,4,6,0
31063,3,2,108690,108693,108695,3,5,0
31064,6,1,108696,108696,108697,0,1,1
31065,5,1,108701,108701,108702,0,1,4
31066,1,3,108702,108702,108705,0,3,0
31067,5,3,108707,108707,108710,0,3,2
31068,4,3,108711,108711,108714,0,3,1
31069,2,3,108713,108714,108717,1,4,0
31070,2,3,108715,108717,108720,2,5,0
31071,2,3,108717,108720,108723,3,6,0
31072,6,3,108723,108723,108726,0,3,0
31073,2,3,108725,108726,108729,1,4,0
31074,3,3,108728,108729,108732,1,4,0
31075,5,2,108733,108733,108735,0,2,1
31076,4,1,108737,108737,108738,0,1,2
31077,5,1,108742,108742,108743,0,1,4
31078,3,1,108745,108745,108746,0,1,2
31079,3,3,108748,108748,108751,0,3,2
31080,6,1,108754,108754,108755,0,1,3
31081,5,1,108759,108759,108760,0,1,4
31082,3,1,108762,108762,108763,0,1,2
31083,2,3,108764,108764,108767,0,3,1
31084,3,1,108767,108767,108768,0,1,0
31085,1,2,108768,108768,108770,0,2,0
31086,3,3,108771,108771,108774,0,3,1
31087,5,2,108776,108776,108778,0,2,2
31088,2,3,108778,108778,108781,0,3,0
31089,5,2,108783,108783,108785,0,2,2
31090,3,3,108786,108786,108789,0,3,1
31091,4,1,108790,108790,108791,0,1,1
31092,3,1,108793,108793,108794,0,1,2
31093,3,1,108796,108796,108797,0,1,2
31094,3,1,108799,108799,108800,0,1,2
31095,6,2,108805,108805,108807,0,2,5
31096,5,1,108810,108810,108811,0,1,3
31097,6,2,108816,108816,108818,0,2,5
31098,2,3,108818,108818,108821,0,3,0
31099,6,2,108824,108824,108826,0,2,3
31100,1,3,108825,108826,108829,1,4,0
31101,2,2,108827,108829,108831,2,4,0
31102,3,2,108830,108831,108833,1,3,0
31103,6,1,108836,108836,108837,0,1,3
31104,5,2,108841,108841,108843,0,2,4
31105,5,1,108846,108846,108847,0,1,3
31106,4,3,108850,108850,108853,0,3,3
31107,1,3,108851,108853,108856,2,5,0
31108,6,3,108857,108857,108860,0,3,1
31109,1,1,108858,108860,108861,2,3,0
31110,3,3,108861,108861,108864,0,3,0
31111,6,1,108867,108867,108868,0,1,3
31112,2,1,108869,108869,108870,0,1,1
31113,1,3,108870,108870,108873,0,3,0
31114,5,2,108875,108875,108877,0,2,2
31115,1,2,108876,108877,108879,1,3,0
31116,2,1,108878,108879,108880,1,2,0
31117,3,3,108881,108881,108884,0,3,1
31118,2,2,108883,108884,108886,1,3,0
31119,6,3,108889,108889,108892,0,3,3
31120,3,2,108892,108892,108894,0,2,0
31121,6,3,108898,108898,108901,0,3,4
31122,1,3,108899,108901,108904,2,5,0
31123,4,3,108903,108904,108907,1,4,0
31124,3,2,108906,108907,108909,1,3,0
31125,1,1,108907,108909,108910,2,3,0
31126,2,2,108909,108910,108912,1,3,0
31127,3,1,108912,108912,108913,0,1,0
31128,1,1,108913,108913,108914,0,1,0
31129,1,2,108914,108914,108916,0,2,0
31130,2,1,108916,108916,108917,0,1,0
31131,3,1,108919,108919,108920,0,1,2
31132,4,3,108923,108923,108926,0,3,3
31133,4,1,108927,108927,108928,0,1,1
31134,5,1,108932,108932,108933,0,1,4
31135,3,1,108935,108935,108936,0,1,2
31136,3,3,108938,108938,108941,0,3,2
31137,4,3,108942,108942,108945,0,3,1
31138,6,1,108948,108948,108949,0,1,3
31139,1,1,108949,108949,108950,0,1,0
31140,3,3,108952,108952,108955,0,3,2
31141,2,2,108954,108955,108957,1,3,0
31142,1,1,108955,108957,108958,2,3,0
31143,6,1,108961,108961,108962,0,1,3
31144,5,2,108966,108966,108968,0,2,4
31145,5,1,108971,108971,108972,0,1,3
31146,1,3,108972,108972,108975,0,3,0
31147,1,2,108973,108975,108977,2,4,0
31148,4,1,108977,108977,108978,0,1,0
31149,4,1,108981,108981,108982,0,1,3
31150,5,1,108986,108986,108987,0,1,4
31151,4,2,108990,108990,108992,0,2,3
31152,2,3,108992,108992,108995,0,3,0
31153,4,2,108996,108996,108998,0,2,1
31154,3,2,108999,108999,109001,0,2,1
31155,1,2,109000,109001,109003,1,3,0
31156,4,1,109004,109004,109005,0,1,1
31157,6,2,109010,109010,109012,0,2,5
31158,4,1,109014,109014,109015,0,1,2
31159,6,3,109020,109020,109023,0,3,5
31160,5,1,109025,109025,109026,0,1,2
31161,5,1,109030,109030,109031,0,1,4
31162,4,2,109034,109034,109036,0,2,3
31163,5,1,109039,109039,109040,0,1,3
31164,3,2,109042,109042,109044,0,2,2
31165,2,1,109044,109044,109045,0,1,0
31166,4,2,109048,109048,109050,0,2,3
31167,1,3,109049,109050,109053,1,4,0
31168,2,3,109051,109053,109056,2,5,0
31169,1,2,109052,109056,109058,4,6,0
31170,5,2,109057,109058,109060,1,3,0
31171,3,3,109060,109060,109063,0,3,0
31172,6,1,109066,109066,109067,0,1,3
31173,1,2,109067,109067,109069,0,2,0
31174,6,3,109073,109073,109076,0,3,4
31175,3,3,109076,109076,109079,0,3,0
31176,4,3,109080,109080,109083,0,3,1
31177,2,3,109082,109083,109086,1,4,0
31178,6,3,109088,109088,109091,0,3,2
31179,4,2,109092,109092,109094,0,2,1
31180,6,2,109098,109098,109100,0,2,4
31181,6,1,109104,109104,109105,0,1,4
31182,4,1,109108,109108,109109,0,1,3
31183,2,1,109110,109110,109111,0,1,1
31184,4,3,109114,109114,109117,0,3,3
31185,3,3,109117,109117,109120,0,3,0
31186,3,1,109120,109120,109121,0,1,0
31187,6,1,109126,109126,109127,0,1,5
31188,4,2,109130,109130,109132,0,2,3
31189,2,3,109132,109132,109135,0,3,0
31190,6,1,109138,109138,109139,0,1,3
31191,3,3,109141,109141,109144,0,3,2
31192,4,3,109145,109145,109148,0,3,1
31193,5,2,109150,109150,109152,0,2,2
31194,2,2,109152,109152,109154,0,2,0
31195,2,3,109154,109154,109157,0,3,0
31196,4,1,109158,109158,109159,0,1,1
31197,1,2,109159,109159,109161,0,2,0
31198,1,1,109160,109161,109162,1,2,0
31199,5,3,109165,109165,109168,0,3,3
31200,6,1,109171,109171,109172,0,1,3
31201,6,3,109177,109177,109180,0,3,5
31202,5,1,109182,109182,109183,0,1,2
31203,6,3,109188,109188,109191,0,3,5
31204,6,1,109194,109194,109195,0,1,3
31205,5,3,109199,109199,109202,0,3,4
31206,3,2,109202,109202,109204,0,2,0
31207,5,3,109207,109207,109210,0,3,3
31208,3,3,109210,109210,109213,0,3,0
31209,2,1,109212,109213,109214,1,2,0
31210,1,1,109213,109214,109215,1,2,0
31211,6,1,109219,109219,109220,0,1,4
31212,5,3,109224,109224,109227,0,3,4
31213,4,3,109228,109228,109231,0,3,1
31214,3,2,109231,109231,109233,0,2,0
31215,1,3,109232,109233,109236,1,4,0
31216,4,1,109236,109236,109237,0,1,0
31217,1,2,109237,109237,109239,0,2,0
31218,3,3,109240,109240,109243,0,3,1
31219,1,3,109241,109243,109246,2,5,0
31220,1,2,109242,109246,109248,4,6,0
31221,3,2,109245,109248,109250,3,5,0
31222,6,2,109251,109251,109253,0,2,1
31223,6,3,109257,109257,109260,0,3,4
31224,1,3,109258,109260,109263,2,5,0
31225,6,1,109264,109264,109265,0,1,1
31226,6,1,109270,109270,109271,0,1,5
31227,4,3,109274,109274,109277,0,3,3
31228,1,2,109275,109277,109279,2,4,0
31229,4,1,109279,109279,109280,0,1,0
31230,5,1,109284,109284,109285,0,1,4
31231,3,3,109287,109287,109290,0,3,2
31232,6,1,109293,109293,109294,0,1,3
31233,4,1,109297,109297,109298,0,1,3
31234,6,1,109303,109303,109304,0,1,5
31235,1,3,109304,109304,109307,0,3,0
31236,3,3,109307,109307,109310,0,3,0
31237,6,2,109313,109313,109315,0,2,3
31238,3,1,109316,109316,109317,0,1,1
31239,2,1,109318,109318,109319,0,1,1
31240,2,3,109320,109320,109323,0,3,1
31241,4,1,109324,109324,109325,0,1,1
31242,3,1,109327,109327,109328,0,1,2
31243,3,3,109330,109330,109333,0,3,2
31244,2,3,109332,109333,109336,1,4,0
31245,5,1,109337,109337,109338,0,1,1
31246,2,2,109339,109339,109341,0,2,1
31247,4,2,109343,109343,109345,0,2,2
31248,4,2,109347,109347,109349,0,2,2
31249,5,3,109352,109352,109355,0,3,3
31250,6,1,109358,109358,109359,0,1,3
31251,6,1,109364,109364,109365,0,1,5
31252,6,3,109370,109370,109373,0,3,5
31253,2,1,109372,109373,109374,1,2,0
31254,5,1,109377,109377,109378,0,1,3
31255,1,1,109378,109378,109379,0,1,0
31256,6,3,109384,109384,109387,0,3,5
31257,2,2,109386,109387,109389,1,3,0
31258,1,2,109387,109389,109391,2,4,0
31259,2,1,109389,109391,109392,2,3,0
31260,1,1,109390,109392,109393,2,3,0
31261,6,3,109396,109396,109399,0,3,3
31262,2,1,109398,109399,109400,1,2,0
31263,5,1,109403,109403,109404,0,1,3
31264,5,2,109408,109408,109410,0,2,4
31265,4,1,109412,109412,109413,0,1,2
31266,5,3,109417,109417,109420,0,3,4
31267,4,1,109421,109421,109422,0,1,1
31268,5,1,109426,109426,109427,0,1,4
31269,1,3,109427,109427,109430,0,3,0
31270,5,3,109432,109432,109435,0,3,2
31271,1,1,109433,109435,109436,2,3,0
31272,6,2,109439,109439,109441,0,2,3
31273,1,3,109440,109441,109444,1,4,0
31274,2,3,109442,109444,109447,2,5,0
31275,5,1,109447,109447,109448,0,1,0
31276,1,2,109448,109448,109450,0,2,0
31277,2,2,109450,109450,109452,0,2,0
31278,3,1,109453,109453,109454,0,1,1
31279,6,3,109459,109459,109462,0,3,5
31280,2,3,109461,109462,109465,1,4,0
31281,5,3,109466,109466,109469,0,3,1
31282,2,3,109468,109469,109472,1,4,0
31283,5,1,109473,109473,109474,0,1,1
31284,6,1,109479,109479,109480,0,1,5
31285,6,1,109485,109485,109486,0,1,5
31286,3,1,109488,109488,109489,0,1,2
31287,5,1,109493,109493,109494,0,1,4
31288,1,1,109494,109494,109495,0,1,0
31289,6,2,109500,109500,109502,0,2,5
31290,2,3,109502,109502,109505,0,3,0
31291,6,1,109508,109508,109509,0,1,3
31292,1,2,109509,109509,109511,0,2,0
31293,3,2,109512,109512,109514,0,2,1
31294,5,2,109517,109517,109519,0,2,3
31295,1,3,109518,109519,109522,1,4,0
31296,2,1,109520,109522,109523,2,3,0
31297,2,2,109522,109523,109525,1,3,0
31298,2,3,109524,109525,109528,1,4,0
31299,2,3,109526,109528,109531,2,5,0
31300,1,1,109527,109531,109532,4,5,0
31301,6,3,109533,109533,109536,0,3,1
31302,5,3,109538,109538,109541,0,3,2
31303,1,2,109539,109541,109543,2,4,0
31304,3,3,109542,109543,109546,1,4,0
31305,3,1,109545,109546,109547,1,2,0
31306,6,3,109551,109551,109554,0,3,4
31307,4,1,109555,109555,109556,0,1,1
31308,5,1,109560,109560,109561,0,1,4
31309,6,2,109566,109566,109568,0,2,5
31310,1,1,109567,109568,109569,1,2,0
31311,3,2,109570,109570,109572,0,2,1
31312,6,2,109576,109576,109578,0,2,4
31313,5,2,109581,109581,109583,0,2,3
31314,3,2,109584,109584,109586,0,2,1
31315,3,1,109587,109587,109588,0,1,1
31316,5,2,109592,109592,109594,0,2,4
31317,1,1,109593,109594,109595,1,2,0
31318,4,1,109597,109597,109598,0,1,2
31319,2,2,109599,109599,109601,0,2,1
31320,5,1,109604,109604,109605,0,1,3
31321,3,1,109607,109607,109608,0,1,2
31322,2,1,109609,109609,109610,0,1,1
31323,3,2,109612,109612,109614,0,2,2
31324,3,3,109615,109615,109618,0,3,1
31325,5,1,109620,109620,109621,0,1,2
31326,5,2,109625,109625,109627,0,2,4
31327,4,3,109629,109629,109632,0,3,2
31328,6,1,109635,109635,109636,0,1,3
31329,2,1,109637,109637,109638,0,1,1
31330,4,2,109641,109641,109643,0,2,3
31331,5,3,109646,109646,109649,0,3,3
31332,3,3,109649,109649,109652,0,3,0
31333,1,3,109650,109652,109655,2,5,0
31334,3,3,109653,109655,109658,2,5,0
31335,2,2,109655,109658,109660,3,5,0
31336,2,3,109657,109660,109663,3,6,0
31337,3,1,109660,109663,109664,3,4,0
31338,4,3,109664,109664,109667,0,3,0
31339,3,1,109667,109667,109668,0,1,0
31340,2,2,109669,109669,109671,0,2,1
31341,2,1,109671,109671,109672,0,1,0
31342,5,3,109676,109676,109679,0,3,4
31343,1,2,109677,109679,109681,2,4,0
31344,2,2,109679,109681,109683,2,4,0
31345,4,2,109683,109683,109685,0,2,0
31346,6,3,109689,109689,109692,0,3,4
31347,5,3,109694,109694,109697,0,3,2
31348,4,2,109698,109698,109700,0,2,1
31349,1,2,109699,109700,109702,1,3,0
31350,1,1,109700,109702,109703,2,3,0
31351,4,2,109704,109704,109706,0,2,1
31352,5,3,109709,109709,109712,0,3,3
31353,2,2,109711,109712,109714,1,3,0
31354,6,2,109717,109717,109719,0,2,3
31355,1,1,109718,109719,109720,1,2,0
31356,3,1,109721,109721,109722,0,1,1
31357,4,3,109725,109725,109728,0,3,3
31358,5,1,109730,109730,109731,0,1,2
31359,1,2,109731,109731,109733,0,2,0
31360,3,1,109734,109734,109735,0,1,1
31361,6,2,109740,109740,109742,0,2,5
31362,6,3,109746,109746,109749,0,3,4
31363,5,1,109751,109751,109752,0,1,2
31364,5,2,109756,109756,109758,0,2,4
31365,6,1,109762,109762,109763,0,1,4
31366,2,3,109764,109764,109767,0,3,1
31367,2,1,109766,109767,109768,1,2,0
31368,4,3,109770,109770,109773,0,3,2
31369,4,2,109774,109774,109776,0,2,1
31370,1,3,109775,109776,109779,1,4,0
31371,2,3,109777,109779,109782,2,5,0
31372,3,1,109780,109782,109783,2,3,0
31373,2,2,109782,109783,109785,1,3,0
31374,2,2,109784,109785,109787,1,3,0
31375,4,3,109788,109788,109791,0,3,1
31376,2,2,109790,109791,109793,1,3,0
31377,6,3,109796,109796,109799,0,3,3
31378,3,3,109799,109799,109802,0,3,0
31379,1,3,109800,109802,109805,2,5,0
31380,3,3,109803,109805,109808,2,5,0
31381,5,1,109808,109808,109809,0,1,0
31382,6,2,109814,109814,109816,0,2,5
31383,2,2,109816,109816,109818,0,2,0
31384,6,1,109822,109822,109823,0,1,4
31385,2,1,109824,109824,109825,0,1,1
31386,1,2,109825,109825,109827,0,2,0
31387,2,2,109827,109827,109829,0,2,0
31388,6,3,109833,109833,109836,0,3,4
31389,2,1,109835,109836,109837,1,2,0
31390,1,2,109836,109837,109839,1,3,0
31391,3,1,109839,109839,109840,0,1,0
31392,2,1,109841,109841,109842,0,1,1
31393,4,2,109845,109845,109847,0,2,3
31394,1,1,109846,109847,109848,1,2,0
31395,5,1,109851,109851,109852,0,1,3
31396,5,3,109856,109856,109859,0,3,4
31397,2,3,109858,109859,109862,1,4,0
31398,6,2,109864,109864,109866,0,2,2
31399,1,1,109865,109866,109867,1,2,0
31400,4,1,109869,109869,109870,0,1,2
31401,1,2,109870,109870,109872,0,2,0
31402,3,2,109873,109873,109875,0,2,1
31403,6,2,109879,109879,109881,0,2,4
31404,6,3,109885,109885,109888,0,3,4
31405,1,3,109886,109888,109891,2,5,0
31406,3,3,109889,109891,109894,2,5,0
31407,6,2,109895,109895,109897,0,2,1
31408,3,2,109898,109898,109900,0,2,1
31409,5,3,109903,109903,109906,0,3,3
31410,1,3,109904,109906,109909,2,5,0
31411,4,3,109908,109909,109912,1,4,0
31412,4,3,109912,109912,109915,0,3,0
31413,6,1,109918,109918,109919,0,1,3
31414,6,3,109924,109924,109927,0,3,5
31415,3,1,109927,109927,109928,0,1,0
31416,2,2,109929,109929,109931,0,2,1
31417,4,2,109933,109933,109935,0,2,2
31418,6,3,109939,109939,109942,0,3,4
31419,1,2,109940,109942,109944,2,4,0
31420,1,2,109941,109944,109946,3,5,0
31421,4,3,109945,109946,109949,1,4,0
31422,2,1,109947,109949,109950,2,3,0
31423,1,1,109948,109950,109951,2,3,0
31424,4,3,109952,109952,109955,0,3,1
31425,4,1,109956,109956,109957,0,1,1
31426,4,3,109960,109960,109963,0,3,3
31427,1,3,109961,109963,109966,2,5,0
31428,4,1,109965,109966,109967,1,2,0
31429,4,1,109969,109969,109970,0,1,2
31430,1,3,109970,109970,109973,0,3,0
31431,3,1,109973,109973,109974,0,1,0
31432,3,2,109976,109976,109978,0,2,2
31433,1,1,109977,109978,109979,1,2,0
31434,6,1,109983,109983,109984,0,1,4
31435,4,3,109987,109987,109990,0,3,3
31436,6,3,109993,109993,109996,0,3,3
31437,4,3,109997,109997,110000,0,3,1
31438,6,3,110003,110003,110006,0,3,3
31439,4,3,110007,110007,110010,0,3,1
31440,4,1,110011,110011,110012,0,1,1
31441,2,3,110013,110013,110016,0,3,1
31442,2,1,110015,110016,110017,1,2,0
31443,1,2,110016,110017,110019,1,3,0
31444,1,3,110017,110019,110022,2,5,0
31445,5,3,110022,110022,110025,0,3,0
31446,5,3,110027,110027,110030,0,3,2
31447,5,2,110032,110032,110034,0,2,2
31448,5,3,110037,110037,110040,0,3,3
31449,2,3,110039,110040,110043,1,4,0
31450,6,3,110045,110045,110048,0,3,2
31451,5,2,110050,110050,110052,0,2,2
31452,3,2,110053,110053,110055,0,2,1
31453,6,3,110059,110059,110062,0,3,4
31454,2,2,110061,110062,110064,1,3,0
31455,2,3,110063,110064,110067,1,4,0
31456,2,3,110065,110067,110070,2,5,0
31457,5,3,110070,110070,110073,0,3,0
31458,2,2,110072,110073,110075,1,3,0
31459,3,1,110075,110075,110076,0,1,0
31460,4,1,110079,110079,110080,0,1,3
31461,3,2,110082,110082,110084,0,2,2
31462,4,3,110086,110086,110089,0,3,2
31463,1,3,110087,110089,110092,2,5,0
31464,5,3,110092,110092,110095,0,3,0
31465,2,2,110094,110095,110097,1,3,0
31466,4,2,110098,110098,110100,0,2,1
31467,4,2,110102,110102,110104,0,2,2
31468,6,3,110108,110108,110111,0,3,4
31469,3,1,110111,110111,110112,0,1,0
31470,4,2,110115,110115,110117,0,2,3
31471,1,1,110116,110117,110118,1,2,0
31472,1,2,110117,110118,110120,1,3,0
31473,2,1,110119,110120,110121,1,2,0
31474,5,1,110124,110124,110125,0,1,3
31475,2,1,110126,110126,110127,0,1,1
31476,1,1,110127,110127,110128,0,1,0
31477,2,1,110129,110129,110130,0,1,1
31478,5,1,110134,110134,110135,0,1,4
31479,2,3,110136,110136,110139,0,3,1
31480,1,2,110137,110139,110141,2,4,0
31481,4,3,110141,110141,110144,0,3,0
31482,2,2,110143,110144,110146,1,3,0
31483,6,3,110149,110149,110152,0,3,3
31484,3,3,110152,110152,110155,0,3,0
31485,5,3,110157,110157,110160,0,3,2
31486,5,1,110162,110162,110163,0,1,2
31487,1,1,110163,110163,110164,0,1,0
31488,2,2,110165,110165,110167,0,2,1
31489,2,3,110167,110167,110170,0,3,0
31490,5,1,110172,110172,110173,0,1,2
31491,2,3,110174,110174,110177,0,3,1
31492,6,1,110180,110180,110181,0,1,3
31493,1,2,110181,110181,110183,0,2,0
31494,6,2,110187,110187,110189,0,2,4
31495,2,2,110189,110189,110191,0,2,0
31496,2,1,110191,110191,110192,0,1,0
31497,1,2,110192,110192,110194,0,2,0
31498,3,2,110195,110195,110197,0,2,1
31499,2,2,110197,110197,110199,0,2,0
31500,5,2,110202,110202,110204,0,2,3
31501,5,1,110207,110207,110208,0,1,3
31502,4,2,110211,110211,110213,0,2,3
31503,6,3,110217,110217,110220,0,3,4
31504,6,3,110223,110223,110226,0,3,3
31505,4,3,110227,110227,110230,0,3,1
31506,2,2,110229,110230,110232,1,3,0
31507,5,3,110234,110234,110237,0,3,2
31508,3,2,110237,110237,110239,0,2,0
31509,1,1,110238,110239,110240,1,2,0
31510,1,1,110239,110240,110241,1,2,0
31511,3,3,110242,110242,110245,0,3,1
31512,6,2,110248,110248,110250,0,2,3
31513,5,1,110253,110253,110254,0,1,3
31514,3,2,110256,110256,110258,0,2,2
31515,3,2,110259,110259,110261,0,2,1
31516,3,3,110262,110262,110265,0,3,1
31517,2,2,110264,110265,110267,1,3,0
31518,5,1,110269,110269,110270,0,1,2
31519,3,1,110272,110272,110273,0,1,2
31520,6,3,110278,110278,110281,0,3,5
31521,6,1,110284,110284,110285,0,1,3
31522,2,1,110286,110286,110287,0,1,1
31523,2,2,110288,110288,110290,0,2,1
31524,6,2,110294,110294,110296,0,2,4
31525,3,2,110297,110297,110299,0,2,1
31526,4,3,110301,110301,110304,0,3,2
31527,4,3,110305,110305,110308,0,3,1
31528,4,3,110309,110309,110312,0,3,1
31529,6,3,110315,110315,110318,0,3,3
31530,4,3,110319,110319,110322,0,3,1
31531,2,1,110321,110322,110323,1,2,0
31532,4,3,110325,110325,110328,0,3,2
31533,6,2,110331,110331,110333,0,2,3
31534,6,2,110337,110337,110339,0,2,4
31535,5,3,110342,110342,110345,0,3,3
31536,2,1,110344,110345,110346,1,2,0
31537,6,1,110350,110350,110351,0,1,4
31538,1,1,110351,110351,110352,0,1,0
31539,2,3,110353,110353,110356,0,3,1
31540,5,3,110358,110358,110361,0,3,2
31541,3,1,110361,110361,110362,0,1,0
31542,3,1,110364,110364,110365,0,1,2
31543,1,3,110365,110365,110368,0,3,0
31544,6,2,110371,110371,110373,0,2,3
31545,5,2,110376,110376,110378,0,2,3
31546,5,2,110381,110381,110383,0,2,3
31547,5,1,110386,110386,110387,0,1,3
31548,1,2,110387,110387,110389,0,2,0
31549,5,2,110392,110392,110394,0,2,3
31550,1,2,110393,110394,110396,1,3,0
31551,6,2,110399,110399,110401,0,2,3
31552,5,1,110404,110404,110405,0,1,3
31553,5,2,110409,110409,110411,0,2,4
31554,2,3,110411,110411,110414,0,3,0
31555,2,2,110413,110414,110416,1,3,0
31556,6,1,110419,110419,110420,0,1,3
31557,6,2,110425,110425,110427,0,2,5
31558,2,2,110427,110427,110429,0,2,0
31559,5,1,110432,110432,110433,0,1,3
31560,4,3,110436,110436,110439,0,3,3
31561,6,1,110442,110442,110443,0,1,3
31562,5,1,110447,110447,110448,0,1,4
31563,1,2,110448,110448,110450,0,2,0
31564,1,1,110449,110450,110451,1,2,0
31565,4,3,110453,110453,110456,0,3,2
31566,1,1,110454,110456,110457,2,3,0
31567,4,2,110458,110458,110460,0,2,1
31568,6,2,110464,110464,110466,0,2,4
31569,1,3,110465,110466,110469,1,4,0
31570,2,2,110467,110469,110471,2,4,0
31571,6,3,110473,110473,110476,0,3,2
31572,3,3,110476,110476,110479,0,3,0
31573,4,3,110480,110480,110483,0,3,1
31574,5,1,110485,110485,110486,0,1,2
31575,6,1,110491,110491,110492,0,1,5
31576,2,3,110493,110493,110496,0,3,1
31577,3,2,110496,110496,110498,0,2,0
31578,1,1,110497,110498,110499,1,2,0
31579,1,1,110498,110499,110500,1,2,0
31580,6,1,110504,110504,110505,0,1,4
31581,6,3,110510,110510,110513,0,3,5
31582,1,1,110511,110513,110514,2,3,0
31583,4,2,110515,110515,110517,0,2,1
31584,4,3,110519,110519,110522,0,3,2
31585,3,3,110522,110522,110525,0,3,0
31586,3,2,110525,110525,110527,0,2,0
31587,3,3,110528,110528,110531,0,3,1
31588,5,2,110533,110533,110535,0,2,2
31589,2,2,110535,110535,110537,0,2,0
31590,2,3,110537,110537,110540,0,3,0
31591,3,1,110540,110540,110541,0,1,0
31592,3,2,110543,110543,110545,0,2,2
31593,3,3,110546,110546,110549,0,3,1
31594,1,3,110547,110549,110552,2,5,0
31595,6,1,110553,110553,110554,0,1,1
31596,2,3,110555,110555,110558,0,3,1
31597,6,3,110561,110561,110564,0,3,3
31598,6,3,110567,110567,110570,0,3,3
31599,2,2,110569,110570,110572,1,3,0
31600,4,3,110573,110573,110576,0,3,1
31601,4,2,110577,110577,110579,0,2,1
31602,4,1,110581,110581,110582,0,1,2
31603,6,2,110587,110587,110589,0,2,5
31604,3,3,110590,110590,110593,0,3,1
31605,4,3,110594,110594,110597,0,3,1
31606,3,3,110597,110597,110600,0,3,0
31607,1,1,110598,110600,110601,2,3,0
31608,5,3,110603,110603,110606,0,3,2
31609,2,3,110605,110606,110609,1,4,0
31610,3,2,110608,110609,110611,1,3,0
31611,6,3,110614,110614,110617,0,3,3
31612,1,1,110615,110617,110618,2,3,0
31613,6,3,110621,110621,110624,0,3,3
31614,5,2,110626,110626,110628,0,2,2
31615,6,1,110632,110632,110633,0,1,4
31616,2,1,110634,110634,110635,0,1,1
31617,6,1,110640,110640,110641,0,1,5
31618,6,1,110646,110646,110647,0,1,5
31619,2,3,110648,110648,110651,0,3,1
31620,1,3,110649,110651,110654,2,5,0
31621,5,3,110654,110654,110657,0,3,0
31622,6,1,110660,110660,110661,0,1,3
31623,4,2,110664,110664,110666,0,2,3
31624,5,3,110669,110669,110672,0,3,3
31625,3,1,110672,110672,110673,0,1,0
31626,3,2,110675,110675,110677,0,2,2
31627,3,3,110678,110678,110681,0,3,1
31628,1,1,110679,110681,110682,2,3,0
31629,1,2,110680,110682,110684,2,4,0
31630,4,3,110684,110684,110687,0,3,0
31631,3,3,110687,110687,110690,0,3,0
31632,5,1,110692,110692,110693,0,1,2
31633,5,3,110697,110697,110700,0,3,4
31634,5,3,110702,110702,110705,0,3,2
31635,4,2,110706,110706,110708,0,2,1
31636,3,1,110709,110709,110710,0,1,1
31637,4,2,110713,110713,110715,0,2,3
31638,5,1,110718,110718,110719,0,1,3
31639,3,3,110721,110721,110724,0,3,2
31640,6,2,110727,110727,110729,0,2,3
31641,5,1,110732,110732,110733,0,1,3
31642,1,3,110733,110733,110736,0,3,0
31643,6,3,110739,110739,110742,0,3,3
31644,2,2,110741,110742,110744,1,3,0
31645,2,3,110743,110744,110747,1,4,0
31646,6,1,110749,110749,110750,0,1,2
31647,3,2,110752,110752,110754,0,2,2
31648,6,2,110758,110758,110760,0,2,4
31649,2,3,110760,110760,110763,0,3,0
31650,4,2,110764,110764,110766,0,2,1
31651,5,3,110769,110769,110772,0,3,3
31652,1,1,110770,110772,110773,2,3,0
31653,1,2,110771,110773,110775,2,4,0
31654,3,2,110774,110775,110777,1,3,0
31655,4,1,110778,110778,110779,0,1,1
31656,4,2,110782,110782,110784,0,2,3
31657,2,2,110784,110784,110786,0,2,0
31658,2,3,110786,110786,110789,0,3,0
31659,3,1,110789,110789,110790,0,1,0
31660,4,2,110793,110793,110795,0,2,3
31661,6,3,110799,110799,110802,0,3,4
31662,1,1,110800,110802,110803,2,3,0
31663,1,3,110801,110803,110806,2,5,0
31664,2,2,110803,110806,110808,3,5,0
31665,4,2,110807,110808,110810,1,3,0
31666,6,1,110813,110813,110814,0,1,3
31667,5,3,110818,110818,110821,0,3,4
31668,2,1,110820,110821,110822,1,2,0
31669,4,3,110824,110824,110827,0,3,2
31670,5,2,110829,110829,110831,0,2,2
31671,3,2,110832,110832,110834,0,2,1
31672,4,1,110836,110836,110837,0,1,2
31673,2,3,110838,110838,110841,0,3,1
31674,1,3,110839,110841,110844,2,5,0
31675,6,2,110845,110845,110847,0,2,1
31676,5,3,110850,110850,110853,0,3,3
31677,4,2,110854,110854,110856,0,2,1
31678,3,3,110857,110857,110860,0,3,1
31679,5,3,110862,110862,110865,0,3,2
31680,2,1,110864,110865,110866,1,2,0
31681,6,2,110870,110870,110872,0,2,4
31682,3,1,110873,110873,110874,0,1,1
31683,1,1,110874,110874,110875,0,1,0
31684,3,1,110877,110877,110878,0,1,2
31685,2,1,110879,110879,110880,0,1,1
31686,5,3,110884,110884,110887,0,3,4
31687,6,2,110890,110890,110892,0,2,3
31688,5,1,110895,110895,110896,0,1,3
31689,3,2,110898,110898,110900,0,2,2
31690,4,3,110902,110902,110905,0,3,2
31691,1,1,110903,110905,110906,2,3,0
31692,2,2,110905,110906,110908,1,3,0
31693,3,1,110908,110908,110909,0,1,0
31694,3,1,110911,110911,110912,0,1,2
31695,2,3,110913,110913,110916,0,3,1
31696,2,3,110915,110916,110919,1,4,0
31697,1,3,110916,110919,110922,3,6,0
31698,4,1,110920,110922,110923,2,3,0
31699,2,3,110922,110923,110926,1,4,0
31700,4,1,110926,110926,110927,0,1,0
31701,1,2,110927,110927,110929,0,2,0
31702,4,3,110931,110931,110934,0,3,2
31703,3,1,110934,110934,110935,0,1,0
31704,5,3,110939,110939,110942,0,3,4
31705,5,3,110944,110944,110947,0,3,2
31706,2,2,110946,110947,110949,1,3,0
31707,1,2,110947,110949,110951,2,4,0
31708,3,1,110950,110951,110952,1,2,0
31709,4,1,110954,110954,110955,0,1,2
31710,2,3,110956,110956,110959,0,3,1
31711,6,1,110962,110962,110963,0,1,3
31712,5,2,110967,110967,110969,0,2,4
31713,1,3,110968,110969,110972,1,4,0
31714,6,2,110974,110974,110976,0,2,2
31715,6,2,110980,110980,110982,0,2,4
31716,1,1,110981,110982,110983,1,2,0
31717,6,2,110987,110987,110989,0,2,4
31718,4,2,110991,110991,110993,0,2,2
31719,5,2,110996,110996,110998,0,2,3
31720,4,1,111000,111000,111001,0,1,2
31721,3,1,111003,111003,111004,0,1,2
31722,6,3,111009,111009,111012,0,3,5
31723,3,1,111012,111012,111013,0,1,0
31724,2,3,111014,111014,111017,0,3,1
31725,3,2,111017,111017,111019,0,2,0
31726,6,3,111023,111023,111026,0,3,4
31727,6,1,111029,111029,111030,0,1,3
31728,5,2,111034,111034,111036,0,2,4
31729,6,2,111040,111040,111042,0,2,4
31730,6,3,111046,111046,111049,0,3,4
31731,5,1,111051,111051,111052,0,1,2
31732,6,1,111057,111057,111058,0,1,5
31733,3,1,111060,111060,111061,0,1,2
31734,5,2,111065,111065,111067,0,2,4
31735,4,3,111069,111069,111072,0,3,2
31736,2,1,111071,111072,111073,1,2,0
31737,1,3,111072,111073,111076,1,4,0
31738,3,2,111075,111076,111078,1,3,0
31739,1,2,111076,111078,111080,2,4,0
31740,4,1,111080,111080,111081,0,1,0
31741,2,1,111082,111082,111083,0,1,1
31742,2,1,111084,111084,111085,0,1,1
31743,6,1,111090,111090,111091,0,1,5
31744,4,1,111094,111094,111095,0,1,3
31745,3,3,111097,111097,111100,0,3,2
31746,5,2,111102,111102,111104,0,2,2
31747,5,1,111107,111107,111108,0,1,3
31748,3,2,111110,111110,111112,0,2,2
31749,2,3,111112,111112,111115,0,3,0
31750,6,3,111118,111118,111121,0,3,3
31751,4,2,111122,111122,111124,0,2,1
31752,4,1,111126,111126,111127,0,1,2
31753,2,2,111128,111128,111130,0,2,1
31754,2,1,111130,111130,111131,0,1,0
31755,3,1,111133,111133,111134,0,1,2
31756,2,2,111135,111135,111137,0,2,1
31757,3,3,111138,111138,111141,0,3,1
31758,2,1,111140,111141,111142,1,2,0
31759,4,1,111144,111144,111145,0,1,2
31760,2,1,111146,111146,111147,0,1,1
31761,5,2,111151,111151,111153,0,2,4
31762,5,1,111156,111156,111157,0,1,3
31763,1,3,111157,111157,111160,0,3,0
31764,4,2,111161,111161,111163,0,2,1
31765,1,1,111162,111163,111164,1,2,0
31766,5,2,111167,111167,111169,0,2,3
31767,5,3,111172,111172,111175,0,3,3
31768,4,1,111176,111176,111177,0,1,1
31769,1,1,111177,111177,111178,0,1,0
31770,6,1,111183,111183,111184,0,1,5
31771,6,1,111189,111189,111190,0,1,5
31772,1,1,111190,111190,111191,0,1,0
31773,6,3,111196,111196,111199,0,3,5
31774,2,1,111198,111199,111200,1,2,0
31775,6,3,111204,111204,111207,0,3,4
31776,2,2,111206,111207,111209,1,3,0
31777,2,1,111208,111209,111210,1,2,0
31778,4,3,111212,111212,111215,0,3,2
31779,6,1,111218,111218,111219,0,1,3
31780,2,2,111220,111220,111222,0,2,1
31781,2,1,111222,111222,111223,0,1,0
31782,6,3,111228,111228,111231,0,3,5
31783,1,3,111229,111231,111234,2,5,0
31784,3,2,111232,111234,111236,2,4,0
31785,5,2,111237,111237,111239,0,2,1
31786,2,2,111239,111239,111241,0,2,0
31787,1,3,111240,111241,111244,1,4,0
31788,4,1,111244,111244,111245,0,1,0
31789,2,2,111246,111246,111248,0,2,1
31790,3,3,111249,111249,111252,0,3,1
31791,2,3,111251,111252,111255,1,4,0
31792,4,3,111255,111255,111258,0,3,0
31793,3,3,111258,111258,111261,0,3,0
31794,3,1,111261,111261,111262,0,1,0
31795,2,3,111263,111263,111266,0,3,1
31796,4,1,111267,111267,111268,0,1,1
31797,3,1,111270,111270,111271,0,1,2
31798,2,1,111272,111272,111273,0,1,1
31799,5,3,111277,111277,111280,0,3,4
31800,5,1,111282,111282,111283,0,1,2
31801,1,2,111283,111283,111285,0,2,0
31802,5,3,111288,111288,111291,0,3,3
31803,3,3,111291,111291,111294,0,3,0
31804,4,3,111295,111295,111298,0,3,1
31805,2,1,111297,111298,111299,1,2,0
31806,3,3,111300,111300,111303,0,3,1
31807,3,1,111303,111303,111304,0,1,0
31808,5,2,111308,111308,111310,0,2,4
31809,5,2,111313,111313,111315,0,2,3
31810,2,3,111315,111315,111318,0,3,0
31811,1,3,111316,111318,111321,2,5,0
31812,3,1,111319,111321,111322,2,3,0
31813,3,2,111322,111322,111324,0,2,0
31814,4,1,111326,111326,111327,0,1,2
31815,2,2,111328,111328,111330,0,2,1
31816,5,3,111333,111333,111336,0,3,3
31817,1,1,111334,111336,111337,2,3,0
31818,4,2,111338,111338,111340,0,2,1
31819,5,2,111343,111343,111345,0,2,3
31820,1,3,111344,111345,111348,1,4,0
31821,6,2,111350,111350,111352,0,2,2
31822,2,2,111352,111352,111354,0,2,0
31823,3,1,111355,111355,111356,0,1,1
31824,1,2,111356,111356,111358,0,2,0
31825,6,1,111362,111362,111363,0,1,4
31826,1,1,111363,111363,111364,0,1,0
31827,2,2,111365,111365,111367,0,2,1
31828,2,1,111367,111367,111368,0,1,0
31829,5,3,111372,111372,111375,0,3,4
31830,6,1,111378,111378,111379,0,1,3
31831,3,2,111381,111381,111383,0,2,2
31832,6,1,111387,111387,111388,0,1,4
31833,3,3,111390,111390,111393,0,3,2
31834,4,2,111394,111394,111396,0,2,1
31835,6,2,111400,111400,111402,0,2,4
31836,5,3,111405,111405,111408,0,3,3
31837,4,3,111409,111409,111412,0,3,1
31838,2,2,111411,111412,111414,1,3,0
31839,1,2,111412,111414,111416,2,4,0
31840,2,1,111414,111416,111417,2,3,0
31841,4,3,111418,111418,111421,0,3,1
31842,4,2,111422,111422,111424,0,2,1
31843,6,2,111428,111428,111430,0,2,4
31844,2,1,111430,111430,111431,0,1,0
31845,5,1,111435,111435,111436,0,1,4
31846,1,1,111436,111436,111437,0,1,0
31847,2,2,111438,111438,111440,0,2,1
31848,5,2,111443,111443,111445,0,2,3
31849,3,1,111446,111446,111447,0,1,1
31850,1,3,111447,111447,111450,0,3,0
31851,3,2,111450,111450,111452,0,2,0
31852,3,3,111453,111453,111456,0,3,1
31853,2,2,111455,111456,111458,1,3,0
31854,5,2,111460,111460,111462,0,2,2
31855,4,3,111464,111464,111467,0,3,2
31856,3,1,111467,111467,111468,0,1,0
31857,3,3,111470,111470,111473,0,3,2
31858,6,3,111476,111476,111479,0,3,3
31859,1,2,111477,111479,111481,2,4,0
31860,6,3,111483,111483,111486,0,3,2
31861,4,2,111487,111487,111489,0,2,1
31862,2,1,111489,111489,111490,0,1,0
31863,2,2,111491,111491,111493,0,2,1
31864,3,1,111494,111494,111495,0,1,1
31865,5,1,111499,111499,111500,0,1,4
31866,5,3,111504,111504,111507,0,3,4
31867,1,1,111505,111507,111508,2,3,0
31868,2,1,111507,111508,111509,1,2,0
31869,3,2,111510,111510,111512,0,2,1
31870,1,1,111511,111512,111513,1,2,0
31871,2,3,111513,111513,111516,0,3,0
31872,6,3,111519,111519,111522,0,3,3
31873,6,3,111525,111525,111528,0,3,3
31874,3,1,111528,111528,111529,0,1,0
31875,3,1,111531,111531,111532,0,1,2
31876,2,1,111533,111533,111534,0,1,1
31877,1,3,111534,111534,111537,0,3,0
31878,4,3,111538,111538,111541,0,3,1
31879,5,2,111543,111543,111545,0,2,2
31880,5,3,111548,111548,111551,0,3,3
31881,3,3,111551,111551,111554,0,3,0
31882,1,3,111552,111554,111557,2,5,0
31883,6,2,111558,111558,111560,0,2,1
31884,3,1,111561,111561,111562,0,1,1
31885,4,1,111565,111565,111566,0,1,3
31886,4,3,111569,111569,111572,0,3,3
31887,4,1,111573,111573,111574,0,1,1
31888,2,1,111575,111575,111576,0,1,1
31889,4,3,111579,111579,111582,0,3,3
31890,1,3,111580,111582,111585,2,5,0
31891,2,1,111582,111585,111586,3,4,0
31892,1,2,111583,111586,111588,3,5,0
31893,4,2,111587,111588,111590,1,3,0
31894,2,1,111589,111590,111591,1,2,0
31895,3,2,111592,111592,111594,0,2,1
31896,5,1,111597,111597,111598,0,1,3
31897,2,3,111599,111599,111602,0,3,1
31898,1,3,111600,111602,111605,2,5,0
31899,5,1,111605,111605,111606,0,1,0
31900,1,1,111606,111606,111607,0,1,0
31901,1,1,111607,111607,111608,0,1,0
31902,2,2,111609,111609,111611,0,2,1
31903,6,2,111615,111615,111617,0,2,4
31904,6,2,111621,111621,111623,0,2,4
31905,3,2,111624,111624,111626,0,2,1
31906,4,3,111628,111628,111631,0,3,2
31907,5,3,111633,111633,111636,0,3,2
31908,5,1,111638,111638,111639,0,1,2
31909,1,2,111639,111639,111641,0,2,0
31910,5,1,111644,111644,111645,0,1,3
31911,1,3,111645,111645,111648,0,3,0
31912,3,1,111648,111648,111649,0,1,0
31913,3,3,111651,111651,111654,0,3,2
31914,4,3,111655,111655,111658,0,3,1
31915,3,2,111658,111658,111660,0,2,0
31916,4,3,111662,111662,111665,0,3,2
31917,4,2,111666,111666,111668,0,2,1
31918,3,1,111669,111669,111670,0,1,1
31919,6,2,111675,111675,111677,0,2,5
31920,1,2,111676,111677,111679,1,3,0
31921,3,3,111679,111679,111682,0,3,0
31922,4,1,111683,111683,111684,0,1,1
31923,2,2,111685,111685,111687,0,2,1
31924,6,2,111691,111691,111693,0,2,4
31925,1,3,111692,111693,111696,1,4,0
31926,3,1,111695,111696,111697,1,2,0
31927,4,2,111699,111699,111701,0,2,2
31928,4,3,111703,111703,111706,0,3,2
31929,1,2,111704,111706,111708,2,4,0
31930,4,1,111708,111708,111709,0,1,0
31931,4,1,111712,111712,111713,0,1,3
31932,3,3,111715,111715,111718,0,3,2
31933,6,2,111721,111721,111723,0,2,3
31934,5,2,111726,111726,111728,0,2,3
31935,6,3,111732,111732,111735,0,3,4
31936,1,3,111733,111735,111738,2,5,0
31937,3,3,111736,111738,111741,2,5,0
31938,2,1,111738,111741,111742,3,4,0
31939,2,3,111740,111742,111745,2,5,0
31940,2,3,111742,111745,111748,3,6,0
31941,5,1,111747,111748,111749,1,2,0
31942,1,3,111748,111749,111752,1,4,0
31943,6,1,111754,111754,111755,0,1,2
31944,1,1,111755,111755,111756,0,1,0
31945,2,3,111757,111757,111760,0,3,1
31946,5,1,111762,111762,111763,0,1,2
31947,1,1,111763,111763,111764,0,1,0
31948,5,3,111768,111768,111771,0,3,4
31949,2,2,111770,111771,111773,1,3,0
31950,5,1,111775,111775,111776,0,1,2
31951,3,1,111778,111778,111779,0,1,2
31952,5,2,111783,111783,111785,0,2,4
31953,4,1,111787,111787,111788,0,1,2
31954,5,2,111792,111792,111794,0,2,4
31955,6,1,111798,111798,111799,0,1,4
31956,6,2,111804,111804,111806,0,2,5
31957,1,2,111805,111806,111808,1,3,0
31958,3,1,111808,111808,111809,0,1,0
31959,2,2,111810,111810,111812,0,2,1
31960,6,2,111816,111816,111818,0,2,4
31961,6,1,111822,111822,111823,0,1,4
31962,1,2,111823,111823,111825,0,2,0
31963,4,1,111827,111827,111828,0,1,2
31964,3,3,111830,111830,111833,0,3,2
31965,6,3,111836,111836,111839,0,3,3
31966,2,1,111838,111839,111840,1,2,0
31967,1,3,111839,111840,111843,1,4,0
31968,2,3,111841,111843,111846,2,5,0
31969,1,2,111842,111846,111848,4,6,0
31970,1,3,111843,111848,111851,5,8,0
31971,5,1,111848,111851,111852,3,4,0
31972,3,3,111851,111852,111855,1,4,0
31973,5,2,111856,111856,111858,0,2,1
31974,1,1,111857,111858,111859,1,2,0
31975,2,2,111859,111859,111861,0,2,0
31976,6,3,111865,111865,111868,0,3,4
31977,2,1,111867,111868,111869,1,2,0
31978,4,3,111871,111871,111874,0,3,2
31979,5,3,111876,111876,111879,0,3,2
31980,6,1,111882,111882,111883,0,1,3
31981,2,1,111884,111884,111885,0,1,1
31982,1,3,111885,111885,111888,0,3,0
31983,6,2,111891,111891,111893,0,2,3
31984,3,3,111894,111894,111897,0,3,1
31985,6,1,111900,111900,111901,0,1,3
31986,5,3,111905,111905,111908,0,3,4
31987,3,1,111908,111908,111909,0,1,0
31988,6,2,111914,111914,111916,0,2,5
31989,3,3,111917,111917,111920,0,3,1
31990,6,1,111923,111923,111924,0,1,3
31991,6,2,111929,111929,111931,0,2,5
31992,4,1,111933,111933,111934,0,1,2
31993,4,1,111937,111937,111938,0,1,3
31994,5,1,111942,111942,111943,0,1,4
31995,4,2,111946,111946,111948,0,2,3
31996,5,2,111951,111951,111953,0,2,3
31997,5,2,111956,111956,111958,0,2,3
31998,2,3,111958,111958,111961,0,3,0
31999,5,2,111963,111963,111965,0,2,2
32000,4,2,111967,111967,111969,0,2,2
32001,2,1,111969,111969,111970,0,1,0
32002,3,2,111972,111972,111974,0,2,2
32003,4,2,111976,111976,111978,0,2,2
32004,2,2,111978,111978,111980,0,2,0
32005,4,2,111982,111982,111984,0,2,2
32006,6,3,111988,111988,111991,0,3,4
32007,1,2,111989,111991,111993,2,4,0
32008,6,1,111995,111995,111996,0,1,2
32009,2,3,111997,111997,112000,0,3,1
32010,3,2,112000,112000,112002,0,2,0
32011,2,1,112002,112002,112003,0,1,0
32012,2,1,112004,112004,112005,0,1,1
32013,4,2,112008,112008,112010,0,2,3
32014,1,2,112009,112010,112012,1,3,0
32015,6,2,112015,112015,112017,0,2,3
32016,5,3,112020,112020,112023,0,3,3
32017,4,1,112024,112024,112025,0,1,1
32018,1,3,112025,112025,112028,0,3,0
32019,5,2,112030,112030,112032,0,2,2
32020,5,3,112035,112035,112038,0,3,3
32021,2,1,112037,112038,112039,1,2,0
32022,6,2,112043,112043,112045,0,2,4
32023,5,3,112048,112048,112051,0,3,3
32024,1,1,112049,112051,112052,2,3,0
32025,5,1,112054,112054,112055,0,1,2
32026,3,2,112057,112057,112059,0,2,2
32027,3,1,112060,112060,112061,0,1,1
32028,4,1,112064,112064,112065,0,1,3
32029,3,2,112067,112067,112069,0,2,2
32030,4,3,112071,112071,112074,0,3,2
32031,1,3,112072,112074,112077,2,5,0
32032,4,1,112076,112077,112078,1,2,0
32033,1,3,112077,112078,112081,1,4,0
32034,4,1,112081,112081,112082,0,1,0
32035,3,2,112084,112084,112086,0,2,2
32036,5,2,112089,112089,112091,0,2,3
32037,6,2,112095,112095,112097,0,2,4
32038,6,1,112101,112101,112102,0,1,4
32039,2,1,112103,112103,112104,0,1,1
32040,3,2,112106,112106,112108,0,2,2
32041,3,3,112109,112109,112112,0,3,1
32042,6,2,112115,112115,112117,0,2,3
32043,1,3,112116,112117,112120,1,4,0
32044,6,2,112122,112122,112124,0,2,2
32045,4,3,112126,112126,112129,0,3,2
32046,1,1,112127,112129,112130,2,3,0
32047,6,3,112133,112133,112136,0,3,3
32048,6,1,112139,112139,112140,0,1,3
32049,4,1,112143,112143,112144,0,1,3
32050,5,3,112148,112148,112151,0,3,4
32051,6,2,112154,112154,112156,0,2,3
32052,4,2,112158,112158,112160,0,2,2
32053,3,3,112161,112161,112164,0,3,1
32054,6,1,112167,112167,112168,0,1,3
32055,1,2,112168,112168,112170,0,2,0
32056,4,3,112172,112172,112175,0,3,2
32057,6,1,112178,112178,112179,0,1,3
32058,1,1,112179,112179,112180,0,1,0
32059,4,1,112183,112183,112184,0,1,3
32060,4,2,112187,112187,112189,0,2,3
32061,5,1,112192,112192,112193,0,1,3
32062,3,3,112195,112195,112198,0,3,2
32063,1,1,112196,112198,112199,2,3,0
32064,2,3,112198,112199,112202,1,4,0
32065,1,3,112199,112202,112205,3,6,0
32066,1,3,112200,112205,112208,5,8,0
32067,4,3,112204,112208,112211,4,7,0
32068,5,2,112209,112211,112213,2,4,0
32069,4,1,112213,112213,112214,0,1,0
32070,5,2,112218,112218,112220,0,2,4
32071,2,1,112220,112220,112221,0,1,0
32072,1,3,112221,112221,112224,0,3,0
32073,5,3,112226,112226,112229,0,3,2
32074,3,3,112229,112229,112232,0,3,0
32075,6,2,112235,112235,112237,0,2,3
32076,3,1,112238,112238,112239,0,1,1
32077,3,2,112241,112241,112243,0,2,2
32078,4,3,112245,112245,112248,0,3,2
32079,5,1,112250,112250,112251,0,1,2
32080,4,1,112254,112254,112255,0,1,3
32081,5,1,112259,112259,112260,0,1,4
32082,6,3,112265,112265,112268,0,3,5
32083,4,2,112269,112269,112271,0,2,1
32084,2,1,112271,112271,112272,0,1,0
32085,3,2,112274,112274,112276,0,2,2
32086,5,2,112279,112279,112281,0,2,3
32087,3,2,112282,112282,112284,0,2,1
32088,1,2,112283,112284,112286,1,3,0
32089,6,3,112289,112289,112292,0,3,3
32090,3,2,112292,112292,112294,0,2,0
32091,6,2,112298,112298,112300,0,2,4
32092,3,1,112301,112301,112302,0,1,1
32093,5,2,112306,112306,112308,0,2,4
32094,6,1,112312,112312,112313,0,1,4
32095,3,3,112315,112315,112318,0,3,2
32096,6,2,112321,112321,112323,0,2,3
32097,6,1,112327,112327,112328,0,1,4
32098,6,2,112333,112333,112335,0,2,5
32099,3,1,112336,112336,112337,0,1,1
32100,5,2,112341,112341,112343,0,2,4
32101,1,2,112342,112343,112345,1,3,0
32102,1,1,112343,112345,112346,2,3,0
32103,6,2,112349,112349,112351,0,2,3
32104,6,2,112355,112355,112357,0,2,4
32105,2,1,112357,112357,112358,0,1,0
32106,3,3,112360,112360,112363,0,3,2
32107,5,2,112365,112365,112367,0,2,2
32108,4,2,112369,112369,112371,0,2,2
32109,1,1,112370,112371,112372,1,2,0
32110,2,2,112372,112372,112374,0,2,0
32111,4,3,112376,112376,112379,0,3,2
32112,1,3,112377,112379,112382,2,5,0
32113,6,2,112383,112383,112385,0,2,1
32114,1,1,112384,112385,112386,1,2,0
32115,2,1,112386,112386,112387,0,1,0
32116,2,3,112388,112388,112391,0,3,1
32117,3,2,112391,112391,112393,0,2,0
32118,2,3,112393,112393,112396,0,3,0
32119,3,2,112396,112396,112398,0,2,0
32120,2,1,112398,112398,112399,0,1,0
32121,1,1,112399,112399,112400,0,1,0
32122,6,1,112405,112405,112406,0,1,5
32123,6,3,112411,112411,112414,0,3,5
32124,4,3,112415,112415,112418,0,3,1
32125,4,3,112419,112419,112422,0,3,1
32126,4,1,112423,112423,112424,0,1,1
32127,3,3,112426,112426,112429,0,3,2
32128,3,3,112429,112429,112432,0,3,0
32129,2,2,112431,112432,112434,1,3,0
32130,1,1,112432,112434,112435,2,3,0
32131,2,1,112434,112435,112436,1,2,0
32132,4,3,112438,112438,112441,0,3,2
32133,1,2,112439,112441,112443,2,4,0
32134,2,3,112441,112443,112446,2,5,0
32135,4,2,112445,112446,112448,1,3,0
32136,1,2,112446,112448,112450,2,4,0
32137,5,3,112451,112451,112454,0,3,1
32138,2,3,112453,112454,112457,1,4,0
32139,3,1,112456,112457,112458,1,2,0
32140,5,1,112461,112461,112462,0,1,3
32141,6,1,112467,112467,112468,0,1,5
32142,3,1,112470,112470,112471,0,1,2
32143,6,3,112476,112476,112479,0,3,5
32144,3,1,112479,112479,112480,0,1,0
32145,6,3,112485,112485,112488,0,3,5
32146,3,1,112488,112488,112489,0,1,0
32147,5,3,112493,112493,112496,0,3,4
32148,5,3,112498,112498,112501,0,3,2
32149,5,2,112503,112503,112505,0,2,2
32150,2,3,112505,112505,112508,0,3,0
32151,4,2,112509,112509,112511,0,2,1
32152,6,2,112515,112515,112517,0,2,4
32153,1,3,112516,112517,112520,1,4,0
32154,3,2,112519,112520,112522,1,3,0
32155,6,3,112525,112525,112528,0,3,3
32156,5,3,112530,112530,112533,0,3,2
32157,1,1,112531,112533,112534,2,3,0
32158,3,3,112534,112534,112537,0,3,0
32159,1,2,112535,112537,112539,2,4,0
32160,4,1,112539,112539,112540,0,1,0
32161,1,3,112540,112540,112543,0,3,0
32162,5,1,112545,112545,112546,0,1,2
32163,5,2,112550,112550,112552,0,2,4
32164,6,3,112556,112556,112559,0,3,4
32165,4,2,112560,112560,112562,0,2,1
32166,3,2,112563,112563,112565,0,2,1
32167,4,1,112567,112567,112568,0,1,2
32168,4,1,112571,112571,112572,0,1,3
32169,6,2,112577,112577,112579,0,2,5
32170,5,1,112582,112582,112583,0,1,3
32171,2,2,112584,112584,112586,0,2,1
32172,1,2,112585,112586,112588,1,3,0
32173,1,1,112586,112588,112589,2,3,0
32174,5,1,112591,112591,112592,0,1,2
32175,3,3,112594,112594,112597,0,3,2
32176,2,1,112596,112597,112598,1,2,0
32177,3,1,112599,112599,112600,0,1,1
32178,2,3,112601,112601,112604,0,3,1
32179,1,3,112602,112604,112607,2,5,0
32180,4,2,112606,112607,112609,1,3,0
32181,3,2,112609,112609,112611,0,2,0
32182,1,3,112610,112611,112614,1,4,0
32183,1,1,112611,112614,112615,3,4,0
32184,3,3,112614,112615,112618,1,4,0
32185,3,1,112617,112618,112619,1,2,0
32186,3,1,112620,112620,112621,0,1,1
32187,1,3,112621,112621,112624,0,3,0
32188,6,3,112627,112627,112630,0,3,3
32189,5,1,112632,112632,112633,0,1,2
32190,3,2,112635,112635,112637,0,2,2
32191,3,1,112638,112638,112639,0,1,1
32192,3,1,112641,112641,112642,0,1,2
32193,2,1,112643,112643,112644,0,1,1
32194,5,3,112648,112648,112651,0,3,4
32195,5,1,112653,112653,112654,0,1,2
32196,3,1,112656,112656,112657,0,1,2
32197,1,3,112657,112657,112660,0,3,0
32198,2,3,112659,112660,112663,1,4,0
32199,4,2,112663,112663,112665,0,2,0
32200,5,3,112668,112668,112671,0,3,3
32201,1,2,112669,112671,112673,2,4,0
32202,6,2,112675,112675,112677,0,2,2
32203,5,1,112680,112680,112681,0,1,3
32204,2,2,112682,112682,112684,0,2,1
32205,3,3,112685,112685,112688,0,3,1
32206,2,2,112687,112688,112690,1,3,0
32207,4,3,112691,112691,112694,0,3,1
32208,1,3,112692,112694,112697,2,5,0
32209,2,2,112694,112697,112699,3,5,0
32210,4,1,112698,112699,112700,1,2,0
32211,4,1,112702,112702,112703,0,1,2
32212,3,3,112705,112705,112708,0,3,2
32213,4,3,112709,112709,112712,0,3,1
32214,5,3,112714,112714,112717,0,3,2
32215,2,3,112716,112717,112720,1,4,0
32216,6,2,112722,112722,112724,0,2,2
32217,3,3,112725,112725,112728,0,3,1
32218,1,1,112726,112728,112729,2,3,0
32219,6,2,112732,112732,112734,0,2,3
32220,2,3,112734,112734,112737,0,3,0
32221,2,3,112736,112737,112740,1,4,0
32222,3,3,112739,112740,112743,1,4,0
32223,2,1,112741,112743,112744,2,3,0
32224,2,3,112743,112744,112747,1,4,0
32225,1,3,112744,112747,112750,3,6,0
32226,3,3,112747,112750,112753,3,6,0
32227,4,2,112751,112753,112755,2,4,0
32228,3,3,112754,112755,112758,1,4,0
32229,4,3,112758,112758,112761,0,3,0
32230,4,3,112762,112762,112765,0,3,1
32231,5,3,112767,112767,112770,0,3,2
32232,1,3,112768,112770,112773,2,5,0
32233,3,2,112771,112773,112775,2,4,0
32234,6,1,112777,112777,112778,0,1,2
32235,6,1,112783,112783,112784,0,1,5
32236,3,2,112786,112786,112788,0,2,2
32237,5,1,112791,112791,112792,0,1,3
32238,4,2,112795,112795,112797,0,2,3
32239,2,2,112797,112797,112799,0,2,0
32240,2,2,112799,112799,112801,0,2,0
32241,2,1,112801,112801,112802,0,1,0
32242,2,3,112803,112803,112806,0,3,1
32243,2,3,112805,112806,112809,1,4,0
32244,5,3,112810,112810,112813,0,3,1
32245,4,3,112814,112814,112817,0,3,1
32246,4,2,112818,112818,112820,0,2,1
32247,1,2,112819,112820,112822,1,3,0
32248,3,2,112822,112822,112824,0,2,0
32249,5,3,112827,112827,112830,0,3,3
32250,3,1,112830,112830,112831,0,1,0
32251,5,1,112835,112835,112836,0,1,4
32252,2,2,112837,112837,112839,0,2,1
32253,4,2,112841,112841,112843,0,2,2
32254,1,1,112842,112843,112844,1,2,0
32255,4,3,112846,112846,112849,0,3,2
32256,2,1,112848,112849,112850,1,2,0
32257,5,1,112853,112853,112854,0,1,3
32258,2,2,112855,112855,112857,0,2,1
32259,5,2,112860,112860,112862,0,2,3
32260,1,1,112861,112862,112863,1,2,0
32261,5,1,112866,112866,112867,0,1,3
32262,4,1,112870,112870,112871,0,1,3
32263,2,3,112872,112872,112875,0,3,1
32264,5,2,112877,112877,112879,0,2,2
32265,1,3,112878,112879,112882,1,4,0
32266,3,2,112881,112882,112884,1,3,0
32267,6,2,112887,112887,112889,0,2,3
32268,6,3,112893,112893,112896,0,3,4
32269,3,2,112896,112896,112898,0,2,0
32270,5,1,112901,112901,112902,0,1,3
32271,2,3,112903,112903,112906,0,3,1
32272,6,3,112909,112909,112912,0,3,3
32273,1,3,112910,112912,112915,2,5,0
32274,2,3,112912,112915,112918,3,6,0
32275,4,3,112916,112918,112921,2,5,0
32276,5,1,112921,112921,112922,0,1,0
32277,3,2,112924,112924,112926,0,2,2
32278,2,2,112926,112926,112928,0,2,0
32279,6,1,112932,112932,112933,0,1,4
32280,1,1,112933,112933,112934,0,1,0
32281,5,1,112938,112938,112939,0,1,4
32282,3,2,112941,112941,112943,0,2,2
32283,2,2,112943,112943,112945,0,2,0
32284,6,1,112949,112949,112950,0,1,4
32285,6,1,112955,112955,112956,0,1,5
32286,5,2,112960,112960,112962,0,2,4
32287,1,3,112961,112962,112965,1,4,0
32288,6,3,112967,112967,112970,0,3,2
32289,2,2,112969,112970,112972,1,3,0
32290,6,2,112975,112975,112977,0,2,3
32291,4,2,112979,112979,112981,0,2,2
32292,4,1,112983,112983,112984,0,1,2
32293,1,2,112984,112984,112986,0,2,0
32294,4,3,112988,112988,112991,0,3,2
32295,6,1,112994,112994,112995,0,1,3
32296,5,3,112999,112999,113002,0,3,4
32297,3,2,113002,113002,113004,0,2,0
32298,5,1,113007,113007,113008,0,1,3
32299,6,3,113013,113013,113016,0,3,5
32300,3,3,113016,113016,113019,0,3,0
32301,6,2,113022,113022,113024,0,2,3
32302,3,3,113025,113025,113028,0,3,1
32303,1,2,113026,113028,113030,2,4,0
32304,1,2,113027,113030,113032,3,5,0
32305,1,1,113028,113032,113033,4,5,0
32306,5,1,113033,113033,113034,0,1,0
32307,4,1,113037,113037,113038,0,1,3
32308,4,3,113041,113041,113044,0,3,3
32309,1,1,113042,113044,113045,2,3,0
32310,1,2,113043,113045,113047,2,4,0
32311,6,1,113049,113049,113050,0,1,2
32312,3,2,113052,113052,113054,0,2,2
32313,1,2,113053,113054,113056,1,3,0
32314,2,1,113055,113056,113057,1,2,0
32315,4,3,113059,113059,113062,0,3,2
32316,6,1,113065,113065,113066,0,1,3
32317,5,1,113070,113070,113071,0,1,4
32318,1,2,113071,113071,113073,0,2,0
32319,4,3,113075,113075,113078,0,3,2
32320,3,2,113078,113078,113080,0,2,0
32321,3,1,113081,113081,113082,0,1,1
32322,6,2,113087,113087,113089,0,2,5
32323,3,2,113090,113090,113092,0,2,1
32324,6,3,113096,113096,113099,0,3,4
32325,2,3,113098,113099,113102,1,4,0
32326,2,2,113100,113102,113104,2,4,0
32327,4,1,113104,113104,113105,0,1,0
32328,4,1,113108,113108,113109,0,1,3
32329,6,3,113114,113114,113117,0,3,5
32330,6,1,113120,113120,113121,0,1,3
32331,2,2,113122,113122,113124,0,2,1
32332,6,3,113128,113128,113131,0,3,4
32333,2,2,113130,113131,113133,1,3,0
32334,5,2,113135,113135,113137,0,2,2
32335,3,2,113138,113138,113140,0,2,1
32336,3,1,113141,113141,113142,0,1,1
32337,3,3,113144,113144,113147,0,3,2
32338,3,3,113147,113147,113150,0,3,0
32339,5,1,113152,113152,113153,0,1,2
32340,6,1,113158,113158,113159,0,1,5
32341,4,3,113162,113162,113165,0,3,3
32342,2,3,113164,113165,113168,1,4,0
32343,4,3,113168,113168,113171,0,3,0
32344,2,1,113170,113171,113172,1,2,0
32345,4,3,113174,113174,113177,0,3,2
32346,1,3,113175,113177,113180,2,5,0
32347,1,3,113176,113180,113183,4,7,0
32348,3,3,113179,113183,113186,4,7,0
32349,1,1,113180,113186,113187,6,7,0
32350,3,1,113183,113187,113188,4,5,0
32351,2,1,113185,113188,113189,3,4,0
32352,1,3,113186,113189,113192,3,6,0
32353,1,3,113187,113192,113195,5,8,0
32354,2,1,113189,113195,113196,6,7,0
32355,4,2,113193,113196,113198,3,5,0
32356,6,3,113199,113199,113202,0,3,1
32357,2,1,113201,113202,113203,1,2,0
32358,4,3,113205,113205,113208,0,3,2
32359,2,1,113207,113208,113209,1,2,0
32360,6,3,113213,113213,113216,0,3,4
32361,3,1,113216,113216,113217,0,1,0
32362,1,1,113217,113217,113218,0,1,0
32363,3,1,113220,113220,113221,0,1,2
32364,3,3,113223,113223,113226,0,3,2
32365,6,3,113229,113229,113232,0,3,3
32366,1,2,113230,113232,113234,2,4,0
32367,1,2,113231,113234,113236,3,5,0
32368,1,1,113232,113236,113237,4,5,0
32369,3,3,113235,113237,113240,2,5,0
32370,3,3,113238,113240,113243,2,5,0
32371,3,3,113241,113243,113246,2,5,0
32372,3,2,113244,113246,113248,2,4,0
32373,3,3,113247,113248,113251,1,4,0
32374,2,1,113249,113251,113252,2,3,0
32375,1,3,113250,113252,113255,2,5,0
32376,2,3,113252,113255,113258,3,6,0
32377,3,2,113255,113258,113260,3,5,0
32378,1,1,113256,113260,113261,4,5,0
32379,5,1,113261,113261,113262,0,1,0
32380,2,3,113263,113263,113266,0,3,1
32381,6,1,113269,113269,113270,0,1,3
32382,1,2,113270,113270,113272,0,2,0
32383,1,3,113271,113272,113275,1,4,0
32384,2,2,113273,113275,113277,2,4,0
32385,1,3,113274,113277,113280,3,6,0
32386,6,2,113280,113280,113282,0,2,0
32387,5,1,113285,113285,113286,0,1,3
32388,5,1,113290,113290,113291,0,1,4
32389,4,3,113294,113294,113297,0,3,3
32390,5,3,113299,113299,113302,0,3,2
32391,3,3,113302,113302,113305,0,3,0
32392,3,2,113305,113305,113307,0,2,0
32393,6,3,113311,113311,113314,0,3,4
32394,5,2,113316,113316,113318,0,2,2
32395,5,3,113321,113321,113324,0,3,3
32396,2,2,113323,113324,113326,1,3,0
32397,6,1,113329,113329,113330,0,1,3
32398,3,1,113332,113332,113333,0,1,2
32399,2,1,113334,113334,113335,0,1,1
32400,5,2,113339,113339,113341,0,2,4
32401,5,2,113344,113344,113346,0,2,3
32402,1,1,113345,113346,113347,1,2,0
32403,5,3,113350,113350,113353,0,3,3
32404,3,1,113353,113353,113354,0,1,0
32405,2,3,113355,113355,113358,0,3,1
32406,5,1,113360,113360,113361,0,1,2
32407,1,2,113361,113361,113363,0,2,0
32408,1,2,113362,113363,113365,1,3,0
32409,6,3,113368,113368,113371,0,3,3
32410,1,1,113369,113371,113372,2,3,0
32411,5,3,113374,113374,113377,0,3,2
32412,4,3,113378,113378,113381,0,3,1
32413,2,2,113380,113381,113383,1,3,0
32414,3,2,113383,113383,113385,0,2,0
32415,1,1,113384,113385,113386,1,2,0
32416,1,2,113385,113386,113388,1,3,0
32417,5,2,113390,113390,113392,0,2,2
32418,6,3,113396,113396,113399,0,3,4
32419,2,2,113398,113399,113401,1,3,0
32420,2,3,113400,113401,113404,1,4,0
32421,4,3,113404,113404,113407,0,3,0
32422,3,3,113407,113407,113410,0,3,0
32423,6,1,113413,113413,113414,0,1,3
32424,5,2,113418,113418,113420,0,2,4
32425,4,1,113422,113422,113423,0,1,2
32426,6,1,113428,113428,113429,0,1,5
32427,1,1,113429,113429,113430,0,1,0
32428,3,1,113432,113432,113433,0,1,2
32429,3,2,113435,113435,113437,0,2,2
32430,1,3,113436,113437,113440,1,4,0
32431,6,2,113442,113442,113444,0,2,2
32432,3,1,113445,113445,113446,0,1,1
32433,6,2,113451,113451,113453,0,2,5
32434,4,2,113455,113455,113457,0,2,2
32435,3,3,113458,113458,113461,0,3,1
32436,3,3,113461,113461,113464,0,3,0
32437,3,1,113464,113464,113465,0,1,0
32438,3,2,113467,113467,113469,0,2,2
32439,2,3,113469,113469,113472,0,3,0
32440,2,1,113471,113472,113473,1,2,0
32441,5,3,113476,113476,113479,0,3,3
32442,1,1,113477,113479,113480,2,3,0
32443,1,2,113478,113480,113482,2,4,0
32444,6,2,113484,113484,113486,0,2,2
32445,4,3,113488,113488,113491,0,3,2
32446,5,3,113493,113493,113496,0,3,2
32447,6,2,113499,113499,113501,0,2,3
32448,5,1,113504,113504,113505,0,1,3
32449,2,2,113506,113506,113508,0,2,1
32450,4,2,113510,113510,113512,0,2,2
32451,4,1,113514,113514,113515,0,1,2
32452,3,3,113517,113517,113520,0,3,2
32453,4,1,113521,113521,113522,0,1,1
32454,1,2,113522,113522,113524,0,2,0
32455,5,2,113527,113527,113529,0,2,3
32456,4,1,113531,113531,113532,0,1,2
32457,3,1,113534,113534,113535,0,1,2
32458,5,3,113539,113539,113542,0,3,4
32459,3,2,113542,113542,113544,0,2,0
32460,1,3,113543,113544,113547,1,4,0
32461,3,2,113546,113547,113549,1,3,0
32462,1,1,113547,113549,113550,2,3,0
32463,6,2,113553,113553,113555,0,2,3
32464,4,3,113557,113557,113560,0,3,2
32465,5,1,113562,113562,113563,0,1,2
32466,3,1,113565,113565,113566,0,1,2
32467,4,3,113569,113569,113572,0,3,3
32468,2,1,113571,113572,113573,1,2,0
32469,3,3,113574,113574,113577,0,3,1
32470,1,2,113575,113577,113579,2,4,0
32471,2,2,113577,113579,113581,2,4,0
32472,4,1,113581,113581,113582,0,1,0
32473,1,3,113582,113582,113585,0,3,0
32474,2,2,113584,113585,113587,1,3,0
32475,1,2,113585,113587,113589,2,4,0
32476,3,3,113588,113589,113592,1,4,0
32477,3,3,113591,113592,113595,1,4,0
32478,4,1,113595,113595,113596,0,1,0
32479,6,3,113601,113601,113604,0,3,5
32480,1,1,113602,113604,113605,2,3,0
32481,5,1,113607,113607,113608,0,1,2
32482,5,3,113612,113612,113615,0,3,4
32483,5,2,113617,113617,113619,0,2,2
32484,2,1,113619,113619,113620,0,1,0
32485,1,1,113620,113620,113621,0,1,0
32486,1,1,113621,113621,113622,0,1,0
32487,5,2,113626,113626,113628,0,2,4
32488,6,1,113632,113632,113633,0,1,4
32489,2,3,113634,113634,113637,0,3,1
32490,4,1,113638,113638,113639,0,1,1
32491,5,1,113643,113643,113644,0,1,4
32492,5,3,113648,113648,113651,0,3,4
32493,5,3,113653,113653,113656,0,3,2
32494,6,3,113659,113659,113662,0,3,3
32495,1,3,113660,113662,113665,2,5,0
32496,6,3,113666,113666,113669,0,3,1
32497,1,2,113667,113669,113671,2,4,0
32498,4,1,113671,113671,113672,0,1,0
32499,1,2,113672,113672,113674,0,2,0
32500,3,2,113675,113675,113677,0,2,1
32501,1,3,113676,113677,113680,1,4,0
32502,1,2,113677,113680,113682,3,5,0
32503,6,3,113683,113683,113686,0,3,1
32504,2,1,113685,113686,113687,1,2,0
32505,1,1,113686,113687,113688,1,2,0
32506,5,3,113691,113691,113694,0,3,3
32507,3,1,113694,113694,113695,0,1,0
32508,2,3,113696,113696,113699,0,3,1
32509,6,3,113702,113702,113705,0,3,3
32510,6,3,113708,113708,113711,0,3,3
32511,2,2,113710,113711,113713,1,3,0
32512,4,2,113714,113714,113716,0,2,1
32513,4,1,113718,113718,113719,0,1,2
32514,6,1,113724,113724,113725,0,1,5
32515,4,2,113728,113728,113730,0,2,3
32516,1,3,113729,113730,113733,1,4,0
32517,1,3,113730,113733,113736,3,6,0
32518,2,2,113732,113736,113738,4,6,0
32519,3,2,113735,113738,113740,3,5,0
32520,2,2,113737,113740,113742,3,5,0
32521,1,3,113738,113742,113745,4,7,0
32522,5,2,113743,113745,113747,2,4,0
32523,1,2,113744,113747,113749,3,5,0
32524,3,2,113747,113749,113751,2,4,0
32525,4,1,113751,113751,113752,0,1,0
32526,6,3,113757,113757,113760,0,3,5
32527,2,1,113759,113760,113761,1,2,0
32528,6,2,113765,113765,113767,0,2,4
32529,2,2,113767,113767,113769,0,2,0
32530,4,2,113771,113771,113773,0,2,2
32531,5,2,113776,113776,113778,0,2,3
32532,5,3,113781,113781,113784,0,3,3
32533,2,2,113783,113784,113786,1,3,0
32534,5,3,113788,113788,113791,0,3,2
32535,6,1,113794,113794,113795,0,1,3
32536,1,2,113795,113795,113797,0,2,0
32537,1,3,113796,113797,113800,1,4,0
32538,3,1,113799,113800,113801,1,2,0
32539,6,1,113805,113805,113806,0,1,4
32540,3,2,113808,113808,113810,0,2,2
32541,5,3,113813,113813,113816,0,3,3
32542,5,2,113818,113818,113820,0,2,2
32543,6,3,113824,113824,113827,0,3,4
32544,1,2,113825,113827,113829,2,4,0
32545,4,1,113829,113829,113830,0,1,0
32546,2,1,113831,113831,113832,0,1,1
32547,6,3,113837,113837,113840,0,3,5
32548,2,1,113839,113840,113841,1,2,0
32549,2,3,113841,113841,113844,0,3,0
32550,4,3,113845,113845,113848,0,3,1
32551,1,3,113846,113848,113851,2,5,0
32552,6,2,113852,113852,113854,0,2,1
32553,5,1,113857,113857,113858,0,1,3
32554,1,1,113858,113858,113859,0,1,0
32555,2,2,113860,113860,113862,0,2,1
32556,5,3,113865,113865,113868,0,3,3
32557,5,3,113870,113870,113873,0,3,2
32558,4,2,113874,113874,113876,0,2,1
32559,1,3,113875,113876,113879,1,4,0
32560,3,1,113878,113879,113880,1,2,0
32561,6,1,113884,113884,113885,0,1,4
32562,6,3,113890,113890,113893,0,3,5
32563,6,2,113896,113896,113898,0,2,3
32564,2,2,113898,113898,113900,0,2,0
32565,2,3,113900,113900,113903,0,3,0
32566,4,2,113904,113904,113906,0,2,1
32567,1,2,113905,113906,113908,1,3,0
32568,2,3,113907,113908,113911,1,4,0
32569,3,1,113910,113911,113912,1,2,0
32570,1,1,113911,113912,113913,1,2,0
32571,1,1,113912,113913,113914,1,2,0
32572,5,3,113917,113917,113920,0,3,3
32573,1,3,113918,113920,113923,2,5,0
32574,3,1,113921,113923,113924,2,3,0
32575,1,2,113922,113924,113926,2,4,0
32576,3,1,113925,113926,113927,1,2,0
32577,2,1,113927,113927,113928,0,1,0
32578,5,3,113932,113932,113935,0,3,4
32579,5,3,113937,113937,113940,0,3,2
32580,6,1,113943,113943,113944,0,1,3
32581,6,2,113949,113949,113951,0,2,5
32582,2,3,113951,113951,113954,0,3,0
32583,1,2,113952,113954,113956,2,4,0
32584,3,2,113955,113956,113958,1,3,0
32585,4,3,113959,113959,113962,0,3,1
32586,4,3,113963,113963,113966,0,3,1
32587,2,1,113965,113966,113967,1,2,0
32588,1,3,113966,113967,113970,1,4,0
32589,5,2,113971,113971,113973,0,2,1
32590,5,1,113976,113976,113977,0,1,3
32591,6,1,113982,113982,113983,0,1,5
32592,6,2,113988,113988,113990,0,2,5
32593,4,1,113992,113992,113993,0,1,2
32594,5,3,113997,113997,114000,0,3,4
32595,2,2,113999,114000,114002,1,3,0
32596,1,3,114000,114002,114005,2,5,0
32597,1,1,114001,114005,114006,4,5,0
32598,5,3,114006,114006,114009,0,3,0
32599,4,1,114010,114010,114011,0,1,1
32600,3,2,114013,114013,114015,0,2,2
32601,2,2,114015,114015,114017,0,2,0
32602,5,1,114020,114020,114021,0,1,3
32603,4,1,114024,114024,114025,0,1,3
32604,1,2,114025,114025,114027,0,2,0
32605,2,2,114027,114027,114029,0,2,0
32606,2,3,114029,114029,114032,0,3,0
32607,4,3,114033,114033,114036,0,3,1
32608,4,2,114037,114037,114039,0,2,1
32609,1,3,114038,114039,114042,1,4,0
32610,4,2,114042,114042,114044,0,2,0
32611,3,1,114045,114045,114046,0,1,1
32612,5,1,114050,114050,114051,0,1,4
32613,4,3,114054,114054,114057,0,3,3
32614,6,2,114060,114060,114062,0,2,3
32615,3,3,114063,114063,114066,0,3,1
32616,3,2,114066,114066,114068,0,2,0
32617,1,3,114067,114068,114071,1,4,0
32618,2,2,114069,114071,114073,2,4,0
32619,5,1,114074,114074,114075,0,1,1
32620,2,3,114076,114076,114079,0,3,1
32621,4,2,114080,114080,114082,0,2,1
32622,4,1,114084,114084,114085,0,1,2
32623,3,1,114087,114087,114088,0,1,2
32624,4,1,114091,114091,114092,0,1,3
32625,5,1,114096,114096,114097,0,1,4
32626,4,1,114100,114100,114101,0,1,3
32627,1,2,114101,114101,114103,0,2,0
32628,5,2,114106,114106,114108,0,2,3
32629,1,1,114107,114108,114109,1,2,0
32630,1,2,114108,114109,114111,1,3,0
32631,5,2,114113,114113,114115,0,2,2
32632,5,2,114118,114118,114120,0,2,3
32633,2,3,114120,114120,114123,0,3,0
32634,4,1,114124,114124,114125,0,1,1
32635,6,2,114130,114130,114132,0,2,5
32636,6,2,114136,114136,114138,0,2,4
32637,5,3,114141,114141,114144,0,3,3
32638,2,3,114143,114144,114147,1,4,0
32639,5,2,114148,114148,114150,0,2,1
32640,1,2,114149,114150,114152,1,3,0
32641,6,1,114155,114155,114156,0,1,3
32642,2,3,114157,114157,114160,0,3,1
32643,2,2,114159,114160,114162,1,3,0
32644,4,1,114163,114163,114164,0,1,1
32645,2,3,114165,114165,114168,0,3,1
32646,1,3,114166,114168,114171,2,5,0
32647,6,1,114172,114172,114173,0,1,1
32648,6,3,114178,114178,114181,0,3,5
32649,2,1,114180,114181,114182,1,2,0
32650,6,2,114186,114186,114188,0,2,4
32651,5,1,114191,114191,114192,0,1,3
32652,1,2,114192,114192,114194,0,2,0
32653,4,2,114196,114196,114198,0,2,2
32654,1,1,114197,114198,114199,1,2,0
32655,3,3,114200,114200,114203,0,3,1
32656,5,3,114205,114205,114208,0,3,2
32657,3,1,114208,114208,114209,0,1,0
32658,1,3,114209,114209,114212,0,3,0
32659,4,2,114213,114213,114215,0,2,1
32660,1,3,114214,114215,114218,1,4,0
32661,2,3,114216,114218,114221,2,5,0
32662,5,1,114221,114221,114222,0,1,0
32663,6,1,114227,114227,114228,0,1,5
32664,4,1,114231,114231,114232,0,1,3
32665,6,1,114237,114237,114238,0,1,5
32666,6,2,114243,114243,114245,0,2,5
32667,5,1,114248,114248,114249,0,1,3
32668,6,3,114254,114254,114257,0,3,5
32669,6,1,114260,114260,114261,0,1,3
32670,5,2,114265,114265,114267,0,2,4
32671,2,3,114267,114267,114270,0,3,0
32672,6,1,114273,114273,114274,0,1,3
32673,1,1,114274,114274,114275,0,1,0
32674,2,1,114276,114276,114277,0,1,1
32675,6,1,114282,114282,114283,0,1,5
32676,2,1,114284,114284,114285,0,1,1
32677,2,2,114286,114286,114288,0,2,1
32678,5,1,114291,114291,114292,0,1,3
32679,5,1,114296,114296,114297,0,1,4
32680,6,2,114302,114302,114304,0,2,5
32681,5,1,114307,114307,114308,0,1,3
32682,4,1,114311,114311,114312,0,1,3
32683,6,2,114317,114317,114319,0,2,5
32684,1,1,114318,114319,114320,1,2,0
32685,1,1,114319,114320,114321,1,2,0
32686,5,1,114324,114324,114325,0,1,3
32687,1,3,114325,114325,114328,0,3,0
32688,1,3,114326,114328,114331,2,5,0
32689,6,2,114332,114332,114334,0,2,1
32690,2,1,114334,114334,114335,0,1,0
32691,5,1,114339,114339,114340,0,1,4
32692,3,1,114342,114342,114343,0,1,2
32693,4,1,114346,114346,114347,0,1,3
32694,1,1,114347,114347,114348,0,1,0
32695,6,2,114353,114353,114355,0,2,5
32696,1,1,114354,114355,114356,1,2,0
32697,3,3,114357,114357,114360,0,3,1
32698,2,2,114359,114360,114362,1,3,0
32699,4,2,114363,114363,114365,0,2,1
32700,5,2,114368,114368,114370,0,2,3
32701,6,2,114374,114374,114376,0,2,4
32702,4,1,114378,114378,114379,0,1,2
32703,6,1,114384,114384,114385,0,1,5
32704,4,2,114388,114388,114390,0,2,3
32705,6,1,114394,114394,114395,0,1,4
32706,1,1,114395,114395,114396,0,1,0
32707,3,2,114398,114398,114400,0,2,2
32708,6,3,114404,114404,114407,0,3,4
32709,5,2,114409,114409,114411,0,2,2
32710,2,2,114411,114411,114413,0,2,0
32711,3,3,114414,114414,114417,0,3,1
32712,1,3,114415,114417,114420,2,5,0
32713,4,3,114419,114420,114423,1,4,0
32714,3,3,114422,114423,114426,1,4,0
32715,2,1,114424,114426,114427,2,3,0
32716,4,3,114428,114428,114431,0,3,1
32717,4,2,114432,114432,114434,0,2,1
32718,6,1,114438,114438,114439,0,1,4
32719,1,3,114439,114439,114442,0,3,0
32720,4,2,114443,114443,114445,0,2,1
32721,5,1,114448,114448,114449,0,1,3
32722,1,2,114449,114449,114451,0,2,0
32723,5,2,114454,114454,114456,0,2,3
32724,2,3,114456,114456,114459,0,3,0
32725,6,3,114462,114462,114465,0,3,3
32726,4,3,114466,114466,114469,0,3,1
32727,6,3,114472,114472,114475,0,3,3
32728,4,1,114476,114476,114477,0,1,1
32729,4,1,114480,114480,114481,0,1,3
32730,4,3,114484,114484,114487,0,3,3
32731,3,1,114487,114487,114488,0,1,0
32732,6,1,114493,114493,114494,0,1,5
32733,5,2,114498,114498,114500,0,2,4
32734,1,3,114499,114500,114503,1,4,0
32735,6,2,114505,114505,114507,0,2,2
32736,6,1,114511,114511,114512,0,1,4
32737,3,1,114514,114514,114515,0,1,2
32738,3,2,114517,114517,114519,0,2,2
32739,1,1,114518,114519,114520,1,2,0
32740,4,3,114522,114522,114525,0,3,2
32741,5,2,114527,114527,114529,0,2,2
32742,6,1,114533,114533,114534,0,1,4
32743,4,2,114537,114537,114539,0,2,3
32744,6,2,114543,114543,114545,0,2,4
32745,1,1,114544,114545,114546,1,2,0
32746,4,2,114548,114548,114550,0,2,2
32747,3,3,114551,114551,114554,0,3,1
32748,3,2,114554,114554,114556,0,2,0
32749,2,3,114556,114556,114559,0,3,0
32750,6,2,114562,114562,114564,0,2,3
32751,3,1,114565,114565,114566,0,1,1
32752,5,3,114570,114570,114573,0,3,4
32753,4,2,114574,114574,114576,0,2,1
32754,4,3,114578,114578,114581,0,3,2
32755,6,2,114584,114584,114586,0,2,3
32756,6,3,114590,114590,114593,0,3,4
32757,2,1,114592,114593,114594,1,2,0
32758,4,1,114596,114596,114597,0,1,2
32759,6,3,114602,114602,114605,0,3,5
32760,1,1,114603,114605,114606,2,3,0
32761,1,1,114604,114606,114607,2,3,0
32762,3,2,114607,114607,114609,0,2,0
32763,4,2,114611,114611,114613,0,2,2
32764,6,1,114617,114617,114618,0,1,4
32765,2,2,114619,114619,114621,0,2,1
32766,5,2,114624,114624,114626,0,2,3
32767,2,3,114626,114626,114629,0,3,0
32768,3,3,114629,114629,114632,0,3,0
32769,1,3,114630,114632,114635,2,5,0
32770,1,2,114631,114635,114637,4,6,0
32771,3,2,114634,114637,114639,3,5,0
32772,6,3,114640,114640,114643,0,3,1
32773,2,1,114642,114643,114644,1,2,0
32774,3,3,114645,114645,114648,0,3,1
32775,5,1,114650,114650,114651,0,1,2
32776,2,1,114652,114652,114653,0,1,1
32777,6,1,114658,114658,114659,0,1,5
32778,6,1,114664,114664,114665,0,1,5
32779,3,3,114667,114667,114670,0,3,2
32780,5,2,114672,114672,114674,0,2,2
32781,6,2,114678,114678,114680,0,2,4
32782,3,3,114681,114681,114684,0,3,1
32783,3,2,114684,114684,114686,0,2,0
32784,3,3,114687,114687,114690,0,3,1
32785,6,1,114693,114693,114694,0,1,3
32786,1,2,114694,114694,114696,0,2,0
32787,3,2,114697,114697,114699,0,2,1
32788,2,2,114699,114699,114701,0,2,0
32789,1,2,114700,114701,114703,1,3,0
32790,1,2,114701,114703,114705,2,4,0
32791,5,1,114706,114706,114707,0,1,1
32792,6,3,114712,114712,114715,0,3,5
32793,4,1,114716,114716,114717,0,1,1
32794,4,3,114720,114720,114723,0,3,3
32795,4,1,114724,114724,114725,0,1,1
32796,2,2,114726,114726,114728,0,2,1
32797,1,1,114727,114728,114729,1,2,0
32798,2,1,114729,114729,114730,0,1,0
32799,3,1,114732,114732,114733,0,1,2
32800,5,2,114737,114737,114739,0,2,4
32801,6,2,114743,114743,114745,0,2,4
32802,5,2,114748,114748,114750,0,2,3
32803,4,2,114752,114752,114754,0,2,2
32804,3,1,114755,114755,114756,0,1,1
32805,5,1,114760,114760,114761,0,1,4
32806,3,1,114763,114763,114764,0,1,2
32807,6,1,114769,114769,114770,0,1,5
32808,5,3,114774,114774,114777,0,3,4
32809,2,3,114776,114777,114780,1,4,0
32810,2,2,114778,114780,114782,2,4,0
32811,1,1,114779,114782,114783,3,4,0
32812,4,1,114783,114783,114784,0,1,0
32813,6,3,114789,114789,114792,0,3,5
32814,5,2,114794,114794,114796,0,2,2
32815,6,1,114800,114800,114801,0,1,4
32816,4,1,114804,114804,114805,0,1,3
32817,2,2,114806,114806,114808,0,2,1
32818,1,1,114807,114808,114809,1,2,0
32819,6,2,114813,114813,114815,0,2,4
32820,5,3,114818,114818,114821,0,3,3
32821,4,1,114822,114822,114823,0,1,1
32822,3,2,114825,114825,114827,0,2,2
32823,3,2,114828,114828,114830,0,2,1
32824,6,1,114834,114834,114835,0,1,4
32825,5,1,114839,114839,114840,0,1,4
32826,1,2,114840,114840,114842,0,2,0
32827,5,2,114845,114845,114847,0,2,3
32828,5,3,114850,114850,114853,0,3,3
32829,1,1,114851,114853,114854,2,3,0
32830,2,1,114853,114854,114855,1,2,0
32831,4,2,114857,114857,114859,0,2,2
32832,2,2,114859,114859,114861,0,2,0
32833,5,2,114864,114864,114866,0,2,3
32834,2,2,114866,114866,114868,0,2,0
32835,3,2,114869,114869,114871,0,2,1
32836,1,1,114870,114871,114872,1,2,0
32837,3,1,114873,114873,114874,0,1,1
32838,4,1,114877,114877,114878,0,1,3
32839,5,3,114882,114882,114885,0,3,4
32840,3,3,114885,114885,114888,0,3,0
32841,1,2,114886,114888,114890,2,4,0
32842,6,2,114892,114892,114894,0,2,2
32843,4,3,114896,114896,114899,0,3,2
32844,4,1,114900,114900,114901,0,1,1
32845,1,3,114901,114901,114904,0,3,0
32846,6,3,114907,114907,114910,0,3,3
32847,6,1,114913,114913,114914,0,1,3
32848,3,2,114916,114916,114918,0,2,2
32849,3,2,114919,114919,114921,0,2,1
32850,6,2,114925,114925,114927,0,2,4
32851,2,2,114927,114927,114929,0,2,0
32852,6,3,114933,114933,114936,0,3,4
32853,4,3,114937,114937,114940,0,3,1
32854,3,1,114940,114940,114941,0,1,0
32855,4,3,114944,114944,114947,0,3,3
32856,2,2,114946,114947,114949,1,3,0
32857,5,1,114951,114951,114952,0,1,2
32858,3,3,114954,114954,114957,0,3,2
32859,5,3,114959,114959,114962,0,3,2
32860,6,3,114965,114965,114968,0,3,3
32861,6,2,114971,114971,114973,0,2,3
32862,3,3,114974,114974,114977,0,3,1
32863,3,3,114977,114977,114980,0,3,0
32864,2,1,114979,114980,114981,1,2,0
32865,6,1,114985,114985,114986,0,1,4
32866,6,1,114991,114991,114992,0,1,5
32867,4,1,114995,114995,114996,0,1,3
32868,5,3,115000,115000,115003,0,3,4
32869,1,2,115001,115003,115005,2,4,0
32870,3,2,115004,115005,115007,1,3,0
32871,6,2,115010,115010,115012,0,2,3
32872,4,1,115014,115014,115015,0,1,2
32873,3,2,115017,115017,115019,0,2,2
32874,5,3,115022,115022,115025,0,3,3
32875,2,3,115024,115025,115028,1,4,0
32876,6,3,115030,115030,115033,0,3,2
32877,3,2,115033,115033,115035,0,2,0
32878,1,1,115034,115035,115036,1,2,0
32879,5,3,115039,115039,115042,0,3,3
32880,2,2,115041,115042,115044,1,3,0
32881,5,1,115046,115046,115047,0,1,2
32882,2,1,115048,115048,115049,0,1,1
32883,4,3,115052,115052,115055,0,3,3
32884,5,3,115057,115057,115060,0,3,2
32885,1,1,115058,115060,115061,2,3,0
32886,4,3,115062,115062,115065,0,3,1
32887,4,2,115066,115066,115068,0,2,1
32888,3,1,115069,115069,115070,0,1,1
32889,1,3,115070,115070,115073,0,3,0
32890,5,1,115075,115075,115076,0,1,2
32891,6,1,115081,115081,115082,0,1,5
32892,1,2,115082,115082,115084,0,2,0
32893,5,3,115087,115087,115090,0,3,3
32894,4,2,115091,115091,115093,0,2,1
32895,1,2,115092,115093,115095,1,3,0
32896,3,3,115095,115095,115098,0,3,0
32897,3,2,115098,115098,115100,0,2,0
32898,3,2,115101,115101,115103,0,2,1
32899,3,3,115104,115104,115107,0,3,1
32900,5,3,115109,115109,115112,0,3,2
32901,5,1,115114,115114,115115,0,1,2
32902,3,2,115117,115117,115119,0,2,2
32903,5,1,115122,115122,115123,0,1,3
32904,5,3,115127,115127,115130,0,3,4
32905,1,1,115128,115130,115131,2,3,0
32906,3,3,115131,115131,115134,0,3,0
32907,5,2,115136,115136,115138,0,2,2
32908,3,1,115139,115139,115140,0,1,1
32909,6,3,115145,115145,115148,0,3,5
32910,3,1,115148,115148,115149,0,1,0
32911,5,1,115153,115153,115154,0,1,4
32912,2,2,115155,115155,115157,0,2,1
32913,1,2,115156,115157,115159,1,3,0
32914,1,2,115157,115159,115161,2,4,0
32915,2,2,115159,115161,115163,2,4,0
32916,1,3,115160,115163,115166,3,6,0
32917,1,2,115161,115166,115168,5,7,0
32918,4,2,115165,115168,115170,3,5,0
32919,6,3,115171,115171,115174,0,3,1
32920,2,1,115173,115174,115175,1,2,0
32921,6,1,115179,115179,115180,0,1,4
32922,4,3,115183,115183,115186,0,3,3
32923,4,3,115187,115187,115190,0,3,1
32924,2,1,115189,115190,115191,1,2,0
32925,4,3,115193,115193,115196,0,3,2
32926,2,1,115195,115196,115197,1,2,0
32927,5,2,115200,115200,115202,0,2,3
32928,1,3,115201,115202,115205,1,4,0
32929,3,3,115204,115205,115208,1,4,0
32930,4,2,115208,115208,115210,0,2,0
32931,2,2,115210,115210,115212,0,2,0
32932,3,2,115213,115213,115215,0,2,1
32933,2,3,115215,115215,115218,0,3,0
32934,2,1,115217,115218,115219,1,2,0
32935,6,1,115223,115223,115224,0,1,4
32936,5,1,115228,115228,115229,0,1,4
32937,1,3,115229,115229,115232,0,3,0
32938,2,2,115231,115232,115234,1,3,0
32939,2,3,115233,115234,115237,1,4,0
32940,2,3,115235,115237,115240,2,5,0
32941,2,3,115237,115240,115243,3,6,0
32942,4,1,115241,115243,115244,2,3,0
32943,5,2,115246,115246,115248,0,2,2
32944,1,2,115247,115248,115250,1,3,0
32945,5,3,115252,115252,115255,0,3,2
32946,6,1,115258,115258,115259,0,1,3
32947,6,2,115264,115264,115266,0,2,5
32948,3,3,115267,115267,115270,0,3,1
32949,4,1,115271,115271,115272,0,1,1
32950,3,2,115274,115274,115276,0,2,2
32951,5,2,115279,115279,115281,0,2,3
32952,6,2,115285,115285,115287,0,2,4
32953,4,2,115289,115289,115291,0,2,2
32954,1,2,115290,115291,115293,1,3,0
32955,2,3,115292,115293,115296,1,4,0
32956,4,2,115296,115296,115298,0,2,0
32957,4,3,115300,115300,115303,0,3,2
32958,3,2,115303,115303,115305,0,2,0
32959,2,1,115305,115305,115306,0,1,0
32960,4,3,115309,115309,115312,0,3,3
32961,4,1,115313,115313,115314,0,1,1
32962,2,3,115315,115315,115318,0,3,1
32963,2,1,115317,115318,115319,1,2,0
32964,1,1,115318,115319,115320,1,2,0
32965,4,3,115322,115322,115325,0,3,2
32966,4,2,115326,115326,115328,0,2,1
32967,1,2,115327,115328,115330,1,3,0
32968,6,3,115333,115333,115336,0,3,3
32969,6,3,115339,115339,115342,0,3,3
32970,1,1,115340,115342,115343,2,3,0
32971,5,1,115345,115345,115346,0,1,2
32972,5,2,115350,115350,115352,0,2,4
32973,4,3,115354,115354,115357,0,3,2
32974,1,1,115355,115357,115358,2,3,0
32975,1,2,115356,115358,115360,2,4,0
32976,5,2,115361,115361,115363,0,2,1
32977,6,1,115367,115367,115368,0,1,4
32978,5,2,115372,115372,115374,0,2,4
32979,3,2,115375,115375,115377,0,2,1
32980,1,3,115376,115377,115380,1,4,0
32981,3,3,115379,115380,115383,1,4,0
32982,1,1,115380,115383,115384,3,4,0
32983,2,1,115382,115384,115385,2,3,0
32984,3,2,115385,115385,115387,0,2,0
32985,4,1,115389,115389,115390,0,1,2
32986,3,3,115392,115392,115395,0,3,2
32987,5,2,115397,115397,115399,0,2,2
32988,2,2,115399,115399,115401,0,2,0
32989,4,3,115403,115403,115406,0,3,2
32990,2,1,115405,115406,115407,1,2,0
32991,6,1,115411,115411,115412,0,1,4
32992,5,3,115416,115416,115419,0,3,4
32993,6,2,115422,115422,115424,0,2,3
32994,4,2,115426,115426,115428,0,2,2
32995,5,1,115431,115431,115432,0,1,3
32996,4,2,115435,115435,115437,0,2,3
32997,6,3,115441,115441,115444,0,3,4
32998,1,3,115442,115444,115447,2,5,0
32999,6,1,115448,115448,115449,0,1,1
33000,3,3,115451,115451,115454,0,3,2
33001,5,2,115456,115456,115458,0,2,2
33002,6,1,115462,115462,115463,0,1,4
33003,6,1,115468,115468,115469,0,1,5
33004,6,2,115474,115474,115476,0,2,5
33005,1,1,115475,115476,115477,1,2,0
33006,3,2,115478,115478,115480,0,2,1
33007,6,2,115484,115484,115486,0,2,4
33008,6,1,115490,115490,115491,0,1,4
33009,6,3,115496,115496,115499,0,3,5
33010,5,3,115501,115501,115504,0,3,2
33011,2,3,115503,115504,115507,1,4,0
33012,3,2,115506,115507,115509,1,3,0
33013,5,2,115511,115511,115513,0,2,2
33014,1,2,115512,115513,115515,1,3,0
33015,3,1,115515,115515,115516,0,1,0
33016,6,3,115521,115521,115524,0,3,5
33017,4,2,115525,115525,115527,0,2,1
33018,5,2,115530,115530,115532,0,2,3
33019,3,1,115533,115533,115534,0,1,1
33020,1,2,115534,115534,115536,0,2,0
33021,3,2,115537,115537,115539,0,2,1
33022,4,1,115541,115541,115542,0,1,2
33023,1,3,115542,115542,115545,0,3,0
33024,2,3,115544,115545,115548,1,4,0
33025,6,3,115550,115550,115553,0,3,2
33026,3,2,115553,115553,115555,0,2,0
33027,4,3,115557,115557,115560,0,3,2
33028,1,2,115558,115560,115562,2,4,0
33029,4,3,115562,115562,115565,0,3,0
33030,4,3,115566,115566,115569,0,3,1
33031,5,3,115571,115571,115574,0,3,2
33032,4,1,115575,115575,115576,0,1,1
33033,3,2,115578,115578,115580,0,2,2
33034,6,3,115584,115584,115587,0,3,4
33035,3,3,115587,115587,115590,0,3,0
33036,4,1,115591,115591,115592,0,1,1
33037,4,2,115595,115595,115597,0,2,3
33038,4,3,115599,115599,115602,0,3,2
33039,1,2,115600,115602,115604,2,4,0
33040,1,3,115601,115604,115607,3,6,0
33041,4,2,115605,115607,115609,2,4,0
33042,1,3,115606,115609,115612,3,6,0
33043,3,1,115609,115612,115613,3,4,0
33044,1,3,115610,115613,115616,3,6,0
33045,1,1,115611,115616,115617,5,6,0
33046,3,1,115614,115617,115618,3,4,0
33047,5,1,115619,115619,115620,0,1,1
33048,3,1,115622,115622,115623,0,1,2
33049,6,1,115628,115628,115629,0,1,5
33050,6,1,115634,115634,115635,0,1,5
33051,6,2,115640,115640,115642,0,2,5
33052,4,3,115644,115644,115647,0,3,2
33053,4,1,115648,115648,115649,0,1,1
33054,5,1,115653,115653,115654,0,1,4
33055,3,2,115656,115656,115658,0,2,2
33056,4,3,115660,115660,115663,0,3,2
33057,2,2,115662,115663,115665,1,3,0
33058,1,3,115663,115665,115668,2,5,0
33059,1,1,115664,115668,115669,4,5,0
33060,4,2,115668,115669,115671,1,3,0
33061,5,3,115673,115673,115676,0,3,2
33062,6,2,115679,115679,115681,0,2,3
33063,3,2,115682,115682,115684,0,2,1
33064,4,2,115686,115686,115688,0,2,2
33065,4,2,115690,115690,115692,0,2,2
33066,1,1,115691,115692,115693,1,2,0
33067,3,1,115694,115694,115695,0,1,1
33068,4,1,115698,115698,115699,0,1,3
33069,2,2,115700,115700,115702,0,2,1
33070,3,3,115703,115703,115706,0,3,1
33071,6,1,115709,115709,115710,0,1,3
33072,1,2,115710,115710,115712,0,2,0
33073,2,3,115712,115712,115715,0,3,0
33074,5,2,115717,115717,115719,0,2,2
33075,1,1,115718,115719,115720,1,2,0
33076,6,3,115724,115724,115727,0,3,4
33077,6,1,115730,115730,115731,0,1,3
33078,6,2,115736,115736,115738,0,2,5
33079,5,2,115741,115741,115743,0,2,3
33080,1,1,115742,115743,115744,1,2,0
33081,2,3,115744,115744,115747,0,3,0
33082,5,1,115749,115749,115750,0,1,2
33083,3,2,115752,115752,115754,0,2,2
33084,1,3,115753,115754,115757,1,4,0
33085,1,2,115754,115757,115759,3,5,0
33086,2,2,115756,115759,115761,3,5,0
33087,5,1,115761,115761,115762,0,1,0
33088,1,2,115762,115762,115764,0,2,0
33089,5,2,115767,115767,115769,0,2,3
33090,3,3,115770,115770,115773,0,3,1
33091,1,1,115771,115773,115774,2,3,0
33092,2,1,115773,115774,115775,1,2,0
33093,6,2,115779,115779,115781,0,2,4
33094,1,2,115780,115781,115783,1,3,0
33095,4,1,115784,115784,115785,0,1,1
33096,1,3,115785,115785,115788,0,3,0
33097,2,1,115787,115788,115789,1,2,0
33098,5,2,115792,115792,115794,0,2,3
33099,4,3,115796,115796,115799,0,3,2
33100,1,1,115797,115799,115800,2,3,0
33101,6,2,115803,115803,115805,0,2,3
33102,5,2,115808,115808,115810,0,2,3
33103,2,1,115810,115810,115811,0,1,0
33104,6,3,115816,115816,115819,0,3,5
33105,6,3,115822,115822,115825,0,3,3
33106,6,3,115828,115828,115831,0,3,3
33107,6,3,115834,115834,115837,0,3,3
33108,3,3,115837,115837,115840,0,3,0
33109,1,1,115838,115840,115841,2,3,0
33110,6,3,115844,115844,115847,0,3,3
33111,3,3,115847,115847,115850,0,3,0
33112,4,3,115851,115851,115854,0,3,1
33113,6,1,115857,115857,115858,0,1,3
33114,1,3,115858,115858,115861,0,3,0
33115,6,1,115864,115864,115865,0,1,3
33116,5,3,115869,115869,115872,0,3,4
33117,4,3,115873,115873,115876,0,3,1
33118,2,1,115875,115876,115877,1,2,0
33119,2,2,115877,115877,115879,0,2,0
33120,3,1,115880,115880,115881,0,1,1
33121,1,3,115881,115881,115884,0,3,0
33122,2,2,115883,115884,115886,1,3,0
33123,6,2,115889,115889,115891,0,2,3
33124,3,2,115892,115892,115894,0,2,1
33125,2,3,115894,115894,115897,0,3,0
33126,4,1,115898,115898,115899,0,1,1
33127,5,3,115903,115903,115906,0,3,4
33128,3,2,115906,115906,115908,0,2,0
33129,6,1,115912,115912,115913,0,1,4
33130,1,3,115913,115913,115916,0,3,0
33131,1,1,115914,115916,115917,2,3,0
33132,3,1,115917,115917,115918,0,1,0
33133,2,2,115919,115919,115921,0,2,1
33134,3,1,115922,115922,115923,0,1,1
33135,3,3,115925,115925,115928,0,3,2
33136,6,1,115931,115931,115932,0,1,3
33137,3,1,115934,115934,115935,0,1,2
33138,6,1,115940,115940,115941,0,1,5
33139,1,2,115941,115941,115943,0,2,0
33140,3,2,115944,115944,115946,0,2,1
33141,1,1,115945,115946,115947,1,2,0
33142,5,2,115950,115950,115952,0,2,3
33143,3,3,115953,115953,115956,0,3,1
33144,1,3,115954,115956,115959,2,5,0
33145,5,2,115959,115959,115961,0,2,0
33146,1,2,115960,115961,115963,1,3,0
33147,5,2,115965,115965,115967,0,2,2
33148,4,1,115969,115969,115970,0,1,2
33149,1,3,115970,115970,115973,0,3,0
33150,4,1,115974,115974,115975,0,1,1
33151,2,1,115976,115976,115977,0,1,1
33152,1,1,115977,115977,115978,0,1,0
33153,4,1,115981,115981,115982,0,1,3
33154,6,2,115987,115987,115989,0,2,5
33155,4,3,115991,115991,115994,0,3,2
33156,6,3,115997,115997,116000,0,3,3
33157,4,1,116001,116001,116002,0,1,1
33158,6,3,116007,116007,116010,0,3,5
33159,4,1,116011,116011,116012,0,1,1
33160,4,3,116015,116015,116018,0,3,3
33161,6,3,116021,116021,116024,0,3,3
33162,2,2,116023,116024,116026,1,3,0
33163,2,2,116025,116026,116028,1,3,0
33164,6,3,116031,116031,116034,0,3,3
33165,1,1,116032,116034,116035,2,3,0
33166,1,3,116033,116035,116038,2,5,0
33167,5,3,116038,116038,116041,0,3,0
33168,5,3,116043,116043,116046,0,3,2
33169,1,2,116044,116046,116048,2,4,0
33170,6,2,116050,116050,116052,0,2,2
33171,5,2,116055,116055,116057,0,2,3
33172,5,2,116060,116060,116062,0,2,3
33173,6,2,116066,116066,116068,0,2,4
33174,6,1,116072,116072,116073,0,1,4
33175,1,1,116073,116073,116074,0,1,0
33176,4,2,116077,116077,116079,0,2,3
33177,5,2,116082,116082,116084,0,2,3
33178,6,1,116088,116088,116089,0,1,4
33179,3,1,116091,116091,116092,0,1,2
33180,6,2,116097,116097,116099,0,2,5
33181,1,1,116098,116099,116100,1,2,0
33182,5,2,116103,116103,116105,0,2,3
33183,4,1,116107,116107,116108,0,1,2
33184,1,3,116108,116108,116111,0,3,0
33185,4,3,116112,116112,116115,0,3,1
33186,1,3,116113,116115,116118,2,5,0
33187,3,1,116116,116118,116119,2,3,0
33188,3,3,116119,116119,116122,0,3,0
33189,5,2,116124,116124,116126,0,2,2
33190,2,1,116126,116126,116127,0,1,0
33191,4,1,116130,116130,116131,0,1,3
33192,5,3,116135,116135,116138,0,3,4
33193,5,3,116140,116140,116143,0,3,2
33194,3,2,116143,116143,116145,0,2,0
33195,2,2,116145,116145,116147,0,2,0
33196,6,1,116151,116151,116152,0,1,4
33197,5,3,116156,116156,116159,0,3,4
33198,4,2,116160,116160,116162,0,2,1
33199,4,3,116164,116164,116167,0,3,2
33200,1,2,116165,116167,116169,2,4,0
33201,4,1,116169,116169,116170,0,1,0
33202,4,1,116173,116173,116174,0,1,3
33203,6,1,116179,116179,116180,0,1,5
33204,2,2,116181,116181,116183,0,2,1
33205,2,1,116183,116183,116184,0,1,0
33206,1,3,116184,116184,116187,0,3,0
33207,3,3,116187,116187,116190,0,3,0
33208,4,3,116191,116191,116194,0,3,1
33209,6,3,116197,116197,116200,0,3,3
33210,3,3,116200,116200,116203,0,3,0
33211,6,1,116206,116206,116207,0,1,3
33212,4,1,116210,116210,116211,0,1,3
33213,5,1,116215,116215,116216,0,1,4
33214,6,2,116221,116221,116223,0,2,5
33215,3,2,116224,116224,116226,0,2,1
33216,2,3,116226,116226,116229,0,3,0
33217,3,2,116229,116229,116231,0,2,0
33218,6,1,116235,116235,116236,0,1,4
33219,1,3,116236,116236,116239,0,3,0
33220,6,3,116242,116242,116245,0,3,3
33221,4,1,116246,116246,116247,0,1,1
33222,2,3,116248,116248,116251,0,3,1
33223,3,3,116251,116251,116254,0,3,0
33224,3,2,116254,116254,116256,0,2,0
33225,6,2,116260,116260,116262,0,2,4
33226,2,3,116262,116262,116265,0,3,0
33227,1,3,116263,116265,116268,2,5,0
33228,6,2,116269,116269,116271,0,2,1
33229,3,2,116272,116272,116274,0,2,1
33230,1,3,116273,116274,116277,1,4,0
33231,3,2,116276,116277,116279,1,3,0
33232,3,2,116279,116279,116281,0,2,0
33233,3,1,116282,116282,116283,0,1,1
33234,6,2,116288,116288,116290,0,2,5
33235,2,2,116290,116290,116292,0,2,0
33236,1,3,116291,116292,116295,1,4,0
33237,1,1,116292,116295,116296,3,4,0
33238,3,1,116295,116296,116297,1,2,0
33239,6,3,116301,116301,116304,0,3,4
33240,5,2,116306,116306,116308,0,2,2
33241,2,2,116308,116308,116310,0,2,0
33242,2,2,116310,116310,116312,0,2,0
33243,6,1,116316,116316,116317,0,1,4
33244,5,1,116321,116321,116322,0,1,4
33245,2,1,116323,116323,116324,0,1,1
33246,2,1,116325,116325,116326,0,1,1
33247,5,3,116330,116330,116333,0,3,4
33248,6,3,116336,116336,116339,0,3,3
33249,1,3,116337,116339,116342,2,5,0
33250,1,1,116338,116342,116343,4,5,0
33251,5,1,116343,116343,116344,0,1,0
33252,3,1,116346,116346,116347,0,1,2
33253,2,3,116348,116348,116351,0,3,1
33254,3,1,116351,116351,116352,0,1,0
33255,5,3,116356,116356,116359,0,3,4
33256,3,3,116359,116359,116362,0,3,0
33257,1,1,116360,116362,116363,2,3,0
33258,4,3,116364,116364,116367,0,3,1
33259,3,2,116367,116367,116369,0,2,0
33260,6,2,116373,116373,116375,0,2,4
33261,3,1,116376,116376,116377,0,1,1
33262,4,2,116380,116380,116382,0,2,3
33263,6,3,116386,116386,116389,0,3,4
33264,4,2,116390,116390,116392,0,2,1
33265,6,1,116396,116396,116397,0,1,4
33266,4,2,116400,116400,116402,0,2,3
33267,4,3,116404,116404,116407,0,3,2
33268,1,2,116405,116407,116409,2,4,0
33269,4,3,116409,116409,116412,0,3,0
33270,4,3,116413,116413,116416,0,3,1
33271,5,3,116418,116418,116421,0,3,2
33272,1,2,116419,116421,116423,2,4,0
33273,2,3,116421,116423,116426,2,5,0
33274,5,2,116426,116426,116428,0,2,0
33275,6,3,116432,116432,116435,0,3,4
33276,2,3,116434,116435,116438,1,4,0
33277,5,3,116439,116439,116442,0,3,1
33278,5,3,116444,116444,116447,0,3,2
33279,1,2,116445,116447,116449,2,4,0
33280,1,1,116446,116449,116450,3,4,0
33281,3,2,116449,116450,116452,1,3,0
33282,3,1,116452,116452,116453,0,1,0
33283,6,2,116458,116458,116460,0,2,5
33284,2,2,116460,116460,116462,0,2,0
33285,2,3,116462,116462,116465,0,3,0
33286,2,1,116464,116465,116466,1,2,0
33287,2,3,116466,116466,116469,0,3,0
33288,3,3,116469,116469,116472,0,3,0
33289,2,2,116471,116472,116474,1,3,0
33290,2,1,116473,116474,116475,1,2,0
33291,5,2,116478,116478,116480,0,2,3
33292,6,3,116484,116484,116487,0,3,4
33293,2,2,116486,116487,116489,1,3,0
33294,5,1,116491,116491,116492,0,1,2
33295,4,2,116495,116495,116497,0,2,3
33296,5,2,116500,116500,116502,0,2,3
33297,5,2,116505,116505,116507,0,2,3
33298,4,3,116509,116509,116512,0,3,2
33299,5,1,116514,116514,116515,0,1,2
33300,1,1,116515,116515,116516,0,1,0
33301,3,2,116518,116518,116520,0,2,2
33302,5,3,116523,116523,116526,0,3,3
33303,6,3,116529,116529,116532,0,3,3
33304,6,3,116535,116535,116538,0,3,3
33305,6,3,116541,116541,116544,0,3,3
33306,4,3,116545,116545,116548,0,3,1
33307,3,2,116548,116548,116550,0,2,0
33308,1,1,116549,116550,116551,1,2,0
33309,1,1,116550,116551,116552,1,2,0
33310,3,1,116553,116553,116554,0,1,1
33311,1,2,116554,116554,116556,0,2,0
33312,6,3,116560,116560,116563,0,3,4
33313,1,2,116561,116563,116565,2,4,0
33314,2,3,116563,116565,116568,2,5,0
33315,4,2,116567,116568,116570,1,3,0
33316,2,3,116569,116570,116573,1,4,0
33317,4,3,116573,116573,116576,0,3,0
33318,5,3,116578,116578,116581,0,3,2
33319,3,3,116581,116581,116584,0,3,0
33320,3,1,116584,116584,116585,0,1,0
33321,2,3,116586,116586,116589,0,3,1
33322,4,2,116590,116590,116592,0,2,1
33323,3,1,116593,116593,116594,0,1,1
33324,6,3,116599,116599,116602,0,3,5
33325,2,2,116601,116602,116604,1,3,0
33326,1,2,116602,116604,116606,2,4,0
33327,2,3,116604,116606,116609,2,5,0
33328,5,2,116609,116609,116611,0,2,0
33329,1,2,116610,116611,116613,1,3,0
33330,3,2,116613,116613,116615,0,2,0
33331,1,3,116614,116615,116618,1,4,0
33332,6,3,116620,116620,116623,0,3,2
33333,3,3,116623,116623,116626,0,3,0
33334,3,1,116626,116626,116627,0,1,0
33335,4,3,116630,116630,116633,0,3,3
33336,3,3,116633,116633,116636,0,3,0
33337,6,1,116639,116639,116640,0,1,3
33338,3,3,116642,116642,116645,0,3,2
33339,5,1,116647,116647,116648,0,1,2
33340,3,3,116650,116650,116653,0,3,2
33341,4,2,116654,116654,116656,0,2,1
33342,2,3,116656,116656,116659,0,3,0
33343,3,1,116659,116659,116660,0,1,0
33344,3,2,116662,116662,116664,0,2,2
33345,1,3,116663,116664,116667,1,4,0
33346,3,3,116666,116667,116670,1,4,0
33347,1,3,116667,116670,116673,3,6,0
33348,1,2,116668,116673,116675,5,7,0
33349,2,2,116670,116675,116677,5,7,0
33350,4,1,116674,116677,116678,3,4,0
33351,1,2,116675,116678,116680,3,5,0
33352,1,3,116676,116680,116683,4,7,0
33353,6,2,116682,116683,116685,1,3,0
33354,4,3,116686,116686,116689,0,3,1
33355,2,2,116688,116689,116691,1,3,0
33356,2,3,116690,116691,116694,1,4,0
33357,6,1,116696,116696,116697,0,1,2
33358,1,2,116697,116697,116699,0,2,0
33359,3,1,116700,116700,116701,0,1,1
33360,3,1,116703,116703,116704,0,1,2
33361,5,3,116708,116708,116711,0,3,4
33362,4,2,116712,116712,116714,0,2,1
33363,1,3,116713,116714,116717,1,4,0
33364,4,3,116717,116717,116720,0,3,0
33365,4,2,116721,116721,116723,0,2,1
33366,1,1,116722,116723,116724,1,2,0
33367,6,2,116728,116728,116730,0,2,4
33368,5,3,116733,116733,116736,0,3,3
33369,5,2,116738,116738,116740,0,2,2
33370,5,1,116743,116743,116744,0,1,3
33371,1,1,116744,116744,116745,0,1,0
33372,3,1,116747,116747,116748,0,1,2
33373,6,3,116753,116753,116756,0,3,5
33374,5,1,116758,116758,116759,0,1,2
33375,4,3,116762,116762,116765,0,3,3
33376,1,3,116763,116765,116768,2,5,0
33377,4,2,116767,116768,116770,1,3,0
33378,2,3,116769,116770,116773,1,4,0
33379,4,1,116773,116773,116774,0,1,0
33380,3,3,116776,116776,116779,0,3,2
33381,1,2,116777,116779,116781,2,4,0
33382,4,2,116781,116781,116783,0,2,0
33383,2,2,116783,116783,116785,0,2,0
33384,4,1,116787,116787,116788,0,1,2
33385,6,3,116793,116793,116796,0,3,5
33386,2,1,116795,116796,116797,1,2,0
33387,3,3,116798,116798,116801,0,3,1
33388,1,1,116799,116801,116802,2,3,0
33389,4,3,116803,116803,116806,0,3,1
33390,6,3,116809,116809,116812,0,3,3
33391,5,3,116814,116814,116817,0,3,2
33392,3,1,116817,116817,116818,0,1,0
33393,1,3,116818,116818,116821,0,3,0
33394,5,1,116823,116823,116824,0,1,2
33395,3,2,116826,116826,116828,0,2,2
33396,2,1,116828,116828,116829,0,1,0
33397,6,3,116834,116834,116837,0,3,5
33398,5,2,116839,116839,116841,0,2,2
33399,3,2,116842,116842,116844,0,2,1
33400,1,1,116843,116844,116845,1,2,0
33401,2,2,116845,116845,116847,0,2,0
33402,2,3,116847,116847,116850,0,3,0
33403,2,2,116849,116850,116852,1,3,0
33404,4,2,116853,116853,116855,0,2,1
33405,6,2,116859,116859,116861,0,2,4
33406,2,3,116861,116861,116864,0,3,0
33407,4,1,116865,116865,116866,0,1,1
33408,6,1,116871,116871,116872,0,1,5
33409,1,3,116872,116872,116875,0,3,0
33410,3,1,116875,116875,116876,0,1,0
33411,2,3,116877,116877,116880,0,3,1
33412,3,3,116880,116880,116883,0,3,0
33413,4,2,116884,116884,116886,0,2,1
33414,1,2,116885,116886,116888,1,3,0
33415,3,1,116888,116888,116889,0,1,0
33416,3,3,116891,116891,116894,0,3,2
33417,1,1,116892,116894,116895,2,3,0
33418,6,3,116898,116898,116901,0,3,3
33419,4,1,116902,116902,116903,0,1,1
33420,4,1,116906,116906,116907,0,1,3
33421,6,3,116912,116912,116915,0,3,5
33422,5,3,116917,116917,116920,0,3,2
33423,3,3,116920,116920,116923,0,3,0
33424,6,3,116926,116926,116929,0,3,3
33425,3,1,116929,116929,116930,0,1,0
33426,2,1,116931,116931,116932,0,1,1
33427,1,1,116932,116932,116933,0,1,0
33428,1,1,116933,116933,116934,0,1,0
33429,6,3,116939,116939,116942,0,3,5
33430,2,3,116941,116942,116945,1,4,0
33431,1,1,116942,116945,116946,3,4,0
33432,6,1,116948,116948,116949,0,1,2
33433,1,2,116949,116949,116951,0,2,0
33434,2,2,116951,116951,116953,0,2,0
33435,2,2,116953,116953,116955,0,2,0
33436,1,2,116954,116955,116957,1,3,0
33437,4,2,116958,116958,116960,0,2,1
33438,2,2,116960,116960,116962,0,2,0
33439,2,2,116962,116962,116964,0,2,0
33440,2,3,116964,116964,116967,0,3,0
33441,6,2,116970,116970,116972,0,2,3
33442,3,2,116973,116973,116975,0,2,1
33443,5,3,116978,116978,116981,0,3,3
33444,5,3,116983,116983,116986,0,3,2
33445,4,2,116987,116987,116989,0,2,1
33446,1,1,116988,116989,116990,1,2,0
33447,5,1,116993,116993,116994,0,1,3
33448,1,1,116994,116994,116995,0,1,0
33449,6,3,117000,117000,117003,0,3,5
33450,4,1,117004,117004,117005,0,1,1
33451,1,3,117005,117005,117008,0,3,0
33452,2,3,117007,117008,117011,1,4,0
33453,5,2,117012,117012,117014,0,2,1
33454,5,1,117017,117017,117018,0,1,3
33455,6,2,117023,117023,117025,0,2,5
33456,6,2,117029,117029,117031,0,2,4
33457,2,2,117031,117031,117033,0,2,0
33458,6,1,117037,117037,117038,0,1,4
33459,3,3,117040,117040,117043,0,3,2
33460,2,2,117042,117043,117045,1,3,0
33461,4,3,117046,117046,117049,0,3,1
33462,4,1,117050,117050,117051,0,1,1
33463,2,3,117052,117052,117055,0,3,1
33464,1,1,117053,117055,117056,2,3,0
33465,1,1,117054,117056,117057,2,3,0
33466,3,3,117057,117057,117060,0,3,0
33467,2,3,117059,117060,117063,1,4,0
33468,5,2,117064,117064,117066,0,2,1
33469,1,2,117065,117066,117068,1,3,0
33470,2,1,117067,117068,117069,1,2,0
33471,3,1,117070,117070,117071,0,1,1
33472,4,2,117074,117074,117076,0,2,3
33473,5,1,117079,117079,117080,0,1,3
33474,4,1,117083,117083,117084,0,1,3
33475,2,1,117085,117085,117086,0,1,1
33476,6,3,117091,117091,117094,0,3,5
33477,6,2,117097,117097,117099,0,2,3
33478,6,1,117103,117103,117104,0,1,4
33479,2,2,117105,117105,117107,0,2,1
33480,1,2,117106,117107,117109,1,3,0
33481,4,1,117110,117110,117111,0,1,1
33482,1,2,117111,117111,117113,0,2,0
33483,5,3,117116,117116,117119,0,3,3
33484,3,2,117119,117119,117121,0,2,0
33485,3,1,117122,117122,117123,0,1,1
33486,6,2,117128,117128,117130,0,2,5
33487,6,3,117134,117134,117137,0,3,4
33488,3,1,117137,117137,117138,0,1,0
33489,4,2,117141,117141,117143,0,2,3
33490,4,3,117145,117145,117148,0,3,2
33491,3,1,117148,117148,117149,0,1,0
33492,3,3,117151,117151,117154,0,3,2
33493,3,2,117154,117154,117156,0,2,0
33494,3,3,117157,117157,117160,0,3,1
33495,2,3,117159,117160,117163,1,4,0
33496,2,3,117161,117163,117166,2,5,0
33497,4,2,117165,117166,117168,1,3,0
33498,2,3,117167,117168,117171,1,4,0
33499,3,3,117170,117171,117174,1,4,0
33500,5,2,117175,117175,117177,0,2,1
33501,4,3,117179,117179,117182,0,3,2
33502,3,1,117182,117182,117183,0,1,0
33503,2,1,117184,117184,117185,0,1,1
33504,3,2,117187,117187,117189,0,2,2
33505,6,3,117193,117193,117196,0,3,4
33506,1,1,117194,117196,117197,2,3,0
33507,4,3,117198,117198,117201,0,3,1
33508,3,1,117201,117201,117202,0,1,0
33509,5,2,117206,117206,117208,0,2,4
33510,4,1,117210,117210,117211,0,1,2
33511,5,2,117215,117215,117217,0,2,4
33512,1,1,117216,117217,117218,1,2,0
33513,1,2,117217,117218,117220,1,3,0
33514,2,2,117219,117220,117222,1,3,0
33515,4,1,117223,117223,117224,0,1,1
33516,3,1,117226,117226,117227,0,1,2
33517,5,1,117231,117231,117232,0,1,4
33518,5,1,117236,117236,117237,0,1,4
33519,3,2,117239,117239,117241,0,2,2
33520,5,2,117244,117244,117246,0,2,3
33521,6,3,117250,117250,117253,0,3,4
33522,1,3,117251,117253,117256,2,5,0
33523,6,3,117257,117257,117260,0,3,1
33524,1,1,117258,117260,117261,2,3,0
33525,3,1,117261,117261,117262,0,1,0
33526,4,3,117265,117265,117268,0,3,3
33527,5,1,117270,117270,117271,0,1,2
33528,1,1,117271,117271,117272,0,1,0
33529,3,3,117274,117274,117277,0,3,2
33530,3,3,117277,117277,117280,0,3,0
33531,4,1,117281,117281,117282,0,1,1
33532,4,1,117285,117285,117286,0,1,3
33533,1,3,117286,117286,117289,0,3,0
33534,1,2,117287,117289,117291,2,4,0
33535,4,3,117291,117291,117294,0,3,0
33536,4,1,117295,117295,117296,0,1,1
33537,1,2,117296,117296,117298,0,2,0
33538,1,1,117297,117298,117299,1,2,0
33539,2,2,117299,117299,117301,0,2,0
33540,3,3,117302,117302,117305,0,3,1
33541,5,3,117307,117307,117310,0,3,2
33542,2,1,117309,117310,117311,1,2,0
33543,5,3,117314,117314,117317,0,3,3
33544,1,3,117315,117317,117320,2,5,0
33545,5,2,117320,117320,117322,0,2,0
33546,6,2,117326,117326,117328,0,2,4
33547,6,1,117332,117332,117333,0,1,4
33548,6,2,117338,117338,117340,0,2,5
33549,2,2,117340,117340,117342,0,2,0
33550,1,3,117341,117342,117345,1,4,0
33551,4,2,117345,117345,117347,0,2,0
33552,3,2,117348,117348,117350,0,2,1
33553,4,1,117352,117352,117353,0,1,2
33554,3,1,117355,117355,117356,0,1,2
33555,6,1,117361,117361,117362,0,1,5
33556,3,2,117364,117364,117366,0,2,2
33557,1,2,117365,117366,117368,1,3,0
33558,2,2,117367,117368,117370,1,3,0
33559,3,1,117370,117370,117371,0,1,0
33560,1,2,117371,117371,117373,0,2,0
33561,6,1,117377,117377,117378,0,1,4
33562,5,2,117382,117382,117384,0,2,4
33563,2,1,117384,117384,117385,0,1,0
33564,2,3,117386,117386,117389,0,3,1
33565,6,2,117392,117392,117394,0,2,3
33566,2,3,117394,117394,117397,0,3,0
33567,2,3,117396,117397,117400,1,4,0
33568,2,1,117398,117400,117401,2,3,0
33569,3,2,117401,117401,117403,0,2,0
33570,5,3,117406,117406,117409,0,3,3
33571,4,2,117410,117410,117412,0,2,1
33572,6,3,117416,117416,117419,0,3,4
33573,4,1,117420,117420,117421,0,1,1
33574,4,1,117424,117424,117425,0,1,3
33575,5,3,117429,117429,117432,0,3,4
33576,2,2,117431,117432,117434,1,3,0
33577,1,1,117432,117434,117435,2,3,0
33578,2,3,117434,117435,117438,1,4,0
33579,2,1,117436,117438,117439,2,3,0
33580,4,1,117440,117440,117441,0,1,1
33581,5,2,117445,117445,117447,0,2,4
33582,6,3,117451,117451,117454,0,3,4
33583,5,2,117456,117456,117458,0,2,2
33584,4,3,117460,117460,117463,0,3,2
33585,3,2,117463,117463,117465,0,2,0
33586,4,3,117467,117467,117470,0,3,2
33587,2,3,117469,117470,117473,1,4,0
33588,5,3,117474,117474,117477,0,3,1
33589,2,2,117476,117477,117479,1,3,0
33590,2,2,117478,117479,117481,1,3,0
33591,5,2,117483,117483,117485,0,2,2
33592,5,1,117488,117488,117489,0,1,3
33593,2,3,117490,117490,117493,0,3,1
33594,4,3,117494,117494,117497,0,3,1
33595,1,2,117495,117497,117499,2,4,0
33596,5,3,117500,117500,117503,0,3,1
33597,2,1,117502,117503,117504,1,2,0
33598,2,2,117504,117504,117506,0,2,0
33599,6,2,117510,117510,117512,0,2,4
33600,3,1,117513,117513,117514,0,1,1
33601,5,3,117518,117518,117521,0,3,4
33602,6,3,117524,117524,117527,0,3,3
33603,5,3,117529,117529,117532,0,3,2
33604,5,3,117534,117534,117537,0,3,2
33605,5,3,117539,117539,117542,0,3,2
33606,5,2,117544,117544,117546,0,2,2
33607,2,2,117546,117546,117548,0,2,0
33608,3,2,117549,117549,117551,0,2,1
33609,1,2,117550,117551,117553,1,3,0
33610,4,1,117554,117554,117555,0,1,1
33611,2,1,117556,117556,117557,0,1,1
33612,5,3,117561,117561,117564,0,3,4
33613,2,1,117563,117564,117565,1,2,0
33614,1,2,117564,117565,117567,1,3,0
33615,1,2,117565,117567,117569,2,4,0
33616,4,1,117569,117569,117570,0,1,0
33617,5,2,117574,117574,117576,0,2,4
33618,6,2,117580,117580,117582,0,2,4
33619,3,2,117583,117583,117585,0,2,1
33620,1,1,117584,117585,117586,1,2,0
33621,6,1,117590,117590,117591,0,1,4
33622,2,3,117592,117592,117595,0,3,1
33623,1,2,117593,117595,117597,2,4,0
33624,3,1,117596,117597,117598,1,2,0
33625,3,1,117599,117599,117600,0,1,1
33626,6,2,117605,117605,117607,0,2,5
33627,1,1,117606,117607,117608,1,2,0
33628,4,1,117610,117610,117611,0,1,2
33629,6,2,117616,117616,117618,0,2,5
33630,5,3,117621,117621,117624,0,3,3
33631,4,2,117625,117625,117627,0,2,1
33632,4,1,117629,117629,117630,0,1,2
33633,1,1,117630,117630,117631,0,1,0
33634,4,2,117634,117634,117636,0,2,3
33635,3,2,117637,117637,117639,0,2,1
33636,2,1,117639,117639,117640,0,1,0
33637,4,2,117643,117643,117645,0,2,3
33638,5,1,117648,117648,117649,0,1,3
33639,2,2,117650,117650,117652,0,2,1
33640,5,2,117655,117655,117657,0,2,3
33641,3,1,117658,117658,117659,0,1,1
33642,1,1,117659,117659,117660,0,1,0
33643,4,2,117663,117663,117665,0,2,3
33644,4,3,117667,117667,117670,0,3,2
33645,3,2,117670,117670,117672,0,2,0
33646,5,3,117675,117675,117678,0,3,3
33647,3,1,117678,117678,117679,0,1,0
33648,1,2,117679,117679,117681,0,2,0
33649,5,2,117684,117684,117686,0,2,3
33650,5,1,117689,117689,117690,0,1,3
33651,2,1,117691,117691,117692,0,1,1
33652,5,2,117696,117696,117698,0,2,4
33653,6,3,117702,117702,117705,0,3,4
33654,2,1,117704,117705,117706,1,2,0
33655,3,2,117707,117707,117709,0,2,1
33656,3,3,117710,117710,117713,0,3,1
33657,4,2,117714,117714,117716,0,2,1
33658,2,2,117716,117716,117718,0,2,0
33659,6,1,117722,117722,117723,0,1,4
33660,1,2,117723,117723,117725,0,2,0
33661,2,1,117725,117725,117726,0,1,0
33662,4,2,117729,117729,117731,0,2,3
33663,2,1,117731,117731,117732,0,1,0
33664,3,1,117734,117734,117735,0,1,2
33665,4,1,117738,117738,117739,0,1,3
33666,5,2,117743,117743,117745,0,2,4
33667,2,1,117745,117745,117746,0,1,0
33668,4,1,117749,117749,117750,0,1,3
33669,2,1,117751,117751,117752,0,1,1
33670,2,3,117753,117753,117756,0,3,1
33671,6,2,117759,117759,117761,0,2,3
33672,4,2,117763,117763,117765,0,2,2
33673,6,3,117769,117769,117772,0,3,4
33674,1,1,117770,117772,117773,2,3,0
33675,5,2,117775,117775,117777,0,2,2
33676,5,1,117780,117780,117781,0,1,3
33677,2,2,117782,117782,117784,0,2,1
33678,2,3,117784,117784,117787,0,3,0
33679,5,1,117789,117789,117790,0,1,2
33680,5,3,117794,117794,117797,0,3,4
33681,3,3,117797,117797,117800,0,3,0
33682,1,2,117798,117800,117802,2,4,0
33683,1,2,117799,117802,117804,3,5,0
33684,6,2,117805,117805,117807,0,2,1
33685,4,2,117809,117809,117811,0,2,2
33686,2,3,117811,117811,117814,0,3,0
33687,5,1,117816,117816,117817,0,1,2
33688,5,2,117821,117821,117823,0,2,4
33689,5,3,117826,117826,117829,0,3,3
33690,2,2,117828,117829,117831,1,3,0
33691,1,2,117829,117831,117833,2,4,0
33692,5,1,117834,117834,117835,0,1,1
33693,2,2,117836,117836,117838,0,2,1
33694,5,3,117841,117841,117844,0,3,3
33695,4,2,117845,117845,117847,0,2,1
33696,5,3,117850,117850,117853,0,3,3
33697,2,1,117852,117853,117854,1,2,0
33698,1,1,117853,117854,117855,1,2,0
33699,2,3,117855,117855,117858,0,3,0
33700,6,2,117861,117861,117863,0,2,3
33701,1,1,117862,117863,117864,1,2,0
33702,1,1,117863,117864,117865,1,2,0
33703,6,2,117869,117869,117871,0,2,4
33704,1,1,117870,117871,117872,1,2,0
33705,4,3,117874,117874,117877,0,3,2
33706,1,2,117875,117877,117879,2,4,0
33707,5,3,117880,117880,117883,0,3,1
33708,5,1,117885,117885,117886,0,1,2
33709,2,1,117887,117887,117888,0,1,1
33710,4,1,117891,117891,117892,0,1,3
33711,2,3,117893,117893,117896,0,3,1
33712,6,3,117899,117899,117902,0,3,3
33713,5,2,117904,117904,117906,0,2,2
33714,4,2,117908,117908,117910,0,2,2
33715,6,3,117914,117914,117917,0,3,4
33716,5,1,117919,117919,117920,0,1,2
33717,5,3,117924,117924,117927,0,3,4
33718,5,1,117929,117929,117930,0,1,2
33719,6,3,117935,117935,117938,0,3,5
33720,1,3,117936,117938,117941,2,5,0
33721,5,2,117941,117941,117943,0,2,0
33722,5,3,117946,117946,117949,0,3,3
33723,6,1,117952,117952,117953,0,1,3
33724,2,3,117954,117954,117957,0,3,1
33725,5,2,117959,117959,117961,0,2,2
33726,3,1,117962,117962,117963,0,1,1
33727,4,3,117966,117966,117969,0,3,3
33728,2,1,117968,117969,117970,1,2,0
33729,5,1,117973,117973,117974,0,1,3
33730,1,3,117974,117974,117977,0,3,0
33731,5,1,117979,117979,117980,0,1,2
33732,1,3,117980,117980,117983,0,3,0
33733,3,3,117983,117983,117986,0,3,0
33734,6,1,117989,117989,117990,0,1,3
33735,6,1,117995,117995,117996,0,1,5
33736,3,1,117998,117998,117999,0,1,2
33737,6,2,118004,118004,118006,0,2,5
33738,2,2,118006,118006,118008,0,2,0
33739,2,2,118008,118008,118010,0,2,0
33740,6,2,118014,118014,118016,0,2,4
33741,2,1,118016,118016,118017,0,1,0
33742,3,2,118019,118019,118021,0,2,2
33743,1,3,118020,118021,118024,1,4,0
33744,3,2,118023,118024,118026,1,3,0
33745,2,2,118025,118026,118028,1,3,0
33746,6,2,118031,118031,118033,0,2,3
33747,4,1,118035,118035,118036,0,1,2
33748,4,1,118039,118039,118040,0,1,3
33749,3,3,118042,118042,118045,0,3,2
33750,3,1,118045,118045,118046,0,1,0
33751,1,2,118046,118046,118048,0,2,0
33752,4,3,118050,118050,118053,0,3,2
33753,5,2,118055,118055,118057,0,2,2
33754,2,1,118057,118057,118058,0,1,0
33755,6,2,118063,118063,118065,0,2,5
33756,4,1,118067,118067,118068,0,1,2
33757,6,3,118073,118073,118076,0,3,5
33758,2,1,118075,118076,118077,1,2,0
33759,6,2,118081,118081,118083,0,2,4
33760,5,3,118086,118086,118089,0,3,3
33761,3,2,118089,118089,118091,0,2,0
33762,4,3,118093,118093,118096,0,3,2
33763,6,1,118099,118099,118100,0,1,3
33764,4,2,118103,118103,118105,0,2,3
33765,4,2,118107,118107,118109,0,2,2
33766,3,2,118110,118110,118112,0,2,1
33767,5,2,118115,118115,118117,0,2,3
33768,6,1,118121,118121,118122,0,1,4
33769,3,3,118124,118124,118127,0,3,2
33770,1,2,118125,118127,118129,2,4,0
33771,4,3,118129,118129,118132,0,3,0
33772,5,3,118134,118134,118137,0,3,2
33773,6,1,118140,118140,118141,0,1,3
33774,2,2,118142,118142,118144,0,2,1
33775,4,1,118146,118146,118147,0,1,2
33776,4,2,118150,118150,118152,0,2,3
33777,5,2,118155,118155,118157,0,2,3
33778,5,1,118160,118160,118161,0,1,3
33779,4,2,118164,118164,118166,0,2,3
33780,1,3,118165,118166,118169,1,4,0
33781,1,2,118166,118169,118171,3,5,0
33782,3,2,118169,118171,118173,2,4,0
33783,2,2,118171,118173,118175,2,4,0
33784,4,2,118175,118175,118177,0,2,0
33785,3,3,118178,118178,118181,0,3,1
33786,1,3,118179,118181,118184,2,5,0
33787,2,2,118181,118184,118186,3,5,0
33788,2,2,118183,118186,118188,3,5,0
33789,4,1,118187,118188,118189,1,2,0
33790,5,3,118192,118192,118195,0,3,3
33791,1,3,118193,118195,118198,2,5,0
33792,4,3,118197,118198,118201,1,4,0
33793,1,3,118198,118201,118204,3,6,0
33794,1,2,118199,118204,118206,5,7,0
33795,2,3,118201,118206,118209,5,8,0
33796,3,3,118204,118209,118212,5,8,0
33797,2,3,118206,118212,118215,6,9,0
33798,6,3,118212,118215,118218,3,6,0
33799,1,3,118213,118218,118221,5,8,0
33800,5,3,118218,118221,118224,3,6,0
33801,1,2,118219,118224,118226,5,7,0
33802,4,3,118223,118226,118229,3,6,0
33803,2,1,118225,118229,118230,4,5,0
33804,1,2,118226,118230,118232,4,6,0
33805,1,3,118227,118232,118235,5,8,0
33806,4,1,118231,118235,118236,4,5,0
33807,1,3,118232,118236,118239,4,7,0
33808,1,1,118233,118239,118240,6,7,0
33809,5,1,118238,118240,118241,2,3,0
33810,5,2,118243,118243,118245,0,2,2
33811,6,2,118249,118249,118251,0,2,4
33812,3,1,118252,118252,118253,0,1,1
33813,3,1,118255,118255,118256,0,1,2
33814,6,3,118261,118261,118264,0,3,5
33815,6,1,118267,118267,118268,0,1,3
33816,2,2,118269,118269,118271,0,2,1
33817,2,1,118271,118271,118272,0,1,0
33818,5,3,118276,118276,118279,0,3,4
33819,1,1,118277,118279,118280,2,3,0
33820,1,3,118278,118280,118283,2,5,0
33821,5,2,118283,118283,118285,0,2,0
33822,6,3,118289,118289,118292,0,3,4
33823,4,3,118293,118293,118296,0,3,1
33824,3,3,118296,118296,118299,0,3,0
33825,4,3,118300,118300,118303,0,3,1
33826,3,2,118303,118303,118305,0,2,0
33827,2,2,118305,118305,118307,0,2,0
33828,3,2,118308,118308,118310,0,2,1
33829,3,1,118311,118311,118312,0,1,1
33830,5,1,118316,118316,118317,0,1,4
33831,4,2,118320,118320,118322,0,2,3
33832,5,1,118325,118325,118326,0,1,3
33833,6,1,118331,118331,118332,0,1,5
33834,4,3,118335,118335,118338,0,3,3
33835,5,3,118340,118340,118343,0,3,2
33836,6,3,118346,118346,118349,0,3,3
33837,3,2,118349,118349,118351,0,2,0
33838,5,2,118354,118354,118356,0,2,3
33839,4,2,118358,118358,118360,0,2,2
33840,6,3,118364,118364,118367,0,3,4
33841,3,3,118367,118367,118370,0,3,0
33842,6,3,118373,118373,118376,0,3,3
33843,2,3,118375,118376,118379,1,4,0
33844,2,3,118377,118379,118382,2,5,0
33845,5,1,118382,118382,118383,0,1,0
33846,2,2,118384,118384,118386,0,2,1
33847,4,2,118388,118388,118390,0,2,2
33848,6,3,118394,118394,118397,0,3,4
33849,5,3,118399,118399,118402,0,3,2
33850,3,3,118402,118402,118405,0,3,0
33851,5,1,118407,118407,118408,0,1,2
33852,1,1,118408,118408,118409,0,1,0
33853,5,1,118413,118413,118414,0,1,4
33854,6,3,118419,118419,118422,0,3,5
33855,1,2,118420,118422,118424,2,4,0
33856,4,3,118424,118424,118427,0,3,0
33857,3,1,118427,118427,118428,0,1,0
33858,1,2,118428,118428,118430,0,2,0
33859,3,2,118431,118431,118433,0,2,1
33860,5,2,118436,118436,118438,0,2,3
33861,4,1,118440,118440,118441,0,1,2
33862,1,2,118441,118441,118443,0,2,0
33863,1,3,118442,118443,118446,1,4,0
33864,6,1,118448,118448,118449,0,1,2
33865,3,1,118451,118451,118452,0,1,2
33866,3,3,118454,118454,118457,0,3,2
33867,4,2,118458,118458,118460,0,2,1
33868,6,3,118464,118464,118467,0,3,4
33869,1,1,118465,118467,118468,2,3,0
33870,6,1,118471,118471,118472,0,1,3
33871,1,2,118472,118472,118474,0,2,0
33872,4,3,118476,118476,118479,0,3,2
33873,3,2,118479,118479,118481,0,2,0
33874,6,1,118485,118485,118486,0,1,4
33875,3,1,118488,118488,118489,0,1,2
33876,1,2,118489,118489,118491,0,2,0
33877,4,1,118493,118493,118494,0,1,2
33878,5,2,118498,118498,118500,0,2,4
33879,3,2,118501,118501,118503,0,2,1
33880,6,3,118507,118507,118510,0,3,4
33881,6,1,118513,118513,118514,0,1,3
33882,5,3,118518,118518,118521,0,3,4
33883,5,3,118523,118523,118526,0,3,2
33884,1,2,118524,118526,118528,2,4,0
33885,1,1,118525,118528,118529,3,4,0
33886,5,1,118530,118530,118531,0,1,1
33887,5,1,118535,118535,118536,0,1,4
33888,3,2,118538,118538,118540,0,2,2
33889,5,1,118543,118543,118544,0,1,3
33890,5,3,118548,118548,118551,0,3,4
33891,4,2,118552,118552,118554,0,2,1
33892,5,3,118557,118557,118560,0,3,3
33893,4,3,118561,118561,118564,0,3,1
33894,2,1,118563,118564,118565,1,2,0
33895,2,3,118565,118565,118568,0,3,0
33896,3,3,118568,118568,118571,0,3,0
33897,1,3,118569,118571,118574,2,5,0
33898,3,1,118572,118574,118575,2,3,0
33899,5,1,118577,118577,118578,0,1,2
33900,4,1,118581,118581,118582,0,1,3
33901,1,2,118582,118582,118584,0,2,0
33902,1,2,118583,118584,118586,1,3,0
33903,5,1,118588,118588,118589,0,1,2
33904,6,3,118594,118594,118597,0,3,5
33905,1,2,118595,118597,118599,2,4,0
33906,5,1,118600,118600,118601,0,1,1
33907,5,1,118605,118605,118606,0,1,4
33908,2,1,118607,118607,118608,0,1,1
33909,5,2,118612,118612,118614,0,2,4
33910,4,1,118616,118616,118617,0,1,2
33911,2,1,118618,118618,118619,0,1,1
33912,6,1,118624,118624,118625,0,1,5
33913,2,2,118626,118626,118628,0,2,1
33914,2,3,118628,118628,118631,0,3,0
33915,2,2,118630,118631,118633,1,3,0
33916,4,3,118634,118634,118637,0,3,1
33917,6,2,118640,118640,118642,0,2,3
33918,6,3,118646,118646,118649,0,3,4
33919,2,2,118648,118649,118651,1,3,0
33920,1,2,118649,118651,118653,2,4,0
33921,3,2,118652,118653,118655,1,3,0
33922,5,1,118657,118657,118658,0,1,2
33923,2,3,118659,118659,118662,0,3,1
33924,1,2,118660,118662,118664,2,4,0
33925,5,2,118665,118665,118667,0,2,1
33926,3,3,118668,118668,118671,0,3,1
33927,5,2,118673,118673,118675,0,2,2
33928,1,1,118674,118675,118676,1,2,0
33929,4,1,118678,118678,118679,0,1,2
33930,2,3,118680,118680,118683,0,3,1
33931,2,3,118682,118683,118686,1,4,0
33932,4,3,118686,118686,118689,0,3,0
33933,5,1,118691,118691,118692,0,1,2
33934,4,2,118695,118695,118697,0,2,3
33935,4,1,118699,118699,118700,0,1,2
33936,6,3,118705,118705,118708,0,3,5
33937,3,1,118708,118708,118709,0,1,0
33938,6,3,118714,118714,118717,0,3,5
33939,3,3,118717,118717,118720,0,3,0
33940,4,1,118721,118721,118722,0,1,1
33941,1,3,118722,118722,118725,0,3,0
33942,3,1,118725,118725,118726,0,1,0
33943,4,3,118729,118729,118732,0,3,3
33944,4,1,118733,118733,118734,0,1,1
33945,3,2,118736,118736,118738,0,2,2
33946,3,3,118739,118739,118742,0,3,1
33947,1,3,118740,118742,118745,2,5,0
33948,4,1,118744,118745,118746,1,2,0
33949,2,2,118746,118746,118748,0,2,0
33950,6,1,118752,118752,118753,0,1,4
33951,2,2,118754,118754,118756,0,2,1
33952,6,2,118760,118760,118762,0,2,4
33953,2,1,118762,118762,118763,0,1,0
33954,6,2,118768,118768,118770,0,2,5
33955,1,3,118769,118770,118773,1,4,0
33956,3,3,118772,118773,118776,1,4,0
33957,6,1,118778,118778,118779,0,1,2
33958,6,1,118784,118784,118785,0,1,5
33959,1,2,118785,118785,118787,0,2,0
33960,5,2,118790,118790,118792,0,2,3
33961,6,1,118796,118796,118797,0,1,4
33962,1,2,118797,118797,118799,0,2,0
33963,3,1,118800,118800,118801,0,1,1
33964,3,1,118803,118803,118804,0,1,2
33965,5,3,118808,118808,118811,0,3,4
33966,4,1,118812,118812,118813,0,1,1
33967,6,2,118818,118818,118820,0,2,5
33968,2,1,118820,118820,118821,0,1,0
33969,1,3,118821,118821,118824,0,3,0
33970,1,3,118822,118824,118827,2,5,0
33971,1,2,118823,118827,118829,4,6,0
33972,2,1,118825,118829,118830,4,5,0
33973,3,2,118828,118830,118832,2,4,0
33974,4,2,118832,118832,118834,0,2,0
33975,4,2,118836,118836,118838,0,2,2
33976,1,2,118837,118838,118840,1,3,0
33977,2,1,118839,118840,118841,1,2,0
33978,4,2,118843,118843,118845,0,2,2
33979,2,1,118845,118845,118846,0,1,0
33980,1,2,118846,118846,118848,0,2,0
33981,2,1,118848,118848,118849,0,1,0
33982,3,3,118851,118851,118854,0,3,2
33983,2,1,118853,118854,118855,1,2,0
33984,4,1,118857,118857,118858,0,1,2
33985,1,2,118858,118858,118860,0,2,0
33986,3,2,118861,118861,118863,0,2,1
33987,6,1,118867,118867,118868,0,1,4
33988,3,3,118870,118870,118873,0,3,2
33989,2,1,118872,118873,118874,1,2,0
33990,5,2,118877,118877,118879,0,2,3
33991,2,1,118879,118879,118880,0,1,0
33992,6,2,118885,118885,118887,0,2,5
33993,6,3,118891,118891,118894,0,3,4
33994,4,3,118895,118895,118898,0,3,1
33995,4,3,118899,118899,118902,0,3,1
33996,5,3,118904,118904,118907,0,3,2
33997,3,3,118907,118907,118910,0,3,0
33998,3,3,118910,118910,118913,0,3,0
33999,3,2,118913,118913,118915,0,2,0
34000,2,2,118915,118915,118917,0,2,0
34001,3,3,118918,118918,118921,0,3,1
34002,2,2,118920,118921,118923,1,3,0
34003,5,2,118925,118925,118927,0,2,2
34004,1,3,118926,118927,118930,1,4,0
34005,6,1,118932,118932,118933,0,1,2
34006,6,3,118938,118938,118941,0,3,5
34007,4,3,118942,118942,118945,0,3,1
34008,3,2,118945,118945,118947,0,2,0
34009,6,3,118951,118951,118954,0,3,4
34010,5,3,118956,118956,118959,0,3,2
34011,3,3,118959,118959,118962,0,3,0
34012,3,3,118962,118962,118965,0,3,0
34013,3,2,118965,118965,118967,0,2,0
34014,4,3,118969,118969,118972,0,3,2
34015,5,3,118974,118974,118977,0,3,2
34016,4,1,118978,118978,118979,0,1,1
34017,2,1,118980,118980,118981,0,1,1
34018,5,3,118985,118985,118988,0,3,4
34019,4,3,118989,118989,118992,0,3,1
34020,6,1,118995,118995,118996,0,1,3
34021,3,1,118998,118998,118999,0,1,2
34022,1,1,118999,118999,119000,0,1,0
34023,4,3,119003,119003,119006,0,3,3
34024,3,2,119006,119006,119008,0,2,0
34025,3,3,119009,119009,119012,0,3,1
34026,5,2,119014,119014,119016,0,2,2
34027,2,1,119016,119016,119017,0,1,0
34028,4,2,119020,119020,119022,0,2,3
34029,1,2,119021,119022,119024,1,3,0
34030,3,2,119024,119024,119026,0,2,0
34031,2,3,119026,119026,119029,0,3,0
34032,5,1,119031,119031,119032,0,1,2
34033,1,3,119032,119032,119035,0,3,0
34034,6,1,119038,119038,119039,0,1,3
34035,5,1,119043,119043,119044,0,1,4
34036,5,1,119048,119048,119049,0,1,4
34037,6,1,119054,119054,119055,0,1,5
34038,1,1,119055,119055,119056,0,1,0
34039,6,3,119061,119061,119064,0,3,5
34040,2,1,119063,119064,119065,1,2,0
34041,1,1,119064,119065,119066,1,2,0
34042,1,2,119065,119066,119068,1,3,0
34043,5,2,119070,119070,119072,0,2,2
34044,5,1,119075,119075,119076,0,1,3
34045,5,1,119080,119080,119081,0,1,4
34046,5,3,119085,119085,119088,0,3,4
34047,4,2,119089,119089,119091,0,2,1
34048,5,2,119094,119094,119096,0,2,3
34049,3,2,119097,119097,119099,0,2,1
34050,3,3,119100,119100,119103,0,3,1
34051,3,2,119103,119103,119105,0,2,0
34052,3,1,119106,119106,119107,0,1,1
34053,4,1,119110,119110,119111,0,1,3
34054,4,3,119114,119114,119117,0,3,3
34055,5,1,119119,119119,119120,0,1,2
34056,5,1,119124,119124,119125,0,1,4
34057,5,1,119129,119129,119130,0,1,4
34058,1,1,119130,119130,119131,0,1,0
34059,5,2,119135,119135,119137,0,2,4
34060,4,1,119139,119139,119140,0,1,2
34061,5,1,119144,119144,119145,0,1,4
34062,4,3,119148,119148,119151,0,3,3
34063,6,2,119154,119154,119156,0,2,3
34064,1,2,119155,119156,119158,1,3,0
34065,3,3,119158,119158,119161,0,3,0
34066,4,2,119162,119162,119164,0,2,1
34067,6,2,119168,119168,119170,0,2,4
34068,3,3,119171,119171,119174,0,3,1
34069,6,3,119177,119177,119180,0,3,3
34070,2,2,119179,119180,119182,1,3,0
34071,1,3,119180,119182,119185,2,5,0
34072,6,1,119186,119186,119187,0,1,1
34073,4,1,119190,119190,119191,0,1,3
34074,5,2,119195,119195,119197,0,2,4
34075,2,3,119197,119197,119200,0,3,0
34076,1,1,119198,119200,119201,2,3,0
34077,3,3,119201,119201,119204,0,3,0
34078,1,3,119202,119204,119207,2,5,0
34079,6,1,119208,119208,119209,0,1,1
34080,4,2,119212,119212,119214,0,2,3
34081,1,3,119213,119214,119217,1,4,0
34082,1,2,119214,119217,119219,3,5,0
34083,1,2,119215,119219,119221,4,6,0
34084,5,1,119220,119221,119222,1,2,0
34085,6,3,119226,119226,119229,0,3,4
34086,2,2,119228,119229,119231,1,3,0
34087,2,1,119230,119231,119232,1,2,0
34088,1,1,119231,119232,119233,1,2,0
34089,1,3,119232,119233,119236,1,4,0
34090,5,3,119237,119237,119240,0,3,1
34091,4,2,119241,119241,119243,0,2,1
34092,2,2,119243,119243,119245,0,2,0
34093,3,3,119246,119246,119249,0,3,1
34094,6,3,119252,119252,119255,0,3,3
34095,5,1,119257,119257,119258,0,1,2
34096,4,1,119261,119261,119262,0,1,3
34097,5,2,119266,119266,119268,0,2,4
34098,6,2,119272,119272,119274,0,2,4
34099,1,2,119273,119274,119276,1,3,0
34100,4,1,119277,119277,119278,0,1,1
34101,6,3,119283,119283,119286,0,3,5
34102,4,1,119287,119287,119288,0,1,1
34103,5,3,119292,119292,119295,0,3,4
34104,1,2,119293,119295,119297,2,4,0
34105,2,2,119295,119297,119299,2,4,0
34106,2,2,119297,119299,119301,2,4,0
34107,6,1,119303,119303,119304,0,1,2
34108,3,2,119306,119306,119308,0,2,2
34109,1,3,119307,119308,119311,1,4,0
34110,6,2,119313,119313,119315,0,2,2
34111,1,1,119314,119315,119316,1,2,0
34112,4,3,119318,119318,119321,0,3,2
34113,1,1,119319,119321,119322,2,3,0
34114,2,2,119321,119322,119324,1,3,0
34115,6,2,119327,119327,119329,0,2,3
34116,5,2,119332,119332,119334,0,2,3
34117,4,1,119336,119336,119337,0,1,2
34118,4,2,119340,119340,119342,0,2,3
34119,3,1,119343,119343,119344,0,1,1
34120,5,3,119348,119348,119351,0,3,4
34121,4,2,119352,119352,119354,0,2,1
34122,1,1,119353,119354,119355,1,2,0
34123,3,1,119356,119356,119357,0,1,1
34124,3,3,119359,119359,119362,0,3,2
34125,5,1,119364,119364,119365,0,1,2
34126,2,2,119366,119366,119368,0,2,1
34127,3,3,119369,119369,119372,0,3,1
34128,2,3,119371,119372,119375,1,4,0
34129,6,2,119377,119377,119379,0,2,2
34130,3,3,119380,119380,119383,0,3,1
34131,2,1,119382,119383,119384,1,2,0
34132,6,1,119388,119388,119389,0,1,4
34133,6,3,119394,119394,119397,0,3,5
34134,5,2,119399,119399,119401,0,2,2
34135,3,1,119402,119402,119403,0,1,1
34136,4,3,119406,119406,119409,0,3,3
34137,5,1,119411,119411,119412,0,1,2
34138,4,2,119415,119415,119417,0,2,3
34139,2,2,119417,119417,119419,0,2,0
34140,4,1,119421,119421,119422,0,1,2
34141,1,3,119422,119422,119425,0,3,0
34142,4,2,119426,119426,119428,0,2,1
34143,6,1,119432,119432,119433,0,1,4
34144,2,3,119434,119434,119437,0,3,1
34145,2,1,119436,119437,119438,1,2,0
34146,1,2,119437,119438,119440,1,3,0
34147,3,3,119440,119440,119443,0,3,0
34148,6,2,119446,119446,119448,0,2,3
34149,3,2,119449,119449,119451,0,2,1
34150,2,2,119451,119451,119453,0,2,0
34151,4,2,119455,119455,119457,0,2,2
34152,3,1,119458,119458,119459,0,1,1
34153,4,2,119462,119462,119464,0,2,3
34154,1,1,119463,119464,119465,1,2,0
34155,5,3,119468,119468,119471,0,3,3
34156,5,1,119473,119473,119474,0,1,2
34157,6,2,119479,119479,119481,0,2,5
34158,1,3,119480,119481,119484,1,4,0
34159,6,3,119486,119486,119489,0,3,2
34160,4,2,119490,119490,119492,0,2,1
34161,1,3,119491,119492,119495,1,4,0
34162,4,1,119495,119495,119496,0,1,0
34163,3,2,119498,119498,119500,0,2,2
34164,2,1,119500,119500,119501,0,1,0
34165,2,3,119502,119502,119505,0,3,1
34166,3,2,119505,119505,119507,0,2,0
34167,5,1,119510,119510,119511,0,1,3
34168,1,1,119511,119511,119512,0,1,0
34169,6,2,119517,119517,119519,0,2,5
34170,3,2,119520,119520,119522,0,2,1
34171,5,2,119525,119525,119527,0,2,3
34172,2,1,119527,119527,119528,0,1,0
34173,6,3,119533,119533,119536,0,3,5
34174,6,3,119539,119539,119542,0,3,3
34175,5,1,119544,119544,119545,0,1,2
34176,6,3,119550,119550,119553,0,3,5
34177,3,3,119553,119553,119556,0,3,0
34178,2,3,119555,119556,119559,1,4,0
34179,2,2,119557,119559,119561,2,4,0
34180,4,2,119561,119561,119563,0,2,0
34181,5,3,119566,119566,119569,0,3,3
34182,5,1,119571,119571,119572,0,1,2
34183,1,3,119572,119572,119575,0,3,0
34184,4,1,119576,119576,119577,0,1,1
34185,5,3,119581,119581,119584,0,3,4
34186,4,3,119585,119585,119588,0,3,1
34187,3,3,119588,119588,119591,0,3,0
34188,4,1,119592,119592,119593,0,1,1
34189,5,3,119597,119597,119600,0,3,4
34190,3,2,119600,119600,119602,0,2,0
34191,2,1,119602,119602,119603,0,1,0
34192,5,2,119607,119607,119609,0,2,4
34193,4,2,119611,119611,119613,0,2,2
34194,6,3,119617,119617,119620,0,3,4
34195,4,1,119621,119621,119622,0,1,1
34196,5,3,119626,119626,119629,0,3,4
34197,2,1,119628,119629,119630,1,2,0
34198,6,2,119634,119634,119636,0,2,4
34199,4,3,119638,119638,119641,0,3,2
34200,2,3,119640,119641,119644,1,4,0
34201,1,1,119641,119644,119645,3,4,0
34202,1,2,119642,119645,119647,3,5,0
34203,4,2,119646,119647,119649,1,3,0
34204,2,3,119648,119649,119652,1,4,0
34205,6,3,119654,119654,119657,0,3,2
34206,6,2,119660,119660,119662,0,2,3
34207,4,2,119664,119664,119666,0,2,2
34208,2,1,119666,119666,119667,0,1,0
34209,3,1,119669,119669,119670,0,1,2
34210,2,2,119671,119671,119673,0,2,1
34211,6,3,119677,119677,119680,0,3,4
34212,4,2,119681,119681,119683,0,2,1
34213,2,2,119683,119683,119685,0,2,0
34214,2,2,119685,119685,119687,0,2,0
34215,3,2,119688,119688,119690,0,2,1
34216,1,3,119689,119690,119693,1,4,0
34217,1,3,119690,119693,119696,3,6,0
34218,3,1,119693,119696,119697,3,4,0
34219,3,1,119696,119697,119698,1,2,0
34220,1,3,119697,119698,119701,1,4,0
34221,3,1,119700,119701,119702,1,2,0
34222,1,2,119701,119702,119704,1,3,0
34223,4,3,119705,119705,119708,0,3,1
34224,2,1,119707,119708,119709,1,2,0
34225,6,1,119713,119713,119714,0,1,4
34226,3,3,119716,119716,119719,0,3,2
34227,5,2,119721,119721,119723,0,2,2
34228,6,3,119727,119727,119730,0,3,4
34229,4,2,119731,119731,119733,0,2,1
34230,4,3,119735,119735,119738,0,3,2
34231,4,1,119739,119739,119740,0,1,1
34232,2,1,119741,119741,119742,0,1,1
34233,1,2,119742,119742,119744,0,2,0
34234,5,2,119747,119747,119749,0,2,3
34235,2,3,119749,119749,119752,0,3,0
34236,2,1,119751,119752,119753,1,2,0
34237,4,1,119755,119755,119756,0,1,2
34238,6,3,119761,119761,119764,0,3,5
34239,1,2,119762,119764,119766,2,4,0
34240,6,3,119768,119768,119771,0,3,2
34241,3,3,119771,119771,119774,0,3,0
34242,4,2,119775,119775,119777,0,2,1
34243,4,2,119779,119779,119781,0,2,2
34244,6,2,119785,119785,119787,0,2,4
34245,2,3,119787,119787,119790,0,3,0
34246,5,3,119792,119792,119795,0,3,2
34247,6,3,119798,119798,119801,0,3,3
34248,2,1,119800,119801,119802,1,2,0
34249,5,3,119805,119805,119808,0,3,3
34250,5,1,119810,119810,119811,0,1,2
34251,3,3,119813,119813,119816,0,3,2
34252,3,3,119816,119816,119819,0,3,0
34253,4,3,119820,119820,119823,0,3,1
34254,6,2,119826,119826,119828,0,2,3
34255,3,1,119829,119829,119830,0,1,1
34256,6,2,119835,119835,119837,0,2,5
34257,1,2,119836,119837,119839,1,3,0
34258,6,3,119842,119842,119845,0,3,3
34259,6,1,119848,119848,119849,0,1,3
34260,5,2,119853,119853,119855,0,2,4
34261,6,1,119859,119859,119860,0,1,4
34262,2,2,119861,119861,119863,0,2,1
34263,3,3,119864,119864,119867,0,3,1
34264,2,3,119866,119867,119870,1,4,0
34265,5,3,119871,119871,119874,0,3,1
34266,3,2,119874,119874,119876,0,2,0
34267,5,1,119879,119879,119880,0,1,3
34268,3,2,119882,119882,119884,0,2,2
34269,3,3,119885,119885,119888,0,3,1
34270,6,1,119891,119891,119892,0,1,3
34271,6,1,119897,119897,119898,0,1,5
34272,5,3,119902,119902,119905,0,3,4
34273,1,2,119903,119905,119907,2,4,0
34274,6,2,119909,119909,119911,0,2,2
34275,1,2,119910,119911,119913,1,3,0
34276,2,2,119912,119913,119915,1,3,0
34277,3,3,119915,119915,119918,0,3,0
34278,5,1,119920,119920,119921,0,1,2
34279,4,1,119924,119924,119925,0,1,3
34280,1,1,119925,119925,119926,0,1,0
34281,1,2,119926,119926,119928,0,2,0
34282,5,1,119931,119931,119932,0,1,3
34283,4,3,119935,119935,119938,0,3,3
34284,6,1,119941,119941,119942,0,1,3
34285,1,1,119942,119942,119943,0,1,0
34286,4,2,119946,119946,119948,0,2,3
34287,6,1,119952,119952,119953,0,1,4
34288,1,2,119953,119953,119955,0,2,0
34289,6,1,119959,119959,119960,0,1,4
34290,4,3,119963,119963,119966,0,3,3
34291,6,2,119969,119969,119971,0,2,3
34292,4,2,119973,119973,119975,0,2,2
34293,1,3,119974,119975,119978,1,4,0
34294,2,3,119976,119978,119981,2,5,0
34295,2,1,119978,119981,119982,3,4,0
34296,6,3,119984,119984,119987,0,3,2
34297,4,1,119988,119988,119989,0,1,1
34298,6,1,119994,119994,119995,0,1,5
34299,1,1,119995,119995,119996,0,1,0
34300,4,2,119999,119999,120001,0,2,3
34301,1,2,120000,120001,120003,1,3,0
34302,1,3,120001,120003,120006,2,5,0
34303,4,1,120005,120006,120007,1,2,0
34304,6,1,120011,120011,120012,0,1,4
34305,2,2,120013,120013,120015,0,2,1
34306,6,2,120019,120019,120021,0,2,4
34307,6,3,120025,120025,120028,0,3,4
34308,5,2,120030,120030,120032,0,2,2
34309,3,2,120033,120033,120035,0,2,1
34310,1,3,120034,120035,120038,1,4,0
34311,5,1,120039,120039,120040,0,1,1
34312,2,3,120041,120041,120044,0,3,1
34313,6,1,120047,120047,120048,0,1,3
34314,4,3,120051,120051,120054,0,3,3
34315,6,1,120057,120057,120058,0,1,3
34316,4,1,120061,120061,120062,0,1,3
34317,6,3,120067,120067,120070,0,3,5
34318,5,2,120072,120072,120074,0,2,2
34319,4,1,120076,120076,120077,0,1,2
34320,3,3,120079,120079,120082,0,3,2
34321,1,3,120080,120082,120085,2,5,0
34322,4,1,120084,120085,120086,1,2,0
34323,1,3,120085,120086,120089,1,4,0
34324,3,3,120088,120089,120092,1,4,0
34325,6,3,120094,120094,120097,0,3,2
34326,3,2,120097,120097,120099,0,2,0
34327,6,1,120103,120103,120104,0,1,4
34328,4,2,120107,120107,120109,0,2,3
34329,5,3,120112,120112,120115,0,3,3
34330,6,3,120118,120118,120121,0,3,3
34331,5,2,120123,120123,120125,0,2,2
34332,4,2,120127,120127,120129,0,2,2
34333,5,2,120132,120132,120134,0,2,3
34334,3,3,120135,120135,120138,0,3,1
34335,6,1,120141,120141,120142,0,1,3
34336,3,2,120144,120144,120146,0,2,2
34337,6,3,120150,120150,120153,0,3,4
34338,2,2,120152,120153,120155,1,3,0
34339,6,1,120158,120158,120159,0,1,3
34340,4,2,120162,120162,120164,0,2,3
34341,3,3,120165,120165,120168,0,3,1
34342,1,3,120166,120168,120171,2,5,0
34343,2,2,120168,120171,120173,3,5,0
34344,4,2,120172,120173,120175,1,3,0
34345,5,1,120177,120177,120178,0,1,2
34346,4,2,120181,120181,120183,0,2,3
34347,4,1,120185,120185,120186,0,1,2
34348,3,3,120188,120188,120191,0,3,2
34349,6,1,120194,120194,120195,0,1,3
34350,2,1,120196,120196,120197,0,1,1
34351,1,3,120197,120197,120200,0,3,0
34352,2,1,120199,120200,120201,1,2,0
34353,4,2,120203,120203,120205,0,2,2
34354,2,2,120205,120205,120207,0,2,0
34355,5,3,120210,120210,120213,0,3,3
34356,3,2,120213,120213,120215,0,2,0
34357,3,3,120216,120216,120219,0,3,1
34358,4,1,120220,120220,120221,0,1,1
34359,5,1,120225,120225,120226,0,1,4
34360,2,3,120227,120227,120230,0,3,1
34361,2,2,120229,120230,120232,1,3,0
34362,4,3,120233,120233,120236,0,3,1
34363,5,1,120238,120238,120239,0,1,2
34364,1,3,120239,120239,120242,0,3,0
34365,2,3,120241,120242,120245,1,4,0
34366,6,2,120247,120247,120249,0,2,2
34367,6,2,120253,120253,120255,0,2,4
34368,3,1,120256,120256,120257,0,1,1
34369,5,1,120261,120261,120262,0,1,4
34370,1,3,120262,120262,120265,0,3,0
34371,2,3,120264,120265,120268,1,4,0
34372,3,3,120267,120268,120271,1,4,0
34373,2,2,120269,120271,120273,2,4,0
34374,4,3,120273,120273,120276,0,3,0
34375,1,2,120274,120276,120278,2,4,0
34376,2,1,120276,120278,120279,2,3,0
34377,6,1,120282,120282,120283,0,1,3
34378,2,3,120284,120284,120287,0,3,1
34379,2,3,120286,120287,120290,1,4,0
34380,6,2,120292,120292,120294,0,2,2
34381,6,1,120298,120298,120299,0,1,4
34382,3,3,120301,120301,120304,0,3,2
34383,3,1,120304,120304,120305,0,1,0
34384,5,1,120309,120309,120310,0,1,4
34385,1,2,120310,120310,120312,0,2,0
34386,4,1,120314,120314,120315,0,1,2
34387,4,1,120318,120318,120319,0,1,3
34388,2,2,120320,120320,120322,0,2,1
34389,4,1,120324,120324,120325,0,1,2
34390,4,1,120328,120328,120329,0,1,3
34391,4,1,120332,120332,120333,0,1,3
34392,5,3,120337,120337,120340,0,3,4
34393,1,2,120338,120340,120342,2,4,0
34394,1,2,120339,120342,120344,3,5,0
34395,5,2,120344,120344,120346,0,2,0
34396,1,3,120345,120346,120349,1,4,0
34397,5,3,120350,120350,120353,0,3,1
34398,5,3,120355,120355,120358,0,3,2
34399,1,2,120356,120358,120360,2,4,0
34400,1,3,120357,120360,120363,3,6,0
34401,3,2,120360,120363,120365,3,5,0
34402,1,1,120361,120365,120366,4,5,0
34403,1,2,120362,120366,120368,4,6,0
34404,6,3,120368,120368,120371,0,3,0
34405,3,3,120371,120371,120374,0,3,0
34406,4,3,120375,120375,120378,0,3,1
34407,4,3,120379,120379,120382,0,3,1
34408,1,2,120380,120382,120384,2,4,0
34409,6,3,120386,120386,120389,0,3,2
34410,3,2,120389,120389,120391,0,2,0
34411,6,2,120395,120395,120397,0,2,4
34412,6,2,120401,120401,120403,0,2,4
34413,5,2,120406,120406,120408,0,2,3
34414,2,1,120408,120408,120409,0,1,0
34415,6,2,120414,120414,120416,0,2,5
34416,3,1,120417,120417,120418,0,1,1
34417,6,1,120423,120423,120424,0,1,5
34418,6,3,120429,120429,120432,0,3,5
34419,2,2,120431,120432,120434,1,3,0
34420,2,1,120433,120434,120435,1,2,0
34421,4,1,120437,120437,120438,0,1,2
34422,6,1,120443,120443,120444,0,1,5
34423,6,1,120449,120449,120450,0,1,5
34424,3,1,120452,120452,120453,0,1,2
34425,3,3,120455,120455,120458,0,3,2
34426,5,3,120460,120460,120463,0,3,2
34427,6,1,120466,120466,120467,0,1,3
34428,2,2,120468,120468,120470,0,2,1
34429,3,1,120471,120471,120472,0,1,1
34430,2,3,120473,120473,120476,0,3,1
34431,5,1,120478,120478,120479,0,1,2
34432,1,2,120479,120479,120481,0,2,0
34433,6,1,120485,120485,120486,0,1,4
34434,1,2,120486,120486,120488,0,2,0
34435,4,1,120490,120490,120491,0,1,2
34436,1,2,120491,120491,120493,0,2,0
34437,3,3,120494,120494,120497,0,3,1
34438,6,3,120500,120500,120503,0,3,3
34439,5,1,120505,120505,120506,0,1,2
34440,3,1,120508,120508,120509,0,1,2
34441,1,2,120509,120509,120511,0,2,0
34442,3,2,120512,120512,120514,0,2,1
34443,4,2,120516,120516,120518,0,2,2
34444,3,1,120519,120519,120520,0,1,1
34445,5,3,120524,120524,120527,0,3,4
34446,1,2,120525,120527,120529,2,4,0
34447,4,2,120529,120529,120531,0,2,0
34448,4,1,120533,120533,120534,0,1,2
34449,2,2,120535,120535,120537,0,2,1
34450,4,1,120539,120539,120540,0,1,2
34451,4,3,120543,120543,120546,0,3,3
34452,2,1,120545,120546,120547,1,2,0
34453,4,2,120549,120549,120551,0,2,2
34454,1,3,120550,120551,120554,1,4,0
34455,1,1,120551,120554,120555,3,4,0
34456,6,1,120557,120557,120558,0,1,2
34457,5,3,120562,120562,120565,0,3,4
34458,4,3,120566,120566,120569,0,3,1
34459,1,3,120567,120569,120572,2,5,0
34460,5,1,120572,120572,120573,0,1,0
34461,2,2,120574,120574,120576,0,2,1
34462,3,2,120577,120577,120579,0,2,1
34463,6,3,120583,120583,120586,0,3,4
34464,4,1,120587,120587,120588,0,1,1
34465,4,1,120591,120591,120592,0,1,3
34466,5,2,120596,120596,120598,0,2,4
34467,3,3,120599,120599,120602,0,3,1
34468,1,1,120600,120602,120603,2,3,0
34469,4,2,120604,120604,120606,0,2,1
34470,3,2,120607,120607,120609,0,2,1
34471,3,1,120610,120610,120611,0,1,1
34472,6,2,120616,120616,120618,0,2,5
34473,5,2,120621,120621,120623,0,2,3
34474,6,3,120627,120627,120630,0,3,4
34475,5,1,120632,120632,120633,0,1,2
34476,1,2,120633,120633,120635,0,2,0
34477,2,2,120635,120635,120637,0,2,0
34478,6,2,120641,120641,120643,0,2,4
34479,6,2,120647,120647,120649,0,2,4
34480,5,2,120652,120652,120654,0,2,3
34481,1,1,120653,120654,120655,1,2,0
34482,6,3,120659,120659,120662,0,3,4
34483,1,3,120660,120662,120665,2,5,0
34484,4,3,120664,120665,120668,1,4,0
34485,4,3,120668,120668,120671,0,3,0
34486,5,2,120673,120673,120675,0,2,2
34487,4,1,120677,120677,120678,0,1,2
34488,6,1,120683,120683,120684,0,1,5
34489,2,2,120685,120685,120687,0,2,1
34490,2,3,120687,120687,120690,0,3,0
34491,6,1,120693,120693,120694,0,1,3
34492,5,1,120698,120698,120699,0,1,4
34493,5,1,120703,120703,120704,0,1,4
34494,6,2,120709,120709,120711,0,2,5
34495,5,1,120714,120714,120715,0,1,3
34496,4,3,120718,120718,120721,0,3,3
34497,4,2,120722,120722,120724,0,2,1
34498,1,1,120723,120724,120725,1,2,0
34499,3,2,120726,120726,120728,0,2,1
34500,1,3,120727,120728,120731,1,4,0
34501,1,3,120728,120731,120734,3,6,0
34502,4,1,120732,120734,120735,2,3,0
34503,3,3,120735,120735,120738,0,3,0
34504,5,1,120740,120740,120741,0,1,2
34505,3,2,120743,120743,120745,0,2,2
34506,6,1,120749,120749,120750,0,1,4
34507,3,1,120752,120752,120753,0,1,2
34508,2,3,120754,120754,120757,0,3,1
34509,4,1,120758,120758,120759,0,1,1
34510,5,2,120763,120763,120765,0,2,4
34511,5,2,120768,120768,120770,0,2,3
34512,4,2,120772,120772,120774,0,2,2
34513,1,3,120773,120774,120777,1,4,0
34514,3,1,120776,120777,120778,1,2,0
34515,4,1,120780,120780,120781,0,1,2
34516,3,2,120783,120783,120785,0,2,2
34517,4,2,120787,120787,120789,0,2,2
34518,5,3,120792,120792,120795,0,3,3
34519,4,3,120796,120796,120799,0,3,1
34520,4,1,120800,120800,120801,0,1,1
34521,2,2,120802,120802,120804,0,2,1
34522,6,3,120808,120808,120811,0,3,4
34523,6,2,120814,120814,120816,0,2,3
34524,3,1,120817,120817,120818,0,1,1
34525,1,1,120818,120818,120819,0,1,0
34526,2,2,120820,120820,120822,0,2,1
34527,5,2,120825,120825,120827,0,2,3
34528,1,2,120826,120827,120829,1,3,0
34529,3,2,120829,120829,120831,0,2,0
34530,1,1,120830,120831,120832,1,2,0
34531,1,2,120831,120832,120834,1,3,0
34532,3,1,120834,120834,120835,0,1,0
34533,5,1,120839,120839,120840,0,1,4
34534,3,1,120842,120842,120843,0,1,2
34535,6,1,120848,120848,120849,0,1,5
34536,1,2,120849,120849,120851,0,2,0
34537,5,2,120854,120854,120856,0,2,3
34538,1,1,120855,120856,120857,1,2,0
34539,6,3,120861,120861,120864,0,3,4
34540,6,2,120867,120867,120869,0,2,3
34541,2,3,120869,120869,120872,0,3,0
34542,1,1,120870,120872,120873,2,3,0
34543,2,2,120872,120873,120875,1,3,0
34544,2,2,120874,120875,120877,1,3,0
34545,6,1,120880,120880,120881,0,1,3
34546,3,1,120883,120883,120884,0,1,2
34547,5,3,120888,120888,120891,0,3,4
34548,4,2,120892,120892,120894,0,2,1
34549,5,1,120897,120897,120898,0,1,3
34550,1,1,120898,120898,120899,0,1,0
34551,5,1,120903,120903,120904,0,1,4
34552,5,2,120908,120908,120910,0,2,4
34553,3,3,120911,120911,120914,0,3,1
34554,1,1,120912,120914,120915,2,3,0
34555,5,2,120917,120917,120919,0,2,2
34556,5,2,120922,120922,120924,0,2,3
34557,4,2,120926,120926,120928,0,2,2
34558,4,3,120930,120930,120933,0,3,2
34559,2,1,120932,120933,120934,1,2,0
34560,6,2,120938,120938,120940,0,2,4
34561,6,2,120944,120944,120946,0,2,4
34562,1,3,120945,120946,120949,1,4,0
34563,4,3,120949,120949,120952,0,3,0
34564,3,1,120952,120952,120953,0,1,0
34565,4,1,120956,120956,120957,0,1,3
34566,4,2,120960,120960,120962,0,2,3
34567,6,1,120966,120966,120967,0,1,4
34568,5,1,120971,120971,120972,0,1,4
34569,5,2,120976,120976,120978,0,2,4
34570,6,3,120982,120982,120985,0,3,4
34571,6,1,120988,120988,120989,0,1,3
34572,4,1,120992,120992,120993,0,1,3
34573,1,3,120993,120993,120996,0,3,0
34574,6,3,120999,120999,121002,0,3,3
34575,1,3,121000,121002,121005,2,5,0
34576,3,2,121003,121005,121007,2,4,0
34577,5,1,121008,121008,121009,0,1,1
34578,2,1,121010,121010,121011,0,1,1
34579,1,1,121011,121011,121012,0,1,0
34580,3,2,121014,121014,121016,0,2,2
34581,5,1,121019,121019,121020,0,1,3
34582,3,2,121022,121022,121024,0,2,2
34583,2,3,121024,121024,121027,0,3,0
34584,6,3,121030,121030,121033,0,3,3
34585,4,2,121034,121034,121036,0,2,1
34586,1,3,121035,121036,121039,1,4,0
34587,5,3,121040,121040,121043,0,3,1
34588,2,2,121042,121043,121045,1,3,0
34589,3,1,121045,121045,121046,0,1,0
34590,3,3,121048,121048,121051,0,3,2
34591,3,1,121051,121051,121052,0,1,0
34592,1,2,121052,121052,121054,0,2,0
34593,1,1,121053,121054,121055,1,2,0
34594,6,2,121059,121059,121061,0,2,4
34595,5,1,121064,121064,121065,0,1,3
34596,5,2,121069,121069,121071,0,2,4
34597,6,1,121075,121075,121076,0,1,4
34598,6,2,121081,121081,121083,0,2,5
34599,1,1,121082,121083,121084,1,2,0
34600,4,1,121086,121086,121087,0,1,2
34601,1,3,121087,121087,121090,0,3,0
34602,4,1,121091,121091,121092,0,1,1
34603,6,1,121097,121097,121098,0,1,5
34604,2,3,121099,121099,121102,0,3,1
34605,6,1,121105,121105,121106,0,1,3
34606,1,3,121106,121106,121109,0,3,0
34607,6,1,121112,121112,121113,0,1,3
34608,3,2,121115,121115,121117,0,2,2
34609,2,3,121117,121117,121120,0,3,0
34610,3,1,121120,121120,121121,0,1,0
34611,6,3,121126,121126,121129,0,3,5
34612,2,1,121128,121129,121130,1,2,0
34613,4,3,121132,121132,121135,0,3,2
34614,3,2,121135,121135,121137,0,2,0
34615,5,1,121140,121140,121141,0,1,3
34616,4,2,121144,121144,121146,0,2,3
34617,3,3,121147,121147,121150,0,3,1
34618,6,1,121153,121153,121154,0,1,3
34619,4,1,121157,121157,121158,0,1,3
34620,4,3,121161,121161,121164,0,3,3
34621,1,3,121162,121164,121167,2,5,0
34622,6,3,121168,121168,121171,0,3,1
34623,3,2,121171,121171,121173,0,2,0
34624,2,3,121173,121173,121176,0,3,0
34625,3,1,121176,121176,121177,0,1,0
34626,2,2,121178,121178,121180,0,2,1
34627,5,1,121183,121183,121184,0,1,3
34628,5,2,121188,121188,121190,0,2,4
34629,1,2,121189,121190,121192,1,3,0
34630,6,2,121195,121195,121197,0,2,3
34631,3,3,121198,121198,121201,0,3,1
34632,1,2,121199,121201,121203,2,4,0
34633,1,3,121200,121203,121206,3,6,0
34634,1,2,121201,121206,121208,5,7,0
34635,1,3,121202,121208,121211,6,9,0
34636,2,2,121204,121211,121213,7,9,0
34637,3,3,121207,121213,121216,6,9,0
34638,3,1,121210,121216,121217,6,7,0
34639,1,3,121211,121217,121220,6,9,0
34640,6,3,121217,121220,121223,3,6,0
34641,3,2,121220,121223,121225,3,5,0
34642,6,3,121226,121226,121229,0,3,1
34643,1,2,121227,121229,121231,2,4,0
34644,4,3,121231,121231,121234,0,3,0
34645,3,1,121234,121234,121235,0,1,0
34646,3,2,121237,121237,121239,0,2,2
34647,6,3,121243,121243,121246,0,3,4
34648,6,2,121249,121249,121251,0,2,3
34649,1,1,121250,121251,121252,1,2,0
34650,1,1,121251,121252,121253,1,2,0
34651,6,2,121257,121257,121259,0,2,4
34652,4,1,121261,121261,121262,0,1,2
34653,1,1,121262,121262,121263,0,1,0
34654,4,1,121266,121266,121267,0,1,3
34655,1,2,121267,121267,121269,0,2,0
34656,6,2,121273,121273,121275,0,2,4
34657,6,1,121279,121279,121280,0,1,4
34658,2,3,121281,121281,121284,0,3,1
34659,5,3,121286,121286,121289,0,3,2
34660,1,1,121287,121289,121290,2,3,0
34661,1,1,121288,121290,121291,2,3,0
34662,4,3,121292,121292,121295,0,3,1
34663,1,3,121293,121295,121298,2,5,0
34664,6,2,121299,121299,121301,0,2,1
34665,5,3,121304,121304,121307,0,3,3
34666,1,2,121305,121307,121309,2,4,0
34667,1,1,121306,121309,121310,3,4,0
34668,2,3,121308,121310,121313,2,5,0
34669,4,1,121312,121313,121314,1,2,0
34670,5,2,121317,121317,121319,0,2,3
34671,3,2,121320,121320,121322,0,2,1
34672,4,1,121324,121324,121325,0,1,2
34673,5,1,121329,121329,121330,0,1,4
34674,4,3,121333,121333,121336,0,3,3
34675,1,3,121334,121336,121339,2,5,0
34676,6,2,121340,121340,121342,0,2,1
34677,6,1,121346,121346,121347,0,1,4
34678,6,1,121352,121352,121353,0,1,5
34679,5,1,121357,121357,121358,0,1,4
34680,1,2,121358,121358,121360,0,2,0
34681,6,2,121364,121364,121366,0,2,4
34682,3,2,121367,121367,121369,0,2,1
34683,5,1,121372,121372,121373,0,1,3
34684,3,2,121375,121375,121377,0,2,2
34685,4,1,121379,121379,121380,0,1,2
34686,2,1,121381,121381,121382,0,1,1
34687,2,2,121383,121383,121385,0,2,1
34688,2,1,121385,121385,121386,0,1,0
34689,4,2,121389,121389,121391,0,2,3
34690,5,3,121394,121394,121397,0,3,3
34691,6,1,121400,121400,121401,0,1,3
34692,1,2,121401,121401,121403,0,2,0
34693,6,1,121407,121407,121408,0,1,4
34694,5,3,121412,121412,121415,0,3,4
34695,2,1,121414,121415,121416,1,2,0
34696,4,1,121418,121418,121419,0,1,2
34697,5,1,121423,121423,121424,0,1,4
34698,1,2,121424,121424,121426,0,2,0
34699,6,1,121430,121430,121431,0,1,4
34700,5,1,121435,121435,121436,0,1,4
34701,3,2,121438,121438,121440,0,2,2
34702,4,3,121442,121442,121445,0,3,2
34703,1,1,121443,121445,121446,2,3,0
34704,5,3,121448,121448,121451,0,3,2
34705,6,1,121454,121454,121455,0,1,3
34706,5,1,121459,121459,121460,0,1,4
34707,6,1,121465,121465,121466,0,1,5
34708,6,1,121471,121471,121472,0,1,5
34709,3,2,121474,121474,121476,0,2,2
34710,6,2,121480,121480,121482,0,2,4
34711,1,3,121481,121482,121485,1,4,0
34712,6,2,121487,121487,121489,0,2,2
34713,1,2,121488,121489,121491,1,3,0
34714,6,1,121494,121494,121495,0,1,3
34715,1,1,121495,121495,121496,0,1,0
34716,4,1,121499,121499,121500,0,1,3
34717,1,3,121500,121500,121503,0,3,0
34718,2,1,121502,121503,121504,1,2,0
34719,1,2,121503,121504,121506,1,3,0
34720,1,3,121504,121506,121509,2,5,0
34721,5,3,121509,121509,121512,0,3,0
34722,1,3,121510,121512,121515,2,5,0
34723,5,3,121515,121515,121518,0,3,0
34724,4,3,121519,121519,121522,0,3,1
34725,2,3,121521,121522,121525,1,4,0
34726,5,3,121526,121526,121529,0,3,1
34727,1,1,121527,121529,121530,2,3,0
34728,1,1,121528,121530,121531,2,3,0
34729,3,1,121531,121531,121532,0,1,0
34730,1,2,121532,121532,121534,0,2,0
34731,2,2,121534,121534,121536,0,2,0
34732,5,1,121539,121539,121540,0,1,3
34733,3,3,121542,121542,121545,0,3,2
34734,5,1,121547,121547,121548,0,1,2
34735,6,2,121553,121553,121555,0,2,5
34736,6,2,121559,121559,121561,0,2,4
34737,4,1,121563,121563,121564,0,1,2
34738,4,2,121567,121567,121569,0,2,3
34739,3,3,121570,121570,121573,0,3,1
34740,4,3,121574,121574,121577,0,3,1
34741,4,2,121578,121578,121580,0,2,1
34742,4,1,121582,121582,121583,0,1,2
34743,6,1,121588,121588,121589,0,1,5
34744,3,2,121591,121591,121593,0,2,2
34745,4,2,121595,121595,121597,0,2,2
34746,6,2,121601,121601,121603,0,2,4
34747,4,1,121605,121605,121606,0,1,2
34748,4,2,121609,121609,121611,0,2,3
34749,3,2,121612,121612,121614,0,2,1
34750,5,2,121617,121617,121619,0,2,3
34751,2,3,121619,121619,121622,0,3,0
34752,2,2,121621,121622,121624,1,3,0
34753,5,2,121626,121626,121628,0,2,2
34754,5,2,121631,121631,121633,0,2,3
34755,6,3,121637,121637,121640,0,3,4
34756,3,2,121640,121640,121642,0,2,0
34757,3,1,121643,121643,121644,0,1,1
34758,5,1,121648,121648,121649,0,1,4
34759,2,3,121650,121650,121653,0,3,1
34760,3,3,121653,121653,121656,0,3,0
34761,5,3,121658,121658,121661,0,3,2
34762,5,3,121663,121663,121666,0,3,2
34763,2,3,121665,121666,121669,1,4,0
34764,6,1,121671,121671,121672,0,1,2
34765,3,3,121674,121674,121677,0,3,2
34766,3,3,121677,121677,121680,0,3,0
34767,3,1,121680,121680,121681,0,1,0
34768,6,3,121686,121686,121689,0,3,5
34769,5,3,121691,121691,121694,0,3,2
34770,6,2,121697,121697,121699,0,2,3
34771,3,3,121700,121700,121703,0,3,1
34772,2,3,121702,121703,121706,1,4,0
34773,2,1,121704,121706,121707,2,3,0
34774,2,1,121706,121707,121708,1,2,0
34775,3,1,121709,121709,121710,0,1,1
34776,4,2,121713,121713,121715,0,2,3
34777,2,2,121715,121715,121717,0,2,0
34778,6,2,121721,121721,121723,0,2,4
34779,4,2,121725,121725,121727,0,2,2
34780,6,1,121731,121731,121732,0,1,4
34781,6,2,121737,121737,121739,0,2,5
34782,2,1,121739,121739,121740,0,1,0
34783,6,2,121745,121745,121747,0,2,5
34784,5,3,121750,121750,121753,0,3,3
34785,3,3,121753,121753,121756,0,3,0
34786,1,1,121754,121756,121757,2,3,0
34787,6,2,121760,121760,121762,0,2,3
34788,3,1,121763,121763,121764,0,1,1
34789,6,3,121769,121769,121772,0,3,5
34790,3,2,121772,121772,121774,0,2,0
34791,4,2,121776,121776,121778,0,2,2
34792,4,2,121780,121780,121782,0,2,2
34793,5,2,121785,121785,121787,0,2,3
34794,6,3,121791,121791,121794,0,3,4
34795,3,2,121794,121794,121796,0,2,0
34796,5,3,121799,121799,121802,0,3,3
34797,5,3,121804,121804,121807,0,3,2
34798,3,1,121807,121807,121808,0,1,0
34799,5,1,121812,121812,121813,0,1,4
34800,4,2,121816,121816,121818,0,2,3
34801,6,3,121822,121822,121825,0,3,4
34802,4,3,121826,121826,121829,0,3,1
34803,5,1,121831,121831,121832,0,1,2
34804,5,3,121836,121836,121839,0,3,4
34805,5,3,121841,121841,121844,0,3,2
34806,6,1,121847,121847,121848,0,1,3
34807,6,3,121853,121853,121856,0,3,5
34808,5,2,121858,121858,121860,0,2,2
34809,2,1,121860,121860,121861,0,1,0
34810,5,3,121865,121865,121868,0,3,4
34811,1,2,121866,121868,121870,2,4,0
34812,2,2,121868,121870,121872,2,4,0
34813,4,1,121872,121872,121873,0,1,0
34814,4,1,121876,121876,121877,0,1,3
34815,1,3,121877,121877,121880,0,3,0
34816,5,1,121882,121882,121883,0,1,2
34817,2,2,121884,121884,121886,0,2,1
34818,2,3,121886,121886,121889,0,3,0
34819,1,3,121887,121889,121892,2,5,0
34820,3,1,121890,121892,121893,2,3,0
34821,3,2,121893,121893,121895,0,2,0
34822,1,1,121894,121895,121896,1,2,0
34823,5,3,121899,121899,121902,0,3,3
34824,1,1,121900,121902,121903,2,3,0
34825,4,3,121904,121904,121907,0,3,1
34826,2,1,121906,121907,121908,1,2,0
34827,2,3,121908,121908,121911,0,3,0
34828,4,1,121912,121912,121913,0,1,1
34829,5,2,121917,121917,121919,0,2,4
34830,4,2,121921,121921,121923,0,2,2
34831,4,2,121925,121925,121927,0,2,2
34832,4,1,121929,121929,121930,0,1,2
34833,4,1,121933,121933,121934,0,1,3
34834,2,1,121935,121935,121936,0,1,1
34835,4,3,121939,121939,121942,0,3,3
34836,1,3,121940,121942,121945,2,5,0
34837,3,1,121943,121945,121946,2,3,0
34838,2,2,121945,121946,121948,1,3,0
34839,1,3,121946,121948,121951,2,5,0
34840,5,3,121951,121951,121954,0,3,0
34841,4,2,121955,121955,121957,0,2,1
34842,5,2,121960,121960,121962,0,2,3
34843,1,2,121961,121962,121964,1,3,0
34844,3,3,121964,121964,121967,0,3,0
34845,3,2,121967,121967,121969,0,2,0
34846,2,2,121969,121969,121971,0,2,0
34847,3,2,121972,121972,121974,0,2,1
34848,6,2,121978,121978,121980,0,2,4
34849,1,2,121979,121980,121982,1,3,0
34850,3,1,121982,121982,121983,0,1,0
34851,3,2,121985,121985,121987,0,2,2
34852,6,3,121991,121991,121994,0,3,4
34853,5,1,121996,121996,121997,0,1,2
34854,4,2,122000,122000,122002,0,2,3
34855,1,2,122001,122002,122004,1,3,0
34856,1,1,122002,122004,122005,2,3,0
34857,1,1,122003,122005,122006,2,3,0
34858,4,1,122007,122007,122008,0,1,1
34859,3,1,122010,122010,122011,0,1,2
34860,4,3,122014,122014,122017,0,3,3
34861,1,3,122015,122017,122020,2,5,0
34862,4,1,122019,122020,122021,1,2,0
34863,1,3,122020,122021,122024,1,4,0
34864,3,2,122023,122024,122026,1,3,0
34865,6,2,122029,122029,122031,0,2,3
34866,1,1,122030,122031,122032,1,2,0
34867,2,3,122032,122032,122035,0,3,0
34868,5,2,122037,122037,122039,0,2,2
34869,4,2,122041,122041,122043,0,2,2
34870,1,2,122042,122043,122045,1,3,0
34871,4,3,122046,122046,122049,0,3,1
34872,6,1,122052,122052,122053,0,1,3
34873,6,2,122058,122058,122060,0,2,5
34874,5,3,122063,122063,122066,0,3,3
34875,5,1,122068,122068,122069,0,1,2
34876,6,3,122074,122074,122077,0,3,5
34877,1,3,122075,122077,122080,2,5,0
34878,5,2,122080,122080,122082,0,2,0
34879,4,2,122084,122084,122086,0,2,2
34880,1,2,122085,122086,122088,1,3,0
34881,3,1,122088,122088,122089,0,1,0
34882,2,2,122090,122090,122092,0,2,1
34883,5,3,122095,122095,122098,0,3,3
34884,4,2,122099,122099,122101,0,2,1
34885,5,2,122104,122104,122106,0,2,3
34886,5,2,122109,122109,122111,0,2,3
34887,2,1,122111,122111,122112,0,1,0
34888,1,3,122112,122112,122115,0,3,0
34889,5,1,122117,122117,122118,0,1,2
34890,1,2,122118,122118,122120,0,2,0
34891,6,3,122124,122124,122127,0,3,4
34892,6,2,122130,122130,122132,0,2,3
34893,1,1,122131,122132,122133,1,2,0
34894,1,2,122132,122133,122135,1,3,0
34895,2,2,122134,122135,122137,1,3,0
34896,4,3,122138,122138,122141,0,3,1
34897,3,2,122141,122141,122143,0,2,0
34898,3,1,122144,122144,122145,0,1,1
34899,6,2,122150,122150,122152,0,2,5
34900,4,3,122154,122154,122157,0,3,2
34901,5,1,122159,122159,122160,0,1,2
34902,4,3,122163,122163,122166,0,3,3
34903,3,2,122166,122166,122168,0,2,0
34904,3,2,122169,122169,122171,0,2,1
34905,1,2,122170,122171,122173,1,3,0
34906,1,2,122171,122173,122175,2,4,0
34907,5,3,122176,122176,122179,0,3,1
34908,6,1,122182,122182,122183,0,1,3
34909,2,2,122184,122184,122186,0,2,1
34910,3,1,122187,122187,122188,0,1,1
34911,4,1,122191,122191,122192,0,1,3
34912,1,1,122192,122192,122193,0,1,0
34913,6,3,122198,122198,122201,0,3,5
34914,4,1,122202,122202,122203,0,1,1
34915,4,1,122206,122206,122207,0,1,3
34916,6,1,122212,122212,122213,0,1,5
34917,2,1,122214,122214,122215,0,1,1
34918,2,1,122216,122216,122217,0,1,1
34919,1,1,122217,122217,122218,0,1,0
34920,2,1,122219,122219,122220,0,1,1
34921,6,1,122225,122225,122226,0,1,5
34922,4,3,122229,122229,122232,0,3,3
34923,5,3,122234,122234,122237,0,3,2
34924,4,3,122238,122238,122241,0,3,1
34925,3,2,122241,122241,122243,0,2,0
34926,4,3,122245,122245,122248,0,3,2
34927,3,2,122248,122248,122250,0,2,0
34928,6,2,122254,122254,122256,0,2,4
34929,2,2,122256,122256,122258,0,2,0
34930,1,1,122257,122258,122259,1,2,0
34931,5,2,122262,122262,122264,0,2,3
34932,3,2,122265,122265,122267,0,2,1
34933,1,3,122266,122267,122270,1,4,0
34934,5,1,122271,122271,122272,0,1,1
34935,4,3,122275,122275,122278,0,3,3
34936,4,1,122279,122279,122280,0,1,1
34937,5,3,122284,122284,122287,0,3,4
34938,2,3,122286,122287,122290,1,4,0
34939,3,3,122289,122290,122293,1,4,0
34940,3,1,122292,122293,122294,1,2,0
34941,6,2,122298,122298,122300,0,2,4
34942,4,1,122302,122302,122303,0,1,2
34943,1,3,122303,122303,122306,0,3,0
34944,2,2,122305,122306,122308,1,3,0
34945,3,1,122308,122308,122309,0,1,0
34946,3,1,122311,122311,122312,0,1,2
34947,6,3,122317,122317,122320,0,3,5
34948,6,1,122323,122323,122324,0,1,3
34949,3,2,122326,122326,122328,0,2,2
34950,6,1,122332,122332,122333,0,1,4
34951,1,2,122333,122333,122335,0,2,0
34952,2,2,122335,122335,122337,0,2,0
34953,2,1,122337,122337,122338,0,1,0
34954,6,3,122343,122343,122346,0,3,5
34955,1,2,122344,122346,122348,2,4,0
34956,5,2,122349,122349,122351,0,2,1
34957,2,1,122351,122351,122352,0,1,0
34958,3,1,122354,122354,122355,0,1,2
34959,1,3,122355,122355,122358,0,3,0
34960,3,1,122358,122358,122359,0,1,0
34961,4,1,122362,122362,122363,0,1,3
34962,5,2,122367,122367,122369,0,2,4
34963,5,1,122372,122372,122373,0,1,3
34964,6,3,122378,122378,122381,0,3,5
34965,4,2,122382,122382,122384,0,2,1
34966,6,1,122388,122388,122389,0,1,4
34967,4,1,122392,122392,122393,0,1,3
34968,4,1,122396,122396,122397,0,1,3
34969,2,3,122398,122398,122401,0,3,1
34970,3,3,122401,122401,122404,0,3,0
34971,4,2,122405,122405,122407,0,2,1
34972,3,1,122408,122408,122409,0,1,1
34973,5,2,122413,122413,122415,0,2,4
34974,4,3,122417,122417,122420,0,3,2
34975,1,2,122418,122420,122422,2,4,0
34976,5,1,122423,122423,122424,0,1,1
34977,1,1,122424,122424,122425,0,1,0
34978,3,1,122427,122427,122428,0,1,2
34979,3,3,122430,122430,122433,0,3,2
34980,3,3,122433,122433,122436,0,3,0
34981,5,2,122438,122438,122440,0,2,2
34982,3,3,122441,122441,122444,0,3,1
34983,2,2,122443,122444,122446,1,3,0
34984,2,2,122445,122446,122448,1,3,0
34985,5,2,122450,122450,122452,0,2,2
34986,2,3,122452,122452,122455,0,3,0
34987,6,1,122458,122458,122459,0,1,3
34988,1,1,122459,122459,122460,0,1,0
34989,6,2,122465,122465,122467,0,2,5
34990,2,2,122467,122467,122469,0,2,0
34991,2,3,122469,122469,122472,0,3,0
34992,6,1,122475,122475,122476,0,1,3
34993,1,1,122476,122476,122477,0,1,0
34994,6,3,122482,122482,122485,0,3,5
34995,6,2,122488,122488,122490,0,2,3
34996,3,3,122491,122491,122494,0,3,1
34997,6,1,122497,122497,122498,0,1,3
34998,6,3,122503,122503,122506,0,3,5
34999,6,3,122509,122509,122512,0,3,3
35000,2,2,122511,122512,122514,1,3,0
35001,1,2,122512,122514,122516,2,4,0
35002,1,1,122513,122516,122517,3,4,0
35003,1,3,122514,122517,122520,3,6,0
35004,6,2,122520,122520,122522,0,2,0
35005,5,2,122525,122525,122527,0,2,3
35006,1,2,122526,122527,122529,1,3,0
35007,1,1,122527,122529,122530,2,3,0
35008,3,2,122530,122530,122532,0,2,0
35009,3,2,122533,122533,122535,0,2,1
35010,1,3,122534,122535,122538,1,4,0
35011,3,3,122537,122538,122541,1,4,0
35012,4,2,122541,122541,122543,0,2,0
35013,5,2,122546,122546,122548,0,2,3
35014,2,1,122548,122548,122549,0,1,0
35015,5,2,122553,122553,122555,0,2,4
35016,4,2,122557,122557,122559,0,2,2
35017,5,2,122562,122562,122564,0,2,3
35018,5,2,122567,122567,122569,0,2,3
35019,6,2,122573,122573,122575,0,2,4
35020,3,2,122576,122576,122578,0,2,1
35021,1,3,122577,122578,122581,1,4,0
35022,6,2,122583,122583,122585,0,2,2
35023,4,2,122587,122587,122589,0,2,2
35024,5,1,122592,122592,122593,0,1,3
35025,3,2,122595,122595,122597,0,2,2
35026,1,1,122596,122597,122598,1,2,0
35027,3,1,122599,122599,122600,0,1,1
35028,1,3,122600,122600,122603,0,3,0
35029,3,1,122603,122603,122604,0,1,0
35030,1,3,122604,122604,122607,0,3,0
35031,2,3,122606,122607,122610,1,4,0
35032,1,2,122607,122610,122612,3,5,0
35033,1,2,122608,122612,122614,4,6,0
35034,1,3,122609,122614,122617,5,8,0
35035,5,2,122614,122617,122619,3,5,0
35036,5,2,122619,122619,122621,0,2,0
35037,3,1,122622,122622,122623,0,1,1
35038,2,1,122624,122624,122625,0,1,1
35039,1,3,122625,122625,122628,0,3,0
35040,2,3,122627,122628,122631,1,4,0
35041,3,2,122630,122631,122633,1,3,0
35042,6,1,122636,122636,122637,0,1,3
35043,2,2,122638,122638,122640,0,2,1
35044,1,2,122639,122640,122642,1,3,0
35045,5,2,122644,122644,122646,0,2,2
35046,2,1,122646,122646,122647,0,1,0
35047,2,1,122648,122648,122649,0,1,1
35048,4,1,122652,122652,122653,0,1,3
35049,3,2,122655,122655,122657,0,2,2
35050,5,2,122660,122660,122662,0,2,3
35051,6,1,122666,122666,122667,0,1,4
35052,6,3,122672,122672,122675,0,3,5
35053,3,3,122675,122675,122678,0,3,0
35054,1,2,122676,122678,122680,2,4,0
35055,2,1,122678,122680,122681,2,3,0
35056,2,2,122680,122681,122683,1,3,0
35057,5,3,122685,122685,122688,0,3,2
35058,2,2,122687,122688,122690,1,3,0
35059,3,2,122690,122690,122692,0,2,0
35060,6,2,122696,122696,122698,0,2,4
35061,1,3,122697,122698,122701,1,4,0
35062,4,1,122701,122701,122702,0,1,0
35063,4,2,122705,122705,122707,0,2,3
35064,6,3,122711,122711,122714,0,3,4
35065,2,1,122713,122714,122715,1,2,0
35066,3,1,122716,122716,122717,0,1,1
35067,5,2,122721,122721,122723,0,2,4
35068,2,2,122723,122723,122725,0,2,0
35069,2,3,122725,122725,122728,0,3,0
35070,1,2,122726,122728,122730,2,4,0
35071,2,3,122728,122730,122733,2,5,0
35072,1,1,122729,122733,122734,4,5,0
35073,1,3,122730,122734,122737,4,7,0
35074,2,3,122732,122737,122740,5,8,0
35075,6,2,122738,122740,122742,2,4,0
35076,1,1,122739,122742,122743,3,4,0
35077,5,3,122744,122744,122747,0,3,1
35078,2,1,122746,122747,122748,1,2,0
35079,4,2,122750,122750,122752,0,2,2
35080,5,1,122755,122755,122756,0,1,3
35081,5,3,122760,122760,122763,0,3,4
35082,1,1,122761,122763,122764,2,3,0
35083,5,2,122766,122766,122768,0,2,2
35084,3,3,122769,122769,122772,0,3,1
35085,6,2,122775,122775,122777,0,2,3
35086,2,3,122777,122777,122780,0,3,0
35087,6,1,122783,122783,122784,0,1,3
35088,5,1,122788,122788,122789,0,1,4
35089,2,1,122790,122790,122791,0,1,1
35090,6,3,122796,122796,122799,0,3,5
35091,2,2,122798,122799,122801,1,3,0
35092,1,3,122799,122801,122804,2,5,0
35093,3,3,122802,122804,122807,2,5,0
35094,3,1,122805,122807,122808,2,3,0
35095,4,3,122809,122809,122812,0,3,1
35096,2,1,122811,122812,122813,1,2,0
35097,2,1,122813,122813,122814,0,1,0
35098,1,2,122814,122814,122816,0,2,0
35099,6,1,122820,122820,122821,0,1,4
35100,6,2,122826,122826,122828,0,2,5
35101,1,2,122827,122828,122830,1,3,0
35102,5,1,122832,122832,122833,0,1,2
35103,6,3,122838,122838,122841,0,3,5
35104,5,2,122843,122843,122845,0,2,2
35105,4,1,122847,122847,122848,0,1,2
35106,5,1,122852,122852,122853,0,1,4
35107,5,1,122857,122857,122858,0,1,4
35108,2,3,122859,122859,122862,0,3,1
35109,4,2,122863,122863,122865,0,2,1
35110,1,2,122864,122865,122867,1,3,0
35111,4,2,122868,122868,122870,0,2,1
35112,3,3,122871,122871,122874,0,3,1
35113,6,1,122877,122877,122878,0,1,3
35114,1,3,122878,122878,122881,0,3,0
35115,6,1,122884,122884,122885,0,1,3
35116,4,3,122888,122888,122891,0,3,3
35117,6,1,122894,122894,122895,0,1,3
35118,6,3,122900,122900,122903,0,3,5
35119,6,3,122906,122906,122909,0,3,3
35120,1,1,122907,122909,122910,2,3,0
35121,3,1,122910,122910,122911,0,1,0
35122,3,2,122913,122913,122915,0,2,2
35123,6,2,122919,122919,122921,0,2,4
35124,1,2,122920,122921,122923,1,3,0
35125,5,1,122925,122925,122926,0,1,2
35126,1,3,122926,122926,122929,0,3,0
35127,6,2,122932,122932,122934,0,2,3
35128,5,3,122937,122937,122940,0,3,3
35129,4,3,122941,122941,122944,0,3,1
35130,2,1,122943,122944,122945,1,2,0
35131,6,2,122949,122949,122951,0,2,4
35132,3,2,122952,122952,122954,0,2,1
35133,2,2,122954,122954,122956,0,2,0
35134,2,1,122956,122956,122957,0,1,0
35135,1,2,122957,122957,122959,0,2,0
35136,2,3,122959,122959,122962,0,3,0
35137,2,1,122961,122962,122963,1,2,0
35138,4,3,122965,122965,122968,0,3,2
35139,3,2,122968,122968,122970,0,2,0
35140,2,1,122970,122970,122971,0,1,0
35141,6,2,122976,122976,122978,0,2,5
35142,6,3,122982,122982,122985,0,3,4
35143,3,1,122985,122985,122986,0,1,0
35144,1,3,122986,122986,122989,0,3,0
35145,4,2,122990,122990,122992,0,2,1
35146,4,3,122994,122994,122997,0,3,2
35147,1,3,122995,122997,123000,2,5,0
35148,3,3,122998,123000,123003,2,5,0
35149,1,2,122999,123003,123005,4,6,0
35150,2,2,123001,123005,123007,4,6,0
35151,4,1,123005,123007,123008,2,3,0
35152,2,2,123007,123008,123010,1,3,0
35153,2,2,123009,123010,123012,1,3,0
35154,5,3,123014,123014,123017,0,3,2
35155,5,3,123019,123019,123022,0,3,2
35156,6,1,123025,123025,123026,0,1,3
35157,1,3,123026,123026,123029,0,3,0
35158,2,1,123028,123029,123030,1,2,0
35159,1,1,123029,123030,123031,1,2,0
35160,6,2,123035,123035,123037,0,2,4
35161,5,2,123040,123040,123042,0,2,3
35162,1,3,123041,123042,123045,1,4,0
35163,4,1,123045,123045,123046,0,1,0
35164,1,2,123046,123046,123048,0,2,0
35165,6,2,123052,123052,123054,0,2,4
35166,3,1,123055,123055,123056,0,1,1
35167,1,2,123056,123056,123058,0,2,0
35168,5,1,123061,123061,123062,0,1,3
35169,1,1,123062,123062,123063,0,1,0
35170,3,3,123065,123065,123068,0,3,2
35171,4,1,123069,123069,123070,0,1,1
35172,2,1,123071,123071,123072,0,1,1
35173,3,1,123074,123074,123075,0,1,2
35174,5,1,123079,123079,123080,0,1,4
35175,3,3,123082,123082,123085,0,3,2
35176,1,3,123083,123085,123088,2,5,0
35177,5,1,123088,123088,123089,0,1,0
35178,1,2,123089,123089,123091,0,2,0
35179,1,1,123090,123091,123092,1,2,0
35180,1,2,123091,123092,123094,1,3,0
35181,2,1,123093,123094,123095,1,2,0
35182,2,2,123095,123095,123097,0,2,0
35183,1,2,123096,123097,123099,1,3,0
35184,4,1,123100,123100,123101,0,1,1
35185,6,3,123106,123106,123109,0,3,5
35186,3,1,123109,123109,123110,0,1,0
35187,3,2,123112,123112,123114,0,2,2
35188,2,2,123114,123114,123116,0,2,0
35189,4,1,123118,123118,123119,0,1,2
35190,4,2,123122,123122,123124,0,2,3
35191,1,3,123123,123124,123127,1,4,0
35192,4,2,123127,123127,123129,0,2,0
35193,4,3,123131,123131,123134,0,3,2
35194,5,3,123136,123136,123139,0,3,2
35195,1,1,123137,123139,123140,2,3,0
35196,5,3,123142,123142,123145,0,3,2
35197,4,3,123146,123146,123149,0,3,1
35198,4,3,123150,123150,123153,0,3,1
35199,1,2,123151,123153,123155,2,4,0
35200,1,2,123152,123155,123157,3,5,0
35201,1,1,123153,123157,123158,4,5,0
35202,6,1,123159,123159,123160,0,1,1
35203,2,3,123161,123161,123164,0,3,1
35204,2,3,123163,123164,123167,1,4,0
35205,4,3,123167,123167,123170,0,3,0
35206,4,2,123171,123171,123173,0,2,1
35207,3,1,123174,123174,123175,0,1,1
35208,6,1,123180,123180,123181,0,1,5
35209,2,2,123182,123182,123184,0,2,1
35210,4,1,123186,123186,123187,0,1,2
35211,3,1,123189,123189,123190,0,1,2
35212,4,2,123193,123193,123195,0,2,3
35213,1,1,123194,123195,123196,1,2,0
35214,4,1,123198,123198,123199,0,1,2
35215,4,3,123202,123202,123205,0,3,3
35216,3,3,123205,123205,123208,0,3,0
35217,1,1,123206,123208,123209,2,3,0
35218,4,3,123210,123210,123213,0,3,1
35219,3,2,123213,123213,123215,0,2,0
35220,6,3,123219,123219,123222,0,3,4
35221,5,2,123224,123224,123226,0,2,2
35222,4,1,123228,123228,123229,0,1,2
35223,5,3,123233,123233,123236,0,3,4
35224,6,1,123239,123239,123240,0,1,3
35225,4,3,123243,123243,123246,0,3,3
35226,3,3,123246,123246,123249,0,3,0
35227,5,1,123251,123251,123252,0,1,2
35228,5,3,123256,123256,123259,0,3,4
35229,4,3,123260,123260,123263,0,3,1
35230,4,2,123264,123264,123266,0,2,1
35231,6,2,123270,123270,123272,0,2,4
35232,5,2,123275,123275,123277,0,2,3
35233,4,3,123279,123279,123282,0,3,2
35234,1,3,123280,123282,123285,2,5,0
35235,5,1,123285,123285,123286,0,1,0
35236,1,1,123286,123286,123287,0,1,0
35237,1,2,123287,123287,123289,0,2,0
35238,4,2,123291,123291,123293,0,2,2
35239,4,1,123295,123295,123296,0,1,2
35240,2,1,123297,123297,123298,0,1,1
35241,5,3,123302,123302,123305,0,3,4
35242,1,3,123303,123305,123308,2,5,0
35243,6,3,123309,123309,123312,0,3,1
35244,3,1,123312,123312,123313,0,1,0
35245,1,3,123313,123313,123316,0,3,0
35246,4,2,123317,123317,123319,0,2,1
35247,1,3,123318,123319,123322,1,4,0
35248,5,1,123323,123323,123324,0,1,1
35249,3,1,123326,123326,123327,0,1,2
35250,3,3,123329,123329,123332,0,3,2
35251,6,2,123335,123335,123337,0,2,3
35252,3,3,123338,123338,123341,0,3,1
35253,1,3,123339,123341,123344,2,5,0
35254,6,2,123345,123345,123347,0,2,1
35255,3,1,123348,123348,123349,0,1,1
35256,5,1,123353,123353,123354,0,1,4
35257,2,1,123355,123355,123356,0,1,1
35258,1,1,123356,123356,123357,0,1,0
35259,6,2,123362,123362,123364,0,2,5
35260,6,3,123368,123368,123371,0,3,4
35261,1,3,123369,123371,123374,2,5,0
35262,6,1,123375,123375,123376,0,1,1
35263,3,1,123378,123378,123379,0,1,2
35264,2,3,123380,123380,123383,0,3,1
35265,5,2,123385,123385,123387,0,2,2
35266,6,2,123391,123391,123393,0,2,4
35267,2,2,123393,123393,123395,0,2,0
35268,5,2,123398,123398,123400,0,2,3
35269,1,3,123399,123400,123403,1,4,0
35270,4,2,123403,123403,123405,0,2,0
35271,5,1,123408,123408,123409,0,1,3
35272,5,3,123413,123413,123416,0,3,4
35273,5,3,123418,123418,123421,0,3,2
35274,6,1,123424,123424,123425,0,1,3
35275,2,2,123426,123426,123428,0,2,1
35276,4,1,123430,123430,123431,0,1,2
35277,6,3,123436,123436,123439,0,3,5
35278,5,1,123441,123441,123442,0,1,2
35279,4,3,123445,123445,123448,0,3,3
35280,3,1,123448,123448,123449,0,1,0
35281,4,1,123452,123452,123453,0,1,3
35282,3,1,123455,123455,123456,0,1,2
35283,1,1,123456,123456,123457,0,1,0
35284,4,3,123460,123460,123463,0,3,3
35285,2,2,123462,123463,123465,1,3,0
35286,4,3,123466,123466,123469,0,3,1
35287,3,1,123469,123469,123470,0,1,0
35288,4,1,123473,123473,123474,0,1,3
35289,5,2,123478,123478,123480,0,2,4
35290,1,1,123479,123480,123481,1,2,0
35291,3,2,123482,123482,123484,0,2,1
35292,6,1,123488,123488,123489,0,1,4
35293,6,3,123494,123494,123497,0,3,5
35294,6,3,123500,123500,123503,0,3,3
35295,5,2,123505,123505,123507,0,2,2
35296,1,2,123506,123507,123509,1,3,0
35297,3,1,123509,123509,123510,0,1,0
35298,6,1,123515,123515,123516,0,1,5
35299,4,2,123519,123519,123521,0,2,3
35300,6,2,123525,123525,123527,0,2,4
35301,2,2,123527,123527,123529,0,2,0
35302,6,3,123533,123533,123536,0,3,4
35303,2,3,123535,123536,123539,1,4,0
35304,5,1,123540,123540,123541,0,1,1
35305,2,1,123542,123542,123543,0,1,1
35306,6,1,123548,123548,123549,0,1,5
35307,3,3,123551,123551,123554,0,3,2
35308,1,3,123552,123554,123557,2,5,0
35309,4,3,123556,123557,123560,1,4,0
35310,2,1,123558,123560,123561,2,3,0
35311,5,1,123563,123563,123564,0,1,2
35312,1,3,123564,123564,123567,0,3,0
35313,4,1,123568,123568,123569,0,1,1
35314,6,1,123574,123574,123575,0,1,5
35315,6,2,123580,123580,123582,0,2,5
35316,5,1,123585,123585,123586,0,1,3
35317,1,2,123586,123586,123588,0,2,0
35318,1,2,123587,123588,123590,1,3,0
35319,4,3,123591,123591,123594,0,3,1
35320,2,2,123593,123594,123596,1,3,0
35321,1,2,123594,123596,123598,2,4,0
35322,6,1,123600,123600,123601,0,1,2
35323,6,2,123606,123606,123608,0,2,5
35324,5,3,123611,123611,123614,0,3,3
35325,1,1,123612,123614,123615,2,3,0
35326,1,3,123613,123615,123618,2,5,0
35327,6,2,123619,123619,123621,0,2,1
35328,2,2,123621,123621,123623,0,2,0
35329,2,1,123623,123623,123624,0,1,0
35330,6,1,123629,123629,123630,0,1,5
35331,1,1,123630,123630,123631,0,1,0
35332,2,3,123632,123632,123635,0,3,1
35333,6,1,123638,123638,123639,0,1,3
35334,2,2,123640,123640,123642,0,2,1
35335,6,1,123646,123646,123647,0,1,4
35336,1,2,123647,123647,123649,0,2,0
35337,4,2,123651,123651,123653,0,2,2
35338,6,2,123657,123657,123659,0,2,4
35339,1,1,123658,123659,123660,1,2,0
35340,5,2,123663,123663,123665,0,2,3
35341,1,3,123664,123665,123668,1,4,0
35342,6,3,123670,123670,123673,0,3,2
35343,4,1,123674,123674,123675,0,1,1
35344,3,3,123677,123677,123680,0,3,2
35345,4,2,123681,123681,123683,0,2,1
35346,5,1,123686,123686,123687,0,1,3
35347,1,2,123687,123687,123689,0,2,0
35348,1,1,123688,123689,123690,1,2,0
35349,3,2,123691,123691,123693,0,2,1
35350,1,1,123692,123693,123694,1,2,0
35351,4,1,123696,123696,123697,0,1,2
35352,2,2,123698,123698,123700,0,2,1
35353,3,3,123701,123701,123704,0,3,1
35354,2,2,123703,123704,123706,1,3,0
35355,4,3,123707,123707,123710,0,3,1
35356,5,2,123712,123712,123714,0,2,2
35357,3,1,123715,123715,123716,0,1,1
35358,3,1,123718,123718,123719,0,1,2
35359,6,3,123724,123724,123727,0,3,5
35360,2,2,123726,123727,123729,1,3,0
35361,4,2,123730,123730,123732,0,2,1
35362,2,3,123732,123732,123735,0,3,0
35363,5,1,123737,123737,123738,0,1,2
35364,5,1,123742,123742,123743,0,1,4
35365,2,1,123744,123744,123745,0,1,1
35366,6,3,123750,123750,123753,0,3,5
35367,2,1,123752,123753,123754,1,2,0
35368,6,1,123758,123758,123759,0,1,4
35369,6,3,123764,123764,123767,0,3,5
35370,4,1,123768,123768,123769,0,1,1
35371,3,1,123771,123771,123772,0,1,2
35372,3,3,123774,123774,123777,0,3,2
35373,2,1,123776,123777,123778,1,2,0
35374,1,2,123777,123778,123780,1,3,0
35375,5,2,123782,123782,123784,0,2,2
35376,1,3,123783,123784,123787,1,4,0
35377,4,1,123787,123787,123788,0,1,0
35378,5,2,123792,123792,123794,0,2,4
35379,4,1,123796,123796,123797,0,1,2
35380,6,3,123802,123802,123805,0,3,5
35381,6,3,123808,123808,123811,0,3,3
35382,3,1,123811,123811,123812,0,1,0
35383,6,1,123817,123817,123818,0,1,5
35384,2,3,123819,123819,123822,0,3,1
35385,5,3,123824,123824,123827,0,3,2
35386,2,1,123826,123827,123828,1,2,0
35387,2,1,123828,123828,123829,0,1,0
35388,1,3,123829,123829,123832,0,3,0
35389,3,2,123832,123832,123834,0,2,0
35390,4,3,123836,123836,123839,0,3,2
35391,4,1,123840,123840,123841,0,1,1
35392,3,3,123843,123843,123846,0,3,2
35393,6,1,123849,123849,123850,0,1,3
35394,6,1,123855,123855,123856,0,1,5
35395,2,1,123857,123857,123858,0,1,1
35396,5,1,123862,123862,123863,0,1,4
35397,2,1,123864,123864,123865,0,1,1
35398,6,3,123870,123870,123873,0,3,5
35399,4,1,123874,123874,123875,0,1,1
35400,3,1,123877,123877,123878,0,1,2
35401,4,1,123881,123881,123882,0,1,3
35402,4,2,123885,123885,123887,0,2,3
35403,2,3,123887,123887,123890,0,3,0
35404,5,1,123892,123892,123893,0,1,2
35405,3,1,123895,123895,123896,0,1,2
35406,3,3,123898,123898,123901,0,3,2
35407,4,1,123902,123902,123903,0,1,1
35408,2,2,123904,123904,123906,0,2,1
35409,6,3,123910,123910,123913,0,3,4
35410,6,2,123916,123916,123918,0,2,3
35411,6,1,123922,123922,123923,0,1,4
35412,5,2,123927,123927,123929,0,2,4
35413,6,2,123933,123933,123935,0,2,4
35414,2,1,123935,123935,123936,0,1,0
35415,3,1,123938,123938,123939,0,1,2
35416,3,1,123941,123941,123942,0,1,2
35417,6,3,123947,123947,123950,0,3,5
35418,1,1,123948,123950,123951,2,3,0
35419,4,2,123952,123952,123954,0,2,1
35420,6,1,123958,123958,123959,0,1,4
35421,3,1,123961,123961,123962,0,1,2
35422,4,3,123965,123965,123968,0,3,3
35423,5,2,123970,123970,123972,0,2,2
35424,5,3,123975,123975,123978,0,3,3
35425,6,1,123981,123981,123982,0,1,3
35426,4,2,123985,123985,123987,0,2,3
35427,1,2,123986,123987,123989,1,3,0
35428,1,1,123987,123989,123990,2,3,0
35429,2,3,123989,123990,123993,1,4,0
35430,6,3,123995,123995,123998,0,3,2
35431,5,3,124000,124000,124003,0,3,2
35432,2,1,124002,124003,124004,1,2,0
35433,5,3,124007,124007,124010,0,3,3
35434,1,3,124008,124010,124013,2,5,0
35435,6,3,124014,124014,124017,0,3,1
35436,1,1,124015,124017,124018,2,3,0
35437,6,1,124021,124021,124022,0,1,3
35438,4,3,124025,124025,124028,0,3,3
35439,1,2,124026,124028,124030,2,4,0
35440,5,2,124031,124031,124033,0,2,1
35441,1,3,124032,124033,124036,1,4,0
35442,5,1,124037,124037,124038,0,1,1
35443,4,3,124041,124041,124044,0,3,3
35444,1,2,124042,124044,124046,2,4,0
35445,3,3,124045,124046,124049,1,4,0
35446,3,3,124048,124049,124052,1,4,0
35447,4,3,124052,124052,124055,0,3,0
35448,2,3,124054,124055,124058,1,4,0
35449,4,3,124058,124058,124061,0,3,0
35450,3,3,124061,124061,124064,0,3,0
35451,4,2,124065,124065,124067,0,2,1
35452,2,2,124067,124067,124069,0,2,0
35453,1,1,124068,124069,124070,1,2,0
35454,6,3,124074,124074,124077,0,3,4
35455,5,3,124079,124079,124082,0,3,2
35456,5,1,124084,124084,124085,0,1,2
35457,4,2,124088,124088,124090,0,2,3
35458,2,3,124090,124090,124093,0,3,0
35459,4,2,124094,124094,124096,0,2,1
35460,4,2,124098,124098,124100,0,2,2
35461,2,2,124100,124100,124102,0,2,0
35462,5,2,124105,124105,124107,0,2,3
35463,4,2,124109,124109,124111,0,2,2
35464,1,3,124110,124111,124114,1,4,0
35465,3,2,124113,124114,124116,1,3,0
35466,6,1,124119,124119,124120,0,1,3
35467,6,2,124125,124125,124127,0,2,5
35468,1,1,124126,124127,124128,1,2,0
35469,3,2,124129,124129,124131,0,2,1
35470,4,3,124133,124133,124136,0,3,2
35471,4,2,124137,124137,124139,0,2,1
35472,2,1,124139,124139,124140,0,1,0
35473,1,1,124140,124140,124141,0,1,0
35474,3,1,124143,124143,124144,0,1,2
35475,5,2,124148,124148,124150,0,2,4
35476,5,2,124153,124153,124155,0,2,3
35477,1,3,124154,124155,124158,1,4,0
35478,4,2,124158,124158,124160,0,2,0
35479,3,2,124161,124161,124163,0,2,1
35480,5,2,124166,124166,124168,0,2,3
35481,3,1,124169,124169,124170,0,1,1
35482,1,3,124170,124170,124173,0,3,0
35483,3,1,124173,124173,124174,0,1,0
35484,3,3,124176,124176,124179,0,3,2
35485,1,3,124177,124179,124182,2,5,0
35486,4,3,124181,124182,124185,1,4,0
35487,6,1,124187,124187,124188,0,1,2
35488,2,3,124189,124189,124192,0,3,1
35489,3,3,124192,124192,124195,0,3,0
35490,1,3,124193,124195,124198,2,5,0
35491,2,3,124195,124198,124201,3,6,0
35492,5,2,124200,124201,124203,1,3,0
35493,1,3,124201,124203,124206,2,5,0
35494,4,1,124205,124206,124207,1,2,0
35495,6,1,124211,124211,124212,0,1,4
35496,4,1,124215,124215,124216,0,1,3
35497,5,2,124220,124220,124222,0,2,4
35498,4,2,124224,124224,124226,0,2,2
35499,2,1,124226,124226,124227,0,1,0
35500,4,1,124230,124230,124231,0,1,3
35501,6,3,124236,124236,124239,0,3,5
35502,4,3,124240,124240,124243,0,3,1
35503,6,1,124246,124246,124247,0,1,3
35504,4,1,124250,124250,124251,0,1,3
35505,6,1,124256,124256,124257,0,1,5
35506,5,1,124261,124261,124262,0,1,4
35507,4,3,124265,124265,124268,0,3,3
35508,4,1,124269,124269,124270,0,1,1
35509,6,2,124275,124275,124277,0,2,5
35510,1,3,124276,124277,124280,1,4,0
35511,6,3,124282,124282,124285,0,3,2
35512,2,2,124284,124285,124287,1,3,0
35513,3,3,124287,124287,124290,0,3,0
35514,5,2,124292,124292,124294,0,2,2
35515,2,2,124294,124294,124296,0,2,0
35516,2,3,124296,124296,124299,0,3,0
35517,5,2,124301,124301,124303,0,2,2
35518,6,3,124307,124307,124310,0,3,4
35519,3,2,124310,124310,124312,0,2,0
35520,2,1,124312,124312,124313,0,1,0
35521,3,1,124315,124315,124316,0,1,2
35522,5,1,124320,124320,124321,0,1,4
35523,3,1,124323,124323,124324,0,1,2
35524,4,1,124327,124327,124328,0,1,3
35525,1,2,124328,124328,124330,0,2,0
35526,3,3,124331,124331,124334,0,3,1
35527,2,1,124333,124334,124335,1,2,0
35528,3,2,124336,124336,124338,0,2,1
35529,1,2,124337,124338,124340,1,3,0
35530,6,3,124343,124343,124346,0,3,3
35531,1,3,124344,124346,124349,2,5,0
35532,3,3,124347,124349,124352,2,5,0
35533,1,3,124348,124352,124355,4,7,0
35534,1,3,124349,124355,124358,6,9,0
35535,2,1,124351,124358,124359,7,8,0
35536,3,3,124354,124359,124362,5,8,0
35537,1,1,124355,124362,124363,7,8,0
35538,5,2,124360,124363,124365,3,5,0
35539,2,1,124362,124365,124366,3,4,0
35540,4,2,124366,124366,124368,0,2,0
35541,4,2,124370,124370,124372,0,2,2
35542,5,1,124375,124375,124376,0,1,3
35543,4,1,124379,124379,124380,0,1,3
35544,3,1,124382,124382,124383,0,1,2
35545,6,1,124388,124388,124389,0,1,5
35546,6,1,124394,124394,124395,0,1,5
35547,2,3,124396,124396,124399,0,3,1
35548,5,1,124401,124401,124402,0,1,2
35549,1,2,124402,124402,124404,0,2,0
35550,2,3,124404,124404,124407,0,3,0
35551,5,3,124409,124409,124412,0,3,2
35552,1,2,124410,124412,124414,2,4,0
35553,2,3,124412,124414,124417,2,5,0
35554,2,2,124414,124417,124419,3,5,0
35555,1,1,124415,124419,124420,4,5,0
35556,5,1,124420,124420,124421,0,1,0
35557,5,3,124425,124425,124428,0,3,4
35558,2,1,124427,124428,124429,1,2,0
35559,5,3,124432,124432,124435,0,3,3
35560,6,2,124438,124438,124440,0,2,3
35561,3,1,124441,124441,124442,0,1,1
35562,3,3,124444,124444,124447,0,3,2
35563,6,2,124450,124450,124452,0,2,3
35564,2,2,124452,124452,124454,0,2,0
35565,2,3,124454,124454,124457,0,3,0
35566,4,1,124458,124458,124459,0,1,1
35567,2,3,124460,124460,124463,0,3,1
35568,6,2,124466,124466,124468,0,2,3
35569,5,2,124471,124471,124473,0,2,3
35570,1,1,124472,124473,124474,1,2,0
35571,4,3,124476,124476,124479,0,3,2
35572,4,1,124480,124480,124481,0,1,1
35573,1,1,124481,124481,124482,0,1,0
35574,4,1,124485,124485,124486,0,1,3
35575,3,1,124488,124488,124489,0,1,2
35576,5,2,124493,124493,124495,0,2,4
35577,2,1,124495,124495,124496,0,1,0
35578,4,2,124499,124499,124501,0,2,3
35579,3,2,124502,124502,124504,0,2,1
35580,6,3,124508,124508,124511,0,3,4
35581,5,2,124513,124513,124515,0,2,2
35582,5,1,124518,124518,124519,0,1,3
35583,1,3,124519,124519,124522,0,3,0
35584,5,3,124524,124524,124527,0,3,2
35585,2,2,124526,124527,124529,1,3,0
35586,2,2,124528,124529,124531,1,3,0
35587,6,3,124534,124534,124537,0,3,3
35588,2,2,124536,124537,124539,1,3,0
35589,1,3,124537,124539,124542,2,5,0
35590,5,2,124542,124542,124544,0,2,0
35591,4,3,124546,124546,124549,0,3,2
35592,3,3,124549,124549,124552,0,3,0
35593,2,3,124551,124552,124555,1,4,0
35594,3,3,124554,124555,124558,1,4,0
35595,3,1,124557,124558,124559,1,2,0
35596,4,2,124561,124561,124563,0,2,2
35597,1,1,124562,124563,124564,1,2,0
35598,5,2,124567,124567,124569,0,2,3
35599,6,1,124573,124573,124574,0,1,4
35600,4,1,124577,124577,124578,0,1,3
35601,2,2,124579,124579,124581,0,2,1
35602,6,3,124585,124585,124588,0,3,4
35603,2,1,124587,124588,124589,1,2,0
35604,6,2,124593,124593,124595,0,2,4
35605,6,3,124599,124599,124602,0,3,4
35606,4,2,124603,124603,124605,0,2,1
35607,3,2,124606,124606,124608,0,2,1
35608,4,3,124610,124610,124613,0,3,2
35609,4,2,124614,124614,124616,0,2,1
35610,5,1,124619,124619,124620,0,1,3
35611,5,1,124624,124624,124625,0,1,4
35612,2,3,124626,124626,124629,0,3,1
35613,5,2,124631,124631,124633,0,2,2
35614,1,2,124632,124633,124635,1,3,0
35615,1,2,124633,124635,124637,2,4,0
35616,4,3,124637,124637,124640,0,3,0
35617,3,1,124640,124640,124641,0,1,0
35618,4,3,124644,124644,124647,0,3,3
35619,3,3,124647,124647,124650,0,3,0
35620,4,3,124651,124651,124654,0,3,1
35621,3,2,124654,124654,124656,0,2,0
35622,3,3,124657,124657,124660,0,3,1
35623,3,3,124660,124660,124663,0,3,0
35624,3,1,124663,124663,124664,0,1,0
35625,4,2,124667,124667,124669,0,2,3
35626,4,1,124671,124671,124672,0,1,2
35627,3,1,124674,124674,124675,0,1,2
35628,2,2,124676,124676,124678,0,2,1
35629,2,2,124678,124678,124680,0,2,0
35630,4,3,124682,124682,124685,0,3,2
35631,2,3,124684,124685,124688,1,4,0
35632,3,2,124687,124688,124690,1,3,0
35633,4,1,124691,124691,124692,0,1,1
35634,4,1,124695,124695,124696,0,1,3
35635,2,3,124697,124697,124700,0,3,1
35636,3,3,124700,124700,124703,0,3,0
35637,2,3,124702,124703,124706,1,4,0
35638,1,2,124703,124706,124708,3,5,0
35639,3,1,124706,124708,124709,2,3,0
35640,4,1,124710,124710,124711,0,1,1
35641,2,1,124712,124712,124713,0,1,1
35642,3,2,124715,124715,124717,0,2,2
35643,4,1,124719,124719,124720,0,1,2
35644,2,1,124721,124721,124722,0,1,1
35645,4,2,124725,124725,124727,0,2,3
35646,6,3,124731,124731,124734,0,3,4
35647,2,3,124733,124734,124737,1,4,0
35648,5,3,124738,124738,124741,0,3,1
35649,3,2,124741,124741,124743,0,2,0
35650,4,2,124745,124745,124747,0,2,2
35651,6,2,124751,124751,124753,0,2,4
35652,5,1,124756,124756,124757,0,1,3
35653,4,2,124760,124760,124762,0,2,3
35654,3,2,124763,124763,124765,0,2,1
35655,2,1,124765,124765,124766,0,1,0
35656,6,2,124771,124771,124773,0,2,5
35657,5,3,124776,124776,124779,0,3,3
35658,5,3,124781,124781,124784,0,3,2
35659,1,3,124782,124784,124787,2,5,0
35660,1,3,124783,124787,124790,4,7,0
35661,5,1,124788,124790,124791,2,3,0
35662,3,1,124791,124791,124792,0,1,0
35663,6,1,124797,124797,124798,0,1,5
35664,1,1,124798,124798,124799,0,1,0
35665,4,2,124802,124802,124804,0,2,3
35666,5,1,124807,124807,124808,0,1,3
35667,1,3,124808,124808,124811,0,3,0
35668,2,2,124810,124811,124813,1,3,0
35669,3,1,124813,124813,124814,0,1,0
35670,1,2,124814,124814,124816,0,2,0
35671,2,3,124816,124816,124819,0,3,0
35672,1,1,124817,124819,124820,2,3,0
35673,3,2,124820,124820,124822,0,2,0
35674,4,2,124824,124824,124826,0,2,2
35675,3,1,124827,124827,124828,0,1,1
35676,2,3,124829,124829,124832,0,3,1
35677,2,3,124831,124832,124835,1,4,0
35678,1,2,124832,124835,124837,3,5,0
35679,2,3,124834,124837,124840,3,6,0
35680,2,1,124836,124840,124841,4,5,0
35681,2,1,124838,124841,124842,3,4,0
35682,2,2,124840,124842,124844,2,4,0
35683,3,2,124843,124844,124846,1,3,0
35684,6,1,124849,124849,124850,0,1,3
35685,3,2,124852,124852,124854,0,2,2
35686,4,1,124856,124856,124857,0,1,2
35687,5,2,124861,124861,124863,0,2,4
35688,4,1,124865,124865,124866,0,1,2
35689,4,2,124869,124869,124871,0,2,3
35690,4,1,124873,124873,124874,0,1,2
35691,6,3,124879,124879,124882,0,3,5
35692,4,1,124883,124883,124884,0,1,1
35693,1,2,124884,124884,124886,0,2,0
35694,2,2,124886,124886,124888,0,2,0
35695,5,2,124891,124891,124893,0,2,3
35696,5,2,124896,124896,124898,0,2,3
35697,1,3,124897,124898,124901,1,4,0
35698,6,2,124903,124903,124905,0,2,2
35699,4,2,124907,124907,124909,0,2,2
35700,5,3,124912,124912,124915,0,3,3
35701,5,3,124917,124917,124920,0,3,2
35702,6,2,124923,124923,124925,0,2,3
35703,2,2,124925,124925,124927,0,2,0
35704,1,3,124926,124927,124930,1,4,0
35705,1,3,124927,124930,124933,3,6,0
35706,5,2,124932,124933,124935,1,3,0
35707,5,1,124937,124937,124938,0,1,2
35708,2,3,124939,124939,124942,0,3,1
35709,2,3,124941,124942,124945,1,4,0
35710,6,3,124947,124947,124950,0,3,2
35711,4,3,124951,124951,124954,0,3,1
35712,2,3,124953,124954,124957,1,4,0
35713,4,1,124957,124957,124958,0,1,0
35714,1,2,124958,124958,124960,0,2,0
35715,2,2,124960,124960,124962,0,2,0
35716,4,2,124964,124964,124966,0,2,2
35717,6,2,124970,124970,124972,0,2,4
35718,5,1,124975,124975,124976,0,1,3
35719,2,3,124977,124977,124980,0,3,1
35720,6,1,124983,124983,124984,0,1,3
35721,2,1,124985,124985,124986,0,1,1
35722,5,2,124990,124990,124992,0,2,4
35723,6,1,124996,124996,124997,0,1,4
35724,6,2,125002,125002,125004,0,2,5
35725,6,3,125008,125008,125011,0,3,4
35726,1,2,125009,125011,125013,2,4,0
35727,2,1,125011,125013,125014,2,3,0
35728,5,3,125016,125016,125019,0,3,2
35729,6,2,125022,125022,125024,0,2,3
35730,5,3,125027,125027,125030,0,3,3
35731,1,1,125028,125030,125031,2,3,0
35732,4,1,125032,125032,125033,0,1,1
35733,4,1,125036,125036,125037,0,1,3
35734,6,2,125042,125042,125044,0,2,5
35735,3,2,125045,125045,125047,0,2,1
35736,4,1,125049,125049,125050,0,1,2
35737,4,3,125053,125053,125056,0,3,3
35738,3,3,125056,125056,125059,0,3,0
35739,2,1,125058,125059,125060,1,2,0
35740,6,1,125064,125064,125065,0,1,4
35741,1,1,125065,125065,125066,0,1,0
35742,4,2,125069,125069,125071,0,2,3
35743,5,2,125074,125074,125076,0,2,3
35744,3,1,125077,125077,125078,0,1,1
35745,5,3,125082,125082,125085,0,3,4
35746,3,2,125085,125085,125087,0,2,0
35747,6,2,125091,125091,125093,0,2,4
35748,2,1,125093,125093,125094,0,1,0
35749,5,1,125098,125098,125099,0,1,4
35750,6,2,125104,125104,125106,0,2,5
35751,3,3,125107,125107,125110,0,3,1
35752,5,3,125112,125112,125115,0,3,2
35753,5,2,125117,125117,125119,0,2,2
35754,2,1,125119,125119,125120,0,1,0
35755,3,2,125122,125122,125124,0,2,2
35756,5,2,125127,125127,125129,0,2,3
35757,1,2,125128,125129,125131,1,3,0
35758,5,3,125133,125133,125136,0,3,2
35759,3,3,125136,125136,125139,0,3,0
35760,1,1,125137,125139,125140,2,3,0
35761,2,1,125139,125140,125141,1,2,0
35762,2,1,125141,125141,125142,0,1,0
35763,1,3,125142,125142,125145,0,3,0
35764,6,2,125148,125148,125150,0,2,3
35765,2,2,125150,125150,125152,0,2,0
35766,2,3,125152,125152,125155,0,3,0
35767,5,3,125157,125157,125160,0,3,2
35768,6,1,125163,125163,125164,0,1,3
35769,3,3,125166,125166,125169,0,3,2
35770,5,2,125171,125171,125173,0,2,2
35771,3,3,125174,125174,125177,0,3,1
35772,3,1,125177,125177,125178,0,1,0
35773,4,3,125181,125181,125184,0,3,3
35774,3,1,125184,125184,125185,0,1,0
35775,1,1,125185,125185,125186,0,1,0
35776,4,2,125189,125189,125191,0,2,3
35777,3,2,125192,125192,125194,0,2,1
35778,5,2,125197,125197,125199,0,2,3
35779,4,2,125201,125201,125203,0,2,2
35780,3,2,125204,125204,125206,0,2,1
35781,6,2,125210,125210,125212,0,2,4
35782,5,1,125215,125215,125216,0,1,3
35783,3,1,125218,125218,125219,0,1,2
35784,5,3,125223,125223,125226,0,3,4
35785,3,3,125226,125226,125229,0,3,0
35786,6,2,125232,125232,125234,0,2,3
35787,4,1,125236,125236,125237,0,1,2
35788,1,2,125237,125237,125239,0,2,0
35789,6,2,125243,125243,125245,0,2,4
35790,4,3,125247,125247,125250,0,3,2
35791,3,3,125250,125250,125253,0,3,0
35792,6,3,125256,125256,125259,0,3,3
35793,1,2,125257,125259,125261,2,4,0
35794,3,2,125260,125261,125263,1,3,0
35795,5,1,125265,125265,125266,0,1,2
35796,4,2,125269,125269,125271,0,2,3
35797,2,1,125271,125271,125272,0,1,0
35798,1,1,125272,125272,125273,0,1,0
35799,2,2,125274,125274,125276,0,2,1
35800,1,2,125275,125276,125278,1,3,0
35801,3,1,125278,125278,125279,0,1,0
35802,5,3,125283,125283,125286,0,3,4
35803,1,1,125284,125286,125287,2,3,0
35804,6,1,125290,125290,125291,0,1,3
35805,5,3,125295,125295,125298,0,3,4
35806,5,3,125300,125300,125303,0,3,2
35807,5,1,125305,125305,125306,0,1,2
35808,6,3,125311,125311,125314,0,3,5
35809,3,3,125314,125314,125317,0,3,0
35810,6,2,125320,125320,125322,0,2,3
35811,5,2,125325,125325,125327,0,2,3
35812,2,2,125327,125327,125329,0,2,0
35813,5,3,125332,125332,125335,0,3,3
35814,1,3,125333,125335,125338,2,5,0
35815,4,2,125337,125338,125340,1,3,0
35816,1,1,125338,125340,125341,2,3,0
35817,1,1,125339,125341,125342,2,3,0
35818,2,3,125341,125342,125345,1,4,0
35819,4,2,125345,125345,125347,0,2,0
35820,4,1,125349,125349,125350,0,1,2
35821,6,3,125355,125355,125358,0,3,5
35822,4,1,125359,125359,125360,0,1,1
35823,5,2,125364,125364,125366,0,2,4
35824,6,1,125370,125370,125371,0,1,4
35825,6,1,125376,125376,125377,0,1,5
35826,6,2,125382,125382,125384,0,2,5
35827,6,1,125388,125388,125389,0,1,4
35828,3,2,125391,125391,125393,0,2,2
35829,2,1,125393,125393,125394,0,1,0
35830,6,3,125399,125399,125402,0,3,5
35831,1,2,125400,125402,125404,2,4,0
35832,4,3,125404,125404,125407,0,3,0
35833,4,1,125408,125408,125409,0,1,1
35834,6,2,125414,125414,125416,0,2,5
35835,6,2,125420,125420,125422,0,2,4
35836,6,2,125426,125426,125428,0,2,4
35837,3,1,125429,125429,125430,0,1,1
35838,3,3,125432,125432,125435,0,3,2
35839,4,2,125436,125436,125438,0,2,1
35840,5,3,125441,125441,125444,0,3,3
35841,5,3,125446,125446,125449,0,3,2
35842,2,2,125448,125449,125451,1,3,0
35843,5,2,125453,125453,125455,0,2,2
35844,6,2,125459,125459,125461,0,2,4
35845,2,3,125461,125461,125464,0,3,0
35846,3,3,125464,125464,125467,0,3,0
35847,5,3,125469,125469,125472,0,3,2
35848,1,3,125470,125472,125475,2,5,0
35849,5,2,125475,125475,125477,0,2,0
35850,3,3,125478,125478,125481,0,3,1
35851,1,3,125479,125481,125484,2,5,0
35852,4,2,125483,125484,125486,1,3,0
35853,6,3,125489,125489,125492,0,3,3
35854,6,2,125495,125495,125497,0,2,3
35855,4,1,125499,125499,125500,0,1,2
35856,4,2,125503,125503,125505,0,2,3
35857,3,3,125506,125506,125509,0,3,1
35858,3,3,125509,125509,125512,0,3,0
35859,5,3,125514,125514,125517,0,3,2
35860,4,3,125518,125518,125521,0,3,1
35861,2,2,125520,125521,125523,1,3,0
35862,6,2,125526,125526,125528,0,2,3
35863,5,2,125531,125531,125533,0,2,3
35864,3,1,125534,125534,125535,0,1,1
35865,5,1,125539,125539,125540,0,1,4
35866,6,3,125545,125545,125548,0,3,5
35867,2,3,125547,125548,125551,1,4,0
35868,5,3,125552,125552,125555,0,3,1
35869,4,3,125556,125556,125559,0,3,1
35870,2,3,125558,125559,125562,1,4,0
35871,2,2,125560,125562,125564,2,4,0
35872,1,3,125561,125564,125567,3,6,0
35873,1,1,125562,125567,125568,5,6,0
35874,5,1,125567,125568,125569,1,2,0
35875,1,1,125568,125569,125570,1,2,0
35876,3,3,125571,125571,125574,0,3,1
35877,5,2,125576,125576,125578,0,2,2
35878,4,2,125580,125580,125582,0,2,2
35879,2,1,125582,125582,125583,0,1,0
35880,1,3,125583,125583,125586,0,3,0
35881,2,2,125585,125586,125588,1,3,0
35882,5,2,125590,125590,125592,0,2,2
35883,4,2,125594,125594,125596,0,2,2
35884,5,1,125599,125599,125600,0,1,3
35885,2,3,125601,125601,125604,0,3,1
35886,1,2,125602,125604,125606,2,4,0
35887,2,2,125604,125606,125608,2,4,0
35888,2,3,125606,125608,125611,2,5,0
35889,3,2,125609,125611,125613,2,4,0
35890,2,2,125611,125613,125615,2,4,0
35891,3,3,125614,125615,125618,1,4,0
35892,2,1,125616,125618,125619,2,3,0
35893,2,1,125618,125619,125620,1,2,0
35894,3,1,125621,125621,125622,0,1,1
35895,3,3,125624,125624,125627,0,3,2
35896,2,1,125626,125627,125628,1,2,0
35897,2,2,125628,125628,125630,0,2,0
35898,6,3,125634,125634,125637,0,3,4
35899,4,3,125638,125638,125641,0,3,1
35900,6,2,125644,125644,125646,0,2,3
35901,3,2,125647,125647,125649,0,2,1
35902,1,2,125648,125649,125651,1,3,0
35903,4,3,125652,125652,125655,0,3,1
35904,5,3,125657,125657,125660,0,3,2
35905,3,2,125660,125660,125662,0,2,0
35906,2,1,125662,125662,125663,0,1,0
35907,1,2,125663,125663,125665,0,2,0
35908,3,1,125666,125666,125667,0,1,1
35909,5,2,125671,125671,125673,0,2,4
35910,2,2,125673,125673,125675,0,2,0
35911,6,2,125679,125679,125681,0,2,4
35912,6,3,125685,125685,125688,0,3,4
35913,2,2,125687,125688,125690,1,3,0
35914,4,1,125691,125691,125692,0,1,1
35915,6,1,125697,125697,125698,0,1,5
35916,6,2,125703,125703,125705,0,2,5
35917,5,3,125708,125708,125711,0,3,3
35918,3,3,125711,125711,125714,0,3,0
35919,3,3,125714,125714,125717,0,3,0
35920,2,3,125716,125717,125720,1,4,0
35921,2,3,125718,125720,125723,2,5,0
35922,5,2,125723,125723,125725,0,2,0
35923,1,2,125724,125725,125727,1,3,0
35924,2,1,125726,125727,125728,1,2,0
35925,5,1,125731,125731,125732,0,1,3
35926,5,3,125736,125736,125739,0,3,4
35927,5,2,125741,125741,125743,0,2,2
35928,6,1,125747,125747,125748,0,1,4
35929,5,1,125752,125752,125753,0,1,4
35930,2,3,125754,125754,125757,0,3,1
35931,2,3,125756,125757,125760,1,4,0
35932,3,2,125759,125760,125762,1,3,0
35933,2,2,125761,125762,125764,1,3,0
35934,2,3,125763,125764,125767,1,4,0
35935,6,2,125769,125769,125771,0,2,2
35936,3,2,125772,125772,125774,0,2,1
35937,1,1,125773,125774,125775,1,2,0
35938,5,2,125778,125778,125780,0,2,3
35939,5,1,125783,125783,125784,0,1,3
35940,4,2,125787,125787,125789,0,2,3
35941,5,2,125792,125792,125794,0,2,3
35942,6,2,125798,125798,125800,0,2,4
35943,5,3,125803,125803,125806,0,3,3
35944,2,1,125805,125806,125807,1,2,0
35945,6,3,125811,125811,125814,0,3,4
35946,6,3,125817,125817,125820,0,3,3
35947,5,1,125822,125822,125823,0,1,2
35948,2,2,125824,125824,125826,0,2,1
35949,3,3,125827,125827,125830,0,3,1
35950,6,1,125833,125833,125834,0,1,3
35951,3,3,125836,125836,125839,0,3,2
35952,1,1,125837,125839,125840,2,3,0
35953,4,3,125841,125841,125844,0,3,1
35954,4,1,125845,125845,125846,0,1,1
35955,6,3,125851,125851,125854,0,3,5
35956,5,2,125856,125856,125858,0,2,2
35957,5,3,125861,125861,125864,0,3,3
35958,6,1,125867,125867,125868,0,1,3
35959,6,2,125873,125873,125875,0,2,5
35960,4,2,125877,125877,125879,0,2,2
35961,3,2,125880,125880,125882,0,2,1
35962,3,3,125883,125883,125886,0,3,1
35963,4,3,125887,125887,125890,0,3,1
35964,5,3,125892,125892,125895,0,3,2
35965,4,1,125896,125896,125897,0,1,1
35966,6,3,125902,125902,125905,0,3,5
35967,1,1,125903,125905,125906,2,3,0
35968,4,2,125907,125907,125909,0,2,1
35969,6,1,125913,125913,125914,0,1,4
35970,6,3,125919,125919,125922,0,3,5
35971,1,1,125920,125922,125923,2,3,0
35972,2,3,125922,125923,125926,1,4,0
35973,5,3,125927,125927,125930,0,3,1
35974,3,1,125930,125930,125931,0,1,0
35975,3,1,125933,125933,125934,0,1,2
35976,6,1,125939,125939,125940,0,1,5
35977,1,1,125940,125940,125941,0,1,0
35978,2,1,125942,125942,125943,0,1,1
35979,2,2,125944,125944,125946,0,2,1
35980,1,2,125945,125946,125948,1,3,0
35981,5,1,125950,125950,125951,0,1,2
35982,2,2,125952,125952,125954,0,2,1
35983,1,1,125953,125954,125955,1,2,0
35984,2,2,125955,125955,125957,0,2,0
35985,3,2,125958,125958,125960,0,2,1
35986,3,2,125961,125961,125963,0,2,1
35987,6,1,125967,125967,125968,0,1,4
35988,6,1,125973,125973,125974,0,1,5
35989,3,3,125976,125976,125979,0,3,2
35990,1,2,125977,125979,125981,2,4,0
35991,5,1,125982,125982,125983,0,1,1
35992,6,3,125988,125988,125991,0,3,5
35993,4,2,125992,125992,125994,0,2,1
35994,4,1,125996,125996,125997,0,1,2
35995,3,2,125999,125999,126001,0,2,2
35996,6,2,126005,126005,126007,0,2,4
35997,2,2,126007,126007,126009,0,2,0
35998,2,3,126009,126009,126012,0,3,0
35999,4,3,126013,126013,126016,0,3,1
36000,1,2,126014,126016,126018,2,4,0
36001,1,2,126015,126018,126020,3,5,0
36002,5,2,126020,126020,126022,0,2,0
36003,5,2,126025,126025,126027,0,2,3
36004,4,3,126029,126029,126032,0,3,2
36005,5,3,126034,126034,126037,0,3,2
36006,2,2,126036,126037,126039,1,3,0
36007,1,3,126037,126039,126042,2,5,0
36008,4,2,126041,126042,126044,1,3,0
36009,4,2,126045,126045,126047,0,2,1
36010,6,2,126051,126051,126053,0,2,4
36011,1,2,126052,126053,126055,1,3,0
36012,2,1,126054,126055,126056,1,2,0
36013,1,3,126055,126056,126059,1,4,0
36014,5,2,126060,126060,126062,0,2,1
36015,3,1,126063,126063,126064,0,1,1
36016,3,1,126066,126066,126067,0,1,2
36017,1,3,126067,126067,126070,0,3,0
36018,3,2,126070,126070,126072,0,2,0
36019,2,2,126072,126072,126074,0,2,0
36020,2,2,126074,126074,126076,0,2,0
36021,6,2,126080,126080,126082,0,2,4
36022,2,1,126082,126082,126083,0,1,0
36023,4,3,126086,126086,126089,0,3,3
36024,5,3,126091,126091,126094,0,3,2
36025,5,1,126096,126096,126097,0,1,2
36026,6,2,126102,126102,126104,0,2,5
36027,2,3,126104,126104,126107,0,3,0
36028,6,3,126110,126110,126113,0,3,3
36029,2,2,126112,126113,126115,1,3,0
36030,6,2,126118,126118,126120,0,2,3
36031,4,1,126122,126122,126123,0,1,2
36032,4,2,126126,126126,126128,0,2,3
36033,6,1,126132,126132,126133,0,1,4
36034,5,3,126137,126137,126140,0,3,4
36035,5,1,126142,126142,126143,0,1,2
36036,5,2,126147,126147,126149,0,2,4
36037,6,3,126153,126153,126156,0,3,4
36038,5,3,126158,126158,126161,0,3,2
36039,5,3,126163,126163,126166,0,3,2
36040,4,2,126167,126167,126169,0,2,1
36041,1,2,126168,126169,126171,1,3,0
36042,5,1,126173,126173,126174,0,1,2
36043,3,2,126176,126176,126178,0,2,2
36044,2,1,126178,126178,126179,0,1,0
36045,6,1,126184,126184,126185,0,1,5
36046,4,3,126188,126188,126191,0,3,3
36047,6,2,126194,126194,126196,0,2,3
36048,5,1,126199,126199,126200,0,1,3
36049,6,1,126205,126205,126206,0,1,5
36050,1,2,126206,126206,126208,0,2,0
36051,2,3,126208,126208,126211,0,3,0
36052,4,2,126212,126212,126214,0,2,1
36053,3,3,126215,126215,126218,0,3,1
36054,5,3,126220,126220,126223,0,3,2
36055,4,2,126224,126224,126226,0,2,1
36056,1,1,126225,126226,126227,1,2,0
36057,2,3,126227,126227,126230,0,3,0
36058,5,3,126232,126232,126235,0,3,2
36059,5,2,126237,126237,126239,0,2,2
36060,1,1,126238,126239,126240,1,2,0
36061,4,2,126242,126242,126244,0,2,2
36062,3,3,126245,126245,126248,0,3,1
36063,2,1,126247,126248,126249,1,2,0
36064,5,1,126252,126252,126253,0,1,3
36065,1,3,126253,126253,126256,0,3,0
36066,6,2,126259,126259,126261,0,2,3
36067,2,2,126261,126261,126263,0,2,0
36068,1,3,126262,126263,126266,1,4,0
36069,2,3,126264,126266,126269,2,5,0
36070,1,2,126265,126269,126271,4,6,0
36071,2,3,126267,126271,126274,4,7,0
36072,1,2,126268,126274,126276,6,8,0
36073,6,2,126274,126276,126278,2,4,0
36074,4,3,126278,126278,126281,0,3,0
36075,6,3,126284,126284,126287,0,3,3
36076,3,3,126287,126287,126290,0,3,0
36077,3,2,126290,126290,126292,0,2,0
36078,6,1,126296,126296,126297,0,1,4
36079,3,2,126299,126299,126301,0,2,2
36080,5,2,126304,126304,126306,0,2,3
36081,2,1,126306,126306,126307,0,1,0
36082,6,3,126312,126312,126315,0,3,5
36083,6,3,126318,126318,126321,0,3,3
36084,1,3,126319,126321,126324,2,5,0
36085,3,1,126322,126324,126325,2,3,0
36086,1,2,126323,126325,126327,2,4,0
36087,6,2,126329,126329,126331,0,2,2
36088,6,3,126335,126335,126338,0,3,4
36089,3,1,126338,126338,126339,0,1,0
36090,2,2,126340,126340,126342,0,2,1
36091,2,2,126342,126342,126344,0,2,0
36092,3,2,126345,126345,126347,0,2,1
36093,4,3,126349,126349,126352,0,3,2
36094,1,1,126350,126352,126353,2,3,0
36095,2,1,126352,126353,126354,1,2,0
36096,1,3,126353,126354,126357,1,4,0
36097,1,3,126354,126357,126360,3,6,0
36098,1,3,126355,126360,126363,5,8,0
36099,4,1,126359,126363,126364,4,5,0
36100,5,1,126364,126364,126365,0,1,0
36101,2,3,126366,126366,126369,0,3,1
36102,6,1,126372,126372,126373,0,1,3
36103,3,2,126375,126375,126377,0,2,2
36104,2,1,126377,126377,126378,0,1,0
36105,1,2,126378,126378,126380,0,2,0
36106,5,2,126383,126383,126385,0,2,3
36107,6,2,126389,126389,126391,0,2,4
36108,2,2,126391,126391,126393,0,2,0
36109,3,2,126394,126394,126396,0,2,1
36110,4,2,126398,126398,126400,0,2,2
36111,2,2,126400,126400,126402,0,2,0
36112,6,2,126406,126406,126408,0,2,4
36113,1,3,126407,126408,126411,1,4,0
36114,5,3,126412,126412,126415,0,3,1
36115,3,2,126415,126415,126417,0,2,0
36116,1,1,126416,126417,126418,1,2,0
36117,1,1,126417,126418,126419,1,2,0
36118,6,3,126423,126423,126426,0,3,4
36119,5,3,126428,126428,126431,0,3,2
36120,4,1,126432,126432,126433,0,1,1
36121,2,3,126434,126434,126437,0,3,1
36122,1,3,126435,126437,126440,2,5,0
36123,6,3,126441,126441,126444,0,3,1
36124,2,2,126443,126444,126446,1,3,0
36125,6,1,126449,126449,126450,0,1,3
36126,6,1,126455,126455,126456,0,1,5
36127,3,1,126458,126458,126459,0,1,2
36128,5,1,126463,126463,126464,0,1,4
36129,4,3,126467,126467,126470,0,3,3
36130,3,3,126470,126470,126473,0,3,0
36131,1,3,126471,126473,126476,2,5,0
36132,5,3,126476,126476,126479,0,3,0
36133,6,2,126482,126482,126484,0,2,3
36134,3,2,126485,126485,126487,0,2,1
36135,1,2,126486,126487,126489,1,3,0
36136,6,1,126492,126492,126493,0,1,3
36137,3,1,126495,126495,126496,0,1,2
36138,4,3,126499,126499,126502,0,3,3
36139,5,3,126504,126504,126507,0,3,2
36140,3,3,126507,126507,126510,0,3,0
36141,4,2,126511,126511,126513,0,2,1
36142,4,3,126515,126515,126518,0,3,2
36143,4,3,126519,126519,126522,0,3,1
36144,6,2,126525,126525,126527,0,2,3
36145,2,2,126527,126527,126529,0,2,0
36146,6,2,126533,126533,126535,0,2,4
36147,2,1,126535,126535,126536,0,1,0
36148,5,1,126540,126540,126541,0,1,4
36149,6,3,126546,126546,126549,0,3,5
36150,6,3,126552,126552,126555,0,3,3
36151,1,3,126553,126555,126558,2,5,0
36152,2,3,126555,126558,126561,3,6,0
36153,6,1,126561,126561,126562,0,1,0
36154,5,1,126566,126566,126567,0,1,4
36155,6,3,126572,126572,126575,0,3,5
36156,5,2,126577,126577,126579,0,2,2
36157,5,3,126582,126582,126585,0,3,3
36158,4,3,126586,126586,126589,0,3,1
36159,3,1,126589,126589,126590,0,1,0
36160,6,2,126595,126595,126597,0,2,5
36161,4,2,126599,126599,126601,0,2,2
36162,1,1,126600,126601,126602,1,2,0
36163,5,3,126605,126605,126608,0,3,3
36164,3,1,126608,126608,126609,0,1,0
36165,4,1,126612,126612,126613,0,1,3
36166,3,2,126615,126615,126617,0,2,2
36167,6,3,126621,126621,126624,0,3,4
36168,4,2,126625,126625,126627,0,2,1
36169,3,3,126628,126628,126631,0,3,1
36170,4,2,126632,126632,126634,0,2,1
36171,1,1,126633,126634,126635,1,2,0
36172,3,2,126636,126636,126638,0,2,1
36173,2,2,126638,126638,126640,0,2,0
36174,3,2,126641,126641,126643,0,2,1
36175,1,2,126642,126643,126645,1,3,0
36176,1,2,126643,126645,126647,2,4,0
36177,6,2,126649,126649,126651,0,2,2
36178,5,3,126654,126654,126657,0,3,3
36179,1,1,126655,126657,126658,2,3,0
36180,1,2,126656,126658,126660,2,4,0
36181,2,1,126658,126660,126661,2,3,0
36182,5,1,126663,126663,126664,0,1,2
36183,6,3,126669,126669,126672,0,3,5
36184,2,3,126671,126672,126675,1,4,0
36185,2,1,126673,126675,126676,2,3,0
36186,5,3,126678,126678,126681,0,3,2
36187,2,1,126680,126681,126682,1,2,0
36188,2,1,126682,126682,126683,0,1,0
36189,2,2,126684,126684,126686,0,2,1
36190,5,1,126689,126689,126690,0,1,3
36191,5,1,126694,126694,126695,0,1,4
36192,6,3,126700,126700,126703,0,3,5
36193,1,3,126701,126703,126706,2,5,0
36194,5,1,126706,126706,126707,0,1,0
36195,3,2,126709,126709,126711,0,2,2
36196,3,2,126712,126712,126714,0,2,1
36197,6,2,126718,126718,126720,0,2,4
36198,1,3,126719,126720,126723,1,4,0
36199,1,2,126720,126723,126725,3,5,0
36200,2,1,126722,126725,126726,3,4,0
36201,4,1,126726,126726,126727,0,1,0
36202,1,2,126727,126727,126729,0,2,0
36203,1,1,126728,126729,126730,1,2,0
36204,1,1,126729,126730,126731,1,2,0
36205,6,1,126735,126735,126736,0,1,4
36206,3,3,126738,126738,126741,0,3,2
36207,2,2,126740,126741,126743,1,3,0
36208,1,3,126741,126743,126746,2,5,0
36209,2,2,126743,126746,126748,3,5,0
36210,5,2,126748,126748,126750,0,2,0
36211,2,2,126750,126750,126752,0,2,0
36212,3,2,126753,126753,126755,0,2,1
36213,2,2,126755,126755,126757,0,2,0
36214,5,3,126760,126760,126763,0,3,3
36215,4,3,126764,126764,126767,0,3,1
36216,1,3,126765,126767,126770,2,5,0
36217,3,1,126768,126770,126771,2,3,0
36218,6,2,126774,126774,126776,0,2,3
36219,5,2,126779,126779,126781,0,2,3
36220,6,3,126785,126785,126788,0,3,4
36221,1,2,126786,126788,126790,2,4,0
36222,5,1,126791,126791,126792,0,1,1
36223,4,3,126795,126795,126798,0,3,3
36224,3,3,126798,126798,126801,0,3,0
36225,4,2,126802,126802,126804,0,2,1
36226,2,3,126804,126804,126807,0,3,0
36227,1,1,126805,126807,126808,2,3,0
36228,5,1,126810,126810,126811,0,1,2
36229,2,3,126812,126812,126815,0,3,1
36230,2,3,126814,126815,126818,1,4,0
36231,2,2,126816,126818,126820,2,4,0
36232,4,3,126820,126820,126823,0,3,0
36233,5,2,126825,126825,126827,0,2,2
36234,6,2,126831,126831,126833,0,2,4
36235,1,3,126832,126833,126836,1,4,0
36236,6,1,126838,126838,126839,0,1,2
36237,4,3,126842,126842,126845,0,3,3
36238,5,2,126847,126847,126849,0,2,2
36239,3,2,126850,126850,126852,0,2,1
36240,5,1,126855,126855,126856,0,1,3
36241,2,2,126857,126857,126859,0,2,1
36242,5,3,126862,126862,126865,0,3,3
36243,3,3,126865,126865,126868,0,3,0
36244,4,3,126869,126869,126872,0,3,1
36245,4,1,126873,126873,126874,0,1,1
36246,2,3,126875,126875,126878,0,3,1
36247,5,2,126880,126880,126882,0,2,2
36248,2,2,126882,126882,126884,0,2,0
36249,6,3,126888,126888,126891,0,3,4
36250,3,3,126891,126891,126894,0,3,0
36251,4,1,126895,126895,126896,0,1,1
36252,5,1,126900,126900,126901,0,1,4
36253,6,1,126906,126906,126907,0,1,5
36254,6,1,126912,126912,126913,0,1,5
36255,4,2,126916,126916,126918,0,2,3
36256,5,1,126921,126921,126922,0,1,3
36257,4,2,126925,126925,126927,0,2,3
36258,6,2,126931,126931,126933,0,2,4
36259,1,3,126932,126933,126936,1,4,0
36260,4,3,126936,126936,126939,0,3,0
36261,6,1,126942,126942,126943,0,1,3
36262,4,3,126946,126946,126949,0,3,3
36263,4,1,126950,126950,126951,0,1,1
36264,2,2,126952,126952,126954,0,2,1
36265,6,2,126958,126958,126960,0,2,4
36266,6,3,126964,126964,126967,0,3,4
36267,3,2,126967,126967,126969,0,2,0
36268,4,1,126971,126971,126972,0,1,2
36269,3,2,126974,126974,126976,0,2,2
36270,6,3,126980,126980,126983,0,3,4
36271,2,2,126982,126983,126985,1,3,0
36272,1,2,126983,126985,126987,2,4,0
36273,6,2,126989,126989,126991,0,2,2
36274,1,3,126990,126991,126994,1,4,0
36275,6,3,126996,126996,126999,0,3,2
36276,5,3,127001,127001,127004,0,3,2
36277,6,3,127007,127007,127010,0,3,3
36278,6,2,127013,127013,127015,0,2,3
36279,5,1,127018,127018,127019,0,1,3
36280,2,3,127020,127020,127023,0,3,1
36281,6,2,127026,127026,127028,0,2,3
36282,6,1,127032,127032,127033,0,1,4
36283,1,3,127033,127033,127036,0,3,0
36284,4,3,127037,127037,127040,0,3,1
36285,3,3,127040,127040,127043,0,3,0
36286,1,1,127041,127043,127044,2,3,0
36287,6,1,127047,127047,127048,0,1,3
36288,1,3,127048,127048,127051,0,3,0
36289,1,2,127049,127051,127053,2,4,0
36290,6,2,127055,127055,127057,0,2,2
36291,2,2,127057,127057,127059,0,2,0
36292,4,3,127061,127061,127064,0,3,2
36293,3,2,127064,127064,127066,0,2,0
36294,1,3,127065,127066,127069,1,4,0
36295,2,2,127067,127069,127071,2,4,0
36296,2,1,127069,127071,127072,2,3,0
36297,6,2,127075,127075,127077,0,2,3
36298,3,2,127078,127078,127080,0,2,1
36299,5,3,127083,127083,127086,0,3,3
36300,4,1,127087,127087,127088,0,1,1
36301,6,3,127093,127093,127096,0,3,5
36302,6,3,127099,127099,127102,0,3,3
36303,3,1,127102,127102,127103,0,1,0
36304,6,2,127108,127108,127110,0,2,5
36305,5,1,127113,127113,127114,0,1,3
36306,3,2,127116,127116,127118,0,2,2
36307,1,3,127117,127118,127121,1,4,0
36308,1,2,127118,127121,127123,3,5,0
36309,4,2,127122,127123,127125,1,3,0
36310,2,1,127124,127125,127126,1,2,0
36311,1,1,127125,127126,127127,1,2,0
36312,5,1,127130,127130,127131,0,1,3
36313,3,1,127133,127133,127134,0,1,2
36314,2,1,127135,127135,127136,0,1,1
36315,6,3,127141,127141,127144,0,3,5
36316,5,1,127146,127146,127147,0,1,2
36317,3,1,127149,127149,127150,0,1,2
36318,6,3,127155,127155,127158,0,3,5
36319,4,3,127159,127159,127162,0,3,1
36320,3,2,127162,127162,127164,0,2,0
36321,3,3,127165,127165,127168,0,3,1
36322,5,3,127170,127170,127173,0,3,2
36323,5,1,127175,127175,127176,0,1,2
36324,3,2,127178,127178,127180,0,2,2
36325,1,2,127179,127180,127182,1,3,0
36326,1,1,127180,127182,127183,2,3,0
36327,6,1,127186,127186,127187,0,1,3
36328,2,1,127188,127188,127189,0,1,1
36329,3,2,127191,127191,127193,0,2,2
36330,3,2,127194,127194,127196,0,2,1
36331,1,1,127195,127196,127197,1,2,0
36332,1,1,127196,127197,127198,1,2,0
36333,3,2,127199,127199,127201,0,2,1
36334,5,2,127204,127204,127206,0,2,3
36335,6,2,127210,127210,127212,0,2,4
36336,5,3,127215,127215,127218,0,3,3
36337,4,3,127219,127219,127222,0,3,1
36338,4,1,127223,127223,127224,0,1,1
36339,1,3,127224,127224,127227,0,3,0
36340,4,1,127228,127228,127229,0,1,1
36341,2,1,127230,127230,127231,0,1,1
36342,1,2,127231,127231,127233,0,2,0
36343,5,3,127236,127236,127239,0,3,3
36344,1,2,127237,127239,127241,2,4,0
36345,4,1,127241,127241,127242,0,1,0
36346,4,2,127245,127245,127247,0,2,3
36347,6,2,127251,127251,127253,0,2,4
36348,3,1,127254,127254,127255,0,1,1
36349,5,1,127259,127259,127260,0,1,4
36350,3,2,127262,127262,127264,0,2,2
36351,1,3,127263,127264,127267,1,4,0
36352,1,2,127264,127267,127269,3,5,0
36353,5,2,127269,127269,127271,0,2,0
36354,1,2,127270,127271,127273,1,3,0
36355,3,3,127273,127273,127276,0,3,0
36356,1,1,127274,127276,127277,2,3,0
36357,1,1,127275,127277,127278,2,3,0
36358,3,1,127278,127278,127279,0,1,0
36359,3,3,127281,127281,127284,0,3,2
36360,3,2,127284,127284,127286,0,2,0
36361,3,1,127287,127287,127288,0,1,1
36362,1,2,127288,127288,127290,0,2,0
36363,4,3,127292,127292,127295,0,3,2
36364,2,2,127294,127295,127297,1,3,0
36365,5,1,127299,127299,127300,0,1,2
36366,1,1,127300,127300,127301,0,1,0
36367,5,1,127305,127305,127306,0,1,4
36368,6,1,127311,127311,127312,0,1,5
36369,3,3,127314,127314,127317,0,3,2
36370,6,3,127320,127320,127323,0,3,3
36371,4,2,127324,127324,127326,0,2,1
36372,4,3,127328,127328,127331,0,3,2
36373,1,2,127329,127331,127333,2,4,0
36374,2,3,127331,127333,127336,2,5,0
36375,6,2,127337,127337,127339,0,2,1
36376,4,3,127341,127341,127344,0,3,2
36377,6,1,127347,127347,127348,0,1,3
36378,1,3,127348,127348,127351,0,3,0
36379,3,1,127351,127351,127352,0,1,0
36380,2,1,127353,127353,127354,0,1,1
36381,5,3,127358,127358,127361,0,3,4
36382,1,2,127359,127361,127363,2,4,0
36383,4,1,127363,127363,127364,0,1,0
36384,3,2,127366,127366,127368,0,2,2
36385,3,3,127369,127369,127372,0,3,1
36386,2,3,127371,127372,127375,1,4,0
36387,6,1,127377,127377,127378,0,1,2
36388,4,2,127381,127381,127383,0,2,3
36389,6,3,127387,127387,127390,0,3,4
36390,3,3,127390,127390,127393,0,3,0
36391,2,3,127392,127393,127396,1,4,0
36392,1,2,127393,127396,127398,3,5,0
36393,2,3,127395,127398,127401,3,6,0
36394,4,2,127399,127401,127403,2,4,0
36395,5,3,127404,127404,127407,0,3,1
36396,4,1,127408,127408,127409,0,1,1
36397,1,2,127409,127409,127411,0,2,0
36398,3,3,127412,127412,127415,0,3,1
36399,6,3,127418,127418,127421,0,3,3
36400,4,3,127422,127422,127425,0,3,1
36401,1,2,127423,127425,127427,2,4,0
36402,1,2,127424,127427,127429,3,5,0
36403,6,1,127430,127430,127431,0,1,1
36404,1,1,127431,127431,127432,0,1,0
36405,2,1,127433,127433,127434,0,1,1
36406,6,1,127439,127439,127440,0,1,5
36407,5,2,127444,127444,127446,0,2,4
36408,6,2,127450,127450,127452,0,2,4
36409,3,1,127453,127453,127454,0,1,1
36410,3,3,127456,127456,127459,0,3,2
36411,2,2,127458,127459,127461,1,3,0
36412,4,2,127462,127462,127464,0,2,1
36413,4,3,127466,127466,127469,0,3,2
36414,2,2,127468,127469,127471,1,3,0
36415,4,2,127472,127472,127474,0,2,1
36416,3,1,127475,127475,127476,0,1,1
36417,4,2,127479,127479,127481,0,2,3
36418,3,3,127482,127482,127485,0,3,1
36419,4,2,127486,127486,127488,0,2,1
36420,4,2,127490,127490,127492,0,2,2
36421,5,2,127495,127495,127497,0,2,3
36422,1,3,127496,127497,127500,1,4,0
36423,4,3,127500,127500,127503,0,3,0
36424,6,1,127506,127506,127507,0,1,3
36425,2,1,127508,127508,127509,0,1,1
36426,1,3,127509,127509,127512,0,3,0
36427,2,3,127511,127512,127515,1,4,0
36428,6,2,127517,127517,127519,0,2,2
36429,2,3,127519,127519,127522,0,3,0
36430,4,1,127523,127523,127524,0,1,1
36431,1,3,127524,127524,127527,0,3,0
36432,5,3,127529,127529,127532,0,3,2
36433,2,3,127531,127532,127535,1,4,0
36434,1,2,127532,127535,127537,3,5,0
36435,1,1,127533,127537,127538,4,5,0
36436,1,3,127534,127538,127541,4,7,0
36437,4,1,127538,127541,127542,3,4,0
36438,4,1,127542,127542,127543,0,1,0
36439,6,1,127548,127548,127549,0,1,5
36440,1,1,127549,127549,127550,0,1,0
36441,2,1,127551,127551,127552,0,1,1
36442,3,2,127554,127554,127556,0,2,2
36443,3,3,127557,127557,127560,0,3,1
36444,4,2,127561,127561,127563,0,2,1
36445,4,3,127565,127565,127568,0,3,2
36446,3,2,127568,127568,127570,0,2,0
36447,4,2,127572,127572,127574,0,2,2
36448,4,3,127576,127576,127579,0,3,2
36449,1,1,127577,127579,127580,2,3,0
36450,6,3,127583,127583,127586,0,3,3
36451,1,1,127584,127586,127587,2,3,0
36452,3,1,127587,127587,127588,0,1,0
36453,5,3,127592,127592,127595,0,3,4
36454,4,1,127596,127596,127597,0,1,1
36455,2,1,127598,127598,127599,0,1,1
36456,4,1,127602,127602,127603,0,1,3
36457,4,2,127606,127606,127608,0,2,3
36458,1,1,127607,127608,127609,1,2,0
36459,5,2,127612,127612,127614,0,2,3
36460,2,2,127614,127614,127616,0,2,0
36461,1,2,127615,127616,127618,1,3,0
36462,3,1,127618,127618,127619,0,1,0
36463,5,1,127623,127623,127624,0,1,4
36464,6,2,127629,127629,127631,0,2,5
36465,6,1,127635,127635,127636,0,1,4
36466,2,2,127637,127637,127639,0,2,1
36467,3,3,127640,127640,127643,0,3,1
36468,5,1,127645,127645,127646,0,1,2
36469,4,3,127649,127649,127652,0,3,3
36470,2,1,127651,127652,127653,1,2,0
36471,6,2,127657,127657,127659,0,2,4
36472,3,2,127660,127660,127662,0,2,1
36473,2,1,127662,127662,127663,0,1,0
36474,4,1,127666,127666,127667,0,1,3
36475,4,2,127670,127670,127672,0,2,3
36476,3,3,127673,127673,127676,0,3,1
36477,1,2,127674,127676,127678,2,4,0
36478,1,1,127675,127678,127679,3,4,0
36479,6,1,127681,127681,127682,0,1,2
36480,3,3,127684,127684,127687,0,3,2
36481,1,2,127685,127687,127689,2,4,0
36482,2,1,127687,127689,127690,2,3,0
36483,1,2,127688,127690,127692,2,4,0
36484,3,1,127691,127692,127693,1,2,0
36485,6,2,127697,127697,127699,0,2,4
36486,3,1,127700,127700,127701,0,1,1
36487,5,2,127705,127705,127707,0,2,4
36488,1,3,127706,127707,127710,1,4,0
36489,1,1,127707,127710,127711,3,4,0
36490,3,1,127710,127711,127712,1,2,0
36491,3,3,127713,127713,127716,0,3,1
36492,2,3,127715,127716,127719,1,4,0
36493,2,1,127717,127719,127720,2,3,0
36494,3,3,127720,127720,127723,0,3,0
36495,6,2,127726,127726,127728,0,2,3
36496,5,1,127731,127731,127732,0,1,3
36497,4,1,127735,127735,127736,0,1,3
36498,3,3,127738,127738,127741,0,3,2
36499,4,1,127742,127742,127743,0,1,1
36500,5,2,127747,127747,127749,0,2,4
36501,4,2,127751,127751,127753,0,2,2
36502,1,1,127752,127753,127754,1,2,0
36503,4,1,127756,127756,127757,0,1,2
36504,6,2,127762,127762,127764,0,2,5
36505,4,2,127766,127766,127768,0,2,2
36506,1,3,127767,127768,127771,1,4,0
36507,2,3,127769,127771,127774,2,5,0
36508,4,1,127773,127774,127775,1,2,0
36509,2,2,127775,127775,127777,0,2,0
36510,6,2,127781,127781,127783,0,2,4
36511,6,1,127787,127787,127788,0,1,4
36512,3,1,127790,127790,127791,0,1,2
36513,6,1,127796,127796,127797,0,1,5
36514,6,1,127802,127802,127803,0,1,5
36515,6,2,127808,127808,127810,0,2,5
36516,4,2,127812,127812,127814,0,2,2
36517,5,1,127817,127817,127818,0,1,3
36518,3,3,127820,127820,127823,0,3,2
36519,3,2,127823,127823,127825,0,2,0
36520,4,1,127827,127827,127828,0,1,2
36521,3,2,127830,127830,127832,0,2,2
36522,2,3,127832,127832,127835,0,3,0
36523,2,2,127834,127835,127837,1,3,0
36524,2,1,127836,127837,127838,1,2,0
36525,4,1,127840,127840,127841,0,1,2
36526,2,2,127842,127842,127844,0,2,1
36527,3,2,127845,127845,127847,0,2,1
36528,1,2,127846,127847,127849,1,3,0
36529,1,2,127847,127849,127851,2,4,0
36530,1,3,127848,127851,127854,3,6,0
36531,1,1,127849,127854,127855,5,6,0
36532,3,2,127852,127855,127857,3,5,0
36533,3,1,127855,127857,127858,2,3,0
36534,2,1,127857,127858,127859,1,2,0
36535,6,2,127863,127863,127865,0,2,4
36536,4,1,127867,127867,127868,0,1,2
36537,4,1,127871,127871,127872,0,1,3
36538,6,2,127877,127877,127879,0,2,5
36539,1,2,127878,127879,127881,1,3,0
36540,6,2,127884,127884,127886,0,2,3
36541,2,3,127886,127886,127889,0,3,0
36542,6,1,127892,127892,127893,0,1,3
36543,6,3,127898,127898,127901,0,3,5
36544,5,1,127903,127903,127904,0,1,2
36545,1,3,127904,127904,127907,0,3,0
36546,3,3,127907,127907,127910,0,3,0
36547,6,2,127913,127913,127915,0,2,3
36548,2,1,127915,127915,127916,0,1,0
36549,6,1,127921,127921,127922,0,1,5
36550,1,3,127922,127922,127925,0,3,0
36551,1,3,127923,127925,127928,2,5,0
36552,3,3,127926,127928,127931,2,5,0
36553,2,1,127928,127931,127932,3,4,0
36554,6,3,127934,127934,127937,0,3,2
36555,1,3,127935,127937,127940,2,5,0
36556,1,1,127936,127940,127941,4,5,0
36557,3,2,127939,127941,127943,2,4,0
36558,6,3,127945,127945,127948,0,3,2
36559,3,3,127948,127948,127951,0,3,0
36560,1,3,127949,127951,127954,2,5,0
36561,4,2,127953,127954,127956,1,3,0
36562,4,2,127957,127957,127959,0,2,1
36563,3,1,127960,127960,127961,0,1,1
36564,5,3,127965,127965,127968,0,3,4
36565,4,2,127969,127969,127971,0,2,1
36566,5,2,127974,127974,127976,0,2,3
36567,4,2,127978,127978,127980,0,2,2
36568,3,2,127981,127981,127983,0,2,1
36569,6,2,127987,127987,127989,0,2,4
36570,4,1,127991,127991,127992,0,1,2
36571,5,1,127996,127996,127997,0,1,4
36572,3,3,127999,127999,128002,0,3,2
36573,5,1,128004,128004,128005,0,1,2
36574,5,3,128009,128009,128012,0,3,4
36575,2,3,128011,128012,128015,1,4,0
36576,6,1,128017,128017,128018,0,1,2
36577,6,1,128023,128023,128024,0,1,5
36578,5,2,128028,128028,128030,0,2,4
36579,2,2,128030,128030,128032,0,2,0
36580,3,3,128033,128033,128036,0,3,1
36581,5,1,128038,128038,128039,0,1,2
36582,6,2,128044,128044,128046,0,2,5
36583,2,1,128046,128046,128047,0,1,0
36584,2,3,128048,128048,128051,0,3,1
36585,4,1,128052,128052,128053,0,1,1
36586,6,2,128058,128058,128060,0,2,5
36587,1,3,128059,128060,128063,1,4,0
36588,1,3,128060,128063,128066,3,6,0
36589,4,3,128064,128066,128069,2,5,0
36590,5,3,128069,128069,128072,0,3,0
36591,1,2,128070,128072,128074,2,4,0
36592,4,1,128074,128074,128075,0,1,0
36593,3,3,128077,128077,128080,0,3,2
36594,5,1,128082,128082,128083,0,1,2
36595,3,3,128085,128085,128088,0,3,2
36596,4,2,128089,128089,128091,0,2,1
36597,4,1,128093,128093,128094,0,1,2
36598,4,2,128097,128097,128099,0,2,3
36599,5,2,128102,128102,128104,0,2,3
36600,3,1,128105,128105,128106,0,1,1
36601,2,1,128107,128107,128108,0,1,1
36602,3,2,128110,128110,128112,0,2,2
36603,1,1,128111,128112,128113,1,2,0
36604,4,2,128115,128115,128117,0,2,2
36605,6,1,128121,128121,128122,0,1,4
36606,5,3,128126,128126,128129,0,3,4
36607,1,3,128127,128129,128132,2,5,0
36608,5,3,128132,128132,128135,0,3,0
36609,5,1,128137,128137,128138,0,1,2
36610,4,2,128141,128141,128143,0,2,3
36611,4,2,128145,128145,128147,0,2,2
36612,1,3,128146,128147,128150,1,4,0
36613,3,1,128149,128150,128151,1,2,0
36614,5,3,128154,128154,128157,0,3,3
36615,1,2,128155,128157,128159,2,4,0
36616,1,2,128156,128159,128161,3,5,0
36617,4,3,128160,128161,128164,1,4,0
36618,2,2,128162,128164,128166,2,4,0
36619,1,3,128163,128166,128169,3,6,0
36620,2,1,128165,128169,128170,4,5,0
36621,3,1,128168,128170,128171,2,3,0
36622,1,1,128169,128171,128172,2,3,0
36623,6,1,128175,128175,128176,0,1,3
36624,2,1,128177,128177,128178,0,1,1
36625,1,2,128178,128178,128180,0,2,0
36626,6,3,128184,128184,128187,0,3,4
36627,1,1,128185,128187,128188,2,3,0
36628,2,1,128187,128188,128189,1,2,0
36629,3,2,128190,128190,128192,0,2,1
36630,2,1,128192,128192,128193,0,1,0
36631,5,2,128197,128197,128199,0,2,4
36632,4,2,128201,128201,128203,0,2,2
36633,3,3,128204,128204,128207,0,3,1
36634,2,3,128206,128207,128210,1,4,0
36635,1,2,128207,128210,128212,3,5,0
36636,6,3,128213,128213,128216,0,3,1
36637,4,2,128217,128217,128219,0,2,1
36638,5,1,128222,128222,128223,0,1,3
36639,5,2,128227,128227,128229,0,2,4
36640,1,2,128228,128229,128231,1,3,0
36641,4,3,128232,128232,128235,0,3,1
36642,2,3,128234,128235,128238,1,4,0
36643,3,3,128237,128238,128241,1,4,0
36644,4,1,128241,128241,128242,0,1,0
36645,4,3,128245,128245,128248,0,3,3
36646,6,1,128251,128251,128252,0,1,3
36647,5,1,128256,128256,128257,0,1,4
36648,6,1,128262,128262,128263,0,1,5
36649,6,2,128268,128268,128270,0,2,5
36650,5,1,128273,128273,128274,0,1,3
36651,1,1,128274,128274,128275,0,1,0
36652,3,1,128277,128277,128278,0,1,2
36653,4,1,128281,128281,128282,0,1,3
36654,6,3,128287,128287,128290,0,3,5
36655,6,2,128293,128293,128295,0,2,3
36656,5,2,128298,128298,128300,0,2,3
36657,6,3,128304,128304,128307,0,3,4
36658,2,1,128306,128307,128308,1,2,0
36659,3,1,128309,128309,128310,0,1,1
36660,4,3,128313,128313,128316,0,3,3
36661,3,3,128316,128316,128319,0,3,0
36662,2,3,128318,128319,128322,1,4,0
36663,1,3,128319,128322,128325,3,6,0
36664,1,1,128320,128325,128326,5,6,0
36665,2,2,128322,128326,128328,4,6,0
36666,4,1,128326,128328,128329,2,3,0
36667,3,3,128329,128329,128332,0,3,0
36668,5,1,128334,128334,128335,0,1,2
36669,2,3,128336,128336,128339,0,3,1
36670,5,3,128341,128341,128344,0,3,2
36671,3,2,128344,128344,128346,0,2,0
36672,1,3,128345,128346,128349,1,4,0
36673,3,1,128348,128349,128350,1,2,0
36674,2,3,128350,128350,128353,0,3,0
36675,6,2,128356,128356,128358,0,2,3
36676,2,2,128358,128358,128360,0,2,0
36677,5,3,128363,128363,128366,0,3,3
36678,5,1,128368,128368,128369,0,1,2
36679,2,3,128370,128370,128373,0,3,1
36680,5,2,128375,128375,128377,0,2,2
36681,1,1,128376,128377,128378,1,2,0
36682,2,1,128378,128378,128379,0,1,0
36683,3,3,128381,128381,128384,0,3,2
36684,2,2,128383,128384,128386,1,3,0
36685,3,2,128386,128386,128388,0,2,0
36686,3,2,128389,128389,128391,0,2,1
36687,5,3,128394,128394,128397,0,3,3
36688,4,2,128398,128398,128400,0,2,1
36689,4,2,128402,128402,128404,0,2,2
36690,1,1,128403,128404,128405,1,2,0
36691,5,1,128408,128408,128409,0,1,3
36692,5,1,128413,128413,128414,0,1,4
36693,6,3,128419,128419,128422,0,3,5
36694,2,3,128421,128422,128425,1,4,0
36695,6,3,128427,128427,128430,0,3,2
36696,5,1,128432,128432,128433,0,1,2
36697,1,1,128433,128433,128434,0,1,0
36698,5,3,128438,128438,128441,0,3,4
36699,1,3,128439,128441,128444,2,5,0
36700,3,3,128442,128444,128447,2,5,0
36701,6,1,128448,128448,128449,0,1,1
36702,2,1,128450,128450,128451,0,1,1
36703,3,1,128453,128453,128454,0,1,2
36704,4,1,128457,128457,128458,0,1,3
36705,2,3,128459,128459,128462,0,3,1
36706,2,3,128461,128462,128465,1,4,0
36707,6,1,128467,128467,128468,0,1,2
36708,3,1,128470,128470,128471,0,1,2
36709,3,2,128473,128473,128475,0,2,2
36710,4,1,128477,128477,128478,0,1,2
36711,6,2,128483,128483,128485,0,2,5
36712,4,3,128487,128487,128490,0,3,2
36713,2,2,128489,128490,128492,1,3,0
36714,5,1,128494,128494,128495,0,1,2
36715,3,1,128497,128497,128498,0,1,2
36716,5,1,128502,128502,128503,0,1,4
36717,1,3,128503,128503,128506,0,3,0
36718,3,1,128506,128506,128507,0,1,0
36719,2,2,128508,128508,128510,0,2,1
36720,6,3,128514,128514,128517,0,3,4
36721,4,2,128518,128518,128520,0,2,1
36722,3,1,128521,128521,128522,0,1,1
36723,6,1,128527,128527,128528,0,1,5
36724,2,1,128529,128529,128530,0,1,1
36725,5,1,128534,128534,128535,0,1,4
36726,6,1,128540,128540,128541,0,1,5
36727,5,2,128545,128545,128547,0,2,4
36728,2,1,128547,128547,128548,0,1,0
36729,5,1,128552,128552,128553,0,1,4
36730,5,1,128557,128557,128558,0,1,4
36731,1,3,128558,128558,128561,0,3,0
36732,3,2,128561,128561,128563,0,2,0
36733,2,3,128563,128563,128566,0,3,0
36734,6,3,128569,128569,128572,0,3,3
36735,2,1,128571,128572,128573,1,2,0
36736,5,3,128576,128576,128579,0,3,3
36737,1,1,128577,128579,128580,2,3,0
36738,2,2,128579,128580,128582,1,3,0
36739,5,1,128584,128584,128585,0,1,2
36740,6,2,128590,128590,128592,0,2,5
36741,4,1,128594,128594,128595,0,1,2
36742,5,3,128599,128599,128602,0,3,4
36743,3,2,128602,128602,128604,0,2,0
36744,1,2,128603,128604,128606,1,3,0
36745,4,2,128607,128607,128609,0,2,1
36746,4,2,128611,128611,128613,0,2,2
36747,6,2,128617,128617,128619,0,2,4
36748,3,2,128620,128620,128622,0,2,1
36749,5,2,128625,128625,128627,0,2,3
36750,3,1,128628,128628,128629,0,1,1
36751,3,2,128631,128631,128633,0,2,2
36752,6,1,128637,128637,128638,0,1,4
36753,2,3,128639,128639,128642,0,3,1
36754,5,2,128644,128644,128646,0,2,2
36755,2,3,128646,128646,128649,0,3,0
36756,3,3,128649,128649,128652,0,3,0
36757,1,2,128650,128652,128654,2,4,0
36758,5,1,128655,128655,128656,0,1,1
36759,6,1,128661,128661,128662,0,1,5
36760,4,3,128665,128665,128668,0,3,3
36761,1,1,128666,128668,128669,2,3,0
36762,2,2,128668,128669,128671,1,3,0
36763,1,1,128669,128671,128672,2,3,0
36764,5,1,128674,128674,128675,0,1,2
36765,4,2,128678,128678,128680,0,2,3
36766,3,1,128681,128681,128682,0,1,1
36767,1,2,128682,128682,128684,0,2,0
36768,6,2,128688,128688,128690,0,2,4
36769,2,3,128690,128690,128693,0,3,0
36770,1,3,128691,128693,128696,2,5,0
36771,6,2,128697,128697,128699,0,2,1
36772,1,3,128698,128699,128702,1,4,0
36773,4,1,128702,128702,128703,0,1,0
36774,5,2,128707,128707,128709,0,2,4
36775,4,2,128711,128711,128713,0,2,2
36776,6,3,128717,128717,128720,0,3,4
36777,2,2,128719,128720,128722,1,3,0
36778,1,3,128720,128722,128725,2,5,0
36779,3,2,128723,128725,128727,2,4,0
36780,6,2,128729,128729,128731,0,2,2
36781,4,2,128733,128733,128735,0,2,2
36782,3,3,128736,128736,128739,0,3,1
36783,5,2,128741,128741,128743,0,2,2
36784,3,2,128744,128744,128746,0,2,1
36785,3,1,128747,128747,128748,0,1,1
36786,4,2,128751,128751,128753,0,2,3
36787,4,2,128755,128755,128757,0,2,2
36788,5,1,128760,128760,128761,0,1,3
36789,1,3,128761,128761,128764,0,3,0
36790,4,2,128765,128765,128767,0,2,1
36791,1,2,128766,128767,128769,1,3,0
36792,2,2,128768,128769,128771,1,3,0
36793,5,1,128773,128773,128774,0,1,2
36794,4,2,128777,128777,128779,0,2,3
36795,6,1,128783,128783,128784,0,1,4
36796,4,1,128787,128787,128788,0,1,3
36797,1,1,128788,128788,128789,0,1,0
36798,1,3,128789,128789,128792,0,3,0
36799,4,2,128793,128793,128795,0,2,1
36800,3,3,128796,128796,128799,0,3,1
36801,1,3,128797,128799,128802,2,5,0
36802,2,2,128799,128802,128804,3,5,0
36803,6,2,128805,128805,128807,0,2,1
36804,5,2,128810,128810,128812,0,2,3
36805,4,2,128814,128814,128816,0,2,2
36806,3,3,128817,128817,128820,0,3,1
36807,3,2,128820,128820,128822,0,2,0
36808,1,2,128821,128822,128824,1,3,0
36809,5,1,128826,128826,128827,0,1,2
36810,3,1,128829,128829,128830,0,1,2
36811,4,2,128833,128833,128835,0,2,3
36812,5,3,128838,128838,128841,0,3,3
36813,5,3,128843,128843,128846,0,3,2
36814,5,3,128848,128848,128851,0,3,2
36815,5,1,128853,128853,128854,0,1,2
36816,6,1,128859,128859,128860,0,1,5
36817,4,2,128863,128863,128865,0,2,3
36818,5,1,128868,128868,128869,0,1,3
36819,4,3,128872,128872,128875,0,3,3
36820,3,3,128875,128875,128878,0,3,0
36821,5,2,128880,128880,128882,0,2,2
36822,4,1,128884,128884,128885,0,1,2
36823,5,1,128889,128889,128890,0,1,4
36824,3,2,128892,128892,128894,0,2,2
36825,3,3,128895,128895,128898,0,3,1
36826,1,1,128896,128898,128899,2,3,0
36827,4,1,128900,128900,128901,0,1,1
36828,4,3,128904,128904,128907,0,3,3
36829,5,1,128909,128909,128910,0,1,2
36830,4,3,128913,128913,128916,0,3,3
36831,4,2,128917,128917,128919,0,2,1
36832,4,1,128921,128921,128922,0,1,2
36833,6,3,128927,128927,128930,0,3,5
36834,5,2,128932,128932,128934,0,2,2
36835,1,1,128933,128934,128935,1,2,0
36836,1,1,128934,128935,128936,1,2,0
36837,5,3,128939,128939,128942,0,3,3
36838,6,2,128945,128945,128947,0,2,3
36839,4,3,128949,128949,128952,0,3,2
36840,3,2,128952,128952,128954,0,2,0
36841,2,2,128954,128954,128956,0,2,0
36842,2,3,128956,128956,128959,0,3,0
36843,1,3,128957,128959,128962,2,5,0
36844,3,1,128960,128962,128963,2,3,0
36845,6,3,128966,128966,128969,0,3,3
36846,1,1,128967,128969,128970,2,3,0
36847,4,3,128971,128971,128974,0,3,1
36848,3,2,128974,128974,128976,0,2,0
36849,4,2,128978,128978,128980,0,2,2
36850,5,1,128983,128983,128984,0,1,3
36851,3,1,128986,128986,128987,0,1,2
36852,1,2,128987,128987,128989,0,2,0
36853,4,3,128991,128991,128994,0,3,2
36854,3,2,128994,128994,128996,0,2,0
36855,5,1,128999,128999,129000,0,1,3
36856,2,2,129001,129001,129003,0,2,1
36857,4,3,129005,129005,129008,0,3,2
36858,2,1,129007,129008,129009,1,2,0
36859,4,3,129011,129011,129014,0,3,2
36860,2,2,129013,129014,129016,1,3,0
36861,4,2,129017,129017,129019,0,2,1
36862,2,1,129019,129019,129020,0,1,0
36863,3,2,129022,129022,129024,0,2,2
36864,3,2,129025,129025,129027,0,2,1
36865,2,2,129027,129027,129029,0,2,0
36866,6,1,129033,129033,129034,0,1,4
36867,4,1,129037,129037,129038,0,1,3
36868,6,3,129043,129043,129046,0,3,5
36869,4,3,129047,129047,129050,0,3,1
36870,4,2,129051,129051,129053,0,2,1
36871,2,2,129053,129053,129055,0,2,0
36872,2,3,129055,129055,129058,0,3,0
36873,2,3,129057,129058,129061,1,4,0
36874,1,3,129058,129061,129064,3,6,0
36875,5,2,129063,129064,129066,1,3,0
36876,2,3,129065,129066,129069,1,4,0
36877,3,3,129068,129069,129072,1,4,0
36878,6,3,129074,129074,129077,0,3,2
36879,1,1,129075,129077,129078,2,3,0
36880,5,2,129080,129080,129082,0,2,2
36881,4,2,129084,129084,129086,0,2,2
36882,5,3,129089,129089,129092,0,3,3
36883,5,2,129094,129094,129096,0,2,2
36884,5,2,129099,129099,129101,0,2,3
36885,3,2,129102,129102,129104,0,2,1
36886,4,1,129106,129106,129107,0,1,2
36887,1,3,129107,129107,129110,0,3,0
36888,6,2,129113,129113,129115,0,2,3
36889,6,1,129119,129119,129120,0,1,4
36890,4,3,129123,129123,129126,0,3,3
36891,2,2,129125,129126,129128,1,3,0
36892,5,3,129130,129130,129133,0,3,2
36893,6,3,129136,129136,129139,0,3,3
36894,5,1,129141,129141,129142,0,1,2
36895,1,3,129142,129142,129145,0,3,0
36896,2,3,129144,129145,129148,1,4,0
36897,2,1,129146,129148,129149,2,3,0
36898,3,2,129149,129149,129151,0,2,0
36899,1,2,129150,129151,129153,1,3,0
36900,4,2,129154,129154,129156,0,2,1
36901,5,3,129159,129159,129162,0,3,3
36902,3,1,129162,129162,129163,0,1,0
36903,3,1,129165,129165,129166,0,1,2
36904,5,1,129170,129170,129171,0,1,4
36905,2,3,129172,129172,129175,0,3,1
36906,1,3,129173,129175,129178,2,5,0
36907,3,1,129176,129178,129179,2,3,0
36908,1,1,129177,129179,129180,2,3,0
36909,3,1,129180,129180,129181,0,1,0
36910,5,2,129185,129185,129187,0,2,4
36911,6,2,129191,129191,129193,0,2,4
36912,1,2,129192,129193,129195,1,3,0
36913,3,3,129195,129195,129198,0,3,0
36914,4,2,129199,129199,129201,0,2,1
36915,1,2,129200,129201,129203,1,3,0
36916,5,1,129205,129205,129206,0,1,2
36917,4,2,129209,129209,129211,0,2,3
36918,3,1,129212,129212,129213,0,1,1
36919,1,1,129213,129213,129214,0,1,0
36920,4,3,129217,129217,129220,0,3,3
36921,2,3,129219,129220,129223,1,4,0
36922,1,1,129220,129223,129224,3,4,0
36923,4,2,129224,129224,129226,0,2,0
36924,5,1,129229,129229,129230,0,1,3
36925,2,2,129231,129231,129233,0,2,1
36926,1,1,129232,129233,129234,1,2,0
36927,5,2,129237,129237,129239,0,2,3
36928,6,3,129243,129243,129246,0,3,4
36929,4,1,129247,129247,129248,0,1,1
36930,5,2,129252,129252,129254,0,2,4
36931,2,3,129254,129254,129257,0,3,0
36932,4,3,129258,129258,129261,0,3,1
36933,5,1,129263,129263,129264,0,1,2
36934,1,2,129264,129264,129266,0,2,0
36935,5,3,129269,129269,129272,0,3,3
36936,1,3,129270,129272,129275,2,5,0
36937,1,1,129271,129275,129276,4,5,0
36938,5,2,129276,129276,129278,0,2,0
36939,1,3,129277,129278,129281,1,4,0
36940,2,1,129279,129281,129282,2,3,0
36941,2,1,129281,129282,129283,1,2,0
36942,2,2,129283,129283,129285,0,2,0
36943,1,2,129284,129285,129287,1,3,0
36944,1,2,129285,129287,129289,2,4,0
36945,1,2,129286,129289,129291,3,5,0
36946,5,2,129291,129291,129293,0,2,0
36947,5,1,129296,129296,129297,0,1,3
36948,5,2,129301,129301,129303,0,2,4
36949,5,3,129306,129306,129309,0,3,3
36950,4,3,129310,129310,129313,0,3,1
36951,1,2,129311,129313,129315,2,4,0
36952,5,3,129316,129316,129319,0,3,1
36953,2,2,129318,129319,129321,1,3,0
36954,3,3,129321,129321,129324,0,3,0
36955,6,3,129327,129327,129330,0,3,3
36956,6,2,129333,129333,129335,0,2,3
36957,5,3,129338,129338,129341,0,3,3
36958,5,3,129343,129343,129346,0,3,2
36959,1,3,129344,129346,129349,2,5,0
36960,1,2,129345,129349,129351,4,6,0
36961,2,1,129347,129351,129352,4,5,0
36962,1,1,129348,129352,129353,4,5,0
36963,5,1,129353,129353,129354,0,1,0
36964,4,2,129357,129357,129359,0,2,3
36965,2,3,129359,129359,129362,0,3,0
36966,4,2,129363,129363,129365,0,2,1
36967,5,2,129368,129368,129370,0,2,3
36968,1,3,129369,129370,129373,1,4,0
36969,5,2,129374,129374,129376,0,2,1
36970,3,2,129377,129377,129379,0,2,1
36971,4,1,129381,129381,129382,0,1,2
36972,6,3,129387,129387,129390,0,3,5
36973,5,1,129392,129392,129393,0,1,2
36974,1,1,129393,129393,129394,0,1,0
36975,1,1,129394,129394,129395,0,1,0
36976,4,1,129398,129398,129399,0,1,3
36977,1,2,129399,129399,129401,0,2,0
36978,5,3,129404,129404,129407,0,3,3
36979,6,1,129410,129410,129411,0,1,3
36980,1,2,129411,129411,129413,0,2,0
36981,3,3,129414,129414,129417,0,3,1
36982,5,2,129419,129419,129421,0,2,2
36983,2,1,129421,129421,129422,0,1,0
36984,2,2,129423,129423,129425,0,2,1
36985,6,3,129429,129429,129432,0,3,4
36986,3,1,129432,129432,129433,0,1,0
36987,4,1,129436,129436,129437,0,1,3
36988,1,3,129437,129437,129440,0,3,0
36989,5,1,129442,129442,129443,0,1,2
36990,6,2,129448,129448,129450,0,2,5
36991,5,2,129453,129453,129455,0,2,3
36992,3,2,129456,129456,129458,0,2,1
36993,1,2,129457,129458,129460,1,3,0
36994,4,3,129461,129461,129464,0,3,1
36995,5,2,129466,129466,129468,0,2,2
36996,3,3,129469,129469,129472,0,3,1
36997,4,1,129473,129473,129474,0,1,1
36998,1,1,129474,129474,129475,0,1,0
36999,5,3,129479,129479,129482,0,3,4
37000,5,1,129484,129484,129485,0,1,2
37001,4,2,129488,129488,129490,0,2,3
37002,3,1,129491,129491,129492,0,1,1
37003,1,2,129492,129492,129494,0,2,0
37004,2,1,129494,129494,129495,0,1,0
37005,6,1,129500,129500,129501,0,1,5
37006,2,1,129502,129502,129503,0,1,1
37007,2,3,129504,129504,129507,0,3,1
37008,6,2,129510,129510,129512,0,2,3
37009,4,2,129514,129514,129516,0,2,2
37010,2,3,129516,129516,129519,0,3,0
37011,4,1,129520,129520,129521,0,1,1
37012,2,3,129522,129522,129525,0,3,1
37013,2,2,129524,129525,129527,1,3,0
37014,6,3,129530,129530,129533,0,3,3
37015,1,3,129531,129533,129536,2,5,0
37016,3,1,129534,129536,129537,2,3,0
37017,5,3,129539,129539,129542,0,3,2
37018,2,1,129541,129542,129543,1,2,0
37019,3,1,129544,129544,129545,0,1,1
37020,4,2,129548,129548,129550,0,2,3
37021,4,1,129552,129552,129553,0,1,2
37022,1,3,129553,129553,129556,0,3,0
37023,1,1,129554,129556,129557,2,3,0
37024,6,2,129560,129560,129562,0,2,3
37025,1,3,129561,129562,129565,1,4,0
37026,5,3,129566,129566,129569,0,3,1
37027,2,1,129568,129569,129570,1,2,0
37028,5,2,129573,129573,129575,0,2,3
37029,3,3,129576,129576,129579,0,3,1
37030,5,2,129581,129581,129583,0,2,2
37031,6,1,129587,129587,129588,0,1,4
37032,1,2,129588,129588,129590,0,2,0
37033,5,1,129593,129593,129594,0,1,3
37034,2,2,129595,129595,129597,0,2,1
37035,4,1,129599,129599,129600,0,1,2
37036,4,1,129603,129603,129604,0,1,3
37037,6,3,129609,129609,129612,0,3,5
37038,4,2,129613,129613,129615,0,2,1
37039,3,1,129616,129616,129617,0,1,1
37040,3,1,129619,129619,129620,0,1,2
37041,6,1,129625,129625,129626,0,1,5
37042,5,1,129630,129630,129631,0,1,4
37043,6,1,129636,129636,129637,0,1,5
37044,2,3,129638,129638,129641,0,3,1
37045,5,2,129643,129643,129645,0,2,2
37046,6,3,129649,129649,129652,0,3,4
37047,2,1,129651,129652,129653,1,2,0
37048,6,1,129657,129657,129658,0,1,4
37049,4,3,129661,129661,129664,0,3,3
37050,2,1,129663,129664,129665,1,2,0
37051,4,1,129667,129667,129668,0,1,2
37052,4,2,129671,129671,129673,0,2,3
37053,6,3,129677,129677,129680,0,3,4
37054,1,1,129678,129680,129681,2,3,0
37055,3,1,129681,129681,129682,0,1,0
37056,6,3,129687,129687,129690,0,3,5
37057,6,3,129693,129693,129696,0,3,3
37058,6,3,129699,129699,129702,0,3,3
37059,1,2,129700,129702,129704,2,4,0
37060,6,3,129706,129706,129709,0,3,2
37061,5,2,129711,129711,129713,0,2,2
37062,4,1,129715,129715,129716,0,1,2
37063,3,3,129718,129718,129721,0,3,2
37064,1,3,129719,129721,129724,2,5,0
37065,6,3,129725,129725,129728,0,3,1
37066,6,1,129731,129731,129732,0,1,3
37067,2,1,129733,129733,129734,0,1,1
37068,5,2,129738,129738,129740,0,2,4
37069,3,3,129741,129741,129744,0,3,1
37070,5,2,129746,129746,129748,0,2,2
37071,2,2,129748,129748,129750,0,2,0
37072,4,1,129752,129752,129753,0,1,2
37073,5,2,129757,129757,129759,0,2,4
37074,4,2,129761,129761,129763,0,2,2
37075,1,2,129762,129763,129765,1,3,0
37076,4,3,129766,129766,129769,0,3,1
37077,5,1,129771,129771,129772,0,1,2
37078,2,3,129773,129773,129776,0,3,1
37079,3,1,129776,129776,129777,0,1,0
37080,2,2,129778,129778,129780,0,2,1
37081,5,2,129783,129783,129785,0,2,3
37082,3,3,129786,129786,129789,0,3,1
37083,4,1,129790,129790,129791,0,1,1
37084,2,1,129792,129792,129793,0,1,1
37085,5,3,129797,129797,129800,0,3,4
37086,5,2,129802,129802,129804,0,2,2
37087,5,3,129807,129807,129810,0,3,3
37088,1,2,129808,129810,129812,2,4,0
37089,5,1,129813,129813,129814,0,1,1
37090,1,2,129814,129814,129816,0,2,0
37091,6,3,129820,129820,129823,0,3,4
37092,1,1,129821,129823,129824,2,3,0
37093,6,2,129827,129827,129829,0,2,3
37094,1,3,129828,129829,129832,1,4,0
37095,4,1,129832,129832,129833,0,1,0
37096,3,3,129835,129835,129838,0,3,2
37097,2,3,129837,129838,129841,1,4,0
37098,2,2,129839,129841,129843,2,4,0
37099,4,3,129843,129843,129846,0,3,0
37100,5,3,129848,129848,129851,0,3,2
37101,6,3,129854,129854,129857,0,3,3
37102,2,1,129856,129857,129858,1,2,0
37103,6,3,129862,129862,129865,0,3,4
37104,3,2,129865,129865,129867,0,2,0
37105,6,1,129871,129871,129872,0,1,4
37106,1,1,129872,129872,129873,0,1,0
37107,3,3,129875,129875,129878,0,3,2
37108,3,3,129878,129878,129881,0,3,0
37109,3,1,129881,129881,129882,0,1,0
37110,6,1,129887,129887,129888,0,1,5
37111,2,2,129889,129889,129891,0,2,1
37112,1,1,129890,129891,129892,1,2,0
37113,6,1,129896,129896,129897,0,1,4
37114,5,2,129901,129901,129903,0,2,4
37115,6,2,129907,129907,129909,0,2,4
37116,6,3,129913,129913,129916,0,3,4
37117,6,1,129919,129919,129920,0,1,3
37118,6,2,129925,129925,129927,0,2,5
37119,1,1,129926,129927,129928,1,2,0
37120,5,1,129931,129931,129932,0,1,3
37121,2,2,129933,129933,129935,0,2,1
37122,3,1,129936,129936,129937,0,1,1
37123,1,2,129937,129937,129939,0,2,0
37124,4,3,129941,129941,129944,0,3,2
37125,6,3,129947,129947,129950,0,3,3
37126,1,1,129948,129950,129951,2,3,0
37127,2,1,129950,129951,129952,1,2,0
37128,1,3,129951,129952,129955,1,4,0
37129,4,1,129955,129955,129956,0,1,0
37130,4,1,129959,129959,129960,0,1,3
37131,3,2,129962,129962,129964,0,2,2
37132,3,2,129965,129965,129967,0,2,1
37133,5,3,129970,129970,129973,0,3,3
37134,3,3,129973,129973,129976,0,3,0
37135,1,1,129974,129976,129977,2,3,0
37136,1,1,129975,129977,129978,2,3,0
37137,6,2,129981,129981,129983,0,2,3
37138,5,1,129986,129986,129987,0,1,3
37139,2,1,129988,129988,129989,0,1,1
37140,4,2,129992,129992,129994,0,2,3
37141,2,2,129994,129994,129996,0,2,0
37142,1,1,129995,129996,129997,1,2,0
37143,5,3,130000,130000,130003,0,3,3
37144,5,3,130005,130005,130008,0,3,2
37145,1,3,130006,130008,130011,2,5,0
37146,5,1,130011,130011,130012,0,1,0
37147,1,3,130012,130012,130015,0,3,0
37148,3,2,130015,130015,130017,0,2,0
37149,4,1,130019,130019,130020,0,1,2
37150,6,3,130025,130025,130028,0,3,5
37151,5,1,130030,130030,130031,0,1,2
37152,3,3,130033,130033,130036,0,3,2
37153,2,1,130035,130036,130037,1,2,0
37154,4,2,130039,130039,130041,0,2,2
37155,5,2,130044,130044,130046,0,2,3
37156,6,2,130050,130050,130052,0,2,4
37157,2,2,130052,130052,130054,0,2,0
37158,1,3,130053,130054,130057,1,4,0
37159,1,1,130054,130057,130058,3,4,0
37160,1,2,130055,130058,130060,3,5,0
37161,4,1,130059,130060,130061,1,2,0
37162,1,3,130060,130061,130064,1,4,0
37163,6,2,130066,130066,130068,0,2,2
37164,5,3,130071,130071,130074,0,3,3
37165,4,2,130075,130075,130077,0,2,1
37166,4,1,130079,130079,130080,0,1,2
37167,3,2,130082,130082,130084,0,2,2
37168,3,2,130085,130085,130087,0,2,1
37169,4,2,130089,130089,130091,0,2,2
37170,1,3,130090,130091,130094,1,4,0
37171,4,3,130094,130094,130097,0,3,0
37172,2,3,130096,130097,130100,1,4,0
37173,2,2,130098,130100,130102,2,4,0
37174,3,1,130101,130102,130103,1,2,0
37175,1,1,130102,130103,130104,1,2,0
37176,4,3,130106,130106,130109,0,3,2
37177,6,3,130112,130112,130115,0,3,3
37178,4,2,130116,130116,130118,0,2,1
37179,1,1,130117,130118,130119,1,2,0
37180,3,1,130120,130120,130121,0,1,1
37181,2,1,130122,130122,130123,0,1,1
37182,6,2,130128,130128,130130,0,2,5
37183,4,2,130132,130132,130134,0,2,2
37184,2,3,130134,130134,130137,0,3,0
37185,5,2,130139,130139,130141,0,2,2
37186,6,2,130145,130145,130147,0,2,4
37187,4,1,130149,130149,130150,0,1,2
37188,1,2,130150,130150,130152,0,2,0
37189,5,2,130155,130155,130157,0,2,3
37190,4,1,130159,130159,130160,0,1,2
37191,1,2,130160,130160,130162,0,2,0
37192,5,1,130165,130165,130166,0,1,3
37193,5,3,130170,130170,130173,0,3,4
37194,2,2,130172,130173,130175,1,3,0
37195,1,2,130173,130175,130177,2,4,0
37196,5,3,130178,130178,130181,0,3,1
37197,2,3,130180,130181,130184,1,4,0
37198,1,2,130181,130184,130186,3,5,0
37199,6,3,130187,130187,130190,0,3,1
37200,4,2,130191,130191,130193,0,2,1
37201,6,3,130197,130197,130200,0,3,4
37202,4,3,130201,130201,130204,0,3,1
37203,6,1,130207,130207,130208,0,1,3
37204,3,1,130210,130210,130211,0,1,2
37205,3,3,130213,130213,130216,0,3,2
37206,2,1,130215,130216,130217,1,2,0
37207,5,1,130220,130220,130221,0,1,3
37208,5,2,130225,130225,130227,0,2,4
37209,4,3,130229,130229,130232,0,3,2
37210,4,1,130233,130233,130234,0,1,1
37211,4,1,130237,130237,130238,0,1,3
37212,2,1,130239,130239,130240,0,1,1
37213,5,3,130244,130244,130247,0,3,4
37214,3,3,130247,130247,130250,0,3,0
37215,4,2,130251,130251,130253,0,2,1
37216,1,1,130252,130253,130254,1,2,0
37217,3,3,130255,130255,130258,0,3,1
37218,2,1,130257,130258,130259,1,2,0
37219,5,3,130262,130262,130265,0,3,3
37220,2,1,130264,130265,130266,1,2,0
37221,2,1,130266,130266,130267,0,1,0
37222,5,1,130271,130271,130272,0,1,4
37223,4,3,130275,130275,130278,0,3,3
37224,4,1,130279,130279,130280,0,1,1
37225,1,1,130280,130280,130281,0,1,0
37226,1,1,130281,130281,130282,0,1,0
37227,5,3,130286,130286,130289,0,3,4
37228,1,3,130287,130289,130292,2,5,0
37229,6,2,130293,130293,130295,0,2,1
37230,1,1,130294,130295,130296,1,2,0
37231,4,2,130298,130298,130300,0,2,2
37232,3,3,130301,130301,130304,0,3,1
37233,1,3,130302,130304,130307,2,5,0
37234,1,1,130303,130307,130308,4,5,0
37235,1,1,130304,130308,130309,4,5,0
37236,4,3,130308,130309,130312,1,4,0
37237,1,2,130309,130312,130314,3,5,0
37238,5,2,130314,130314,130316,0,2,0
37239,3,2,130317,130317,130319,0,2,1
37240,2,3,130319,130319,130322,0,3,0
37241,6,3,130325,130325,130328,0,3,3
37242,6,1,130331,130331,130332,0,1,3
37243,5,3,130336,130336,130339,0,3,4
37244,2,2,130338,130339,130341,1,3,0
37245,2,1,130340,130341,130342,1,2,0
37246,2,1,130342,130342,130343,0,1,0
37247,4,1,130346,130346,130347,0,1,3
37248,4,2,130350,130350,130352,0,2,3
37249,6,2,130356,130356,130358,0,2,4
37250,6,3,130362,130362,130365,0,3,4
37251,1,2,130363,130365,130367,2,4,0
37252,1,2,130364,130367,130369,3,5,0
37253,2,1,130366,130369,130370,3,4,0
37254,3,1,130369,130370,130371,1,2,0
37255,1,3,130370,130371,130374,1,4,0
37256,1,1,130371,130374,130375,3,4,0
37257,6,2,130377,130377,130379,0,2,2
37258,6,3,130383,130383,130386,0,3,4
37259,6,2,130389,130389,130391,0,2,3
37260,2,1,130391,130391,130392,0,1,0
37261,2,2,130393,130393,130395,0,2,1
37262,5,2,130398,130398,130400,0,2,3
37263,3,2,130401,130401,130403,0,2,1
37264,6,1,130407,130407,130408,0,1,4
37265,1,1,130408,130408,130409,0,1,0
37266,3,1,130411,130411,130412,0,1,2
37267,6,1,130417,130417,130418,0,1,5
37268,1,3,130418,130418,130421,0,3,0
37269,6,2,130424,130424,130426,0,2,3
37270,6,3,130430,130430,130433,0,3,4
37271,5,3,130435,130435,130438,0,3,2
37272,2,3,130437,130438,130441,1,4,0
37273,3,2,130440,130441,130443,1,3,0
37274,5,1,130445,130445,130446,0,1,2
37275,4,1,130449,130449,130450,0,1,3
37276,6,2,130455,130455,130457,0,2,5
37277,4,3,130459,130459,130462,0,3,2
37278,2,3,130461,130462,130465,1,4,0
37279,1,1,130462,130465,130466,3,4,0
37280,3,3,130465,130466,130469,1,4,0
37281,1,3,130466,130469,130472,3,6,0
37282,2,1,130468,130472,130473,4,5,0
37283,1,2,130469,130473,130475,4,6,0
37284,6,3,130475,130475,130478,0,3,0
37285,6,3,130481,130481,130484,0,3,3
37286,3,2,130484,130484,130486,0,2,0
37287,6,3,130490,130490,130493,0,3,4
37288,2,1,130492,130493,130494,1,2,0
37289,5,3,130497,130497,130500,0,3,3
37290,5,2,130502,130502,130504,0,2,2
37291,1,2,130503,130504,130506,1,3,0
37292,4,1,130507,130507,130508,0,1,1
37293,4,3,130511,130511,130514,0,3,3
37294,4,3,130515,130515,130518,0,3,1
37295,6,1,130521,130521,130522,0,1,3
37296,5,1,130526,130526,130527,0,1,4
37297,5,3,130531,130531,130534,0,3,4
37298,5,1,130536,130536,130537,0,1,2
37299,2,1,130538,130538,130539,0,1,1
37300,5,3,130543,130543,130546,0,3,4
37301,3,2,130546,130546,130548,0,2,0
37302,3,2,130549,130549,130551,0,2,1
37303,5,3,130554,130554,130557,0,3,3
37304,4,2,130558,130558,130560,0,2,1
37305,2,3,130560,130560,130563,0,3,0
37306,3,1,130563,130563,130564,0,1,0
37307,5,1,130568,130568,130569,0,1,4
37308,6,1,130574,130574,130575,0,1,5
37309,6,3,130580,130580,130583,0,3,5
37310,1,2,130581,130583,130585,2,4,0
37311,2,3,130583,130585,130588,2,5,0
37312,4,3,130587,130588,130591,1,4,0
37313,3,3,130590,130591,130594,1,4,0
37314,2,3,130592,130594,130597,2,5,0
37315,6,1,130598,130598,130599,0,1,1
37316,5,3,130603,130603,130606,0,3,4
37317,4,3,130607,130607,130610,0,3,1
37318,3,2,130610,130610,130612,0,2,0
37319,1,1,130611,130612,130613,1,2,0
37320,1,1,130612,130613,130614,1,2,0
37321,6,1,130618,130618,130619,0,1,4
37322,2,1,130620,130620,130621,0,1,1
37323,3,3,130623,130623,130626,0,3,2
37324,3,1,130626,130626,130627,0,1,0
37325,4,1,130630,130630,130631,0,1,3
37326,2,3,130632,130632,130635,0,3,1
37327,3,1,130635,130635,130636,0,1,0
37328,6,3,130641,130641,130644,0,3,5
37329,2,3,130643,130644,130647,1,4,0
37330,1,1,130644,130647,130648,3,4,0
37331,5,1,130649,130649,130650,0,1,1
37332,2,2,130651,130651,130653,0,2,1
37333,3,3,130654,130654,130657,0,3,1
37334,6,1,130660,130660,130661,0,1,3
37335,5,1,130665,130665,130666,0,1,4
37336,5,2,130670,130670,130672,0,2,4
37337,6,3,130676,130676,130679,0,3,4
37338,6,2,130682,130682,130684,0,2,3
37339,1,3,130683,130684,130687,1,4,0
37340,3,2,130686,130687,130689,1,3,0
37341,1,1,130687,130689,130690,2,3,0
37342,6,2,130693,130693,130695,0,2,3
37343,3,3,130696,130696,130699,0,3,1
37344,5,1,130701,130701,130702,0,1,2
37345,1,3,130702,130702,130705,0,3,0
37346,4,3,130706,130706,130709,0,3,1
37347,1,2,130707,130709,130711,2,4,0
37348,4,2,130711,130711,130713,0,2,0
37349,6,3,130717,130717,130720,0,3,4
37350,6,1,130723,130723,130724,0,1,3
37351,2,1,130725,130725,130726,0,1,1
37352,4,3,130729,130729,130732,0,3,3
37353,6,2,130735,130735,130737,0,2,3
37354,6,1,130741,130741,130742,0,1,4
37355,6,3,130747,130747,130750,0,3,5
37356,6,2,130753,130753,130755,0,2,3
37357,5,1,130758,130758,130759,0,1,3
37358,1,1,130759,130759,130760,0,1,0
37359,4,1,130763,130763,130764,0,1,3
37360,2,3,130765,130765,130768,0,3,1
37361,2,3,130767,130768,130771,1,4,0
37362,2,2,130769,130771,130773,2,4,0
37363,3,1,130772,130773,130774,1,2,0
37364,6,1,130778,130778,130779,0,1,4
37365,4,2,130782,130782,130784,0,2,3
37366,3,2,130785,130785,130787,0,2,1
37367,4,2,130789,130789,130791,0,2,2
37368,2,1,130791,130791,130792,0,1,0
37369,3,3,130794,130794,130797,0,3,2
37370,2,1,130796,130797,130798,1,2,0
37371,2,3,130798,130798,130801,0,3,0
37372,3,2,130801,130801,130803,0,2,0
37373,6,1,130807,130807,130808,0,1,4
37374,5,2,130812,130812,130814,0,2,4
37375,2,2,130814,130814,130816,0,2,0
37376,6,3,130820,130820,130823,0,3,4
37377,3,1,130823,130823,130824,0,1,0
37378,6,1,130829,130829,130830,0,1,5
37379,1,3,130830,130830,130833,0,3,0
37380,4,1,130834,130834,130835,0,1,1
37381,4,3,130838,130838,130841,0,3,3
37382,5,1,130843,130843,130844,0,1,2
37383,1,3,130844,130844,130847,0,3,0
37384,6,2,130850,130850,130852,0,2,3
37385,4,3,130854,130854,130857,0,3,2
37386,3,2,130857,130857,130859,0,2,0
37387,2,2,130859,130859,130861,0,2,0
37388,4,2,130863,130863,130865,0,2,2
37389,5,3,130868,130868,130871,0,3,3
37390,6,3,130874,130874,130877,0,3,3
37391,3,3,130877,130877,130880,0,3,0
37392,2,1,130879,130880,130881,1,2,0
37393,2,3,130881,130881,130884,0,3,0
37394,3,2,130884,130884,130886,0,2,0
37395,6,3,130890,130890,130893,0,3,4
37396,3,2,130893,130893,130895,0,2,0
37397,1,1,130894,130895,130896,1,2,0
37398,3,2,130897,130897,130899,0,2,1
37399,2,2,130899,130899,130901,0,2,0
37400,5,1,130904,130904,130905,0,1,3
37401,1,3,130905,130905,130908,0,3,0
37402,2,2,130907,130908,130910,1,3,0
37403,3,2,130910,130910,130912,0,2,0
37404,4,2,130914,130914,130916,0,2,2
37405,2,3,130916,130916,130919,0,3,0
37406,2,1,130918,130919,130920,1,2,0
37407,2,2,130920,130920,130922,0,2,0
37408,4,2,130924,130924,130926,0,2,2
37409,4,3,130928,130928,130931,0,3,2
37410,4,1,130932,130932,130933,0,1,1
37411,1,1,130933,130933,130934,0,1,0
37412,4,2,130937,130937,130939,0,2,3
37413,6,2,130943,130943,130945,0,2,4
37414,1,1,130944,130945,130946,1,2,0
37415,3,3,130947,130947,130950,0,3,1
37416,4,2,130951,130951,130953,0,2,1
37417,5,3,130956,130956,130959,0,3,3
37418,4,2,130960,130960,130962,0,2,1
37419,2,3,130962,130962,130965,0,3,0
37420,5,3,130967,130967,130970,0,3,2
37421,5,1,130972,130972,130973,0,1,2
37422,3,1,130975,130975,130976,0,1,2
37423,5,2,130980,130980,130982,0,2,4
37424,3,2,130983,130983,130985,0,2,1
37425,1,3,130984,130985,130988,1,4,0
37426,6,1,130990,130990,130991,0,1,2
37427,4,2,130994,130994,130996,0,2,3
37428,6,1,131000,131000,131001,0,1,4
37429,3,3,131003,131003,131006,0,3,2
37430,3,3,131006,131006,131009,0,3,0
37431,3,3,131009,131009,131012,0,3,0
37432,1,2,131010,131012,131014,2,4,0
37433,4,1,131014,131014,131015,0,1,0
37434,2,1,131016,131016,131017,0,1,1
37435,1,1,131017,131017,131018,0,1,0
37436,1,2,131018,131018,131020,0,2,0
37437,3,1,131021,131021,131022,0,1,1
37438,1,3,131022,131022,131025,0,3,0
37439,5,3,131027,131027,131030,0,3,2
37440,4,3,131031,131031,131034,0,3,1
37441,1,2,131032,131034,131036,2,4,0
37442,1,1,131033,131036,131037,3,4,0
37443,4,2,131037,131037,131039,0,2,0
37444,1,1,131038,131039,131040,1,2,0
37445,1,2,131039,131040,131042,1,3,0
37446,5,1,131044,131044,131045,0,1,2
37447,1,1,131045,131045,131046,0,1,0
37448,1,3,131046,131046,131049,0,3,0
37449,3,1,131049,131049,131050,0,1,0
37450,3,1,131052,131052,131053,0,1,2
37451,4,2,131056,131056,131058,0,2,3
37452,2,3,131058,131058,131061,0,3,0
37453,2,3,131060,131061,131064,1,4,0
37454,3,2,131063,131064,131066,1,3,0
37455,3,3,131066,131066,131069,0,3,0
37456,5,2,131071,131071,131073,0,2,2
37457,4,1,131075,131075,131076,0,1,2
37458,6,2,131081,131081,131083,0,2,5
37459,5,1,131086,131086,131087,0,1,3
37460,2,3,131088,131088,131091,0,3,1
37461,6,1,131094,131094,131095,0,1,3
37462,2,1,131096,131096,131097,0,1,1
37463,1,3,131097,131097,131100,0,3,0
37464,5,2,131102,131102,131104,0,2,2
37465,1,1,131103,131104,131105,1,2,0
37466,2,3,131105,131105,131108,0,3,0
37467,4,3,131109,131109,131112,0,3,1
37468,3,2,131112,131112,131114,0,2,0
37469,2,1,131114,131114,131115,0,1,0
37470,1,2,131115,131115,131117,0,2,0
37471,6,2,131121,131121,131123,0,2,4
37472,4,2,131125,131125,131127,0,2,2
37473,1,1,131126,131127,131128,1,2,0
37474,2,3,131128,131128,131131,0,3,0
37475,1,2,131129,131131,131133,2,4,0
37476,2,1,131131,131133,131134,2,3,0
37477,5,3,131136,131136,131139,0,3,2
37478,1,3,131137,131139,131142,2,5,0
37479,4,2,131141,131142,131144,1,3,0
37480,5,2,131146,131146,131148,0,2,2
37481,5,3,131151,131151,131154,0,3,3
37482,5,3,131156,131156,131159,0,3,2
37483,2,2,131158,131159,131161,1,3,0
37484,1,1,131159,131161,131162,2,3,0
37485,2,3,131161,131162,131165,1,4,0
37486,2,3,131163,131165,131168,2,5,0
37487,5,3,131168,131168,131171,0,3,0
37488,5,2,131173,131173,131175,0,2,2
37489,4,1,131177,131177,131178,0,1,2
37490,3,2,131180,131180,131182,0,2,2
37491,1,2,131181,131182,131184,1,3,0
37492,1,1,131182,131184,131185,2,3,0
37493,6,2,131188,131188,131190,0,2,3
37494,5,1,131193,131193,131194,0,1,3
37495,4,2,131197,131197,131199,0,2,3
37496,3,1,131200,131200,131201,0,1,1
37497,6,2,131206,131206,131208,0,2,5
37498,6,2,131212,131212,131214,0,2,4
37499,4,2,131216,131216,131218,0,2,2
37500,5,3,131221,131221,131224,0,3,3
37501,1,2,131222,131224,131226,2,4,0
37502,3,2,131225,131226,131228,1,3,0
37503,2,3,131227,131228,131231,1,4,0
37504,1,3,131228,131231,131234,3,6,0
37505,5,3,131233,131234,131237,1,4,0
37506,2,3,131235,131237,131240,2,5,0
37507,6,1,131241,131241,131242,0,1,1
37508,2,3,131243,131243,131246,0,3,1
37509,3,3,131246,131246,131249,0,3,0
37510,2,3,131248,131249,131252,1,4,0
37511,6,1,131254,131254,131255,0,1,2
37512,3,1,131257,131257,131258,0,1,2
37513,6,3,131263,131263,131266,0,3,5
37514,2,1,131265,131266,131267,1,2,0
37515,2,1,131267,131267,131268,0,1,0
37516,6,2,131273,131273,131275,0,2,5
37517,2,3,131275,131275,131278,0,3,0
37518,1,1,131276,131278,131279,2,3,0
37519,1,1,131277,131279,131280,2,3,0
37520,5,2,131282,131282,131284,0,2,2
37521,6,3,131288,131288,131291,0,3,4
37522,2,2,131290,131291,131293,1,3,0
37523,3,2,131293,131293,131295,0,2,0
37524,5,2,131298,131298,131300,0,2,3
37525,1,1,131299,131300,131301,1,2,0
37526,5,2,131304,131304,131306,0,2,3
37527,5,2,131309,131309,131311,0,2,3
37528,2,3,131311,131311,131314,0,3,0
37529,1,3,131312,131314,131317,2,5,0
37530,4,2,131316,131317,131319,1,3,0
37531,2,1,131318,131319,131320,1,2,0
37532,6,1,131324,131324,131325,0,1,4
37533,6,2,131330,131330,131332,0,2,5
37534,1,2,131331,131332,131334,1,3,0
37535,1,3,131332,131334,131337,2,5,0
37536,3,1,131335,131337,131338,2,3,0
37537,5,2,131340,131340,131342,0,2,2
37538,4,2,131344,131344,131346,0,2,2
37539,3,1,131347,131347,131348,0,1,1
37540,6,2,131353,131353,131355,0,2,5
37541,6,2,131359,131359,131361,0,2,4
37542,4,2,131363,131363,131365,0,2,2
37543,6,2,131369,131369,131371,0,2,4
37544,6,2,131375,131375,131377,0,2,4
37545,6,2,131381,131381,131383,0,2,4
37546,3,1,131384,131384,131385,0,1,1
37547,2,1,131386,131386,131387,0,1,1
37548,2,2,131388,131388,131390,0,2,1
37549,2,1,131390,131390,131391,0,1,0
37550,5,2,131395,131395,131397,0,2,4
37551,2,1,131397,131397,131398,0,1,0
37552,4,3,131401,131401,131404,0,3,3
37553,1,2,131402,131404,131406,2,4,0
37554,3,2,131405,131406,131408,1,3,0
37555,4,1,131409,131409,131410,0,1,1
37556,3,2,131412,131412,131414,0,2,2
37557,3,2,131415,131415,131417,0,2,1
37558,6,1,131421,131421,131422,0,1,4
37559,2,2,131423,131423,131425,0,2,1
37560,2,3,131425,131425,131428,0,3,0
37561,2,3,131427,131428,131431,1,4,0
37562,4,3,131431,131431,131434,0,3,0
37563,1,1,131432,131434,131435,2,3,0
37564,5,2,131437,131437,131439,0,2,2
37565,1,3,131438,131439,131442,1,4,0
37566,6,2,131444,131444,131446,0,2,2
37567,6,3,131450,131450,131453,0,3,4
37568,3,3,131453,131453,131456,0,3,0
37569,6,1,131459,131459,131460,0,1,3
37570,6,1,131465,131465,131466,0,1,5
37571,3,1,131468,131468,131469,0,1,2
37572,4,2,131472,131472,131474,0,2,3
37573,6,2,131478,131478,131480,0,2,4
37574,6,2,131484,131484,131486,0,2,4
37575,2,2,131486,131486,131488,0,2,0
37576,5,2,131491,131491,131493,0,2,3
37577,4,1,131495,131495,131496,0,1,2
37578,5,1,131500,131500,131501,0,1,4
37579,2,3,131502,131502,131505,0,3,1
37580,5,2,131507,131507,131509,0,2,2
37581,1,3,131508,131509,131512,1,4,0
37582,1,2,131509,131512,131514,3,5,0
37583,4,2,131513,131514,131516,1,3,0
37584,3,3,131516,131516,131519,0,3,0
37585,1,2,131517,131519,131521,2,4,0
37586,5,3,131522,131522,131525,0,3,1
37587,3,1,131525,131525,131526,0,1,0
37588,3,2,131528,131528,131530,0,2,2
37589,3,1,131531,131531,131532,0,1,1
37590,1,2,131532,131532,131534,0,2,0
37591,6,3,131538,131538,131541,0,3,4
37592,2,3,131540,131541,131544,1,4,0
37593,6,2,131546,131546,131548,0,2,2
37594,6,3,131552,131552,131555,0,3,4
37595,6,3,131558,131558,131561,0,3,3
37596,5,3,131563,131563,131566,0,3,2
37597,2,3,131565,131566,131569,1,4,0
37598,5,3,131570,131570,131573,0,3,1
37599,6,2,131576,131576,131578,0,2,3
37600,5,1,131581,131581,131582,0,1,3
37601,5,1,131586,131586,131587,0,1,4
37602,6,3,131592,131592,131595,0,3,5
37603,6,3,131598,131598,131601,0,3,3
37604,5,3,131603,131603,131606,0,3,2
37605,5,1,131608,131608,131609,0,1,2
37606,4,3,131612,131612,131615,0,3,3
37607,2,3,131614,131615,131618,1,4,0
37608,5,1,131619,131619,131620,0,1,1
37609,6,3,131625,131625,131628,0,3,5
37610,2,2,131627,131628,131630,1,3,0
37611,5,1,131632,131632,131633,0,1,2
37612,4,1,131636,131636,131637,0,1,3
37613,6,1,131642,131642,131643,0,1,5
37614,6,1,131648,131648,131649,0,1,5
37615,4,3,131652,131652,131655,0,3,3
37616,6,3,131658,131658,131661,0,3,3
37617,2,3,131660,131661,131664,1,4,0
37618,1,2,131661,131664,131666,3,5,0
37619,2,3,131663,131666,131669,3,6,0
37620,2,3,131665,131669,131672,4,7,0
37621,3,1,131668,131672,131673,4,5,0
37622,3,2,131671,131673,131675,2,4,0
37623,1,2,131672,131675,131677,3,5,0
37624,6,3,131678,131678,131681,0,3,1
37625,1,3,131679,131681,131684,2,5,0
37626,3,2,131682,131684,131686,2,4,0
37627,3,2,131685,131686,131688,1,3,0
37628,4,1,131689,131689,131690,0,1,1
37629,3,1,131692,131692,131693,0,1,2
37630,1,3,131693,131693,131696,0,3,0
37631,5,3,131698,131698,131701,0,3,2
37632,2,3,131700,131701,131704,1,4,0
37633,2,3,131702,131704,131707,2,5,0
37634,5,3,131707,131707,131710,0,3,0
37635,6,1,131713,131713,131714,0,1,3
37636,1,3,131714,131714,131717,0,3,0
37637,3,2,131717,131717,131719,0,2,0
37638,6,2,131723,131723,131725,0,2,4
37639,3,1,131726,131726,131727,0,1,1
37640,3,3,131729,131729,131732,0,3,2
37641,1,3,131730,131732,131735,2,5,0
37642,5,1,131735,131735,131736,0,1,0
37643,2,2,131737,131737,131739,0,2,1
37644,2,3,131739,131739,131742,0,3,0
37645,3,3,131742,131742,131745,0,3,0
37646,4,3,131746,131746,131749,0,3,1
37647,4,3,131750,131750,131753,0,3,1
37648,1,1,131751,131753,131754,2,3,0
37649,3,2,131754,131754,131756,0,2,0
37650,5,2,131759,131759,131761,0,2,3
37651,6,2,131765,131765,131767,0,2,4
37652,1,3,131766,131767,131770,1,4,0
37653,1,1,131767,131770,131771,3,4,0
37654,3,1,131770,131771,131772,1,2,0
37655,6,1,131776,131776,131777,0,1,4
37656,5,1,131781,131781,131782,0,1,4
37657,2,2,131783,131783,131785,0,2,1
37658,1,1,131784,131785,131786,1,2,0
37659,5,3,131789,131789,131792,0,3,3
37660,5,2,131794,131794,131796,0,2,2
37661,1,2,131795,131796,131798,1,3,0
37662,6,2,131801,131801,131803,0,2,3
37663,2,1,131803,131803,131804,0,1,0
37664,3,3,131806,131806,131809,0,3,2
37665,1,1,131807,131809,131810,2,3,0
37666,1,2,131808,131810,131812,2,4,0
37667,2,2,131810,131812,131814,2,4,0
37668,6,1,131816,131816,131817,0,1,2
37669,6,1,131822,131822,131823,0,1,5
37670,4,2,131826,131826,131828,0,2,3
37671,4,3,131830,131830,131833,0,3,2
37672,3,2,131833,131833,131835,0,2,0
37673,2,3,131835,131835,131838,0,3,0
37674,5,2,131840,131840,131842,0,2,2
37675,4,3,131844,131844,131847,0,3,2
37676,1,1,131845,131847,131848,2,3,0
37677,1,1,131846,131848,131849,2,3,0
37678,3,1,131849,131849,131850,0,1,0
37679,3,2,131852,131852,131854,0,2,2
37680,2,1,131854,131854,131855,0,1,0
37681,6,3,131860,131860,131863,0,3,5
37682,6,2,131866,131866,131868,0,2,3
37683,4,3,131870,131870,131873,0,3,2
37684,5,2,131875,131875,131877,0,2,2
37685,3,2,131878,131878,131880,0,2,1
37686,6,2,131884,131884,131886,0,2,4
37687,3,2,131887,131887,131889,0,2,1
37688,3,2,131890,131890,131892,0,2,1
37689,4,3,131894,131894,131897,0,3,2
37690,4,1,131898,131898,131899,0,1,1
37691,3,3,131901,131901,131904,0,3,2
37692,6,3,131907,131907,131910,0,3,3
37693,4,3,131911,131911,131914,0,3,1
37694,2,3,131913,131914,131917,1,4,0
37695,3,1,131916,131917,131918,1,2,0
37696,2,2,131918,131918,131920,0,2,0
37697,4,3,131922,131922,131925,0,3,2
37698,3,1,131925,131925,131926,0,1,0
37699,6,3,131931,131931,131934,0,3,5
37700,1,2,131932,131934,131936,2,4,0
37701,3,2,131935,131936,131938,1,3,0
37702,3,1,131938,131938,131939,0,1,0
37703,6,3,131944,131944,131947,0,3,5
37704,5,2,131949,131949,131951,0,2,2
37705,5,1,131954,131954,131955,0,1,3
37706,2,3,131956,131956,131959,0,3,1
37707,4,3,131960,131960,131963,0,3,1
37708,3,1,131963,131963,131964,0,1,0
37709,2,3,131965,131965,131968,0,3,1
37710,2,2,131967,131968,131970,1,3,0
37711,4,3,131971,131971,131974,0,3,1
37712,4,1,131975,131975,131976,0,1,1
37713,2,3,131977,131977,131980,0,3,1
37714,4,3,131981,131981,131984,0,3,1
37715,1,1,131982,131984,131985,2,3,0
37716,2,1,131984,131985,131986,1,2,0
37717,4,2,131988,131988,131990,0,2,2
37718,2,1,131990,131990,131991,0,1,0
37719,4,1,131994,131994,131995,0,1,3
37720,2,1,131996,131996,131997,0,1,1
37721,5,2,132001,132001,132003,0,2,4
37722,6,3,132007,132007,132010,0,3,4
37723,1,1,132008,132010,132011,2,3,0
37724,5,2,132013,132013,132015,0,2,2
37725,3,3,132016,132016,132019,0,3,1
37726,2,3,132018,132019,132022,1,4,0
37727,4,2,132022,132022,132024,0,2,0
37728,6,3,132028,132028,132031,0,3,4
37729,5,2,132033,132033,132035,0,2,2
37730,1,3,132034,132035,132038,1,4,0
37731,2,2,132036,132038,132040,2,4,0
37732,6,2,132042,132042,132044,0,2,2
37733,4,1,132046,132046,132047,0,1,2
37734,4,2,132050,132050,132052,0,2,3
37735,3,3,132053,132053,132056,0,3,1
37736,4,3,132057,132057,132060,0,3,1
37737,3,2,132060,132060,132062,0,2,0
37738,1,1,132061,132062,132063,1,2,0
37739,6,1,132067,132067,132068,0,1,4
37740,3,1,132070,132070,132071,0,1,2
37741,1,2,132071,132071,132073,0,2,0
37742,5,3,132076,132076,132079,0,3,3
37743,5,2,132081,132081,132083,0,2,2
37744,6,3,132087,132087,132090,0,3,4
37745,4,1,132091,132091,132092,0,1,1
37746,6,2,132097,132097,132099,0,2,5
37747,5,2,132102,132102,132104,0,2,3
37748,2,2,132104,132104,132106,0,2,0
37749,2,2,132106,132106,132108,0,2,0
37750,5,1,132111,132111,132112,0,1,3
37751,2,3,132113,132113,132116,0,3,1
37752,4,1,132117,132117,132118,0,1,1
37753,2,1,132119,132119,132120,0,1,1
37754,2,2,132121,132121,132123,0,2,1
37755,3,1,132124,132124,132125,0,1,1
37756,4,2,132128,132128,132130,0,2,3
37757,4,3,132132,132132,132135,0,3,2
37758,6,3,132138,132138,132141,0,3,3
37759,6,3,132144,132144,132147,0,3,3
37760,6,2,132150,132150,132152,0,2,3
37761,6,1,132156,132156,132157,0,1,4
37762,2,2,132158,132158,132160,0,2,1
37763,4,3,132162,132162,132165,0,3,2
37764,4,2,132166,132166,132168,0,2,1
37765,1,2,132167,132168,132170,1,3,0
37766,1,1,132168,132170,132171,2,3,0
37767,1,3,132169,132171,132174,2,5,0
37768,4,3,132173,132174,132177,1,4,0
37769,2,2,132175,132177,132179,2,4,0
37770,2,1,132177,132179,132180,2,3,0
37771,4,1,132181,132181,132182,0,1,1
37772,4,3,132185,132185,132188,0,3,3
37773,5,3,132190,132190,132193,0,3,2
37774,3,1,132193,132193,132194,0,1,0
37775,5,2,132198,132198,132200,0,2,4
37776,4,3,132202,132202,132205,0,3,2
37777,3,3,132205,132205,132208,0,3,0
37778,5,2,132210,132210,132212,0,2,2
37779,3,1,132213,132213,132214,0,1,1
37780,4,2,132217,132217,132219,0,2,3
37781,3,2,132220,132220,132222,0,2,1
37782,5,1,132225,132225,132226,0,1,3
37783,1,3,132226,132226,132229,0,3,0
37784,5,3,132231,132231,132234,0,3,2
37785,2,1,132233,132234,132235,1,2,0
37786,3,2,132236,132236,132238,0,2,1
37787,4,2,132240,132240,132242,0,2,2
37788,2,2,132242,132242,132244,0,2,0
37789,3,1,132245,132245,132246,0,1,1
37790,2,3,132247,132247,132250,0,3,1
37791,4,2,132251,132251,132253,0,2,1
37792,2,1,132253,132253,132254,0,1,0
37793,4,2,132257,132257,132259,0,2,3
37794,4,1,132261,132261,132262,0,1,2
37795,1,2,132262,132262,132264,0,2,0
37796,3,1,132265,132265,132266,0,1,1
37797,2,1,132267,132267,132268,0,1,1
37798,6,2,132273,132273,132275,0,2,5
37799,4,3,132277,132277,132280,0,3,2
37800,1,2,132278,132280,132282,2,4,0
37801,1,1,132279,132282,132283,3,4,0
37802,6,3,132285,132285,132288,0,3,2
37803,1,2,132286,132288,132290,2,4,0
37804,5,2,132291,132291,132293,0,2,1
37805,6,1,132297,132297,132298,0,1,4
37806,2,1,132299,132299,132300,0,1,1
37807,4,2,132303,132303,132305,0,2,3
37808,2,1,132305,132305,132306,0,1,0
37809,6,3,132311,132311,132314,0,3,5
37810,6,1,132317,132317,132318,0,1,3
37811,6,1,132323,132323,132324,0,1,5
37812,2,2,132325,132325,132327,0,2,1
37813,4,1,132329,132329,132330,0,1,2
37814,6,2,132335,132335,132337,0,2,5
37815,6,1,132341,132341,132342,0,1,4
37816,2,3,132343,132343,132346,0,3,1
37817,2,3,132345,132346,132349,1,4,0
37818,3,3,132348,132349,132352,1,4,0
37819,3,1,132351,132352,132353,1,2,0
37820,6,2,132357,132357,132359,0,2,4
37821,4,3,132361,132361,132364,0,3,2
37822,2,3,132363,132364,132367,1,4,0
37823,2,3,132365,132367,132370,2,5,0
37824,5,3,132370,132370,132373,0,3,0
37825,3,2,132373,132373,132375,0,2,0
37826,5,2,132378,132378,132380,0,2,3
37827,5,1,132383,132383,132384,0,1,3
37828,4,3,132387,132387,132390,0,3,3
37829,3,3,132390,132390,132393,0,3,0
37830,3,2,132393,132393,132395,0,2,0
37831,1,3,132394,132395,132398,1,4,0
37832,5,3,132399,132399,132402,0,3,1
37833,6,1,132405,132405,132406,0,1,3
37834,3,2,132408,132408,132410,0,2,2
37835,2,1,132410,132410,132411,0,1,0
37836,1,3,132411,132411,132414,0,3,0
37837,2,1,132413,132414,132415,1,2,0
37838,3,3,132416,132416,132419,0,3,1
37839,2,3,132418,132419,132422,1,4,0
37840,5,3,132423,132423,132426,0,3,1
37841,5,2,132428,132428,132430,0,2,2
37842,6,2,132434,132434,132436,0,2,4
37843,4,1,132438,132438,132439,0,1,2
37844,4,2,132442,132442,132444,0,2,3
37845,2,2,132444,132444,132446,0,2,0
37846,5,2,132449,132449,132451,0,2,3
37847,5,2,132454,132454,132456,0,2,3
37848,2,3,132456,132456,132459,0,3,0
37849,6,1,132462,132462,132463,0,1,3
37850,1,1,132463,132463,132464,0,1,0
37851,4,3,132467,132467,132470,0,3,3
37852,3,1,132470,132470,132471,0,1,0
37853,4,1,132474,132474,132475,0,1,3
37854,5,3,132479,132479,132482,0,3,4
37855,5,1,132484,132484,132485,0,1,2
37856,1,2,132485,132485,132487,0,2,0
37857,2,2,132487,132487,132489,0,2,0
37858,3,2,132490,132490,132492,0,2,1
37859,6,2,132496,132496,132498,0,2,4
37860,4,2,132500,132500,132502,0,2,2
37861,3,1,132503,132503,132504,0,1,1
37862,3,2,132506,132506,132508,0,2,2
37863,2,1,132508,132508,132509,0,1,0
37864,4,2,132512,132512,132514,0,2,3
37865,5,1,132517,132517,132518,0,1,3
37866,3,3,132520,132520,132523,0,3,2
37867,3,3,132523,132523,132526,0,3,0
37868,5,2,132528,132528,132530,0,2,2
37869,6,2,132534,132534,132536,0,2,4
37870,3,1,132537,132537,132538,0,1,1
37871,4,1,132541,132541,132542,0,1,3
37872,2,3,132543,132543,132546,0,3,1
37873,5,3,132548,132548,132551,0,3,2
37874,1,1,132549,132551,132552,2,3,0
37875,4,3,132553,132553,132556,0,3,1
37876,1,2,132554,132556,132558,2,4,0
37877,2,1,132556,132558,132559,2,3,0
37878,2,1,132558,132559,132560,1,2,0
37879,1,1,132559,132560,132561,1,2,0
37880,4,3,132563,132563,132566,0,3,2
37881,2,3,132565,132566,132569,1,4,0
37882,6,1,132571,132571,132572,0,1,2
37883,6,3,132577,132577,132580,0,3,5
37884,6,1,132583,132583,132584,0,1,3
37885,3,1,132586,132586,132587,0,1,2
37886,4,1,132590,132590,132591,0,1,3
37887,3,3,132593,132593,132596,0,3,2
37888,2,3,132595,132596,132599,1,4,0
37889,4,2,132599,132599,132601,0,2,0
37890,4,2,132603,132603,132605,0,2,2
37891,5,3,132608,132608,132611,0,3,3
37892,1,1,132609,132611,132612,2,3,0
37893,2,1,132611,132612,132613,1,2,0
37894,2,1,132613,132613,132614,0,1,0
37895,4,3,132617,132617,132620,0,3,3
37896,4,1,132621,132621,132622,0,1,1
37897,4,2,132625,132625,132627,0,2,3
37898,4,3,132629,132629,132632,0,3,2
37899,3,1,132632,132632,132633,0,1,0
37900,6,2,132638,132638,132640,0,2,5
37901,5,3,132643,132643,132646,0,3,3
37902,5,3,132648,132648,132651,0,3,2
37903,2,3,132650,132651,132654,1,4,0
37904,4,2,132654,132654,132656,0,2,0
37905,5,2,132659,132659,132661,0,2,3
37906,5,1,132664,132664,132665,0,1,3
37907,3,2,132667,132667,132669,0,2,2
37908,3,1,132670,132670,132671,0,1,1
37909,1,2,132671,132671,132673,0,2,0
37910,1,2,132672,132673,132675,1,3,0
37911,3,1,132675,132675,132676,0,1,0
37912,3,1,132678,132678,132679,0,1,2
37913,6,2,132684,132684,132686,0,2,5
37914,1,2,132685,132686,132688,1,3,0
37915,6,3,132691,132691,132694,0,3,3
37916,4,3,132695,132695,132698,0,3,1
37917,1,1,132696,132698,132699,2,3,0
37918,1,1,132697,132699,132700,2,3,0
37919,3,3,132700,132700,132703,0,3,0
37920,5,1,132705,132705,132706,0,1,2
37921,6,2,132711,132711,132713,0,2,5
37922,1,2,132712,132713,132715,1,3,0
37923,6,3,132718,132718,132721,0,3,3
37924,3,1,132721,132721,132722,0,1,0
37925,2,3,132723,132723,132726,0,3,1
37926,3,1,132726,132726,132727,0,1,0
37927,5,3,132731,132731,132734,0,3,4
37928,6,3,132737,132737,132740,0,3,3
37929,6,1,132743,132743,132744,0,1,3
37930,5,1,132748,132748,132749,0,1,4
37931,6,2,132754,132754,132756,0,2,5
37932,3,1,132757,132757,132758,0,1,1
37933,4,3,132761,132761,132764,0,3,3
37934,5,3,132766,132766,132769,0,3,2
37935,2,3,132768,132769,132772,1,4,0
37936,3,3,132771,132772,132775,1,4,0
37937,1,1,132772,132775,132776,3,4,0
37938,5,1,132777,132777,132778,0,1,1
37939,3,2,132780,132780,132782,0,2,2
37940,3,3,132783,132783,132786,0,3,1
37941,3,1,132786,132786,132787,0,1,0
37942,3,3,132789,132789,132792,0,3,2
37943,5,1,132794,132794,132795,0,1,2
37944,5,1,132799,132799,132800,0,1,4
37945,2,2,132801,132801,132803,0,2,1
37946,6,2,132807,132807,132809,0,2,4
37947,5,1,132812,132812,132813,0,1,3
37948,1,3,132813,132813,132816,0,3,0
37949,4,3,132817,132817,132820,0,3,1
37950,5,2,132822,132822,132824,0,2,2
37951,5,1,132827,132827,132828,0,1,3
37952,6,1,132833,132833,132834,0,1,5
37953,2,3,132835,132835,132838,0,3,1
37954,5,2,132840,132840,132842,0,2,2
37955,6,1,132846,132846,132847,0,1,4
37956,2,3,132848,132848,132851,0,3,1
37957,3,3,132851,132851,132854,0,3,0
37958,4,2,132855,132855,132857,0,2,1
37959,6,2,132861,132861,132863,0,2,4
37960,3,1,132864,132864,132865,0,1,1
37961,4,2,132868,132868,132870,0,2,3
37962,2,3,132870,132870,132873,0,3,0
37963,1,3,132871,132873,132876,2,5,0
37964,1,3,132872,132876,132879,4,7,0
37965,4,3,132876,132879,132882,3,6,0
37966,4,3,132880,132882,132885,2,5,0
37967,1,2,132881,132885,132887,4,6,0
37968,4,1,132885,132887,132888,2,3,0
37969,2,1,132887,132888,132889,1,2,0
37970,4,1,132891,132891,132892,0,1,2
37971,5,3,132896,132896,132899,0,3,4
37972,4,2,132900,132900,132902,0,2,1
37973,1,2,132901,132902,132904,1,3,0
37974,4,3,132905,132905,132908,0,3,1
37975,1,1,132906,132908,132909,2,3,0
37976,5,1,132911,132911,132912,0,1,2
37977,2,3,132913,132913,132916,0,3,1
37978,1,3,132914,132916,132919,2,5,0
37979,4,2,132918,132919,132921,1,3,0
37980,2,1,132920,132921,132922,1,2,0
37981,4,1,132924,132924,132925,0,1,2
37982,5,2,132929,132929,132931,0,2,4
37983,5,3,132934,132934,132937,0,3,3
37984,4,3,132938,132938,132941,0,3,1
37985,1,3,132939,132941,132944,2,5,0
37986,6,2,132945,132945,132947,0,2,1
37987,3,3,132948,132948,132951,0,3,1
37988,2,1,132950,132951,132952,1,2,0
37989,5,1,132955,132955,132956,0,1,3
37990,6,3,132961,132961,132964,0,3,5
37991,4,3,132965,132965,132968,0,3,1
37992,5,1,132970,132970,132971,0,1,2
37993,2,2,132972,132972,132974,0,2,1
37994,6,1,132978,132978,132979,0,1,4
37995,5,2,132983,132983,132985,0,2,4
37996,4,3,132987,132987,132990,0,3,2
37997,3,3,132990,132990,132993,0,3,0
37998,4,3,132994,132994,132997,0,3,1
37999,2,2,132996,132997,132999,1,3,0
38000,4,2,133000,133000,133002,0,2,1
38001,2,3,133002,133002,133005,0,3,0
38002,2,1,133004,133005,133006,1,2,0
38003,3,3,133007,133007,133010,0,3,1
38004,5,3,133012,133012,133015,0,3,2
38005,5,3,133017,133017,133020,0,3,2
38006,2,1,133019,133020,133021,1,2,0
38007,4,2,133023,133023,133025,0,2,2
38008,2,2,133025,133025,133027,0,2,0
38009,4,1,133029,133029,133030,0,1,2
38010,4,3,133033,133033,133036,0,3,3
38011,3,3,133036,133036,133039,0,3,0
38012,6,2,133042,133042,133044,0,2,3
38013,4,3,133046,133046,133049,0,3,2
38014,2,2,133048,133049,133051,1,3,0
38015,5,2,133053,133053,133055,0,2,2
38016,6,2,133059,133059,133061,0,2,4
38017,2,2,133061,133061,133063,0,2,0
38018,2,1,133063,133063,133064,0,1,0
38019,5,3,133068,133068,133071,0,3,4
38020,2,2,133070,133071,133073,1,3,0
38021,5,3,133075,133075,133078,0,3,2
38022,2,1,133077,133078,133079,1,2,0
38023,5,2,133082,133082,133084,0,2,3
38024,4,3,133086,133086,133089,0,3,2
38025,4,3,133090,133090,133093,0,3,1
38026,2,2,133092,133093,133095,1,3,0
38027,4,2,133096,133096,133098,0,2,1
38028,6,3,133102,133102,133105,0,3,4
38029,6,2,133108,133108,133110,0,2,3
38030,1,2,133109,133110,133112,1,3,0
38031,6,2,133115,133115,133117,0,2,3
38032,3,2,133118,133118,133120,0,2,1
38033,4,1,133122,133122,133123,0,1,2
38034,5,2,133127,133127,133129,0,2,4
38035,1,2,133128,133129,133131,1,3,0
38036,1,1,133129,133131,133132,2,3,0
38037,2,1,133131,133132,133133,1,2,0
38038,6,3,133137,133137,133140,0,3,4
38039,3,1,133140,133140,133141,0,1,0
38040,3,2,133143,133143,133145,0,2,2
38041,6,1,133149,133149,133150,0,1,4
38042,6,3,133155,133155,133158,0,3,5
38043,6,1,133161,133161,133162,0,1,3
38044,3,3,133164,133164,133167,0,3,2
38045,3,1,133167,133167,133168,0,1,0
38046,6,1,133173,133173,133174,0,1,5
38047,5,2,133178,133178,133180,0,2,4
38048,3,3,133181,133181,133184,0,3,1
38049,5,1,133186,133186,133187,0,1,2
38050,5,1,133191,133191,133192,0,1,4
38051,4,3,133195,133195,133198,0,3,3
38052,4,3,133199,133199,133202,0,3,1
38053,5,2,133204,133204,133206,0,2,2
38054,2,1,133206,133206,133207,0,1,0
38055,4,1,133210,133210,133211,0,1,3
38056,4,2,133214,133214,133216,0,2,3
38057,5,3,133219,133219,133222,0,3,3
38058,1,3,133220,133222,133225,2,5,0
38059,1,3,133221,133225,133228,4,7,0
38060,5,2,133226,133228,133230,2,4,0
38061,3,1,133229,133230,133231,1,2,0
38062,4,3,133233,133233,133236,0,3,2
38063,6,3,133239,133239,133242,0,3,3
38064,1,2,133240,133242,133244,2,4,0
38065,1,3,133241,133244,133247,3,6,0
38066,3,1,133244,133247,133248,3,4,0
38067,1,3,133245,133248,133251,3,6,0
38068,2,1,133247,133251,133252,4,5,0
38069,2,2,133249,133252,133254,3,5,0
38070,4,1,133253,133254,133255,1,2,0
38071,3,3,133256,133256,133259,0,3,1
38072,1,1,133257,133259,133260,2,3,0
38073,5,1,133262,133262,133263,0,1,2
38074,3,1,133265,133265,133266,0,1,2
38075,2,3,133267,133267,133270,0,3,1
38076,4,1,133271,133271,133272,0,1,1
38077,6,1,133277,133277,133278,0,1,5
38078,4,3,133281,133281,133284,0,3,3
38079,4,1,133285,133285,133286,0,1,1
38080,4,2,133289,133289,133291,0,2,3
38081,5,1,133294,133294,133295,0,1,3
38082,5,3,133299,133299,133302,0,3,4
38083,5,1,133304,133304,133305,0,1,2
38084,2,1,133306,133306,133307,0,1,1
38085,5,1,133311,133311,133312,0,1,4
38086,3,2,133314,133314,133316,0,2,2
38087,2,1,133316,133316,133317,0,1,0
38088,6,2,133322,133322,133324,0,2,5
38089,3,2,133325,133325,133327,0,2,1
38090,5,1,133330,133330,133331,0,1,3
38091,3,2,133333,133333,133335,0,2,2
38092,4,2,133337,133337,133339,0,2,2
38093,2,1,133339,133339,133340,0,1,0
38094,6,2,133345,133345,133347,0,2,5
38095,2,3,133347,133347,133350,0,3,0
38096,4,2,133351,133351,133353,0,2,1
38097,3,1,133354,133354,133355,0,1,1
38098,4,2,133358,133358,133360,0,2,3
38099,2,3,133360,133360,133363,0,3,0
38100,3,1,133363,133363,133364,0,1,0
38101,6,3,133369,133369,133372,0,3,5
38102,6,2,133375,133375,133377,0,2,3
38103,5,3,133380,133380,133383,0,3,3
38104,5,2,133385,133385,133387,0,2,2
38105,2,3,133387,133387,133390,0,3,0
38106,4,2,133391,133391,133393,0,2,1
38107,6,2,133397,133397,133399,0,2,4
38108,6,2,133403,133403,133405,0,2,4
38109,6,2,133409,133409,133411,0,2,4
38110,2,3,133411,133411,133414,0,3,0
38111,5,3,133416,133416,133419,0,3,2
38112,3,2,133419,133419,133421,0,2,0
38113,3,3,133422,133422,133425,0,3,1
38114,1,3,133423,133425,133428,2,5,0
38115,5,2,133428,133428,133430,0,2,0
38116,2,2,133430,133430,133432,0,2,0
38117,1,1,133431,133432,133433,1,2,0
38118,1,2,133432,133433,133435,1,3,0
38119,2,2,133434,133435,133437,1,3,0
38120,2,1,133436,133437,133438,1,2,0
38121,4,3,133440,133440,133443,0,3,2
38122,2,2,133442,133443,133445,1,3,0
38123,3,1,133445,133445,133446,0,1,0
38124,2,1,133447,133447,133448,0,1,1
38125,5,2,133452,133452,133454,0,2,4
38126,4,1,133456,133456,133457,0,1,2
38127,5,1,133461,133461,133462,0,1,4
38128,4,2,133465,133465,133467,0,2,3
38129,4,3,133469,133469,133472,0,3,2
38130,2,3,133471,133472,133475,1,4,0
38131,3,2,133474,133475,133477,1,3,0
38132,5,1,133479,133479,133480,0,1,2
38133,3,2,133482,133482,133484,0,2,2
38134,2,1,133484,133484,133485,0,1,0
38135,1,2,133485,133485,133487,0,2,0
38136,5,3,133490,133490,133493,0,3,3
38137,3,2,133493,133493,133495,0,2,0
38138,4,2,133497,133497,133499,0,2,2
38139,1,1,133498,133499,133500,1,2,0
38140,6,2,133504,133504,133506,0,2,4
38141,1,2,133505,133506,133508,1,3,0
38142,6,3,133511,133511,133514,0,3,3
38143,2,1,133513,133514,133515,1,2,0
38144,1,1,133514,133515,133516,1,2,0
38145,2,2,133516,133516,133518,0,2,0
38146,4,3,133520,133520,133523,0,3,2
38147,5,3,133525,133525,133528,0,3,2
38148,1,1,133526,133528,133529,2,3,0
38149,4,3,133530,133530,133533,0,3,1
38150,2,3,133532,133533,133536,1,4,0
38151,5,1,133537,133537,133538,0,1,1
38152,1,3,133538,133538,133541,0,3,0
38153,5,3,133543,133543,133546,0,3,2
38154,3,3,133546,133546,133549,0,3,0
38155,2,1,133548,133549,133550,1,2,0
38156,6,2,133554,133554,133556,0,2,4
38157,1,3,133555,133556,133559,1,4,0
38158,4,1,133559,133559,133560,0,1,0
38159,6,3,133565,133565,133568,0,3,5
38160,6,1,133571,133571,133572,0,1,3
38161,6,1,133577,133577,133578,0,1,5
38162,5,1,133582,133582,133583,0,1,4
38163,2,3,133584,133584,133587,0,3,1
38164,1,2,133585,133587,133589,2,4,0
38165,2,1,133587,133589,133590,2,3,0
38166,3,3,133590,133590,133593,0,3,0
38167,6,3,133596,133596,133599,0,3,3
38168,6,3,133602,133602,133605,0,3,3
38169,6,3,133608,133608,133611,0,3,3
38170,6,2,133614,133614,133616,0,2,3
38171,5,3,133619,133619,133622,0,3,3
38172,5,3,133624,133624,133627,0,3,2
38173,6,2,133630,133630,133632,0,2,3
38174,5,2,133635,133635,133637,0,2,3
38175,4,1,133639,133639,133640,0,1,2
38176,3,1,133642,133642,133643,0,1,2
38177,6,2,133648,133648,133650,0,2,5
38178,2,2,133650,133650,133652,0,2,0
38179,3,1,133653,133653,133654,0,1,1
38180,2,3,133655,133655,133658,0,3,1
38181,1,2,133656,133658,133660,2,4,0
38182,3,2,133659,133660,133662,1,3,0
38183,4,1,133663,133663,133664,0,1,1
38184,5,2,133668,133668,133670,0,2,4
38185,5,2,133673,133673,133675,0,2,3
38186,2,2,133675,133675,133677,0,2,0
38187,4,2,133679,133679,133681,0,2,2
38188,5,1,133684,133684,133685,0,1,3
38189,2,2,133686,133686,133688,0,2,1
38190,5,1,133691,133691,133692,0,1,3
38191,3,1,133694,133694,133695,0,1,2
38192,3,2,133697,133697,133699,0,2,2
38193,1,3,133698,133699,133702,1,4,0
38194,4,2,133702,133702,133704,0,2,0
38195,1,3,133703,133704,133707,1,4,0
38196,3,2,133706,133707,133709,1,3,0
38197,1,3,133707,133709,133712,2,5,0
38198,3,3,133710,133712,133715,2,5,0
38199,4,3,133714,133715,133718,1,4,0
38200,2,3,133716,133718,133721,2,5,0
38201,2,3,133718,133721,133724,3,6,0
38202,2,3,133720,133724,133727,4,7,0
38203,3,1,133723,133727,133728,4,5,0
38204,1,2,133724,133728,133730,4,6,0
38205,3,1,133727,133730,133731,3,4,0
38206,6,2,133733,133733,133735,0,2,2
38207,3,2,133736,133736,133738,0,2,1
38208,3,2,133739,133739,133741,0,2,1
38209,2,1,133741,133741,133742,0,1,0
38210,3,3,133744,133744,133747,0,3,2
38211,3,1,133747,133747,133748,0,1,0
38212,1,1,133748,133748,133749,0,1,0
38213,4,2,133752,133752,133754,0,2,3
38214,6,3,133758,133758,133761,0,3,4
38215,6,2,133764,133764,133766,0,2,3
38216,4,2,133768,133768,133770,0,2,2
38217,5,3,133773,133773,133776,0,3,3
38218,3,1,133776,133776,133777,0,1,0
38219,6,1,133782,133782,133783,0,1,5
38220,1,1,133783,133783,133784,0,1,0
38221,3,2,133786,133786,133788,0,2,2
38222,4,1,133790,133790,133791,0,1,2
38223,2,3,133792,133792,133795,0,3,1
38224,2,1,133794,133795,133796,1,2,0
38225,5,3,133799,133799,133802,0,3,3
38226,4,2,133803,133803,133805,0,2,1
38227,6,2,133809,133809,133811,0,2,4
38228,6,3,133815,133815,133818,0,3,4
38229,5,2,133820,133820,133822,0,2,2
38230,5,3,133825,133825,133828,0,3,3
38231,6,1,133831,133831,133832,0,1,3
38232,1,1,133832,133832,133833,0,1,0
38233,6,2,133838,133838,133840,0,2,5
38234,5,2,133843,133843,133845,0,2,3
38235,5,1,133848,133848,133849,0,1,3
38236,6,3,133854,133854,133857,0,3,5
38237,2,3,133856,133857,133860,1,4,0
38238,5,2,133861,133861,133863,0,2,1
38239,3,1,133864,133864,133865,0,1,1
38240,6,1,133870,133870,133871,0,1,5
38241,2,2,133872,133872,133874,0,2,1
38242,2,3,133874,133874,133877,0,3,0
38243,3,2,133877,133877,133879,0,2,0
38244,2,2,133879,133879,133881,0,2,0
38245,3,3,133882,133882,133885,0,3,1
38246,4,1,133886,133886,133887,0,1,1
38247,5,2,133891,133891,133893,0,2,4
38248,3,2,133894,133894,133896,0,2,1
38249,1,1,133895,133896,133897,1,2,0
38250,3,2,133898,133898,133900,0,2,1
38251,2,1,133900,133900,133901,0,1,0
38252,6,1,133906,133906,133907,0,1,5
38253,3,3,133909,133909,133912,0,3,2
38254,3,2,133912,133912,133914,0,2,0
38255,1,2,133913,133914,133916,1,3,0
38256,6,1,133919,133919,133920,0,1,3
38257,2,2,133921,133921,133923,0,2,1
38258,4,1,133925,133925,133926,0,1,2
38259,6,1,133931,133931,133932,0,1,5
38260,4,1,133935,133935,133936,0,1,3
38261,3,3,133938,133938,133941,0,3,2
38262,4,1,133942,133942,133943,0,1,1
38263,6,2,133948,133948,133950,0,2,5
38264,5,1,133953,133953,133954,0,1,3
38265,5,1,133958,133958,133959,0,1,4
38266,3,3,133961,133961,133964,0,3,2
38267,5,3,133966,133966,133969,0,3,2
38268,3,3,133969,133969,133972,0,3,0
38269,4,2,133973,133973,133975,0,2,1
38270,5,2,133978,133978,133980,0,2,3
38271,3,1,133981,133981,133982,0,1,1
38272,4,1,133985,133985,133986,0,1,3
38273,1,3,133986,133986,133989,0,3,0
38274,1,1,133987,133989,133990,2,3,0
38275,6,3,133993,133993,133996,0,3,3
38276,5,2,133998,133998,134000,0,2,2
38277,6,3,134004,134004,134007,0,3,4
38278,5,2,134009,134009,134011,0,2,2
38279,1,1,134010,134011,134012,1,2,0
38280,1,1,134011,134012,134013,1,2,0
38281,5,3,134016,134016,134019,0,3,3
38282,5,2,134021,134021,134023,0,2,2
38283,4,3,134025,134025,134028,0,3,2
38284,2,3,134027,134028,134031,1,4,0
38285,5,3,134032,134032,134035,0,3,1
38286,2,3,134034,134035,134038,1,4,0
38287,2,1,134036,134038,134039,2,3,0
38288,3,1,134039,134039,134040,0,1,0
38289,1,2,134040,134040,134042,0,2,0
38290,2,3,134042,134042,134045,0,3,0
38291,4,1,134046,134046,134047,0,1,1
38292,2,3,134048,134048,134051,0,3,1
38293,1,3,134049,134051,134054,2,5,0
38294,1,2,134050,134054,134056,4,6,0
38295,4,3,134054,134056,134059,2,5,0
38296,1,2,134055,134059,134061,4,6,0
38297,1,1,134056,134061,134062,5,6,0
38298,5,1,134061,134062,134063,1,2,0
38299,6,3,134067,134067,134070,0,3,4
38300,6,2,134073,134073,134075,0,2,3
38301,5,1,134078,134078,134079,0,1,3
38302,3,2,134081,134081,134083,0,2,2
38303,2,3,134083,134083,134086,0,3,0
38304,3,2,134086,134086,134088,0,2,0
38305,6,2,134092,134092,134094,0,2,4
38306,2,2,134094,134094,134096,0,2,0
38307,3,1,134097,134097,134098,0,1,1
38308,3,2,134100,134100,134102,0,2,2
38309,1,2,134101,134102,134104,1,3,0
38310,6,3,134107,134107,134110,0,3,3
38311,1,1,134108,134110,134111,2,3,0
38312,6,2,134114,134114,134116,0,2,3
38313,4,1,134118,134118,134119,0,1,2
38314,2,1,134120,134120,134121,0,1,1
38315,1,3,134121,134121,134124,0,3,0
38316,6,3,134127,134127,134130,0,3,3
38317,5,1,134132,134132,134133,0,1,2
38318,3,1,134135,134135,134136,0,1,2
38319,4,1,134139,134139,134140,0,1,3
38320,3,1,134142,134142,134143,0,1,2
38321,3,2,134145,134145,134147,0,2,2
38322,3,2,134148,134148,134150,0,2,1
38323,5,3,134153,134153,134156,0,3,3
38324,4,2,134157,134157,134159,0,2,1
38325,1,2,134158,134159,134161,1,3,0
38326,5,3,134163,134163,134166,0,3,2
38327,6,3,134169,134169,134172,0,3,3
38328,6,2,134175,134175,134177,0,2,3
38329,5,3,134180,134180,134183,0,3,3
38330,6,1,134186,134186,134187,0,1,3
38331,3,1,134189,134189,134190,0,1,2
38332,4,2,134193,134193,134195,0,2,3
38333,5,3,134198,134198,134201,0,3,3
38334,6,3,134204,134204,134207,0,3,3
38335,4,2,134208,134208,134210,0,2,1
38336,4,1,134212,134212,134213,0,1,2
38337,4,3,134216,134216,134219,0,3,3
38338,1,3,134217,134219,134222,2,5,0
38339,1,2,134218,134222,134224,4,6,0
38340,1,1,134219,134224,134225,5,6,0
38341,2,3,134221,134225,134228,4,7,0
38342,5,2,134226,134228,134230,2,4,0
38343,5,2,134231,134231,134233,0,2,1
38344,2,3,134233,134233,134236,0,3,0
38345,2,3,134235,134236,134239,1,4,0
38346,3,1,134238,134239,134240,1,2,0
38347,5,2,134243,134243,134245,0,2,3
38348,1,3,134244,134245,134248,1,4,0
38349,2,2,134246,134248,134250,2,4,0
38350,4,2,134250,134250,134252,0,2,0
38351,6,3,134256,134256,134259,0,3,4
38352,4,1,134260,134260,134261,0,1,1
38353,1,2,134261,134261,134263,0,2,0
38354,3,2,134264,134264,134266,0,2,1
38355,6,3,134270,134270,134273,0,3,4
38356,4,3,134274,134274,134277,0,3,1
38357,2,3,134276,134277,134280,1,4,0
38358,5,3,134281,134281,134284,0,3,1
38359,5,2,134286,134286,134288,0,2,2
38360,6,1,134292,134292,134293,0,1,4
38361,6,1,134298,134298,134299,0,1,5
38362,1,2,134299,134299,134301,0,2,0
38363,5,1,134304,134304,134305,0,1,3
38364,1,3,134305,134305,134308,0,3,0
38365,5,2,134310,134310,134312,0,2,2
38366,2,3,134312,134312,134315,0,3,0
38367,1,1,134313,134315,134316,2,3,0
38368,4,2,134317,134317,134319,0,2,1
38369,5,1,134322,134322,134323,0,1,3
38370,2,3,134324,134324,134327,0,3,1
38371,3,3,134327,134327,134330,0,3,0
38372,6,2,134333,134333,134335,0,2,3
38373,4,2,134337,134337,134339,0,2,2
38374,6,3,134343,134343,134346,0,3,4
38375,6,2,134349,134349,134351,0,2,3
38376,1,3,134350,134351,134354,1,4,0
38377,2,3,134352,134354,134357,2,5,0
38378,6,1,134358,134358,134359,0,1,1
38379,6,1,134364,134364,134365,0,1,5
38380,4,1,134368,134368,134369,0,1,3
38381,2,1,134370,134370,134371,0,1,1
38382,1,1,134371,134371,134372,0,1,0
38383,2,2,134373,134373,134375,0,2,1
38384,3,1,134376,134376,134377,0,1,1
38385,4,3,134380,134380,134383,0,3,3
38386,1,1,134381,134383,134384,2,3,0
38387,2,2,134383,134384,134386,1,3,0
38388,1,1,134384,134386,134387,2,3,0
38389,6,2,134390,134390,134392,0,2,3
38390,2,3,134392,134392,134395,0,3,0
38391,2,3,134394,134395,134398,1,4,0
38392,6,3,134400,134400,134403,0,3,2
38393,4,1,134404,134404,134405,0,1,1
38394,5,2,134409,134409,134411,0,2,4
38395,6,2,134415,134415,134417,0,2,4
38396,2,2,134417,134417,134419,0,2,0
38397,3,2,134420,134420,134422,0,2,1
38398,4,1,134424,134424,134425,0,1,2
38399,1,1,134425,134425,134426,0,1,0
38400,4,2,134429,134429,134431,0,2,3
38401,6,1,134435,134435,134436,0,1,4
38402,2,1,134437,134437,134438,0,1,1
38403,4,2,134441,134441,134443,0,2,3
38404,6,1,134447,134447,134448,0,1,4
38405,4,1,134451,134451,134452,0,1,3
38406,4,2,134455,134455,134457,0,2,3
38407,2,1,134457,134457,134458,0,1,0
38408,6,2,134463,134463,134465,0,2,5
38409,4,1,134467,134467,134468,0,1,2
38410,3,3,134470,134470,134473,0,3,2
38411,1,1,134471,134473,134474,2,3,0
38412,1,1,134472,134474,134475,2,3,0
38413,4,2,134476,134476,134478,0,2,1
38414,5,1,134481,134481,134482,0,1,3
38415,1,2,134482,134482,134484,0,2,0
38416,3,3,134485,134485,134488,0,3,1
38417,6,2,134491,134491,134493,0,2,3
38418,4,1,134495,134495,134496,0,1,2
38419,4,1,134499,134499,134500,0,1,3
38420,1,1,134500,134500,134501,0,1,0
38421,1,3,134501,134501,134504,0,3,0
38422,6,2,134507,134507,134509,0,2,3
38423,6,3,134513,134513,134516,0,3,4
38424,6,2,134519,134519,134521,0,2,3
38425,4,2,134523,134523,134525,0,2,2
38426,5,1,134528,134528,134529,0,1,3
38427,4,3,134532,134532,134535,0,3,3
38428,5,2,134537,134537,134539,0,2,2
38429,6,2,134543,134543,134545,0,2,4
38430,4,2,134547,134547,134549,0,2,2
38431,3,1,134550,134550,134551,0,1,1
38432,4,1,134554,134554,134555,0,1,3
38433,1,2,134555,134555,134557,0,2,0
38434,3,3,134558,134558,134561,0,3,1
38435,6,3,134564,134564,134567,0,3,3
38436,6,1,134570,134570,134571,0,1,3
38437,4,1,134574,134574,134575,0,1,3
38438,4,2,134578,134578,134580,0,2,3
38439,2,2,134580,134580,134582,0,2,0
38440,4,3,134584,134584,134587,0,3,2
38441,1,3,134585,134587,134590,2,5,0
38442,2,3,134587,134590,134593,3,6,0
38443,4,3,134591,134593,134596,2,5,0
38444,1,2,134592,134596,134598,4,6,0
38445,2,1,134594,134598,134599,4,5,0
38446,4,1,134598,134599,134600,1,2,0
38447,5,1,134603,134603,134604,0,1,3
38448,5,1,134608,134608,134609,0,1,4
38449,4,2,134612,134612,134614,0,2,3
38450,1,1,134613,134614,134615,1,2,0
38451,3,1,134616,134616,134617,0,1,1
38452,2,1,134618,134618,134619,0,1,1
38453,3,3,134621,134621,134624,0,3,2
38454,4,2,134625,134625,134627,0,2,1
38455,3,1,134628,134628,134629,0,1,1
38456,5,1,134633,134633,134634,0,1,4
38457,3,1,134636,134636,134637,0,1,2
38458,4,3,134640,134640,134643,0,3,3
38459,3,3,134643,134643,134646,0,3,0
38460,5,3,134648,134648,134651,0,3,2
38461,1,2,134649,134651,134653,2,4,0
38462,1,2,134650,134653,134655,3,5,0
38463,5,1,134655,134655,134656,0,1,0
38464,2,3,134657,134657,134660,0,3,1
38465,5,2,134662,134662,134664,0,2,2
38466,5,2,134667,134667,134669,0,2,3
38467,2,2,134669,134669,134671,0,2,0
38468,2,3,134671,134671,134674,0,3,0
38469,2,2,134673,134674,134676,1,3,0
38470,5,2,134678,134678,134680,0,2,2
38471,4,3,134682,134682,134685,0,3,2
38472,5,2,134687,134687,134689,0,2,2
38473,6,1,134693,134693,134694,0,1,4
38474,1,1,134694,134694,134695,0,1,0
38475,6,1,134700,134700,134701,0,1,5
38476,6,2,134706,134706,134708,0,2,5
38477,1,2,134707,134708,134710,1,3,0
38478,2,3,134709,134710,134713,1,4,0
38479,2,3,134711,134713,134716,2,5,0
38480,6,1,134717,134717,134718,0,1,1
38481,3,3,134720,134720,134723,0,3,2
38482,2,1,134722,134723,134724,1,2,0
38483,1,1,134723,134724,134725,1,2,0
38484,1,2,134724,134725,134727,1,3,0
38485,5,2,134729,134729,134731,0,2,2
38486,6,3,134735,134735,134738,0,3,4
38487,4,3,134739,134739,134742,0,3,1
38488,1,3,134740,134742,134745,2,5,0
38489,4,2,134744,134745,134747,1,3,0
38490,2,1,134746,134747,134748,1,2,0
38491,2,3,134748,134748,134751,0,3,0
38492,6,1,134754,134754,134755,0,1,3
38493,2,1,134756,134756,134757,0,1,1
38494,1,2,134757,134757,134759,0,2,0
38495,5,3,134762,134762,134765,0,3,3
38496,5,3,134767,134767,134770,0,3,2
38497,5,1,134772,134772,134773,0,1,2
38498,6,1,134778,134778,134779,0,1,5
38499,1,3,134779,134779,134782,0,3,0
38500,1,1,134780,134782,134783,2,3,0
38501,1,3,134781,134783,134786,2,5,0
38502,6,2,134787,134787,134789,0,2,1
38503,5,1,134792,134792,134793,0,1,3
38504,1,3,134793,134793,134796,0,3,0
38505,3,1,134796,134796,134797,0,1,0
38506,4,2,134800,134800,134802,0,2,3
38507,3,3,134803,134803,134806,0,3,1
38508,6,3,134809,134809,134812,0,3,3
38509,2,2,134811,134812,134814,1,3,0
38510,5,3,134816,134816,134819,0,3,2
38511,3,2,134819,134819,134821,0,2,0
38512,5,3,134824,134824,134827,0,3,3
38513,3,2,134827,134827,134829,0,2,0
38514,4,1,134831,134831,134832,0,1,2
38515,4,1,134835,134835,134836,0,1,3
38516,3,1,134838,134838,134839,0,1,2
38517,1,3,134839,134839,134842,0,3,0
38518,3,3,134842,134842,134845,0,3,0
38519,4,1,134846,134846,134847,0,1,1
38520,2,1,134848,134848,134849,0,1,1
38521,3,1,134851,134851,134852,0,1,2
38522,4,3,134855,134855,134858,0,3,3
38523,2,2,134857,134858,134860,1,3,0
38524,3,1,134860,134860,134861,0,1,0
38525,2,2,134862,134862,134864,0,2,1
38526,4,3,134866,134866,134869,0,3,2
38527,6,1,134872,134872,134873,0,1,3
38528,6,3,134878,134878,134881,0,3,5
38529,6,2,134884,134884,134886,0,2,3
38530,5,1,134889,134889,134890,0,1,3
38531,4,1,134893,134893,134894,0,1,3
38532,1,2,134894,134894,134896,0,2,0
38533,2,3,134896,134896,134899,0,3,0
38534,1,2,134897,134899,134901,2,4,0
38535,5,1,134902,134902,134903,0,1,1
38536,5,3,134907,134907,134910,0,3,4
38537,4,2,134911,134911,134913,0,2,1
38538,1,2,134912,134913,134915,1,3,0
38539,2,1,134914,134915,134916,1,2,0
38540,2,2,134916,134916,134918,0,2,0
38541,5,1,134921,134921,134922,0,1,3
38542,3,2,134924,134924,134926,0,2,2
38543,2,2,134926,134926,134928,0,2,0
38544,5,2,134931,134931,134933,0,2,3
38545,6,3,134937,134937,134940,0,3,4
38546,2,3,134939,134940,134943,1,4,0
38547,6,2,134945,134945,134947,0,2,2
38548,5,2,134950,134950,134952,0,2,3
38549,2,3,134952,134952,134955,0,3,0
38550,3,3,134955,134955,134958,0,3,0
38551,6,3,134961,134961,134964,0,3,3
38552,6,3,134967,134967,134970,0,3,3
38553,1,2,134968,134970,134972,2,4,0
38554,5,2,134973,134973,134975,0,2,1
38555,1,2,134974,134975,134977,1,3,0
38556,1,1,134975,134977,134978,2,3,0
38557,5,2,134980,134980,134982,0,2,2
38558,1,1,134981,134982,134983,1,2,0
38559,2,1,134983,134983,134984,0,1,0
38560,5,2,134988,134988,134990,0,2,4
38561,6,2,134994,134994,134996,0,2,4
38562,6,1,135000,135000,135001,0,1,4
38563,2,2,135002,135002,135004,0,2,1
38564,6,1,135008,135008,135009,0,1,4
38565,1,2,135009,135009,135011,0,2,0
38566,5,3,135014,135014,135017,0,3,3
38567,2,3,135016,135017,135020,1,4,0
38568,2,2,135018,135020,135022,2,4,0
38569,2,3,135020,135022,135025,2,5,0
38570,4,2,135024,135025,135027,1,3,0
38571,4,3,135028,135028,135031,0,3,1
38572,1,3,135029,135031,135034,2,5,0
38573,3,2,135032,135034,135036,2,4,0
38574,6,1,135038,135038,135039,0,1,2
38575,6,1,135044,135044,135045,0,1,5
38576,4,2,135048,135048,135050,0,2,3
38577,1,2,135049,135050,135052,1,3,0
38578,3,3,135052,135052,135055,0,3,0
38579,1,1,135053,135055,135056,2,3,0
38580,4,1,135057,135057,135058,0,1,1
38581,3,3,135060,135060,135063,0,3,2
38582,3,3,135063,135063,135066,0,3,0
38583,3,1,135066,135066,135067,0,1,0
38584,5,3,135071,135071,135074,0,3,4
38585,4,1,135075,135075,135076,0,1,1
38586,6,3,135081,135081,135084,0,3,5
38587,1,2,135082,135084,135086,2,4,0
38588,3,2,135085,135086,135088,1,3,0
38589,3,2,135088,135088,135090,0,2,0
38590,4,2,135092,135092,135094,0,2,2
38591,6,1,135098,135098,135099,0,1,4
38592,1,3,135099,135099,135102,0,3,0
38593,6,1,135105,135105,135106,0,1,3
38594,1,3,135106,135106,135109,0,3,0
38595,1,1,135107,135109,135110,2,3,0
38596,5,1,135112,135112,135113,0,1,2
38597,5,2,135117,135117,135119,0,2,4
38598,5,3,135122,135122,135125,0,3,3
38599,6,2,135128,135128,135130,0,2,3
38600,2,2,135130,135130,135132,0,2,0
38601,1,2,135131,135132,135134,1,3,0
38602,5,1,135136,135136,135137,0,1,2
38603,1,1,135137,135137,135138,0,1,0
38604,6,1,135143,135143,135144,0,1,5
38605,3,1,135146,135146,135147,0,1,2
38606,2,3,135148,135148,135151,0,3,1
38607,5,1,135153,135153,135154,0,1,2
38608,5,2,135158,135158,135160,0,2,4
38609,5,2,135163,135163,135165,0,2,3
38610,4,1,135167,135167,135168,0,1,2
38611,3,3,135170,135170,135173,0,3,2
38612,2,1,135172,135173,135174,1,2,0
38613,6,3,135178,135178,135181,0,3,4
38614,3,3,135181,135181,135184,0,3,0
38615,5,2,135186,135186,135188,0,2,2
38616,5,2,135191,135191,135193,0,2,3
38617,6,3,135197,135197,135200,0,3,4
38618,1,1,135198,135200,135201,2,3,0
38619,1,2,135199,135201,135203,2,4,0
38620,4,2,135203,135203,135205,0,2,0
38621,6,1,135209,135209,135210,0,1,4
38622,3,1,135212,135212,135213,0,1,2
38623,6,3,135218,135218,135221,0,3,5
38624,1,2,135219,135221,135223,2,4,0
38625,2,2,135221,135223,135225,2,4,0
38626,4,3,135225,135225,135228,0,3,0
38627,2,3,135227,135228,135231,1,4,0
38628,5,1,135232,135232,135233,0,1,1
38629,1,2,135233,135233,135235,0,2,0
38630,6,1,135239,135239,135240,0,1,4
38631,4,2,135243,135243,135245,0,2,3
38632,5,2,135248,135248,135250,0,2,3
38633,2,2,135250,135250,135252,0,2,0
38634,3,3,135253,135253,135256,0,3,1
38635,6,3,135259,135259,135262,0,3,3
38636,3,3,135262,135262,135265,0,3,0
38637,2,1,135264,135265,135266,1,2,0
38638,6,1,135270,135270,135271,0,1,4
38639,1,1,135271,135271,135272,0,1,0
38640,4,2,135275,135275,135277,0,2,3
38641,4,1,135279,135279,135280,0,1,2
38642,6,3,135285,135285,135288,0,3,5
38643,3,2,135288,135288,135290,0,2,0
38644,1,2,135289,135290,135292,1,3,0
38645,5,1,135294,135294,135295,0,1,2
38646,1,3,135295,135295,135298,0,3,0
38647,5,2,135300,135300,135302,0,2,2
38648,6,2,135306,135306,135308,0,2,4
38649,4,3,135310,135310,135313,0,3,2
38650,5,1,135315,135315,135316,0,1,2
38651,4,3,135319,135319,135322,0,3,3
38652,3,1,135322,135322,135323,0,1,0
38653,5,1,135327,135327,135328,0,1,4
38654,3,1,135330,135330,135331,0,1,2
38655,1,1,135331,135331,135332,0,1,0
38656,6,3,135337,135337,135340,0,3,5
38657,3,2,135340,135340,135342,0,2,0
38658,3,1,135343,135343,135344,0,1,1
38659,2,3,135345,135345,135348,0,3,1
38660,5,1,135350,135350,135351,0,1,2
38661,4,3,135354,135354,135357,0,3,3
38662,2,3,135356,135357,135360,1,4,0
38663,3,1,135359,135360,135361,1,2,0
38664,5,3,135364,135364,135367,0,3,3
38665,4,2,135368,135368,135370,0,2,1
38666,1,1,135369,135370,135371,1,2,0
38667,1,3,135370,135371,135374,1,4,0
38668,3,2,135373,135374,135376,1,3,0
38669,5,3,135378,135378,135381,0,3,2
38670,6,1,135384,135384,135385,0,1,3
38671,6,3,135390,135390,135393,0,3,5
38672,1,2,135391,135393,135395,2,4,0
38673,3,2,135394,135395,135397,1,3,0
38674,6,3,135400,135400,135403,0,3,3
38675,6,3,135406,135406,135409,0,3,3
38676,3,3,135409,135409,135412,0,3,0
38677,3,1,135412,135412,135413,0,1,0
38678,2,1,135414,135414,135415,0,1,1
38679,2,3,135416,135416,135419,0,3,1
38680,4,3,135420,135420,135423,0,3,1
38681,5,1,135425,135425,135426,0,1,2
38682,2,2,135427,135427,135429,0,2,1
38683,2,1,135429,135429,135430,0,1,0
38684,6,2,135435,135435,135437,0,2,5
38685,4,1,135439,135439,135440,0,1,2
38686,5,2,135444,135444,135446,0,2,4
38687,4,2,135448,135448,135450,0,2,2
38688,3,2,135451,135451,135453,0,2,1
38689,2,3,135453,135453,135456,0,3,0
38690,2,1,135455,135456,135457,1,2,0
38691,6,3,135461,135461,135464,0,3,4
38692,1,1,135462,135464,135465,2,3,0
38693,6,1,135468,135468,135469,0,1,3
38694,6,1,135474,135474,135475,0,1,5
38695,2,2,135476,135476,135478,0,2,1
38696,5,3,135481,135481,135484,0,3,3
38697,6,3,135487,135487,135490,0,3,3
38698,5,3,135492,135492,135495,0,3,2
38699,2,1,135494,135495,135496,1,2,0
38700,3,1,135497,135497,135498,0,1,1
38701,6,1,135503,135503,135504,0,1,5
38702,4,3,135507,135507,135510,0,3,3
38703,5,3,135512,135512,135515,0,3,2
38704,5,1,135517,135517,135518,0,1,2
38705,2,2,135519,135519,135521,0,2,1
38706,5,1,135524,135524,135525,0,1,3
38707,1,1,135525,135525,135526,0,1,0
38708,2,3,135527,135527,135530,0,3,1
38709,6,1,135533,135533,135534,0,1,3
38710,4,1,135537,135537,135538,0,1,3
38711,6,2,135543,135543,135545,0,2,5
38712,3,1,135546,135546,135547,0,1,1
38713,1,2,135547,135547,135549,0,2,0
38714,2,1,135549,135549,135550,0,1,0
38715,1,1,135550,135550,135551,0,1,0
38716,2,3,135552,135552,135555,0,3,1
38717,2,3,135554,135555,135558,1,4,0
38718,4,3,135558,135558,135561,0,3,0
38719,1,2,135559,135561,135563,2,4,0
38720,1,2,135560,135563,135565,3,5,0
38721,6,1,135566,135566,135567,0,1,1
38722,4,2,135570,135570,135572,0,2,3
38723,6,3,135576,135576,135579,0,3,4
38724,1,1,135577,135579,135580,2,3,0
38725,3,2,135580,135580,135582,0,2,0
38726,6,3,135586,135586,135589,0,3,4
38727,5,3,135591,135591,135594,0,3,2
38728,1,3,135592,135594,135597,2,5,0
38729,2,2,135594,135597,135599,3,5,0
38730,1,1,135595,135599,135600,4,5,0
38731,1,2,135596,135600,135602,4,6,0
38732,2,3,135598,135602,135605,4,7,0
38733,5,1,135603,135605,135606,2,3,0
38734,1,3,135604,135606,135609,2,5,0
38735,6,2,135610,135610,135612,0,2,1
38736,4,2,135614,135614,135616,0,2,2
38737,1,2,135615,135616,135618,1,3,0
38738,3,3,135618,135618,135621,0,3,0
38739,6,1,135624,135624,135625,0,1,3
38740,4,2,135628,135628,135630,0,2,3
38741,6,1,135634,135634,135635,0,1,4
38742,3,2,135637,135637,135639,0,2,2
38743,5,3,135642,135642,135645,0,3,3
38744,5,1,135647,135647,135648,0,1,2
38745,4,1,135651,135651,135652,0,1,3
38746,5,1,135656,135656,135657,0,1,4
38747,4,3,135660,135660,135663,0,3,3
38748,2,1,135662,135663,135664,1,2,0
38749,4,1,135666,135666,135667,0,1,2
38750,4,1,135670,135670,135671,0,1,3
38751,4,1,135674,135674,135675,0,1,3
38752,1,2,135675,135675,135677,0,2,0
38753,6,3,135681,135681,135684,0,3,4
38754,3,2,135684,135684,135686,0,2,0
38755,1,2,135685,135686,135688,1,3,0
38756,3,3,135688,135688,135691,0,3,0
38757,5,1,135693,135693,135694,0,1,2
38758,5,1,135698,135698,135699,0,1,4
38759,1,3,135699,135699,135702,0,3,0
38760,5,3,135704,135704,135707,0,3,2
38761,2,2,135706,135707,135709,1,3,0
38762,5,2,135711,135711,135713,0,2,2
38763,5,3,135716,135716,135719,0,3,3
38764,4,1,135720,135720,135721,0,1,1
38765,5,1,135725,135725,135726,0,1,4
38766,5,1,135730,135730,135731,0,1,4
38767,3,3,135733,135733,135736,0,3,2
38768,4,3,135737,135737,135740,0,3,1
38769,5,3,135742,135742,135745,0,3,2
38770,1,2,135743,135745,135747,2,4,0
38771,3,3,135746,135747,135750,1,4,0
38772,2,1,135748,135750,135751,2,3,0
38773,1,1,135749,135751,135752,2,3,0
38774,3,3,135752,135752,135755,0,3,0
38775,6,2,135758,135758,135760,0,2,3
38776,5,1,135763,135763,135764,0,1,3
38777,4,2,135767,135767,135769,0,2,3
38778,5,3,135772,135772,135775,0,3,3
38779,2,2,135774,135775,135777,1,3,0
38780,6,2,135780,135780,135782,0,2,3
38781,6,1,135786,135786,135787,0,1,4
38782,4,1,135790,135790,135791,0,1,3
38783,4,1,135794,135794,135795,0,1,3
38784,6,3,135800,135800,135803,0,3,5
38785,5,3,135805,135805,135808,0,3,2
38786,5,1,135810,135810,135811,0,1,2
38787,1,2,135811,135811,135813,0,2,0
38788,2,3,135813,135813,135816,0,3,0
38789,2,2,135815,135816,135818,1,3,0
38790,4,3,135819,135819,135822,0,3,1
38791,3,3,135822,135822,135825,0,3,0
38792,6,3,135828,135828,135831,0,3,3
38793,5,1,135833,135833,135834,0,1,2
38794,4,1,135837,135837,135838,0,1,3
38795,1,2,135838,135838,135840,0,2,0
38796,5,1,135843,135843,135844,0,1,3
38797,2,3,135845,135845,135848,0,3,1
38798,3,2,135848,135848,135850,0,2,0
38799,5,2,135853,135853,135855,0,2,3
38800,1,1,135854,135855,135856,1,2,0
38801,3,1,135857,135857,135858,0,1,1
38802,4,1,135861,135861,135862,0,1,3
38803,5,1,135866,135866,135867,0,1,4
38804,5,2,135871,135871,135873,0,2,4
38805,3,1,135874,135874,135875,0,1,1
38806,3,3,135877,135877,135880,0,3,2
38807,1,1,135878,135880,135881,2,3,0
38808,3,2,135881,135881,135883,0,2,0
38809,3,1,135884,135884,135885,0,1,1
38810,1,1,135885,135885,135886,0,1,0
38811,5,2,135890,135890,135892,0,2,4
38812,4,3,135894,135894,135897,0,3,2
38813,2,2,135896,135897,135899,1,3,0
38814,5,3,135901,135901,135904,0,3,2
38815,1,3,135902,135904,135907,2,5,0
38816,6,2,135908,135908,135910,0,2,1
38817,2,1,135910,135910,135911,0,1,0
38818,6,1,135916,135916,135917,0,1,5
38819,2,1,135918,135918,135919,0,1,1
38820,4,1,135922,135922,135923,0,1,3
38821,1,3,135923,135923,135926,0,3,0
38822,2,3,135925,135926,135929,1,4,0
38823,3,1,135928,135929,135930,1,2,0
38824,3,3,135931,135931,135934,0,3,1
38825,2,1,135933,135934,135935,1,2,0
38826,6,3,135939,135939,135942,0,3,4
38827,6,1,135945,135945,135946,0,1,3
38828,6,1,135951,135951,135952,0,1,5
38829,1,3,135952,135952,135955,0,3,0
38830,5,3,135957,135957,135960,0,3,2
38831,2,1,135959,135960,135961,1,2,0
38832,1,3,135960,135961,135964,1,4,0
38833,2,1,135962,135964,135965,2,3,0
38834,3,1,135965,135965,135966,0,1,0
38835,1,1,135966,135966,135967,0,1,0
38836,3,3,135969,135969,135972,0,3,2
38837,5,1,135974,135974,135975,0,1,2
38838,2,1,135976,135976,135977,0,1,1
38839,5,1,135981,135981,135982,0,1,4
38840,5,3,135986,135986,135989,0,3,4
38841,3,3,135989,135989,135992,0,3,0
38842,6,2,135995,135995,135997,0,2,3
38843,5,1,136000,136000,136001,0,1,3
38844,4,2,136004,136004,136006,0,2,3
38845,5,2,136009,136009,136011,0,2,3
38846,2,1,136011,136011,136012,0,1,0
38847,6,2,136017,136017,136019,0,2,5
38848,4,1,136021,136021,136022,0,1,2
38849,2,1,136023,136023,136024,0,1,1
38850,1,2,136024,136024,136026,0,2,0
38851,2,2,136026,136026,136028,0,2,0
38852,6,3,136032,136032,136035,0,3,4
38853,2,1,136034,136035,136036,1,2,0
38854,2,2,136036,136036,136038,0,2,0
38855,1,3,136037,136038,136041,1,4,0
38856,5,1,136042,136042,136043,0,1,1
38857,5,2,136047,136047,136049,0,2,4
38858,2,2,136049,136049,136051,0,2,0
38859,5,2,136054,136054,136056,0,2,3
38860,3,3,136057,136057,136060,0,3,1
38861,5,3,136062,136062,136065,0,3,2
38862,6,1,136068,136068,136069,0,1,3
38863,2,1,136070,136070,136071,0,1,1
38864,1,3,136071,136071,136074,0,3,0
38865,3,3,136074,136074,136077,0,3,0
38866,5,1,136079,136079,136080,0,1,2
38867,1,1,136080,136080,136081,0,1,0
38868,5,1,136085,136085,136086,0,1,4
38869,6,1,136091,136091,136092,0,1,5
38870,2,2,136093,136093,136095,0,2,1
38871,6,3,136099,136099,136102,0,3,4
38872,3,2,136102,136102,136104,0,2,0
38873,5,3,136107,136107,136110,0,3,3
38874,2,1,136109,136110,136111,1,2,0
38875,3,2,136112,136112,136114,0,2,1
38876,5,1,136117,136117,136118,0,1,3
38877,1,2,136118,136118,136120,0,2,0
38878,6,3,136124,136124,136127,0,3,4
38879,6,3,136130,136130,136133,0,3,3
38880,3,1,136133,136133,136134,0,1,0
38881,5,3,136138,136138,136141,0,3,4
38882,4,3,136142,136142,136145,0,3,1
38883,3,1,136145,136145,136146,0,1,0
38884,1,3,136146,136146,136149,0,3,0
38885,5,1,136151,136151,136152,0,1,2
38886,3,1,136154,136154,136155,0,1,2
38887,3,2,136157,136157,136159,0,2,2
38888,4,3,136161,136161,136164,0,3,2
38889,2,3,136163,136164,136167,1,4,0
38890,2,1,136165,136167,136168,2,3,0
38891,5,1,136170,136170,136171,0,1,2
38892,2,1,136172,136172,136173,0,1,1
38893,2,1,136174,136174,136175,0,1,1
38894,5,1,136179,136179,136180,0,1,4
38895,5,3,136184,136184,136187,0,3,4
38896,3,3,136187,136187,136190,0,3,0
38897,4,2,136191,136191,136193,0,2,1
38898,4,1,136195,136195,136196,0,1,2
38899,5,3,136200,136200,136203,0,3,4
38900,2,2,136202,136203,136205,1,3,0
38901,5,2,136207,136207,136209,0,2,2
38902,6,1,136213,136213,136214,0,1,4
38903,2,2,136215,136215,136217,0,2,1
38904,3,1,136218,136218,136219,0,1,1
38905,3,3,136221,136221,136224,0,3,2
38906,2,1,136223,136224,136225,1,2,0
38907,3,3,136226,136226,136229,0,3,1
38908,3,1,136229,136229,136230,0,1,0
38909,1,1,136230,136230,136231,0,1,0
38910,3,3,136233,136233,136236,0,3,2
38911,2,3,136235,136236,136239,1,4,0
38912,5,3,136240,136240,136243,0,3,1
38913,3,3,136243,136243,136246,0,3,0
38914,4,3,136247,136247,136250,0,3,1
38915,1,1,136248,136250,136251,2,3,0
38916,2,1,136250,136251,136252,1,2,0
38917,6,2,136256,136256,136258,0,2,4
38918,1,3,136257,136258,136261,1,4,0
38919,3,2,136260,136261,136263,1,3,0
38920,2,3,136262,136263,136266,1,4,0
38921,1,3,136263,136266,136269,3,6,0
38922,5,3,136268,136269,136272,1,4,0
38923,2,3,136270,136272,136275,2,5,0
38924,6,1,136276,136276,136277,0,1,1
38925,3,3,136279,136279,136282,0,3,2
38926,5,1,136284,136284,136285,0,1,2
38927,1,1,136285,136285,136286,0,1,0
38928,6,3,136291,136291,136294,0,3,5
38929,3,2,136294,136294,136296,0,2,0
38930,4,1,136298,136298,136299,0,1,2
38931,3,1,136301,136301,136302,0,1,2
38932,1,3,136302,136302,136305,0,3,0
38933,6,1,136308,136308,136309,0,1,3
38934,1,2,136309,136309,136311,0,2,0
38935,3,3,136312,136312,136315,0,3,1
38936,2,3,136314,136315,136318,1,4,0
38937,4,3,136318,136318,136321,0,3,0
38938,5,2,136323,136323,136325,0,2,2
38939,4,3,136327,136327,136330,0,3,2
38940,2,3,136329,136330,136333,1,4,0
38941,3,3,136332,136333,136336,1,4,0
38942,2,2,136334,136336,136338,2,4,0
38943,1,1,136335,136338,136339,3,4,0
38944,6,1,136341,136341,136342,0,1,2
38945,2,2,136343,136343,136345,0,2,1
38946,6,2,136349,136349,136351,0,2,4
38947,2,1,136351,136351,136352,0,1,0
38948,3,2,136354,136354,136356,0,2,2
38949,2,2,136356,136356,136358,0,2,0
38950,2,1,136358,136358,136359,0,1,0
38951,5,2,136363,136363,136365,0,2,4
38952,1,2,136364,136365,136367,1,3,0
38953,3,3,136367,136367,136370,0,3,0
38954,3,1,136370,136370,136371,0,1,0
38955,2,2,136372,136372,136374,0,2,1
38956,6,2,136378,136378,136380,0,2,4
38957,5,3,136383,136383,136386,0,3,3
38958,2,2,136385,136386,136388,1,3,0
38959,2,2,136387,136388,136390,1,3,0
38960,5,2,136392,136392,136394,0,2,2
38961,6,3,136398,136398,136401,0,3,4
38962,2,2,136400,136401,136403,1,3,0
38963,1,1,136401,136403,136404,2,3,0
38964,5,2,136406,136406,136408,0,2,2
38965,2,2,136408,136408,136410,0,2,0
38966,4,1,136412,136412,136413,0,1,2
38967,2,2,136414,136414,136416,0,2,1
38968,6,3,136420,136420,136423,0,3,4
38969,5,3,136425,136425,136428,0,3,2
38970,5,1,136430,136430,136431,0,1,2
38971,1,2,136431,136431,136433,0,2,0
38972,6,1,136437,136437,136438,0,1,4
38973,1,1,136438,136438,136439,0,1,0
38974,5,2,136443,136443,136445,0,2,4
38975,6,1,136449,136449,136450,0,1,4
38976,4,2,136453,136453,136455,0,2,3
38977,3,2,136456,136456,136458,0,2,1
38978,4,1,136460,136460,136461,0,1,2
38979,6,3,136466,136466,136469,0,3,5
38980,5,2,136471,136471,136473,0,2,2
38981,2,1,136473,136473,136474,0,1,0
38982,6,3,136479,136479,136482,0,3,5
38983,5,2,136484,136484,136486,0,2,2
38984,2,1,136486,136486,136487,0,1,0
38985,4,1,136490,136490,136491,0,1,3
38986,2,1,136492,136492,136493,0,1,1
38987,2,3,136494,136494,136497,0,3,1
38988,5,3,136499,136499,136502,0,3,2
38989,3,1,136502,136502,136503,0,1,0
38990,3,2,136505,136505,136507,0,2,2
38991,1,1,136506,136507,136508,1,2,0
38992,1,3,136507,136508,136511,1,4,0
38993,5,1,136512,136512,136513,0,1,1
38994,5,1,136517,136517,136518,0,1,4
38995,3,3,136520,136520,136523,0,3,2
38996,2,2,136522,136523,136525,1,3,0
38997,3,1,136525,136525,136526,0,1,0
38998,4,2,136529,136529,136531,0,2,3
38999,3,3,136532,136532,136535,0,3,1
39000,5,1,136537,136537,136538,0,1,2
39001,4,2,136541,136541,136543,0,2,3
39002,1,2,136542,136543,136545,1,3,0
39003,6,1,136548,136548,136549,0,1,3
39004,5,2,136553,136553,136555,0,2,4
39005,6,1,136559,136559,136560,0,1,4
39006,5,1,136564,136564,136565,0,1,4
39007,6,2,136570,136570,136572,0,2,5
39008,4,3,136574,136574,136577,0,3,2
39009,4,3,136578,136578,136581,0,3,1
39010,6,2,136584,136584,136586,0,2,3
39011,4,1,136588,136588,136589,0,1,2
39012,4,3,136592,136592,136595,0,3,3
39013,4,3,136596,136596,136599,0,3,1
39014,4,1,136600,136600,136601,0,1,1
39015,2,2,136602,136602,136604,0,2,1
39016,6,3,136608,136608,136611,0,3,4
39017,1,3,136609,136611,136614,2,5,0
39018,5,1,136614,136614,136615,0,1,0
39019,6,2,136620,136620,136622,0,2,5
39020,5,2,136625,136625,136627,0,2,3
39021,6,1,136631,136631,136632,0,1,4
39022,6,1,136637,136637,136638,0,1,5
39023,5,1,136642,136642,136643,0,1,4
39024,6,3,136648,136648,136651,0,3,5
39025,3,2,136651,136651,136653,0,2,0
39026,4,1,136655,136655,136656,0,1,2
39027,4,1,136659,136659,136660,0,1,3
39028,4,3,136663,136663,136666,0,3,3
39029,6,3,136669,136669,136672,0,3,3
39030,6,1,136675,136675,136676,0,1,3
39031,3,1,136678,136678,136679,0,1,2
39032,3,2,136681,136681,136683,0,2,2
39033,1,3,136682,136683,136686,1,4,0
39034,4,2,136686,136686,136688,0,2,0
39035,6,1,136692,136692,136693,0,1,4
39036,6,3,136698,136698,136701,0,3,5
39037,2,3,136700,136701,136704,1,4,0
39038,6,2,136706,136706,136708,0,2,2
39039,4,2,136710,136710,136712,0,2,2
39040,6,1,136716,136716,136717,0,1,4
39041,5,1,136721,136721,136722,0,1,4
39042,3,3,136724,136724,136727,0,3,2
39043,5,3,136729,136729,136732,0,3,2
39044,6,1,136735,136735,136736,0,1,3
39045,1,3,136736,136736,136739,0,3,0
39046,5,3,136741,136741,136744,0,3,2
39047,4,2,136745,136745,136747,0,2,1
39048,6,1,136751,136751,136752,0,1,4
39049,4,2,136755,136755,136757,0,2,3
39050,6,2,136761,136761,136763,0,2,4
39051,1,1,136762,136763,136764,1,2,0
39052,4,3,136766,136766,136769,0,3,2
39053,1,2,136767,136769,136771,2,4,0
39054,5,3,136772,136772,136775,0,3,1
39055,5,2,136777,136777,136779,0,2,2
39056,3,3,136780,136780,136783,0,3,1
39057,4,2,136784,136784,136786,0,2,1
39058,2,2,136786,136786,136788,0,2,0
39059,1,2,136787,136788,136790,1,3,0
39060,1,3,136788,136790,136793,2,5,0
39061,5,2,136793,136793,136795,0,2,0
39062,3,3,136796,136796,136799,0,3,1
39063,1,1,136797,136799,136800,2,3,0
39064,1,2,136798,136800,136802,2,4,0
39065,3,3,136801,136802,136805,1,4,0
39066,6,1,136807,136807,136808,0,1,2
39067,5,3,136812,136812,136815,0,3,4
39068,4,1,136816,136816,136817,0,1,1
39069,1,3,136817,136817,136820,0,3,0
39070,3,3,136820,136820,136823,0,3,0
39071,6,3,136826,136826,136829,0,3,3
39072,2,2,136828,136829,136831,1,3,0
39073,3,3,136831,136831,136834,0,3,0
39074,4,2,136835,136835,136837,0,2,1
39075,3,1,136838,136838,136839,0,1,1
39076,5,1,136843,136843,136844,0,1,4
39077,2,3,136845,136845,136848,0,3,1
39078,3,3,136848,136848,136851,0,3,0
39079,1,3,136849,136851,136854,2,5,0
39080,3,3,136852,136854,136857,2,5,0
39081,1,1,136853,136857,136858,4,5,0
39082,6,2,136859,136859,136861,0,2,1
39083,2,2,136861,136861,136863,0,2,0
39084,2,2,136863,136863,136865,0,2,0
39085,2,2,136865,136865,136867,0,2,0
39086,1,3,136866,136867,136870,1,4,0
39087,3,3,136869,136870,136873,1,4,0
39088,5,3,136874,136874,136877,0,3,1
39089,3,2,136877,136877,136879,0,2,0
39090,5,1,136882,136882,136883,0,1,3
39091,1,2,136883,136883,136885,0,2,0
39092,3,3,136886,136886,136889,0,3,1
39093,4,3,136890,136890,136893,0,3,1
39094,2,2,136892,136893,136895,1,3,0
39095,6,2,136898,136898,136900,0,2,3
39096,4,3,136902,136902,136905,0,3,2
39097,1,1,136903,136905,136906,2,3,0
39098,5,1,136908,136908,136909,0,1,2
39099,3,3,136911,136911,136914,0,3,2
39100,5,3,136916,136916,136919,0,3,2
39101,6,2,136922,136922,136924,0,2,3
39102,2,3,136924,136924,136927,0,3,0
39103,3,1,136927,136927,136928,0,1,0
39104,3,2,136930,136930,136932,0,2,2
39105,3,1,136933,136933,136934,0,1,1
39106,2,1,136935,136935,136936,0,1,1
39107,3,2,136938,136938,136940,0,2,2
39108,5,3,136943,136943,136946,0,3,3
39109,4,1,136947,136947,136948,0,1,1
39110,5,1,136952,136952,136953,0,1,4
39111,3,2,136955,136955,136957,0,2,2
39112,1,1,136956,136957,136958,1,2,0
39113,4,1,136960,136960,136961,0,1,2
39114,6,1,136966,136966,136967,0,1,5
39115,6,3,136972,136972,136975,0,3,5
39116,6,3,136978,136978,136981,0,3,3
39117,1,3,136979,136981,136984,2,5,0
39118,4,2,136983,136984,136986,1,3,0
39119,6,3,136989,136989,136992,0,3,3
39120,3,1,136992,136992,136993,0,1,0
39121,3,3,136995,136995,136998,0,3,2
39122,6,1,137001,137001,137002,0,1,3
39123,1,1,137002,137002,137003,0,1,0
39124,6,1,137008,137008,137009,0,1,5
39125,1,1,137009,137009,137010,0,1,0
39126,6,2,137015,137015,137017,0,2,5
39127,1,1,137016,137017,137018,1,2,0
39128,6,1,137022,137022,137023,0,1,4
39129,4,2,137026,137026,137028,0,2,3
39130,5,3,137031,137031,137034,0,3,3
39131,6,2,137037,137037,137039,0,2,3
39132,3,1,137040,137040,137041,0,1,1
39133,5,1,137045,137045,137046,0,1,4
39134,1,1,137046,137046,137047,0,1,0
39135,2,1,137048,137048,137049,0,1,1
39136,4,2,137052,137052,137054,0,2,3
39137,5,3,137057,137057,137060,0,3,3
39138,1,2,137058,137060,137062,2,4,0
39139,3,3,137061,137062,137065,1,4,0
39140,4,1,137065,137065,137066,0,1,0
39141,5,3,137070,137070,137073,0,3,4
39142,3,1,137073,137073,137074,0,1,0
39143,5,3,137078,137078,137081,0,3,4
39144,1,1,137079,137081,137082,2,3,0
39145,3,1,137082,137082,137083,0,1,0
39146,4,2,137086,137086,137088,0,2,3
39147,3,1,137089,137089,137090,0,1,1
39148,4,1,137093,137093,137094,0,1,3
39149,3,3,137096,137096,137099,0,3,2
39150,5,1,137101,137101,137102,0,1,2
39151,2,2,137103,137103,137105,0,2,1
39152,5,3,137108,137108,137111,0,3,3
39153,6,1,137114,137114,137115,0,1,3
39154,3,2,137117,137117,137119,0,2,2
39155,6,3,137123,137123,137126,0,3,4
39156,2,2,137125,137126,137128,1,3,0
39157,3,3,137128,137128,137131,0,3,0
39158,2,1,137130,137131,137132,1,2,0
39159,5,1,137135,137135,137136,0,1,3
39160,6,2,137141,137141,137143,0,2,5
39161,5,1,137146,137146,137147,0,1,3
39162,6,1,137152,137152,137153,0,1,5
39163,2,1,137154,137154,137155,0,1,1
39164,5,1,137159,137159,137160,0,1,4
39165,1,1,137160,137160,137161,0,1,0
39166,5,1,137165,137165,137166,0,1,4
39167,3,2,137168,137168,137170,0,2,2
39168,2,1,137170,137170,137171,0,1,0
39169,2,1,137172,137172,137173,0,1,1
39170,6,3,137178,137178,137181,0,3,5
39171,1,1,137179,137181,137182,2,3,0
39172,2,2,137181,137182,137184,1,3,0
39173,3,3,137184,137184,137187,0,3,0
39174,2,1,137186,137187,137188,1,2,0
39175,4,2,137190,137190,137192,0,2,2
39176,1,3,137191,137192,137195,1,4,0
39177,6,1,137197,137197,137198,0,1,2
39178,6,3,137203,137203,137206,0,3,5
39179,2,2,137205,137206,137208,1,3,0
39180,3,3,137208,137208,137211,0,3,0
39181,3,3,137211,137211,137214,0,3,0
39182,3,3,137214,137214,137217,0,3,0
39183,1,2,137215,137217,137219,2,4,0
39184,4,2,137219,137219,137221,0,2,0
39185,4,1,137223,137223,137224,0,1,2
39186,4,1,137227,137227,137228,0,1,3
39187,1,3,137228,137228,137231,0,3,0
39188,2,1,137230,137231,137232,1,2,0
39189,5,1,137235,137235,137236,0,1,3
39190,5,1,137240,137240,137241,0,1,4
39191,4,3,137244,137244,137247,0,3,3
39192,6,1,137250,137250,137251,0,1,3
39193,3,3,137253,137253,137256,0,3,2
39194,1,3,137254,137256,137259,2,5,0
39195,5,2,137259,137259,137261,0,2,0
39196,4,2,137263,137263,137265,0,2,2
39197,2,3,137265,137265,137268,0,3,0
39198,3,3,137268,137268,137271,0,3,0
39199,5,1,137273,137273,137274,0,1,2
39200,5,3,137278,137278,137281,0,3,4
39201,5,2,137283,137283,137285,0,2,2
39202,1,2,137284,137285,137287,1,3,0
39203,6,1,137290,137290,137291,0,1,3
39204,1,1,137291,137291,137292,0,1,0
39205,5,1,137296,137296,137297,0,1,4
39206,2,2,137298,137298,137300,0,2,1
39207,1,3,137299,137300,137303,1,4,0
39208,4,2,137303,137303,137305,0,2,0
39209,5,2,137308,137308,137310,0,2,3
39210,1,3,137309,137310,137313,1,4,0
39211,3,2,137312,137313,137315,1,3,0
39212,1,2,137313,137315,137317,2,4,0
39213,1,3,137314,137317,137320,3,6,0
39214,6,2,137320,137320,137322,0,2,0
39215,2,3,137322,137322,137325,0,3,0
39216,5,3,137327,137327,137330,0,3,2
39217,6,2,137333,137333,137335,0,2,3
39218,5,3,137338,137338,137341,0,3,3
39219,3,1,137341,137341,137342,0,1,0
39220,6,1,137347,137347,137348,0,1,5
39221,1,3,137348,137348,137351,0,3,0
39222,3,2,137351,137351,137353,0,2,0
39223,1,1,137352,137353,137354,1,2,0
39224,2,3,137354,137354,137357,0,3,0
39225,2,3,137356,137357,137360,1,4,0
39226,3,3,137359,137360,137363,1,4,0
39227,4,2,137363,137363,137365,0,2,0
39228,5,3,137368,137368,137371,0,3,3
39229,6,2,137374,137374,137376,0,2,3
39230,3,2,137377,137377,137379,0,2,1
39231,3,3,137380,137380,137383,0,3,1
39232,4,2,137384,137384,137386,0,2,1
39233,6,1,137390,137390,137391,0,1,4
39234,5,3,137395,137395,137398,0,3,4
39235,5,1,137400,137400,137401,0,1,2
39236,6,1,137406,137406,137407,0,1,5
39237,2,3,137408,137408,137411,0,3,1
39238,5,2,137413,137413,137415,0,2,2
39239,6,3,137419,137419,137422,0,3,4
39240,2,2,137421,137422,137424,1,3,0
39241,1,1,137422,137424,137425,2,3,0
39242,4,3,137426,137426,137429,0,3,1
39243,3,1,137429,137429,137430,0,1,0
39244,2,3,137431,137431,137434,0,3,1
39245,5,2,137436,137436,137438,0,2,2
39246,4,3,137440,137440,137443,0,3,2
39247,4,1,137444,137444,137445,0,1,1
39248,2,2,137446,137446,137448,0,2,1
39249,2,1,137448,137448,137449,0,1,0
39250,2,2,137450,137450,137452,0,2,1
39251,5,2,137455,137455,137457,0,2,3
39252,2,3,137457,137457,137460,0,3,0
39253,3,3,137460,137460,137463,0,3,0
39254,2,3,137462,137463,137466,1,4,0
39255,4,2,137466,137466,137468,0,2,0
39256,6,2,137472,137472,137474,0,2,4
39257,1,1,137473,137474,137475,1,2,0
39258,4,2,137477,137477,137479,0,2,2
39259,6,1,137483,137483,137484,0,1,4
39260,5,1,137488,137488,137489,0,1,4
39261,5,1,137493,137493,137494,0,1,4
39262,4,3,137497,137497,137500,0,3,3
39263,3,1,137500,137500,137501,0,1,0
39264,2,3,137502,137502,137505,0,3,1
39265,1,1,137503,137505,137506,2,3,0
39266,4,3,137507,137507,137510,0,3,1
39267,3,1,137510,137510,137511,0,1,0
39268,1,3,137511,137511,137514,0,3,0
39269,6,2,137517,137517,137519,0,2,3
39270,3,3,137520,137520,137523,0,3,1
39271,1,2,137521,137523,137525,2,4,0
39272,3,2,137524,137525,137527,1,3,0
39273,1,3,137525,137527,137530,2,5,0
39274,2,2,137527,137530,137532,3,5,0
39275,2,3,137529,137532,137535,3,6,0
39276,4,2,137533,137535,137537,2,4,0
39277,4,2,137537,137537,137539,0,2,0
39278,1,1,137538,137539,137540,1,2,0
39279,2,2,137540,137540,137542,0,2,0
39280,1,3,137541,137542,137545,1,4,0
39281,2,2,137543,137545,137547,2,4,0
39282,3,2,137546,137547,137549,1,3,0
39283,5,1,137551,137551,137552,0,1,2
39284,4,1,137555,137555,137556,0,1,3
39285,2,2,137557,137557,137559,0,2,1
39286,5,3,137562,137562,137565,0,3,3
39287,2,3,137564,137565,137568,1,4,0
39288,2,1,137566,137568,137569,2,3,0
39289,2,2,137568,137569,137571,1,3,0
39290,2,3,137570,137571,137574,1,4,0
39291,4,2,137574,137574,137576,0,2,0
39292,3,1,137577,137577,137578,0,1,1
39293,5,2,137582,137582,137584,0,2,4
39294,5,3,137587,137587,137590,0,3,3
39295,6,2,137593,137593,137595,0,2,3
39296,5,3,137598,137598,137601,0,3,3
39297,1,3,137599,137601,137604,2,5,0
39298,2,2,137601,137604,137606,3,5,0
39299,1,1,137602,137606,137607,4,5,0
39300,2,3,137604,137607,137610,3,6,0
39301,4,3,137608,137610,137613,2,5,0
39302,5,1,137613,137613,137614,0,1,0
39303,3,3,137616,137616,137619,0,3,2
39304,2,1,137618,137619,137620,1,2,0
39305,6,1,137624,137624,137625,0,1,4
39306,6,3,137630,137630,137633,0,3,5
39307,3,2,137633,137633,137635,0,2,0
39308,2,3,137635,137635,137638,0,3,0
39309,3,3,137638,137638,137641,0,3,0
39310,5,3,137643,137643,137646,0,3,2
39311,2,3,137645,137646,137649,1,4,0
39312,5,1,137650,137650,137651,0,1,1
39313,5,2,137655,137655,137657,0,2,4
39314,5,2,137660,137660,137662,0,2,3
39315,2,3,137662,137662,137665,0,3,0
39316,2,3,137664,137665,137668,1,4,0
39317,5,3,137669,137669,137672,0,3,1
39318,3,3,137672,137672,137675,0,3,0
39319,5,3,137677,137677,137680,0,3,2
39320,4,2,137681,137681,137683,0,2,1
39321,6,2,137687,137687,137689,0,2,4
39322,4,3,137691,137691,137694,0,3,2
39323,3,2,137694,137694,137696,0,2,0
39324,3,2,137697,137697,137699,0,2,1
39325,6,2,137703,137703,137705,0,2,4
39326,1,3,137704,137705,137708,1,4,0
39327,1,1,137705,137708,137709,3,4,0
39328,1,3,137706,137709,137712,3,6,0
39329,4,2,137710,137712,137714,2,4,0
39330,3,3,137713,137714,137717,1,4,0
39331,3,2,137716,137717,137719,1,3,0
39332,4,3,137720,137720,137723,0,3,1
39333,1,1,137721,137723,137724,2,3,0
39334,2,3,137723,137724,137727,1,4,0
39335,6,3,137729,137729,137732,0,3,2
39336,5,2,137734,137734,137736,0,2,2
39337,3,2,137737,137737,137739,0,2,1
39338,2,2,137739,137739,137741,0,2,0
39339,1,2,137740,137741,137743,1,3,0
39340,4,1,137744,137744,137745,0,1,1
39341,5,3,137749,137749,137752,0,3,4
39342,1,1,137750,137752,137753,2,3,0
39343,3,3,137753,137753,137756,0,3,0
39344,1,2,137754,137756,137758,2,4,0
39345,5,1,137759,137759,137760,0,1,1
39346,5,2,137764,137764,137766,0,2,4
39347,6,2,137770,137770,137772,0,2,4
39348,6,2,137776,137776,137778,0,2,4
39349,2,1,137778,137778,137779,0,1,0
39350,1,1,137779,137779,137780,0,1,0
39351,6,1,137785,137785,137786,0,1,5
39352,2,1,137787,137787,137788,0,1,1
39353,6,2,137793,137793,137795,0,2,5
39354,3,2,137796,137796,137798,0,2,1
39355,4,2,137800,137800,137802,0,2,2
39356,6,3,137806,137806,137809,0,3,4
39357,6,1,137812,137812,137813,0,1,3
39358,6,2,137818,137818,137820,0,2,5
39359,1,2,137819,137820,137822,1,3,0
39360,5,3,137824,137824,137827,0,3,2
39361,3,1,137827,137827,137828,0,1,0
39362,1,1,137828,137828,137829,0,1,0
39363,3,1,137831,137831,137832,0,1,2
39364,2,2,137833,137833,137835,0,2,1
39365,4,3,137837,137837,137840,0,3,2
39366,2,1,137839,137840,137841,1,2,0
39367,4,2,137843,137843,137845,0,2,2
39368,5,3,137848,137848,137851,0,3,3
39369,5,3,137853,137853,137856,0,3,2
39370,5,2,137858,137858,137860,0,2,2
39371,3,1,137861,137861,137862,0,1,1
39372,2,1,137863,137863,137864,0,1,1
39373,5,2,137868,137868,137870,0,2,4
39374,5,2,137873,137873,137875,0,2,3
39375,1,3,137874,137875,137878,1,4,0
39376,2,3,137876,137878,137881,2,5,0
39377,3,3,137879,137881,137884,2,5,0
39378,1,2,137880,137884,137886,4,6,0
39379,2,3,137882,137886,137889,4,7,0
39380,2,1,137884,137889,137890,5,6,0
39381,3,1,137887,137890,137891,3,4,0
39382,4,3,137891,137891,137894,0,3,0
39383,6,3,137897,137897,137900,0,3,3
39384,5,1,137902,137902,137903,0,1,2
39385,5,3,137907,137907,137910,0,3,4
39386,6,2,137913,137913,137915,0,2,3
39387,6,2,137919,137919,137921,0,2,4
39388,5,1,137924,137924,137925,0,1,3
39389,6,3,137930,137930,137933,0,3,5
39390,2,1,137932,137933,137934,1,2,0
39391,3,2,137935,137935,137937,0,2,1
39392,1,1,137936,137937,137938,1,2,0
39393,4,3,137940,137940,137943,0,3,2
39394,3,3,137943,137943,137946,0,3,0
39395,2,2,137945,137946,137948,1,3,0
39396,5,3,137950,137950,137953,0,3,2
39397,2,1,137952,137953,137954,1,2,0
39398,1,3,137953,137954,137957,1,4,0
39399,1,2,137954,137957,137959,3,5,0
39400,1,3,137955,137959,137962,4,7,0
39401,5,1,137960,137962,137963,2,3,0
39402,1,1,137961,137963,137964,2,3,0
39403,5,2,137966,137966,137968,0,2,2
39404,3,3,137969,137969,137972,0,3,1
39405,1,3,137970,137972,137975,2,5,0
39406,4,1,137974,137975,137976,1,2,0
39407,1,1,137975,137976,137977,1,2,0
39408,2,3,137977,137977,137980,0,3,0
39409,6,3,137983,137983,137986,0,3,3
39410,5,2,137988,137988,137990,0,2,2
39411,5,2,137993,137993,137995,0,2,3
39412,3,1,137996,137996,137997,0,1,1
39413,2,3,137998,137998,138001,0,3,1
39414,2,2,138000,138001,138003,1,3,0
39415,6,3,138006,138006,138009,0,3,3
39416,2,2,138008,138009,138011,1,3,0
39417,1,2,138009,138011,138013,2,4,0
39418,1,3,138010,138013,138016,3,6,0
39419,4,3,138014,138016,138019,2,5,0
39420,4,3,138018,138019,138022,1,4,0
39421,4,2,138022,138022,138024,0,2,0
39422,5,1,138027,138027,138028,0,1,3
39423,2,3,138029,138029,138032,0,3,1
39424,4,3,138033,138033,138036,0,3,1
39425,2,3,138035,138036,138039,1,4,0
39426,1,1,138036,138039,138040,3,4,0
39427,2,2,138038,138040,138042,2,4,0
39428,4,2,138042,138042,138044,0,2,0
39429,3,2,138045,138045,138047,0,2,1
39430,3,3,138048,138048,138051,0,3,1
39431,5,1,138053,138053,138054,0,1,2
39432,3,2,138056,138056,138058,0,2,2
39433,1,1,138057,138058,138059,1,2,0
39434,5,1,138062,138062,138063,0,1,3
39435,1,2,138063,138063,138065,0,2,0
39436,6,1,138069,138069,138070,0,1,4
39437,6,2,138075,138075,138077,0,2,5
39438,5,1,138080,138080,138081,0,1,3
39439,4,3,138084,138084,138087,0,3,3
39440,1,1,138085,138087,138088,2,3,0
39441,6,1,138091,138091,138092,0,1,3
39442,1,3,138092,138092,138095,0,3,0
39443,4,3,138096,138096,138099,0,3,1
39444,3,1,138099,138099,138100,0,1,0
39445,2,1,138101,138101,138102,0,1,1
39446,3,2,138104,138104,138106,0,2,2
39447,3,2,138107,138107,138109,0,2,1
39448,3,2,138110,138110,138112,0,2,1
39449,4,3,138114,138114,138117,0,3,2
39450,4,3,138118,138118,138121,0,3,1
39451,3,1,138121,138121,138122,0,1,0
39452,2,2,138123,138123,138125,0,2,1
39453,5,2,138128,138128,138130,0,2,3
39454,1,3,138129,138130,138133,1,4,0
39455,6,1,138135,138135,138136,0,1,2
39456,4,2,138139,138139,138141,0,2,3
39457,1,2,138140,138141,138143,1,3,0
39458,5,3,138145,138145,138148,0,3,2
39459,4,1,138149,138149,138150,0,1,1
39460,2,1,138151,138151,138152,0,1,1
39461,6,2,138157,138157,138159,0,2,5
39462,2,3,138159,138159,138162,0,3,0
39463,5,2,138164,138164,138166,0,2,2
39464,1,3,138165,138166,138169,1,4,0
39465,1,3,138166,138169,138172,3,6,0
39466,4,1,138170,138172,138173,2,3,0
39467,5,1,138175,138175,138176,0,1,2
39468,3,3,138178,138178,138181,0,3,2
39469,3,3,138181,138181,138184,0,3,0
39470,2,1,138183,138184,138185,1,2,0
39471,4,1,138187,138187,138188,0,1,2
39472,5,2,138192,138192,138194,0,2,4
39473,4,3,138196,138196,138199,0,3,2
39474,4,2,138200,138200,138202,0,2,1
39475,5,3,138205,138205,138208,0,3,3
39476,5,3,138210,138210,138213,0,3,2
39477,2,2,138212,138213,138215,1,3,0
39478,2,1,138214,138215,138216,1,2,0
39479,4,3,138218,138218,138221,0,3,2
39480,3,1,138221,138221,138222,0,1,0
39481,2,2,138223,138223,138225,0,2,1
39482,1,3,138224,138225,138228,1,4,0
39483,3,1,138227,138228,138229,1,2,0
39484,3,1,138230,138230,138231,0,1,1
39485,1,2,138231,138231,138233,0,2,0
39486,6,1,138237,138237,138238,0,1,4
39487,3,2,138240,138240,138242,0,2,2
39488,3,2,138243,138243,138245,0,2,1
39489,5,2,138248,138248,138250,0,2,3
39490,4,1,138252,138252,138253,0,1,2
39491,4,3,138256,138256,138259,0,3,3
39492,2,3,138258,138259,138262,1,4,0
39493,4,1,138262,138262,138263,0,1,0
39494,6,3,138268,138268,138271,0,3,5
39495,5,2,138273,138273,138275,0,2,2
39496,6,2,138279,138279,138281,0,2,4
39497,6,3,138285,138285,138288,0,3,4
39498,5,3,138290,138290,138293,0,3,2
39499,5,1,138295,138295,138296,0,1,2
39500,3,1,138298,138298,138299,0,1,2
39501,6,3,138304,138304,138307,0,3,5
39502,6,2,138310,138310,138312,0,2,3
39503,3,3,138313,138313,138316,0,3,1
39504,2,3,138315,138316,138319,1,4,0
39505,4,2,138319,138319,138321,0,2,0
39506,2,2,138321,138321,138323,0,2,0
39507,2,3,138323,138323,138326,0,3,0
39508,5,3,138328,138328,138331,0,3,2
39509,4,3,138332,138332,138335,0,3,1
39510,5,2,138337,138337,138339,0,2,2
39511,1,2,138338,138339,138341,1,3,0
39512,5,2,138343,138343,138345,0,2,2
39513,4,3,138347,138347,138350,0,3,2
39514,2,2,138349,138350,138352,1,3,0
39515,5,2,138354,138354,138356,0,2,2
39516,6,2,138360,138360,138362,0,2,4
39517,6,3,138366,138366,138369,0,3,4
39518,1,2,138367,138369,138371,2,4,0
39519,3,3,138370,138371,138374,1,4,0
39520,4,3,138374,138374,138377,0,3,0
39521,5,2,138379,138379,138381,0,2,2
39522,5,1,138384,138384,138385,0,1,3
39523,1,2,138385,138385,138387,0,2,0
39524,3,2,138388,138388,138390,0,2,1
39525,5,2,138393,138393,138395,0,2,3
39526,1,1,138394,138395,138396,1,2,0
39527,3,1,138397,138397,138398,0,1,1
39528,1,2,138398,138398,138400,0,2,0
39529,3,1,138401,138401,138402,0,1,1
39530,3,1,138404,138404,138405,0,1,2
39531,4,3,138408,138408,138411,0,3,3
39532,6,2,138414,138414,138416,0,2,3
39533,2,3,138416,138416,138419,0,3,0
39534,5,1,138421,138421,138422,0,1,2
39535,2,2,138423,138423,138425,0,2,1
39536,1,1,138424,138425,138426,1,2,0
39537,3,3,138427,138427,138430,0,3,1
39538,6,1,138433,138433,138434,0,1,3
39539,2,2,138435,138435,138437,0,2,1
39540,4,2,138439,138439,138441,0,2,2
39541,4,1,138443,138443,138444,0,1,2
39542,2,3,138445,138445,138448,0,3,1
39543,5,1,138450,138450,138451,0,1,2
39544,1,3,138451,138451,138454,0,3,0
39545,5,3,138456,138456,138459,0,3,2
39546,4,3,138460,138460,138463,0,3,1
39547,5,1,138465,138465,138466,0,1,2
39548,2,2,138467,138467,138469,0,2,1
39549,2,1,138469,138469,138470,0,1,0
39550,2,2,138471,138471,138473,0,2,1
39551,3,2,138474,138474,138476,0,2,1
39552,5,2,138479,138479,138481,0,2,3
39553,4,2,138483,138483,138485,0,2,2
39554,2,3,138485,138485,138488,0,3,0
39555,2,1,138487,138488,138489,1,2,0
39556,4,2,138491,138491,138493,0,2,2
39557,2,2,138493,138493,138495,0,2,0
39558,6,1,138499,138499,138500,0,1,4
39559,4,1,138503,138503,138504,0,1,3
39560,6,1,138509,138509,138510,0,1,5
39561,5,3,138514,138514,138517,0,3,4
39562,2,2,138516,138517,138519,1,3,0
39563,4,3,138520,138520,138523,0,3,1
39564,6,2,138526,138526,138528,0,2,3
39565,6,2,138532,138532,138534,0,2,4
39566,1,3,138533,138534,138537,1,4,0
39567,5,2,138538,138538,138540,0,2,1
39568,1,1,138539,138540,138541,1,2,0
39569,6,2,138545,138545,138547,0,2,4
39570,1,3,138546,138547,138550,1,4,0
39571,6,1,138552,138552,138553,0,1,2
39572,6,2,138558,138558,138560,0,2,5
39573,4,1,138562,138562,138563,0,1,2
39574,5,1,138567,138567,138568,0,1,4
39575,6,3,138573,138573,138576,0,3,5
39576,2,3,138575,138576,138579,1,4,0
39577,1,3,138576,138579,138582,3,6,0
39578,6,2,138582,138582,138584,0,2,0
39579,2,1,138584,138584,138585,0,1,0
39580,5,1,138589,138589,138590,0,1,4
39581,2,1,138591,138591,138592,0,1,1
39582,1,1,138592,138592,138593,0,1,0
39583,4,3,138596,138596,138599,0,3,3
39584,1,1,138597,138599,138600,2,3,0
39585,3,1,138600,138600,138601,0,1,0
39586,3,1,138603,138603,138604,0,1,2
39587,4,2,138607,138607,138609,0,2,3
39588,3,2,138610,138610,138612,0,2,1
39589,3,3,138613,138613,138616,0,3,1
39590,5,1,138618,138618,138619,0,1,2
39591,2,3,138620,138620,138623,0,3,1
39592,3,3,138623,138623,138626,0,3,0
39593,1,3,138624,138626,138629,2,5,0
39594,4,1,138628,138629,138630,1,2,0
39595,1,3,138629,138630,138633,1,4,0
39596,5,1,138634,138634,138635,0,1,1
39597,5,2,138639,138639,138641,0,2,4
39598,5,1,138644,138644,138645,0,1,3
39599,1,1,138645,138645,138646,0,1,0
39600,1,1,138646,138646,138647,0,1,0
39601,1,2,138647,138647,138649,0,2,0
39602,1,3,138648,138649,138652,1,4,0
39603,6,1,138654,138654,138655,0,1,2
39604,2,1,138656,138656,138657,0,1,1
39605,6,1,138662,138662,138663,0,1,5
39606,2,2,138664,138664,138666,0,2,1
39607,3,1,138667,138667,138668,0,1,1
39608,1,2,138668,138668,138670,0,2,0
39609,3,1,138671,138671,138672,0,1,1
39610,1,3,138672,138672,138675,0,3,0
39611,5,1,138677,138677,138678,0,1,2
39612,4,1,138681,138681,138682,0,1,3
39613,5,3,138686,138686,138689,0,3,4
39614,5,2,138691,138691,138693,0,2,2
39615,4,2,138695,138695,138697,0,2,2
39616,1,3,138696,138697,138700,1,4,0
39617,4,1,138700,138700,138701,0,1,0
39618,2,1,138702,138702,138703,0,1,1
39619,6,2,138708,138708,138710,0,2,5
39620,1,1,138709,138710,138711,1,2,0
39621,1,3,138710,138711,138714,1,4,0
39622,5,3,138715,138715,138718,0,3,1
39623,4,3,138719,138719,138722,0,3,1
39624,5,3,138724,138724,138727,0,3,2
39625,2,1,138726,138727,138728,1,2,0
39626,4,3,138730,138730,138733,0,3,2
39627,1,2,138731,138733,138735,2,4,0
39628,5,1,138736,138736,138737,0,1,1
39629,4,1,138740,138740,138741,0,1,3
39630,6,3,138746,138746,138749,0,3,5
39631,3,2,138749,138749,138751,0,2,0
39632,2,3,138751,138751,138754,0,3,0
39633,2,2,138753,138754,138756,1,3,0
39634,1,3,138754,138756,138759,2,5,0
39635,2,1,138756,138759,138760,3,4,0
39636,5,3,138761,138761,138764,0,3,1
39637,4,1,138765,138765,138766,0,1,1
39638,1,3,138766,138766,138769,0,3,0
39639,5,3,138771,138771,138774,0,3,2
39640,5,2,138776,138776,138778,0,2,2
39641,6,3,138782,138782,138785,0,3,4
39642,3,1,138785,138785,138786,0,1,0
39643,4,3,138789,138789,138792,0,3,3
39644,4,3,138793,138793,138796,0,3,1
39645,2,2,138795,138796,138798,1,3,0
39646,3,1,138798,138798,138799,0,1,0
39647,4,3,138802,138802,138805,0,3,3
39648,6,1,138808,138808,138809,0,1,3
39649,4,3,138812,138812,138815,0,3,3
39650,3,3,138815,138815,138818,0,3,0
39651,2,1,138817,138818,138819,1,2,0
39652,6,1,138823,138823,138824,0,1,4
39653,3,2,138826,138826,138828,0,2,2
39654,3,2,138829,138829,138831,0,2,1
39655,4,1,138833,138833,138834,0,1,2
39656,5,1,138838,138838,138839,0,1,4
39657,4,1,138842,138842,138843,0,1,3
39658,5,2,138847,138847,138849,0,2,4
39659,4,2,138851,138851,138853,0,2,2
39660,2,3,138853,138853,138856,0,3,0
39661,5,2,138858,138858,138860,0,2,2
39662,4,2,138862,138862,138864,0,2,2
39663,2,2,138864,138864,138866,0,2,0
39664,3,2,138867,138867,138869,0,2,1
39665,3,2,138870,138870,138872,0,2,1
39666,5,3,138875,138875,138878,0,3,3
39667,5,3,138880,138880,138883,0,3,2
39668,3,3,138883,138883,138886,0,3,0
39669,2,1,138885,138886,138887,1,2,0
39670,3,2,138888,138888,138890,0,2,1
39671,1,2,138889,138890,138892,1,3,0
39672,1,1,138890,138892,138893,2,3,0
39673,2,1,138892,138893,138894,1,2,0
39674,4,3,138896,138896,138899,0,3,2
39675,5,1,138901,138901,138902,0,1,2
39676,2,2,138903,138903,138905,0,2,1
39677,5,2,138908,138908,138910,0,2,3
39678,4,3,138912,138912,138915,0,3,2
39679,1,1,138913,138915,138916,2,3,0
39680,6,1,138919,138919,138920,0,1,3
39681,1,2,138920,138920,138922,0,2,0
39682,4,1,138924,138924,138925,0,1,2
39683,4,3,138928,138928,138931,0,3,3
39684,3,1,138931,138931,138932,0,1,0
39685,6,3,138937,138937,138940,0,3,5
39686,3,2,138940,138940,138942,0,2,0
39687,4,2,138944,138944,138946,0,2,2
39688,2,1,138946,138946,138947,0,1,0
39689,4,1,138950,138950,138951,0,1,3
39690,6,3,138956,138956,138959,0,3,5
39691,4,2,138960,138960,138962,0,2,1
39692,2,3,138962,138962,138965,0,3,0
39693,4,1,138966,138966,138967,0,1,1
39694,6,3,138972,138972,138975,0,3,5
39695,1,3,138973,138975,138978,2,5,0
39696,1,2,138974,138978,138980,4,6,0
39697,4,2,138978,138980,138982,2,4,0
39698,2,3,138980,138982,138985,2,5,0
39699,5,3,138985,138985,138988,0,3,0
39700,3,2,138988,138988,138990,0,2,0
39701,1,2,138989,138990,138992,1,3,0
39702,4,2,138993,138993,138995,0,2,1
39703,5,2,138998,138998,139000,0,2,3
39704,2,2,139000,139000,139002,0,2,0
39705,2,1,139002,139002,139003,0,1,0
39706,1,1,139003,139003,139004,0,1,0
39707,2,2,139005,139005,139007,0,2,1
39708,6,2,139011,139011,139013,0,2,4
39709,2,1,139013,139013,139014,0,1,0
39710,2,3,139015,139015,139018,0,3,1
39711,4,2,139019,139019,139021,0,2,1
39712,5,2,139024,139024,139026,0,2,3
39713,2,2,139026,139026,139028,0,2,0
39714,3,1,139029,139029,139030,0,1,1
39715,4,2,139033,139033,139035,0,2,3
39716,4,1,139037,139037,139038,0,1,2
39717,6,1,139043,139043,139044,0,1,5
39718,3,2,139046,139046,139048,0,2,2
39719,6,3,139052,139052,139055,0,3,4
39720,5,3,139057,139057,139060,0,3,2
39721,5,2,139062,139062,139064,0,2,2
39722,5,1,139067,139067,139068,0,1,3
39723,1,3,139068,139068,139071,0,3,0
39724,6,1,139074,139074,139075,0,1,3
39725,5,3,139079,139079,139082,0,3,4
39726,4,3,139083,139083,139086,0,3,1
39727,4,2,139087,139087,139089,0,2,1
39728,3,2,139090,139090,139092,0,2,1
39729,2,3,139092,139092,139095,0,3,0
39730,2,1,139094,139095,139096,1,2,0
39731,6,2,139100,139100,139102,0,2,4
39732,4,1,139104,139104,139105,0,1,2
39733,3,2,139107,139107,139109,0,2,2
39734,2,3,139109,139109,139112,0,3,0
39735,4,3,139113,139113,139116,0,3,1
39736,1,2,139114,139116,139118,2,4,0
39737,3,2,139117,139118,139120,1,3,0
39738,1,3,139118,139120,139123,2,5,0
39739,4,2,139122,139123,139125,1,3,0
39740,3,3,139125,139125,139128,0,3,0
39741,2,2,139127,139128,139130,1,3,0
39742,3,3,139130,139130,139133,0,3,0
39743,2,1,139132,139133,139134,1,2,0
39744,2,3,139134,139134,139137,0,3,0
39745,5,1,139139,139139,139140,0,1,2
39746,3,2,139142,139142,139144,0,2,2
39747,6,1,139148,139148,139149,0,1,4
39748,2,3,139150,139150,139153,0,3,1
39749,5,1,139155,139155,139156,0,1,2
39750,5,2,139160,139160,139162,0,2,4
39751,2,2,139162,139162,139164,0,2,0
39752,4,3,139166,139166,139169,0,3,2
39753,1,2,139167,139169,139171,2,4,0
39754,3,3,139170,139171,139174,1,4,0
39755,2,1,139172,139174,139175,2,3,0
39756,2,2,139174,139175,139177,1,3,0
39757,3,2,139177,139177,139179,0,2,0
39758,1,2,139178,139179,139181,1,3,0
39759,3,2,139181,139181,139183,0,2,0
39760,4,1,139185,139185,139186,0,1,2
39761,3,2,139188,139188,139190,0,2,2
39762,6,3,139194,139194,139197,0,3,4
39763,5,1,139199,139199,139200,0,1,2
39764,2,1,139201,139201,139202,0,1,1
39765,2,1,139203,139203,139204,0,1,1
39766,1,3,139204,139204,139207,0,3,0
39767,3,3,139207,139207,139210,0,3,0
39768,6,3,139213,139213,139216,0,3,3
39769,5,1,139218,139218,139219,0,1,2
39770,4,3,139222,139222,139225,0,3,3
39771,5,2,139227,139227,139229,0,2,2
39772,6,3,139233,139233,139236,0,3,4
39773,1,2,139234,139236,139238,2,4,0
39774,6,2,139240,139240,139242,0,2,2
39775,2,1,139242,139242,139243,0,1,0
39776,6,2,139248,139248,139250,0,2,5
39777,5,1,139253,139253,139254,0,1,3
39778,5,2,139258,139258,139260,0,2,4
39779,3,1,139261,139261,139262,0,1,1
39780,6,2,139267,139267,139269,0,2,5
39781,4,2,139271,139271,139273,0,2,2
39782,3,2,139274,139274,139276,0,2,1
39783,4,1,139278,139278,139279,0,1,2
39784,2,3,139280,139280,139283,0,3,1
39785,4,2,139284,139284,139286,0,2,1
39786,2,2,139286,139286,139288,0,2,0
39787,3,3,139289,139289,139292,0,3,1
39788,3,1,139292,139292,139293,0,1,0
39789,2,3,139294,139294,139297,0,3,1
39790,1,3,139295,139297,139300,2,5,0
39791,5,1,139300,139300,139301,0,1,0
39792,5,2,139305,139305,139307,0,2,4
39793,5,3,139310,139310,139313,0,3,3
39794,6,2,139316,139316,139318,0,2,3
39795,6,2,139322,139322,139324,0,2,4
39796,5,1,139327,139327,139328,0,1,3
39797,1,1,139328,139328,139329,0,1,0
39798,4,2,139332,139332,139334,0,2,3
39799,6,3,139338,139338,139341,0,3,4
39800,1,1,139339,139341,139342,2,3,0
39801,3,2,139342,139342,139344,0,2,0
39802,6,3,139348,139348,139351,0,3,4
39803,6,1,139354,139354,139355,0,1,3
39804,4,1,139358,139358,139359,0,1,3
39805,1,2,139359,139359,139361,0,2,0
39806,2,2,139361,139361,139363,0,2,0
39807,3,2,139364,139364,139366,0,2,1
39808,3,1,139367,139367,139368,0,1,1
39809,1,2,139368,139368,139370,0,2,0
39810,2,3,139370,139370,139373,0,3,0
39811,4,2,139374,139374,139376,0,2,1
39812,1,3,139375,139376,139379,1,4,0
39813,5,1,139380,139380,139381,0,1,1
39814,1,2,139381,139381,139383,0,2,0
39815,1,1,139382,139383,139384,1,2,0
39816,6,1,139388,139388,139389,0,1,4
39817,1,1,139389,139389,139390,0,1,0
39818,3,1,139392,139392,139393,0,1,2
39819,1,3,139393,139393,139396,0,3,0
39820,1,3,139394,139396,139399,2,5,0
39821,3,2,139397,139399,139401,2,4,0
39822,5,1,139402,139402,139403,0,1,1
39823,1,1,139403,139403,139404,0,1,0
39824,4,1,139407,139407,139408,0,1,3
39825,6,2,139413,139413,139415,0,2,5
39826,1,2,139414,139415,139417,1,3,0
39827,4,2,139418,139418,139420,0,2,1
39828,6,2,139424,139424,139426,0,2,4
39829,5,2,139429,139429,139431,0,2,3
39830,1,3,139430,139431,139434,1,4,0
39831,2,3,139432,139434,139437,2,5,0
39832,5,1,139437,139437,139438,0,1,0
39833,1,3,139438,139438,139441,0,3,0
39834,4,2,139442,139442,139444,0,2,1
39835,5,3,139447,139447,139450,0,3,3
39836,4,2,139451,139451,139453,0,2,1
39837,3,1,139454,139454,139455,0,1,1
39838,2,2,139456,139456,139458,0,2,1
39839,3,1,139459,139459,139460,0,1,1
39840,4,1,139463,139463,139464,0,1,3
39841,5,3,139468,139468,139471,0,3,4
39842,4,1,139472,139472,139473,0,1,1
39843,4,1,139476,139476,139477,0,1,3
39844,5,2,139481,139481,139483,0,2,4
39845,6,2,139487,139487,139489,0,2,4
39846,2,2,139489,139489,139491,0,2,0
39847,3,2,139492,139492,139494,0,2,1
39848,6,2,139498,139498,139500,0,2,4
39849,4,2,139502,139502,139504,0,2,2
39850,4,3,139506,139506,139509,0,3,2
39851,3,3,139509,139509,139512,0,3,0
39852,4,2,139513,139513,139515,0,2,1
39853,5,2,139518,139518,139520,0,2,3
39854,6,2,139524,139524,139526,0,2,4
39855,1,1,139525,139526,139527,1,2,0
39856,4,1,139529,139529,139530,0,1,2
39857,1,2,139530,139530,139532,0,2,0
39858,5,3,139535,139535,139538,0,3,3
39859,5,2,139540,139540,139542,0,2,2
39860,4,3,139544,139544,139547,0,3,2
39861,1,1,139545,139547,139548,2,3,0
39862,2,2,139547,139548,139550,1,3,0
39863,6,2,139553,139553,139555,0,2,3
39864,4,2,139557,139557,139559,0,2,2
39865,3,2,139560,139560,139562,0,2,1
39866,4,3,139564,139564,139567,0,3,2
39867,5,3,139569,139569,139572,0,3,2
39868,5,2,139574,139574,139576,0,2,2
39869,3,1,139577,139577,139578,0,1,1
39870,2,1,139579,139579,139580,0,1,1
39871,4,2,139583,139583,139585,0,2,3
39872,4,3,139587,139587,139590,0,3,2
39873,3,3,139590,139590,139593,0,3,0
39874,3,2,139593,139593,139595,0,2,0
39875,1,2,139594,139595,139597,1,3,0
39876,4,3,139598,139598,139601,0,3,1
39877,2,2,139600,139601,139603,1,3,0
39878,6,1,139606,139606,139607,0,1,3
39879,1,3,139607,139607,139610,0,3,0
39880,3,3,139610,139610,139613,0,3,0
39881,1,1,139611,139613,139614,2,3,0
39882,4,3,139615,139615,139618,0,3,1
39883,1,3,139616,139618,139621,2,5,0
39884,6,2,139622,139622,139624,0,2,1
39885,4,1,139626,139626,139627,0,1,2
39886,3,2,139629,139629,139631,0,2,2
39887,1,3,139630,139631,139634,1,4,0
39888,1,2,139631,139634,139636,3,5,0
39889,6,1,139637,139637,139638,0,1,1
39890,5,2,139642,139642,139644,0,2,4
39891,4,3,139646,139646,139649,0,3,2
39892,2,3,139648,139649,139652,1,4,0
39893,5,3,139653,139653,139656,0,3,1
39894,5,3,139658,139658,139661,0,3,2
39895,1,2,139659,139661,139663,2,4,0
39896,5,3,139664,139664,139667,0,3,1
39897,1,1,139665,139667,139668,2,3,0
39898,6,2,139671,139671,139673,0,2,3
39899,2,2,139673,139673,139675,0,2,0
39900,4,2,139677,139677,139679,0,2,2
39901,2,3,139679,139679,139682,0,3,0
39902,6,2,139685,139685,139687,0,2,3
39903,6,1,139691,139691,139692,0,1,4
39904,6,3,139697,139697,139700,0,3,5
39905,2,1,139699,139700,139701,1,2,0
39906,5,1,139704,139704,139705,0,1,3
39907,4,3,139708,139708,139711,0,3,3
39908,1,1,139709,139711,139712,2,3,0
39909,5,2,139714,139714,139716,0,2,2
39910,5,1,139719,139719,139720,0,1,3
39911,6,1,139725,139725,139726,0,1,5
39912,4,2,139729,139729,139731,0,2,3
39913,2,2,139731,139731,139733,0,2,0
39914,1,1,139732,139733,139734,1,2,0
39915,3,1,139735,139735,139736,0,1,1
39916,5,1,139740,139740,139741,0,1,4
39917,6,2,139746,139746,139748,0,2,5
39918,2,3,139748,139748,139751,0,3,0
39919,5,3,139753,139753,139756,0,3,2
39920,1,3,139754,139756,139759,2,5,0
39921,5,1,139759,139759,139760,0,1,0
39922,3,2,139762,139762,139764,0,2,2
39923,3,1,139765,139765,139766,0,1,1
39924,5,1,139770,139770,139771,0,1,4
39925,2,1,139772,139772,139773,0,1,1
39926,1,3,139773,139773,139776,0,3,0
39927,4,3,139777,139777,139780,0,3,1
39928,2,3,139779,139780,139783,1,4,0
39929,1,2,139780,139783,139785,3,5,0
39930,1,1,139781,139785,139786,4,5,0
39931,4,2,139785,139786,139788,1,3,0
39932,3,3,139788,139788,139791,0,3,0
39933,3,3,139791,139791,139794,0,3,0
39934,3,2,139794,139794,139796,0,2,0
39935,5,2,139799,139799,139801,0,2,3
39936,1,1,139800,139801,139802,1,2,0
39937,6,1,139806,139806,139807,0,1,4
39938,5,3,139811,139811,139814,0,3,4
39939,3,3,139814,139814,139817,0,3,0
39940,5,2,139819,139819,139821,0,2,2
39941,3,2,139822,139822,139824,0,2,1
39942,4,3,139826,139826,139829,0,3,2
39943,4,3,139830,139830,139833,0,3,1
39944,2,2,139832,139833,139835,1,3,0
39945,1,1,139833,139835,139836,2,3,0
39946,4,3,139837,139837,139840,0,3,1
39947,1,3,139838,139840,139843,2,5,0
39948,5,3,139843,139843,139846,0,3,0
39949,1,2,139844,139846,139848,2,4,0
39950,1,3,139845,139848,139851,3,6,0
39951,2,3,139847,139851,139854,4,7,0
39952,5,3,139852,139854,139857,2,5,0
39953,4,2,139856,139857,139859,1,3,0
39954,3,1,139859,139859,139860,0,1,0
39955,1,1,139860,139860,139861,0,1,0
39956,6,2,139866,139866,139868,0,2,5
39957,2,2,139868,139868,139870,0,2,0
39958,2,2,139870,139870,139872,0,2,0
39959,5,3,139875,139875,139878,0,3,3
39960,6,2,139881,139881,139883,0,2,3
39961,6,2,139887,139887,139889,0,2,4
39962,3,2,139890,139890,139892,0,2,1
39963,1,3,139891,139892,139895,1,4,0
39964,5,3,139896,139896,139899,0,3,1
39965,5,1,139901,139901,139902,0,1,2
39966,5,3,139906,139906,139909,0,3,4
39967,2,3,139908,139909,139912,1,4,0
39968,6,2,139914,139914,139916,0,2,2
39969,5,2,139919,139919,139921,0,2,3
39970,4,2,139923,139923,139925,0,2,2
39971,4,3,139927,139927,139930,0,3,2
39972,2,3,139929,139930,139933,1,4,0
39973,2,2,139931,139933,139935,2,4,0
39974,2,2,139933,139935,139937,2,4,0
39975,2,2,139935,139937,139939,2,4,0
39976,4,3,139939,139939,139942,0,3,0
39977,6,1,139945,139945,139946,0,1,3
39978,1,1,139946,139946,139947,0,1,0
39979,6,1,139952,139952,139953,0,1,5
39980,5,2,139957,139957,139959,0,2,4
39981,1,3,139958,139959,139962,1,4,0
39982,3,3,139961,139962,139965,1,4,0
39983,5,3,139966,139966,139969,0,3,1
39984,4,2,139970,139970,139972,0,2,1
39985,2,2,139972,139972,139974,0,2,0
39986,4,3,139976,139976,139979,0,3,2
39987,1,2,139977,139979,139981,2,4,0
39988,1,2,139978,139981,139983,3,5,0
39989,4,1,139982,139983,139984,1,2,0
39990,2,3,139984,139984,139987,0,3,0
39991,2,3,139986,139987,139990,1,4,0
39992,6,2,139992,139992,139994,0,2,2
39993,1,3,139993,139994,139997,1,4,0
39994,3,1,139996,139997,139998,1,2,0
39995,2,3,139998,139998,140001,0,3,0
39996,3,1,140001,140001,140002,0,1,0
39997,3,3,140004,140004,140007,0,3,2
39998,4,1,140008,140008,140009,0,1,1
39999,6,1,140014,140014,140015,0,1,5
40000,6,2,140020,140020,140022,0,2,5
40001,3,1,140023,140023,140024,0,1,1
40002,6,3,140029,140029,140032,0,3,5
40003,5,1,140034,140034,140035,0,1,2
40004,2,3,140036,140036,140039,0,3,1
40005,3,3,140039,140039,140042,0,3,0
40006,4,1,140043,140043,140044,0,1,1
40007,5,1,140048,140048,140049,0,1,4
40008,1,3,140049,140049,140052,0,3,0
40009,4,2,140053,140053,140055,0,2,1
40010,6,2,140059,140059,140061,0,2,4
40011,1,2,140060,140061,140063,1,3,0
40012,4,2,140064,140064,140066,0,2,1
40013,3,3,140067,140067,140070,0,3,1
40014,4,3,140071,140071,140074,0,3,1
40015,3,3,140074,140074,140077,0,3,0
40016,1,3,140075,140077,140080,2,5,0
40017,3,1,140078,140080,140081,2,3,0
40018,5,1,140083,140083,140084,0,1,2
40019,6,3,140089,140089,140092,0,3,5
40020,5,3,140094,140094,140097,0,3,2
40021,4,1,140098,140098,140099,0,1,1
40022,3,1,140101,140101,140102,0,1,2
40023,2,1,140103,140103,140104,0,1,1
40024,5,2,140108,140108,140110,0,2,4
40025,2,2,140110,140110,140112,0,2,0
40026,2,3,140112,140112,140115,0,3,0
40027,3,1,140115,140115,140116,0,1,0
40028,3,2,140118,140118,140120,0,2,2
40029,1,2,140119,140120,140122,1,3,0
40030,1,3,140120,140122,140125,2,5,0
40031,5,2,140125,140125,140127,0,2,0
40032,4,1,140129,140129,140130,0,1,2
40033,5,1,140134,140134,140135,0,1,4
40034,3,3,140137,140137,140140,0,3,2
40035,1,3,140138,140140,140143,2,5,0
40036,4,3,140142,140143,140146,1,4,0
40037,4,2,140146,140146,140148,0,2,0
40038,1,3,140147,140148,140151,1,4,0
40039,6,1,140153,140153,140154,0,1,2
40040,3,1,140156,140156,140157,0,1,2
40041,1,3,140157,140157,140160,0,3,0
40042,5,3,140162,140162,140165,0,3,2
40043,2,1,140164,140165,140166,1,2,0
40044,2,3,140166,140166,140169,0,3,0
40045,1,2,140167,140169,140171,2,4,0
40046,5,3,140172,140172,140175,0,3,1
40047,6,1,140178,140178,140179,0,1,3
40048,1,2,140179,140179,140181,0,2,0
40049,3,3,140182,140182,140185,0,3,1
40050,2,3,140184,140185,140188,1,4,0
40051,4,3,140188,140188,140191,0,3,0
40052,6,2,140194,140194,140196,0,2,3
40053,1,1,140195,140196,140197,1,2,0
40054,1,3,140196,140197,140200,1,4,0
40055,6,1,140202,140202,140203,0,1,2
40056,3,2,140205,140205,140207,0,2,2
40057,4,1,140209,140209,140210,0,1,2
40058,3,1,140212,140212,140213,0,1,2
40059,4,3,140216,140216,140219,0,3,3
40060,4,1,140220,140220,140221,0,1,1
40061,5,2,140225,140225,140227,0,2,4
40062,4,3,140229,140229,140232,0,3,2
40063,5,2,140234,140234,140236,0,2,2
40064,3,1,140237,140237,140238,0,1,1
40065,1,2,140238,140238,140240,0,2,0
40066,3,3,140241,140241,140244,0,3,1
40067,3,3,140244,140244,140247,0,3,0
40068,5,2,140249,140249,140251,0,2,2
40069,3,1,140252,140252,140253,0,1,1
40070,6,2,140258,140258,140260,0,2,5
40071,6,1,140264,140264,140265,0,1,4
40072,6,3,140270,140270,140273,0,3,5
40073,3,1,140273,140273,140274,0,1,0
40074,4,1,140277,140277,140278,0,1,3
40075,3,3,140280,140280,140283,0,3,2
40076,4,1,140284,140284,140285,0,1,1
40077,6,1,140290,140290,140291,0,1,5
40078,5,2,140295,140295,140297,0,2,4
40079,4,2,140299,140299,140301,0,2,2
40080,4,3,140303,140303,140306,0,3,2
40081,2,3,140305,140306,140309,1,4,0
40082,2,2,140307,140309,140311,2,4,0
40083,4,2,140311,140311,140313,0,2,0
40084,3,1,140314,140314,140315,0,1,1
40085,4,1,140318,140318,140319,0,1,3
40086,6,3,140324,140324,140327,0,3,5
40087,1,3,140325,140327,140330,2,5,0
40088,3,3,140328,140330,140333,2,5,0
40089,4,2,140332,140333,140335,1,3,0
40090,1,3,140333,140335,140338,2,5,0
40091,4,2,140337,140338,140340,1,3,0
40092,3,1,140340,140340,140341,0,1,0
40093,1,3,140341,140341,140344,0,3,0
40094,5,1,140346,140346,140347,0,1,2
40095,2,1,140348,140348,140349,0,1,1
40096,6,3,140354,140354,140357,0,3,5
40097,1,1,140355,140357,140358,2,3,0
40098,3,1,140358,140358,140359,0,1,0
40099,4,3,140362,140362,140365,0,3,3
40100,1,1,140363,140365,140366,2,3,0
40101,5,1,140368,140368,140369,0,1,2
40102,4,1,140372,140372,140373,0,1,3
40103,6,3,140378,140378,140381,0,3,5
40104,2,3,140380,140381,140384,1,4,0
40105,6,2,140386,140386,140388,0,2,2
40106,3,1,140389,140389,140390,0,1,1
40107,5,3,140394,140394,140397,0,3,4
40108,6,2,140400,140400,140402,0,2,3
40109,4,2,140404,140404,140406,0,2,2
40110,1,2,140405,140406,140408,1,3,0
40111,5,2,140410,140410,140412,0,2,2
40112,2,2,140412,140412,140414,0,2,0
40113,5,3,140417,140417,140420,0,3,3
40114,1,2,140418,140420,140422,2,4,0
40115,2,3,140420,140422,140425,2,5,0
40116,6,3,140426,140426,140429,0,3,1
40117,1,1,140427,140429,140430,2,3,0
40118,2,2,140429,140430,140432,1,3,0
40119,4,2,140433,140433,140435,0,2,1
40120,3,1,140436,140436,140437,0,1,1
40121,1,3,140437,140437,140440,0,3,0
40122,6,2,140443,140443,140445,0,2,3
40123,4,3,140447,140447,140450,0,3,2
40124,5,1,140452,140452,140453,0,1,2
40125,6,2,140458,140458,140460,0,2,5
40126,1,2,140459,140460,140462,1,3,0
40127,6,1,140465,140465,140466,0,1,3
40128,5,1,140470,140470,140471,0,1,4
40129,4,1,140474,140474,140475,0,1,3
40130,5,3,140479,140479,140482,0,3,4
40131,4,3,140483,140483,140486,0,3,1
40132,1,2,140484,140486,140488,2,4,0
40133,2,3,140486,140488,140491,2,5,0
40134,3,3,140489,140491,140494,2,5,0
40135,6,3,140495,140495,140498,0,3,1
40136,1,3,140496,140498,140501,2,5,0
40137,5,1,140501,140501,140502,0,1,0
40138,4,1,140505,140505,140506,0,1,3
40139,5,1,140510,140510,140511,0,1,4
40140,4,3,140514,140514,140517,0,3,3
40141,6,3,140520,140520,140523,0,3,3
40142,4,1,140524,140524,140525,0,1,1
40143,1,2,140525,140525,140527,0,2,0
40144,6,2,140531,140531,140533,0,2,4
40145,4,1,140535,140535,140536,0,1,2
40146,4,2,140539,140539,140541,0,2,3
40147,5,1,140544,140544,140545,0,1,3
40148,2,2,140546,140546,140548,0,2,1
40149,5,3,140551,140551,140554,0,3,3
40150,1,1,140552,140554,140555,2,3,0
40151,4,3,140556,140556,140559,0,3,1
40152,6,3,140562,140562,140565,0,3,3
40153,6,2,140568,140568,140570,0,2,3
40154,1,3,140569,140570,140573,1,4,0
40155,3,2,140572,140573,140575,1,3,0
40156,5,1,140577,140577,140578,0,1,2
40157,2,1,140579,140579,140580,0,1,1
40158,1,2,140580,140580,140582,0,2,0
40159,5,1,140585,140585,140586,0,1,3
40160,6,3,140591,140591,140594,0,3,5
40161,1,1,140592,140594,140595,2,3,0
40162,2,3,140594,140595,140598,1,4,0
40163,5,1,140599,140599,140600,0,1,1
40164,3,3,140602,140602,140605,0,3,2
40165,4,1,140606,140606,140607,0,1,1
40166,2,3,140608,140608,140611,0,3,1
40167,3,1,140611,140611,140612,0,1,0
40168,5,2,140616,140616,140618,0,2,4
40169,6,1,140622,140622,140623,0,1,4
40170,3,1,140625,140625,140626,0,1,2
40171,6,2,140631,140631,140633,0,2,5
40172,3,3,140634,140634,140637,0,3,1
40173,2,1,140636,140637,140638,1,2,0
40174,5,1,140641,140641,140642,0,1,3
40175,6,1,140647,140647,140648,0,1,5
40176,6,3,140653,140653,140656,0,3,5
40177,5,3,140658,140658,140661,0,3,2
40178,1,1,140659,140661,140662,2,3,0
40179,2,2,140661,140662,140664,1,3,0
40180,2,3,140663,140664,140667,1,4,0
40181,4,2,140667,140667,140669,0,2,0
40182,4,2,140671,140671,140673,0,2,2
40183,2,3,140673,140673,140676,0,3,0
40184,1,1,140674,140676,140677,2,3,0
40185,1,1,140675,140677,140678,2,3,0
40186,3,3,140678,140678,140681,0,3,0
40187,2,3,140680,140681,140684,1,4,0
40188,3,2,140683,140684,140686,1,3,0
40189,6,3,140689,140689,140692,0,3,3
40190,2,2,140691,140692,140694,1,3,0
40191,6,1,140697,140697,140698,0,1,3
40192,2,2,140699,140699,140701,0,2,1
40193,3,2,140702,140702,140704,0,2,1
40194,5,1,140707,140707,140708,0,1,3
40195,6,2,140713,140713,140715,0,2,5
40196,1,2,140714,140715,140717,1,3,0
40197,3,2,140717,140717,140719,0,2,0
40198,3,3,140720,140720,140723,0,3,1
40199,5,1,140725,140725,140726,0,1,2
40200,4,1,140729,140729,140730,0,1,3
40201,4,1,140733,140733,140734,0,1,3
40202,2,2,140735,140735,140737,0,2,1
40203,6,2,140741,140741,140743,0,2,4
40204,3,2,140744,140744,140746,0,2,1
40205,3,2,140747,140747,140749,0,2,1
40206,5,2,140752,140752,140754,0,2,3
40207,1,2,140753,140754,140756,1,3,0
40208,3,2,140756,140756,140758,0,2,0
40209,3,1,140759,140759,140760,0,1,1
40210,3,2,140762,140762,140764,0,2,2
40211,4,3,140766,140766,140769,0,3,2
40212,1,3,140767,140769,140772,2,5,0
40213,4,2,140771,140772,140774,1,3,0
40214,2,1,140773,140774,140775,1,2,0
40215,2,3,140775,140775,140778,0,3,0
40216,6,3,140781,140781,140784,0,3,3
40217,5,2,140786,140786,140788,0,2,2
40218,1,3,140787,140788,140791,1,4,0
40219,3,1,140790,140791,140792,1,2,0
40220,5,1,140795,140795,140796,0,1,3
40221,2,2,140797,140797,140799,0,2,1
40222,1,2,140798,140799,140801,1,3,0
40223,2,1,140800,140801,140802,1,2,0
40224,6,1,140806,140806,140807,0,1,4
40225,5,1,140811,140811,140812,0,1,4
40226,6,2,140817,140817,140819,0,2,5
40227,1,2,140818,140819,140821,1,3,0
40228,5,2,140823,140823,140825,0,2,2
40229,1,1,140824,140825,140826,1,2,0
40230,2,2,140826,140826,140828,0,2,0
40231,5,2,140831,140831,140833,0,2,3
40232,1,2,140832,140833,140835,1,3,0
40233,4,3,140836,140836,140839,0,3,1
40234,6,2,140842,140842,140844,0,2,3
40235,3,2,140845,140845,140847,0,2,1
40236,2,2,140847,140847,140849,0,2,0
40237,1,3,140848,140849,140852,1,4,0
40238,2,2,140850,140852,140854,2,4,0
40239,2,2,140852,140854,140856,2,4,0
40240,1,3,140853,140856,140859,3,6,0
40241,2,3,140855,140859,140862,4,7,0
40242,5,2,140860,140862,140864,2,4,0
40243,1,3,140861,140864,140867,3,6,0
40244,5,3,140866,140867,140870,1,4,0
40245,6,2,140872,140872,140874,0,2,2
40246,3,1,140875,140875,140876,0,1,1
40247,3,2,140878,140878,140880,0,2,2
40248,2,2,140880,140880,140882,0,2,0
40249,4,3,140884,140884,140887,0,3,2
40250,6,1,140890,140890,140891,0,1,3
40251,1,2,140891,140891,140893,0,2,0
40252,4,2,140895,140895,140897,0,2,2
40253,1,1,140896,140897,140898,1,2,0
40254,3,1,140899,140899,140900,0,1,1
40255,4,3,140903,140903,140906,0,3,3
40256,6,3,140909,140909,140912,0,3,3
40257,5,1,140914,140914,140915,0,1,2
40258,6,1,140920,140920,140921,0,1,5
40259,4,2,140924,140924,140926,0,2,3
40260,6,2,140930,140930,140932,0,2,4
40261,6,3,140936,140936,140939,0,3,4
40262,6,3,140942,140942,140945,0,3,3
40263,4,1,140946,140946,140947,0,1,1
40264,6,1,140952,140952,140953,0,1,5
40265,1,1,140953,140953,140954,0,1,0
40266,6,3,140959,140959,140962,0,3,5
40267,2,2,140961,140962,140964,1,3,0
40268,4,2,140965,140965,140967,0,2,1
40269,3,1,140968,140968,140969,0,1,1
40270,5,2,140973,140973,140975,0,2,4
40271,6,3,140979,140979,140982,0,3,4
40272,6,2,140985,140985,140987,0,2,3
40273,2,3,140987,140987,140990,0,3,0
40274,3,3,140990,140990,140993,0,3,0
40275,6,2,140996,140996,140998,0,2,3
40276,2,3,140998,140998,141001,0,3,0
40277,5,2,141003,141003,141005,0,2,2
40278,6,1,141009,141009,141010,0,1,4
40279,2,3,141011,141011,141014,0,3,1
40280,3,3,141014,141014,141017,0,3,0
40281,5,3,141019,141019,141022,0,3,2
40282,5,3,141024,141024,141027,0,3,2
40283,3,2,141027,141027,141029,0,2,0
40284,1,1,141028,141029,141030,1,2,0
40285,2,3,141030,141030,141033,0,3,0
40286,4,1,141034,141034,141035,0,1,1
40287,1,1,141035,141035,141036,0,1,0
40288,1,2,141036,141036,141038,0,2,0
40289,3,1,141039,141039,141040,0,1,1
40290,6,2,141045,141045,141047,0,2,5
40291,6,2,141051,141051,141053,0,2,4
40292,4,3,141055,141055,141058,0,3,2
40293,1,3,141056,141058,141061,2,5,0
40294,6,2,141062,141062,141064,0,2,1
40295,6,1,141068,141068,141069,0,1,4
40296,5,1,141073,141073,141074,0,1,4
40297,1,3,141074,141074,141077,0,3,0
40298,2,1,141076,141077,141078,1,2,0
40299,5,2,141081,141081,141083,0,2,3
40300,1,2,141082,141083,141085,1,3,0
40301,3,2,141085,141085,141087,0,2,0
40302,4,3,141089,141089,141092,0,3,2
40303,2,1,141091,141092,141093,1,2,0
40304,4,2,141095,141095,141097,0,2,2
40305,3,3,141098,141098,141101,0,3,1
40306,6,2,141104,141104,141106,0,2,3
40307,6,2,141110,141110,141112,0,2,4
40308,5,3,141115,141115,141118,0,3,3
40309,6,2,141121,141121,141123,0,2,3
40310,1,1,141122,141123,141124,1,2,0
40311,1,2,141123,141124,141126,1,3,0
40312,6,3,141129,141129,141132,0,3,3
40313,3,1,141132,141132,141133,0,1,0
40314,3,2,141135,141135,141137,0,2,2
40315,6,2,141141,141141,141143,0,2,4
40316,4,1,141145,141145,141146,0,1,2
40317,3,2,141148,141148,141150,0,2,2
40318,4,1,141152,141152,141153,0,1,2
40319,6,2,141158,141158,141160,0,2,5
40320,3,2,141161,141161,141163,0,2,1
40321,1,2,141162,141163,141165,1,3,0
40322,6,2,141168,141168,141170,0,2,3
40323,1,2,141169,141170,141172,1,3,0
40324,3,2,141172,141172,141174,0,2,0
40325,5,1,141177,141177,141178,0,1,3
40326,1,1,141178,141178,141179,0,1,0
40327,2,1,141180,141180,141181,0,1,1
40328,6,1,141186,141186,141187,0,1,5
40329,4,1,141190,141190,141191,0,1,3
40330,2,1,141192,141192,141193,0,1,1
40331,5,3,141197,141197,141200,0,3,4
40332,4,3,141201,141201,141204,0,3,1
40333,4,2,141205,141205,141207,0,2,1
40334,1,3,141206,141207,141210,1,4,0
40335,2,2,141208,141210,141212,2,4,0
40336,2,3,141210,141212,141215,2,5,0
40337,4,3,141214,141215,141218,1,4,0
40338,6,3,141220,141220,141223,0,3,2
40339,4,2,141224,141224,141226,0,2,1
40340,4,2,141228,141228,141230,0,2,2
40341,5,1,141233,141233,141234,0,1,3
40342,6,2,141239,141239,141241,0,2,5
40343,5,1,141244,141244,141245,0,1,3
40344,2,1,141246,141246,141247,0,1,1
40345,5,3,141251,141251,141254,0,3,4
40346,2,1,141253,141254,141255,1,2,0
40347,1,2,141254,141255,141257,1,3,0
40348,1,1,141255,141257,141258,2,3,0
40349,2,3,141257,141258,141261,1,4,0
40350,3,3,141260,141261,141264,1,4,0
40351,6,2,141266,141266,141268,0,2,2
40352,6,1,141272,141272,141273,0,1,4
40353,6,3,141278,141278,141281,0,3,5
40354,4,2,141282,141282,141284,0,2,1
40355,4,2,141286,141286,141288,0,2,2
40356,3,2,141289,141289,141291,0,2,1
40357,3,2,141292,141292,141294,0,2,1
40358,4,3,141296,141296,141299,0,3,2
40359,3,1,141299,141299,141300,0,1,0
40360,6,2,141305,141305,141307,0,2,5
40361,6,3,141311,141311,141314,0,3,4
40362,4,2,141315,141315,141317,0,2,1
40363,6,2,141321,141321,141323,0,2,4
40364,6,3,141327,141327,141330,0,3,4
40365,2,2,141329,141330,141332,1,3,0
40366,6,2,141335,141335,141337,0,2,3
40367,3,3,141338,141338,141341,0,3,1
40368,1,3,141339,141341,141344,2,5,0
40369,5,2,141344,141344,141346,0,2,0
40370,6,3,141350,141350,141353,0,3,4
40371,5,1,141355,141355,141356,0,1,2
40372,1,2,141356,141356,141358,0,2,0
40373,4,1,141360,141360,141361,0,1,2
40374,1,3,141361,141361,141364,0,3,0
40375,5,2,141366,141366,141368,0,2,2
40376,3,3,141369,141369,141372,0,3,1
40377,6,1,141375,141375,141376,0,1,3
40378,2,1,141377,141377,141378,0,1,1
40379,4,3,141381,141381,141384,0,3,3
40380,4,1,141385,141385,141386,0,1,1
40381,4,1,141389,141389,141390,0,1,3
40382,2,2,141391,141391,141393,0,2,1
40383,6,1,141397,141397,141398,0,1,4
40384,3,3,141400,141400,141403,0,3,2
40385,6,3,141406,141406,141409,0,3,3
40386,1,3,141407,141409,141412,2,5,0
40387,6,2,141413,141413,141415,0,2,1
40388,6,2,141419,141419,141421,0,2,4
40389,5,1,141424,141424,141425,0,1,3
40390,1,1,141425,141425,141426,0,1,0
40391,6,1,141431,141431,141432,0,1,5
40392,2,2,141433,141433,141435,0,2,1
40393,2,3,141435,141435,141438,0,3,0
40394,5,1,141440,141440,141441,0,1,2
40395,5,1,141445,141445,141446,0,1,4
40396,5,2,141450,141450,141452,0,2,4
40397,6,1,141456,141456,141457,0,1,4
40398,1,3,141457,141457,141460,0,3,0
40399,4,3,141461,141461,141464,0,3,1
40400,1,1,141462,141464,141465,2,3,0
40401,5,3,141467,141467,141470,0,3,2
40402,2,3,141469,141470,141473,1,4,0
40403,6,3,141475,141475,141478,0,3,2
40404,4,2,141479,141479,141481,0,2,1
40405,3,3,141482,141482,141485,0,3,1
40406,3,2,141485,141485,141487,0,2,0
40407,6,2,141491,141491,141493,0,2,4
40408,1,1,141492,141493,141494,1,2,0
40409,5,3,141497,141497,141500,0,3,3
40410,3,3,141500,141500,141503,0,3,0
40411,1,2,141501,141503,141505,2,4,0
40412,2,1,141503,141505,141506,2,3,0
40413,6,2,141509,141509,141511,0,2,3
40414,4,3,141513,141513,141516,0,3,2
40415,1,1,141514,141516,141517,2,3,0
40416,6,2,141520,141520,141522,0,2,3
40417,3,3,141523,141523,141526,0,3,1
40418,6,1,141529,141529,141530,0,1,3
40419,1,1,141530,141530,141531,0,1,0
40420,1,1,141531,141531,141532,0,1,0
40421,1,2,141532,141532,141534,0,2,0
40422,3,3,141535,141535,141538,0,3,1
40423,5,3,141540,141540,141543,0,3,2
40424,1,3,141541,141543,141546,2,5,0
40425,3,3,141544,141546,141549,2,5,0
40426,1,1,141545,141549,141550,4,5,0
40427,5,3,141550,141550,141553,0,3,0
40428,6,3,141556,141556,141559,0,3,3
40429,6,1,141562,141562,141563,0,1,3
40430,5,3,141567,141567,141570,0,3,4
40431,1,2,141568,141570,141572,2,4,0
40432,5,3,141573,141573,141576,0,3,1
40433,1,3,141574,141576,141579,2,5,0
40434,6,2,141580,141580,141582,0,2,1
40435,2,2,141582,141582,141584,0,2,0
40436,2,2,141584,141584,141586,0,2,0
40437,5,2,141589,141589,141591,0,2,3
40438,6,1,141595,141595,141596,0,1,4
40439,1,1,141596,141596,141597,0,1,0
40440,2,3,141598,141598,141601,0,3,1
40441,1,3,141599,141601,141604,2,5,0
40442,4,3,141603,141604,141607,1,4,0
40443,6,1,141609,141609,141610,0,1,2
40444,3,1,141612,141612,141613,0,1,2
40445,6,3,141618,141618,141621,0,3,5
40446,3,2,141621,141621,141623,0,2,0
40447,3,3,141624,141624,141627,0,3,1
40448,3,3,141627,141627,141630,0,3,0
40449,5,1,141632,141632,141633,0,1,2
40450,4,1,141636,141636,141637,0,1,3
40451,2,3,141638,141638,141641,0,3,1
40452,2,3,141640,141641,141644,1,4,0
40453,3,3,141643,141644,141647,1,4,0
40454,3,3,141646,141647,141650,1,4,0
40455,4,1,141650,141650,141651,0,1,0
40456,4,2,141654,141654,141656,0,2,3
40457,3,3,141657,141657,141660,0,3,1
40458,5,3,141662,141662,141665,0,3,2
40459,3,3,141665,141665,141668,0,3,0
40460,6,2,141671,141671,141673,0,2,3
40461,6,1,141677,141677,141678,0,1,4
40462,2,3,141679,141679,141682,0,3,1
40463,6,2,141685,141685,141687,0,2,3
40464,5,3,141690,141690,141693,0,3,3
40465,1,1,141691,141693,141694,2,3,0
40466,4,2,141695,141695,141697,0,2,1
40467,4,1,141699,141699,141700,0,1,2
40468,6,1,141705,141705,141706,0,1,5
40469,4,3,141709,141709,141712,0,3,3
40470,4,2,141713,141713,141715,0,2,1
40471,1,1,141714,141715,141716,1,2,0
40472,4,1,141718,141718,141719,0,1,2
40473,1,3,141719,141719,141722,0,3,0
40474,3,2,141722,141722,141724,0,2,0
40475,6,1,141728,141728,141729,0,1,4
40476,1,3,141729,141729,141732,0,3,0
40477,5,3,141734,141734,141737,0,3,2
40478,2,1,141736,141737,141738,1,2,0
40479,5,1,141741,141741,141742,0,1,3
40480,2,2,141743,141743,141745,0,2,1
40481,6,3,141749,141749,141752,0,3,4
40482,3,3,141752,141752,141755,0,3,0
40483,5,1,141757,141757,141758,0,1,2
40484,5,2,141762,141762,141764,0,2,4
40485,1,3,141763,141764,141767,1,4,0
40486,2,2,141765,141767,141769,2,4,0
40487,2,3,141767,141769,141772,2,5,0
40488,6,2,141773,141773,141775,0,2,1
40489,6,1,141779,141779,141780,0,1,4
40490,5,3,141784,141784,141787,0,3,4
40491,6,1,141790,141790,141791,0,1,3
40492,1,3,141791,141791,141794,0,3,0
40493,5,3,141796,141796,141799,0,3,2
40494,4,2,141800,141800,141802,0,2,1
40495,3,2,141803,141803,141805,0,2,1
40496,4,3,141807,141807,141810,0,3,2
40497,6,1,141813,141813,141814,0,1,3
40498,2,2,141815,141815,141817,0,2,1
40499,6,1,141821,141821,141822,0,1,4
40500,4,1,141825,141825,141826,0,1,3
40501,2,1,141827,141827,141828,0,1,1
40502,1,2,141828,141828,141830,0,2,0
40503,2,2,141830,141830,141832,0,2,0
40504,5,1,141835,141835,141836,0,1,3
40505,3,2,141838,141838,141840,0,2,2
40506,5,1,141843,141843,141844,0,1,3
40507,6,3,141849,141849,141852,0,3,5
40508,1,2,141850,141852,141854,2,4,0
40509,2,1,141852,141854,141855,2,3,0
40510,4,3,141856,141856,141859,0,3,1
40511,5,3,141861,141861,141864,0,3,2
40512,5,2,141866,141866,141868,0,2,2
40513,6,3,141872,141872,141875,0,3,4
40514,1,3,141873,141875,141878,2,5,0
40515,1,2,141874,141878,141880,4,6,0
40516,6,3,141880,141880,141883,0,3,0
40517,3,1,141883,141883,141884,0,1,0
40518,3,2,141886,141886,141888,0,2,2
40519,1,1,141887,141888,141889,1,2,0
40520,2,3,141889,141889,141892,0,3,0
40521,3,2,141892,141892,141894,0,2,0
40522,4,1,141896,141896,141897,0,1,2
40523,4,1,141900,141900,141901,0,1,3
40524,6,1,141906,141906,141907,0,1,5
40525,1,1,141907,141907,141908,0,1,0
40526,6,3,141913,141913,141916,0,3,5
40527,5,1,141918,141918,141919,0,1,2
40528,4,3,141922,141922,141925,0,3,3
40529,1,2,141923,141925,141927,2,4,0
40530,1,1,141924,141927,141928,3,4,0
40531,2,2,141926,141928,141930,2,4,0
40532,2,1,141928,141930,141931,2,3,0
40533,4,1,141932,141932,141933,0,1,1
40534,5,3,141937,141937,141940,0,3,4
40535,2,2,141939,141940,141942,1,3,0
40536,3,1,141942,141942,141943,0,1,0
40537,1,2,141943,141943,141945,0,2,0
40538,3,1,141946,141946,141947,0,1,1
40539,1,2,141947,141947,141949,0,2,0
40540,2,1,141949,141949,141950,0,1,0
40541,1,3,141950,141950,141953,0,3,0
40542,3,1,141953,141953,141954,0,1,0
40543,4,3,141957,141957,141960,0,3,3
40544,1,1,141958,141960,141961,2,3,0
40545,2,2,141960,141961,141963,1,3,0
40546,4,2,141964,141964,141966,0,2,1
40547,6,3,141970,141970,141973,0,3,4
40548,5,2,141975,141975,141977,0,2,2
40549,5,3,141980,141980,141983,0,3,3
40550,1,3,141981,141983,141986,2,5,0
40551,6,3,141987,141987,141990,0,3,1
40552,1,1,141988,141990,141991,2,3,0
40553,3,1,141991,141991,141992,0,1,0
40554,6,3,141997,141997,142000,0,3,5
40555,4,3,142001,142001,142004,0,3,1
40556,5,3,142006,142006,142009,0,3,2
40557,2,3,142008,142009,142012,1,4,0
40558,3,3,142011,142012,142015,1,4,0
40559,6,3,142017,142017,142020,0,3,2
40560,4,3,142021,142021,142024,0,3,1
40561,2,3,142023,142024,142027,1,4,0
40562,1,3,142024,142027,142030,3,6,0
40563,2,2,142026,142030,142032,4,6,0
40564,5,2,142031,142032,142034,1,3,0
40565,4,3,142035,142035,142038,0,3,1
40566,6,2,142041,142041,142043,0,2,3
40567,6,3,142047,142047,142050,0,3,4
40568,4,3,142051,142051,142054,0,3,1
40569,2,2,142053,142054,142056,1,3,0
40570,1,3,142054,142056,142059,2,5,0
40571,1,2,142055,142059,142061,4,6,0
40572,5,2,142060,142061,142063,1,3,0
40573,6,1,142066,142066,142067,0,1,3
40574,6,2,142072,142072,142074,0,2,5
40575,1,1,142073,142074,142075,1,2,0
40576,1,1,142074,142075,142076,1,2,0
40577,2,2,142076,142076,142078,0,2,0
40578,1,3,142077,142078,142081,1,4,0
40579,1,3,142078,142081,142084,3,6,0
40580,5,2,142083,142084,142086,1,3,0
40581,6,1,142089,142089,142090,0,1,3
40582,5,2,142094,142094,142096,0,2,4
40583,3,3,142097,142097,142100,0,3,1
40584,6,2,142103,142103,142105,0,2,3
40585,2,3,142105,142105,142108,0,3,0
40586,4,2,142109,142109,142111,0,2,1
40587,4,2,142113,142113,142115,0,2,2
40588,2,2,142115,142115,142117,0,2,0
40589,4,1,142119,142119,142120,0,1,2
40590,5,2,142124,142124,142126,0,2,4
40591,1,3,142125,142126,142129,1,4,0
40592,1,2,142126,142129,142131,3,5,0
40593,6,2,142132,142132,142134,0,2,1
40594,2,2,142134,142134,142136,0,2,0
40595,1,2,142135,142136,142138,1,3,0
40596,2,1,142137,142138,142139,1,2,0
40597,1,1,142138,142139,142140,1,2,0
40598,1,3,142139,142140,142143,1,4,0
40599,5,3,142144,142144,142147,0,3,1
40600,2,3,142146,142147,142150,1,4,0
40601,3,1,142149,142150,142151,1,2,0
40602,1,1,142150,142151,142152,1,2,0
40603,3,2,142153,142153,142155,0,2,1
40604,4,2,142157,142157,142159,0,2,2
40605,3,1,142160,142160,142161,0,1,1
40606,5,3,142165,142165,142168,0,3,4
40607,5,3,142170,142170,142173,0,3,2
40608,2,1,142172,142173,142174,1,2,0
40609,1,1,142173,142174,142175,1,2,0
40610,1,3,142174,142175,142178,1,4,0
40611,3,3,142177,142178,142181,1,4,0
40612,4,2,142181,142181,142183,0,2,0
40613,5,2,142186,142186,142188,0,2,3
40614,2,3,142188,142188,142191,0,3,0
40615,6,2,142194,142194,142196,0,2,3
40616,6,3,142200,142200,142203,0,3,4
40617,2,2,142202,142203,142205,1,3,0
40618,3,1,142205,142205,142206,0,1,0
40619,6,3,142211,142211,142214,0,3,5
40620,5,2,142216,142216,142218,0,2,2
40621,4,2,142220,142220,142222,0,2,2
40622,1,2,142221,142222,142224,1,3,0
40623,3,3,142224,142224,142227,0,3,0
40624,2,2,142226,142227,142229,1,3,0
40625,3,2,142229,142229,142231,0,2,0
40626,3,3,142232,142232,142235,0,3,1
40627,1,1,142233,142235,142236,2,3,0
40628,6,3,142239,142239,142242,0,3,3
40629,3,1,142242,142242,142243,0,1,0
40630,5,3,142247,142247,142250,0,3,4
40631,4,1,142251,142251,142252,0,1,1
40632,5,3,142256,142256,142259,0,3,4
40633,5,3,142261,142261,142264,0,3,2
40634,1,2,142262,142264,142266,2,4,0
40635,5,3,142267,142267,142270,0,3,1
40636,6,1,142273,142273,142274,0,1,3
40637,2,3,142275,142275,142278,0,3,1
40638,5,2,142280,142280,142282,0,2,2
40639,2,2,142282,142282,142284,0,2,0
40640,6,3,142288,142288,142291,0,3,4
40641,1,1,142289,142291,142292,2,3,0
40642,6,2,142295,142295,142297,0,2,3
40643,5,2,142300,142300,142302,0,2,3
40644,6,2,142306,142306,142308,0,2,4
40645,6,3,142312,142312,142315,0,3,4
40646,3,3,142315,142315,142318,0,3,0
40647,2,3,142317,142318,142321,1,4,0
40648,5,2,142322,142322,142324,0,2,1
40649,5,2,142327,142327,142329,0,2,3
40650,1,2,142328,142329,142331,1,3,0
40651,2,2,142330,142331,142333,1,3,0
40652,4,3,142334,142334,142337,0,3,1
40653,3,1,142337,142337,142338,0,1,0
40654,5,3,142342,142342,142345,0,3,4
40655,4,2,142346,142346,142348,0,2,1
40656,6,3,142352,142352,142355,0,3,4
40657,1,2,142353,142355,142357,2,4,0
40658,2,3,142355,142357,142360,2,5,0
40659,2,2,142357,142360,142362,3,5,0
40660,2,3,142359,142362,142365,3,6,0
40661,3,1,142362,142365,142366,3,4,0
40662,6,2,142368,142368,142370,0,2,2
40663,4,1,142372,142372,142373,0,1,2
40664,5,3,142377,142377,142380,0,3,4
40665,1,2,142378,142380,142382,2,4,0
40666,6,3,142384,142384,142387,0,3,2
40667,3,3,142387,142387,142390,0,3,0
40668,4,3,142391,142391,142394,0,3,1
40669,6,2,142397,142397,142399,0,2,3
40670,6,1,142403,142403,142404,0,1,4
40671,6,3,142409,142409,142412,0,3,5
40672,6,3,142415,142415,142418,0,3,3
40673,2,2,142417,142418,142420,1,3,0
40674,4,3,142421,142421,142424,0,3,1
40675,3,2,142424,142424,142426,0,2,0
40676,2,1,142426,142426,142427,0,1,0
40677,2,1,142428,142428,142429,0,1,1
40678,4,2,142432,142432,142434,0,2,3
40679,4,3,142436,142436,142439,0,3,2
40680,6,1,142442,142442,142443,0,1,3
40681,2,3,142444,142444,142447,0,3,1
40682,5,1,142449,142449,142450,0,1,2
40683,4,3,142453,142453,142456,0,3,3
40684,4,2,142457,142457,142459,0,2,1
40685,5,1,142462,142462,142463,0,1,3
40686,5,3,142467,142467,142470,0,3,4
40687,3,2,142470,142470,142472,0,2,0
40688,6,2,142476,142476,142478,0,2,4
40689,3,2,142479,142479,142481,0,2,1
40690,1,3,142480,142481,142484,1,4,0
40691,3,2,142483,142484,142486,1,3,0
40692,6,3,142489,142489,142492,0,3,3
40693,1,3,142490,142492,142495,2,5,0
40694,5,2,142495,142495,142497,0,2,0
40695,6,1,142501,142501,142502,0,1,4
40696,2,1,142503,142503,142504,0,1,1
40697,6,2,142509,142509,142511,0,2,5
40698,4,2,142513,142513,142515,0,2,2
40699,5,1,142518,142518,142519,0,1,3
40700,6,3,142524,142524,142527,0,3,5
40701,2,3,142526,142527,142530,1,4,0
40702,5,2,142531,142531,142533,0,2,1
40703,6,2,142537,142537,142539,0,2,4
40704,1,3,142538,142539,142542,1,4,0
40705,4,1,142542,142542,142543,0,1,0
40706,4,3,142546,142546,142549,0,3,3
40707,5,3,142551,142551,142554,0,3,2
40708,4,1,142555,142555,142556,0,1,1
40709,3,1,142558,142558,142559,0,1,2
40710,5,2,142563,142563,142565,0,2,4
40711,3,2,142566,142566,142568,0,2,1
40712,4,3,142570,142570,142573,0,3,2
40713,2,1,142572,142573,142574,1,2,0
40714,2,3,142574,142574,142577,0,3,0
40715,5,2,142579,142579,142581,0,2,2
40716,2,3,142581,142581,142584,0,3,0
40717,4,2,142585,142585,142587,0,2,1
40718,4,2,142589,142589,142591,0,2,2
40719,2,1,142591,142591,142592,0,1,0
40720,4,2,142595,142595,142597,0,2,3
40721,5,1,142600,142600,142601,0,1,3
40722,1,1,142601,142601,142602,0,1,0
40723,6,1,142607,142607,142608,0,1,5
40724,5,3,142612,142612,142615,0,3,4
40725,2,2,142614,142615,142617,1,3,0
40726,6,1,142620,142620,142621,0,1,3
40727,4,2,142624,142624,142626,0,2,3
40728,1,3,142625,142626,142629,1,4,0
40729,6,3,142631,142631,142634,0,3,2
40730,4,3,142635,142635,142638,0,3,1
40731,3,3,142638,142638,142641,0,3,0
40732,3,3,142641,142641,142644,0,3,0
40733,4,2,142645,142645,142647,0,2,1
40734,1,3,142646,142647,142650,1,4,0
40735,5,3,142651,142651,142654,0,3,1
40736,5,1,142656,142656,142657,0,1,2
40737,5,2,142661,142661,142663,0,2,4
40738,3,3,142664,142664,142667,0,3,1
40739,5,1,142669,142669,142670,0,1,2
40740,5,3,142674,142674,142677,0,3,4
40741,4,3,142678,142678,142681,0,3,1
40742,6,1,142684,142684,142685,0,1,3
40743,2,3,142686,142686,142689,0,3,1
40744,5,1,142691,142691,142692,0,1,2
40745,3,3,142694,142694,142697,0,3,2
40746,6,3,142700,142700,142703,0,3,3
40747,2,2,142702,142703,142705,1,3,0
40748,1,3,142703,142705,142708,2,5,0
40749,3,2,142706,142708,142710,2,4,0
40750,1,2,142707,142710,142712,3,5,0
40751,3,3,142710,142712,142715,2,5,0
40752,4,1,142714,142715,142716,1,2,0
40753,2,1,142716,142716,142717,0,1,0
40754,1,3,142717,142717,142720,0,3,0
40755,5,2,142722,142722,142724,0,2,2
40756,5,1,142727,142727,142728,0,1,3
40757,3,3,142730,142730,142733,0,3,2
40758,4,3,142734,142734,142737,0,3,1
40759,5,3,142739,142739,142742,0,3,2
40760,3,1,142742,142742,142743,0,1,0
40761,4,1,142746,142746,142747,0,1,3
40762,2,2,142748,142748,142750,0,2,1
40763,5,3,142753,142753,142756,0,3,3
40764,6,3,142759,142759,142762,0,3,3
40765,4,1,142763,142763,142764,0,1,1
40766,1,3,142764,142764,142767,0,3,0
40767,3,2,142767,142767,142769,0,2,0
40768,6,2,142773,142773,142775,0,2,4
40769,5,2,142778,142778,142780,0,2,3
40770,4,3,142782,142782,142785,0,3,2
40771,2,2,142784,142785,142787,1,3,0
40772,3,1,142787,142787,142788,0,1,0
40773,1,3,142788,142788,142791,0,3,0
40774,6,3,142794,142794,142797,0,3,3
40775,1,3,142795,142797,142800,2,5,0
40776,1,2,142796,142800,142802,4,6,0
40777,4,1,142800,142802,142803,2,3,0
40778,5,3,142805,142805,142808,0,3,2
40779,2,1,142807,142808,142809,1,2,0
40780,1,3,142808,142809,142812,1,4,0
40781,5,1,142813,142813,142814,0,1,1
40782,5,2,142818,142818,142820,0,2,4
40783,6,2,142824,142824,142826,0,2,4
40784,5,1,142829,142829,142830,0,1,3
40785,5,3,142834,142834,142837,0,3,4
40786,2,3,142836,142837,142840,1,4,0
40787,2,3,142838,142840,142843,2,5,0
40788,5,3,142843,142843,142846,0,3,0
40789,2,2,142845,142846,142848,1,3,0
40790,1,2,142846,142848,142850,2,4,0
40791,4,1,142850,142850,142851,0,1,0
40792,3,2,142853,142853,142855,0,2,2
40793,5,1,142858,142858,142859,0,1,3
40794,6,3,142864,142864,142867,0,3,5
40795,1,2,142865,142867,142869,2,4,0
40796,4,2,142869,142869,142871,0,2,0
40797,5,3,142874,142874,142877,0,3,3
40798,2,2,142876,142877,142879,1,3,0
40799,2,3,142878,142879,142882,1,4,0
40800,6,1,142884,142884,142885,0,1,2
40801,3,2,142887,142887,142889,0,2,2
40802,2,1,142889,142889,142890,0,1,0
40803,4,3,142893,142893,142896,0,3,3
40804,3,2,142896,142896,142898,0,2,0
40805,6,1,142902,142902,142903,0,1,4
40806,3,1,142905,142905,142906,0,1,2
40807,3,3,142908,142908,142911,0,3,2
40808,1,2,142909,142911,142913,2,4,0
40809,4,1,142913,142913,142914,0,1,0
40810,6,2,142919,142919,142921,0,2,5
40811,6,1,142925,142925,142926,0,1,4
40812,1,2,142926,142926,142928,0,2,0
40813,2,1,142928,142928,142929,0,1,0
40814,1,1,142929,142929,142930,0,1,0
40815,2,1,142931,142931,142932,0,1,1
40816,6,2,142937,142937,142939,0,2,5
40817,5,1,142942,142942,142943,0,1,3
40818,6,2,142948,142948,142950,0,2,5
40819,5,3,142953,142953,142956,0,3,3
40820,6,1,142959,142959,142960,0,1,3
40821,4,2,142963,142963,142965,0,2,3
40822,3,1,142966,142966,142967,0,1,1
40823,2,2,142968,142968,142970,0,2,1
40824,5,3,142973,142973,142976,0,3,3
40825,5,1,142978,142978,142979,0,1,2
40826,4,1,142982,142982,142983,0,1,3
40827,5,2,142987,142987,142989,0,2,4
40828,5,3,142992,142992,142995,0,3,3
40829,6,2,142998,142998,143000,0,2,3
40830,2,1,143000,143000,143001,0,1,0
40831,1,3,143001,143001,143004,0,3,0
40832,3,1,143004,143004,143005,0,1,0
40833,5,2,143009,143009,143011,0,2,4
40834,2,2,143011,143011,143013,0,2,0
40835,3,1,143014,143014,143015,0,1,1
40836,1,3,143015,143015,143018,0,3,0
40837,3,3,143018,143018,143021,0,3,0
40838,2,2,143020,143021,143023,1,3,0
40839,5,1,143025,143025,143026,0,1,2
40840,4,3,143029,143029,143032,0,3,3
40841,6,3,143035,143035,143038,0,3,3
40842,5,3,143040,143040,143043,0,3,2
40843,4,3,143044,143044,143047,0,3,1
40844,5,3,143049,143049,143052,0,3,2
40845,2,3,143051,143052,143055,1,4,0
40846,4,1,143055,143055,143056,0,1,0
40847,6,1,143061,143061,143062,0,1,5
40848,5,1,143066,143066,143067,0,1,4
40849,3,2,143069,143069,143071,0,2,2
40850,6,3,143075,143075,143078,0,3,4
40851,4,3,143079,143079,143082,0,3,1
40852,6,3,143085,143085,143088,0,3,3
40853,4,1,143089,143089,143090,0,1,1
40854,1,1,143090,143090,143091,0,1,0
40855,3,2,143093,143093,143095,0,2,2
40856,2,2,143095,143095,143097,0,2,0
40857,4,1,143099,143099,143100,0,1,2
40858,2,2,143101,143101,143103,0,2,1
40859,4,2,143105,143105,143107,0,2,2
40860,5,2,143110,143110,143112,0,2,3
40861,2,2,143112,143112,143114,0,2,0
40862,6,2,143118,143118,143120,0,2,4
40863,4,2,143122,143122,143124,0,2,2
40864,4,2,143126,143126,143128,0,2,2
40865,5,3,143131,143131,143134,0,3,3
40866,3,2,143134,143134,143136,0,2,0
40867,3,1,143137,143137,143138,0,1,1
40868,6,1,143143,143143,143144,0,1,5
40869,2,1,143145,143145,143146,0,1,1
40870,3,3,143148,143148,143151,0,3,2
40871,3,3,143151,143151,143154,0,3,0
40872,4,3,143155,143155,143158,0,3,1
40873,2,2,143157,143158,143160,1,3,0
40874,1,1,143158,143160,143161,2,3,0
40875,3,1,143161,143161,143162,0,1,0
40876,2,1,143163,143163,143164,0,1,1
40877,3,3,143166,143166,143169,0,3,2
40878,6,3,143172,143172,143175,0,3,3
40879,5,1,143177,143177,143178,0,1,2
40880,2,1,143179,143179,143180,0,1,1
40881,6,3,143185,143185,143188,0,3,5
40882,4,1,143189,143189,143190,0,1,1
40883,5,2,143194,143194,143196,0,2,4
40884,4,3,143198,143198,143201,0,3,2
40885,1,3,143199,143201,143204,2,5,0
40886,5,1,143204,143204,143205,0,1,0
40887,5,3,143209,143209,143212,0,3,4
40888,5,3,143214,143214,143217,0,3,2
40889,4,3,143218,143218,143221,0,3,1
40890,2,3,143220,143221,143224,1,4,0
40891,4,2,143224,143224,143226,0,2,0
40892,4,3,143228,143228,143231,0,3,2
40893,5,2,143233,143233,143235,0,2,2
40894,3,2,143236,143236,143238,0,2,1
40895,4,3,143240,143240,143243,0,3,2
40896,4,2,143244,143244,143246,0,2,1
40897,5,2,143249,143249,143251,0,2,3
40898,1,2,143250,143251,143253,1,3,0
40899,2,3,143252,143253,143256,1,4,0
40900,5,1,143257,143257,143258,0,1,1
40901,4,1,143261,143261,143262,0,1,3
40902,1,1,143262,143262,143263,0,1,0
40903,5,3,143267,143267,143270,0,3,4
40904,1,1,143268,143270,143271,2,3,0
40905,5,3,143273,143273,143276,0,3,2
40906,4,1,143277,143277,143278,0,1,1
40907,3,3,143280,143280,143283,0,3,2
40908,1,2,143281,143283,143285,2,4,0
40909,2,1,143283,143285,143286,2,3,0
40910,4,3,143287,143287,143290,0,3,1
40911,1,3,143288,143290,143293,2,5,0
40912,4,2,143292,143293,143295,1,3,0
40913,3,3,143295,143295,143298,0,3,0
40914,5,1,143300,143300,143301,0,1,2
40915,3,2,143303,143303,143305,0,2,2
40916,6,1,143309,143309,143310,0,1,4
40917,4,1,143313,143313,143314,0,1,3
40918,4,3,143317,143317,143320,0,3,3
40919,4,2,143321,143321,143323,0,2,1
40920,1,1,143322,143323,143324,1,2,0
40921,3,3,143325,143325,143328,0,3,1
40922,3,2,143328,143328,143330,0,2,0
40923,3,3,143331,143331,143334,0,3,1
40924,2,1,143333,143334,143335,1,2,0
40925,5,3,143338,143338,143341,0,3,3
40926,4,3,143342,143342,143345,0,3,1
40927,3,1,143345,143345,143346,0,1,0
40928,1,2,143346,143346,143348,0,2,0
40929,5,1,143351,143351,143352,0,1,3
40930,2,1,143353,143353,143354,0,1,1
40931,1,1,143354,143354,143355,0,1,0
40932,1,3,143355,143355,143358,0,3,0
40933,1,3,143356,143358,143361,2,5,0
40934,2,3,143358,143361,143364,3,6,0
40935,2,2,143360,143364,143366,4,6,0
40936,3,2,143363,143366,143368,3,5,0
40937,6,2,143369,143369,143371,0,2,1
40938,1,1,143370,143371,143372,1,2,0
40939,6,3,143376,143376,143379,0,3,4
40940,3,3,143379,143379,143382,0,3,0
40941,5,1,143384,143384,143385,0,1,2
40942,3,1,143387,143387,143388,0,1,2
40943,3,2,143390,143390,143392,0,2,2
40944,1,3,143391,143392,143395,1,4,0
40945,4,2,143395,143395,143397,0,2,0
40946,1,3,143396,143397,143400,1,4,0
40947,3,3,143399,143400,143403,1,4,0
40948,6,1,143405,143405,143406,0,1,2
40949,2,1,143407,143407,143408,0,1,1
40950,1,3,143408,143408,143411,0,3,0
40951,5,3,143413,143413,143416,0,3,2
40952,1,2,143414,143416,143418,2,4,0
40953,1,2,143415,143418,143420,3,5,0
40954,1,3,143416,143420,143423,4,7,0
40955,4,1,143420,143423,143424,3,4,0
40956,6,2,143426,143426,143428,0,2,2
40957,2,3,143428,143428,143431,0,3,0
40958,1,2,143429,143431,143433,2,4,0
40959,4,2,143433,143433,143435,0,2,0
40960,1,3,143434,143435,143438,1,4,0
40961,5,3,143439,143439,143442,0,3,1
40962,1,3,143440,143442,143445,2,5,0
40963,5,1,143445,143445,143446,0,1,0
40964,6,2,143451,143451,143453,0,2,5
40965,6,3,143457,143457,143460,0,3,4
40966,6,3,143463,143463,143466,0,3,3
40967,2,3,143465,143466,143469,1,4,0
40968,6,1,143471,143471,143472,0,1,2
40969,5,2,143476,143476,143478,0,2,4
40970,3,2,143479,143479,143481,0,2,1
40971,5,2,143484,143484,143486,0,2,3
40972,2,2,143486,143486,143488,0,2,0
40973,3,2,143489,143489,143491,0,2,1
40974,2,2,143491,143491,143493,0,2,0
40975,3,3,143494,143494,143497,0,3,1
40976,6,3,143500,143500,143503,0,3,3
40977,5,3,143505,143505,143508,0,3,2
40978,4,1,143509,143509,143510,0,1,1
40979,5,2,143514,143514,143516,0,2,4
40980,3,1,143517,143517,143518,0,1,1
40981,6,2,143523,143523,143525,0,2,5
40982,6,2,143529,143529,143531,0,2,4
40983,3,3,143532,143532,143535,0,3,1
40984,4,1,143536,143536,143537,0,1,1
40985,3,3,143539,143539,143542,0,3,2
40986,2,3,143541,143542,143545,1,4,0
40987,3,3,143544,143545,143548,1,4,0
40988,4,1,143548,143548,143549,0,1,0
40989,1,3,143549,143549,143552,0,3,0
40990,3,1,143552,143552,143553,0,1,0
40991,5,3,143557,143557,143560,0,3,4
40992,2,2,143559,143560,143562,1,3,0
40993,4,1,143563,143563,143564,0,1,1
40994,1,3,143564,143564,143567,0,3,0
40995,5,1,143569,143569,143570,0,1,2
40996,5,2,143574,143574,143576,0,2,4
40997,4,2,143578,143578,143580,0,2,2
40998,5,3,143583,143583,143586,0,3,3
40999,3,1,143586,143586,143587,0,1,0
41000,6,3,143592,143592,143595,0,3,5
41001,1,1,143593,143595,143596,2,3,0
41002,4,3,143597,143597,143600,0,3,1
41003,5,2,143602,143602,143604,0,2,2
41004,2,1,143604,143604,143605,0,1,0
41005,1,1,143605,143605,143606,0,1,0
41006,3,2,143608,143608,143610,0,2,2
41007,1,1,143609,143610,143611,1,2,0
41008,4,3,143613,143613,143616,0,3,2
41009,5,3,143618,143618,143621,0,3,2
41010,2,1,143620,143621,143622,1,2,0
41011,3,3,143623,143623,143626,0,3,1
41012,3,2,143626,143626,143628,0,2,0
41013,2,1,143628,143628,143629,0,1,0
41014,3,2,143631,143631,143633,0,2,2
41015,2,2,143633,143633,143635,0,2,0
41016,5,1,143638,143638,143639,0,1,3
41017,4,2,143642,143642,143644,0,2,3
41018,5,3,143647,143647,143650,0,3,3
41019,5,3,143652,143652,143655,0,3,2
41020,6,3,143658,143658,143661,0,3,3
41021,6,1,143664,143664,143665,0,1,3
41022,3,1,143667,143667,143668,0,1,2
41023,5,1,143672,143672,143673,0,1,4
41024,3,2,143675,143675,143677,0,2,2
41025,4,2,143679,143679,143681,0,2,2
41026,5,2,143684,143684,143686,0,2,3
41027,6,1,143690,143690,143691,0,1,4
41028,6,3,143696,143696,143699,0,3,5
41029,6,2,143702,143702,143704,0,2,3
41030,3,3,143705,143705,143708,0,3,1
41031,6,1,143711,143711,143712,0,1,3
41032,1,3,143712,143712,143715,0,3,0
41033,5,1,143717,143717,143718,0,1,2
41034,1,2,143718,143718,143720,0,2,0
41035,6,1,143724,143724,143725,0,1,4
41036,1,2,143725,143725,143727,0,2,0
41037,2,2,143727,143727,143729,0,2,0
41038,3,3,143730,143730,143733,0,3,1
41039,1,1,143731,143733,143734,2,3,0
41040,5,1,143736,143736,143737,0,1,2
41041,3,3,143739,143739,143742,0,3,2
41042,3,1,143742,143742,143743,0,1,0
41043,3,3,143745,143745,143748,0,3,2
41044,5,2,143750,143750,143752,0,2,2
41045,2,2,143752,143752,143754,0,2,0
41046,5,2,143757,143757,143759,0,2,3
41047,6,1,143763,143763,143764,0,1,4
41048,3,3,143766,143766,143769,0,3,2
41049,5,1,143771,143771,143772,0,1,2
41050,2,2,143773,143773,143775,0,2,1
41051,2,2,143775,143775,143777,0,2,0
41052,4,3,143779,143779,143782,0,3,2
41053,6,1,143785,143785,143786,0,1,3
41054,1,2,143786,143786,143788,0,2,0
41055,1,2,143787,143788,143790,1,3,0
41056,5,2,143792,143792,143794,0,2,2
41057,3,1,143795,143795,143796,0,1,1
41058,6,1,143801,143801,143802,0,1,5
41059,4,3,143805,143805,143808,0,3,3
41060,6,3,143811,143811,143814,0,3,3
41061,4,1,143815,143815,143816,0,1,1
41062,3,1,143818,143818,143819,0,1,2
41063,5,2,143823,143823,143825,0,2,4
41064,1,2,143824,143825,143827,1,3,0
41065,3,3,143827,143827,143830,0,3,0
41066,5,3,143832,143832,143835,0,3,2
41067,3,2,143835,143835,143837,0,2,0
41068,6,3,143841,143841,143844,0,3,4
41069,1,1,143842,143844,143845,2,3,0
41070,6,3,143848,143848,143851,0,3,3
41071,5,2,143853,143853,143855,0,2,2
41072,3,1,143856,143856,143857,0,1,1
41073,6,1,143862,143862,143863,0,1,5
41074,2,1,143864,143864,143865,0,1,1
41075,2,3,143866,143866,143869,0,3,1
41076,5,2,143871,143871,143873,0,2,2
41077,6,2,143877,143877,143879,0,2,4
41078,3,1,143880,143880,143881,0,1,1
41079,5,3,143885,143885,143888,0,3,4
41080,5,3,143890,143890,143893,0,3,2
41081,4,1,143894,143894,143895,0,1,1
41082,4,3,143898,143898,143901,0,3,3
41083,1,1,143899,143901,143902,2,3,0
41084,2,2,143901,143902,143904,1,3,0
41085,4,1,143905,143905,143906,0,1,1
41086,6,3,143911,143911,143914,0,3,5
41087,1,3,143912,143914,143917,2,5,0
41088,4,2,143916,143917,143919,1,3,0
41089,4,3,143920,143920,143923,0,3,1
41090,3,2,143923,143923,143925,0,2,0
41091,4,2,143927,143927,143929,0,2,2
41092,1,1,143928,143929,143930,1,2,0
41093,3,3,143931,143931,143934,0,3,1
41094,1,2,143932,143934,143936,2,4,0
41095,2,1,143934,143936,143937,2,3,0
41096,6,1,143940,143940,143941,0,1,3
41097,3,1,143943,143943,143944,0,1,2
41098,6,1,143949,143949,143950,0,1,5
41099,5,2,143954,143954,143956,0,2,4
41100,2,2,143956,143956,143958,0,2,0
41101,1,2,143957,143958,143960,1,3,0
41102,4,1,143961,143961,143962,0,1,1
41103,1,2,143962,143962,143964,0,2,0
41104,2,1,143964,143964,143965,0,1,0
41105,5,2,143969,143969,143971,0,2,4
41106,5,1,143974,143974,143975,0,1,3
41107,5,1,143979,143979,143980,0,1,4
41108,1,2,143980,143980,143982,0,2,0
41109,1,3,143981,143982,143985,1,4,0
41110,3,3,143984,143985,143988,1,4,0
41111,3,1,143987,143988,143989,1,2,0
41112,4,1,143991,143991,143992,0,1,2
41113,1,2,143992,143992,143994,0,2,0
41114,1,2,143993,143994,143996,1,3,0
41115,2,3,143995,143996,143999,1,4,0
41116,5,1,144000,144000,144001,0,1,1
41117,4,2,144004,144004,144006,0,2,3
41118,6,3,144010,144010,144013,0,3,4
41119,6,3,144016,144016,144019,0,3,3
41120,6,2,144022,144022,144024,0,2,3
41121,1,1,144023,144024,144025,1,2,0
41122,2,3,144025,144025,144028,0,3,0
41123,4,3,144029,144029,144032,0,3,1
41124,5,1,144034,144034,144035,0,1,2
41125,6,1,144040,144040,144041,0,1,5
41126,2,1,144042,144042,144043,0,1,1
41127,6,1,144048,144048,144049,0,1,5
41128,6,3,144054,144054,144057,0,3,5
41129,4,3,144058,144058,144061,0,3,1
41130,1,3,144059,144061,144064,2,5,0
41131,5,3,144064,144064,144067,0,3,0
41132,2,3,144066,144067,144070,1,4,0
41133,5,2,144071,144071,144073,0,2,1
41134,3,3,144074,144074,144077,0,3,1
41135,3,3,144077,144077,144080,0,3,0
41136,4,1,144081,144081,144082,0,1,1
41137,2,3,144083,144083,144086,0,3,1
41138,3,2,144086,144086,144088,0,2,0
41139,2,1,144088,144088,144089,0,1,0
41140,5,1,144093,144093,144094,0,1,4
41141,2,3,144095,144095,144098,0,3,1
41142,5,3,144100,144100,144103,0,3,2
41143,3,2,144103,144103,144105,0,2,0
41144,6,1,144109,144109,144110,0,1,4
41145,1,2,144110,144110,144112,0,2,0
41146,5,3,144115,144115,144118,0,3,3
41147,3,3,144118,144118,144121,0,3,0
41148,2,1,144120,144121,144122,1,2,0
41149,4,2,144124,144124,144126,0,2,2
41150,2,3,144126,144126,144129,0,3,0
41151,6,2,144132,144132,144134,0,2,3
41152,5,3,144137,144137,144140,0,3,3
41153,5,2,144142,144142,144144,0,2,2
41154,6,3,144148,144148,144151,0,3,4
41155,5,1,144153,144153,144154,0,1,2
41156,4,1,144157,144157,144158,0,1,3
41157,6,3,144163,144163,144166,0,3,5
41158,5,3,144168,144168,144171,0,3,2
41159,4,3,144172,144172,144175,0,3,1
41160,6,3,144178,144178,144181,0,3,3
41161,1,2,144179,144181,144183,2,4,0
41162,5,2,144184,144184,144186,0,2,1
41163,3,1,144187,144187,144188,0,1,1
41164,3,3,144190,144190,144193,0,3,2
41165,4,1,144194,144194,144195,0,1,1
41166,1,3,144195,144195,144198,0,3,0
41167,6,3,144201,144201,144204,0,3,3
41168,5,2,144206,144206,144208,0,2,2
41169,5,3,144211,144211,144214,0,3,3
41170,1,3,144212,144214,144217,2,5,0
41171,5,2,144217,144217,144219,0,2,0
41172,6,3,144223,144223,144226,0,3,4
41173,1,2,144224,144226,144228,2,4,0
41174,4,3,144228,144228,144231,0,3,0
41175,2,2,144230,144231,144233,1,3,0
41176,2,2,144232,144233,144235,1,3,0
41177,4,1,144236,144236,144237,0,1,1
41178,2,3,144238,144238,144241,0,3,1
41179,3,1,144241,144241,144242,0,1,0
41180,5,1,144246,144246,144247,0,1,4
41181,4,3,144250,144250,144253,0,3,3
41182,2,2,144252,144253,144255,1,3,0
41183,6,1,144258,144258,144259,0,1,3
41184,4,1,144262,144262,144263,0,1,3
41185,6,2,144268,144268,144270,0,2,5
41186,3,1,144271,144271,144272,0,1,1
41187,4,3,144275,144275,144278,0,3,3
41188,1,1,144276,144278,144279,2,3,0
41189,2,3,144278,144279,144282,1,4,0
41190,6,3,144284,144284,144287,0,3,2
41191,4,2,144288,144288,144290,0,2,1
41192,2,2,144290,144290,144292,0,2,0
41193,2,3,144292,144292,144295,0,3,0
41194,1,2,144293,144295,144297,2,4,0
41195,3,1,144296,144297,144298,1,2,0
41196,3,2,144299,144299,144301,0,2,1
41197,1,3,144300,144301,144304,1,4,0
41198,3,3,144303,144304,144307,1,4,0
41199,1,2,144304,144307,144309,3,5,0
41200,6,2,144310,144310,144312,0,2,1
41201,6,1,144316,144316,144317,0,1,4
41202,4,3,144320,144320,144323,0,3,3
41203,1,1,144321,144323,144324,2,3,0
41204,2,3,144323,144324,144327,1,4,0
41205,1,3,144324,144327,144330,3,6,0
41206,2,1,144326,144330,144331,4,5,0
41207,4,1,144330,144331,144332,1,2,0
41208,3,3,144333,144333,144336,0,3,1
41209,5,3,144338,144338,144341,0,3,2
41210,5,3,144343,144343,144346,0,3,2
41211,1,2,144344,144346,144348,2,4,0
41212,3,1,144347,144348,144349,1,2,0
41213,4,2,144351,144351,144353,0,2,2
41214,2,1,144353,144353,144354,0,1,0
41215,2,1,144355,144355,144356,0,1,1
41216,1,2,144356,144356,144358,0,2,0
41217,2,2,144358,144358,144360,0,2,0
41218,6,2,144364,144364,144366,0,2,4
41219,2,1,144366,144366,144367,0,1,0
41220,4,2,144370,144370,144372,0,2,3
41221,6,3,144376,144376,144379,0,3,4
41222,4,1,144380,144380,144381,0,1,1
41223,2,1,144382,144382,144383,0,1,1
41224,4,1,144386,144386,144387,0,1,3
41225,6,1,144392,144392,144393,0,1,5
41226,3,2,144395,144395,144397,0,2,2
41227,4,3,144399,144399,144402,0,3,2
41228,6,1,144405,144405,144406,0,1,3
41229,6,3,144411,144411,144414,0,3,5
41230,6,2,144417,144417,144419,0,2,3
41231,4,3,144421,144421,144424,0,3,2
41232,6,3,144427,144427,144430,0,3,3
41233,1,1,144428,144430,144431,2,3,0
41234,6,3,144434,144434,144437,0,3,3
41235,1,3,144435,144437,144440,2,5,0
41236,3,3,144438,144440,144443,2,5,0
41237,2,1,144440,144443,144444,3,4,0
41238,6,1,144446,144446,144447,0,1,2
41239,6,1,144452,144452,144453,0,1,5
41240,3,1,144455,144455,144456,0,1,2
41241,4,2,144459,144459,144461,0,2,3
41242,5,1,144464,144464,144465,0,1,3
41243,3,2,144467,144467,144469,0,2,2
41244,4,2,144471,144471,144473,0,2,2
41245,6,2,144477,144477,144479,0,2,4
41246,3,2,144480,144480,144482,0,2,1
41247,5,1,144485,144485,144486,0,1,3
41248,4,1,144489,144489,144490,0,1,3
41249,1,1,144490,144490,144491,0,1,0
41250,6,3,144496,144496,144499,0,3,5
41251,1,2,144497,144499,144501,2,4,0
41252,1,3,144498,144501,144504,3,6,0
41253,5,3,144503,144504,144507,1,4,0
41254,1,3,144504,144507,144510,3,6,0
41255,5,1,144509,144510,144511,1,2,0
41256,1,3,144510,144511,144514,1,4,0
41257,1,1,144511,144514,144515,3,4,0
41258,4,3,144515,144515,144518,0,3,0
41259,5,3,144520,144520,144523,0,3,2
41260,1,3,144521,144523,144526,2,5,0
41261,2,1,144523,144526,144527,3,4,0
41262,6,1,144529,144529,144530,0,1,2
41263,5,3,144534,144534,144537,0,3,4
41264,5,1,144539,144539,144540,0,1,2
41265,4,2,144543,144543,144545,0,2,3
41266,2,1,144545,144545,144546,0,1,0
41267,3,3,144548,144548,144551,0,3,2
41268,5,2,144553,144553,144555,0,2,2
41269,6,2,144559,144559,144561,0,2,4
41270,3,1,144562,144562,144563,0,1,1
41271,5,1,144567,144567,144568,0,1,4
41272,1,2,144568,144568,144570,0,2,0
41273,5,3,144573,144573,144576,0,3,3
41274,5,1,144578,144578,144579,0,1,2
41275,5,3,144583,144583,144586,0,3,4
41276,6,3,144589,144589,144592,0,3,3
41277,2,3,144591,144592,144595,1,4,0
41278,1,2,144592,144595,144597,3,5,0
41279,3,2,144595,144597,144599,2,4,0
41280,6,2,144601,144601,144603,0,2,2
41281,3,1,144604,144604,144605,0,1,1
41282,5,2,144609,144609,144611,0,2,4
41283,3,1,144612,144612,144613,0,1,1
41284,5,1,144617,144617,144618,0,1,4
41285,1,1,144618,144618,144619,0,1,0
41286,5,1,144623,144623,144624,0,1,4
41287,3,2,144626,144626,144628,0,2,2
41288,5,1,144631,144631,144632,0,1,3
41289,2,3,144633,144633,144636,0,3,1
41290,6,2,144639,144639,144641,0,2,3
41291,4,1,144643,144643,144644,0,1,2
41292,1,3,144644,144644,144647,0,3,0
41293,3,1,144647,144647,144648,0,1,0
41294,3,1,144650,144650,144651,0,1,2
41295,5,3,144655,144655,144658,0,3,4
41296,5,1,144660,144660,144661,0,1,2
41297,2,3,144662,144662,144665,0,3,1
41298,4,1,144666,144666,144667,0,1,1
41299,4,1,144670,144670,144671,0,1,3
41300,1,3,144671,144671,144674,0,3,0
41301,2,2,144673,144674,144676,1,3,0
41302,3,3,144676,144676,144679,0,3,0
41303,1,3,144677,144679,144682,2,5,0
41304,5,2,144682,144682,144684,0,2,0
41305,3,1,144685,144685,144686,0,1,1
41306,2,3,144687,144687,144690,0,3,1
41307,2,2,144689,144690,144692,1,3,0
41308,2,3,144691,144692,144695,1,4,0
41309,6,3,144697,144697,144700,0,3,2
41310,5,2,144702,144702,144704,0,2,2
41311,2,1,144704,144704,144705,0,1,0
41312,5,1,144709,144709,144710,0,1,4
41313,4,1,144713,144713,144714,0,1,3
41314,3,2,144716,144716,144718,0,2,2
41315,3,3,144719,144719,144722,0,3,1
41316,4,2,144723,144723,144725,0,2,1
41317,6,1,144729,144729,144730,0,1,4
41318,5,3,144734,144734,144737,0,3,4
41319,1,1,144735,144737,144738,2,3,0
41320,4,2,144739,144739,144741,0,2,1
41321,3,1,144742,144742,144743,0,1,1
41322,6,1,144748,144748,144749,0,1,5
41323,2,2,144750,144750,144752,0,2,1
41324,3,2,144753,144753,144755,0,2,1
41325,1,3,144754,144755,144758,1,4,0
41326,5,3,144759,144759,144762,0,3,1
41327,1,2,144760,144762,144764,2,4,0
41328,5,3,144765,144765,144768,0,3,1
41329,2,1,144767,144768,144769,1,2,0
41330,5,1,144772,144772,144773,0,1,3
41331,1,3,144773,144773,144776,0,3,0
41332,2,3,144775,144776,144779,1,4,0
41333,2,2,144777,144779,144781,2,4,0
41334,5,3,144782,144782,144785,0,3,1
41335,1,2,144783,144785,144787,2,4,0
41336,2,3,144785,144787,144790,2,5,0
41337,2,1,144787,144790,144791,3,4,0
41338,1,1,144788,144791,144792,3,4,0
41339,3,2,144791,144792,144794,1,3,0
41340,4,1,144795,144795,144796,0,1,1
41341,4,2,144799,144799,144801,0,2,3
41342,5,2,144804,144804,144806,0,2,3
41343,4,1,144808,144808,144809,0,1,2
41344,1,2,144809,144809,144811,0,2,0
41345,2,2,144811,144811,144813,0,2,0
41346,3,1,144814,144814,144815,0,1,1
41347,3,3,144817,144817,144820,0,3,2
41348,2,1,144819,144820,144821,1,2,0
41349,1,2,144820,144821,144823,1,3,0
41350,3,3,144823,144823,144826,0,3,0
41351,2,3,144825,144826,144829,1,4,0
41352,1,1,144826,144829,144830,3,4,0
41353,5,2,144831,144831,144833,0,2,1
41354,5,1,144836,144836,144837,0,1,3
41355,5,1,144841,144841,144842,0,1,4
41356,3,2,144844,144844,144846,0,2,2
41357,3,3,144847,144847,144850,0,3,1
41358,4,3,144851,144851,144854,0,3,1
41359,1,1,144852,144854,144855,2,3,0
41360,6,2,144858,144858,144860,0,2,3
41361,4,3,144862,144862,144865,0,3,2
41362,1,2,144863,144865,144867,2,4,0
41363,1,1,144864,144867,144868,3,4,0
41364,6,2,144870,144870,144872,0,2,2
41365,5,1,144875,144875,144876,0,1,3
41366,4,3,144879,144879,144882,0,3,3
41367,6,2,144885,144885,144887,0,2,3
41368,6,3,144891,144891,144894,0,3,4
41369,1,3,144892,144894,144897,2,5,0
41370,4,3,144896,144897,144900,1,4,0
41371,1,1,144897,144900,144901,3,4,0
41372,3,1,144900,144901,144902,1,2,0
41373,1,3,144901,144902,144905,1,4,0
41374,6,2,144907,144907,144909,0,2,2
41375,2,1,144909,144909,144910,0,1,0
41376,1,2,144910,144910,144912,0,2,0
41377,3,1,144913,144913,144914,0,1,1
41378,2,3,144915,144915,144918,0,3,1
41379,5,1,144920,144920,144921,0,1,2
41380,4,3,144924,144924,144927,0,3,3
41381,4,2,144928,144928,144930,0,2,1
41382,5,3,144933,144933,144936,0,3,3
41383,5,3,144938,144938,144941,0,3,2
41384,6,1,144944,144944,144945,0,1,3
41385,1,3,144945,144945,144948,0,3,0
41386,2,3,144947,144948,144951,1,4,0
41387,2,2,144949,144951,144953,2,4,0
41388,4,2,144953,144953,144955,0,2,0
41389,3,2,144956,144956,144958,0,2,1
41390,4,1,144960,144960,144961,0,1,2
41391,5,2,144965,144965,144967,0,2,4
41392,6,3,144971,144971,144974,0,3,4
41393,2,3,144973,144974,144977,1,4,0
41394,2,3,144975,144977,144980,2,5,0
41395,4,3,144979,144980,144983,1,4,0
41396,4,1,144983,144983,144984,0,1,0
41397,4,3,144987,144987,144990,0,3,3
41398,1,3,144988,144990,144993,2,5,0
41399,4,3,144992,144993,144996,1,4,0
41400,1,1,144993,144996,144997,3,4,0
41401,2,1,144995,144997,144998,2,3,0
41402,6,2,145001,145001,145003,0,2,3
41403,4,1,145005,145005,145006,0,1,2
41404,1,2,145006,145006,145008,0,2,0
41405,3,1,145009,145009,145010,0,1,1
41406,2,2,145011,145011,145013,0,2,1
41407,4,3,145015,145015,145018,0,3,2
41408,1,1,145016,145018,145019,2,3,0
41409,3,3,145019,145019,145022,0,3,0
41410,1,2,145020,145022,145024,2,4,0
41411,2,3,145022,145024,145027,2,5,0
41412,6,1,145028,145028,145029,0,1,1
41413,5,1,145033,145033,145034,0,1,4
41414,4,3,145037,145037,145040,0,3,3
41415,3,2,145040,145040,145042,0,2,0
41416,2,1,145042,145042,145043,0,1,0
41417,1,1,145043,145043,145044,0,1,0
41418,4,3,145047,145047,145050,0,3,3
41419,5,2,145052,145052,145054,0,2,2
41420,1,1,145053,145054,145055,1,2,0
41421,1,2,145054,145055,145057,1,3,0
41422,1,2,145055,145057,145059,2,4,0
41423,6,1,145061,145061,145062,0,1,2
41424,5,3,145066,145066,145069,0,3,4
41425,6,3,145072,145072,145075,0,3,3
41426,1,2,145073,145075,145077,2,4,0
41427,2,1,145075,145077,145078,2,3,0
41428,3,3,145078,145078,145081,0,3,0
41429,5,3,145083,145083,145086,0,3,2
41430,6,2,145089,145089,145091,0,2,3
41431,5,3,145094,145094,145097,0,3,3
41432,3,3,145097,145097,145100,0,3,0
41433,1,1,145098,145100,145101,2,3,0
41434,1,2,145099,145101,145103,2,4,0
41435,3,3,145102,145103,145106,1,4,0
41436,3,2,145105,145106,145108,1,3,0
41437,5,1,145110,145110,145111,0,1,2
41438,6,2,145116,145116,145118,0,2,5
41439,1,3,145117,145118,145121,1,4,0
41440,2,2,145119,145121,145123,2,4,0
41441,2,3,145121,145123,145126,2,5,0
41442,2,2,145123,145126,145128,3,5,0
41443,6,1,145129,145129,145130,0,1,1
41444,4,1,145133,145133,145134,0,1,3
41445,2,1,145135,145135,145136,0,1,1
41446,3,2,145138,145138,145140,0,2,2
41447,3,3,145141,145141,145144,0,3,1
41448,1,2,145142,145144,145146,2,4,0
41449,2,2,145144,145146,145148,2,4,0
41450,2,2,145146,145148,145150,2,4,0
41451,6,1,145152,145152,145153,0,1,2
41452,5,3,145157,145157,145160,0,3,4
41453,4,3,145161,145161,145164,0,3,1
41454,2,3,145163,145164,145167,1,4,0
41455,3,3,145166,145167,145170,1,4,0
41456,4,2,145170,145170,145172,0,2,0
41457,6,2,145176,145176,145178,0,2,4
41458,2,1,145178,145178,145179,0,1,0
41459,1,2,145179,145179,145181,0,2,0
41460,5,1,145184,145184,145185,0,1,3
41461,5,2,145189,145189,145191,0,2,4
41462,1,2,145190,145191,145193,1,3,0
41463,6,2,145196,145196,145198,0,2,3
41464,3,1,145199,145199,145200,0,1,1
41465,5,1,145204,145204,145205,0,1,4
41466,6,3,145210,145210,145213,0,3,5
41467,5,1,145215,145215,145216,0,1,2
41468,2,3,145217,145217,145220,0,3,1
41469,1,3,145218,145220,145223,2,5,0
41470,6,3,145224,145224,145227,0,3,1
41471,1,3,145225,145227,145230,2,5,0
41472,4,3,145229,145230,145233,1,4,0
41473,1,2,145230,145233,145235,3,5,0
41474,2,3,145232,145235,145238,3,6,0
41475,2,2,145234,145238,145240,4,6,0
41476,4,3,145238,145240,145243,2,5,0
41477,6,1,145244,145244,145245,0,1,1
41478,2,2,145246,145246,145248,0,2,1
41479,4,3,145250,145250,145253,0,3,2
41480,6,2,145256,145256,145258,0,2,3
41481,3,1,145259,145259,145260,0,1,1
41482,4,1,145263,145263,145264,0,1,3
41483,2,1,145265,145265,145266,0,1,1
41484,2,1,145267,145267,145268,0,1,1
41485,6,1,145273,145273,145274,0,1,5
41486,5,2,145278,145278,145280,0,2,4
41487,1,1,145279,145280,145281,1,2,0
41488,6,2,145285,145285,145287,0,2,4
41489,6,3,145291,145291,145294,0,3,4
41490,3,1,145294,145294,145295,0,1,0
41491,5,2,145299,145299,145301,0,2,4
41492,2,3,145301,145301,145304,0,3,0
41493,3,1,145304,145304,145305,0,1,0
41494,2,3,145306,145306,145309,0,3,1
41495,1,3,145307,145309,145312,2,5,0
41496,5,3,145312,145312,145315,0,3,0
41497,2,2,145314,145315,145317,1,3,0
41498,4,1,145318,145318,145319,0,1,1
41499,5,1,145323,145323,145324,0,1,4
41500,3,1,145326,145326,145327,0,1,2
41501,5,3,145331,145331,145334,0,3,4
41502,4,3,145335,145335,145338,0,3,1
41503,4,1,145339,145339,145340,0,1,1
41504,5,1,145344,145344,145345,0,1,4
41505,4,1,145348,145348,145349,0,1,3
41506,1,1,145349,145349,145350,0,1,0
41507,6,3,145355,145355,145358,0,3,5
41508,4,2,145359,145359,145361,0,2,1
41509,3,3,145362,145362,145365,0,3,1
41510,3,1,145365,145365,145366,0,1,0
41511,5,2,145370,145370,145372,0,2,4
41512,4,3,145374,145374,145377,0,3,2
41513,5,2,145379,145379,145381,0,2,2
41514,1,2,145380,145381,145383,1,3,0
41515,2,3,145382,145383,145386,1,4,0
41516,1,2,145383,145386,145388,3,5,0
41517,6,1,145389,145389,145390,0,1,1
41518,4,3,145393,145393,145396,0,3,3
41519,6,2,145399,145399,145401,0,2,3
41520,1,1,145400,145401,145402,1,2,0
41521,1,3,145401,145402,145405,1,4,0
41522,3,1,145404,145405,145406,1,2,0
41523,2,3,145406,145406,145409,0,3,0
41524,2,1,145408,145409,145410,1,2,0
41525,3,1,145411,145411,145412,0,1,1
41526,4,1,145415,145415,145416,0,1,3
41527,1,3,145416,145416,145419,0,3,0
41528,6,3,145422,145422,145425,0,3,3
41529,4,2,145426,145426,145428,0,2,1
41530,2,2,145428,145428,145430,0,2,0
41531,5,1,145433,145433,145434,0,1,3
41532,5,1,145438,145438,145439,0,1,4
41533,3,3,145441,145441,145444,0,3,2
41534,6,1,145447,145447,145448,0,1,3
41535,2,2,145449,145449,145451,0,2,1
41536,3,2,145452,145452,145454,0,2,1
41537,4,2,145456,145456,145458,0,2,2
41538,1,2,145457,145458,145460,1,3,0
41539,1,1,145458,145460,145461,2,3,0
41540,3,1,145461,145461,145462,0,1,0
41541,3,3,145464,145464,145467,0,3,2
41542,5,3,145469,145469,145472,0,3,2
41543,6,1,145475,145475,145476,0,1,3
41544,6,2,145481,145481,145483,0,2,5
41545,2,2,145483,145483,145485,0,2,0
41546,5,3,145488,145488,145491,0,3,3
41547,5,3,145493,145493,145496,0,3,2
41548,3,2,145496,145496,145498,0,2,0
41549,5,3,145501,145501,145504,0,3,3
41550,3,1,145504,145504,145505,0,1,0
41551,4,1,145508,145508,145509,0,1,3
41552,5,2,145513,145513,145515,0,2,4
41553,1,2,145514,145515,145517,1,3,0
41554,1,2,145515,145517,145519,2,4,0
41555,5,1,145520,145520,145521,0,1,1
41556,5,3,145525,145525,145528,0,3,4
41557,5,3,145530,145530,145533,0,3,2
41558,3,1,145533,145533,145534,0,1,0
41559,3,2,145536,145536,145538,0,2,2
41560,4,1,145540,145540,145541,0,1,2
41561,6,2,145546,145546,145548,0,2,5
41562,4,3,145550,145550,145553,0,3,2
41563,2,1,145552,145553,145554,1,2,0
41564,2,3,145554,145554,145557,0,3,0
41565,6,3,145560,145560,145563,0,3,3
41566,6,1,145566,145566,145567,0,1,3
41567,2,1,145568,145568,145569,0,1,1
41568,6,3,145574,145574,145577,0,3,5
41569,2,3,145576,145577,145580,1,4,0
41570,5,3,145581,145581,145584,0,3,1
41571,2,1,145583,145584,145585,1,2,0
41572,6,2,145589,145589,145591,0,2,4
41573,1,1,145590,145591,145592,1,2,0
41574,6,3,145596,145596,145599,0,3,4
41575,6,2,145602,145602,145604,0,2,3
41576,2,2,145604,145604,145606,0,2,0
41577,5,2,145609,145609,145611,0,2,3
41578,3,3,145612,145612,145615,0,3,1
41579,4,3,145616,145616,145619,0,3,1
41580,1,1,145617,145619,145620,2,3,0
41581,5,3,145622,145622,145625,0,3,2
41582,4,2,145626,145626,145628,0,2,1
41583,6,1,145632,145632,145633,0,1,4
41584,2,2,145634,145634,145636,0,2,1
41585,1,1,145635,145636,145637,1,2,0
41586,2,2,145637,145637,145639,0,2,0
41587,2,2,145639,145639,145641,0,2,0
41588,2,3,145641,145641,145644,0,3,0
41589,2,3,145643,145644,145647,1,4,0
41590,1,3,145644,145647,145650,3,6,0
41591,4,1,145648,145650,145651,2,3,0
41592,2,2,145650,145651,145653,1,3,0
41593,5,1,145655,145655,145656,0,1,2
41594,5,2,145660,145660,145662,0,2,4
41595,4,3,145664,145664,145667,0,3,2
41596,1,1,145665,145667,145668,2,3,0
41597,6,3,145671,145671,145674,0,3,3
41598,4,2,145675,145675,145677,0,2,1
41599,3,3,145678,145678,145681,0,3,1
41600,6,2,145684,145684,145686,0,2,3
41601,1,1,145685,145686,145687,1,2,0
41602,2,3,145687,145687,145690,0,3,0
41603,6,2,145693,145693,145695,0,2,3
41604,4,3,145697,145697,145700,0,3,2
41605,4,1,145701,145701,145702,0,1,1
41606,4,3,145705,145705,145708,0,3,3
41607,3,2,145708,145708,145710,0,2,0
41608,6,1,145714,145714,145715,0,1,4
41609,6,2,145720,145720,145722,0,2,5
41610,6,3,145726,145726,145729,0,3,4
41611,1,2,145727,145729,145731,2,4,0
41612,4,3,145731,145731,145734,0,3,0
41613,3,3,145734,145734,145737,0,3,0
41614,2,3,145736,145737,145740,1,4,0
41615,4,3,145740,145740,145743,0,3,0
41616,1,2,145741,145743,145745,2,4,0
41617,2,2,145743,145745,145747,2,4,0
41618,3,2,145746,145747,145749,1,3,0
41619,4,2,145750,145750,145752,0,2,1
41620,2,1,145752,145752,145753,0,1,0
41621,4,1,145756,145756,145757,0,1,3
41622,3,3,145759,145759,145762,0,3,2
41623,5,1,145764,145764,145765,0,1,2
41624,5,1,145769,145769,145770,0,1,4
41625,6,1,145775,145775,145776,0,1,5
41626,1,3,145776,145776,145779,0,3,0
41627,3,2,145779,145779,145781,0,2,0
41628,4,3,145783,145783,145786,0,3,2
41629,6,2,145789,145789,145791,0,2,3
41630,6,3,145795,145795,145798,0,3,4
41631,2,3,145797,145798,145801,1,4,0
41632,2,2,145799,145801,145803,2,4,0
41633,5,1,145804,145804,145805,0,1,1
41634,6,2,145810,145810,145812,0,2,5
41635,4,1,145814,145814,145815,0,1,2
41636,5,3,145819,145819,145822,0,3,4
41637,2,1,145821,145822,145823,1,2,0
41638,3,3,145824,145824,145827,0,3,1
41639,6,2,145830,145830,145832,0,2,3
41640,1,2,145831,145832,145834,1,3,0
41641,3,1,145834,145834,145835,0,1,0
41642,6,1,145840,145840,145841,0,1,5
41643,3,2,145843,145843,145845,0,2,2
41644,2,3,145845,145845,145848,0,3,0
41645,6,3,145851,145851,145854,0,3,3
41646,6,1,145857,145857,145858,0,1,3
41647,4,2,145861,145861,145863,0,2,3
41648,1,3,145862,145863,145866,1,4,0
41649,4,2,145866,145866,145868,0,2,0
41650,6,2,145872,145872,145874,0,2,4
41651,1,1,145873,145874,145875,1,2,0
41652,5,2,145878,145878,145880,0,2,3
41653,5,3,145883,145883,145886,0,3,3
41654,3,1,145886,145886,145887,0,1,0
41655,6,2,145892,145892,145894,0,2,5
41656,2,2,145894,145894,145896,0,2,0
41657,5,3,145899,145899,145902,0,3,3
41658,4,1,145903,145903,145904,0,1,1
41659,2,3,145905,145905,145908,0,3,1
41660,3,1,145908,145908,145909,0,1,0
41661,6,1,145914,145914,145915,0,1,5
41662,3,1,145917,145917,145918,0,1,2
41663,5,3,145922,145922,145925,0,3,4
41664,4,3,145926,145926,145929,0,3,1
41665,2,3,145928,145929,145932,1,4,0
41666,5,3,145933,145933,145936,0,3,1
41667,5,1,145938,145938,145939,0,1,2
41668,6,3,145944,145944,145947,0,3,5
41669,6,1,145950,145950,145951,0,1,3
41670,2,1,145952,145952,145953,0,1,1
41671,6,3,145958,145958,145961,0,3,5
41672,2,3,145960,145961,145964,1,4,0
41673,2,3,145962,145964,145967,2,5,0
41674,3,2,145965,145967,145969,2,4,0
41675,1,1,145966,145969,145970,3,4,0
41676,6,3,145972,145972,145975,0,3,2
41677,6,1,145978,145978,145979,0,1,3
41678,6,3,145984,145984,145987,0,3,5
41679,4,3,145988,145988,145991,0,3,1
41680,4,2,145992,145992,145994,0,2,1
41681,2,2,145994,145994,145996,0,2,0
41682,5,1,145999,145999,146000,0,1,3
41683,1,2,146000,146000,146002,0,2,0
41684,1,3,146001,146002,146005,1,4,0
41685,4,1,146005,146005,146006,0,1,0
41686,5,3,146010,146010,146013,0,3,4
41687,6,1,146016,146016,146017,0,1,3
41688,1,2,146017,146017,146019,0,2,0
41689,6,3,146023,146023,146026,0,3,4
41690,1,1,146024,146026,146027,2,3,0
41691,5,1,146029,146029,146030,0,1,2
41692,4,3,146033,146033,146036,0,3,3
41693,3,1,146036,146036,146037,0,1,0
41694,3,1,146039,146039,146040,0,1,2
41695,3,1,146042,146042,146043,0,1,2
41696,6,2,146048,146048,146050,0,2,5
41697,2,3,146050,146050,146053,0,3,0
41698,4,1,146054,146054,146055,0,1,1
41699,5,2,146059,146059,146061,0,2,4
41700,2,2,146061,146061,146063,0,2,0
41701,4,2,146065,146065,146067,0,2,2
41702,6,3,146071,146071,146074,0,3,4
41703,2,3,146073,146074,146077,1,4,0
41704,2,3,146075,146077,146080,2,5,0
41705,5,3,146080,146080,146083,0,3,0
41706,5,3,146085,146085,146088,0,3,2
41707,4,2,146089,146089,146091,0,2,1
41708,5,3,146094,146094,146097,0,3,3
41709,2,2,146096,146097,146099,1,3,0
41710,5,1,146101,146101,146102,0,1,2
41711,6,3,146107,146107,146110,0,3,5
41712,4,2,146111,146111,146113,0,2,1
41713,1,2,146112,146113,146115,1,3,0
41714,5,3,146117,146117,146120,0,3,2
41715,3,3,146120,146120,146123,0,3,0
41716,4,1,146124,146124,146125,0,1,1
41717,1,3,146125,146125,146128,0,3,0
41718,6,3,146131,146131,146134,0,3,3
41719,4,1,146135,146135,146136,0,1,1
41720,1,3,146136,146136,146139,0,3,0
41721,6,3,146142,146142,146145,0,3,3
41722,6,1,146148,146148,146149,0,1,3
41723,5,3,146153,146153,146156,0,3,4
41724,6,3,146159,146159,146162,0,3,3
41725,1,1,146160,146162,146163,2,3,0
41726,6,1,146166,146166,146167,0,1,3
41727,2,3,146168,146168,146171,0,3,1
41728,4,2,146172,146172,146174,0,2,1
41729,3,2,146175,146175,146177,0,2,1
41730,5,2,146180,146180,146182,0,2,3
41731,2,3,146182,146182,146185,0,3,0
41732,6,3,146188,146188,146191,0,3,3
41733,3,3,146191,146191,146194,0,3,0
41734,2,2,146193,146194,146196,1,3,0
41735,1,2,146194,146196,146198,2,4,0
41736,3,1,146197,146198,146199,1,2,0
41737,4,1,146201,146201,146202,0,1,2
41738,3,2,146204,146204,146206,0,2,2
41739,2,3,146206,146206,146209,0,3,0
41740,3,3,146209,146209,146212,0,3,0
41741,4,3,146213,146213,146216,0,3,1
41742,4,1,146217,146217,146218,0,1,1
41743,5,1,146222,146222,146223,0,1,4
41744,1,1,146223,146223,146224,0,1,0
41745,4,3,146227,146227,146230,0,3,3
41746,2,1,146229,146230,146231,1,2,0
41747,6,1,146235,146235,146236,0,1,4
41748,6,2,146241,146241,146243,0,2,5
41749,4,1,146245,146245,146246,0,1,2
41750,4,1,146249,146249,146250,0,1,3
41751,6,3,146255,146255,146258,0,3,5
41752,6,2,146261,146261,146263,0,2,3
41753,5,3,146266,146266,146269,0,3,3
41754,4,3,146270,146270,146273,0,3,1
41755,6,1,146276,146276,146277,0,1,3
41756,4,1,146280,146280,146281,0,1,3
41757,2,2,146282,146282,146284,0,2,1
41758,6,2,146288,146288,146290,0,2,4
41759,2,3,146290,146290,146293,0,3,0
41760,5,3,146295,146295,146298,0,3,2
41761,5,2,146300,146300,146302,0,2,2
41762,2,1,146302,146302,146303,0,1,0
41763,3,1,146305,146305,146306,0,1,2
41764,1,2,146306,146306,146308,0,2,0
41765,5,1,146311,146311,146312,0,1,3
41766,6,3,146317,146317,146320,0,3,5
41767,3,1,146320,146320,146321,0,1,0
41768,5,2,146325,146325,146327,0,2,4
41769,4,1,146329,146329,146330,0,1,2
41770,4,2,146333,146333,146335,0,2,3
41771,6,3,146339,146339,146342,0,3,4
41772,1,3,146340,146342,146345,2,5,0
41773,5,3,146345,146345,146348,0,3,0
41774,3,1,146348,146348,146349,0,1,0
41775,1,2,146349,146349,146351,0,2,0
41776,5,2,146354,146354,146356,0,2,3
41777,3,2,146357,146357,146359,0,2,1
41778,6,3,146363,146363,146366,0,3,4
41779,2,2,146365,146366,146368,1,3,0
41780,6,3,146371,146371,146374,0,3,3
41781,5,3,146376,146376,146379,0,3,2
41782,3,1,146379,146379,146380,0,1,0
41783,3,2,146382,146382,146384,0,2,2
41784,4,1,146386,146386,146387,0,1,2
41785,6,3,146392,146392,146395,0,3,5
41786,6,1,146398,146398,146399,0,1,3
41787,1,2,146399,146399,146401,0,2,0
41788,4,3,146403,146403,146406,0,3,2
41789,6,1,146409,146409,146410,0,1,3
41790,1,2,146410,146410,146412,0,2,0
41791,5,3,146415,146415,146418,0,3,3
41792,2,2,146417,146418,146420,1,3,0
41793,2,2,146419,146420,146422,1,3,0
41794,6,1,146425,146425,146426,0,1,3
41795,3,1,146428,146428,146429,0,1,2
41796,6,2,146434,146434,146436,0,2,5
41797,1,1,146435,146436,146437,1,2,0
41798,6,1,146441,146441,146442,0,1,4
41799,4,3,146445,146445,146448,0,3,3
41800,5,3,146450,146450,146453,0,3,2
41801,2,1,146452,146453,146454,1,2,0
41802,5,1,146457,146457,146458,0,1,3
41803,3,2,146460,146460,146462,0,2,2
41804,2,2,146462,146462,146464,0,2,0
41805,1,1,146463,146464,146465,1,2,0
41806,1,1,146464,146465,146466,1,2,0
41807,6,1,146470,146470,146471,0,1,4
41808,4,1,146474,146474,146475,0,1,3
41809,6,3,146480,146480,146483,0,3,5
41810,5,3,146485,146485,146488,0,3,2
41811,3,1,146488,146488,146489,0,1,0
41812,3,3,146491,146491,146494,0,3,2
41813,1,1,146492,146494,146495,2,3,0
41814,3,3,146495,146495,146498,0,3,0
41815,6,3,146501,146501,146504,0,3,3
41816,3,3,146504,146504,146507,0,3,0
41817,4,1,146508,146508,146509,0,1,1
41818,3,3,146511,146511,146514,0,3,2
41819,6,3,146517,146517,146520,0,3,3
41820,2,2,146519,146520,146522,1,3,0
41821,1,2,146520,146522,146524,2,4,0
41822,3,3,146523,146524,146527,1,4,0
41823,3,1,146526,146527,146528,1,2,0
41824,6,1,146532,146532,146533,0,1,4
41825,2,2,146534,146534,146536,0,2,1
41826,4,3,146538,146538,146541,0,3,2
41827,6,2,146544,146544,146546,0,2,3
41828,6,1,146550,146550,146551,0,1,4
41829,5,1,146555,146555,146556,0,1,4
41830,1,3,146556,146556,146559,0,3,0
41831,5,2,146561,146561,146563,0,2,2
41832,5,2,146566,146566,146568,0,2,3
41833,1,1,146567,146568,146569,1,2,0
41834,2,3,146569,146569,146572,0,3,0
41835,1,1,146570,146572,146573,2,3,0
41836,6,1,146576,146576,146577,0,1,3
41837,5,1,146581,146581,146582,0,1,4
41838,6,2,146587,146587,146589,0,2,5
41839,2,3,146589,146589,146592,0,3,0
41840,2,3,146591,146592,146595,1,4,0
41841,6,3,146597,146597,146600,0,3,2
41842,1,3,146598,146600,146603,2,5,0
41843,1,1,146599,146603,146604,4,5,0
41844,3,2,146602,146604,146606,2,4,0
41845,2,2,146604,146606,146608,2,4,0
41846,4,1,146608,146608,146609,0,1,0
41847,6,3,146614,146614,146617,0,3,5
41848,1,2,146615,146617,146619,2,4,0
41849,2,1,146617,146619,146620,2,3,0
41850,1,3,146618,146620,146623,2,5,0
41851,5,1,146623,146623,146624,0,1,0
41852,3,1,146626,146626,146627,0,1,2
41853,5,3,146631,146631,146634,0,3,4
41854,6,2,146637,146637,146639,0,2,3
41855,5,2,146642,146642,146644,0,2,3
41856,6,1,146648,146648,146649,0,1,4
41857,3,3,146651,146651,146654,0,3,2
41858,6,2,146657,146657,146659,0,2,3
41859,6,1,146663,146663,146664,0,1,4
41860,2,1,146665,146665,146666,0,1,1
41861,2,1,146667,146667,146668,0,1,1
41862,4,1,146671,146671,146672,0,1,3
41863,1,2,146672,146672,146674,0,2,0
41864,3,3,146675,146675,146678,0,3,1
41865,2,2,146677,146678,146680,1,3,0
41866,5,3,146682,146682,146685,0,3,2
41867,1,1,146683,146685,146686,2,3,0
41868,2,2,146685,146686,146688,1,3,0
41869,1,1,146686,146688,146689,2,3,0
41870,5,3,146691,146691,146694,0,3,2
41871,4,2,146695,146695,146697,0,2,1
41872,5,2,146700,146700,146702,0,2,3
41873,5,2,146705,146705,146707,0,2,3
41874,2,2,146707,146707,146709,0,2,0
41875,4,2,146711,146711,146713,0,2,2
41876,5,2,146716,146716,146718,0,2,3
41877,1,1,146717,146718,146719,1,2,0
41878,6,3,146723,146723,146726,0,3,4
41879,1,2,146724,146726,146728,2,4,0
41880,6,2,146730,146730,146732,0,2,2
41881,2,2,146732,146732,146734,0,2,0
41882,3,3,146735,146735,146738,0,3,1
41883,3,1,146738,146738,146739,0,1,0
41884,2,2,146740,146740,146742,0,2,1
41885,2,1,146742,146742,146743,0,1,0
41886,1,2,146743,146743,146745,0,2,0
41887,6,1,146749,146749,146750,0,1,4
41888,1,1,146750,146750,146751,0,1,0
41889,6,3,146756,146756,146759,0,3,5
41890,1,1,146757,146759,146760,2,3,0
41891,3,1,146760,146760,146761,0,1,0
41892,6,3,146766,146766,146769,0,3,5
41893,4,2,146770,146770,146772,0,2,1
41894,3,1,146773,146773,146774,0,1,1
41895,2,3,146775,146775,146778,0,3,1
41896,5,3,146780,146780,146783,0,3,2
41897,3,2,146783,146783,146785,0,2,0
41898,5,1,146788,146788,146789,0,1,3
41899,4,3,146792,146792,146795,0,3,3
41900,3,1,146795,146795,146796,0,1,0
41901,6,1,146801,146801,146802,0,1,5
41902,3,2,146804,146804,146806,0,2,2
41903,2,3,146806,146806,146809,0,3,0
41904,5,3,146811,146811,146814,0,3,2
41905,3,2,146814,146814,146816,0,2,0
41906,2,2,146816,146816,146818,0,2,0
41907,1,1,146817,146818,146819,1,2,0
41908,3,2,146820,146820,146822,0,2,1
41909,6,2,146826,146826,146828,0,2,4
41910,5,1,146831,146831,146832,0,1,3
41911,2,2,146833,146833,146835,0,2,1
41912,1,2,146834,146835,146837,1,3,0
41913,5,1,146839,146839,146840,0,1,2
41914,5,2,146844,146844,146846,0,2,4
41915,3,2,146847,146847,146849,0,2,1
41916,5,3,146852,146852,146855,0,3,3
41917,3,2,146855,146855,146857,0,2,0
41918,5,3,146860,146860,146863,0,3,3
41919,1,2,146861,146863,146865,2,4,0
41920,6,3,146867,146867,146870,0,3,2
41921,4,2,146871,146871,146873,0,2,1
41922,5,1,146876,146876,146877,0,1,3
41923,4,3,146880,146880,146883,0,3,3
41924,4,3,146884,146884,146887,0,3,1
41925,3,3,146887,146887,146890,0,3,0
41926,1,3,146888,146890,146893,2,5,0
41927,4,2,146892,146893,146895,1,3,0
41928,2,1,146894,146895,146896,1,2,0
41929,3,2,146897,146897,146899,0,2,1
41930,5,3,146902,146902,146905,0,3,3
41931,6,1,146908,146908,146909,0,1,3
41932,3,2,146911,146911,146913,0,2,2
41933,5,1,146916,146916,146917,0,1,3
41934,1,3,146917,146917,146920,0,3,0
41935,4,2,146921,146921,146923,0,2,1
41936,1,3,146922,146923,146926,1,4,0
41937,2,3,146924,146926,146929,2,5,0
41938,4,1,146928,146929,146930,1,2,0
41939,4,3,146932,146932,146935,0,3,2
41940,6,1,146938,146938,146939,0,1,3
41941,4,3,146942,146942,146945,0,3,3
41942,4,3,146946,146946,146949,0,3,1
41943,2,2,146948,146949,146951,1,3,0
41944,4,3,146952,146952,146955,0,3,1
41945,6,1,146958,146958,146959,0,1,3
41946,4,3,146962,146962,146965,0,3,3
41947,4,2,146966,146966,146968,0,2,1
41948,3,2,146969,146969,146971,0,2,1
41949,2,1,146971,146971,146972,0,1,0
41950,1,1,146972,146972,146973,0,1,0
41951,4,1,146976,146976,146977,0,1,3
41952,4,2,146980,146980,146982,0,2,3
41953,6,2,146986,146986,146988,0,2,4
41954,3,3,146989,146989,146992,0,3,1
41955,1,1,146990,146992,146993,2,3,0
41956,2,1,146992,146993,146994,1,2,0
41957,4,1,146996,146996,146997,0,1,2
41958,5,1,147001,147001,147002,0,1,4
41959,2,2,147003,147003,147005,0,2,1
41960,3,2,147006,147006,147008,0,2,1
41961,4,3,147010,147010,147013,0,3,2
41962,3,3,147013,147013,147016,0,3,0
41963,6,2,147019,147019,147021,0,2,3
41964,1,1,147020,147021,147022,1,2,0
41965,6,1,147026,147026,147027,0,1,4
41966,5,3,147031,147031,147034,0,3,4
41967,6,1,147037,147037,147038,0,1,3
41968,4,2,147041,147041,147043,0,2,3
41969,4,3,147045,147045,147048,0,3,2
41970,1,1,147046,147048,147049,2,3,0
41971,4,3,147050,147050,147053,0,3,1
41972,5,3,147055,147055,147058,0,3,2
41973,4,3,147059,147059,147062,0,3,1
41974,6,3,147065,147065,147068,0,3,3
41975,1,1,147066,147068,147069,2,3,0
41976,4,2,147070,147070,147072,0,2,1
41977,2,3,147072,147072,147075,0,3,0
41978,2,3,147074,147075,147078,1,4,0
41979,5,3,147079,147079,147082,0,3,1
41980,5,1,147084,147084,147085,0,1,2
41981,3,1,147087,147087,147088,0,1,2
41982,1,3,147088,147088,147091,0,3,0
41983,6,3,147094,147094,147097,0,3,3
41984,3,2,147097,147097,147099,0,2,0
41985,1,2,147098,147099,147101,1,3,0
41986,3,2,147101,147101,147103,0,2,0
41987,1,2,147102,147103,147105,1,3,0
41988,6,3,147108,147108,147111,0,3,3
41989,2,2,147110,147111,147113,1,3,0
41990,5,2,147115,147115,147117,0,2,2
41991,2,3,147117,147117,147120,0,3,0
41992,3,3,147120,147120,147123,0,3,0
41993,6,1,147126,147126,147127,0,1,3
41994,1,3,147127,147127,147130,0,3,0
41995,1,1,147128,147130,147131,2,3,0
41996,3,2,147131,147131,147133,0,2,0
41997,6,1,147137,147137,147138,0,1,4
41998,1,1,147138,147138,147139,0,1,0
41999,5,1,147143,147143,147144,0,1,4
42000,2,3,147145,147145,147148,0,3,1
42001,6,1,147151,147151,147152,0,1,3
42002,6,2,147157,147157,147159,0,2,5
42003,6,3,147163,147163,147166,0,3,4
42004,2,2,147165,147166,147168,1,3,0
42005,2,1,147167,147168,147169,1,2,0
42006,6,3,147173,147173,147176,0,3,4
42007,6,1,147179,147179,147180,0,1,3
42008,1,1,147180,147180,147181,0,1,0
42009,4,3,147184,147184,147187,0,3,3
42010,4,2,147188,147188,147190,0,2,1
42011,3,3,147191,147191,147194,0,3,1
42012,5,1,147196,147196,147197,0,1,2
42013,2,3,147198,147198,147201,0,3,1
42014,4,2,147202,147202,147204,0,2,1
42015,6,1,147208,147208,147209,0,1,4
42016,4,3,147212,147212,147215,0,3,3
42017,3,3,147215,147215,147218,0,3,0
42018,4,3,147219,147219,147222,0,3,1
42019,2,1,147221,147222,147223,1,2,0
42020,1,1,147222,147223,147224,1,2,0
42021,5,2,147227,147227,147229,0,2,3
42022,4,1,147231,147231,147232,0,1,2
42023,1,3,147232,147232,147235,0,3,0
42024,6,3,147238,147238,147241,0,3,3
42025,1,1,147239,147241,147242,2,3,0
42026,2,2,147241,147242,147244,1,3,0
42027,6,1,147247,147247,147248,0,1,3
42028,1,2,147248,147248,147250,0,2,0
42029,2,3,147250,147250,147253,0,3,0
42030,2,1,147252,147253,147254,1,2,0
42031,5,2,147257,147257,147259,0,2,3
42032,4,3,147261,147261,147264,0,3,2
42033,3,2,147264,147264,147266,0,2,0
42034,2,3,147266,147266,147269,0,3,0
42035,2,1,147268,147269,147270,1,2,0
42036,5,3,147273,147273,147276,0,3,3
42037,3,2,147276,147276,147278,0,2,0
42038,3,1,147279,147279,147280,0,1,1
42039,5,3,147284,147284,147287,0,3,4
42040,3,2,147287,147287,147289,0,2,0
42041,3,2,147290,147290,147292,0,2,1
42042,6,2,147296,147296,147298,0,2,4
42043,6,1,147302,147302,147303,0,1,4
42044,2,2,147304,147304,147306,0,2,1
42045,1,3,147305,147306,147309,1,4,0
42046,1,2,147306,147309,147311,3,5,0
42047,4,3,147310,147311,147314,1,4,0
42048,6,2,147316,147316,147318,0,2,2
42049,4,3,147320,147320,147323,0,3,2
42050,3,3,147323,147323,147326,0,3,0
42051,3,1,147326,147326,147327,0,1,0
42052,6,1,147332,147332,147333,0,1,5
42053,1,2,147333,147333,147335,0,2,0
42054,3,2,147336,147336,147338,0,2,1
42055,3,3,147339,147339,147342,0,3,1
42056,6,2,147345,147345,147347,0,2,3
42057,3,2,147348,147348,147350,0,2,1
42058,2,2,147350,147350,147352,0,2,0
42059,3,2,147353,147353,147355,0,2,1
42060,5,1,147358,147358,147359,0,1,3
42061,4,2,147362,147362,147364,0,2,3
42062,1,1,147363,147364,147365,1,2,0
42063,5,3,147368,147368,147371,0,3,3
42064,5,3,147373,147373,147376,0,3,2
42065,5,2,147378,147378,147380,0,2,2
42066,3,3,147381,147381,147384,0,3,1
42067,2,3,147383,147384,147387,1,4,0
42068,1,3,147384,147387,147390,3,6,0
42069,4,1,147388,147390,147391,2,3,0
42070,3,2,147391,147391,147393,0,2,0
42071,6,2,147397,147397,147399,0,2,4
42072,6,3,147403,147403,147406,0,3,4
42073,6,2,147409,147409,147411,0,2,3
42074,5,2,147414,147414,147416,0,2,3
42075,2,1,147416,147416,147417,0,1,0
42076,2,3,147418,147418,147421,0,3,1
42077,4,2,147422,147422,147424,0,2,1
42078,1,1,147423,147424,147425,1,2,0
42079,2,2,147425,147425,147427,0,2,0
42080,3,2,147428,147428,147430,0,2,1
42081,3,2,147431,147431,147433,0,2,1
42082,4,2,147435,147435,147437,0,2,2
42083,6,3,147441,147441,147444,0,3,4
42084,3,3,147444,147444,147447,0,3,0
42085,4,3,147448,147448,147451,0,3,1
42086,1,3,147449,147451,147454,2,5,0
42087,6,3,147455,147455,147458,0,3,1
42088,6,1,147461,147461,147462,0,1,3
42089,1,1,147462,147462,147463,0,1,0
42090,2,1,147464,147464,147465,0,1,1
42091,1,1,147465,147465,147466,0,1,0
42092,2,2,147467,147467,147469,0,2,1
42093,1,1,147468,147469,147470,1,2,0
42094,5,3,147473,147473,147476,0,3,3
42095,1,2,147474,147476,147478,2,4,0
42096,2,3,147476,147478,147481,2,5,0
42097,6,1,147482,147482,147483,0,1,1
42098,5,1,147487,147487,147488,0,1,4
42099,5,3,147492,147492,147495,0,3,4
42100,3,3,147495,147495,147498,0,3,0
42101,3,2,147498,147498,147500,0,2,0
42102,5,3,147503,147503,147506,0,3,3
42103,4,1,147507,147507,147508,0,1,1
42104,2,3,147509,147509,147512,0,3,1
42105,5,1,147514,147514,147515,0,1,2
42106,1,2,147515,147515,147517,0,2,0
42107,3,2,147518,147518,147520,0,2,1
42108,4,1,147522,147522,147523,0,1,2
42109,3,3,147525,147525,147528,0,3,2
42110,4,2,147529,147529,147531,0,2,1
42111,2,3,147531,147531,147534,0,3,0
42112,1,3,147532,147534,147537,2,5,0
42113,2,1,147534,147537,147538,3,4,0
42114,3,2,147537,147538,147540,1,3,0
42115,4,2,147541,147541,147543,0,2,1
42116,6,1,147547,147547,147548,0,1,4
42117,2,1,147549,147549,147550,0,1,1
42118,1,3,147550,147550,147553,0,3,0
42119,2,2,147552,147553,147555,1,3,0
42120,6,1,147558,147558,147559,0,1,3
42121,6,1,147564,147564,147565,0,1,5
42122,5,3,147569,147569,147572,0,3,4
42123,2,1,147571,147572,147573,1,2,0
42124,2,2,147573,147573,147575,0,2,0
42125,1,3,147574,147575,147578,1,4,0
42126,6,2,147580,147580,147582,0,2,2
42127,5,3,147585,147585,147588,0,3,3
42128,4,2,147589,147589,147591,0,2,1
42129,2,1,147591,147591,147592,0,1,0
42130,5,3,147596,147596,147599,0,3,4
42131,5,1,147601,147601,147602,0,1,2
42132,3,3,147604,147604,147607,0,3,2
42133,5,3,147609,147609,147612,0,3,2
42134,5,1,147614,147614,147615,0,1,2
42135,3,1,147617,147617,147618,0,1,2
42136,4,2,147621,147621,147623,0,2,3
42137,2,3,147623,147623,147626,0,3,0
42138,3,3,147626,147626,147629,0,3,0
42139,3,2,147629,147629,147631,0,2,0
42140,6,1,147635,147635,147636,0,1,4
42141,6,1,147641,147641,147642,0,1,5
42142,1,2,147642,147642,147644,0,2,0
42143,4,2,147646,147646,147648,0,2,2
42144,4,3,147650,147650,147653,0,3,2
42145,2,1,147652,147653,147654,1,2,0
42146,6,1,147658,147658,147659,0,1,4
42147,5,3,147663,147663,147666,0,3,4
42148,6,3,147669,147669,147672,0,3,3
42149,3,3,147672,147672,147675,0,3,0
42150,5,1,147677,147677,147678,0,1,2
42151,2,1,147679,147679,147680,0,1,1
42152,1,1,147680,147680,147681,0,1,0
42153,6,3,147686,147686,147689,0,3,5
42154,5,2,147691,147691,147693,0,2,2
42155,4,3,147695,147695,147698,0,3,2
42156,4,2,147699,147699,147701,0,2,1
42157,3,3,147702,147702,147705,0,3,1
42158,5,3,147707,147707,147710,0,3,2
42159,2,3,147709,147710,147713,1,4,0
42160,6,1,147715,147715,147716,0,1,2
42161,5,1,147720,147720,147721,0,1,4
42162,2,2,147722,147722,147724,0,2,1
42163,5,1,147727,147727,147728,0,1,3
42164,5,2,147732,147732,147734,0,2,4
42165,5,1,147737,147737,147738,0,1,3
42166,5,3,147742,147742,147745,0,3,4
42167,1,2,147743,147745,147747,2,4,0
42168,2,2,147745,147747,147749,2,4,0
42169,5,1,147750,147750,147751,0,1,1
42170,4,1,147754,147754,147755,0,1,3
42171,4,1,147758,147758,147759,0,1,3
42172,4,3,147762,147762,147765,0,3,3
42173,4,1,147766,147766,147767,0,1,1
42174,2,3,147768,147768,147771,0,3,1
42175,2,2,147770,147771,147773,1,3,0
42176,1,3,147771,147773,147776,2,5,0
42177,4,2,147775,147776,147778,1,3,0
42178,1,3,147776,147778,147781,2,5,0
42179,4,3,147780,147781,147784,1,4,0
42180,2,2,147782,147784,147786,2,4,0
42181,3,1,147785,147786,147787,1,2,0
42182,6,3,147791,147791,147794,0,3,4
42183,1,3,147792,147794,147797,2,5,0
42184,1,1,147793,147797,147798,4,5,0
42185,1,2,147794,147798,147800,4,6,0
42186,6,2,147800,147800,147802,0,2,0
42187,2,1,147802,147802,147803,0,1,0
42188,2,3,147804,147804,147807,0,3,1
42189,2,2,147806,147807,147809,1,3,0
42190,4,2,147810,147810,147812,0,2,1
42191,6,3,147816,147816,147819,0,3,4
42192,4,2,147820,147820,147822,0,2,1
42193,4,3,147824,147824,147827,0,3,2
42194,3,2,147827,147827,147829,0,2,0
42195,6,3,147833,147833,147836,0,3,4
42196,2,2,147835,147836,147838,1,3,0
42197,4,3,147839,147839,147842,0,3,1
42198,1,2,147840,147842,147844,2,4,0
42199,1,3,147841,147844,147847,3,6,0
42200,5,2,147846,147847,147849,1,3,0
42201,4,2,147850,147850,147852,0,2,1
42202,4,1,147854,147854,147855,0,1,2
42203,3,3,147857,147857,147860,0,3,2
42204,1,1,147858,147860,147861,2,3,0
42205,6,1,147864,147864,147865,0,1,3
42206,5,1,147869,147869,147870,0,1,4
42207,3,2,147872,147872,147874,0,2,2
42208,2,1,147874,147874,147875,0,1,0
42209,3,1,147877,147877,147878,0,1,2
42210,3,3,147880,147880,147883,0,3,2
42211,3,2,147883,147883,147885,0,2,0
42212,1,3,147884,147885,147888,1,4,0
42213,1,3,147885,147888,147891,3,6,0
42214,3,1,147888,147891,147892,3,4,0
42215,5,2,147893,147893,147895,0,2,1
42216,4,2,147897,147897,147899,0,2,2
42217,1,2,147898,147899,147901,1,3,0
42218,4,2,147902,147902,147904,0,2,1
42219,3,2,147905,147905,147907,0,2,1
42220,4,2,147909,147909,147911,0,2,2
42221,6,1,147915,147915,147916,0,1,4
42222,5,3,147920,147920,147923,0,3,4
42223,3,3,147923,147923,147926,0,3,0
42224,6,2,147929,147929,147931,0,2,3
42225,3,2,147932,147932,147934,0,2,1
42226,3,1,147935,147935,147936,0,1,1
42227,6,2,147941,147941,147943,0,2,5
42228,2,1,147943,147943,147944,0,1,0
42229,5,3,147948,147948,147951,0,3,4
42230,6,1,147954,147954,147955,0,1,3
42231,4,1,147958,147958,147959,0,1,3
42232,3,2,147961,147961,147963,0,2,2
42233,3,1,147964,147964,147965,0,1,1
42234,3,3,147967,147967,147970,0,3,2
42235,6,3,147973,147973,147976,0,3,3
42236,3,2,147976,147976,147978,0,2,0
42237,2,3,147978,147978,147981,0,3,0
42238,5,2,147983,147983,147985,0,2,2
42239,5,2,147988,147988,147990,0,2,3
42240,5,1,147993,147993,147994,0,1,3
42241,5,1,147998,147998,147999,0,1,4
42242,3,2,148001,148001,148003,0,2,2
42243,4,2,148005,148005,148007,0,2,2
42244,1,2,148006,148007,148009,1,3,0
42245,3,2,148009,148009,148011,0,2,0
42246,4,2,148013,148013,148015,0,2,2
42247,1,2,148014,148015,148017,1,3,0
42248,6,3,148020,148020,148023,0,3,3
42249,2,1,148022,148023,148024,1,2,0
42250,2,3,148024,148024,148027,0,3,0
42251,6,3,148030,148030,148033,0,3,3
42252,1,3,148031,148033,148036,2,5,0
42253,5,1,148036,148036,148037,0,1,0
42254,3,3,148039,148039,148042,0,3,2
42255,5,1,148044,148044,148045,0,1,2
42256,3,3,148047,148047,148050,0,3,2
42257,6,1,148053,148053,148054,0,1,3
42258,5,3,148058,148058,148061,0,3,4
42259,5,3,148063,148063,148066,0,3,2
42260,1,2,148064,148066,148068,2,4,0
42261,3,1,148067,148068,148069,1,2,0
42262,4,1,148071,148071,148072,0,1,2
42263,5,2,148076,148076,148078,0,2,4
42264,2,1,148078,148078,148079,0,1,0
42265,4,2,148082,148082,148084,0,2,3
42266,5,1,148087,148087,148088,0,1,3
42267,3,3,148090,148090,148093,0,3,2
42268,1,2,148091,148093,148095,2,4,0
42269,4,3,148095,148095,148098,0,3,0
42270,1,2,148096,148098,148100,2,4,0
42271,6,1,148102,148102,148103,0,1,2
42272,3,1,148105,148105,148106,0,1,2
42273,2,3,148107,148107,148110,0,3,1
42274,5,1,148112,148112,148113,0,1,2
42275,1,3,148113,148113,148116,0,3,0
42276,1,2,148114,148116,148118,2,4,0
42277,5,1,148119,148119,148120,0,1,1
42278,1,1,148120,148120,148121,0,1,0
42279,3,2,148123,148123,148125,0,2,2
42280,4,3,148127,148127,148130,0,3,2
42281,4,3,148131,148131,148134,0,3,1
42282,6,2,148137,148137,148139,0,2,3
42283,5,2,148142,148142,148144,0,2,3
42284,3,2,148145,148145,148147,0,2,1
42285,6,3,148151,148151,148154,0,3,4
42286,6,3,148157,148157,148160,0,3,3
42287,5,2,148162,148162,148164,0,2,2
42288,2,3,148164,148164,148167,0,3,0
42289,3,3,148167,148167,148170,0,3,0
42290,3,2,148170,148170,148172,0,2,0
42291,6,2,148176,148176,148178,0,2,4
42292,2,2,148178,148178,148180,0,2,0
42293,5,1,148183,148183,148184,0,1,3
42294,6,1,148189,148189,148190,0,1,5
42295,3,1,148192,148192,148193,0,1,2
42296,4,2,148196,148196,148198,0,2,3
42297,5,2,148201,148201,148203,0,2,3
42298,2,2,148203,148203,148205,0,2,0
42299,5,3,148208,148208,148211,0,3,3
42300,1,2,148209,148211,148213,2,4,0
42301,5,3,148214,148214,148217,0,3,1
42302,4,2,148218,148218,148220,0,2,1
42303,3,3,148221,148221,148224,0,3,1
42304,3,2,148224,148224,148226,0,2,0
42305,2,1,148226,148226,148227,0,1,0
42306,1,2,148227,148227,148229,0,2,0
42307,1,2,148228,148229,148231,1,3,0
42308,5,3,148233,148233,148236,0,3,2
42309,4,3,148237,148237,148240,0,3,1
42310,5,3,148242,148242,148245,0,3,2
42311,2,3,148244,148245,148248,1,4,0
42312,4,2,148248,148248,148250,0,2,0
42313,5,2,148253,148253,148255,0,2,3
42314,6,2,148259,148259,148261,0,2,4
42315,3,2,148262,148262,148264,0,2,1
42316,3,2,148265,148265,148267,0,2,1
42317,1,3,148266,148267,148270,1,4,0
42318,3,1,148269,148270,148271,1,2,0
42319,6,3,148275,148275,148278,0,3,4
42320,5,1,148280,148280,148281,0,1,2
42321,1,1,148281,148281,148282,0,1,0
42322,6,1,148287,148287,148288,0,1,5
42323,1,1,148288,148288,148289,0,1,0
42324,4,1,148292,148292,148293,0,1,3
42325,6,3,148298,148298,148301,0,3,5
42326,1,3,148299,148301,148304,2,5,0
42327,1,2,148300,148304,148306,4,6,0
42328,1,3,148301,148306,148309,5,8,0
42329,4,3,148305,148309,148312,4,7,0
42330,6,3,148311,148312,148315,1,4,0
42331,3,3,148314,148315,148318,1,4,0
42332,3,2,148317,148318,148320,1,3,0
42333,2,3,148319,148320,148323,1,4,0
42334,3,1,148322,148323,148324,1,2,0
42335,3,2,148325,148325,148327,0,2,1
42336,6,1,148331,148331,148332,0,1,4
42337,6,2,148337,148337,148339,0,2,5
42338,3,3,148340,148340,148343,0,3,1
42339,5,1,148345,148345,148346,0,1,2
42340,3,2,148348,148348,148350,0,2,2
42341,3,2,148351,148351,148353,0,2,1
42342,5,3,148356,148356,148359,0,3,3
42343,5,3,148361,148361,148364,0,3,2
42344,6,1,148367,148367,148368,0,1,3
42345,2,1,148369,148369,148370,0,1,1
42346,5,2,148374,148374,148376,0,2,4
42347,3,3,148377,148377,148380,0,3,1
42348,1,2,148378,148380,148382,2,4,0
42349,2,1,148380,148382,148383,2,3,0
42350,4,1,148384,148384,148385,0,1,1
42351,1,3,148385,148385,148388,0,3,0
42352,1,3,148386,148388,148391,2,5,0
42353,3,2,148389,148391,148393,2,4,0
42354,5,2,148394,148394,148396,0,2,1
42355,6,3,148400,148400,148403,0,3,4
42356,1,3,148401,148403,148406,2,5,0
42357,6,2,148407,148407,148409,0,2,1
42358,5,2,148412,148412,148414,0,2,3
42359,3,1,148415,148415,148416,0,1,1
42360,4,2,148419,148419,148421,0,2,3
42361,5,1,148424,148424,148425,0,1,3
42362,4,1,148428,148428,148429,0,1,3
42363,4,1,148432,148432,148433,0,1,3
42364,2,1,148434,148434,148435,0,1,1
42365,6,2,148440,148440,148442,0,2,5
42366,2,1,148442,148442,148443,0,1,0
42367,3,3,148445,148445,148448,0,3,2
42368,3,3,148448,148448,148451,0,3,0
42369,4,1,148452,148452,148453,0,1,1
42370,3,2,148455,148455,148457,0,2,2
42371,4,2,148459,148459,148461,0,2,2
42372,1,2,148460,148461,148463,1,3,0
42373,2,2,148462,148463,148465,1,3,0
42374,1,1,148463,148465,148466,2,3,0
42375,1,2,148464,148466,148468,2,4,0
42376,1,1,148465,148468,148469,3,4,0
42377,5,3,148470,148470,148473,0,3,1
42378,2,2,148472,148473,148475,1,3,0
42379,3,2,148475,148475,148477,0,2,0
42380,2,2,148477,148477,148479,0,2,0
42381,3,2,148480,148480,148482,0,2,1
42382,4,1,148484,148484,148485,0,1,2
42383,4,3,148488,148488,148491,0,3,3
42384,5,3,148493,148493,148496,0,3,2
42385,5,2,148498,148498,148500,0,2,2
42386,6,1,148504,148504,148505,0,1,4
42387,1,2,148505,148505,148507,0,2,0
42388,1,2,148506,148507,148509,1,3,0
42389,2,1,148508,148509,148510,1,2,0
42390,4,2,148512,148512,148514,0,2,2
42391,5,1,148517,148517,148518,0,1,3
42392,5,2,148522,148522,148524,0,2,4
42393,2,1,148524,148524,148525,0,1,0
42394,1,3,148525,148525,148528,0,3,0
42395,3,2,148528,148528,148530,0,2,0
42396,3,2,148531,148531,148533,0,2,1
42397,1,2,148532,148533,148535,1,3,0
42398,5,2,148537,148537,148539,0,2,2
42399,5,3,148542,148542,148545,0,3,3
42400,1,3,148543,148545,148548,2,5,0
42401,2,1,148545,148548,148549,3,4,0
42402,4,2,148549,148549,148551,0,2,0
42403,6,3,148555,148555,148558,0,3,4
42404,3,1,148558,148558,148559,0,1,0
42405,6,1,148564,148564,148565,0,1,5
42406,3,1,148567,148567,148568,0,1,2
42407,6,1,148573,148573,148574,0,1,5
42408,3,1,148576,148576,148577,0,1,2
42409,5,1,148581,148581,148582,0,1,4
42410,1,1,148582,148582,148583,0,1,0
42411,6,3,148588,148588,148591,0,3,5
42412,1,3,148589,148591,148594,2,5,0
42413,6,1,148595,148595,148596,0,1,1
42414,4,3,148599,148599,148602,0,3,3
42415,2,1,148601,148602,148603,1,2,0
42416,6,3,148607,148607,148610,0,3,4
42417,3,3,148610,148610,148613,0,3,0
42418,4,2,148614,148614,148616,0,2,1
42419,5,1,148619,148619,148620,0,1,3
42420,2,2,148621,148621,148623,0,2,1
42421,2,2,148623,148623,148625,0,2,0
42422,5,3,148628,148628,148631,0,3,3
42423,3,3,148631,148631,148634,0,3,0
42424,6,1,148637,148637,148638,0,1,3
42425,1,1,148638,148638,148639,0,1,0
42426,1,1,148639,148639,148640,0,1,0
42427,3,1,148642,148642,148643,0,1,2
42428,4,3,148646,148646,148649,0,3,3
42429,5,1,148651,148651,148652,0,1,2
42430,6,1,148657,148657,148658,0,1,5
42431,4,3,148661,148661,148664,0,3,3
42432,1,1,148662,148664,148665,2,3,0
42433,3,2,148665,148665,148667,0,2,0
42434,3,3,148668,148668,148671,0,3,1
42435,4,2,148672,148672,148674,0,2,1
42436,1,1,148673,148674,148675,1,2,0
42437,2,2,148675,148675,148677,0,2,0
42438,6,3,148681,148681,148684,0,3,4
42439,2,1,148683,148684,148685,1,2,0
42440,4,3,148687,148687,148690,0,3,2
42441,6,1,148693,148693,148694,0,1,3
42442,6,3,148699,148699,148702,0,3,5
42443,6,2,148705,148705,148707,0,2,3
42444,2,2,148707,148707,148709,0,2,0
42445,1,2,148708,148709,148711,1,3,0
42446,3,1,148711,148711,148712,0,1,0
42447,5,1,148716,148716,148717,0,1,4
42448,6,2,148722,148722,148724,0,2,5
42449,3,3,148725,148725,148728,0,3,1
42450,6,3,148731,148731,148734,0,3,3
42451,5,2,148736,148736,148738,0,2,2
42452,5,1,148741,148741,148742,0,1,3
42453,3,3,148744,148744,148747,0,3,2
42454,4,2,148748,148748,148750,0,2,1
42455,4,2,148752,148752,148754,0,2,2
42456,5,1,148757,148757,148758,0,1,3
42457,6,3,148763,148763,148766,0,3,5
42458,6,1,148769,148769,148770,0,1,3
42459,3,1,148772,148772,148773,0,1,2
42460,1,2,148773,148773,148775,0,2,0
42461,5,3,148778,148778,148781,0,3,3
42462,2,3,148780,148781,148784,1,4,0
42463,5,1,148785,148785,148786,0,1,1
42464,1,2,148786,148786,148788,0,2,0
42465,2,2,148788,148788,148790,0,2,0
42466,4,1,148792,148792,148793,0,1,2
42467,1,3,148793,148793,148796,0,3,0
42468,5,3,148798,148798,148801,0,3,2
42469,3,1,148801,148801,148802,0,1,0
42470,5,1,148806,148806,148807,0,1,4
42471,2,1,148808,148808,148809,0,1,1
42472,2,2,148810,148810,148812,0,2,1
42473,6,2,148816,148816,148818,0,2,4
42474,5,3,148821,148821,148824,0,3,3
42475,5,3,148826,148826,148829,0,3,2
42476,6,2,148832,148832,148834,0,2,3
42477,5,2,148837,148837,148839,0,2,3
42478,3,2,148840,148840,148842,0,2,1
42479,3,2,148843,148843,148845,0,2,1
42480,1,1,148844,148845,148846,1,2,0
42481,1,3,148845,148846,148849,1,4,0
42482,4,1,148849,148849,148850,0,1,0
42483,2,1,148851,148851,148852,0,1,1
42484,2,2,148853,148853,148855,0,2,1
42485,3,2,148856,148856,148858,0,2,1
42486,4,3,148860,148860,148863,0,3,2
42487,2,2,148862,148863,148865,1,3,0
42488,3,1,148865,148865,148866,0,1,0
42489,5,1,148870,148870,148871,0,1,4
42490,6,3,148876,148876,148879,0,3,5
42491,1,1,148877,148879,148880,2,3,0
42492,4,1,148881,148881,148882,0,1,1
42493,1,1,148882,148882,148883,0,1,0
42494,5,2,148887,148887,148889,0,2,4
42495,4,3,148891,148891,148894,0,3,2
42496,6,1,148897,148897,148898,0,1,3
42497,4,3,148901,148901,148904,0,3,3
42498,4,1,148905,148905,148906,0,1,1
42499,6,1,148911,148911,148912,0,1,5
42500,3,3,148914,148914,148917,0,3,2
42501,1,1,148915,148917,148918,2,3,0
42502,6,2,148921,148921,148923,0,2,3
42503,5,1,148926,148926,148927,0,1,3
42504,5,1,148931,148931,148932,0,1,4
42505,5,3,148936,148936,148939,0,3,4
42506,4,3,148940,148940,148943,0,3,1
42507,3,2,148943,148943,148945,0,2,0
42508,6,3,148949,148949,148952,0,3,4
42509,6,2,148955,148955,148957,0,2,3
42510,5,3,148960,148960,148963,0,3,3
42511,2,3,148962,148963,148966,1,4,0
42512,3,2,148965,148966,148968,1,3,0
42513,6,2,148971,148971,148973,0,2,3
42514,2,2,148973,148973,148975,0,2,0
42515,3,3,148976,148976,148979,0,3,1
42516,4,2,148980,148980,148982,0,2,1
42517,3,1,148983,148983,148984,0,1,1
42518,4,3,148987,148987,148990,0,3,3
42519,5,3,148992,148992,148995,0,3,2
42520,5,1,148997,148997,148998,0,1,2
42521,3,1,149000,149000,149001,0,1,2
42522,2,2,149002,149002,149004,0,2,1
42523,2,2,149004,149004,149006,0,2,0
42524,1,1,149005,149006,149007,1,2,0
42525,4,2,149009,149009,149011,0,2,2
42526,5,2,149014,149014,149016,0,2,3
42527,3,2,149017,149017,149019,0,2,1
42528,4,3,149021,149021,149024,0,3,2
42529,6,1,149027,149027,149028,0,1,3
42530,6,2,149033,149033,149035,0,2,5
42531,6,2,149039,149039,149041,0,2,4
42532,1,3,149040,149041,149044,1,4,0
42533,2,3,149042,149044,149047,2,5,0
42534,5,2,149047,149047,149049,0,2,0
42535,1,1,149048,149049,149050,1,2,0
42536,2,2,149050,149050,149052,0,2,0
42537,3,3,149053,149053,149056,0,3,1
42538,5,1,149058,149058,149059,0,1,2
42539,6,1,149064,149064,149065,0,1,5
42540,4,1,149068,149068,149069,0,1,3
42541,1,2,149069,149069,149071,0,2,0
42542,5,2,149074,149074,149076,0,2,3
42543,4,2,149078,149078,149080,0,2,2
42544,5,2,149083,149083,149085,0,2,3
42545,5,1,149088,149088,149089,0,1,3
42546,2,1,149090,149090,149091,0,1,1
42547,5,1,149095,149095,149096,0,1,4
42548,2,3,149097,149097,149100,0,3,1
42549,6,2,149103,149103,149105,0,2,3
42550,4,1,149107,149107,149108,0,1,2
42551,2,1,149109,149109,149110,0,1,1
42552,2,1,149111,149111,149112,0,1,1
42553,4,3,149115,149115,149118,0,3,3
42554,2,3,149117,149118,149121,1,4,0
42555,1,2,149118,149121,149123,3,5,0
42556,6,2,149124,149124,149126,0,2,1
42557,2,3,149126,149126,149129,0,3,0
42558,1,3,149127,149129,149132,2,5,0
42559,2,1,149129,149132,149133,3,4,0
42560,6,2,149135,149135,149137,0,2,2
42561,5,1,149140,149140,149141,0,1,3
42562,2,1,149142,149142,149143,0,1,1
42563,2,3,149144,149144,149147,0,3,1
42564,6,2,149150,149150,149152,0,2,3
42565,2,2,149152,149152,149154,0,2,0
42566,6,3,149158,149158,149161,0,3,4
42567,1,3,149159,149161,149164,2,5,0
42568,2,2,149161,149164,149166,3,5,0
42569,5,3,149166,149166,149169,0,3,0
42570,1,2,149167,149169,149171,2,4,0
42571,1,3,149168,149171,149174,3,6,0
42572,3,3,149171,149174,149177,3,6,0
42573,1,2,149172,149177,149179,5,7,0
42574,3,3,149175,149179,149182,4,7,0
42575,1,1,149176,149182,149183,6,7,0
42576,1,1,149177,149183,149184,6,7,0
42577,1,2,149178,149184,149186,6,8,0
42578,5,3,149183,149186,149189,3,6,0
42579,2,3,149185,149189,149192,4,7,0
42580,3,3,149188,149192,149195,4,7,0
42581,5,2,149193,149195,149197,2,4,0
42582,2,1,149195,149197,149198,2,3,0
42583,1,2,149196,149198,149200,2,4,0
42584,3,2,149199,149200,149202,1,3,0
42585,6,2,149205,149205,149207,0,2,3
42586,4,2,149209,149209,149211,0,2,2
42587,6,3,149215,149215,149218,0,3,4
42588,2,3,149217,149218,149221,1,4,0
42589,3,2,149220,149221,149223,1,3,0
42590,4,1,149224,149224,149225,0,1,1
42591,2,2,149226,149226,149228,0,2,1
42592,1,1,149227,149228,149229,1,2,0
42593,2,2,149229,149229,149231,0,2,0
42594,6,1,149235,149235,149236,0,1,4
42595,2,3,149237,149237,149240,0,3,1
42596,2,2,149239,149240,149242,1,3,0
42597,5,3,149244,149244,149247,0,3,2
42598,6,3,149250,149250,149253,0,3,3
42599,4,1,149254,149254,149255,0,1,1
42600,1,1,149255,149255,149256,0,1,0
42601,5,2,149260,149260,149262,0,2,4
42602,6,1,149266,149266,149267,0,1,4
42603,4,1,149270,149270,149271,0,1,3
42604,3,3,149273,149273,149276,0,3,2
42605,5,3,149278,149278,149281,0,3,2
42606,2,3,149280,149281,149284,1,4,0
42607,1,3,149281,149284,149287,3,6,0
42608,6,1,149287,149287,149288,0,1,0
42609,3,1,149290,149290,149291,0,1,2
42610,6,1,149296,149296,149297,0,1,5
42611,3,2,149299,149299,149301,0,2,2
42612,2,2,149301,149301,149303,0,2,0
42613,5,1,149306,149306,149307,0,1,3
42614,2,3,149308,149308,149311,0,3,1
42615,1,3,149309,149311,149314,2,5,0
42616,6,2,149315,149315,149317,0,2,1
42617,1,3,149316,149317,149320,1,4,0
42618,1,3,149317,149320,149323,3,6,0
42619,6,2,149323,149323,149325,0,2,0
42620,4,3,149327,149327,149330,0,3,2
42621,6,3,149333,149333,149336,0,3,3
42622,1,1,149334,149336,149337,2,3,0
42623,5,2,149339,149339,149341,0,2,2
42624,3,3,149342,149342,149345,0,3,1
42625,1,1,149343,149345,149346,2,3,0
42626,2,2,149345,149346,149348,1,3,0
42627,1,2,149346,149348,149350,2,4,0
42628,3,3,149349,149350,149353,1,4,0
42629,4,1,149353,149353,149354,0,1,0
42630,4,2,149357,149357,149359,0,2,3
42631,3,1,149360,149360,149361,0,1,1
42632,2,1,149362,149362,149363,0,1,1
42633,1,1,149363,149363,149364,0,1,0
42634,4,1,149367,149367,149368,0,1,3
42635,3,3,149370,149370,149373,0,3,2
42636,3,2,149373,149373,149375,0,2,0
42637,3,2,149376,149376,149378,0,2,1
42638,4,3,149380,149380,149383,0,3,2
42639,4,1,149384,149384,149385,0,1,1
42640,3,3,149387,149387,149390,0,3,2
42641,3,1,149390,149390,149391,0,1,0
42642,5,1,149395,149395,149396,0,1,4
42643,3,1,149398,149398,149399,0,1,2
42644,4,3,149402,149402,149405,0,3,3
42645,3,2,149405,149405,149407,0,2,0
42646,4,1,149409,149409,149410,0,1,2
42647,1,1,149410,149410,149411,0,1,0
42648,4,3,149414,149414,149417,0,3,3
42649,2,2,149416,149417,149419,1,3,0
42650,4,1,149420,149420,149421,0,1,1
42651,5,1,149425,149425,149426,0,1,4
42652,3,1,149428,149428,149429,0,1,2
42653,4,3,149432,149432,149435,0,3,3
42654,2,3,149434,149435,149438,1,4,0
42655,6,3,149440,149440,149443,0,3,2
42656,1,1,149441,149443,149444,2,3,0
42657,5,3,149446,149446,149449,0,3,2
42658,6,3,149452,149452,149455,0,3,3
42659,4,3,149456,149456,149459,0,3,1
42660,3,1,149459,149459,149460,0,1,0
42661,4,3,149463,149463,149466,0,3,3
42662,4,2,149467,149467,149469,0,2,1
42663,5,1,149472,149472,149473,0,1,3
42664,6,1,149478,149478,149479,0,1,5
42665,6,1,149484,149484,149485,0,1,5
42666,3,3,149487,149487,149490,0,3,2
42667,6,1,149493,149493,149494,0,1,3
42668,3,1,149496,149496,149497,0,1,2
42669,5,3,149501,149501,149504,0,3,4
42670,2,3,149503,149504,149507,1,4,0
42671,1,3,149504,149507,149510,3,6,0
42672,3,3,149507,149510,149513,3,6,0
42673,5,1,149512,149513,149514,1,2,0
42674,4,1,149516,149516,149517,0,1,2
42675,2,2,149518,149518,149520,0,2,1
42676,6,2,149524,149524,149526,0,2,4
42677,3,2,149527,149527,149529,0,2,1
42678,5,1,149532,149532,149533,0,1,3
42679,4,3,149536,149536,149539,0,3,3
42680,5,3,149541,149541,149544,0,3,2
42681,1,3,149542,149544,149547,2,5,0
42682,2,3,149544,149547,149550,3,6,0
42683,2,3,149546,149550,149553,4,7,0
42684,4,1,149550,149553,149554,3,4,0
42685,3,3,149553,149554,149557,1,4,0
42686,2,2,149555,149557,149559,2,4,0
42687,2,3,149557,149559,149562,2,5,0
42688,6,1,149563,149563,149564,0,1,1
42689,3,2,149566,149566,149568,0,2,2
42690,6,2,149572,149572,149574,0,2,4
42691,2,3,149574,149574,149577,0,3,0
42692,1,3,149575,149577,149580,2,5,0
42693,1,1,149576,149580,149581,4,5,0
42694,2,1,149578,149581,149582,3,4,0
42695,1,3,149579,149582,149585,3,6,0
42696,3,1,149582,149585,149586,3,4,0
42697,5,2,149587,149587,149589,0,2,1
42698,4,1,149591,149591,149592,0,1,2
42699,2,3,149593,149593,149596,0,3,1
42700,1,1,149594,149596,149597,2,3,0
42701,4,2,149598,149598,149600,0,2,1
42702,1,1,149599,149600,149601,1,2,0
42703,2,2,149601,149601,149603,0,2,0
42704,5,3,149606,149606,149609,0,3,3
42705,3,3,149609,149609,149612,0,3,0
42706,6,1,149615,149615,149616,0,1,3
42707,6,2,149621,149621,149623,0,2,5
42708,1,3,149622,149623,149626,1,4,0
42709,3,2,149625,149626,149628,1,3,0
42710,4,3,149629,149629,149632,0,3,1
42711,1,2,149630,149632,149634,2,4,0
42712,1,3,149631,149634,149637,3,6,0
42713,3,1,149634,149637,149638,3,4,0
42714,2,3,149636,149638,149641,2,5,0
42715,3,2,149639,149641,149643,2,4,0
42716,2,1,149641,149643,149644,2,3,0
42717,6,2,149647,149647,149649,0,2,3
42718,1,2,149648,149649,149651,1,3,0
42719,2,3,149650,149651,149654,1,4,0
42720,4,3,149654,149654,149657,0,3,0
42721,2,2,149656,149657,149659,1,3,0
42722,2,2,149658,149659,149661,1,3,0
42723,5,3,149663,149663,149666,0,3,2
42724,3,2,149666,149666,149668,0,2,0
42725,2,3,149668,149668,149671,0,3,0
42726,3,2,149671,149671,149673,0,2,0
42727,1,2,149672,149673,149675,1,3,0
42728,3,3,149675,149675,149678,0,3,0
42729,1,2,149676,149678,149680,2,4,0
42730,1,2,149677,149680,149682,3,5,0
42731,6,1,149683,149683,149684,0,1,1
42732,1,1,149684,149684,149685,0,1,0
42733,5,3,149689,149689,149692,0,3,4
42734,6,2,149695,149695,149697,0,2,3
42735,3,2,149698,149698,149700,0,2,1
42736,6,2,149704,149704,149706,0,2,4
42737,5,2,149709,149709,149711,0,2,3
42738,3,1,149712,149712,149713,0,1,1
42739,6,2,149718,149718,149720,0,2,5
42740,6,1,149724,149724,149725,0,1,4
42741,3,3,149727,149727,149730,0,3,2
42742,5,3,149732,149732,149735,0,3,2
42743,6,1,149738,149738,149739,0,1,3
42744,3,3,149741,149741,149744,0,3,2
42745,3,3,149744,149744,149747,0,3,0
42746,6,2,149750,149750,149752,0,2,3
42747,5,1,149755,149755,149756,0,1,3
42748,3,3,149758,149758,149761,0,3,2
42749,5,3,149763,149763,149766,0,3,2
42750,3,2,149766,149766,149768,0,2,0
42751,2,1,149768,149768,149769,0,1,0
42752,1,2,149769,149769,149771,0,2,0
42753,3,3,149772,149772,149775,0,3,1
42754,5,3,149777,149777,149780,0,3,2
42755,6,1,149783,149783,149784,0,1,3
42756,1,3,149784,149784,149787,0,3,0
42757,5,1,149789,149789,149790,0,1,2
42758,2,1,149791,149791,149792,0,1,1
42759,2,2,149793,149793,149795,0,2,1
42760,1,3,149794,149795,149798,1,4,0
42761,1,2,149795,149798,149800,3,5,0
42762,3,1,149798,149800,149801,2,3,0
42763,1,3,149799,149801,149804,2,5,0
42764,6,2,149805,149805,149807,0,2,1
42765,2,2,149807,149807,149809,0,2,0
42766,3,3,149810,149810,149813,0,3,1
42767,6,1,149816,149816,149817,0,1,3
42768,1,2,149817,149817,149819,0,2,0
42769,5,3,149822,149822,149825,0,3,3
42770,2,3,149824,149825,149828,1,4,0
42771,3,3,149827,149828,149831,1,4,0
42772,5,2,149832,149832,149834,0,2,1
42773,6,2,149838,149838,149840,0,2,4
42774,3,1,149841,149841,149842,0,1,1
42775,6,2,149847,149847,149849,0,2,5
42776,5,1,149852,149852,149853,0,1,3
42777,4,1,149856,149856,149857,0,1,3
42778,3,2,149859,149859,149861,0,2,2
42779,3,2,149862,149862,149864,0,2,1
42780,4,3,149866,149866,149869,0,3,2
42781,6,2,149872,149872,149874,0,2,3
42782,3,1,149875,149875,149876,0,1,1
42783,3,1,149878,149878,149879,0,1,2
42784,2,1,149880,149880,149881,0,1,1
42785,4,3,149884,149884,149887,0,3,3
42786,3,1,149887,149887,149888,0,1,0
42787,1,2,149888,149888,149890,0,2,0
42788,1,3,149889,149890,149893,1,4,0
42789,2,2,149891,149893,149895,2,4,0
42790,1,2,149892,149895,149897,3,5,0
42791,5,1,149897,149897,149898,0,1,0
42792,4,2,149901,149901,149903,0,2,3
42793,1,3,149902,149903,149906,1,4,0
42794,2,2,149904,149906,149908,2,4,0
42795,5,1,149909,149909,149910,0,1,1
42796,2,1,149911,149911,149912,0,1,1
42797,2,1,149913,149913,149914,0,1,1
42798,6,1,149919,149919,149920,0,1,5
42799,6,2,149925,149925,149927,0,2,5
42800,5,1,149930,149930,149931,0,1,3
42801,5,2,149935,149935,149937,0,2,4
42802,3,3,149938,149938,149941,0,3,1
42803,5,1,149943,149943,149944,0,1,2
42804,5,1,149948,149948,149949,0,1,4
42805,1,1,149949,149949,149950,0,1,0
42806,2,3,149951,149951,149954,0,3,1
42807,3,3,149954,149954,149957,0,3,0
42808,6,2,149960,149960,149962,0,2,3
42809,1,1,149961,149962,149963,1,2,0
42810,6,1,149967,149967,149968,0,1,4
42811,6,3,149973,149973,149976,0,3,5
42812,5,3,149978,149978,149981,0,3,2
42813,2,1,149980,149981,149982,1,2,0
42814,2,2,149982,149982,149984,0,2,0
42815,2,1,149984,149984,149985,0,1,0
42816,4,2,149988,149988,149990,0,2,3
42817,1,2,149989,149990,149992,1,3,0
42818,6,1,149995,149995,149996,0,1,3
42819,6,2,150001,150001,150003,0,2,5
42820,4,3,150005,150005,150008,0,3,2
42821,1,1,150006,150008,150009,2,3,0
42822,1,1,150007,150009,150010,2,3,0
42823,5,2,150012,150012,150014,0,2,2
42824,4,2,150016,150016,150018,0,2,2
42825,3,3,150019,150019,150022,0,3,1
42826,4,2,150023,150023,150025,0,2,1
42827,5,1,150028,150028,150029,0,1,3
42828,1,2,150029,150029,150031,0,2,0
42829,3,2,150032,150032,150034,0,2,1
42830,6,1,150038,150038,150039,0,1,4
42831,2,1,150040,150040,150041,0,1,1
42832,4,2,150044,150044,150046,0,2,3
42833,5,1,150049,150049,150050,0,1,3
42834,1,2,150050,150050,150052,0,2,0
42835,6,3,150056,150056,150059,0,3,4
42836,5,2,150061,150061,150063,0,2,2
42837,4,3,150065,150065,150068,0,3,2
42838,1,3,150066,150068,150071,2,5,0
42839,4,1,150070,150071,150072,1,2,0
42840,2,2,150072,150072,150074,0,2,0
42841,4,3,150076,150076,150079,0,3,2
42842,5,2,150081,150081,150083,0,2,2
42843,1,2,150082,150083,150085,1,3,0
42844,5,3,150087,150087,150090,0,3,2
42845,4,1,150091,150091,150092,0,1,1
42846,1,2,150092,150092,150094,0,2,0
42847,1,2,150093,150094,150096,1,3,0
42848,2,1,150095,150096,150097,1,2,0
42849,3,3,150098,150098,150101,0,3,1
42850,1,3,150099,150101,150104,2,5,0
42851,6,3,150105,150105,150108,0,3,1
42852,2,1,150107,150108,150109,1,2,0
42853,1,1,150108,150109,150110,1,2,0
42854,3,1,150111,150111,150112,0,1,1
42855,3,3,150114,150114,150117,0,3,2
42856,1,3,150115,150117,150120,2,5,0
42857,2,2,150117,150120,150122,3,5,0
42858,2,3,150119,150122,150125,3,6,0
42859,6,3,150125,150125,150128,0,3,0
42860,1,1,150126,150128,150129,2,3,0
42861,2,3,150128,150129,150132,1,4,0
42862,4,1,150132,150132,150133,0,1,0
42863,1,1,150133,150133,150134,0,1,0
42864,1,1,150134,150134,150135,0,1,0
42865,3,1,150137,150137,150138,0,1,2
42866,4,3,150141,150141,150144,0,3,3
42867,2,2,150143,150144,150146,1,3,0
42868,2,2,150145,150146,150148,1,3,0
42869,1,3,150146,150148,150151,2,5,0
42870,2,2,150148,150151,150153,3,5,0
42871,1,1,150149,150153,150154,4,5,0
42872,2,1,150151,150154,150155,3,4,0
42873,3,3,150154,150155,150158,1,4,0
42874,2,2,150156,150158,150160,2,4,0
42875,6,2,150162,150162,150164,0,2,2
42876,6,3,150168,150168,150171,0,3,4
42877,6,1,150174,150174,150175,0,1,3
42878,1,2,150175,150175,150177,0,2,0
42879,3,1,150178,150178,150179,0,1,1
42880,5,1,150183,150183,150184,0,1,4
42881,6,3,150189,150189,150192,0,3,5
42882,2,1,150191,150192,150193,1,2,0
42883,6,2,150197,150197,150199,0,2,4
42884,2,2,150199,150199,150201,0,2,0
42885,6,3,150205,150205,150208,0,3,4
42886,2,1,150207,150208,150209,1,2,0
42887,3,2,150210,150210,150212,0,2,1
42888,6,2,150216,150216,150218,0,2,4
42889,2,3,150218,150218,150221,0,3,0
42890,5,2,150223,150223,150225,0,2,2
42891,3,1,150226,150226,150227,0,1,1
42892,5,2,150231,150231,150233,0,2,4
42893,5,3,150236,150236,150239,0,3,3
42894,4,2,150240,150240,150242,0,2,1
42895,5,1,150245,150245,150246,0,1,3
42896,1,1,150246,150246,150247,0,1,0
42897,6,2,150252,150252,150254,0,2,5
42898,1,1,150253,150254,150255,1,2,0
42899,2,2,150255,150255,150257,0,2,0
42900,4,2,150259,150259,150261,0,2,2
42901,3,3,150262,150262,150265,0,3,1
42902,4,2,150266,150266,150268,0,2,1
42903,2,3,150268,150268,150271,0,3,0
42904,3,1,150271,150271,150272,0,1,0
42905,4,3,150275,150275,150278,0,3,3
42906,3,3,150278,150278,150281,0,3,0
42907,2,1,150280,150281,150282,1,2,0
42908,3,3,150283,150283,150286,0,3,1
42909,6,1,150289,150289,150290,0,1,3
42910,3,3,150292,150292,150295,0,3,2
42911,6,1,150298,150298,150299,0,1,3
42912,1,1,150299,150299,150300,0,1,0
42913,1,1,150300,150300,150301,0,1,0
42914,2,1,150302,150302,150303,0,1,1
42915,1,2,150303,150303,150305,0,2,0
42916,5,2,150308,150308,150310,0,2,3
42917,4,3,150312,150312,150315,0,3,2
42918,4,2,150316,150316,150318,0,2,1
42919,1,1,150317,150318,150319,1,2,0
42920,5,1,150322,150322,150323,0,1,3
42921,1,1,150323,150323,150324,0,1,0
42922,2,1,150325,150325,150326,0,1,1
42923,4,3,150329,150329,150332,0,3,3
42924,5,2,150334,150334,150336,0,2,2
42925,1,3,150335,150336,150339,1,4,0
42926,1,3,150336,150339,150342,3,6,0
42927,1,1,150337,150342,150343,5,6,0
42928,3,3,150340,150343,150346,3,6,0
42929,3,2,150343,150346,150348,3,5,0
42930,4,3,150347,150348,150351,1,4,0
42931,5,3,150352,150352,150355,0,3,1
42932,3,3,150355,150355,150358,0,3,0
42933,2,3,150357,150358,150361,1,4,0
42934,6,2,150363,150363,150365,0,2,2
42935,4,3,150367,150367,150370,0,3,2
42936,1,1,150368,150370,150371,2,3,0
42937,5,3,150373,150373,150376,0,3,2
42938,3,3,150376,150376,150379,0,3,0
42939,5,2,150381,150381,150383,0,2,2
42940,4,3,150385,150385,150388,0,3,2
42941,6,2,150391,150391,150393,0,2,3
42942,1,2,150392,150393,150395,1,3,0
42943,3,2,150395,150395,150397,0,2,0
42944,4,3,150399,150399,150402,0,3,2
42945,5,1,150404,150404,150405,0,1,2
42946,2,2,150406,150406,150408,0,2,1
42947,1,1,150407,150408,150409,1,2,0
42948,2,3,150409,150409,150412,0,3,0
42949,5,2,150414,150414,150416,0,2,2
42950,2,1,150416,150416,150417,0,1,0
42951,3,1,150419,150419,150420,0,1,2
42952,4,2,150423,150423,150425,0,2,3
42953,6,1,150429,150429,150430,0,1,4
42954,6,2,150435,150435,150437,0,2,5
42955,3,1,150438,150438,150439,0,1,1
42956,3,1,150441,150441,150442,0,1,2
42957,4,1,150445,150445,150446,0,1,3
42958,5,2,150450,150450,150452,0,2,4
42959,4,3,150454,150454,150457,0,3,2
42960,2,2,150456,150457,150459,1,3,0
42961,5,2,150461,150461,150463,0,2,2
42962,2,2,150463,150463,150465,0,2,0
42963,3,1,150466,150466,150467,0,1,1
42964,3,1,150469,150469,150470,0,1,2
42965,2,3,150471,150471,150474,0,3,1
42966,6,2,150477,150477,150479,0,2,3
42967,6,1,150483,150483,150484,0,1,4
42968,3,2,150486,150486,150488,0,2,2
42969,6,3,150492,150492,150495,0,3,4
42970,6,2,150498,150498,150500,0,2,3
42971,5,3,150503,150503,150506,0,3,3
42972,2,2,150505,150506,150508,1,3,0
42973,5,1,150510,150510,150511,0,1,2
42974,4,1,150514,150514,150515,0,1,3
42975,1,3,150515,150515,150518,0,3,0
42976,4,2,150519,150519,150521,0,2,1
42977,6,1,150525,150525,150526,0,1,4
42978,3,1,150528,150528,150529,0,1,2
42979,1,2,150529,150529,150531,0,2,0
42980,1,3,150530,150531,150534,1,4,0
42981,6,2,150536,150536,150538,0,2,2
42982,3,1,150539,150539,150540,0,1,1
42983,3,1,150542,150542,150543,0,1,2
42984,6,2,150548,150548,150550,0,2,5
42985,3,1,150551,150551,150552,0,1,1
42986,1,3,150552,150552,150555,0,3,0
42987,6,3,150558,150558,150561,0,3,3
42988,3,1,150561,150561,150562,0,1,0
42989,5,3,150566,150566,150569,0,3,4
42990,1,1,150567,150569,150570,2,3,0
42991,6,2,150573,150573,150575,0,2,3
42992,5,1,150578,150578,150579,0,1,3
42993,3,2,150581,150581,150583,0,2,2
42994,2,2,150583,150583,150585,0,2,0
42995,6,3,150589,150589,150592,0,3,4
42996,1,2,150590,150592,150594,2,4,0
42997,5,3,150595,150595,150598,0,3,1
42998,5,2,150600,150600,150602,0,2,2
42999,6,3,150606,150606,150609,0,3,4
43000,2,2,150608,150609,150611,1,3,0
43001,5,3,150613,150613,150616,0,3,2
43002,1,2,150614,150616,150618,2,4,0
43003,2,2,150616,150618,150620,2,4,0
43004,4,1,150620,150620,150621,0,1,0
43005,5,1,150625,150625,150626,0,1,4
43006,5,2,150630,150630,150632,0,2,4
43007,6,1,150636,150636,150637,0,1,4
43008,4,2,150640,150640,150642,0,2,3
43009,1,2,150641,150642,150644,1,3,0
43010,5,1,150646,150646,150647,0,1,2
43011,4,3,150650,150650,150653,0,3,3
43012,3,3,150653,150653,150656,0,3,0
43013,5,2,150658,150658,150660,0,2,2
43014,1,2,150659,150660,150662,1,3,0
43015,5,3,150664,150664,150667,0,3,2
43016,1,3,150665,150667,150670,2,5,0
43017,2,3,150667,150670,150673,3,6,0
43018,2,1,150669,150673,150674,4,5,0
43019,5,3,150674,150674,150677,0,3,0
43020,1,1,150675,150677,150678,2,3,0
43021,4,3,150679,150679,150682,0,3,1
43022,5,2,150684,150684,150686,0,2,2
43023,2,1,150686,150686,150687,0,1,0
43024,5,3,150691,150691,150694,0,3,4
43025,4,3,150695,150695,150698,0,3,1
43026,4,2,150699,150699,150701,0,2,1
43027,2,1,150701,150701,150702,0,1,0
43028,6,2,150707,150707,150709,0,2,5
43029,5,1,150712,150712,150713,0,1,3
43030,4,1,150716,150716,150717,0,1,3
43031,4,1,150720,150720,150721,0,1,3
43032,4,1,150724,150724,150725,0,1,3
43033,6,1,150730,150730,150731,0,1,5
43034,4,2,150734,150734,150736,0,2,3
43035,2,2,150736,150736,150738,0,2,0
43036,6,2,150742,150742,150744,0,2,4
43037,5,3,150747,150747,150750,0,3,3
43038,2,1,150749,150750,150751,1,2,0
43039,3,2,150752,150752,150754,0,2,1
43040,3,2,150755,150755,150757,0,2,1
43041,2,1,150757,150757,150758,0,1,0
43042,5,1,150762,150762,150763,0,1,4
43043,4,1,150766,150766,150767,0,1,3
43044,6,3,150772,150772,150775,0,3,5
43045,6,2,150778,150778,150780,0,2,3
43046,5,2,150783,150783,150785,0,2,3
43047,2,1,150785,150785,150786,0,1,0
43048,4,3,150789,150789,150792,0,3,3
43049,6,1,150795,150795,150796,0,1,3
43050,4,3,150799,150799,150802,0,3,3
43051,1,1,150800,150802,150803,2,3,0
43052,3,3,150803,150803,150806,0,3,0
43053,6,1,150809,150809,150810,0,1,3
43054,4,1,150813,150813,150814,0,1,3
43055,6,3,150819,150819,150822,0,3,5
43056,3,1,150822,150822,150823,0,1,0
43057,1,3,150823,150823,150826,0,3,0
43058,1,2,150824,150826,150828,2,4,0
43059,3,2,150827,150828,150830,1,3,0
43060,1,1,150828,150830,150831,2,3,0
43061,2,2,150830,150831,150833,1,3,0
43062,1,1,150831,150833,150834,2,3,0
43063,2,3,150833,150834,150837,1,4,0
43064,6,3,150839,150839,150842,0,3,2
43065,3,2,150842,150842,150844,0,2,0
43066,2,3,150844,150844,150847,0,3,0
43067,4,3,150848,150848,150851,0,3,1
43068,3,1,150851,150851,150852,0,1,0
43069,6,1,150857,150857,150858,0,1,5
43070,4,2,150861,150861,150863,0,2,3
43071,4,3,150865,150865,150868,0,3,2
43072,4,3,150869,150869,150872,0,3,1
43073,2,3,150871,150872,150875,1,4,0
43074,5,3,150876,150876,150879,0,3,1
43075,2,3,150878,150879,150882,1,4,0
43076,6,2,150884,150884,150886,0,2,2
43077,4,3,150888,150888,150891,0,3,2
43078,2,2,150890,150891,150893,1,3,0
43079,5,3,150895,150895,150898,0,3,2
43080,4,3,150899,150899,150902,0,3,1
43081,1,3,150900,150902,150905,2,5,0
43082,5,2,150905,150905,150907,0,2,0
43083,6,2,150911,150911,150913,0,2,4
43084,2,2,150913,150913,150915,0,2,0
43085,5,3,150918,150918,150921,0,3,3
43086,3,2,150921,150921,150923,0,2,0
43087,3,2,150924,150924,150926,0,2,1
43088,1,3,150925,150926,150929,1,4,0
43089,4,2,150929,150929,150931,0,2,0
43090,2,1,150931,150931,150932,0,1,0
43091,1,3,150932,150932,150935,0,3,0
43092,6,2,150938,150938,150940,0,2,3
43093,5,1,150943,150943,150944,0,1,3
43094,4,1,150947,150947,150948,0,1,3
43095,6,2,150953,150953,150955,0,2,5
43096,4,1,150957,150957,150958,0,1,2
43097,3,2,150960,150960,150962,0,2,2
43098,5,1,150965,150965,150966,0,1,3
43099,5,3,150970,150970,150973,0,3,4
43100,6,2,150976,150976,150978,0,2,3
43101,1,3,150977,150978,150981,1,4,0
43102,5,1,150982,150982,150983,0,1,1
43103,4,2,150986,150986,150988,0,2,3
43104,3,1,150989,150989,150990,0,1,1
43105,6,3,150995,150995,150998,0,3,5
43106,2,3,150997,150998,151001,1,4,0
43107,5,3,151002,151002,151005,0,3,1
43108,3,2,151005,151005,151007,0,2,0
43109,3,2,151008,151008,151010,0,2,1
43110,4,1,151012,151012,151013,0,1,2
43111,3,2,151015,151015,151017,0,2,2
43112,6,3,151021,151021,151024,0,3,4
43113,1,2,151022,151024,151026,2,4,0
43114,2,3,151024,151026,151029,2,5,0
43115,1,3,151025,151029,151032,4,7,0
43116,5,2,151030,151032,151034,2,4,0
43117,4,3,151034,151034,151037,0,3,0
43118,6,1,151040,151040,151041,0,1,3
43119,3,1,151043,151043,151044,0,1,2
43120,5,3,151048,151048,151051,0,3,4
43121,2,2,151050,151051,151053,1,3,0
43122,5,2,151055,151055,151057,0,2,2
43123,5,1,151060,151060,151061,0,1,3
43124,2,1,151062,151062,151063,0,1,1
43125,6,2,151068,151068,151070,0,2,5
43126,2,2,151070,151070,151072,0,2,0
43127,2,2,151072,151072,151074,0,2,0
43128,4,1,151076,151076,151077,0,1,2
43129,1,1,151077,151077,151078,0,1,0
43130,5,2,151082,151082,151084,0,2,4
43131,1,3,151083,151084,151087,1,4,0
43132,6,3,151089,151089,151092,0,3,2
43133,2,3,151091,151092,151095,1,4,0
43134,2,2,151093,151095,151097,2,4,0
43135,1,1,151094,151097,151098,3,4,0
43136,4,2,151098,151098,151100,0,2,0
43137,5,3,151103,151103,151106,0,3,3
43138,4,2,151107,151107,151109,0,2,1
43139,6,2,151113,151113,151115,0,2,4
43140,3,2,151116,151116,151118,0,2,1
43141,1,3,151117,151118,151121,1,4,0
43142,1,2,151118,151121,151123,3,5,0
43143,1,3,151119,151123,151126,4,7,0
43144,5,2,151124,151126,151128,2,4,0
43145,1,2,151125,151128,151130,3,5,0
43146,3,1,151128,151130,151131,2,3,0
43147,2,1,151130,151131,151132,1,2,0
43148,3,2,151133,151133,151135,0,2,1
43149,4,2,151137,151137,151139,0,2,2
43150,1,3,151138,151139,151142,1,4,0
43151,6,1,151144,151144,151145,0,1,2
43152,3,2,151147,151147,151149,0,2,2
43153,6,2,151153,151153,151155,0,2,4
43154,2,1,151155,151155,151156,0,1,0
43155,2,1,151157,151157,151158,0,1,1
43156,6,3,151163,151163,151166,0,3,5
43157,6,3,151169,151169,151172,0,3,3
43158,5,1,151174,151174,151175,0,1,2
43159,3,3,151177,151177,151180,0,3,2
43160,1,2,151178,151180,151182,2,4,0
43161,1,1,151179,151182,151183,3,4,0
43162,5,3,151184,151184,151187,0,3,1
43163,6,3,151190,151190,151193,0,3,3
43164,2,2,151192,151193,151195,1,3,0
43165,3,2,151195,151195,151197,0,2,0
43166,2,1,151197,151197,151198,0,1,0
43167,5,1,151202,151202,151203,0,1,4
43168,4,1,151206,151206,151207,0,1,3
43169,6,3,151212,151212,151215,0,3,5
43170,6,1,151218,151218,151219,0,1,3
43171,4,2,151222,151222,151224,0,2,3
43172,5,1,151227,151227,151228,0,1,3
43173,6,2,151233,151233,151235,0,2,5
43174,2,3,151235,151235,151238,0,3,0
43175,6,2,151241,151241,151243,0,2,3
43176,6,3,151247,151247,151250,0,3,4
43177,6,3,151253,151253,151256,0,3,3
43178,4,1,151257,151257,151258,0,1,1
43179,2,3,151259,151259,151262,0,3,1
43180,1,2,151260,151262,151264,2,4,0
43181,6,2,151266,151266,151268,0,2,2
43182,2,3,151268,151268,151271,0,3,0
43183,6,2,151274,151274,151276,0,2,3
43184,1,3,151275,151276,151279,1,4,0
43185,1,3,151276,151279,151282,3,6,0
43186,6,3,151282,151282,151285,0,3,0
43187,6,1,151288,151288,151289,0,1,3
43188,6,2,151294,151294,151296,0,2,5
43189,6,2,151300,151300,151302,0,2,4
43190,6,2,151306,151306,151308,0,2,4
43191,6,2,151312,151312,151314,0,2,4
43192,4,3,151316,151316,151319,0,3,2
43193,4,1,151320,151320,151321,0,1,1
43194,1,2,151321,151321,151323,0,2,0
43195,5,1,151326,151326,151327,0,1,3
43196,6,1,151332,151332,151333,0,1,5
43197,3,3,151335,151335,151338,0,3,2
43198,3,2,151338,151338,151340,0,2,0
43199,2,3,151340,151340,151343,0,3,0
43200,2,1,151342,151343,151344,1,2,0
43201,4,1,151346,151346,151347,0,1,2
43202,1,3,151347,151347,151350,0,3,0
43203,2,1,151349,151350,151351,1,2,0
43204,1,1,151350,151351,151352,1,2,0
43205,5,2,151355,151355,151357,0,2,3
43206,1,2,151356,151357,151359,1,3,0
43207,1,1,151357,151359,151360,2,3,0
43208,1,3,151358,151360,151363,2,5,0
43209,3,1,151361,151363,151364,2,3,0
43210,1,3,151362,151364,151367,2,5,0
43211,5,1,151367,151367,151368,0,1,0
43212,3,2,151370,151370,151372,0,2,2
43213,5,1,151375,151375,151376,0,1,3
43214,4,1,151379,151379,151380,0,1,3
43215,5,1,151384,151384,151385,0,1,4
43216,3,3,151387,151387,151390,0,3,2
43217,5,2,151392,151392,151394,0,2,2
43218,4,2,151396,151396,151398,0,2,2
43219,1,3,151397,151398,151401,1,4,0
43220,2,1,151399,151401,151402,2,3,0
43221,3,3,151402,151402,151405,0,3,0
43222,4,2,151406,151406,151408,0,2,1
43223,3,1,151409,151409,151410,0,1,1
43224,1,2,151410,151410,151412,0,2,0
43225,2,2,151412,151412,151414,0,2,0
43226,2,2,151414,151414,151416,0,2,0
43227,2,2,151416,151416,151418,0,2,0
43228,5,3,151421,151421,151424,0,3,3
43229,5,1,151426,151426,151427,0,1,2
43230,6,1,151432,151432,151433,0,1,5
43231,2,2,151434,151434,151436,0,2,1
43232,5,3,151439,151439,151442,0,3,3
43233,6,2,151445,151445,151447,0,2,3
43234,5,3,151450,151450,151453,0,3,3
43235,4,2,151454,151454,151456,0,2,1
43236,6,1,151460,151460,151461,0,1,4
43237,4,3,151464,151464,151467,0,3,3
43238,2,3,151466,151467,151470,1,4,0
43239,4,1,151470,151470,151471,0,1,0
43240,2,2,151472,151472,151474,0,2,1
43241,3,3,151475,151475,151478,0,3,1
43242,6,3,151481,151481,151484,0,3,3
43243,5,1,151486,151486,151487,0,1,2
43244,6,1,151492,151492,151493,0,1,5
43245,5,3,151497,151497,151500,0,3,4
43246,2,1,151499,151500,151501,1,2,0
43247,6,3,151505,151505,151508,0,3,4
43248,5,3,151510,151510,151513,0,3,2
43249,4,3,151514,151514,151517,0,3,1
43250,3,1,151517,151517,151518,0,1,0
43251,1,1,151518,151518,151519,0,1,0
43252,6,2,151524,151524,151526,0,2,5
43253,4,2,151528,151528,151530,0,2,2
43254,1,2,151529,151530,151532,1,3,0
43255,3,1,151532,151532,151533,0,1,0
43256,5,3,151537,151537,151540,0,3,4
43257,1,3,151538,151540,151543,2,5,0
43258,3,3,151541,151543,151546,2,5,0
43259,4,2,151545,151546,151548,1,3,0
43260,6,2,151551,151551,151553,0,2,3
43261,6,2,151557,151557,151559,0,2,4
43262,1,1,151558,151559,151560,1,2,0
43263,6,1,151564,151564,151565,0,1,4
43264,5,1,151569,151569,151570,0,1,4
43265,3,2,151572,151572,151574,0,2,2
43266,2,2,151574,151574,151576,0,2,0
43267,6,3,151580,151580,151583,0,3,4
43268,5,1,151585,151585,151586,0,1,2
43269,2,1,151587,151587,151588,0,1,1
43270,5,1,151592,151592,151593,0,1,4
43271,5,2,151597,151597,151599,0,2,4
43272,6,3,151603,151603,151606,0,3,4
43273,2,3,151605,151606,151609,1,4,0
43274,6,3,151611,151611,151614,0,3,2
43275,3,2,151614,151614,151616,0,2,0
43276,6,3,151620,151620,151623,0,3,4
43277,5,1,151625,151625,151626,0,1,2
43278,4,3,151629,151629,151632,0,3,3
43279,4,2,151633,151633,151635,0,2,1
43280,4,3,151637,151637,151640,0,3,2
43281,6,2,151643,151643,151645,0,2,3
43282,2,1,151645,151645,151646,0,1,0
43283,4,3,151649,151649,151652,0,3,3
43284,4,1,151653,151653,151654,0,1,1
43285,1,3,151654,151654,151657,0,3,0
43286,6,3,151660,151660,151663,0,3,3
43287,5,2,151665,151665,151667,0,2,2
43288,3,1,151668,151668,151669,0,1,1
43289,6,2,151674,151674,151676,0,2,5
43290,4,3,151678,151678,151681,0,3,2
43291,2,2,151680,151681,151683,1,3,0
43292,1,1,151681,151683,151684,2,3,0
43293,5,1,151686,151686,151687,0,1,2
43294,2,1,151688,151688,151689,0,1,1
43295,2,2,151690,151690,151692,0,2,1
43296,4,1,151694,151694,151695,0,1,2
43297,3,1,151697,151697,151698,0,1,2
43298,5,2,151702,151702,151704,0,2,4
43299,3,3,151705,151705,151708,0,3,1
43300,1,2,151706,151708,151710,2,4,0
43301,5,1,151711,151711,151712,0,1,1
43302,5,3,151716,151716,151719,0,3,4
43303,3,3,151719,151719,151722,0,3,0
43304,2,2,151721,151722,151724,1,3,0
43305,2,1,151723,151724,151725,1,2,0
43306,1,3,151724,151725,151728,1,4,0
43307,5,1,151729,151729,151730,0,1,1
43308,1,2,151730,151730,151732,0,2,0
43309,3,1,151733,151733,151734,0,1,1
43310,5,2,151738,151738,151740,0,2,4
43311,3,1,151741,151741,151742,0,1,1
43312,5,1,151746,151746,151747,0,1,4
43313,2,1,151748,151748,151749,0,1,1
43314,2,1,151750,151750,151751,0,1,1
43315,3,1,151753,151753,151754,0,1,2
43316,5,3,151758,151758,151761,0,3,4
43317,3,3,151761,151761,151764,0,3,0
43318,1,2,151762,151764,151766,2,4,0
43319,2,3,151764,151766,151769,2,5,0
43320,3,1,151767,151769,151770,2,3,0
43321,6,1,151773,151773,151774,0,1,3
43322,4,3,151777,151777,151780,0,3,3
43323,2,3,151779,151780,151783,1,4,0
43324,6,2,151785,151785,151787,0,2,2
43325,4,2,151789,151789,151791,0,2,2
43326,5,1,151794,151794,151795,0,1,3
43327,1,3,151795,151795,151798,0,3,0
43328,4,3,151799,151799,151802,0,3,1
43329,1,2,151800,151802,151804,2,4,0
43330,5,1,151805,151805,151806,0,1,1
43331,4,1,151809,151809,151810,0,1,3
43332,2,1,151811,151811,151812,0,1,1
43333,5,1,151816,151816,151817,0,1,4
43334,1,3,151817,151817,151820,0,3,0
43335,5,2,151822,151822,151824,0,2,2
43336,4,3,151826,151826,151829,0,3,2
43337,3,1,151829,151829,151830,0,1,0
43338,2,1,151831,151831,151832,0,1,1
43339,1,3,151832,151832,151835,0,3,0
43340,1,3,151833,151835,151838,2,5,0
43341,3,1,151836,151838,151839,2,3,0
43342,3,2,151839,151839,151841,0,2,0
43343,2,1,151841,151841,151842,0,1,0
43344,3,3,151844,151844,151847,0,3,2
43345,5,2,151849,151849,151851,0,2,2
43346,6,1,151855,151855,151856,0,1,4
43347,3,3,151858,151858,151861,0,3,2
43348,2,3,151860,151861,151864,1,4,0
43349,5,2,151865,151865,151867,0,2,1
43350,1,1,151866,151867,151868,1,2,0
43351,4,3,151870,151870,151873,0,3,2
43352,6,2,151876,151876,151878,0,2,3
43353,4,2,151880,151880,151882,0,2,2
43354,6,3,151886,151886,151889,0,3,4
43355,5,3,151891,151891,151894,0,3,2
43356,6,1,151897,151897,151898,0,1,3
43357,5,1,151902,151902,151903,0,1,4
43358,1,2,151903,151903,151905,0,2,0
43359,2,3,151905,151905,151908,0,3,0
43360,2,2,151907,151908,151910,1,3,0
43361,1,3,151908,151910,151913,2,5,0
43362,3,1,151911,151913,151914,2,3,0
43363,6,1,151917,151917,151918,0,1,3
43364,2,1,151919,151919,151920,0,1,1
43365,4,2,151923,151923,151925,0,2,3
43366,2,3,151925,151925,151928,0,3,0
43367,4,1,151929,151929,151930,0,1,1
43368,3,2,151932,151932,151934,0,2,2
43369,1,2,151933,151934,151936,1,3,0
43370,4,1,151937,151937,151938,0,1,1
43371,6,2,151943,151943,151945,0,2,5
43372,6,3,151949,151949,151952,0,3,4
43373,4,3,151953,151953,151956,0,3,1
43374,3,2,151956,151956,151958,0,2,0
43375,5,1,151961,151961,151962,0,1,3
43376,1,2,151962,151962,151964,0,2,0
43377,2,1,151964,151964,151965,0,1,0
43378,2,3,151966,151966,151969,0,3,1
43379,1,1,151967,151969,151970,2,3,0
43380,3,2,151970,151970,151972,0,2,0
43381,3,2,151973,151973,151975,0,2,1
43382,1,3,151974,151975,151978,1,4,0
43383,6,2,151980,151980,151982,0,2,2
43384,2,3,151982,151982,151985,0,3,0
43385,5,2,151987,151987,151989,0,2,2
43386,4,1,151991,151991,151992,0,1,2
43387,1,1,151992,151992,151993,0,1,0
43388,5,1,151997,151997,151998,0,1,4
43389,2,1,151999,151999,152000,0,1,1
43390,3,1,152002,152002,152003,0,1,2
43391,5,1,152007,152007,152008,0,1,4
43392,1,2,152008,152008,152010,0,2,0
43393,1,1,152009,152010,152011,1,2,0
43394,3,3,152012,152012,152015,0,3,1
43395,1,1,152013,152015,152016,2,3,0
43396,4,2,152017,152017,152019,0,2,1
43397,3,1,152020,152020,152021,0,1,1
43398,1,1,152021,152021,152022,0,1,0
43399,2,1,152023,152023,152024,0,1,1
43400,5,3,152028,152028,152031,0,3,4
43401,5,1,152033,152033,152034,0,1,2
43402,1,3,152034,152034,152037,0,3,0
43403,2,1,152036,152037,152038,1,2,0
43404,5,2,152041,152041,152043,0,2,3
43405,1,2,152042,152043,152045,1,3,0
43406,1,2,152043,152045,152047,2,4,0
43407,1,2,152044,152047,152049,3,5,0
43408,5,1,152049,152049,152050,0,1,0
43409,4,1,152053,152053,152054,0,1,3
43410,1,1,152054,152054,152055,0,1,0
43411,1,2,152055,152055,152057,0,2,0
43412,5,3,152060,152060,152063,0,3,3
43413,5,1,152065,152065,152066,0,1,2
43414,3,3,152068,152068,152071,0,3,2
43415,6,3,152074,152074,152077,0,3,3
43416,6,3,152080,152080,152083,0,3,3
43417,1,1,152081,152083,152084,2,3,0
43418,3,1,152084,152084,152085,0,1,0
43419,6,3,152090,152090,152093,0,3,5
43420,3,2,152093,152093,152095,0,2,0
43421,5,3,152098,152098,152101,0,3,3
43422,1,3,152099,152101,152104,2,5,0
43423,3,2,152102,152104,152106,2,4,0
43424,2,2,152104,152106,152108,2,4,0
43425,6,3,152110,152110,152113,0,3,2
43426,5,3,152115,152115,152118,0,3,2
43427,5,3,152120,152120,152123,0,3,2
43428,2,3,152122,152123,152126,1,4,0
43429,3,3,152125,152126,152129,1,4,0
43430,1,3,152126,152129,152132,3,6,0
43431,6,3,152132,152132,152135,0,3,0
43432,3,1,152135,152135,152136,0,1,0
43433,3,2,152138,152138,152140,0,2,2
43434,1,2,152139,152140,152142,1,3,0
43435,6,2,152145,152145,152147,0,2,3
43436,1,1,152146,152147,152148,1,2,0
43437,1,3,152147,152148,152151,1,4,0
43438,2,2,152149,152151,152153,2,4,0
43439,1,3,152150,152153,152156,3,6,0
43440,2,1,152152,152156,152157,4,5,0
43441,3,3,152155,152157,152160,2,5,0
43442,3,3,152158,152160,152163,2,5,0
43443,6,1,152164,152164,152165,0,1,1
43444,3,2,152167,152167,152169,0,2,2
43445,6,3,152173,152173,152176,0,3,4
43446,5,1,152178,152178,152179,0,1,2
43447,6,1,152184,152184,152185,0,1,5
43448,5,1,152189,152189,152190,0,1,4
43449,2,3,152191,152191,152194,0,3,1
43450,2,3,152193,152194,152197,1,4,0
43451,2,2,152195,152197,152199,2,4,0
43452,4,1,152199,152199,152200,0,1,0
43453,5,3,152204,152204,152207,0,3,4
43454,3,3,152207,152207,152210,0,3,0
43455,5,3,152212,152212,152215,0,3,2
43456,1,3,152213,152215,152218,2,5,0
43457,3,3,152216,152218,152221,2,5,0
43458,3,2,152219,152221,152223,2,4,0
43459,3,1,152222,152223,152224,1,2,0
43460,2,3,152224,152224,152227,0,3,0
43461,1,1,152225,152227,152228,2,3,0
43462,3,3,152228,152228,152231,0,3,0
43463,4,2,152232,152232,152234,0,2,1
43464,1,2,152233,152234,152236,1,3,0
43465,6,1,152239,152239,152240,0,1,3
43466,6,2,152245,152245,152247,0,2,5
43467,2,3,152247,152247,152250,0,3,0
43468,3,2,152250,152250,152252,0,2,0
43469,1,1,152251,152252,152253,1,2,0
43470,4,1,152255,152255,152256,0,1,2
43471,6,2,152261,152261,152263,0,2,5
43472,2,1,152263,152263,152264,0,1,0
43473,5,2,152268,152268,152270,0,2,4
43474,2,3,152270,152270,152273,0,3,0
43475,6,1,152276,152276,152277,0,1,3
43476,1,3,152277,152277,152280,0,3,0
43477,6,2,152283,152283,152285,0,2,3
43478,6,2,152289,152289,152291,0,2,4
43479,2,3,152291,152291,152294,0,3,0
43480,1,3,152292,152294,152297,2,5,0
43481,4,2,152296,152297,152299,1,3,0
43482,1,1,152297,152299,152300,2,3,0
43483,2,2,152299,152300,152302,1,3,0
43484,2,3,152301,152302,152305,1,4,0
43485,1,2,152302,152305,152307,3,5,0
43486,6,2,152308,152308,152310,0,2,1
43487,5,1,152313,152313,152314,0,1,3
43488,4,3,152317,152317,152320,0,3,3
43489,5,3,152322,152322,152325,0,3,2
43490,4,1,152326,152326,152327,0,1,1
43491,6,3,152332,152332,152335,0,3,5
43492,1,2,152333,152335,152337,2,4,0
43493,1,2,152334,152337,152339,3,5,0
43494,1,2,152335,152339,152341,4,6,0
43495,5,1,152340,152341,152342,1,2,0
43496,3,3,152343,152343,152346,0,3,1
43497,3,1,152346,152346,152347,0,1,0
43498,1,2,152347,152347,152349,0,2,0
43499,1,2,152348,152349,152351,1,3,0
43500,3,2,152351,152351,152353,0,2,0
43501,1,3,152352,152353,152356,1,4,0
43502,1,3,152353,152356,152359,3,6,0
43503,1,2,152354,152359,152361,5,7,0
43504,2,1,152356,152361,152362,5,6,0
43505,2,1,152358,152362,152363,4,5,0
43506,1,2,152359,152363,152365,4,6,0
43507,4,2,152363,152365,152367,2,4,0
43508,6,1,152369,152369,152370,0,1,2
43509,2,1,152371,152371,152372,0,1,1
43510,4,3,152375,152375,152378,0,3,3
43511,2,3,152377,152378,152381,1,4,0
43512,6,3,152383,152383,152386,0,3,2
43513,3,3,152386,152386,152389,0,3,0
43514,6,1,152392,152392,152393,0,1,3
43515,1,1,152393,152393,152394,0,1,0
43516,1,1,152394,152394,152395,0,1,0
43517,6,2,152400,152400,152402,0,2,5
43518,5,2,152405,152405,152407,0,2,3
43519,6,1,152411,152411,152412,0,1,4
43520,3,2,152414,152414,152416,0,2,2
43521,6,2,152420,152420,152422,0,2,4
43522,4,2,152424,152424,152426,0,2,2
43523,5,3,152429,152429,152432,0,3,3
43524,3,1,152432,152432,152433,0,1,0
43525,3,3,152435,152435,152438,0,3,2
43526,2,2,152437,152438,152440,1,3,0
43527,6,2,152443,152443,152445,0,2,3
43528,3,1,152446,152446,152447,0,1,1
43529,3,3,152449,152449,152452,0,3,2
43530,6,3,152455,152455,152458,0,3,3
43531,2,1,152457,152458,152459,1,2,0
43532,5,2,152462,152462,152464,0,2,3
43533,4,3,152466,152466,152469,0,3,2
43534,5,2,152471,152471,152473,0,2,2
43535,3,3,152474,152474,152477,0,3,1
43536,2,3,152476,152477,152480,1,4,0
43537,2,2,152478,152480,152482,2,4,0
43538,6,1,152484,152484,152485,0,1,2
43539,1,1,152485,152485,152486,0,1,0
43540,6,1,152491,152491,152492,0,1,5
43541,3,2,152494,152494,152496,0,2,2
43542,2,2,152496,152496,152498,0,2,0
43543,1,1,152497,152498,152499,1,2,0
43544,5,1,152502,152502,152503,0,1,3
43545,5,1,152507,152507,152508,0,1,4
43546,3,2,152510,152510,152512,0,2,2
43547,6,1,152516,152516,152517,0,1,4
43548,2,3,152518,152518,152521,0,3,1
43549,5,2,152523,152523,152525,0,2,2
43550,2,1,152525,152525,152526,0,1,0
43551,6,3,152531,152531,152534,0,3,5
43552,2,2,152533,152534,152536,1,3,0
43553,6,2,152539,152539,152541,0,2,3
43554,6,1,152545,152545,152546,0,1,4
43555,5,1,152550,152550,152551,0,1,4
43556,2,1,152552,152552,152553,0,1,1
43557,3,2,152555,152555,152557,0,2,2
43558,6,3,152561,152561,152564,0,3,4
43559,4,3,152565,152565,152568,0,3,1
43560,5,2,152570,152570,152572,0,2,2
43561,4,2,152574,152574,152576,0,2,2
43562,5,2,152579,152579,152581,0,2,3
43563,5,3,152584,152584,152587,0,3,3
43564,5,3,152589,152589,152592,0,3,2
43565,3,2,152592,152592,152594,0,2,0
43566,6,3,152598,152598,152601,0,3,4
43567,1,1,152599,152601,152602,2,3,0
43568,4,1,152603,152603,152604,0,1,1
43569,1,2,152604,152604,152606,0,2,0
43570,2,3,152606,152606,152609,0,3,0
43571,6,1,152612,152612,152613,0,1,3
43572,6,1,152618,152618,152619,0,1,5
43573,4,3,152622,152622,152625,0,3,3
43574,5,1,152627,152627,152628,0,1,2
43575,3,3,152630,152630,152633,0,3,2
43576,2,2,152632,152633,152635,1,3,0
43577,2,3,152634,152635,152638,1,4,0
43578,6,1,152640,152640,152641,0,1,2
43579,1,1,152641,152641,152642,0,1,0
43580,5,2,152646,152646,152648,0,2,4
43581,4,3,152650,152650,152653,0,3,2
43582,2,3,152652,152653,152656,1,4,0
43583,6,2,152658,152658,152660,0,2,2
43584,3,3,152661,152661,152664,0,3,1
43585,6,1,152667,152667,152668,0,1,3
43586,1,3,152668,152668,152671,0,3,0
43587,2,1,152670,152671,152672,1,2,0
43588,4,2,152674,152674,152676,0,2,2
43589,2,3,152676,152676,152679,0,3,0
43590,6,3,152682,152682,152685,0,3,3
43591,1,2,152683,152685,152687,2,4,0
43592,2,2,152685,152687,152689,2,4,0
43593,6,2,152691,152691,152693,0,2,2
43594,1,3,152692,152693,152696,1,4,0
43595,3,1,152695,152696,152697,1,2,0
43596,6,2,152701,152701,152703,0,2,4
43597,4,1,152705,152705,152706,0,1,2
43598,3,1,152708,152708,152709,0,1,2
43599,1,3,152709,152709,152712,0,3,0
43600,3,2,152712,152712,152714,0,2,0
43601,2,1,152714,152714,152715,0,1,0
43602,1,3,152715,152715,152718,0,3,0
43603,3,1,152718,152718,152719,0,1,0
43604,2,2,152720,152720,152722,0,2,1
43605,2,1,152722,152722,152723,0,1,0
43606,5,1,152727,152727,152728,0,1,4
43607,2,2,152729,152729,152731,0,2,1
43608,4,2,152733,152733,152735,0,2,2
43609,5,3,152738,152738,152741,0,3,3
43610,2,1,152740,152741,152742,1,2,0
43611,6,3,152746,152746,152749,0,3,4
43612,4,2,152750,152750,152752,0,2,1
43613,3,1,152753,152753,152754,0,1,1
43614,3,1,152756,152756,152757,0,1,2
43615,6,2,152762,152762,152764,0,2,5
43616,3,3,152765,152765,152768,0,3,1
43617,4,1,152769,152769,152770,0,1,1
43618,6,1,152775,152775,152776,0,1,5
43619,4,2,152779,152779,152781,0,2,3
43620,5,1,152784,152784,152785,0,1,3
43621,5,2,152789,152789,152791,0,2,4
43622,2,1,152791,152791,152792,0,1,0
43623,4,1,152795,152795,152796,0,1,3
43624,6,3,152801,152801,152804,0,3,5
43625,6,3,152807,152807,152810,0,3,3
43626,5,3,152812,152812,152815,0,3,2
43627,2,2,152814,152815,152817,1,3,0
43628,6,2,152820,152820,152822,0,2,3
43629,4,3,152824,152824,152827,0,3,2
43630,6,2,152830,152830,152832,0,2,3
43631,6,1,152836,152836,152837,0,1,4
43632,2,1,152838,152838,152839,0,1,1
43633,1,1,152839,152839,152840,0,1,0
43634,2,2,152841,152841,152843,0,2,1
43635,2,1,152843,152843,152844,0,1,0
43636,3,1,152846,152846,152847,0,1,2
43637,1,2,152847,152847,152849,0,2,0
43638,6,2,152853,152853,152855,0,2,4
43639,4,1,152857,152857,152858,0,1,2
43640,5,3,152862,152862,152865,0,3,4
43641,6,3,152868,152868,152871,0,3,3
43642,3,3,152871,152871,152874,0,3,0
43643,3,1,152874,152874,152875,0,1,0
43644,4,3,152878,152878,152881,0,3,3
43645,5,1,152883,152883,152884,0,1,2
43646,6,1,152889,152889,152890,0,1,5
43647,6,2,152895,152895,152897,0,2,5
43648,3,1,152898,152898,152899,0,1,1
43649,6,1,152904,152904,152905,0,1,5
43650,5,3,152909,152909,152912,0,3,4
43651,5,1,152914,152914,152915,0,1,2
43652,6,3,152920,152920,152923,0,3,5
43653,3,1,152923,152923,152924,0,1,0
43654,2,2,152925,152925,152927,0,2,1
43655,1,1,152926,152927,152928,1,2,0
43656,3,1,152929,152929,152930,0,1,1
43657,3,2,152932,152932,152934,0,2,2
43658,1,2,152933,152934,152936,1,3,0
43659,5,2,152938,152938,152940,0,2,2
43660,4,1,152942,152942,152943,0,1,2
43661,4,2,152946,152946,152948,0,2,3
43662,1,1,152947,152948,152949,1,2,0
43663,3,3,152950,152950,152953,0,3,1
43664,6,2,152956,152956,152958,0,2,3
43665,6,2,152962,152962,152964,0,2,4
43666,1,2,152963,152964,152966,1,3,0
43667,1,3,152964,152966,152969,2,5,0
43668,2,3,152966,152969,152972,3,6,0
43669,6,1,152972,152972,152973,0,1,0
43670,4,1,152976,152976,152977,0,1,3
43671,4,1,152980,152980,152981,0,1,3
43672,4,1,152984,152984,152985,0,1,3
43673,4,3,152988,152988,152991,0,3,3
43674,2,2,152990,152991,152993,1,3,0
43675,5,1,152995,152995,152996,0,1,2
43676,3,3,152998,152998,153001,0,3,2
43677,3,3,153001,153001,153004,0,3,0
43678,2,2,153003,153004,153006,1,3,0
43679,4,1,153007,153007,153008,0,1,1
43680,1,3,153008,153008,153011,0,3,0
43681,6,2,153014,153014,153016,0,2,3
43682,3,1,153017,153017,153018,0,1,1
43683,1,1,153018,153018,153019,0,1,0
43684,5,1,153023,153023,153024,0,1,4
43685,1,1,153024,153024,153025,0,1,0
43686,5,2,153029,153029,153031,0,2,4
43687,1,1,153030,153031,153032,1,2,0
43688,2,1,153032,153032,153033,0,1,0
43689,6,3,153038,153038,153041,0,3,5
43690,4,2,153042,153042,153044,0,2,1
43691,2,3,153044,153044,153047,0,3,0
43692,6,1,153050,153050,153051,0,1,3
43693,2,2,153052,153052,153054,0,2,1
43694,1,2,153053,153054,153056,1,3,0
43695,4,1,153057,153057,153058,0,1,1
43696,1,1,153058,153058,153059,0,1,0
43697,6,3,153064,153064,153067,0,3,5
43698,3,1,153067,153067,153068,0,1,0
43699,1,1,153068,153068,153069,0,1,0
43700,1,1,153069,153069,153070,0,1,0
43701,1,3,153070,153070,153073,0,3,0
43702,4,3,153074,153074,153077,0,3,1
43703,1,1,153075,153077,153078,2,3,0
43704,2,2,153077,153078,153080,1,3,0
43705,1,3,153078,153080,153083,2,5,0
43706,6,2,153084,153084,153086,0,2,1
43707,6,1,153090,153090,153091,0,1,4
43708,2,2,153092,153092,153094,0,2,1
43709,4,3,153096,153096,153099,0,3,2
43710,4,1,153100,153100,153101,0,1,1
43711,4,2,153104,153104,153106,0,2,3
43712,4,1,153108,153108,153109,0,1,2
43713,1,1,153109,153109,153110,0,1,0
43714,5,2,153114,153114,153116,0,2,4
43715,6,1,153120,153120,153121,0,1,4
43716,3,2,153123,153123,153125,0,2,2
43717,3,2,153126,153126,153128,0,2,1
43718,1,2,153127,153128,153130,1,3,0
43719,4,3,153131,153131,153134,0,3,1
43720,1,1,153132,153134,153135,2,3,0
43721,5,3,153137,153137,153140,0,3,2
43722,3,2,153140,153140,153142,0,2,0
43723,2,3,153142,153142,153145,0,3,0
43724,2,2,153144,153145,153147,1,3,0
43725,4,1,153148,153148,153149,0,1,1
43726,5,3,153153,153153,153156,0,3,4
43727,5,1,153158,153158,153159,0,1,2
43728,6,3,153164,153164,153167,0,3,5
43729,2,1,153166,153167,153168,1,2,0
43730,6,1,153172,153172,153173,0,1,4
43731,5,3,153177,153177,153180,0,3,4
43732,1,2,153178,153180,153182,2,4,0
43733,4,1,153182,153182,153183,0,1,0
43734,5,2,153187,153187,153189,0,2,4
43735,6,1,153193,153193,153194,0,1,4
43736,2,1,153195,153195,153196,0,1,1
43737,3,1,153198,153198,153199,0,1,2
43738,3,2,153201,153201,153203,0,2,2
43739,5,1,153206,153206,153207,0,1,3
43740,5,2,153211,153211,153213,0,2,4
43741,5,2,153216,153216,153218,0,2,3
43742,6,1,153222,153222,153223,0,1,4
43743,4,1,153226,153226,153227,0,1,3
43744,3,2,153229,153229,153231,0,2,2
43745,2,2,153231,153231,153233,0,2,0
43746,4,1,153235,153235,153236,0,1,2
43747,3,3,153238,153238,153241,0,3,2
43748,6,2,153244,153244,153246,0,2,3
43749,4,3,153248,153248,153251,0,3,2
43750,4,1,153252,153252,153253,0,1,1
43751,5,3,153257,153257,153260,0,3,4
43752,2,1,153259,153260,153261,1,2,0
43753,1,1,153260,153261,153262,1,2,0
43754,1,3,153261,153262,153265,1,4,0
43755,2,2,153263,153265,153267,2,4,0
43756,2,1,153265,153267,153268,2,3,0
43757,3,3,153268,153268,153271,0,3,0
43758,6,3,153274,153274,153277,0,3,3
43759,1,1,153275,153277,153278,2,3,0
43760,2,1,153277,153278,153279,1,2,0
43761,3,3,153280,153280,153283,0,3,1
43762,2,2,153282,153283,153285,1,3,0
43763,3,3,153285,153285,153288,0,3,0
43764,5,2,153290,153290,153292,0,2,2
43765,5,1,153295,153295,153296,0,1,3
43766,5,3,153300,153300,153303,0,3,4
43767,2,3,153302,153303,153306,1,4,0
43768,6,1,153308,153308,153309,0,1,2
43769,5,2,153313,153313,153315,0,2,4
43770,3,1,153316,153316,153317,0,1,1
43771,6,1,153322,153322,153323,0,1,5
43772,3,2,153325,153325,153327,0,2,2
43773,1,3,153326,153327,153330,1,4,0
43774,3,1,153329,153330,153331,1,2,0
43775,2,1,153331,153331,153332,0,1,0
43776,2,2,153333,153333,153335,0,2,1
43777,2,3,153335,153335,153338,0,3,0
43778,4,3,153339,153339,153342,0,3,1
43779,4,3,153343,153343,153346,0,3,1
43780,6,2,153349,153349,153351,0,2,3
43781,3,1,153352,153352,153353,0,1,1
43782,6,2,153358,153358,153360,0,2,5
43783,6,2,153364,153364,153366,0,2,4
43784,6,3,153370,153370,153373,0,3,4
43785,3,2,153373,153373,153375,0,2,0
43786,1,2,153374,153375,153377,1,3,0
43787,3,3,153377,153377,153380,0,3,0
43788,5,1,153382,153382,153383,0,1,2
43789,1,3,153383,153383,153386,0,3,0
43790,2,1,153385,153386,153387,1,2,0
43791,4,3,153389,153389,153392,0,3,2
43792,3,3,153392,153392,153395,0,3,0
43793,6,1,153398,153398,153399,0,1,3
43794,2,2,153400,153400,153402,0,2,1
43795,2,1,153402,153402,153403,0,1,0
43796,3,1,153405,153405,153406,0,1,2
43797,4,3,153409,153409,153412,0,3,3
43798,2,2,153411,153412,153414,1,3,0
43799,3,3,153414,153414,153417,0,3,0
43800,5,3,153419,153419,153422,0,3,2
43801,4,3,153423,153423,153426,0,3,1
43802,4,3,153427,153427,153430,0,3,1
43803,1,2,153428,153430,153432,2,4,0
43804,2,2,153430,153432,153434,2,4,0
43805,4,1,153434,153434,153435,0,1,0
43806,4,2,153438,153438,153440,0,2,3
43807,4,3,153442,153442,153445,0,3,2
43808,5,2,153447,153447,153449,0,2,2
43809,1,3,153448,153449,153452,1,4,0
43810,5,2,153453,153453,153455,0,2,1
43811,1,2,153454,153455,153457,1,3,0
43812,4,3,153458,153458,153461,0,3,1
43813,2,3,153460,153461,153464,1,4,0
43814,3,3,153463,153464,153467,1,4,0
43815,4,3,153467,153467,153470,0,3,0
43816,4,1,153471,153471,153472,0,1,1
43817,2,1,153473,153473,153474,0,1,1
43818,5,3,153478,153478,153481,0,3,4
43819,1,3,153479,153481,153484,2,5,0
43820,2,3,153481,153484,153487,3,6,0
43821,2,3,153483,153487,153490,4,7,0
43822,6,2,153489,153490,153492,1,3,0
43823,6,3,153495,153495,153498,0,3,3
43824,2,3,153497,153498,153501,1,4,0
43825,1,1,153498,153501,153502,3,4,0
43826,2,2,153500,153502,153504,2,4,0
43827,2,3,153502,153504,153507,2,5,0
43828,2,2,153504,153507,153509,3,5,0
43829,1,3,153505,153509,153512,4,7,0
43830,1,2,153506,153512,153514,6,8,0
43831,4,3,153510,153514,153517,4,7,0
43832,3,2,153513,153517,153519,4,6,0
43833,2,3,153515,153519,153522,4,7,0
43834,4,1,153519,153522,153523,3,4,0
43835,1,1,153520,153523,153524,3,4,0
43836,1,3,153521,153524,153527,3,6,0
43837,2,1,153523,153527,153528,4,5,0
43838,4,3,153527,153528,153531,1,4,0
43839,2,2,153529,153531,153533,2,4,0
43840,6,2,153535,153535,153537,0,2,2
43841,5,2,153540,153540,153542,0,2,3
43842,2,1,153542,153542,153543,0,1,0
43843,5,3,153547,153547,153550,0,3,4
43844,1,2,153548,153550,153552,2,4,0
43845,1,3,153549,153552,153555,3,6,0
43846,3,3,153552,153555,153558,3,6,0
43847,6,3,153558,153558,153561,0,3,0
43848,2,2,153560,153561,153563,1,3,0
43849,5,3,153565,153565,153568,0,3,2
43850,3,1,153568,153568,153569,0,1,0
43851,3,3,153571,153571,153574,0,3,2
43852,5,2,153576,153576,153578,0,2,2
43853,6,1,153582,153582,153583,0,1,4
43854,4,1,153586,153586,153587,0,1,3
43855,1,3,153587,153587,153590,0,3,0
43856,1,1,153588,153590,153591,2,3,0
43857,4,3,153592,153592,153595,0,3,1
43858,1,1,153593,153595,153596,2,3,0
43859,6,3,153599,153599,153602,0,3,3
43860,5,2,153604,153604,153606,0,2,2
43861,2,2,153606,153606,153608,0,2,0
43862,6,2,153612,153612,153614,0,2,4
43863,1,2,153613,153614,153616,1,3,0
43864,3,2,153616,153616,153618,0,2,0
43865,2,3,153618,153618,153621,0,3,0
43866,4,3,153622,153622,153625,0,3,1
43867,5,2,153627,153627,153629,0,2,2
43868,1,2,153628,153629,153631,1,3,0
43869,5,1,153633,153633,153634,0,1,2
43870,4,3,153637,153637,153640,0,3,3
43871,3,1,153640,153640,153641,0,1,0
43872,1,3,153641,153641,153644,0,3,0
43873,4,1,153645,153645,153646,0,1,1
43874,5,1,153650,153650,153651,0,1,4
43875,6,1,153656,153656,153657,0,1,5
43876,2,1,153658,153658,153659,0,1,1
43877,1,1,153659,153659,153660,0,1,0
43878,5,3,153664,153664,153667,0,3,4
43879,6,1,153670,153670,153671,0,1,3
43880,1,3,153671,153671,153674,0,3,0
43881,6,1,153677,153677,153678,0,1,3
43882,2,3,153679,153679,153682,0,3,1
43883,1,1,153680,153682,153683,2,3,0
43884,1,1,153681,153683,153684,2,3,0
43885,4,1,153685,153685,153686,0,1,1
43886,4,3,153689,153689,153692,0,3,3
43887,3,3,153692,153692,153695,0,3,0
43888,3,2,153695,153695,153697,0,2,0
43889,4,3,153699,153699,153702,0,3,2
43890,4,1,153703,153703,153704,0,1,1
43891,4,3,153707,153707,153710,0,3,3
43892,1,1,153708,153710,153711,2,3,0
43893,2,3,153710,153711,153714,1,4,0
43894,5,1,153715,153715,153716,0,1,1
43895,6,1,153721,153721,153722,0,1,5
43896,1,3,153722,153722,153725,0,3,0
43897,6,2,153728,153728,153730,0,2,3
43898,1,2,153729,153730,153732,1,3,0
43899,3,3,153732,153732,153735,0,3,0
43900,6,1,153738,153738,153739,0,1,3
43901,3,3,153741,153741,153744,0,3,2
43902,6,1,153747,153747,153748,0,1,3
43903,3,3,153750,153750,153753,0,3,2
43904,1,2,153751,153753,153755,2,4,0
43905,2,1,153753,153755,153756,2,3,0
43906,3,2,153756,153756,153758,0,2,0
43907,4,2,153760,153760,153762,0,2,2
43908,3,3,153763,153763,153766,0,3,1
43909,5,3,153768,153768,153771,0,3,2
43910,4,3,153772,153772,153775,0,3,1
43911,6,3,153778,153778,153781,0,3,3
43912,6,2,153784,153784,153786,0,2,3
43913,5,3,153789,153789,153792,0,3,3
43914,2,2,153791,153792,153794,1,3,0
43915,5,3,153796,153796,153799,0,3,2
43916,6,3,153802,153802,153805,0,3,3
43917,6,3,153808,153808,153811,0,3,3
43918,3,2,153811,153811,153813,0,2,0
43919,4,2,153815,153815,153817,0,2,2
43920,3,3,153818,153818,153821,0,3,1
43921,2,2,153820,153821,153823,1,3,0
43922,5,2,153825,153825,153827,0,2,2
43923,4,3,153829,153829,153832,0,3,2
43924,1,1,153830,153832,153833,2,3,0
43925,5,3,153835,153835,153838,0,3,2
43926,6,3,153841,153841,153844,0,3,3
43927,5,3,153846,153846,153849,0,3,2
43928,4,2,153850,153850,153852,0,2,1
43929,5,1,153855,153855,153856,0,1,3
43930,6,2,153861,153861,153863,0,2,5
43931,6,3,153867,153867,153870,0,3,4
43932,1,1,153868,153870,153871,2,3,0
43933,4,3,153872,153872,153875,0,3,1
43934,2,2,153874,153875,153877,1,3,0
43935,3,2,153877,153877,153879,0,2,0
43936,2,2,153879,153879,153881,0,2,0
43937,5,2,153884,153884,153886,0,2,3
43938,1,2,153885,153886,153888,1,3,0
43939,5,1,153890,153890,153891,0,1,2
43940,5,3,153895,153895,153898,0,3,4
43941,2,1,153897,153898,153899,1,2,0
43942,5,2,153902,153902,153904,0,2,3
43943,4,1,153906,153906,153907,0,1,2
43944,3,2,153909,153909,153911,0,2,2
43945,5,2,153914,153914,153916,0,2,3
43946,1,3,153915,153916,153919,1,4,0
43947,5,2,153920,153920,153922,0,2,1
43948,4,2,153924,153924,153926,0,2,2
43949,5,3,153929,153929,153932,0,3,3
43950,5,2,153934,153934,153936,0,2,2
43951,1,3,153935,153936,153939,1,4,0
43952,3,2,153938,153939,153941,1,3,0
43953,3,3,153941,153941,153944,0,3,0
43954,3,3,153944,153944,153947,0,3,0
43955,1,1,153945,153947,153948,2,3,0
43956,2,3,153947,153948,153951,1,4,0
43957,4,1,153951,153951,153952,0,1,0
43958,5,3,153956,153956,153959,0,3,4
43959,5,1,153961,153961,153962,0,1,2
43960,2,3,153963,153963,153966,0,3,1
43961,1,1,153964,153966,153967,2,3,0
43962,4,1,153968,153968,153969,0,1,1
43963,3,3,153971,153971,153974,0,3,2
43964,1,2,153972,153974,153976,2,4,0
43965,6,3,153978,153978,153981,0,3,2
43966,3,1,153981,153981,153982,0,1,0
43967,1,1,153982,153982,153983,0,1,0
43968,1,1,153983,153983,153984,0,1,0
43969,5,1,153988,153988,153989,0,1,4
43970,5,1,153993,153993,153994,0,1,4
43971,3,2,153996,153996,153998,0,2,2
43972,2,3,153998,153998,154001,0,3,0
43973,3,2,154001,154001,154003,0,2,0
43974,1,2,154002,154003,154005,1,3,0
43975,1,1,154003,154005,154006,2,3,0
43976,1,2,154004,154006,154008,2,4,0
43977,2,1,154006,154008,154009,2,3,0
43978,3,2,154009,154009,154011,0,2,0
43979,2,1,154011,154011,154012,0,1,0
43980,3,2,154014,154014,154016,0,2,2
43981,6,2,154020,154020,154022,0,2,4
43982,4,3,154024,154024,154027,0,3,2
43983,2,3,154026,154027,154030,1,4,0
43984,6,1,154032,154032,154033,0,1,2
43985,6,1,154038,154038,154039,0,1,5
43986,3,2,154041,154041,154043,0,2,2
43987,3,3,154044,154044,154047,0,3,1
43988,1,3,154045,154047,154050,2,5,0
43989,4,1,154049,154050,154051,1,2,0
43990,3,1,154052,154052,154053,0,1,1
43991,2,1,154054,154054,154055,0,1,1
43992,2,2,154056,154056,154058,0,2,1
43993,4,3,154060,154060,154063,0,3,2
43994,1,2,154061,154063,154065,2,4,0
43995,5,3,154066,154066,154069,0,3,1
43996,2,2,154068,154069,154071,1,3,0
43997,6,1,154074,154074,154075,0,1,3
43998,2,1,154076,154076,154077,0,1,1
43999,3,1,154079,154079,154080,0,1,2
44000,4,3,154083,154083,154086,0,3,3
44001,3,2,154086,154086,154088,0,2,0
44002,1,3,154087,154088,154091,1,4,0
44003,3,2,154090,154091,154093,1,3,0
44004,2,2,154092,154093,154095,1,3,0
44005,4,1,154096,154096,154097,0,1,1
44006,3,1,154099,154099,154100,0,1,2
44007,1,1,154100,154100,154101,0,1,0
44008,5,2,154105,154105,154107,0,2,4
44009,5,2,154110,154110,154112,0,2,3
44010,2,3,154112,154112,154115,0,3,0
44011,6,3,154118,154118,154121,0,3,3
44012,3,3,154121,154121,154124,0,3,0
44013,1,2,154122,154124,154126,2,4,0
44014,5,3,154127,154127,154130,0,3,1
44015,6,1,154133,154133,154134,0,1,3
44016,4,1,154137,154137,154138,0,1,3
44017,6,3,154143,154143,154146,0,3,5
44018,2,3,154145,154146,154149,1,4,0
44019,1,3,154146,154149,154152,3,6,0
44020,6,2,154152,154152,154154,0,2,0
44021,2,3,154154,154154,154157,0,3,0
44022,5,2,154159,154159,154161,0,2,2
44023,3,1,154162,154162,154163,0,1,1
44024,4,2,154166,154166,154168,0,2,3
44025,4,3,154170,154170,154173,0,3,2
44026,3,2,154173,154173,154175,0,2,0
44027,6,3,154179,154179,154182,0,3,4
44028,2,3,154181,154182,154185,1,4,0
44029,3,3,154184,154185,154188,1,4,0
44030,5,2,154189,154189,154191,0,2,1
44031,1,3,154190,154191,154194,1,4,0
44032,4,2,154194,154194,154196,0,2,0
44033,6,3,154200,154200,154203,0,3,4
44034,2,1,154202,154203,154204,1,2,0
44035,2,3,154204,154204,154207,0,3,0
44036,6,3,154210,154210,154213,0,3,3
44037,2,1,154212,154213,154214,1,2,0
44038,4,2,154216,154216,154218,0,2,2
44039,4,1,154220,154220,154221,0,1,2
44040,4,2,154224,154224,154226,0,2,3
44041,5,3,154229,154229,154232,0,3,3
44042,3,2,154232,154232,154234,0,2,0
44043,4,2,154236,154236,154238,0,2,2
44044,4,3,154240,154240,154243,0,3,2
44045,1,2,154241,154243,154245,2,4,0
44046,6,1,154247,154247,154248,0,1,2
44047,1,3,154248,154248,154251,0,3,0
44048,2,2,154250,154251,154253,1,3,0
44049,3,1,154253,154253,154254,0,1,0
44050,4,1,154257,154257,154258,0,1,3
44051,6,3,154263,154263,154266,0,3,5
44052,6,3,154269,154269,154272,0,3,3
44053,5,2,154274,154274,154276,0,2,2
44054,4,1,154278,154278,154279,0,1,2
44055,2,1,154280,154280,154281,0,1,1
44056,6,3,154286,154286,154289,0,3,5
44057,4,3,154290,154290,154293,0,3,1
44058,2,2,154292,154293,154295,1,3,0
44059,6,1,154298,154298,154299,0,1,3
44060,4,2,154302,154302,154304,0,2,3
44061,3,3,154305,154305,154308,0,3,1
44062,3,2,154308,154308,154310,0,2,0
44063,6,1,154314,154314,154315,0,1,4
44064,2,3,154316,154316,154319,0,3,1
44065,6,1,154322,154322,154323,0,1,3
44066,1,3,154323,154323,154326,0,3,0
44067,5,1,154328,154328,154329,0,1,2
44068,3,2,154331,154331,154333,0,2,2
44069,5,1,154336,154336,154337,0,1,3
44070,5,2,154341,154341,154343,0,2,4
44071,2,1,154343,154343,154344,0,1,0
44072,4,3,154347,154347,154350,0,3,3
44073,2,2,154349,154350,154352,1,3,0
44074,3,2,154352,154352,154354,0,2,0
44075,2,1,154354,154354,154355,0,1,0
44076,5,2,154359,154359,154361,0,2,4
44077,6,1,154365,154365,154366,0,1,4
44078,6,2,154371,154371,154373,0,2,5
44079,5,2,154376,154376,154378,0,2,3
44080,5,1,154381,154381,154382,0,1,3
44081,6,2,154387,154387,154389,0,2,5
44082,4,1,154391,154391,154392,0,1,2
44083,5,1,154396,154396,154397,0,1,4
44084,1,1,154397,154397,154398,0,1,0
44085,2,3,154399,154399,154402,0,3,1
44086,6,1,154405,154405,154406,0,1,3
44087,6,2,154411,154411,154413,0,2,5
44088,3,2,154414,154414,154416,0,2,1
44089,5,3,154419,154419,154422,0,3,3
44090,3,2,154422,154422,154424,0,2,0
44091,6,2,154428,154428,154430,0,2,4
44092,3,3,154431,154431,154434,0,3,1
44093,5,3,154436,154436,154439,0,3,2
44094,2,3,154438,154439,154442,1,4,0
44095,3,2,154441,154442,154444,1,3,0
44096,6,3,154447,154447,154450,0,3,3
44097,5,3,154452,154452,154455,0,3,2
44098,1,3,154453,154455,154458,2,5,0
44099,3,2,154456,154458,154460,2,4,0
44100,6,1,154462,154462,154463,0,1,2
44101,2,3,154464,154464,154467,0,3,1
44102,4,1,154468,154468,154469,0,1,1
44103,5,2,154473,154473,154475,0,2,4
44104,5,1,154478,154478,154479,0,1,3
44105,6,1,154484,154484,154485,0,1,5
44106,1,1,154485,154485,154486,0,1,0
44107,2,3,154487,154487,154490,0,3,1
44108,3,2,154490,154490,154492,0,2,0
44109,2,3,154492,154492,154495,0,3,0
44110,2,2,154494,154495,154497,1,3,0
44111,1,3,154495,154497,154500,2,5,0
44112,3,3,154498,154500,154503,2,5,0
44113,5,2,154503,154503,154505,0,2,0
44114,5,3,154508,154508,154511,0,3,3
44115,3,3,154511,154511,154514,0,3,0
44116,6,3,154517,154517,154520,0,3,3
44117,5,2,154522,154522,154524,0,2,2
44118,1,1,154523,154524,154525,1,2,0
44119,1,3,154524,154525,154528,1,4,0
44120,1,3,154525,154528,154531,3,6,0
44121,3,2,154528,154531,154533,3,5,0
44122,1,3,154529,154533,154536,4,7,0
44123,3,1,154532,154536,154537,4,5,0
44124,5,2,154537,154537,154539,0,2,0
44125,3,2,154540,154540,154542,0,2,1
44126,5,3,154545,154545,154548,0,3,3
44127,6,2,154551,154551,154553,0,2,3
44128,2,3,154553,154553,154556,0,3,0
44129,5,1,154558,154558,154559,0,1,2
44130,4,3,154562,154562,154565,0,3,3
44131,5,3,154567,154567,154570,0,3,2
44132,3,2,154570,154570,154572,0,2,0
44133,2,2,154572,154572,154574,0,2,0
44134,2,1,154574,154574,154575,0,1,0
44135,3,3,154577,154577,154580,0,3,2
44136,5,2,154582,154582,154584,0,2,2
44137,2,1,154584,154584,154585,0,1,0
44138,3,3,154587,154587,154590,0,3,2
44139,1,2,154588,154590,154592,2,4,0
44140,4,1,154592,154592,154593,0,1,0
44141,5,3,154597,154597,154600,0,3,4
44142,1,2,154598,154600,154602,2,4,0
44143,2,2,154600,154602,154604,2,4,0
44144,3,1,154603,154604,154605,1,2,0
44145,2,2,154605,154605,154607,0,2,0
44146,5,3,154610,154610,154613,0,3,3
44147,5,3,154615,154615,154618,0,3,2
44148,4,3,154619,154619,154622,0,3,1
44149,6,3,154625,154625,154628,0,3,3
44150,5,3,154630,154630,154633,0,3,2
44151,3,3,154633,154633,154636,0,3,0
44152,2,2,154635,154636,154638,1,3,0
44153,4,3,154639,154639,154642,0,3,1
44154,6,1,154645,154645,154646,0,1,3
44155,6,3,154651,154651,154654,0,3,5
44156,3,3,154654,154654,154657,0,3,0
44157,5,3,154659,154659,154662,0,3,2
44158,2,1,154661,154662,154663,1,2,0
44159,3,3,154664,154664,154667,0,3,1
44160,2,2,154666,154667,154669,1,3,0
44161,2,1,154668,154669,154670,1,2,0
44162,1,2,154669,154670,154672,1,3,0
44163,1,1,154670,154672,154673,2,3,0
44164,6,2,154676,154676,154678,0,2,3
44165,1,1,154677,154678,154679,1,2,0
44166,6,3,154683,154683,154686,0,3,4
44167,6,2,154689,154689,154691,0,2,3
44168,5,1,154694,154694,154695,0,1,3
44169,2,1,154696,154696,154697,0,1,1
44170,1,3,154697,154697,154700,0,3,0
44171,5,3,154702,154702,154705,0,3,2
44172,1,2,154703,154705,154707,2,4,0
44173,5,3,154708,154708,154711,0,3,1
44174,4,2,154712,154712,154714,0,2,1
44175,3,2,154715,154715,154717,0,2,1
44176,3,1,154718,154718,154719,0,1,1
44177,6,3,154724,154724,154727,0,3,5
44178,3,1,154727,154727,154728,0,1,0
44179,5,1,154732,154732,154733,0,1,4
44180,3,3,154735,154735,154738,0,3,2
44181,5,1,154740,154740,154741,0,1,2
44182,5,3,154745,154745,154748,0,3,4
44183,5,2,154750,154750,154752,0,2,2
44184,5,3,154755,154755,154758,0,3,3
44185,5,3,154760,154760,154763,0,3,2
44186,1,1,154761,154763,154764,2,3,0
44187,2,2,154763,154764,154766,1,3,0
44188,2,3,154765,154766,154769,1,4,0
44189,4,2,154769,154769,154771,0,2,0
44190,1,3,154770,154771,154774,1,4,0
44191,1,1,154771,154774,154775,3,4,0
44192,6,3,154777,154777,154780,0,3,2
44193,6,2,154783,154783,154785,0,2,3
44194,1,2,154784,154785,154787,1,3,0
44195,2,1,154786,154787,154788,1,2,0
44196,3,3,154789,154789,154792,0,3,1
44197,6,3,154795,154795,154798,0,3,3
44198,6,2,154801,154801,154803,0,2,3
44199,5,3,154806,154806,154809,0,3,3
44200,4,3,154810,154810,154813,0,3,1
44201,1,2,154811,154813,154815,2,4,0
44202,6,1,154817,154817,154818,0,1,2
44203,1,1,154818,154818,154819,0,1,0
44204,1,1,154819,154819,154820,0,1,0
44205,4,1,154823,154823,154824,0,1,3
44206,4,3,154827,154827,154830,0,3,3
44207,2,3,154829,154830,154833,1,4,0
44208,5,2,154834,154834,154836,0,2,1
44209,4,1,154838,154838,154839,0,1,2
44210,1,1,154839,154839,154840,0,1,0
44211,4,2,154843,154843,154845,0,2,3
44212,4,2,154847,154847,154849,0,2,2
44213,6,1,154853,154853,154854,0,1,4
44214,3,1,154856,154856,154857,0,1,2
44215,6,1,154862,154862,154863,0,1,5
44216,5,1,154867,154867,154868,0,1,4
44217,6,2,154873,154873,154875,0,2,5
44218,6,2,154879,154879,154881,0,2,4
44219,5,2,154884,154884,154886,0,2,3
44220,3,1,154887,154887,154888,0,1,1
44221,4,2,154891,154891,154893,0,2,3
44222,6,2,154897,154897,154899,0,2,4
44223,4,3,154901,154901,154904,0,3,2
44224,2,1,154903,154904,154905,1,2,0
44225,1,3,154904,154905,154908,1,4,0
44226,5,2,154909,154909,154911,0,2,1
44227,2,1,154911,154911,154912,0,1,0
44228,6,1,154917,154917,154918,0,1,5
44229,1,3,154918,154918,154921,0,3,0
44230,2,3,154920,154921,154924,1,4,0
44231,3,3,154923,154924,154927,1,4,0
44232,1,1,154924,154927,154928,3,4,0
44233,1,1,154925,154928,154929,3,4,0
44234,6,2,154931,154931,154933,0,2,2
44235,5,1,154936,154936,154937,0,1,3
44236,4,1,154940,154940,154941,0,1,3
44237,1,1,154941,154941,154942,0,1,0
44238,3,1,154944,154944,154945,0,1,2
44239,6,1,154950,154950,154951,0,1,5
44240,2,3,154952,154952,154955,0,3,1
44241,1,3,154953,154955,154958,2,5,0
44242,1,2,154954,154958,154960,4,6,0
44243,4,1,154958,154960,154961,2,3,0
44244,2,1,154960,154961,154962,1,2,0
44245,3,1,154963,154963,154964,0,1,1
44246,5,3,154968,154968,154971,0,3,4
44247,2,2,154970,154971,154973,1,3,0
44248,1,3,154971,154973,154976,2,5,0
44249,2,3,154973,154976,154979,3,6,0
44250,1,3,154974,154979,154982,5,8,0
44251,2,1,154976,154982,154983,6,7,0
44252,3,2,154979,154983,154985,4,6,0
44253,1,2,154980,154985,154987,5,7,0
44254,5,3,154985,154987,154990,2,5,0
44255,6,1,154991,154991,154992,0,1,1
44256,1,2,154992,154992,154994,0,2,0
44257,3,2,154995,154995,154997,0,2,1
44258,3,3,154998,154998,155001,0,3,1
44259,2,3,155000,155001,155004,1,4,0
44260,6,3,155006,155006,155009,0,3,2
44261,6,3,155012,155012,155015,0,3,3
44262,6,3,155018,155018,155021,0,3,3
44263,6,1,155024,155024,155025,0,1,3
44264,6,3,155030,155030,155033,0,3,5
44265,4,2,155034,155034,155036,0,2,1
44266,4,3,155038,155038,155041,0,3,2
44267,2,2,155040,155041,155043,1,3,0
44268,5,3,155045,155045,155048,0,3,2
44269,5,1,155050,155050,155051,0,1,2
44270,1,3,155051,155051,155054,0,3,0
44271,1,2,155052,155054,155056,2,4,0
44272,3,1,155055,155056,155057,1,2,0
44273,5,2,155060,155060,155062,0,2,3
44274,2,3,155062,155062,155065,0,3,0
44275,4,3,155066,155066,155069,0,3,1
44276,6,2,155072,155072,155074,0,2,3
44277,6,3,155078,155078,155081,0,3,4
44278,4,3,155082,155082,155085,0,3,1
44279,2,3,155084,155085,155088,1,4,0
44280,4,2,155088,155088,155090,0,2,0
44281,3,2,155091,155091,155093,0,2,1
44282,5,2,155096,155096,155098,0,2,3
44283,1,2,155097,155098,155100,1,3,0
44284,3,1,155100,155100,155101,0,1,0
44285,2,2,155102,155102,155104,0,2,1
44286,1,1,155103,155104,155105,1,2,0
44287,5,1,155108,155108,155109,0,1,3
44288,5,2,155113,155113,155115,0,2,4
44289,4,2,155117,155117,155119,0,2,2
44290,4,2,155121,155121,155123,0,2,2
44291,5,1,155126,155126,155127,0,1,3
44292,2,2,155128,155128,155130,0,2,1
44293,5,1,155133,155133,155134,0,1,3
44294,6,3,155139,155139,155142,0,3,5
44295,4,1,155143,155143,155144,0,1,1
44296,3,3,155146,155146,155149,0,3,2
44297,1,1,155147,155149,155150,2,3,0
44298,4,1,155151,155151,155152,0,1,1
44299,4,1,155155,155155,155156,0,1,3
44300,2,3,155157,155157,155160,0,3,1
44301,6,1,155163,155163,155164,0,1,3
44302,3,2,155166,155166,155168,0,2,2
44303,2,2,155168,155168,155170,0,2,0
44304,3,3,155171,155171,155174,0,3,1
44305,4,3,155175,155175,155178,0,3,1
44306,4,2,155179,155179,155181,0,2,1
44307,3,3,155182,155182,155185,0,3,1
44308,3,3,155185,155185,155188,0,3,0
44309,1,2,155186,155188,155190,2,4,0
44310,5,1,155191,155191,155192,0,1,1
44311,6,1,155197,155197,155198,0,1,5
44312,3,3,155200,155200,155203,0,3,2
44313,2,3,155202,155203,155206,1,4,0
44314,3,1,155205,155206,155207,1,2,0
44315,1,3,155206,155207,155210,1,4,0
44316,5,1,155211,155211,155212,0,1,1
44317,5,2,155216,155216,155218,0,2,4
44318,2,2,155218,155218,155220,0,2,0
44319,3,3,155221,155221,155224,0,3,1
44320,3,1,155224,155224,155225,0,1,0
44321,6,1,155230,155230,155231,0,1,5
44322,3,1,155233,155233,155234,0,1,2
44323,4,1,155237,155237,155238,0,1,3
44324,3,1,155240,155240,155241,0,1,2
44325,5,3,155245,155245,155248,0,3,4
44326,4,3,155249,155249,155252,0,3,1
44327,4,2,155253,155253,155255,0,2,1
44328,1,1,155254,155255,155256,1,2,0
44329,4,2,155258,155258,155260,0,2,2
44330,4,3,155262,155262,155265,0,3,2
44331,4,1,155266,155266,155267,0,1,1
44332,3,1,155269,155269,155270,0,1,2
44333,6,3,155275,155275,155278,0,3,5
44334,4,2,155279,155279,155281,0,2,1
44335,1,3,155280,155281,155284,1,4,0
44336,2,3,155282,155284,155287,2,5,0
44337,1,2,155283,155287,155289,4,6,0
44338,1,1,155284,155289,155290,5,6,0
44339,5,3,155289,155290,155293,1,4,0
44340,6,1,155295,155295,155296,0,1,2
44341,6,3,155301,155301,155304,0,3,5
44342,5,1,155306,155306,155307,0,1,2
44343,5,2,155311,155311,155313,0,2,4
44344,4,2,155315,155315,155317,0,2,2
44345,1,1,155316,155317,155318,1,2,0
44346,2,3,155318,155318,155321,0,3,0
44347,3,3,155321,155321,155324,0,3,0
44348,3,2,155324,155324,155326,0,2,0
44349,2,3,155326,155326,155329,0,3,0
44350,1,2,155327,155329,155331,2,4,0
44351,6,1,155333,155333,155334,0,1,2
44352,5,3,155338,155338,155341,0,3,4
44353,4,2,155342,155342,155344,0,2,1
44354,1,2,155343,155344,155346,1,3,0
44355,5,1,155348,155348,155349,0,1,2
44356,4,3,155352,155352,155355,0,3,3
44357,4,1,155356,155356,155357,0,1,1
44358,3,3,155359,155359,155362,0,3,2
44359,4,2,155363,155363,155365,0,2,1
44360,6,2,155369,155369,155371,0,2,4
44361,1,2,155370,155371,155373,1,3,0
44362,1,3,155371,155373,155376,2,5,0
44363,3,3,155374,155376,155379,2,5,0
44364,6,2,155380,155380,155382,0,2,1
44365,1,1,155381,155382,155383,1,2,0
44366,5,1,155386,155386,155387,0,1,3
44367,3,3,155389,155389,155392,0,3,2
44368,6,2,155395,155395,155397,0,2,3
44369,4,3,155399,155399,155402,0,3,2
44370,5,3,155404,155404,155407,0,3,2
44371,5,3,155409,155409,155412,0,3,2
44372,1,3,155410,155412,155415,2,5,0
44373,3,2,155413,155415,155417,2,4,0
44374,6,3,155419,155419,155422,0,3,2
44375,3,3,155422,155422,155425,0,3,0
44376,2,3,155424,155425,155428,1,4,0
44377,5,2,155429,155429,155431,0,2,1
44378,2,1,155431,155431,155432,0,1,0
44379,4,3,155435,155435,155438,0,3,3
44380,2,1,155437,155438,155439,1,2,0
44381,6,1,155443,155443,155444,0,1,4
44382,5,1,155448,155448,155449,0,1,4
44383,3,3,155451,155451,155454,0,3,2
44384,3,3,155454,155454,155457,0,3,0
44385,6,1,155460,155460,155461,0,1,3
44386,3,2,155463,155463,155465,0,2,2
44387,6,2,155469,155469,155471,0,2,4
44388,5,2,155474,155474,155476,0,2,3
44389,2,3,155476,155476,155479,0,3,0
44390,1,3,155477,155479,155482,2,5,0
44391,6,2,155483,155483,155485,0,2,1
44392,5,3,155488,155488,155491,0,3,3
44393,6,1,155494,155494,155495,0,1,3
44394,2,3,155496,155496,155499,0,3,1
44395,6,1,155502,155502,155503,0,1,3
44396,6,3,155508,155508,155511,0,3,5
44397,6,2,155514,155514,155516,0,2,3
44398,1,2,155515,155516,155518,1,3,0
44399,5,1,155520,155520,155521,0,1,2
44400,4,1,155524,155524,155525,0,1,3
44401,3,1,155527,155527,155528,0,1,2
44402,6,1,155533,155533,155534,0,1,5
44403,6,3,155539,155539,155542,0,3,5
44404,1,2,155540,155542,155544,2,4,0
44405,6,3,155546,155546,155549,0,3,2
44406,1,2,155547,155549,155551,2,4,0
44407,6,1,155553,155553,155554,0,1,2
44408,1,2,155554,155554,155556,0,2,0
44409,1,2,155555,155556,155558,1,3,0
44410,1,3,155556,155558,155561,2,5,0
44411,6,1,155562,155562,155563,0,1,1
44412,4,2,155566,155566,155568,0,2,3
44413,6,1,155572,155572,155573,0,1,4
44414,2,3,155574,155574,155577,0,3,1
44415,3,3,155577,155577,155580,0,3,0
44416,2,3,155579,155580,155583,1,4,0
44417,2,1,155581,155583,155584,2,3,0
44418,2,1,155583,155584,155585,1,2,0
44419,6,3,155589,155589,155592,0,3,4
44420,1,3,155590,155592,155595,2,5,0
44421,4,1,155594,155595,155596,1,2,0
44422,2,2,155596,155596,155598,0,2,0
44423,3,2,155599,155599,155601,0,2,1
44424,6,1,155605,155605,155606,0,1,4
44425,5,2,155610,155610,155612,0,2,4
44426,2,2,155612,155612,155614,0,2,0
44427,2,2,155614,155614,155616,0,2,0
44428,3,1,155617,155617,155618,0,1,1
44429,6,1,155623,155623,155624,0,1,5
44430,2,3,155625,155625,155628,0,3,1
44431,1,3,155626,155628,155631,2,5,0
44432,6,3,155632,155632,155635,0,3,1
44433,6,3,155638,155638,155641,0,3,3
44434,1,1,155639,155641,155642,2,3,0
44435,5,3,155644,155644,155647,0,3,2
44436,1,1,155645,155647,155648,2,3,0
44437,6,3,155651,155651,155654,0,3,3
44438,4,2,155655,155655,155657,0,2,1
44439,1,1,155656,155657,155658,1,2,0
44440,3,2,155659,155659,155661,0,2,1
44441,5,2,155664,155664,155666,0,2,3
44442,3,3,155667,155667,155670,0,3,1
44443,4,3,155671,155671,155674,0,3,1
44444,2,1,155673,155674,155675,1,2,0
44445,2,3,155675,155675,155678,0,3,0
44446,5,3,155680,155680,155683,0,3,2
44447,4,1,155684,155684,155685,0,1,1
44448,6,3,155690,155690,155693,0,3,5
44449,5,1,155695,155695,155696,0,1,2
44450,3,3,155698,155698,155701,0,3,2
44451,4,2,155702,155702,155704,0,2,1
44452,3,3,155705,155705,155708,0,3,1
44453,5,2,155710,155710,155712,0,2,2
44454,1,3,155711,155712,155715,1,4,0
44455,1,1,155712,155715,155716,3,4,0
44456,4,2,155716,155716,155718,0,2,0
44457,6,1,155722,155722,155723,0,1,4
44458,2,1,155724,155724,155725,0,1,1
44459,6,1,155730,155730,155731,0,1,5
44460,6,2,155736,155736,155738,0,2,5
44461,6,2,155742,155742,155744,0,2,4
44462,5,3,155747,155747,155750,0,3,3
44463,5,3,155752,155752,155755,0,3,2
44464,2,1,155754,155755,155756,1,2,0
44465,4,1,155758,155758,155759,0,1,2
44466,5,2,155763,155763,155765,0,2,4
44467,6,1,155769,155769,155770,0,1,4
44468,5,2,155774,155774,155776,0,2,4
44469,4,2,155778,155778,155780,0,2,2
44470,5,3,155783,155783,155786,0,3,3
44471,5,2,155788,155788,155790,0,2,2
44472,1,3,155789,155790,155793,1,4,0
44473,6,3,155795,155795,155798,0,3,2
44474,3,2,155798,155798,155800,0,2,0
44475,6,1,155804,155804,155805,0,1,4
44476,3,1,155807,155807,155808,0,1,2
44477,4,2,155811,155811,155813,0,2,3
44478,4,1,155815,155815,155816,0,1,2
44479,4,2,155819,155819,155821,0,2,3
44480,4,1,155823,155823,155824,0,1,2
44481,3,2,155826,155826,155828,0,2,2
44482,6,3,155832,155832,155835,0,3,4
44483,2,3,155834,155835,155838,1,4,0
44484,6,3,155840,155840,155843,0,3,2
44485,1,3,155841,155843,155846,2,5,0
44486,4,2,155845,155846,155848,1,3,0
44487,5,3,155850,155850,155853,0,3,2
44488,6,1,155856,155856,155857,0,1,3
44489,4,3,155860,155860,155863,0,3,3
44490,5,2,155865,155865,155867,0,2,2
44491,1,3,155866,155867,155870,1,4,0
44492,1,2,155867,155870,155872,3,5,0
44493,3,3,155870,155872,155875,2,5,0
44494,3,2,155873,155875,155877,2,4,0
44495,3,1,155876,155877,155878,1,2,0
44496,3,2,155879,155879,155881,0,2,1
44497,5,3,155884,155884,155887,0,3,3
44498,6,1,155890,155890,155891,0,1,3
44499,5,2,155895,155895,155897,0,2,4
44500,5,1,155900,155900,155901,0,1,3
44501,4,1,155904,155904,155905,0,1,3
44502,6,2,155910,155910,155912,0,2,5
44503,5,1,155915,155915,155916,0,1,3
44504,5,2,155920,155920,155922,0,2,4
44505,6,3,155926,155926,155929,0,3,4
44506,1,1,155927,155929,155930,2,3,0
44507,5,3,155932,155932,155935,0,3,2
44508,2,3,155934,155935,155938,1,4,0
44509,4,2,155938,155938,155940,0,2,0
44510,3,3,155941,155941,155944,0,3,1
44511,4,2,155945,155945,155947,0,2,1
44512,4,2,155949,155949,155951,0,2,2
44513,1,1,155950,155951,155952,1,2,0
44514,1,2,155951,155952,155954,1,3,0
44515,6,2,155957,155957,155959,0,2,3
44516,3,2,155960,155960,155962,0,2,1
44517,5,1,155965,155965,155966,0,1,3
44518,1,3,155966,155966,155969,0,3,0
44519,6,3,155972,155972,155975,0,3,3
44520,6,1,155978,155978,155979,0,1,3
44521,6,2,155984,155984,155986,0,2,5
44522,4,2,155988,155988,155990,0,2,2
44523,1,2,155989,155990,155992,1,3,0
44524,3,1,155992,155992,155993,0,1,0
44525,6,3,155998,155998,156001,0,3,5
44526,4,2,156002,156002,156004,0,2,1
44527,1,2,156003,156004,156006,1,3,0
44528,5,1,156008,156008,156009,0,1,2
44529,2,1,156010,156010,156011,0,1,1
44530,3,2,156013,156013,156015,0,2,2
44531,4,2,156017,156017,156019,0,2,2
44532,4,1,156021,156021,156022,0,1,2
44533,2,1,156023,156023,156024,0,1,1
44534,6,3,156029,156029,156032,0,3,5
44535,1,2,156030,156032,156034,2,4,0
44536,6,3,156036,156036,156039,0,3,2
44537,3,1,156039,156039,156040,0,1,0
44538,2,1,156041,156041,156042,0,1,1
44539,1,1,156042,156042,156043,0,1,0
44540,2,2,156044,156044,156046,0,2,1
44541,1,1,156045,156046,156047,1,2,0
44542,6,3,156051,156051,156054,0,3,4
44543,2,1,156053,156054,156055,1,2,0
44544,1,2,156054,156055,156057,1,3,0
44545,4,3,156058,156058,156061,0,3,1
44546,6,2,156064,156064,156066,0,2,3
44547,6,2,156070,156070,156072,0,2,4
44548,4,3,156074,156074,156077,0,3,2
44549,1,3,156075,156077,156080,2,5,0
44550,1,1,156076,156080,156081,4,5,0
44551,3,2,156079,156081,156083,2,4,0
44552,3,3,156082,156083,156086,1,4,0
44553,3,3,156085,156086,156089,1,4,0
44554,2,1,156087,156089,156090,2,3,0
44555,3,1,156090,156090,156091,0,1,0
44556,4,2,156094,156094,156096,0,2,3
44557,4,2,156098,156098,156100,0,2,2
44558,5,3,156103,156103,156106,0,3,3
44559,3,1,156106,156106,156107,0,1,0
44560,2,3,156108,156108,156111,0,3,1
44561,6,2,156114,156114,156116,0,2,3
44562,6,3,156120,156120,156123,0,3,4
44563,6,3,156126,156126,156129,0,3,3
44564,4,3,156130,156130,156133,0,3,1
44565,1,2,156131,156133,156135,2,4,0
44566,5,1,156136,156136,156137,0,1,1
44567,6,3,156142,156142,156145,0,3,5
44568,3,3,156145,156145,156148,0,3,0
44569,3,2,156148,156148,156150,0,2,0
44570,6,3,156154,156154,156157,0,3,4
44571,5,3,156159,156159,156162,0,3,2
44572,4,1,156163,156163,156164,0,1,1
44573,2,1,156165,156165,156166,0,1,1
44574,3,3,156168,156168,156171,0,3,2
44575,2,3,156170,156171,156174,1,4,0
44576,5,1,156175,156175,156176,0,1,1
44577,5,3,156180,156180,156183,0,3,4
44578,5,1,156185,156185,156186,0,1,2
44579,3,2,156188,156188,156190,0,2,2
44580,4,3,156192,156192,156195,0,3,2
44581,2,1,156194,156195,156196,1,2,0
44582,5,1,156199,156199,156200,0,1,3
44583,1,3,156200,156200,156203,0,3,0
44584,6,2,156206,156206,156208,0,2,3
44585,2,1,156208,156208,156209,0,1,0
44586,2,2,156210,156210,156212,0,2,1
44587,2,3,156212,156212,156215,0,3,0
44588,3,3,156215,156215,156218,0,3,0
44589,3,3,156218,156218,156221,0,3,0
44590,4,3,156222,156222,156225,0,3,1
44591,6,3,156228,156228,156231,0,3,3
44592,3,2,156231,156231,156233,0,2,0
44593,6,3,156237,156237,156240,0,3,4
44594,1,2,156238,156240,156242,2,4,0
44595,4,3,156242,156242,156245,0,3,0
44596,1,2,156243,156245,156247,2,4,0
44597,6,3,156249,156249,156252,0,3,2
44598,1,3,156250,156252,156255,2,5,0
44599,5,2,156255,156255,156257,0,2,0
44600,6,2,156261,156261,156263,0,2,4
44601,6,1,156267,156267,156268,0,1,4
44602,4,3,156271,156271,156274,0,3,3
44603,6,2,156277,156277,156279,0,2,3
44604,2,1,156279,156279,156280,0,1,0
44605,5,3,156284,156284,156287,0,3,4
44606,5,3,156289,156289,156292,0,3,2
44607,3,2,156292,156292,156294,0,2,0
44608,3,2,156295,156295,156297,0,2,1
44609,5,1,156300,156300,156301,0,1,3
44610,1,2,156301,156301,156303,0,2,0
44611,3,3,156304,156304,156307,0,3,1
44612,4,1,156308,156308,156309,0,1,1
44613,4,3,156312,156312,156315,0,3,3
44614,4,3,156316,156316,156319,0,3,1
44615,6,2,156322,156322,156324,0,2,3
44616,3,2,156325,156325,156327,0,2,1
44617,3,2,156328,156328,156330,0,2,1
44618,6,3,156334,156334,156337,0,3,4
44619,1,3,156335,156337,156340,2,5,0
44620,5,1,156340,156340,156341,0,1,0
44621,2,1,156342,156342,156343,0,1,1
44622,2,2,156344,156344,156346,0,2,1
44623,6,3,156350,156350,156353,0,3,4
44624,3,2,156353,156353,156355,0,2,0
44625,1,1,156354,156355,156356,1,2,0
44626,5,3,156359,156359,156362,0,3,3
44627,1,1,156360,156362,156363,2,3,0
44628,3,1,156363,156363,156364,0,1,0
44629,3,3,156366,156366,156369,0,3,2
44630,5,2,156371,156371,156373,0,2,2
44631,2,1,156373,156373,156374,0,1,0
44632,6,2,156379,156379,156381,0,2,5
44633,1,3,156380,156381,156384,1,4,0
44634,2,3,156382,156384,156387,2,5,0
44635,2,2,156384,156387,156389,3,5,0
44636,4,1,156388,156389,156390,1,2,0
44637,5,2,156393,156393,156395,0,2,3
44638,2,2,156395,156395,156397,0,2,0
44639,6,2,156401,156401,156403,0,2,4
44640,4,3,156405,156405,156408,0,3,2
44641,2,2,156407,156408,156410,1,3,0
44642,1,2,156408,156410,156412,2,4,0
44643,5,1,156413,156413,156414,0,1,1
44644,1,2,156414,156414,156416,0,2,0
44645,2,3,156416,156416,156419,0,3,0
44646,2,3,156418,156419,156422,1,4,0
44647,2,3,156420,156422,156425,2,5,0
44648,3,1,156423,156425,156426,2,3,0
44649,4,1,156427,156427,156428,0,1,1
44650,4,2,156431,156431,156433,0,2,3
44651,6,3,156437,156437,156440,0,3,4
44652,3,2,156440,156440,156442,0,2,0
44653,6,1,156446,156446,156447,0,1,4
44654,1,3,156447,156447,156450,0,3,0
44655,5,3,156452,156452,156455,0,3,2
44656,3,1,156455,156455,156456,0,1,0
44657,5,1,156460,156460,156461,0,1,4
44658,5,3,156465,156465,156468,0,3,4
44659,1,3,156466,156468,156471,2,5,0
44660,4,1,156470,156471,156472,1,2,0
44661,4,1,156474,156474,156475,0,1,2
44662,3,2,156477,156477,156479,0,2,2
44663,4,3,156481,156481,156484,0,3,2
44664,5,3,156486,156486,156489,0,3,2
44665,4,1,156490,156490,156491,0,1,1
44666,3,2,156493,156493,156495,0,2,2
44667,1,2,156494,156495,156497,1,3,0
44668,5,2,156499,156499,156501,0,2,2
44669,2,2,156501,156501,156503,0,2,0
44670,4,3,156505,156505,156508,0,3,2
44671,3,1,156508,156508,156509,0,1,0
44672,6,1,156514,156514,156515,0,1,5
44673,3,2,156517,156517,156519,0,2,2
44674,1,1,156518,156519,156520,1,2,0
44675,3,3,156521,156521,156524,0,3,1
44676,6,3,156527,156527,156530,0,3,3
44677,5,1,156532,156532,156533,0,1,2
44678,1,2,156533,156533,156535,0,2,0
44679,1,3,156534,156535,156538,1,4,0
44680,3,1,156537,156538,156539,1,2,0
44681,6,2,156543,156543,156545,0,2,4
44682,6,1,156549,156549,156550,0,1,4
44683,1,1,156550,156550,156551,0,1,0
44684,5,2,156555,156555,156557,0,2,4
44685,4,3,156559,156559,156562,0,3,2
44686,5,1,156564,156564,156565,0,1,2
44687,5,2,156569,156569,156571,0,2,4
44688,2,3,156571,156571,156574,0,3,0
44689,2,2,156573,156574,156576,1,3,0
44690,3,2,156576,156576,156578,0,2,0
44691,3,2,156579,156579,156581,0,2,1
44692,4,2,156583,156583,156585,0,2,2
44693,2,3,156585,156585,156588,0,3,0
44694,3,2,156588,156588,156590,0,2,0
44695,5,2,156593,156593,156595,0,2,3
44696,1,2,156594,156595,156597,1,3,0
44697,6,2,156600,156600,156602,0,2,3
44698,5,2,156605,156605,156607,0,2,3
44699,6,1,156611,156611,156612,0,1,4
44700,6,1,156617,156617,156618,0,1,5
44701,2,1,156619,156619,156620,0,1,1
44702,2,2,156621,156621,156623,0,2,1
44703,1,2,156622,156623,156625,1,3,0
44704,4,3,156626,156626,156629,0,3,1
44705,1,2,156627,156629,156631,2,4,0
44706,6,3,156633,156633,156636,0,3,2
44707,2,1,156635,156636,156637,1,2,0
44708,3,1,156638,156638,156639,0,1,1
44709,4,3,156642,156642,156645,0,3,3
44710,5,3,156647,156647,156650,0,3,2
44711,6,1,156653,156653,156654,0,1,3
44712,1,3,156654,156654,156657,0,3,0
44713,5,3,156659,156659,156662,0,3,2
44714,3,2,156662,156662,156664,0,2,0
44715,6,2,156668,156668,156670,0,2,4
44716,4,2,156672,156672,156674,0,2,2
44717,2,2,156674,156674,156676,0,2,0
44718,5,3,156679,156679,156682,0,3,3
44719,4,2,156683,156683,156685,0,2,1
44720,3,1,156686,156686,156687,0,1,1
44721,3,1,156689,156689,156690,0,1,2
44722,3,1,156692,156692,156693,0,1,2
44723,5,1,156697,156697,156698,0,1,4
44724,6,3,156703,156703,156706,0,3,5
44725,4,2,156707,156707,156709,0,2,1
44726,1,2,156708,156709,156711,1,3,0
44727,2,2,156710,156711,156713,1,3,0
44728,2,3,156712,156713,156716,1,4,0
44729,5,1,156717,156717,156718,0,1,1
44730,5,3,156722,156722,156725,0,3,4
44731,2,2,156724,156725,156727,1,3,0
44732,4,1,156728,156728,156729,0,1,1
44733,1,3,156729,156729,156732,0,3,0
44734,4,2,156733,156733,156735,0,2,1
44735,3,2,156736,156736,156738,0,2,1
44736,5,1,156741,156741,156742,0,1,3
44737,2,1,156743,156743,156744,0,1,1
44738,4,1,156747,156747,156748,0,1,3
44739,4,3,156751,156751,156754,0,3,3
44740,1,2,156752,156754,156756,2,4,0
44741,2,2,156754,156756,156758,2,4,0
44742,5,2,156759,156759,156761,0,2,1
44743,5,1,156764,156764,156765,0,1,3
44744,2,3,156766,156766,156769,0,3,1
44745,2,3,156768,156769,156772,1,4,0
44746,3,2,156771,156772,156774,1,3,0
44747,4,1,156775,156775,156776,0,1,1
44748,1,1,156776,156776,156777,0,1,0
44749,3,2,156779,156779,156781,0,2,2
44750,1,2,156780,156781,156783,1,3,0
44751,3,2,156783,156783,156785,0,2,0
44752,1,1,156784,156785,156786,1,2,0
44753,1,2,156785,156786,156788,1,3,0
44754,2,3,156787,156788,156791,1,4,0
44755,6,3,156793,156793,156796,0,3,2
44756,2,2,156795,156796,156798,1,3,0
44757,3,1,156798,156798,156799,0,1,0
44758,6,2,156804,156804,156806,0,2,5
44759,2,1,156806,156806,156807,0,1,0
44760,4,2,156810,156810,156812,0,2,3
44761,1,3,156811,156812,156815,1,4,0
44762,4,2,156815,156815,156817,0,2,0
44763,1,2,156816,156817,156819,1,3,0
44764,2,2,156818,156819,156821,1,3,0
44765,5,3,156823,156823,156826,0,3,2
44766,4,2,156827,156827,156829,0,2,1
44767,3,2,156830,156830,156832,0,2,1
44768,4,2,156834,156834,156836,0,2,2
44769,6,2,156840,156840,156842,0,2,4
44770,1,1,156841,156842,156843,1,2,0
44771,3,2,156844,156844,156846,0,2,1
44772,5,1,156849,156849,156850,0,1,3
44773,1,1,156850,156850,156851,0,1,0
44774,3,1,156853,156853,156854,0,1,2
44775,3,2,156856,156856,156858,0,2,2
44776,2,1,156858,156858,156859,0,1,0
44777,4,1,156862,156862,156863,0,1,3
44778,2,2,156864,156864,156866,0,2,1
44779,1,3,156865,156866,156869,1,4,0
44780,4,1,156869,156869,156870,0,1,0
44781,2,3,156871,156871,156874,0,3,1
44782,1,2,156872,156874,156876,2,4,0
44783,6,2,156878,156878,156880,0,2,2
44784,6,1,156884,156884,156885,0,1,4
44785,6,1,156890,156890,156891,0,1,5
44786,4,2,156894,156894,156896,0,2,3
44787,3,2,156897,156897,156899,0,2,1
44788,1,3,156898,156899,156902,1,4,0
44789,3,1,156901,156902,156903,1,2,0
44790,3,3,156904,156904,156907,0,3,1
44791,6,1,156910,156910,156911,0,1,3
44792,4,2,156914,156914,156916,0,2,3
44793,3,2,156917,156917,156919,0,2,1
44794,2,3,156919,156919,156922,0,3,0
44795,2,2,156921,156922,156924,1,3,0
44796,1,1,156922,156924,156925,2,3,0
44797,1,2,156923,156925,156927,2,4,0
44798,1,2,156924,156927,156929,3,5,0
44799,2,2,156926,156929,156931,3,5,0
44800,6,1,156932,156932,156933,0,1,1
44801,2,3,156934,156934,156937,0,3,1
44802,3,3,156937,156937,156940,0,3,0
44803,5,1,156942,156942,156943,0,1,2
44804,5,1,156947,156947,156948,0,1,4
44805,1,1,156948,156948,156949,0,1,0
44806,2,3,156950,156950,156953,0,3,1
44807,2,3,156952,156953,156956,1,4,0
44808,6,2,156958,156958,156960,0,2,2
44809,2,2,156960,156960,156962,0,2,0
44810,4,2,156964,156964,156966,0,2,2
44811,4,3,156968,156968,156971,0,3,2
44812,2,1,156970,156971,156972,1,2,0
44813,2,3,156972,156972,156975,0,3,0
44814,3,2,156975,156975,156977,0,2,0
44815,1,1,156976,156977,156978,1,2,0
44816,4,2,156980,156980,156982,0,2,2
44817,5,1,156985,156985,156986,0,1,3
44818,1,3,156986,156986,156989,0,3,0
44819,3,1,156989,156989,156990,0,1,0
44820,4,3,156993,156993,156996,0,3,3
44821,4,2,156997,156997,156999,0,2,1
44822,1,2,156998,156999,157001,1,3,0
44823,2,2,157000,157001,157003,1,3,0
44824,5,2,157005,157005,157007,0,2,2
44825,6,2,157011,157011,157013,0,2,4
44826,3,1,157014,157014,157015,0,1,1
44827,6,1,157020,157020,157021,0,1,5
44828,6,2,157026,157026,157028,0,2,5
44829,2,3,157028,157028,157031,0,3,0
44830,2,1,157030,157031,157032,1,2,0
44831,5,2,157035,157035,157037,0,2,3
44832,6,1,157041,157041,157042,0,1,4
44833,4,2,157045,157045,157047,0,2,3
44834,2,1,157047,157047,157048,0,1,0
44835,2,3,157049,157049,157052,0,3,1
44836,5,1,157054,157054,157055,0,1,2
44837,6,2,157060,157060,157062,0,2,5
44838,2,1,157062,157062,157063,0,1,0
44839,2,1,157064,157064,157065,0,1,1
44840,4,1,157068,157068,157069,0,1,3
44841,3,1,157071,157071,157072,0,1,2
44842,4,3,157075,157075,157078,0,3,3
44843,2,1,157077,157078,157079,1,2,0
44844,5,2,157082,157082,157084,0,2,3
44845,2,1,157084,157084,157085,0,1,0
44846,2,3,157086,157086,157089,0,3,1
44847,1,3,157087,157089,157092,2,5,0
44848,1,1,157088,157092,157093,4,5,0
44849,6,3,157094,157094,157097,0,3,1
44850,4,1,157098,157098,157099,0,1,1
44851,6,1,157104,157104,157105,0,1,5
44852,4,2,157108,157108,157110,0,2,3
44853,1,1,157109,157110,157111,1,2,0
44854,2,2,157111,157111,157113,0,2,0
44855,3,3,157114,157114,157117,0,3,1
44856,5,1,157119,157119,157120,0,1,2
44857,5,3,157124,157124,157127,0,3,4
44858,1,3,157125,157127,157130,2,5,0
44859,1,2,157126,157130,157132,4,6,0
44860,6,1,157132,157132,157133,0,1,0
44861,1,2,157133,157133,157135,0,2,0
44862,2,2,157135,157135,157137,0,2,0
44863,4,3,157139,157139,157142,0,3,2
44864,1,1,157140,157142,157143,2,3,0
44865,4,1,157144,157144,157145,0,1,1
44866,2,3,157146,157146,157149,0,3,1
44867,4,3,157150,157150,157153,0,3,1
44868,6,2,157156,157156,157158,0,2,3
44869,5,3,157161,157161,157164,0,3,3
44870,3,2,157164,157164,157166,0,2,0
44871,6,1,157170,157170,157171,0,1,4
44872,1,3,157171,157171,157174,0,3,0
44873,2,3,157173,157174,157177,1,4,0
44874,3,2,157176,157177,157179,1,3,0
44875,3,1,157179,157179,157180,0,1,0
44876,4,2,157183,157183,157185,0,2,3
44877,1,1,157184,157185,157186,1,2,0
44878,5,2,157189,157189,157191,0,2,3
44879,6,2,157195,157195,157197,0,2,4
44880,1,3,157196,157197,157200,1,4,0
44881,5,2,157201,157201,157203,0,2,1
44882,4,1,157205,157205,157206,0,1,2
44883,3,2,157208,157208,157210,0,2,2
44884,6,1,157214,157214,157215,0,1,4
44885,2,2,157216,157216,157218,0,2,1
44886,5,1,157221,157221,157222,0,1,3
44887,3,3,157224,157224,157227,0,3,2
44888,5,3,157229,157229,157232,0,3,2
44889,2,3,157231,157232,157235,1,4,0
44890,5,1,157236,157236,157237,0,1,1
44891,6,2,157242,157242,157244,0,2,5
44892,4,1,157246,157246,157247,0,1,2
44893,1,1,157247,157247,157248,0,1,0
44894,2,1,157249,157249,157250,0,1,1
44895,2,3,157251,157251,157254,0,3,1
44896,5,2,157256,157256,157258,0,2,2
44897,6,3,157262,157262,157265,0,3,4
44898,5,2,157267,157267,157269,0,2,2
44899,3,2,157270,157270,157272,0,2,1
44900,4,1,157274,157274,157275,0,1,2
44901,2,2,157276,157276,157278,0,2,1
44902,3,3,157279,157279,157282,0,3,1
44903,1,3,157280,157282,157285,2,5,0
44904,3,3,157283,157285,157288,2,5,0
44905,2,1,157285,157288,157289,3,4,0
44906,6,2,157291,157291,157293,0,2,2
44907,2,1,157293,157293,157294,0,1,0
44908,5,2,157298,157298,157300,0,2,4
44909,3,1,157301,157301,157302,0,1,1
44910,1,3,157302,157302,157305,0,3,0
44911,4,1,157306,157306,157307,0,1,1
44912,6,1,157312,157312,157313,0,1,5
44913,5,1,157317,157317,157318,0,1,4
44914,6,1,157323,157323,157324,0,1,5
44915,5,3,157328,157328,157331,0,3,4
44916,5,1,157333,157333,157334,0,1,2
44917,1,1,157334,157334,157335,0,1,0
44918,5,3,157339,157339,157342,0,3,4
44919,2,3,157341,157342,157345,1,4,0
44920,4,1,157345,157345,157346,0,1,0
44921,2,2,157347,157347,157349,0,2,1
44922,6,2,157353,157353,157355,0,2,4
44923,6,2,157359,157359,157361,0,2,4
44924,5,1,157364,157364,157365,0,1,3
44925,6,1,157370,157370,157371,0,1,5
44926,6,1,157376,157376,157377,0,1,5
44927,2,2,157378,157378,157380,0,2,1
44928,3,1,157381,157381,157382,0,1,1
44929,1,3,157382,157382,157385,0,3,0
44930,2,2,157384,157385,157387,1,3,0
44931,6,1,157390,157390,157391,0,1,3
44932,6,3,157396,157396,157399,0,3,5
44933,4,2,157400,157400,157402,0,2,1
44934,5,3,157405,157405,157408,0,3,3
44935,5,2,157410,157410,157412,0,2,2
44936,4,3,157414,157414,157417,0,3,2
44937,1,2,157415,157417,157419,2,4,0
44938,2,1,157417,157419,157420,2,3,0
44939,4,3,157421,157421,157424,0,3,1
44940,1,1,157422,157424,157425,2,3,0
44941,5,1,157427,157427,157428,0,1,2
44942,1,2,157428,157428,157430,0,2,0
44943,1,3,157429,157430,157433,1,4,0
44944,3,1,157432,157433,157434,1,2,0
44945,6,2,157438,157438,157440,0,2,4
44946,5,1,157443,157443,157444,0,1,3
44947,2,1,157445,157445,157446,0,1,1
44948,4,1,157449,157449,157450,0,1,3
44949,4,3,157453,157453,157456,0,3,3
44950,3,3,157456,157456,157459,0,3,0
44951,6,1,157462,157462,157463,0,1,3
44952,6,2,157468,157468,157470,0,2,5
44953,2,3,157470,157470,157473,0,3,0
44954,4,3,157474,157474,157477,0,3,1
44955,2,3,157476,157477,157480,1,4,0
44956,1,2,157477,157480,157482,3,5,0
44957,3,2,157480,157482,157484,2,4,0
44958,2,3,157482,157484,157487,2,5,0
44959,6,1,157488,157488,157489,0,1,1
44960,2,3,157490,157490,157493,0,3,1
44961,3,3,157493,157493,157496,0,3,0
44962,4,2,157497,157497,157499,0,2,1
44963,1,3,157498,157499,157502,1,4,0
44964,6,1,157504,157504,157505,0,1,2
44965,6,2,157510,157510,157512,0,2,5
44966,1,1,157511,157512,157513,1,2,0
44967,5,3,157516,157516,157519,0,3,3
44968,3,3,157519,157519,157522,0,3,0
44969,6,1,157525,157525,157526,0,1,3
44970,6,2,157531,157531,157533,0,2,5
44971,1,1,157532,157533,157534,1,2,0
44972,4,1,157536,157536,157537,0,1,2
44973,6,2,157542,157542,157544,0,2,5
44974,5,2,157547,157547,157549,0,2,3
44975,4,1,157551,157551,157552,0,1,2
44976,4,1,157555,157555,157556,0,1,3
44977,5,3,157560,157560,157563,0,3,4
44978,2,1,157562,157563,157564,1,2,0
44979,5,3,157567,157567,157570,0,3,3
44980,4,1,157571,157571,157572,0,1,1
44981,1,2,157572,157572,157574,0,2,0
44982,3,1,157575,157575,157576,0,1,1
44983,5,3,157580,157580,157583,0,3,4
44984,1,2,157581,157583,157585,2,4,0
44985,6,2,157587,157587,157589,0,2,2
44986,5,1,157592,157592,157593,0,1,3
44987,1,2,157593,157593,157595,0,2,0
44988,6,3,157599,157599,157602,0,3,4
44989,2,3,157601,157602,157605,1,4,0
44990,5,1,157606,157606,157607,0,1,1
44991,3,3,157609,157609,157612,0,3,2
44992,2,3,157611,157612,157615,1,4,0
44993,1,3,157612,157615,157618,3,6,0
44994,1,2,157613,157618,157620,5,7,0
44995,2,1,157615,157620,157621,5,6,0
44996,1,2,157616,157621,157623,5,7,0
44997,6,2,157622,157623,157625,1,3,0
44998,2,2,157624,157625,157627,1,3,0
44999,6,3,157630,157630,157633,0,3,3
45000,1,2,157631,157633,157635,2,4,0
45001,6,3,157637,157637,157640,0,3,2
45002,3,3,157640,157640,157643,0,3,0
45003,1,1,157641,157643,157644,2,3,0
45004,2,2,157643,157644,157646,1,3,0
45005,2,1,157645,157646,157647,1,2,0
45006,3,2,157648,157648,157650,0,2,1
45007,4,2,157652,157652,157654,0,2,2
45008,1,3,157653,157654,157657,1,4,0
45009,1,1,157654,157657,157658,3,4,0
45010,3,2,157657,157658,157660,1,3,0
45011,2,1,157659,157660,157661,1,2,0
45012,5,1,157664,157664,157665,0,1,3
45013,1,1,157665,157665,157666,0,1,0
45014,1,3,157666,157666,157669,0,3,0
45015,4,3,157670,157670,157673,0,3,1
45016,2,2,157672,157673,157675,1,3,0
45017,6,2,157678,157678,157680,0,2,3
45018,5,2,157683,157683,157685,0,2,3
45019,3,1,157686,157686,157687,0,1,1
45020,6,3,157692,157692,157695,0,3,5
45021,1,2,157693,157695,157697,2,4,0
45022,6,3,157699,157699,157702,0,3,2
45023,6,3,157705,157705,157708,0,3,3
45024,2,2,157707,157708,157710,1,3,0
45025,4,2,157711,157711,157713,0,2,1
45026,6,2,157717,157717,157719,0,2,4
45027,1,1,157718,157719,157720,1,2,0
45028,2,1,157720,157720,157721,0,1,0
45029,5,1,157725,157725,157726,0,1,4
45030,4,2,157729,157729,157731,0,2,3
45031,2,2,157731,157731,157733,0,2,0
45032,4,2,157735,157735,157737,0,2,2
45033,6,2,157741,157741,157743,0,2,4
45034,5,2,157746,157746,157748,0,2,3
45035,5,3,157751,157751,157754,0,3,3
45036,4,2,157755,157755,157757,0,2,1
45037,6,2,157761,157761,157763,0,2,4
45038,2,2,157763,157763,157765,0,2,0
45039,6,2,157769,157769,157771,0,2,4
45040,6,3,157775,157775,157778,0,3,4
45041,3,2,157778,157778,157780,0,2,0
45042,4,2,157782,157782,157784,0,2,2
45043,4,3,157786,157786,157789,0,3,2
45044,5,1,157791,157791,157792,0,1,2
45045,3,1,157794,157794,157795,0,1,2
45046,1,1,157795,157795,157796,0,1,0
45047,5,1,157800,157800,157801,0,1,4
45048,6,2,157806,157806,157808,0,2,5
45049,4,2,157810,157810,157812,0,2,2
45050,2,2,157812,157812,157814,0,2,0
45051,1,3,157813,157814,157817,1,4,0
45052,2,1,157815,157817,157818,2,3,0
45053,1,1,157816,157818,157819,2,3,0
45054,4,2,157820,157820,157822,0,2,1
45055,4,2,157824,157824,157826,0,2,2
45056,3,2,157827,157827,157829,0,2,1
45057,3,2,157830,157830,157832,0,2,1
45058,5,1,157835,157835,157836,0,1,3
45059,3,1,157838,157838,157839,0,1,2
45060,3,1,157841,157841,157842,0,1,2
45061,2,2,157843,157843,157845,0,2,1
45062,4,2,157847,157847,157849,0,2,2
45063,4,1,157851,157851,157852,0,1,2
45064,6,1,157857,157857,157858,0,1,5
45065,2,1,157859,157859,157860,0,1,1
45066,3,2,157862,157862,157864,0,2,2
45067,3,3,157865,157865,157868,0,3,1
45068,2,2,157867,157868,157870,1,3,0
45069,3,2,157870,157870,157872,0,2,0
45070,1,1,157871,157872,157873,1,2,0
45071,5,3,157876,157876,157879,0,3,3
45072,4,1,157880,157880,157881,0,1,1
45073,3,2,157883,157883,157885,0,2,2
45074,6,1,157889,157889,157890,0,1,4
45075,6,2,157895,157895,157897,0,2,5
45076,6,1,157901,157901,157902,0,1,4
45077,4,3,157905,157905,157908,0,3,3
45078,2,1,157907,157908,157909,1,2,0
45079,1,2,157908,157909,157911,1,3,0
45080,4,2,157912,157912,157914,0,2,1
45081,5,1,157917,157917,157918,0,1,3
45082,2,1,157919,157919,157920,0,1,1
45083,1,2,157920,157920,157922,0,2,0
45084,1,1,157921,157922,157923,1,2,0
45085,2,2,157923,157923,157925,0,2,0
45086,4,3,157927,157927,157930,0,3,2
45087,3,1,157930,157930,157931,0,1,0
45088,2,2,157932,157932,157934,0,2,1
45089,1,3,157933,157934,157937,1,4,0
45090,5,3,157938,157938,157941,0,3,1
45091,4,1,157942,157942,157943,0,1,1
45092,6,2,157948,157948,157950,0,2,5
45093,5,2,157953,157953,157955,0,2,3
45094,6,1,157959,157959,157960,0,1,4
45095,4,3,157963,157963,157966,0,3,3
45096,4,1,157967,157967,157968,0,1,1
45097,3,2,157970,157970,157972,0,2,2
45098,5,1,157975,157975,157976,0,1,3
45099,6,3,157981,157981,157984,0,3,5
45100,2,2,157983,157984,157986,1,3,0
45101,4,3,157987,157987,157990,0,3,1
45102,2,3,157989,157990,157993,1,4,0
45103,3,1,157992,157993,157994,1,2,0
45104,2,3,157994,157994,157997,0,3,0
45105,1,1,157995,157997,157998,2,3,0
45106,6,3,158001,158001,158004,0,3,3
45107,3,1,158004,158004,158005,0,1,0
45108,6,1,158010,158010,158011,0,1,5
45109,2,2,158012,158012,158014,0,2,1
45110,6,1,158018,158018,158019,0,1,4
45111,6,1,158024,158024,158025,0,1,5
45112,4,2,158028,158028,158030,0,2,3
45113,6,3,158034,158034,158037,0,3,4
45114,5,3,158039,158039,158042,0,3,2
45115,3,3,158042,158042,158045,0,3,0
45116,6,2,158048,158048,158050,0,2,3
45117,4,1,158052,158052,158053,0,1,2
45118,2,2,158054,158054,158056,0,2,1
45119,4,2,158058,158058,158060,0,2,2
45120,2,3,158060,158060,158063,0,3,0
45121,4,2,158064,158064,158066,0,2,1
45122,4,2,158068,158068,158070,0,2,2
45123,2,1,158070,158070,158071,0,1,0
45124,1,3,158071,158071,158074,0,3,0
45125,4,1,158075,158075,158076,0,1,1
45126,4,2,158079,158079,158081,0,2,3
45127,6,1,158085,158085,158086,0,1,4
45128,4,1,158089,158089,158090,0,1,3
45129,6,1,158095,158095,158096,0,1,5
45130,1,3,158096,158096,158099,0,3,0
45131,4,1,158100,158100,158101,0,1,1
45132,6,3,158106,158106,158109,0,3,5
45133,6,1,158112,158112,158113,0,1,3
45134,4,1,158116,158116,158117,0,1,3
45135,4,1,158120,158120,158121,0,1,3
45136,1,1,158121,158121,158122,0,1,0
45137,5,1,158126,158126,158127,0,1,4
45138,4,1,158130,158130,158131,0,1,3
45139,6,3,158136,158136,158139,0,3,5
45140,2,2,158138,158139,158141,1,3,0
45141,6,2,158144,158144,158146,0,2,3
45142,3,2,158147,158147,158149,0,2,1
45143,2,2,158149,158149,158151,0,2,0
45144,3,2,158152,158152,158154,0,2,1
45145,6,2,158158,158158,158160,0,2,4
45146,4,2,158162,158162,158164,0,2,2
45147,3,2,158165,158165,158167,0,2,1
45148,2,1,158167,158167,158168,0,1,0
45149,4,2,158171,158171,158173,0,2,3
45150,2,1,158173,158173,158174,0,1,0
45151,1,1,158174,158174,158175,0,1,0
45152,2,2,158176,158176,158178,0,2,1
45153,5,1,158181,158181,158182,0,1,3
45154,2,1,158183,158183,158184,0,1,1
45155,3,2,158186,158186,158188,0,2,2
45156,2,2,158188,158188,158190,0,2,0
45157,1,2,158189,158190,158192,1,3,0
45158,6,1,158195,158195,158196,0,1,3
45159,1,1,158196,158196,158197,0,1,0
45160,5,3,158201,158201,158204,0,3,4
45161,1,3,158202,158204,158207,2,5,0
45162,4,2,158206,158207,158209,1,3,0
45163,4,1,158210,158210,158211,0,1,1
45164,5,2,158215,158215,158217,0,2,4
45165,4,2,158219,158219,158221,0,2,2
45166,1,2,158220,158221,158223,1,3,0
45167,3,3,158223,158223,158226,0,3,0
45168,5,3,158228,158228,158231,0,3,2
45169,2,3,158230,158231,158234,1,4,0
45170,6,3,158236,158236,158239,0,3,2
45171,1,3,158237,158239,158242,2,5,0
45172,6,1,158243,158243,158244,0,1,1
45173,4,2,158247,158247,158249,0,2,3
45174,3,1,158250,158250,158251,0,1,1
45175,5,1,158255,158255,158256,0,1,4
45176,5,3,158260,158260,158263,0,3,4
45177,3,2,158263,158263,158265,0,2,0
45178,1,1,158264,158265,158266,1,2,0
45179,3,1,158267,158267,158268,0,1,1
45180,6,3,158273,158273,158276,0,3,5
45181,1,1,158274,158276,158277,2,3,0
45182,2,1,158276,158277,158278,1,2,0
45183,4,2,158280,158280,158282,0,2,2
45184,1,3,158281,158282,158285,1,4,0
45185,4,3,158285,158285,158288,0,3,0
45186,2,3,158287,158288,158291,1,4,0
45187,2,3,158289,158291,158294,2,5,0
45188,3,1,158292,158294,158295,2,3,0
45189,2,2,158294,158295,158297,1,3,0
45190,5,3,158299,158299,158302,0,3,2
45191,5,1,158304,158304,158305,0,1,2
45192,3,1,158307,158307,158308,0,1,2
45193,5,2,158312,158312,158314,0,2,4
45194,5,1,158317,158317,158318,0,1,3
45195,3,3,158320,158320,158323,0,3,2
45196,3,1,158323,158323,158324,0,1,0
45197,1,3,158324,158324,158327,0,3,0
45198,6,1,158330,158330,158331,0,1,3
45199,4,1,158334,158334,158335,0,1,3
45200,6,3,158340,158340,158343,0,3,5
45201,5,2,158345,158345,158347,0,2,2
45202,2,2,158347,158347,158349,0,2,0
45203,5,2,158352,158352,158354,0,2,3
45204,5,3,158357,158357,158360,0,3,3
45205,1,3,158358,158360,158363,2,5,0
45206,1,2,158359,158363,158365,4,6,0
45207,3,2,158362,158365,158367,3,5,0
45208,1,1,158363,158367,158368,4,5,0
45209,6,1,158369,158369,158370,0,1,1
45210,1,1,158370,158370,158371,0,1,0
45211,3,1,158373,158373,158374,0,1,2
45212,6,1,158379,158379,158380,0,1,5
45213,6,1,158385,158385,158386,0,1,5
45214,1,3,158386,158386,158389,0,3,0
45215,5,3,158391,158391,158394,0,3,2
45216,3,3,158394,158394,158397,0,3,0
45217,2,1,158396,158397,158398,1,2,0
45218,6,1,158402,158402,158403,0,1,4
45219,4,1,158406,158406,158407,0,1,3
45220,5,3,158411,158411,158414,0,3,4
45221,2,1,158413,158414,158415,1,2,0
45222,2,2,158415,158415,158417,0,2,0
45223,2,3,158417,158417,158420,0,3,0
45224,3,2,158420,158420,158422,0,2,0
45225,3,1,158423,158423,158424,0,1,1
45226,1,2,158424,158424,158426,0,2,0
45227,5,3,158429,158429,158432,0,3,3
45228,2,2,158431,158432,158434,1,3,0
45229,2,1,158433,158434,158435,1,2,0
45230,5,3,158438,158438,158441,0,3,3
45231,6,3,158444,158444,158447,0,3,3
45232,4,3,158448,158448,158451,0,3,1
45233,6,1,158454,158454,158455,0,1,3
45234,1,1,158455,158455,158456,0,1,0
45235,6,2,158461,158461,158463,0,2,5
45236,3,1,158464,158464,158465,0,1,1
45237,6,1,158470,158470,158471,0,1,5
45238,1,3,158471,158471,158474,0,3,0
45239,4,1,158475,158475,158476,0,1,1
45240,3,3,158478,158478,158481,0,3,2
45241,2,1,158480,158481,158482,1,2,0
45242,4,3,158484,158484,158487,0,3,2
45243,1,2,158485,158487,158489,2,4,0
45244,6,2,158491,158491,158493,0,2,2
45245,6,3,158497,158497,158500,0,3,4
45246,5,2,158502,158502,158504,0,2,2
45247,6,3,158508,158508,158511,0,3,4
45248,1,3,158509,158511,158514,2,5,0
45249,4,3,158513,158514,158517,1,4,0
45250,3,1,158516,158517,158518,1,2,0
45251,1,1,158517,158518,158519,1,2,0
45252,5,3,158522,158522,158525,0,3,3
45253,3,3,158525,158525,158528,0,3,0
45254,6,2,158531,158531,158533,0,2,3
45255,1,1,158532,158533,158534,1,2,0
45256,3,2,158535,158535,158537,0,2,1
45257,4,2,158539,158539,158541,0,2,2
45258,5,2,158544,158544,158546,0,2,3
45259,4,3,158548,158548,158551,0,3,2
45260,4,2,158552,158552,158554,0,2,1
45261,1,1,158553,158554,158555,1,2,0
45262,6,2,158559,158559,158561,0,2,4
45263,1,3,158560,158561,158564,1,4,0
45264,1,1,158561,158564,158565,3,4,0
45265,5,3,158566,158566,158569,0,3,1
45266,1,3,158567,158569,158572,2,5,0
45267,2,1,158569,158572,158573,3,4,0
45268,1,1,158570,158573,158574,3,4,0
45269,1,1,158571,158574,158575,3,4,0
45270,5,1,158576,158576,158577,0,1,1
45271,4,3,158580,158580,158583,0,3,3
45272,4,1,158584,158584,158585,0,1,1
45273,5,3,158589,158589,158592,0,3,4
45274,4,3,158593,158593,158596,0,3,1
45275,2,1,158595,158596,158597,1,2,0
45276,1,2,158596,158597,158599,1,3,0
45277,6,1,158602,158602,158603,0,1,3
45278,3,2,158605,158605,158607,0,2,2
45279,3,1,158608,158608,158609,0,1,1
45280,5,3,158613,158613,158616,0,3,4
45281,5,2,158618,158618,158620,0,2,2
45282,2,1,158620,158620,158621,0,1,0
45283,3,1,158623,158623,158624,0,1,2
45284,6,3,158629,158629,158632,0,3,5
45285,5,1,158634,158634,158635,0,1,2
45286,1,2,158635,158635,158637,0,2,0
45287,6,2,158641,158641,158643,0,2,4
45288,5,3,158646,158646,158649,0,3,3
45289,3,3,158649,158649,158652,0,3,0
45290,2,2,158651,158652,158654,1,3,0
45291,5,3,158656,158656,158659,0,3,2
45292,4,1,158660,158660,158661,0,1,1
45293,2,1,158662,158662,158663,0,1,1
45294,2,3,158664,158664,158667,0,3,1
45295,1,2,158665,158667,158669,2,4,0
45296,2,1,158667,158669,158670,2,3,0
45297,2,3,158669,158670,158673,1,4,0
45298,1,1,158670,158673,158674,3,4,0
45299,1,2,158671,158674,158676,3,5,0
45300,3,2,158674,158676,158678,2,4,0
45301,5,2,158679,158679,158681,0,2,1
45302,1,3,158680,158681,158684,1,4,0
45303,4,1,158684,158684,158685,0,1,0
45304,6,2,158690,158690,158692,0,2,5
45305,1,2,158691,158692,158694,1,3,0
45306,6,2,158697,158697,158699,0,2,3
45307,2,2,158699,158699,158701,0,2,0
45308,6,1,158705,158705,158706,0,1,4
45309,5,3,158710,158710,158713,0,3,4
45310,2,1,158712,158713,158714,1,2,0
45311,4,3,158716,158716,158719,0,3,2
45312,1,2,158717,158719,158721,2,4,0
45313,4,1,158721,158721,158722,0,1,0
45314,4,2,158725,158725,158727,0,2,3
45315,6,1,158731,158731,158732,0,1,4
45316,1,1,158732,158732,158733,0,1,0
45317,6,3,158738,158738,158741,0,3,5
45318,5,1,158743,158743,158744,0,1,2
45319,2,1,158745,158745,158746,0,1,1
45320,3,3,158748,158748,158751,0,3,2
45321,2,3,158750,158751,158754,1,4,0
45322,1,2,158751,158754,158756,3,5,0
45323,5,3,158756,158756,158759,0,3,0
45324,1,3,158757,158759,158762,2,5,0
45325,3,3,158760,158762,158765,2,5,0
45326,4,1,158764,158765,158766,1,2,0
45327,5,3,158769,158769,158772,0,3,3
45328,4,1,158773,158773,158774,0,1,1
45329,4,2,158777,158777,158779,0,2,3
45330,2,2,158779,158779,158781,0,2,0
45331,4,3,158783,158783,158786,0,3,2
45332,3,3,158786,158786,158789,0,3,0
45333,3,3,158789,158789,158792,0,3,0
45334,2,2,158791,158792,158794,1,3,0
45335,5,2,158796,158796,158798,0,2,2
45336,2,3,158798,158798,158801,0,3,0
45337,6,2,158804,158804,158806,0,2,3
45338,3,3,158807,158807,158810,0,3,1
45339,6,3,158813,158813,158816,0,3,3
45340,5,2,158818,158818,158820,0,2,2
45341,5,3,158823,158823,158826,0,3,3
45342,6,3,158829,158829,158832,0,3,3
45343,6,2,158835,158835,158837,0,2,3
45344,6,1,158841,158841,158842,0,1,4
45345,6,1,158847,158847,158848,0,1,5
45346,6,2,158853,158853,158855,0,2,5
45347,6,3,158859,158859,158862,0,3,4
45348,1,2,158860,158862,158864,2,4,0
45349,5,1,158865,158865,158866,0,1,1
45350,1,1,158866,158866,158867,0,1,0
45351,6,3,158872,158872,158875,0,3,5
45352,4,1,158876,158876,158877,0,1,1
45353,3,3,158879,158879,158882,0,3,2
45354,1,3,158880,158882,158885,2,5,0
45355,6,3,158886,158886,158889,0,3,1
45356,3,1,158889,158889,158890,0,1,0
45357,1,1,158890,158890,158891,0,1,0
45358,6,2,158896,158896,158898,0,2,5
45359,3,2,158899,158899,158901,0,2,1
45360,1,3,158900,158901,158904,1,4,0
45361,2,3,158902,158904,158907,2,5,0
45362,5,3,158907,158907,158910,0,3,0
45363,3,3,158910,158910,158913,0,3,0
45364,1,2,158911,158913,158915,2,4,0
45365,1,1,158912,158915,158916,3,4,0
45366,6,2,158918,158918,158920,0,2,2
45367,4,2,158922,158922,158924,0,2,2
45368,4,2,158926,158926,158928,0,2,2
45369,3,1,158929,158929,158930,0,1,1
45370,3,3,158932,158932,158935,0,3,2
45371,4,3,158936,158936,158939,0,3,1
45372,3,2,158939,158939,158941,0,2,0
45373,2,3,158941,158941,158944,0,3,0
45374,3,2,158944,158944,158946,0,2,0
45375,5,2,158949,158949,158951,0,2,3
45376,2,3,158951,158951,158954,0,3,0
45377,1,2,158952,158954,158956,2,4,0
45378,5,2,158957,158957,158959,0,2,1
45379,3,2,158960,158960,158962,0,2,1
45380,3,1,158963,158963,158964,0,1,1
45381,1,3,158964,158964,158967,0,3,0
45382,2,1,158966,158967,158968,1,2,0
45383,4,1,158970,158970,158971,0,1,2
45384,2,2,158972,158972,158974,0,2,1
45385,6,2,158978,158978,158980,0,2,4
45386,5,2,158983,158983,158985,0,2,3
45387,2,2,158985,158985,158987,0,2,0
45388,2,2,158987,158987,158989,0,2,0
45389,2,1,158989,158989,158990,0,1,0
45390,6,3,158995,158995,158998,0,3,5
45391,3,3,158998,158998,159001,0,3,0
45392,1,1,158999,159001,159002,2,3,0
45393,1,2,159000,159002,159004,2,4,0
45394,5,1,159005,159005,159006,0,1,1
45395,3,2,159008,159008,159010,0,2,2
45396,4,3,159012,159012,159015,0,3,2
45397,4,2,159016,159016,159018,0,2,1
45398,1,2,159017,159018,159020,1,3,0
45399,3,3,159020,159020,159023,0,3,0
45400,6,1,159026,159026,159027,0,1,3
45401,4,2,159030,159030,159032,0,2,3
45402,1,3,159031,159032,159035,1,4,0
45403,6,3,159037,159037,159040,0,3,2
45404,5,2,159042,159042,159044,0,2,2
45405,2,1,159044,159044,159045,0,1,0
45406,5,3,159049,159049,159052,0,3,4
45407,3,3,159052,159052,159055,0,3,0
45408,4,1,159056,159056,159057,0,1,1
45409,1,3,159057,159057,159060,0,3,0
45410,4,1,159061,159061,159062,0,1,1
45411,1,3,159062,159062,159065,0,3,0
45412,3,2,159065,159065,159067,0,2,0
45413,4,3,159069,159069,159072,0,3,2
45414,6,3,159075,159075,159078,0,3,3
45415,4,2,159079,159079,159081,0,2,1
45416,3,1,159082,159082,159083,0,1,1
45417,1,1,159083,159083,159084,0,1,0
45418,2,2,159085,159085,159087,0,2,1
45419,1,2,159086,159087,159089,1,3,0
45420,4,1,159090,159090,159091,0,1,1
45421,2,1,159092,159092,159093,0,1,1
45422,2,2,159094,159094,159096,0,2,1
45423,4,1,159098,159098,159099,0,1,2
45424,1,3,159099,159099,159102,0,3,0
45425,6,2,159105,159105,159107,0,2,3
45426,3,2,159108,159108,159110,0,2,1
45427,3,1,159111,159111,159112,0,1,1
45428,4,1,159115,159115,159116,0,1,3
45429,6,1,159121,159121,159122,0,1,5
45430,6,2,159127,159127,159129,0,2,5
45431,3,1,159130,159130,159131,0,1,1
45432,6,3,159136,159136,159139,0,3,5
45433,6,3,159142,159142,159145,0,3,3
45434,6,2,159148,159148,159150,0,2,3
45435,6,3,159154,159154,159157,0,3,4
45436,2,1,159156,159157,159158,1,2,0
45437,1,1,159157,159158,159159,1,2,0
45438,6,2,159163,159163,159165,0,2,4
45439,3,2,159166,159166,159168,0,2,1
45440,2,1,159168,159168,159169,0,1,0
45441,6,2,159174,159174,159176,0,2,5
45442,5,1,159179,159179,159180,0,1,3
45443,6,1,159185,159185,159186,0,1,5
45444,2,1,159187,159187,159188,0,1,1
45445,1,3,159188,159188,159191,0,3,0
45446,5,3,159193,159193,159196,0,3,2
45447,6,1,159199,159199,159200,0,1,3
45448,2,3,159201,159201,159204,0,3,1
45449,6,3,159207,159207,159210,0,3,3
45450,2,3,159209,159210,159213,1,4,0
45451,2,3,159211,159213,159216,2,5,0
45452,1,1,159212,159216,159217,4,5,0
45453,4,2,159216,159217,159219,1,3,0
45454,6,2,159222,159222,159224,0,2,3
45455,1,3,159223,159224,159227,1,4,0
45456,3,2,159226,159227,159229,1,3,0
45457,4,1,159230,159230,159231,0,1,1
45458,4,2,159234,159234,159236,0,2,3
45459,5,2,159239,159239,159241,0,2,3
45460,4,1,159243,159243,159244,0,1,2
45461,4,1,159247,159247,159248,0,1,3
45462,4,2,159251,159251,159253,0,2,3
45463,4,2,159255,159255,159257,0,2,2
45464,1,3,159256,159257,159260,1,4,0
45465,5,2,159261,159261,159263,0,2,1
45466,5,3,159266,159266,159269,0,3,3
45467,6,3,159272,159272,159275,0,3,3
45468,5,3,159277,159277,159280,0,3,2
45469,1,2,159278,159280,159282,2,4,0
45470,1,3,159279,159282,159285,3,6,0
45471,2,1,159281,159285,159286,4,5,0
45472,5,1,159286,159286,159287,0,1,0
45473,5,3,159291,159291,159294,0,3,4
45474,4,3,159295,159295,159298,0,3,1
45475,2,2,159297,159298,159300,1,3,0
45476,2,3,159299,159300,159303,1,4,0
45477,3,3,159302,159303,159306,1,4,0
45478,1,1,159303,159306,159307,3,4,0
45479,2,3,159305,159307,159310,2,5,0
45480,6,3,159311,159311,159314,0,3,1
45481,3,3,159314,159314,159317,0,3,0
45482,5,3,159319,159319,159322,0,3,2
45483,1,2,159320,159322,159324,2,4,0
45484,6,1,159326,159326,159327,0,1,2
45485,6,2,159332,159332,159334,0,2,5
45486,1,2,159333,159334,159336,1,3,0
45487,6,2,159339,159339,159341,0,2,3
45488,3,1,159342,159342,159343,0,1,1
45489,5,2,159347,159347,159349,0,2,4
45490,3,2,159350,159350,159352,0,2,1
45491,1,3,159351,159352,159355,1,4,0
45492,3,2,159354,159355,159357,1,3,0
45493,3,3,159357,159357,159360,0,3,0
45494,5,3,159362,159362,159365,0,3,2
45495,3,2,159365,159365,159367,0,2,0
45496,5,3,159370,159370,159373,0,3,3
45497,3,3,159373,159373,159376,0,3,0
45498,5,3,159378,159378,159381,0,3,2
45499,5,2,159383,159383,159385,0,2,2
45500,6,2,159389,159389,159391,0,2,4
45501,4,1,159393,159393,159394,0,1,2
45502,5,3,159398,159398,159401,0,3,4
45503,4,2,159402,159402,159404,0,2,1
45504,5,2,159407,159407,159409,0,2,3
45505,5,2,159412,159412,159414,0,2,3
45506,4,1,159416,159416,159417,0,1,2
45507,1,2,159417,159417,159419,0,2,0
45508,4,2,159421,159421,159423,0,2,2
45509,6,2,159427,159427,159429,0,2,4
45510,6,1,159433,159433,159434,0,1,4
45511,2,1,159435,159435,159436,0,1,1
45512,1,3,159436,159436,159439,0,3,0
45513,5,3,159441,159441,159444,0,3,2
45514,6,3,159447,159447,159450,0,3,3
45515,4,1,159451,159451,159452,0,1,1
45516,5,1,159456,159456,159457,0,1,4
45517,5,3,159461,159461,159464,0,3,4
45518,3,1,159464,159464,159465,0,1,0
45519,6,2,159470,159470,159472,0,2,5
45520,3,1,159473,159473,159474,0,1,1
45521,3,3,159476,159476,159479,0,3,2
45522,5,1,159481,159481,159482,0,1,2
45523,3,3,159484,159484,159487,0,3,2
45524,1,2,159485,159487,159489,2,4,0
45525,3,2,159488,159489,159491,1,3,0
45526,1,3,159489,159491,159494,2,5,0
45527,1,3,159490,159494,159497,4,7,0
45528,2,3,159492,159497,159500,5,8,0
45529,2,1,159494,159500,159501,6,7,0
45530,4,3,159498,159501,159504,3,6,0
45531,6,2,159504,159504,159506,0,2,0
45532,5,3,159509,159509,159512,0,3,3
45533,1,3,159510,159512,159515,2,5,0
45534,2,2,159512,159515,159517,3,5,0
45535,1,3,159513,159517,159520,4,7,0
45536,4,1,159517,159520,159521,3,4,0
45537,3,2,159520,159521,159523,1,3,0
45538,6,2,159526,159526,159528,0,2,3
45539,6,2,159532,159532,159534,0,2,4
45540,2,3,159534,159534,159537,0,3,0
45541,3,3,159537,159537,159540,0,3,0
45542,3,1,159540,159540,159541,0,1,0
45543,1,3,159541,159541,159544,0,3,0
45544,5,3,159546,159546,159549,0,3,2
45545,1,3,159547,159549,159552,2,5,0
45546,3,2,159550,159552,159554,2,4,0
45547,4,2,159554,159554,159556,0,2,0
45548,4,1,159558,159558,159559,0,1,2
45549,2,1,159560,159560,159561,0,1,1
45550,5,1,159565,159565,159566,0,1,4
45551,6,1,159571,159571,159572,0,1,5
45552,1,3,159572,159572,159575,0,3,0
45553,2,1,159574,159575,159576,1,2,0
45554,3,2,159577,159577,159579,0,2,1
45555,4,2,159581,159581,159583,0,2,2
45556,2,1,159583,159583,159584,0,1,0
45557,6,1,159589,159589,159590,0,1,5
45558,3,3,159592,159592,159595,0,3,2
45559,1,3,159593,159595,159598,2,5,0
45560,4,2,159597,159598,159600,1,3,0
45561,6,3,159603,159603,159606,0,3,3
45562,6,1,159609,159609,159610,0,1,3
45563,5,2,159614,159614,159616,0,2,4
45564,3,1,159617,159617,159618,0,1,1
45565,4,2,159621,159621,159623,0,2,3
45566,2,1,159623,159623,159624,0,1,0
45567,4,2,159627,159627,159629,0,2,3
45568,4,3,159631,159631,159634,0,3,2
45569,5,2,159636,159636,159638,0,2,2
45570,5,3,159641,159641,159644,0,3,3
45571,1,2,159642,159644,159646,2,4,0
45572,5,3,159647,159647,159650,0,3,1
45573,4,3,159651,159651,159654,0,3,1
45574,2,3,159653,159654,159657,1,4,0
45575,3,3,159656,159657,159660,1,4,0
45576,4,1,159660,159660,159661,0,1,0
45577,2,2,159662,159662,159664,0,2,1
45578,2,2,159664,159664,159666,0,2,0
45579,4,3,159668,159668,159671,0,3,2
45580,6,1,159674,159674,159675,0,1,3
45581,6,2,159680,159680,159682,0,2,5
45582,2,2,159682,159682,159684,0,2,0
45583,4,3,159686,159686,159689,0,3,2
45584,5,3,159691,159691,159694,0,3,2
45585,2,2,159693,159694,159696,1,3,0
45586,2,1,159695,159696,159697,1,2,0
45587,6,2,159701,159701,159703,0,2,4
45588,2,2,159703,159703,159705,0,2,0
45589,6,1,159709,159709,159710,0,1,4
45590,1,2,159710,159710,159712,0,2,0
45591,4,1,159714,159714,159715,0,1,2
45592,5,3,159719,159719,159722,0,3,4
45593,5,3,159724,159724,159727,0,3,2
45594,3,1,159727,159727,159728,0,1,0
45595,5,2,159732,159732,159734,0,2,4
45596,1,3,159733,159734,159737,1,4,0
45597,6,1,159739,159739,159740,0,1,2
45598,5,3,159744,159744,159747,0,3,4
45599,2,3,159746,159747,159750,1,4,0
45600,3,3,159749,159750,159753,1,4,0
45601,4,1,159753,159753,159754,0,1,0
45602,4,2,159757,159757,159759,0,2,3
45603,5,1,159762,159762,159763,0,1,3
45604,5,2,159767,159767,159769,0,2,4
45605,5,1,159772,159772,159773,0,1,3
45606,1,1,159773,159773,159774,0,1,0
45607,1,2,159774,159774,159776,0,2,0
45608,6,3,159780,159780,159783,0,3,4
45609,6,1,159786,159786,159787,0,1,3
45610,4,1,159790,159790,159791,0,1,3
45611,1,2,159791,159791,159793,0,2,0
45612,2,2,159793,159793,159795,0,2,0
45613,3,2,159796,159796,159798,0,2,1
45614,5,2,159801,159801,159803,0,2,3
45615,6,2,159807,159807,159809,0,2,4
45616,4,1,159811,159811,159812,0,1,2
45617,6,2,159817,159817,159819,0,2,5
45618,1,2,159818,159819,159821,1,3,0
45619,2,2,159820,159821,159823,1,3,0
45620,4,2,159824,159824,159826,0,2,1
45621,4,2,159828,159828,159830,0,2,2
45622,6,2,159834,159834,159836,0,2,4
45623,6,2,159840,159840,159842,0,2,4
45624,1,3,159841,159842,159845,1,4,0
45625,5,1,159846,159846,159847,0,1,1
45626,4,1,159850,159850,159851,0,1,3
45627,6,2,159856,159856,159858,0,2,5
45628,6,2,159862,159862,159864,0,2,4
45629,6,3,159868,159868,159871,0,3,4
45630,4,1,159872,159872,159873,0,1,1
45631,6,3,159878,159878,159881,0,3,5
45632,6,2,159884,159884,159886,0,2,3
45633,5,2,159889,159889,159891,0,2,3
45634,2,1,159891,159891,159892,0,1,0
45635,5,1,159896,159896,159897,0,1,4
45636,1,1,159897,159897,159898,0,1,0
45637,4,2,159901,159901,159903,0,2,3
45638,2,3,159903,159903,159906,0,3,0
45639,3,2,159906,159906,159908,0,2,0
45640,1,1,159907,159908,159909,1,2,0
45641,3,3,159910,159910,159913,0,3,1
45642,6,2,159916,159916,159918,0,2,3
45643,1,1,159917,159918,159919,1,2,0
45644,1,1,159918,159919,159920,1,2,0
45645,4,1,159922,159922,159923,0,1,2
45646,2,1,159924,159924,159925,0,1,1
45647,3,1,159927,159927,159928,0,1,2
45648,5,3,159932,159932,159935,0,3,4
45649,3,2,159935,159935,159937,0,2,0
45650,6,3,159941,159941,159944,0,3,4
45651,1,1,159942,159944,159945,2,3,0
45652,2,3,159944,159945,159948,1,4,0
45653,3,3,159947,159948,159951,1,4,0
45654,4,2,159951,159951,159953,0,2,0
45655,2,2,159953,159953,159955,0,2,0
45656,6,2,159959,159959,159961,0,2,4
45657,4,2,159963,159963,159965,0,2,2
45658,1,3,159964,159965,159968,1,4,0
45659,1,2,159965,159968,159970,3,5,0
45660,6,3,159971,159971,159974,0,3,1
45661,1,2,159972,159974,159976,2,4,0
45662,6,2,159978,159978,159980,0,2,2
45663,1,2,159979,159980,159982,1,3,0
45664,4,2,159983,159983,159985,0,2,1
45665,5,2,159988,159988,159990,0,2,3
45666,5,1,159993,159993,159994,0,1,3
45667,5,3,159998,159998,160001,0,3,4
45668,1,1,159999,160001,160002,2,3,0
45669,1,1,160000,160002,160003,2,3,0
45670,3,3,160003,160003,160006,0,3,0
45671,4,3,160007,160007,160010,0,3,1
45672,3,3,160010,160010,160013,0,3,0
45673,5,3,160015,160015,160018,0,3,2
45674,5,3,160020,160020,160023,0,3,2
45675,6,3,160026,160026,160029,0,3,3
45676,4,1,160030,160030,160031,0,1,1
45677,4,2,160034,160034,160036,0,2,3
45678,3,2,160037,160037,160039,0,2,1
45679,1,3,160038,160039,160042,1,4,0
45680,3,1,160041,160042,160043,1,2,0
45681,3,1,160044,160044,160045,0,1,1
45682,5,3,160049,160049,160052,0,3,4
45683,3,3,160052,160052,160055,0,3,0
45684,3,3,160055,160055,160058,0,3,0
45685,6,1,160061,160061,160062,0,1,3
45686,3,3,160064,160064,160067,0,3,2
45687,5,1,160069,160069,160070,0,1,2
45688,6,1,160075,160075,160076,0,1,5
45689,1,3,160076,160076,160079,0,3,0
45690,3,3,160079,160079,160082,0,3,0
45691,6,2,160085,160085,160087,0,2,3
45692,4,3,160089,160089,160092,0,3,2
45693,1,1,160090,160092,160093,2,3,0
45694,3,3,160093,160093,160096,0,3,0
45695,6,2,160099,160099,160101,0,2,3
45696,3,1,160102,160102,160103,0,1,1
45697,2,2,160104,160104,160106,0,2,1
45698,4,1,160108,160108,160109,0,1,2
45699,6,1,160114,160114,160115,0,1,5
45700,5,3,160119,160119,160122,0,3,4
45701,1,2,160120,160122,160124,2,4,0
45702,5,1,160125,160125,160126,0,1,1
45703,4,1,160129,160129,160130,0,1,3
45704,5,3,160134,160134,160137,0,3,4
45705,1,1,160135,160137,160138,2,3,0
45706,1,3,160136,160138,160141,2,5,0
45707,2,3,160138,160141,160144,3,6,0
45708,4,2,160142,160144,160146,2,4,0
45709,2,3,160144,160146,160149,2,5,0
45710,5,3,160149,160149,160152,0,3,0
45711,5,2,160154,160154,160156,0,2,2
45712,6,3,160160,160160,160163,0,3,4
45713,4,3,160164,160164,160167,0,3,1
45714,4,2,160168,160168,160170,0,2,1
45715,2,1,160170,160170,160171,0,1,0
45716,3,3,160173,160173,160176,0,3,2
45717,1,1,160174,160176,160177,2,3,0
45718,3,3,160177,160177,160180,0,3,0
45719,6,1,160183,160183,160184,0,1,3
45720,4,1,160187,160187,160188,0,1,3
45721,2,2,160189,160189,160191,0,2,1
45722,5,2,160194,160194,160196,0,2,3
45723,5,1,160199,160199,160200,0,1,3
45724,1,2,160200,160200,160202,0,2,0
45725,5,2,160205,160205,160207,0,2,3
45726,5,1,160210,160210,160211,0,1,3
45727,3,1,160213,160213,160214,0,1,2
45728,5,3,160218,160218,160221,0,3,4
45729,6,2,160224,160224,160226,0,2,3
45730,3,1,160227,160227,160228,0,1,1
45731,2,2,160229,160229,160231,0,2,1
45732,2,1,160231,160231,160232,0,1,0
45733,1,1,160232,160232,160233,0,1,0
45734,2,3,160234,160234,160237,0,3,1
45735,3,3,160237,160237,160240,0,3,0
45736,5,2,160242,160242,160244,0,2,2
45737,5,2,160247,160247,160249,0,2,3
45738,4,1,160251,160251,160252,0,1,2
45739,4,2,160255,160255,160257,0,2,3
45740,5,2,160260,160260,160262,0,2,3
45741,1,2,160261,160262,160264,1,3,0
45742,1,3,160262,160264,160267,2,5,0
45743,1,3,160263,160267,160270,4,7,0
45744,1,2,160264,160270,160272,6,8,0
45745,1,1,160265,160272,160273,7,8,0
45746,5,2,160270,160273,160275,3,5,0
45747,3,2,160273,160275,160277,2,4,0
45748,4,3,160277,160277,160280,0,3,0
45749,4,1,160281,160281,160282,0,1,1
45750,2,3,160283,160283,160286,0,3,1
45751,4,3,160287,160287,160290,0,3,1
45752,2,2,160289,160290,160292,1,3,0
45753,1,1,160290,160292,160293,2,3,0
45754,5,2,160295,160295,160297,0,2,2
45755,1,2,160296,160297,160299,1,3,0
45756,4,3,160300,160300,160303,0,3,1
45757,5,2,160305,160305,160307,0,2,2
45758,5,3,160310,160310,160313,0,3,3
45759,3,2,160313,160313,160315,0,2,0
45760,5,3,160318,160318,160321,0,3,3
45761,4,1,160322,160322,160323,0,1,1
45762,2,3,160324,160324,160327,0,3,1
45763,6,1,160330,160330,160331,0,1,3
45764,4,2,160334,160334,160336,0,2,3
45765,2,2,160336,160336,160338,0,2,0
45766,3,1,160339,160339,160340,0,1,1
45767,4,2,160343,160343,160345,0,2,3
45768,6,3,160349,160349,160352,0,3,4
45769,3,1,160352,160352,160353,0,1,0
45770,2,1,160354,160354,160355,0,1,1
45771,5,1,160359,160359,160360,0,1,4
45772,3,3,160362,160362,160365,0,3,2
45773,3,2,160365,160365,160367,0,2,0
45774,5,2,160370,160370,160372,0,2,3
45775,6,3,160376,160376,160379,0,3,4
45776,4,3,160380,160380,160383,0,3,1
45777,1,1,160381,160383,160384,2,3,0
45778,2,1,160383,160384,160385,1,2,0
45779,3,2,160386,160386,160388,0,2,1
45780,1,2,160387,160388,160390,1,3,0
45781,6,3,160393,160393,160396,0,3,3
45782,1,3,160394,160396,160399,2,5,0
45783,6,2,160400,160400,160402,0,2,1
45784,1,1,160401,160402,160403,1,2,0
45785,5,2,160406,160406,160408,0,2,3
45786,6,2,160412,160412,160414,0,2,4
45787,1,2,160413,160414,160416,1,3,0
45788,4,1,160417,160417,160418,0,1,1
45789,1,1,160418,160418,160419,0,1,0
45790,3,1,160421,160421,160422,0,1,2
45791,4,2,160425,160425,160427,0,2,3
45792,1,1,160426,160427,160428,1,2,0
45793,5,3,160431,160431,160434,0,3,3
45794,2,1,160433,160434,160435,1,2,0
45795,3,1,160436,160436,160437,0,1,1
45796,1,3,160437,160437,160440,0,3,0
45797,2,3,160439,160440,160443,1,4,0
45798,3,2,160442,160443,160445,1,3,0
45799,3,2,160445,160445,160447,0,2,0
45800,2,3,160447,160447,160450,0,3,0
45801,2,3,160449,160450,160453,1,4,0
45802,1,2,160450,160453,160455,3,5,0
45803,4,1,160454,160455,160456,1,2,0
45804,2,3,160456,160456,160459,0,3,0
45805,4,3,160460,160460,160463,0,3,1
45806,4,3,160464,160464,160467,0,3,1
45807,5,3,160469,160469,160472,0,3,2
45808,6,3,160475,160475,160478,0,3,3
45809,3,3,160478,160478,160481,0,3,0
45810,6,2,160484,160484,160486,0,2,3
45811,5,2,160489,160489,160491,0,2,3
45812,6,3,160495,160495,160498,0,3,4
45813,1,1,160496,160498,160499,2,3,0
45814,5,1,160501,160501,160502,0,1,2
45815,1,1,160502,160502,160503,0,1,0
45816,4,2,160506,160506,160508,0,2,3
45817,3,3,160509,160509,160512,0,3,1
45818,6,1,160515,160515,160516,0,1,3
45819,4,2,160519,160519,160521,0,2,3
45820,3,2,160522,160522,160524,0,2,1
45821,6,2,160528,160528,160530,0,2,4
45822,4,3,160532,160532,160535,0,3,2
45823,1,3,160533,160535,160538,2,5,0
45824,6,1,160539,160539,160540,0,1,1
45825,4,1,160543,160543,160544,0,1,3
45826,6,1,160549,160549,160550,0,1,5
45827,4,2,160553,160553,160555,0,2,3
45828,4,1,160557,160557,160558,0,1,2
45829,5,1,160562,160562,160563,0,1,4
45830,5,2,160567,160567,160569,0,2,4
45831,2,1,160569,160569,160570,0,1,0
45832,1,1,160570,160570,160571,0,1,0
45833,4,2,160574,160574,160576,0,2,3
45834,1,3,160575,160576,160579,1,4,0
45835,2,3,160577,160579,160582,2,5,0
45836,4,1,160581,160582,160583,1,2,0
45837,1,1,160582,160583,160584,1,2,0
45838,3,2,160585,160585,160587,0,2,1
45839,1,3,160586,160587,160590,1,4,0
45840,3,3,160589,160590,160593,1,4,0
45841,6,2,160595,160595,160597,0,2,2
45842,1,1,160596,160597,160598,1,2,0
45843,4,3,160600,160600,160603,0,3,2
45844,6,3,160606,160606,160609,0,3,3
45845,5,1,160611,160611,160612,0,1,2
45846,5,1,160616,160616,160617,0,1,4
45847,5,3,160621,160621,160624,0,3,4
45848,6,2,160627,160627,160629,0,2,3
45849,2,3,160629,160629,160632,0,3,0
45850,3,3,160632,160632,160635,0,3,0
45851,1,3,160633,160635,160638,2,5,0
45852,2,1,160635,160638,160639,3,4,0
45853,1,2,160636,160639,160641,3,5,0
45854,3,3,160639,160641,160644,2,5,0
45855,3,1,160642,160644,160645,2,3,0
45856,6,2,160648,160648,160650,0,2,3
45857,3,2,160651,160651,160653,0,2,1
45858,2,3,160653,160653,160656,0,3,0
45859,1,1,160654,160656,160657,2,3,0
45860,4,2,160658,160658,160660,0,2,1
45861,5,2,160663,160663,160665,0,2,3
45862,2,3,160665,160665,160668,0,3,0
45863,6,3,160671,160671,160674,0,3,3
45864,1,1,160672,160674,160675,2,3,0
45865,2,1,160674,160675,160676,1,2,0
45866,4,1,160678,160678,160679,0,1,2
45867,1,3,160679,160679,160682,0,3,0
45868,3,3,160682,160682,160685,0,3,0
45869,4,1,160686,160686,160687,0,1,1
45870,4,1,160690,160690,160691,0,1,3
45871,1,2,160691,160691,160693,0,2,0
45872,5,2,160696,160696,160698,0,2,3
45873,5,1,160701,160701,160702,0,1,3
45874,5,1,160706,160706,160707,0,1,4
45875,5,2,160711,160711,160713,0,2,4
45876,4,1,160715,160715,160716,0,1,2
45877,1,1,160716,160716,160717,0,1,0
45878,3,3,160719,160719,160722,0,3,2
45879,6,2,160725,160725,160727,0,2,3
45880,1,2,160726,160727,160729,1,3,0
45881,2,1,160728,160729,160730,1,2,0
45882,3,3,160731,160731,160734,0,3,1
45883,4,2,160735,160735,160737,0,2,1
45884,2,3,160737,160737,160740,0,3,0
45885,6,1,160743,160743,160744,0,1,3
45886,6,3,160749,160749,160752,0,3,5
45887,1,1,160750,160752,160753,2,3,0
45888,5,1,160755,160755,160756,0,1,2
45889,3,3,160758,160758,160761,0,3,2
45890,3,2,160761,160761,160763,0,2,0
45891,3,3,160764,160764,160767,0,3,1
45892,3,3,160767,160767,160770,0,3,0
45893,6,1,160773,160773,160774,0,1,3
45894,4,2,160777,160777,160779,0,2,3
45895,5,3,160782,160782,160785,0,3,3
45896,2,3,160784,160785,160788,1,4,0
45897,2,3,160786,160788,160791,2,5,0
45898,5,2,160791,160791,160793,0,2,0
45899,4,2,160795,160795,160797,0,2,2
45900,5,3,160800,160800,160803,0,3,3
45901,1,2,160801,160803,160805,2,4,0
45902,1,2,160802,160805,160807,3,5,0
45903,5,3,160807,160807,160810,0,3,0
45904,4,2,160811,160811,160813,0,2,1
45905,4,2,160815,160815,160817,0,2,2
45906,4,2,160819,160819,160821,0,2,2
45907,6,3,160825,160825,160828,0,3,4
45908,2,1,160827,160828,160829,1,2,0
45909,2,1,160829,160829,160830,0,1,0
45910,6,1,160835,160835,160836,0,1,5
45911,4,2,160839,160839,160841,0,2,3
45912,4,2,160843,160843,160845,0,2,2
45913,1,1,160844,160845,160846,1,2,0
45914,3,2,160847,160847,160849,0,2,1
45915,5,2,160852,160852,160854,0,2,3
45916,5,2,160857,160857,160859,0,2,3
45917,4,3,160861,160861,160864,0,3,2
45918,6,3,160867,160867,160870,0,3,3
45919,4,1,160871,160871,160872,0,1,1
45920,3,3,160874,160874,160877,0,3,2
45921,5,2,160879,160879,160881,0,2,2
45922,6,3,160885,160885,160888,0,3,4
45923,6,3,160891,160891,160894,0,3,3
45924,2,3,160893,160894,160897,1,4,0
45925,4,1,160897,160897,160898,0,1,0
45926,2,2,160899,160899,160901,0,2,1
45927,5,1,160904,160904,160905,0,1,3
45928,1,3,160905,160905,160908,0,3,0
45929,6,3,160911,160911,160914,0,3,3
45930,5,1,160916,160916,160917,0,1,2
45931,2,1,160918,160918,160919,0,1,1
45932,5,3,160923,160923,160926,0,3,4
45933,6,2,160929,160929,160931,0,2,3
45934,2,2,160931,160931,160933,0,2,0
45935,2,2,160933,160933,160935,0,2,0
45936,3,1,160936,160936,160937,0,1,1
45937,3,1,160939,160939,160940,0,1,2
45938,4,1,160943,160943,160944,0,1,3
45939,4,2,160947,160947,160949,0,2,3
45940,1,2,160948,160949,160951,1,3,0
45941,6,2,160954,160954,160956,0,2,3
45942,4,2,160958,160958,160960,0,2,2
45943,1,3,160959,160960,160963,1,4,0
45944,3,1,160962,160963,160964,1,2,0
45945,4,2,160966,160966,160968,0,2,2
45946,5,1,160971,160971,160972,0,1,3
45947,6,1,160977,160977,160978,0,1,5
45948,5,3,160982,160982,160985,0,3,4
45949,1,2,160983,160985,160987,2,4,0
45950,4,2,160987,160987,160989,0,2,0
45951,2,1,160989,160989,160990,0,1,0
45952,1,3,160990,160990,160993,0,3,0
45953,2,3,160992,160993,160996,1,4,0
45954,1,2,160993,160996,160998,3,5,0
45955,2,3,160995,160998,161001,3,6,0
45956,5,3,161000,161001,161004,1,4,0
45957,5,2,161005,161005,161007,0,2,1
45958,5,2,161010,161010,161012,0,2,3
45959,6,2,161016,161016,161018,0,2,4
45960,4,1,161020,161020,161021,0,1,2
45961,2,3,161022,161022,161025,0,3,1
45962,1,2,161023,161025,161027,2,4,0
45963,2,3,161025,161027,161030,2,5,0
45964,1,3,161026,161030,161033,4,7,0
45965,2,3,161028,161033,161036,5,8,0
45966,4,2,161032,161036,161038,4,6,0
45967,2,1,161034,161038,161039,4,5,0
45968,5,3,161039,161039,161042,0,3,0
45969,5,3,161044,161044,161047,0,3,2
45970,4,1,161048,161048,161049,0,1,1
45971,1,3,161049,161049,161052,0,3,0
45972,3,1,161052,161052,161053,0,1,0
45973,1,3,161053,161053,161056,0,3,0
45974,2,3,161055,161056,161059,1,4,0
45975,1,2,161056,161059,161061,3,5,0
45976,2,3,161058,161061,161064,3,6,0
45977,3,2,161061,161064,161066,3,5,0
45978,1,2,161062,161066,161068,4,6,0
45979,5,3,161067,161068,161071,1,4,0
45980,1,1,161068,161071,161072,3,4,0
45981,6,1,161074,161074,161075,0,1,2
45982,5,1,161079,161079,161080,0,1,4
45983,2,2,161081,161081,161083,0,2,1
45984,3,1,161084,161084,161085,0,1,1
45985,1,3,161085,161085,161088,0,3,0
45986,1,2,161086,161088,161090,2,4,0
45987,4,3,161090,161090,161093,0,3,0
45988,2,2,161092,161093,161095,1,3,0
45989,5,2,161097,161097,161099,0,2,2
45990,6,1,161103,161103,161104,0,1,4
45991,4,2,161107,161107,161109,0,2,3
45992,6,2,161113,161113,161115,0,2,4
45993,1,1,161114,161115,161116,1,2,0
45994,5,2,161119,161119,161121,0,2,3
45995,1,1,161120,161121,161122,1,2,0
45996,2,1,161122,161122,161123,0,1,0
45997,4,1,161126,161126,161127,0,1,3
45998,5,1,161131,161131,161132,0,1,4
45999,1,3,161132,161132,161135,0,3,0
46000,3,3,161135,161135,161138,0,3,0
46001,6,2,161141,161141,161143,0,2,3
46002,2,1,161143,161143,161144,0,1,0
46003,6,2,161149,161149,161151,0,2,5
46004,5,1,161154,161154,161155,0,1,3
46005,6,2,161160,161160,161162,0,2,5
46006,2,2,161162,161162,161164,0,2,0
46007,3,1,161165,161165,161166,0,1,1
46008,3,1,161168,161168,161169,0,1,2
46009,5,3,161173,161173,161176,0,3,4
46010,2,2,161175,161176,161178,1,3,0
46011,4,2,161179,161179,161181,0,2,1
46012,6,3,161185,161185,161188,0,3,4
46013,3,2,161188,161188,161190,0,2,0
46014,6,1,161194,161194,161195,0,1,4
46015,4,2,161198,161198,161200,0,2,3
46016,5,2,161203,161203,161205,0,2,3
46017,6,2,161209,161209,161211,0,2,4
46018,3,1,161212,161212,161213,0,1,1
46019,2,3,161214,161214,161217,0,3,1
46020,4,3,161218,161218,161221,0,3,1
46021,2,3,161220,161221,161224,1,4,0
46022,2,1,161222,161224,161225,2,3,0
46023,2,2,161224,161225,161227,1,3,0
46024,5,2,161229,161229,161231,0,2,2
46025,1,1,161230,161231,161232,1,2,0
46026,3,3,161233,161233,161236,0,3,1
46027,2,1,161235,161236,161237,1,2,0
46028,2,3,161237,161237,161240,0,3,0
46029,5,1,161242,161242,161243,0,1,2
46030,3,2,161245,161245,161247,0,2,2
46031,3,2,161248,161248,161250,0,2,1
46032,5,2,161253,161253,161255,0,2,3
46033,3,1,161256,161256,161257,0,1,1
46034,1,3,161257,161257,161260,0,3,0
46035,6,2,161263,161263,161265,0,2,3
46036,2,3,161265,161265,161268,0,3,0
46037,6,2,161271,161271,161273,0,2,3
46038,6,2,161277,161277,161279,0,2,4
46039,2,1,161279,161279,161280,0,1,0
46040,1,2,161280,161280,161282,0,2,0
46041,2,1,161282,161282,161283,0,1,0
46042,4,2,161286,161286,161288,0,2,3
46043,2,2,161288,161288,161290,0,2,0
46044,4,2,161292,161292,161294,0,2,2
46045,6,2,161298,161298,161300,0,2,4
46046,3,1,161301,161301,161302,0,1,1
46047,6,1,161307,161307,161308,0,1,5
46048,6,2,161313,161313,161315,0,2,5
46049,3,2,161316,161316,161318,0,2,1
46050,6,2,161322,161322,161324,0,2,4
46051,5,2,161327,161327,161329,0,2,3
46052,5,3,161332,161332,161335,0,3,3
46053,2,1,161334,161335,161336,1,2,0
46054,6,1,161340,161340,161341,0,1,4
46055,1,3,161341,161341,161344,0,3,0
46056,3,1,161344,161344,161345,0,1,0
46057,4,2,161348,161348,161350,0,2,3
46058,6,2,161354,161354,161356,0,2,4
46059,3,3,161357,161357,161360,0,3,1
46060,5,2,161362,161362,161364,0,2,2
46061,6,2,161368,161368,161370,0,2,4
46062,1,3,161369,161370,161373,1,4,0
46063,4,2,161373,161373,161375,0,2,0
46064,5,2,161378,161378,161380,0,2,3
46065,6,2,161384,161384,161386,0,2,4
46066,6,2,161390,161390,161392,0,2,4
46067,3,2,161393,161393,161395,0,2,1
46068,4,3,161397,161397,161400,0,3,2
46069,5,3,161402,161402,161405,0,3,2
46070,2,3,161404,161405,161408,1,4,0
46071,3,3,161407,161408,161411,1,4,0
46072,5,2,161412,161412,161414,0,2,1
46073,1,3,161413,161414,161417,1,4,0
46074,4,3,161417,161417,161420,0,3,0
46075,5,2,161422,161422,161424,0,2,2
46076,5,2,161427,161427,161429,0,2,3
46077,1,3,161428,161429,161432,1,4,0
46078,2,2,161430,161432,161434,2,4,0
46079,3,3,161433,161434,161437,1,4,0
46080,1,1,161434,161437,161438,3,4,0
46081,2,3,161436,161438,161441,2,5,0
46082,4,3,161440,161441,161444,1,4,0
46083,4,1,161444,161444,161445,0,1,0
46084,4,1,161448,161448,161449,0,1,3
46085,1,3,161449,161449,161452,0,3,0
46086,6,1,161455,161455,161456,0,1,3
46087,1,2,161456,161456,161458,0,2,0
46088,1,3,161457,161458,161461,1,4,0
46089,6,2,161463,161463,161465,0,2,2
46090,6,2,161469,161469,161471,0,2,4
46091,5,1,161474,161474,161475,0,1,3
46092,3,3,161477,161477,161480,0,3,2
46093,6,3,161483,161483,161486,0,3,3
46094,2,2,161485,161486,161488,1,3,0
46095,6,2,161491,161491,161493,0,2,3
46096,2,3,161493,161493,161496,0,3,0
46097,1,1,161494,161496,161497,2,3,0
46098,4,1,161498,161498,161499,0,1,1
46099,3,1,161501,161501,161502,0,1,2
46100,3,2,161504,161504,161506,0,2,2
46101,5,2,161509,161509,161511,0,2,3
46102,1,2,161510,161511,161513,1,3,0
46103,2,1,161512,161513,161514,1,2,0
46104,6,3,161518,161518,161521,0,3,4
46105,6,3,161524,161524,161527,0,3,3
46106,3,3,161527,161527,161530,0,3,0
46107,3,1,161530,161530,161531,0,1,0
46108,1,1,161531,161531,161532,0,1,0
46109,6,2,161537,161537,161539,0,2,5
46110,2,1,161539,161539,161540,0,1,0
46111,6,2,161545,161545,161547,0,2,5
46112,4,3,161549,161549,161552,0,3,2
46113,2,1,161551,161552,161553,1,2,0
46114,6,1,161557,161557,161558,0,1,4
46115,1,1,161558,161558,161559,0,1,0
46116,2,2,161560,161560,161562,0,2,1
46117,4,1,161564,161564,161565,0,1,2
46118,1,1,161565,161565,161566,0,1,0
46119,6,3,161571,161571,161574,0,3,5
46120,3,1,161574,161574,161575,0,1,0
46121,5,1,161579,161579,161580,0,1,4
46122,5,3,161584,161584,161587,0,3,4
46123,5,1,161589,161589,161590,0,1,2
46124,5,3,161594,161594,161597,0,3,4
46125,6,1,161600,161600,161601,0,1,3
46126,1,2,161601,161601,161603,0,2,0
46127,4,3,161605,161605,161608,0,3,2
46128,5,3,161610,161610,161613,0,3,2
46129,5,1,161615,161615,161616,0,1,2
46130,1,1,161616,161616,161617,0,1,0
46131,4,2,161620,161620,161622,0,2,3
46132,6,2,161626,161626,161628,0,2,4
46133,2,2,161628,161628,161630,0,2,0
46134,3,3,161631,161631,161634,0,3,1
46135,4,1,161635,161635,161636,0,1,1
46136,1,1,161636,161636,161637,0,1,0
46137,3,3,161639,161639,161642,0,3,2
46138,4,3,161643,161643,161646,0,3,1
46139,1,2,161644,161646,161648,2,4,0
46140,2,1,161646,161648,161649,2,3,0
46141,4,1,161650,161650,161651,0,1,1
46142,4,1,161654,161654,161655,0,1,3
46143,1,2,161655,161655,161657,0,2,0
46144,5,3,161660,161660,161663,0,3,3
46145,6,1,161666,161666,161667,0,1,3
46146,4,2,161670,161670,161672,0,2,3
46147,3,3,161673,161673,161676,0,3,1
46148,3,2,161676,161676,161678,0,2,0
46149,6,2,161682,161682,161684,0,2,4
46150,2,2,161684,161684,161686,0,2,0
46151,3,2,161687,161687,161689,0,2,1
46152,2,1,161689,161689,161690,0,1,0
46153,2,1,161691,161691,161692,0,1,1
46154,1,2,161692,161692,161694,0,2,0
46155,3,2,161695,161695,161697,0,2,1
46156,3,1,161698,161698,161699,0,1,1
46157,3,1,161701,161701,161702,0,1,2
46158,4,2,161705,161705,161707,0,2,3
46159,6,3,161711,161711,161714,0,3,4
46160,3,1,161714,161714,161715,0,1,0
46161,5,1,161719,161719,161720,0,1,4
46162,3,3,161722,161722,161725,0,3,2
46163,6,3,161728,161728,161731,0,3,3
46164,4,1,161732,161732,161733,0,1,1
46165,6,2,161738,161738,161740,0,2,5
46166,3,1,161741,161741,161742,0,1,1
46167,2,1,161743,161743,161744,0,1,1
46168,5,2,161748,161748,161750,0,2,4
46169,3,3,161751,161751,161754,0,3,1
46170,2,1,161753,161754,161755,1,2,0
46171,3,3,161756,161756,161759,0,3,1
46172,4,2,161760,161760,161762,0,2,1
46173,6,2,161766,161766,161768,0,2,4
46174,4,3,161770,161770,161773,0,3,2
46175,1,1,161771,161773,161774,2,3,0
46176,4,2,161775,161775,161777,0,2,1
46177,4,3,161779,161779,161782,0,3,2
46178,2,3,161781,161782,161785,1,4,0
46179,5,1,161786,161786,161787,0,1,1
46180,6,1,161792,161792,161793,0,1,5
46181,6,3,161798,161798,161801,0,3,5
46182,2,1,161800,161801,161802,1,2,0
46183,1,2,161801,161802,161804,1,3,0
46184,5,3,161806,161806,161809,0,3,2
46185,3,3,161809,161809,161812,0,3,0
46186,5,2,161814,161814,161816,0,2,2
46187,4,2,161818,161818,161820,0,2,2
46188,4,1,161822,161822,161823,0,1,2
46189,3,2,161825,161825,161827,0,2,2
46190,2,1,161827,161827,161828,0,1,0
46191,3,2,161830,161830,161832,0,2,2
46192,3,1,161833,161833,161834,0,1,1
46193,3,3,161836,161836,161839,0,3,2
46194,1,1,161837,161839,161840,2,3,0
46195,4,1,161841,161841,161842,0,1,1
46196,6,3,161847,161847,161850,0,3,5
46197,4,1,161851,161851,161852,0,1,1
46198,4,3,161855,161855,161858,0,3,3
46199,4,3,161859,161859,161862,0,3,1
46200,1,2,161860,161862,161864,2,4,0
46201,5,1,161865,161865,161866,0,1,1
46202,4,2,161869,161869,161871,0,2,3
46203,3,1,161872,161872,161873,0,1,1
46204,5,2,161877,161877,161879,0,2,4
46205,1,3,161878,161879,161882,1,4,0
46206,3,1,161881,161882,161883,1,2,0
46207,2,3,161883,161883,161886,0,3,0
46208,2,1,161885,161886,161887,1,2,0
46209,3,3,161888,161888,161891,0,3,1
46210,3,2,161891,161891,161893,0,2,0
46211,1,1,161892,161893,161894,1,2,0
46212,4,3,161896,161896,161899,0,3,2
46213,3,2,161899,161899,161901,0,2,0
46214,2,3,161901,161901,161904,0,3,0
46215,4,2,161905,161905,161907,0,2,1
46216,3,2,161908,161908,161910,0,2,1
46217,1,3,161909,161910,161913,1,4,0
46218,5,2,161914,161914,161916,0,2,1
46219,4,1,161918,161918,161919,0,1,2
46220,1,3,161919,161919,161922,0,3,0
46221,3,1,161922,161922,161923,0,1,0
46222,4,1,161926,161926,161927,0,1,3
46223,1,2,161927,161927,161929,0,2,0
46224,3,2,161930,161930,161932,0,2,1
46225,3,3,161933,161933,161936,0,3,1
46226,1,3,161934,161936,161939,2,5,0
46227,2,1,161936,161939,161940,3,4,0
46228,5,1,161941,161941,161942,0,1,1
46229,6,1,161947,161947,161948,0,1,5
46230,3,1,161950,161950,161951,0,1,2
46231,4,3,161954,161954,161957,0,3,3
46232,4,2,161958,161958,161960,0,2,1
46233,4,1,161962,161962,161963,0,1,2
46234,2,1,161964,161964,161965,0,1,1
46235,6,1,161970,161970,161971,0,1,5
46236,6,1,161976,161976,161977,0,1,5
46237,2,2,161978,161978,161980,0,2,1
46238,1,1,161979,161980,161981,1,2,0
46239,4,1,161983,161983,161984,0,1,2
46240,2,3,161985,161985,161988,0,3,1
46241,3,2,161988,161988,161990,0,2,0
46242,5,2,161993,161993,161995,0,2,3
46243,6,1,161999,161999,162000,0,1,4
46244,6,2,162005,162005,162007,0,2,5
46245,1,3,162006,162007,162010,1,4,0
46246,4,3,162010,162010,162013,0,3,0
46247,2,1,162012,162013,162014,1,2,0
46248,6,2,162018,162018,162020,0,2,4
46249,4,3,162022,162022,162025,0,3,2
46250,3,1,162025,162025,162026,0,1,0
46251,1,1,162026,162026,162027,0,1,0
46252,5,2,162031,162031,162033,0,2,4
46253,4,3,162035,162035,162038,0,3,2
46254,5,1,162040,162040,162041,0,1,2
46255,4,1,162044,162044,162045,0,1,3
46256,6,3,162050,162050,162053,0,3,5
46257,1,2,162051,162053,162055,2,4,0
46258,6,2,162057,162057,162059,0,2,2
46259,5,1,162062,162062,162063,0,1,3
46260,6,3,162068,162068,162071,0,3,5
46261,3,3,162071,162071,162074,0,3,0
46262,4,1,162075,162075,162076,0,1,1
46263,3,1,162078,162078,162079,0,1,2
46264,3,3,162081,162081,162084,0,3,2
46265,4,1,162085,162085,162086,0,1,1
46266,4,1,162089,162089,162090,0,1,3
46267,5,3,162094,162094,162097,0,3,4
46268,2,2,162096,162097,162099,1,3,0
46269,3,1,162099,162099,162100,0,1,0
46270,5,3,162104,162104,162107,0,3,4
46271,1,2,162105,162107,162109,2,4,0
46272,2,3,162107,162109,162112,2,5,0
46273,6,2,162113,162113,162115,0,2,1
46274,3,1,162116,162116,162117,0,1,1
46275,5,3,162121,162121,162124,0,3,4
46276,4,1,162125,162125,162126,0,1,1
46277,6,3,162131,162131,162134,0,3,5
46278,6,3,162137,162137,162140,0,3,3
46279,5,2,162142,162142,162144,0,2,2
46280,3,3,162145,162145,162148,0,3,1
46281,5,1,162150,162150,162151,0,1,2
46282,5,1,162155,162155,162156,0,1,4
46283,4,3,162159,162159,162162,0,3,3
46284,1,1,162160,162162,162163,2,3,0
46285,3,2,162163,162163,162165,0,2,0
46286,6,2,162169,162169,162171,0,2,4
46287,6,3,162175,162175,162178,0,3,4
46288,4,3,162179,162179,162182,0,3,1
46289,2,2,162181,162182,162184,1,3,0
46290,5,3,162186,162186,162189,0,3,2
46291,5,2,162191,162191,162193,0,2,2
46292,4,3,162195,162195,162198,0,3,2
46293,6,2,162201,162201,162203,0,2,3
46294,1,2,162202,162203,162205,1,3,0
46295,3,3,162205,162205,162208,0,3,0
46296,2,2,162207,162208,162210,1,3,0
46297,6,3,162213,162213,162216,0,3,3
46298,2,2,162215,162216,162218,1,3,0
46299,6,1,162221,162221,162222,0,1,3
46300,4,2,162225,162225,162227,0,2,3
46301,3,2,162228,162228,162230,0,2,1
46302,2,2,162230,162230,162232,0,2,0
46303,5,1,162235,162235,162236,0,1,3
46304,2,2,162237,162237,162239,0,2,1
46305,4,3,162241,162241,162244,0,3,2
46306,2,3,162243,162244,162247,1,4,0
46307,5,3,162248,162248,162251,0,3,1
46308,3,3,162251,162251,162254,0,3,0
46309,5,2,162256,162256,162258,0,2,2
46310,4,3,162260,162260,162263,0,3,2
46311,6,1,162266,162266,162267,0,1,3
46312,6,3,162272,162272,162275,0,3,5
46313,1,1,162273,162275,162276,2,3,0
46314,2,2,162275,162276,162278,1,3,0
46315,1,2,162276,162278,162280,2,4,0
46316,4,1,162280,162280,162281,0,1,0
46317,3,1,162283,162283,162284,0,1,2
46318,4,2,162287,162287,162289,0,2,3
46319,6,3,162293,162293,162296,0,3,4
46320,1,2,162294,162296,162298,2,4,0
46321,1,3,162295,162298,162301,3,6,0
46322,5,3,162300,162301,162304,1,4,0
46323,2,1,162302,162304,162305,2,3,0
46324,5,3,162307,162307,162310,0,3,2
46325,1,3,162308,162310,162313,2,5,0
46326,1,3,162309,162313,162316,4,7,0
46327,3,2,162312,162316,162318,4,6,0
46328,1,3,162313,162318,162321,5,8,0
46329,6,3,162319,162321,162324,2,5,0
46330,2,2,162321,162324,162326,3,5,0
46331,4,3,162325,162326,162329,1,4,0
46332,3,2,162328,162329,162331,1,3,0
46333,6,1,162334,162334,162335,0,1,3
46334,3,3,162337,162337,162340,0,3,2
46335,4,1,162341,162341,162342,0,1,1
46336,6,2,162347,162347,162349,0,2,5
46337,1,3,162348,162349,162352,1,4,0
46338,2,3,162350,162352,162355,2,5,0
46339,4,2,162354,162355,162357,1,3,0
46340,2,2,162356,162357,162359,1,3,0
46341,1,3,162357,162359,162362,2,5,0
46342,1,3,162358,162362,162365,4,7,0
46343,2,3,162360,162365,162368,5,8,0
46344,5,3,162365,162368,162371,3,6,0
46345,3,2,162368,162371,162373,3,5,0
46346,3,1,162371,162373,162374,2,3,0
46347,2,2,162373,162374,162376,1,3,0
46348,5,2,162378,162378,162380,0,2,2
46349,2,3,162380,162380,162383,0,3,0
46350,2,3,162382,162383,162386,1,4,0
46351,4,1,162386,162386,162387,0,1,0
46352,1,1,162387,162387,162388,0,1,0
46353,5,1,162392,162392,162393,0,1,4
46354,2,1,162394,162394,162395,0,1,1
46355,4,3,162398,162398,162401,0,3,3
46356,3,2,162401,162401,162403,0,2,0
46357,6,3,162407,162407,162410,0,3,4
46358,4,3,162411,162411,162414,0,3,1
46359,1,3,162412,162414,162417,2,5,0
46360,4,1,162416,162417,162418,1,2,0
46361,2,2,162418,162418,162420,0,2,0
46362,3,1,162421,162421,162422,0,1,1
46363,1,2,162422,162422,162424,0,2,0
46364,1,3,162423,162424,162427,1,4,0
46365,5,1,162428,162428,162429,0,1,1
46366,5,1,162433,162433,162434,0,1,4
46367,1,2,162434,162434,162436,0,2,0
46368,5,3,162439,162439,162442,0,3,3
46369,5,1,162444,162444,162445,0,1,2
46370,3,2,162447,162447,162449,0,2,2
46371,6,3,162453,162453,162456,0,3,4
46372,5,2,162458,162458,162460,0,2,2
46373,1,3,162459,162460,162463,1,4,0
46374,6,1,162465,162465,162466,0,1,2
46375,1,2,162466,162466,162468,0,2,0
46376,4,3,162470,162470,162473,0,3,2
46377,6,3,162476,162476,162479,0,3,3
46378,3,1,162479,162479,162480,0,1,0
46379,2,3,162481,162481,162484,0,3,1
46380,2,2,162483,162484,162486,1,3,0
46381,1,2,162484,162486,162488,2,4,0
46382,6,2,162490,162490,162492,0,2,2
46383,5,2,162495,162495,162497,0,2,3
46384,3,2,162498,162498,162500,0,2,1
46385,2,3,162500,162500,162503,0,3,0
46386,4,2,162504,162504,162506,0,2,1
46387,5,1,162509,162509,162510,0,1,3
46388,5,1,162514,162514,162515,0,1,4
46389,6,3,162520,162520,162523,0,3,5
46390,3,1,162523,162523,162524,0,1,0
46391,6,2,162529,162529,162531,0,2,5
46392,2,1,162531,162531,162532,0,1,0
46393,5,2,162536,162536,162538,0,2,4
46394,6,2,162542,162542,162544,0,2,4
46395,4,3,162546,162546,162549,0,3,2
46396,2,1,162548,162549,162550,1,2,0
46397,2,1,162550,162550,162551,0,1,0
46398,2,1,162552,162552,162553,0,1,1
46399,5,2,162557,162557,162559,0,2,4
46400,3,3,162560,162560,162563,0,3,1
46401,1,3,162561,162563,162566,2,5,0
46402,2,1,162563,162566,162567,3,4,0
46403,6,1,162569,162569,162570,0,1,2
46404,5,1,162574,162574,162575,0,1,4
46405,4,3,162578,162578,162581,0,3,3
46406,3,3,162581,162581,162584,0,3,0
46407,3,1,162584,162584,162585,0,1,0
46408,5,2,162589,162589,162591,0,2,4
46409,6,2,162595,162595,162597,0,2,4
46410,1,1,162596,162597,162598,1,2,0
46411,4,3,162600,162600,162603,0,3,2
46412,4,1,162604,162604,162605,0,1,1
46413,5,2,162609,162609,162611,0,2,4
46414,2,3,162611,162611,162614,0,3,0
46415,2,1,162613,162614,162615,1,2,0
46416,1,1,162614,162615,162616,1,2,0
46417,5,1,162619,162619,162620,0,1,3
46418,3,3,162622,162622,162625,0,3,2
46419,2,1,162624,162625,162626,1,2,0
46420,2,3,162626,162626,162629,0,3,0
46421,3,1,162629,162629,162630,0,1,0
46422,6,1,162635,162635,162636,0,1,5
46423,2,3,162637,162637,162640,0,3,1
46424,1,1,162638,162640,162641,2,3,0
46425,5,3,162643,162643,162646,0,3,2
46426,5,1,162648,162648,162649,0,1,2
46427,6,1,162654,162654,162655,0,1,5
46428,1,1,162655,162655,162656,0,1,0
46429,5,1,162660,162660,162661,0,1,4
46430,4,1,162664,162664,162665,0,1,3
46431,2,3,162666,162666,162669,0,3,1
46432,2,3,162668,162669,162672,1,4,0
46433,2,3,162670,162672,162675,2,5,0
46434,1,3,162671,162675,162678,4,7,0
46435,2,1,162673,162678,162679,5,6,0
46436,6,1,162679,162679,162680,0,1,0
46437,5,1,162684,162684,162685,0,1,4
46438,4,2,162688,162688,162690,0,2,3
46439,1,3,162689,162690,162693,1,4,0
46440,6,3,162695,162695,162698,0,3,2
46441,3,3,162698,162698,162701,0,3,0
46442,4,2,162702,162702,162704,0,2,1
46443,1,3,162703,162704,162707,1,4,0
46444,4,1,162707,162707,162708,0,1,0
46445,1,1,162708,162708,162709,0,1,0
46446,4,2,162712,162712,162714,0,2,3
46447,3,1,162715,162715,162716,0,1,1
46448,1,3,162716,162716,162719,0,3,0
46449,6,3,162722,162722,162725,0,3,3
46450,2,3,162724,162725,162728,1,4,0
46451,2,2,162726,162728,162730,2,4,0
46452,2,1,162728,162730,162731,2,3,0
46453,5,3,162733,162733,162736,0,3,2
46454,6,3,162739,162739,162742,0,3,3
46455,3,2,162742,162742,162744,0,2,0
46456,6,3,162748,162748,162751,0,3,4
46457,6,2,162754,162754,162756,0,2,3
46458,2,2,162756,162756,162758,0,2,0
46459,6,1,162762,162762,162763,0,1,4
46460,1,1,162763,162763,162764,0,1,0
46461,2,2,162765,162765,162767,0,2,1
46462,5,1,162770,162770,162771,0,1,3
46463,5,3,162775,162775,162778,0,3,4
46464,6,1,162781,162781,162782,0,1,3
46465,3,1,162784,162784,162785,0,1,2
46466,2,2,162786,162786,162788,0,2,1
46467,4,1,162790,162790,162791,0,1,2
46468,5,2,162795,162795,162797,0,2,4
46469,2,3,162797,162797,162800,0,3,0
46470,4,1,162801,162801,162802,0,1,1
46471,5,3,162806,162806,162809,0,3,4
46472,3,2,162809,162809,162811,0,2,0
46473,2,2,162811,162811,162813,0,2,0
46474,3,1,162814,162814,162815,0,1,1
46475,4,3,162818,162818,162821,0,3,3
46476,5,2,162823,162823,162825,0,2,2
46477,1,3,162824,162825,162828,1,4,0
46478,1,2,162825,162828,162830,3,5,0
46479,1,1,162826,162830,162831,4,5,0
46480,6,3,162832,162832,162835,0,3,1
46481,5,1,162837,162837,162838,0,1,2
46482,3,3,162840,162840,162843,0,3,2
46483,1,2,162841,162843,162845,2,4,0
46484,6,1,162847,162847,162848,0,1,2
46485,5,1,162852,162852,162853,0,1,4
46486,2,3,162854,162854,162857,0,3,1
46487,6,3,162860,162860,162863,0,3,3
46488,6,2,162866,162866,162868,0,2,3
46489,4,1,162870,162870,162871,0,1,2
46490,2,3,162872,162872,162875,0,3,1
46491,3,2,162875,162875,162877,0,2,0
46492,5,3,162880,162880,162883,0,3,3
46493,6,1,162886,162886,162887,0,1,3
46494,1,1,162887,162887,162888,0,1,0
46495,3,3,162890,162890,162893,0,3,2
46496,4,2,162894,162894,162896,0,2,1
46497,2,1,162896,162896,162897,0,1,0
46498,2,2,162898,162898,162900,0,2,1
46499,1,1,162899,162900,162901,1,2,0
46500,2,2,162901,162901,162903,0,2,0
46501,5,1,162906,162906,162907,0,1,3
46502,3,3,162909,162909,162912,0,3,2
46503,1,2,162910,162912,162914,2,4,0
46504,3,1,162913,162914,162915,1,2,0
46505,6,1,162919,162919,162920,0,1,4
46506,6,1,162925,162925,162926,0,1,5
46507,3,1,162928,162928,162929,0,1,2
46508,3,2,162931,162931,162933,0,2,2
46509,4,1,162935,162935,162936,0,1,2
46510,6,3,162941,162941,162944,0,3,5
46511,2,3,162943,162944,162947,1,4,0
46512,3,1,162946,162947,162948,1,2,0
46513,6,1,162952,162952,162953,0,1,4
46514,1,2,162953,162953,162955,0,2,0
46515,6,2,162959,162959,162961,0,2,4
46516,2,2,162961,162961,162963,0,2,0
46517,1,3,162962,162963,162966,1,4,0
46518,3,2,162965,162966,162968,1,3,0
46519,3,1,162968,162968,162969,0,1,0
46520,2,1,162970,162970,162971,0,1,1
46521,6,3,162976,162976,162979,0,3,5
46522,2,1,162978,162979,162980,1,2,0
46523,1,2,162979,162980,162982,1,3,0
46524,2,2,162981,162982,162984,1,3,0
46525,2,1,162983,162984,162985,1,2,0
46526,2,1,162985,162985,162986,0,1,0
46527,3,3,162988,162988,162991,0,3,2
46528,6,1,162994,162994,162995,0,1,3
46529,6,1,163000,163000,163001,0,1,5
46530,6,2,163006,163006,163008,0,2,5
46531,1,2,163007,163008,163010,1,3,0
46532,4,1,163011,163011,163012,0,1,1
46533,3,2,163014,163014,163016,0,2,2
46534,6,3,163020,163020,163023,0,3,4
46535,6,3,163026,163026,163029,0,3,3
46536,2,3,163028,163029,163032,1,4,0
46537,3,1,163031,163032,163033,1,2,0
46538,4,3,163035,163035,163038,0,3,2
46539,3,1,163038,163038,163039,0,1,0
46540,1,3,163039,163039,163042,0,3,0
46541,1,1,163040,163042,163043,2,3,0
46542,1,1,163041,163043,163044,2,3,0
46543,6,3,163047,163047,163050,0,3,3
46544,1,2,163048,163050,163052,2,4,0
46545,1,1,163049,163052,163053,3,4,0
46546,3,3,163052,163053,163056,1,4,0
46547,4,2,163056,163056,163058,0,2,0
46548,4,3,163060,163060,163063,0,3,2
46549,4,1,163064,163064,163065,0,1,1
46550,1,3,163065,163065,163068,0,3,0
46551,5,2,163070,163070,163072,0,2,2
46552,2,2,163072,163072,163074,0,2,0
46553,4,2,163076,163076,163078,0,2,2
46554,3,1,163079,163079,163080,0,1,1
46555,4,3,163083,163083,163086,0,3,3
46556,3,1,163086,163086,163087,0,1,0
46557,2,1,163088,163088,163089,0,1,1
46558,2,1,163090,163090,163091,0,1,1
46559,5,1,163095,163095,163096,0,1,4
46560,6,2,163101,163101,163103,0,2,5
46561,4,2,163105,163105,163107,0,2,2
46562,4,2,163109,163109,163111,0,2,2
46563,4,2,163113,163113,163115,0,2,2
46564,3,2,163116,163116,163118,0,2,1
46565,3,2,163119,163119,163121,0,2,1
46566,4,1,163123,163123,163124,0,1,2
46567,4,3,163127,163127,163130,0,3,3
46568,4,1,163131,163131,163132,0,1,1
46569,5,3,163136,163136,163139,0,3,4
46570,1,2,163137,163139,163141,2,4,0
46571,5,3,163142,163142,163145,0,3,1
46572,4,1,163146,163146,163147,0,1,1
46573,6,1,163152,163152,163153,0,1,5
46574,1,3,163153,163153,163156,0,3,0
46575,3,1,163156,163156,163157,0,1,0
46576,1,2,163157,163157,163159,0,2,0
46577,1,3,163158,163159,163162,1,4,0
46578,2,3,163160,163162,163165,2,5,0
46579,5,1,163165,163165,163166,0,1,0
46580,1,1,163166,163166,163167,0,1,0
46581,5,1,163171,163171,163172,0,1,4
46582,6,2,163177,163177,163179,0,2,5
46583,2,1,163179,163179,163180,0,1,0
46584,4,3,163183,163183,163186,0,3,3
46585,4,2,163187,163187,163189,0,2,1
46586,6,3,163193,163193,163196,0,3,4
46587,5,1,163198,163198,163199,0,1,2
46588,6,3,163204,163204,163207,0,3,5
46589,4,1,163208,163208,163209,0,1,1
46590,5,2,163213,163213,163215,0,2,4
46591,1,1,163214,163215,163216,1,2,0
46592,3,2,163217,163217,163219,0,2,1
46593,3,2,163220,163220,163222,0,2,1
46594,1,2,163221,163222,163224,1,3,0
46595,4,2,163225,163225,163227,0,2,1
46596,3,3,163228,163228,163231,0,3,1
46597,6,2,163234,163234,163236,0,2,3
46598,6,2,163240,163240,163242,0,2,4
46599,4,1,163244,163244,163245,0,1,2
46600,6,2,163250,163250,163252,0,2,5
46601,1,2,163251,163252,163254,1,3,0
46602,1,1,163252,163254,163255,2,3,0
46603,2,1,163254,163255,163256,1,2,0
46604,3,1,163257,163257,163258,0,1,1
46605,5,2,163262,163262,163264,0,2,4
46606,3,2,163265,163265,163267,0,2,1
46607,5,1,163270,163270,163271,0,1,3
46608,3,3,163273,163273,163276,0,3,2
46609,2,1,163275,163276,163277,1,2,0
46610,2,3,163277,163277,163280,0,3,0
46611,5,3,163282,163282,163285,0,3,2
46612,4,1,163286,163286,163287,0,1,1
46613,1,1,163287,163287,163288,0,1,0
46614,4,1,163291,163291,163292,0,1,3
46615,6,1,163297,163297,163298,0,1,5
46616,4,3,163301,163301,163304,0,3,3
46617,4,2,163305,163305,163307,0,2,1
46618,4,2,163309,163309,163311,0,2,2
46619,6,2,163315,163315,163317,0,2,4
46620,5,1,163320,163320,163321,0,1,3
46621,4,1,163324,163324,163325,0,1,3
46622,1,1,163325,163325,163326,0,1,0
46623,6,1,163331,163331,163332,0,1,5
46624,6,1,163337,163337,163338,0,1,5
46625,4,1,163341,163341,163342,0,1,3
46626,3,3,163344,163344,163347,0,3,2
46627,5,1,163349,163349,163350,0,1,2
46628,5,1,163354,163354,163355,0,1,4
46629,2,2,163356,163356,163358,0,2,1
46630,5,2,163361,163361,163363,0,2,3
46631,2,3,163363,163363,163366,0,3,0
46632,2,1,163365,163366,163367,1,2,0
46633,1,1,163366,163367,163368,1,2,0
46634,2,2,163368,163368,163370,0,2,0
46635,2,1,163370,163370,163371,0,1,0
46636,2,3,163372,163372,163375,0,3,1
46637,5,1,163377,163377,163378,0,1,2
46638,5,3,163382,163382,163385,0,3,4
46639,2,2,163384,163385,163387,1,3,0
46640,6,1,163390,163390,163391,0,1,3
46641,2,2,163392,163392,163394,0,2,1
46642,2,3,163394,163394,163397,0,3,0
46643,3,1,163397,163397,163398,0,1,0
46644,1,2,163398,163398,163400,0,2,0
46645,1,3,163399,163400,163403,1,4,0
46646,1,1,163400,163403,163404,3,4,0
46647,1,1,163401,163404,163405,3,4,0
46648,6,2,163407,163407,163409,0,2,2
46649,5,3,163412,163412,163415,0,3,3
46650,3,3,163415,163415,163418,0,3,0
46651,1,1,163416,163418,163419,2,3,0
46652,6,3,163422,163422,163425,0,3,3
46653,1,3,163423,163425,163428,2,5,0
46654,6,2,163429,163429,163431,0,2,1
46655,6,1,163435,163435,163436,0,1,4
46656,5,3,163440,163440,163443,0,3,4
46657,4,2,163444,163444,163446,0,2,1
46658,5,1,163449,163449,163450,0,1,3
46659,2,2,163451,163451,163453,0,2,1
46660,4,1,163455,163455,163456,0,1,2
46661,4,2,163459,163459,163461,0,2,3
46662,5,3,163464,163464,163467,0,3,3
46663,4,3,163468,163468,163471,0,3,1
46664,4,3,163472,163472,163475,0,3,1
46665,1,2,163473,163475,163477,2,4,0
46666,2,3,163475,163477,163480,2,5,0
46667,3,3,163478,163480,163483,2,5,0
46668,5,3,163483,163483,163486,0,3,0
46669,4,3,163487,163487,163490,0,3,1
46670,5,2,163492,163492,163494,0,2,2
46671,1,1,163493,163494,163495,1,2,0
46672,6,2,163499,163499,163501,0,2,4
46673,2,3,163501,163501,163504,0,3,0
46674,5,1,163506,163506,163507,0,1,2
46675,2,3,163508,163508,163511,0,3,1
46676,6,3,163514,163514,163517,0,3,3
46677,4,2,163518,163518,163520,0,2,1
46678,5,3,163523,163523,163526,0,3,3
46679,3,3,163526,163526,163529,0,3,0
46680,3,2,163529,163529,163531,0,2,0
46681,2,1,163531,163531,163532,0,1,0
46682,2,1,163533,163533,163534,0,1,1
46683,1,3,163534,163534,163537,0,3,0
46684,3,2,163537,163537,163539,0,2,0
46685,2,2,163539,163539,163541,0,2,0
46686,3,2,163542,163542,163544,0,2,1
46687,2,3,163544,163544,163547,0,3,0
46688,3,2,163547,163547,163549,0,2,0
46689,2,1,163549,163549,163550,0,1,0
46690,3,2,163552,163552,163554,0,2,2
46691,2,2,163554,163554,163556,0,2,0
46692,4,2,163558,163558,163560,0,2,2
46693,1,1,163559,163560,163561,1,2,0
46694,5,3,163564,163564,163567,0,3,3
46695,2,2,163566,163567,163569,1,3,0
46696,6,1,163572,163572,163573,0,1,3
46697,6,3,163578,163578,163581,0,3,5
46698,4,3,163582,163582,163585,0,3,1
46699,3,3,163585,163585,163588,0,3,0
46700,5,2,163590,163590,163592,0,2,2
46701,1,3,163591,163592,163595,1,4,0
46702,5,1,163596,163596,163597,0,1,1
46703,6,1,163602,163602,163603,0,1,5
46704,4,3,163606,163606,163609,0,3,3
46705,1,1,163607,163609,163610,2,3,0
46706,5,2,163612,163612,163614,0,2,2
46707,4,2,163616,163616,163618,0,2,2
46708,4,1,163620,163620,163621,0,1,2
46709,6,2,163626,163626,163628,0,2,5
46710,2,2,163628,163628,163630,0,2,0
46711,5,1,163633,163633,163634,0,1,3
46712,1,3,163634,163634,163637,0,3,0
46713,6,2,163640,163640,163642,0,2,3
46714,6,1,163646,163646,163647,0,1,4
46715,5,2,163651,163651,163653,0,2,4
46716,6,3,163657,163657,163660,0,3,4
46717,1,1,163658,163660,163661,2,3,0
46718,6,1,163664,163664,163665,0,1,3
46719,4,3,163668,163668,163671,0,3,3
46720,5,3,163673,163673,163676,0,3,2
46721,5,2,163678,163678,163680,0,2,2
46722,5,3,163683,163683,163686,0,3,3
46723,4,1,163687,163687,163688,0,1,1
46724,5,3,163692,163692,163695,0,3,4
46725,3,1,163695,163695,163696,0,1,0
46726,4,1,163699,163699,163700,0,1,3
46727,1,2,163700,163700,163702,0,2,0
46728,4,2,163704,163704,163706,0,2,2
46729,4,3,163708,163708,163711,0,3,2
46730,6,2,163714,163714,163716,0,2,3
46731,2,1,163716,163716,163717,0,1,0
46732,3,3,163719,163719,163722,0,3,2
46733,1,2,163720,163722,163724,2,4,0
46734,3,1,163723,163724,163725,1,2,0
46735,4,2,163727,163727,163729,0,2,2
46736,2,1,163729,163729,163730,0,1,0
46737,5,2,163734,163734,163736,0,2,4
46738,2,2,163736,163736,163738,0,2,0
46739,2,3,163738,163738,163741,0,3,0
46740,3,3,163741,163741,163744,0,3,0
46741,1,2,163742,163744,163746,2,4,0
46742,4,3,163746,163746,163749,0,3,0
46743,3,1,163749,163749,163750,0,1,0
46744,4,2,163753,163753,163755,0,2,3
46745,5,1,163758,163758,163759,0,1,3
46746,5,2,163763,163763,163765,0,2,4
46747,5,1,163768,163768,163769,0,1,3
46748,3,3,163771,163771,163774,0,3,2
46749,5,3,163776,163776,163779,0,3,2
46750,1,2,163777,163779,163781,2,4,0
46751,4,1,163781,163781,163782,0,1,0
46752,1,3,163782,163782,163785,0,3,0
46753,5,1,163787,163787,163788,0,1,2
46754,4,1,163791,163791,163792,0,1,3
46755,4,3,163795,163795,163798,0,3,3
46756,4,2,163799,163799,163801,0,2,1
46757,5,3,163804,163804,163807,0,3,3
46758,6,3,163810,163810,163813,0,3,3
46759,5,2,163815,163815,163817,0,2,2
46760,5,2,163820,163820,163822,0,2,3
46761,3,1,163823,163823,163824,0,1,1
46762,4,3,163827,163827,163830,0,3,3
46763,4,2,163831,163831,163833,0,2,1
46764,4,2,163835,163835,163837,0,2,2
46765,4,1,163839,163839,163840,0,1,2
46766,3,2,163842,163842,163844,0,2,2
46767,4,3,163846,163846,163849,0,3,2
46768,3,3,163849,163849,163852,0,3,0
46769,1,2,163850,163852,163854,2,4,0
46770,6,3,163856,163856,163859,0,3,2
46771,5,1,163861,163861,163862,0,1,2
46772,6,3,163867,163867,163870,0,3,5
46773,4,2,163871,163871,163873,0,2,1
46774,3,3,163874,163874,163877,0,3,1
46775,2,1,163876,163877,163878,1,2,0
46776,6,3,163882,163882,163885,0,3,4
46777,3,3,163885,163885,163888,0,3,0
46778,6,3,163891,163891,163894,0,3,3
46779,4,1,163895,163895,163896,0,1,1
46780,1,2,163896,163896,163898,0,2,0
46781,5,1,163901,163901,163902,0,1,3
46782,4,1,163905,163905,163906,0,1,3
46783,6,1,163911,163911,163912,0,1,5
46784,4,3,163915,163915,163918,0,3,3
46785,1,2,163916,163918,163920,2,4,0
46786,3,3,163919,163920,163923,1,4,0
46787,4,2,163923,163923,163925,0,2,0
46788,6,1,163929,163929,163930,0,1,4
46789,1,3,163930,163930,163933,0,3,0
46790,1,1,163931,163933,163934,2,3,0
46791,6,1,163937,163937,163938,0,1,3
46792,6,3,163943,163943,163946,0,3,5
46793,5,1,163948,163948,163949,0,1,2
46794,1,3,163949,163949,163952,0,3,0
46795,4,1,163953,163953,163954,0,1,1
46796,4,1,163957,163957,163958,0,1,3
46797,3,1,163960,163960,163961,0,1,2
46798,3,2,163963,163963,163965,0,2,2
46799,1,2,163964,163965,163967,1,3,0
46800,2,3,163966,163967,163970,1,4,0
46801,1,2,163967,163970,163972,3,5,0
46802,3,1,163970,163972,163973,2,3,0
46803,4,1,163974,163974,163975,0,1,1
46804,5,2,163979,163979,163981,0,2,4
46805,3,2,163982,163982,163984,0,2,1
46806,3,2,163985,163985,163987,0,2,1
46807,1,2,163986,163987,163989,1,3,0
46808,2,2,163988,163989,163991,1,3,0
46809,2,3,163990,163991,163994,1,4,0
46810,1,2,163991,163994,163996,3,5,0
46811,2,1,163993,163996,163997,3,4,0
46812,2,3,163995,163997,164000,2,5,0
46813,3,3,163998,164000,164003,2,5,0
46814,3,3,164001,164003,164006,2,5,0
46815,3,3,164004,164006,164009,2,5,0
46816,6,1,164010,164010,164011,0,1,1
46817,6,2,164016,164016,164018,0,2,5
46818,4,2,164020,164020,164022,0,2,2
46819,3,3,164023,164023,164026,0,3,1
46820,4,2,164027,164027,164029,0,2,1
46821,1,3,164028,164029,164032,1,4,0
46822,2,3,164030,164032,164035,2,5,0
46823,2,2,164032,164035,164037,3,5,0
46824,2,2,164034,164037,164039,3,5,0
46825,4,3,164038,164039,164042,1,4,0
46826,3,1,164041,164042,164043,1,2,0
46827,5,2,164046,164046,164048,0,2,3
46828,3,3,164049,164049,164052,0,3,1
46829,4,1,164053,164053,164054,0,1,1
46830,1,2,164054,164054,164056,0,2,0
46831,1,2,164055,164056,164058,1,3,0
46832,3,2,164058,164058,164060,0,2,0
46833,4,2,164062,164062,164064,0,2,2
46834,2,2,164064,164064,164066,0,2,0
46835,2,2,164066,164066,164068,0,2,0
46836,4,1,164070,164070,164071,0,1,2
46837,5,2,164075,164075,164077,0,2,4
46838,3,1,164078,164078,164079,0,1,1
46839,1,1,164079,164079,164080,0,1,0
46840,5,2,164084,164084,164086,0,2,4
46841,6,2,164090,164090,164092,0,2,4
46842,4,3,164094,164094,164097,0,3,2
46843,6,2,164100,164100,164102,0,2,3
46844,6,2,164106,164106,164108,0,2,4
46845,5,2,164111,164111,164113,0,2,3
46846,1,3,164112,164113,164116,1,4,0
46847,5,2,164117,164117,164119,0,2,1
46848,4,1,164121,164121,164122,0,1,2
46849,2,2,164123,164123,164125,0,2,1
46850,6,2,164129,164129,164131,0,2,4
46851,4,2,164133,164133,164135,0,2,2
46852,5,1,164138,164138,164139,0,1,3
46853,4,2,164142,164142,164144,0,2,3
46854,5,2,164147,164147,164149,0,2,3
46855,4,1,164151,164151,164152,0,1,2
46856,1,2,164152,164152,164154,0,2,0
46857,3,1,164155,164155,164156,0,1,1
46858,3,1,164158,164158,164159,0,1,2
46859,4,2,164162,164162,164164,0,2,3
46860,1,3,164163,164164,164167,1,4,0
46861,2,1,164165,164167,164168,2,3,0
46862,3,3,164168,164168,164171,0,3,0
46863,6,2,164174,164174,164176,0,2,3
46864,1,3,164175,164176,164179,1,4,0
46865,3,1,164178,164179,164180,1,2,0
46866,1,3,164179,164180,164183,1,4,0
46867,3,2,164182,164183,164185,1,3,0
46868,5,2,164187,164187,164189,0,2,2
46869,5,3,164192,164192,164195,0,3,3
46870,3,2,164195,164195,164197,0,2,0
46871,5,3,164200,164200,164203,0,3,3
46872,3,3,164203,164203,164206,0,3,0
46873,5,3,164208,164208,164211,0,3,2
46874,4,1,164212,164212,164213,0,1,1
46875,2,2,164214,164214,164216,0,2,1
46876,6,1,164220,164220,164221,0,1,4
46877,1,1,164221,164221,164222,0,1,0
46878,1,2,164222,164222,164224,0,2,0
46879,3,1,164225,164225,164226,0,1,1
46880,3,1,164228,164228,164229,0,1,2
46881,6,1,164234,164234,164235,0,1,5
46882,3,2,164237,164237,164239,0,2,2
46883,6,2,164243,164243,164245,0,2,4
46884,4,3,164247,164247,164250,0,3,2
46885,5,1,164252,164252,164253,0,1,2
46886,6,2,164258,164258,164260,0,2,5
46887,6,3,164264,164264,164267,0,3,4
46888,3,1,164267,164267,164268,0,1,0
46889,6,3,164273,164273,164276,0,3,5
46890,1,1,164274,164276,164277,2,3,0
46891,6,3,164280,164280,164283,0,3,3
46892,1,1,164281,164283,164284,2,3,0
46893,5,1,164286,164286,164287,0,1,2
46894,4,3,164290,164290,164293,0,3,3
46895,3,2,164293,164293,164295,0,2,0
46896,5,1,164298,164298,164299,0,1,3
46897,6,1,164304,164304,164305,0,1,5
46898,4,3,164308,164308,164311,0,3,3
46899,2,2,164310,164311,164313,1,3,0
46900,6,2,164316,164316,164318,0,2,3
46901,3,1,164319,164319,164320,0,1,1
46902,4,2,164323,164323,164325,0,2,3
46903,3,2,164326,164326,164328,0,2,1
46904,1,3,164327,164328,164331,1,4,0
46905,1,3,164328,164331,164334,3,6,0
46906,1,2,164329,164334,164336,5,7,0
46907,3,1,164332,164336,164337,4,5,0
46908,3,1,164335,164337,164338,2,3,0
46909,4,2,164339,164339,164341,0,2,1
46910,4,3,164343,164343,164346,0,3,2
46911,6,1,164349,164349,164350,0,1,3
46912,5,3,164354,164354,164357,0,3,4
46913,2,2,164356,164357,164359,1,3,0
46914,1,1,164357,164359,164360,2,3,0
46915,4,1,164361,164361,164362,0,1,1
46916,2,2,164363,164363,164365,0,2,1
46917,3,3,164366,164366,164369,0,3,1
46918,2,1,164368,164369,164370,1,2,0
46919,2,1,164370,164370,164371,0,1,0
46920,2,2,164372,164372,164374,0,2,1
46921,1,3,164373,164374,164377,1,4,0
46922,1,2,164374,164377,164379,3,5,0
46923,2,3,164376,164379,164382,3,6,0
46924,6,2,164382,164382,164384,0,2,0
46925,3,3,164385,164385,164388,0,3,1
46926,1,3,164386,164388,164391,2,5,0
46927,6,2,164392,164392,164394,0,2,1
46928,6,3,164398,164398,164401,0,3,4
46929,6,2,164404,164404,164406,0,2,3
46930,6,1,164410,164410,164411,0,1,4
46931,4,2,164414,164414,164416,0,2,3
46932,3,1,164417,164417,164418,0,1,1
46933,2,1,164419,164419,164420,0,1,1
46934,2,2,164421,164421,164423,0,2,1
46935,3,2,164424,164424,164426,0,2,1
46936,5,3,164429,164429,164432,0,3,3
46937,2,1,164431,164432,164433,1,2,0
46938,1,1,164432,164433,164434,1,2,0
46939,3,3,164435,164435,164438,0,3,1
46940,3,3,164438,164438,164441,0,3,0
46941,6,1,164444,164444,164445,0,1,3
46942,6,1,164450,164450,164451,0,1,5
46943,1,1,164451,164451,164452,0,1,0
46944,5,2,164456,164456,164458,0,2,4
46945,1,3,164457,164458,164461,1,4,0
46946,6,1,164463,164463,164464,0,1,2
46947,3,2,164466,164466,164468,0,2,2
46948,2,1,164468,164468,164469,0,1,0
46949,6,1,164474,164474,164475,0,1,5
46950,3,2,164477,164477,164479,0,2,2
46951,6,3,164483,164483,164486,0,3,4
46952,3,1,164486,164486,164487,0,1,0
46953,5,3,164491,164491,164494,0,3,4
46954,4,1,164495,164495,164496,0,1,1
46955,1,1,164496,164496,164497,0,1,0
46956,5,3,164501,164501,164504,0,3,4
46957,3,1,164504,164504,164505,0,1,0
46958,5,2,164509,164509,164511,0,2,4
46959,5,2,164514,164514,164516,0,2,3
46960,2,2,164516,164516,164518,0,2,0
46961,3,1,164519,164519,164520,0,1,1
46962,5,1,164524,164524,164525,0,1,4
46963,5,2,164529,164529,164531,0,2,4
46964,2,3,164531,164531,164534,0,3,0
46965,5,3,164536,164536,164539,0,3,2
46966,3,1,164539,164539,164540,0,1,0
46967,5,2,164544,164544,164546,0,2,4
46968,2,2,164546,164546,164548,0,2,0
46969,4,2,164550,164550,164552,0,2,2
46970,5,1,164555,164555,164556,0,1,3
46971,1,3,164556,164556,164559,0,3,0
46972,1,1,164557,164559,164560,2,3,0
46973,5,3,164562,164562,164565,0,3,2
46974,1,3,164563,164565,164568,2,5,0
46975,1,1,164564,164568,164569,4,5,0
46976,1,3,164565,164569,164572,4,7,0
46977,1,3,164566,164572,164575,6,9,0
46978,4,1,164570,164575,164576,5,6,0
46979,3,2,164573,164576,164578,3,5,0
46980,4,1,164577,164578,164579,1,2,0
46981,5,3,164582,164582,164585,0,3,3
46982,5,3,164587,164587,164590,0,3,2
46983,2,3,164589,164590,164593,1,4,0
46984,6,2,164595,164595,164597,0,2,2
46985,1,3,164596,164597,164600,1,4,0
46986,3,2,164599,164600,164602,1,3,0
46987,6,3,164605,164605,164608,0,3,3
46988,3,3,164608,164608,164611,0,3,0
46989,2,1,164610,164611,164612,1,2,0
46990,3,1,164613,164613,164614,0,1,1
46991,1,1,164614,164614,164615,0,1,0
46992,4,3,164618,164618,164621,0,3,3
46993,6,1,164624,164624,164625,0,1,3
46994,5,3,164629,164629,164632,0,3,4
46995,2,2,164631,164632,164634,1,3,0
46996,6,1,164637,164637,164638,0,1,3
46997,1,1,164638,164638,164639,0,1,0
46998,2,3,164640,164640,164643,0,3,1
46999,1,1,164641,164643,164644,2,3,0
47000,1,2,164642,164644,164646,2,4,0
47001,5,1,164647,164647,164648,0,1,1
47002,2,2,164649,164649,164651,0,2,1
47003,2,2,164651,164651,164653,0,2,0
47004,6,1,164657,164657,164658,0,1,4
47005,6,2,164663,164663,164665,0,2,5
47006,1,2,164664,164665,164667,1,3,0
47007,2,3,164666,164667,164670,1,4,0
47008,5,1,164671,164671,164672,0,1,1
47009,4,1,164675,164675,164676,0,1,3
47010,5,2,164680,164680,164682,0,2,4
47011,1,3,164681,164682,164685,1,4,0
47012,6,2,164687,164687,164689,0,2,2
47013,2,3,164689,164689,164692,0,3,0
47014,4,1,164693,164693,164694,0,1,1
47015,4,1,164697,164697,164698,0,1,3
47016,6,1,164703,164703,164704,0,1,5
47017,4,2,164707,164707,164709,0,2,3
47018,4,2,164711,164711,164713,0,2,2
47019,2,2,164713,164713,164715,0,2,0
47020,6,3,164719,164719,164722,0,3,4
47021,2,3,164721,164722,164725,1,4,0
47022,2,3,164723,164725,164728,2,5,0
47023,6,1,164729,164729,164730,0,1,1
47024,5,3,164734,164734,164737,0,3,4
47025,4,3,164738,164738,164741,0,3,1
47026,5,2,164743,164743,164745,0,2,2
47027,5,3,164748,164748,164751,0,3,3
47028,2,2,164750,164751,164753,1,3,0
47029,2,1,164752,164753,164754,1,2,0
47030,6,1,164758,164758,164759,0,1,4
47031,6,2,164764,164764,164766,0,2,5
47032,4,2,164768,164768,164770,0,2,2
47033,3,3,164771,164771,164774,0,3,1
47034,6,3,164777,164777,164780,0,3,3
47035,2,1,164779,164780,164781,1,2,0
47036,5,2,164784,164784,164786,0,2,3
47037,2,3,164786,164786,164789,0,3,0
47038,6,3,164792,164792,164795,0,3,3
47039,1,2,164793,164795,164797,2,4,0
47040,5,2,164798,164798,164800,0,2,1
47041,3,2,164801,164801,164803,0,2,1
47042,6,3,164807,164807,164810,0,3,4
47043,6,2,164813,164813,164815,0,2,3
47044,6,1,164819,164819,164820,0,1,4
47045,1,2,164820,164820,164822,0,2,0
47046,4,2,164824,164824,164826,0,2,2
47047,4,1,164828,164828,164829,0,1,2
47048,4,1,164832,164832,164833,0,1,3
47049,2,3,164834,164834,164837,0,3,1
47050,1,1,164835,164837,164838,2,3,0
47051,2,1,164837,164838,164839,1,2,0
47052,6,2,164843,164843,164845,0,2,4
47053,1,3,164844,164845,164848,1,4,0
47054,6,3,164850,164850,164853,0,3,2
47055,4,2,164854,164854,164856,0,2,1
47056,6,3,164860,164860,164863,0,3,4
47057,1,1,164861,164863,164864,2,3,0
47058,3,3,164864,164864,164867,0,3,0
47059,1,1,164865,164867,164868,2,3,0
47060,5,2,164870,164870,164872,0,2,2
47061,4,1,164874,164874,164875,0,1,2
47062,6,2,164880,164880,164882,0,2,5
47063,4,2,164884,164884,164886,0,2,2
47064,4,1,164888,164888,164889,0,1,2
47065,5,2,164893,164893,164895,0,2,4
47066,3,2,164896,164896,164898,0,2,1
47067,3,3,164899,164899,164902,0,3,1
47068,1,2,164900,164902,164904,2,4,0
47069,1,3,164901,164904,164907,3,6,0
47070,3,3,164904,164907,164910,3,6,0
47071,1,3,164905,164910,164913,5,8,0
47072,5,3,164910,164913,164916,3,6,0
47073,1,2,164911,164916,164918,5,7,0
47074,3,2,164914,164918,164920,4,6,0
47075,4,3,164918,164920,164923,2,5,0
47076,2,1,164920,164923,164924,3,4,0
47077,2,2,164922,164924,164926,2,4,0
47078,4,3,164926,164926,164929,0,3,0
47079,6,3,164932,164932,164935,0,3,3
47080,5,2,164937,164937,164939,0,2,2
47081,3,3,164940,164940,164943,0,3,1
47082,1,3,164941,164943,164946,2,5,0
47083,2,2,164943,164946,164948,3,5,0
47084,5,2,164948,164948,164950,0,2,0
47085,4,3,164952,164952,164955,0,3,2
47086,2,1,164954,164955,164956,1,2,0
47087,4,1,164958,164958,164959,0,1,2
47088,6,1,164964,164964,164965,0,1,5
47089,2,2,164966,164966,164968,0,2,1
47090,6,3,164972,164972,164975,0,3,4
47091,5,2,164977,164977,164979,0,2,2
47092,1,2,164978,164979,164981,1,3,0
47093,5,3,164983,164983,164986,0,3,2
47094,6,3,164989,164989,164992,0,3,3
47095,3,1,164992,164992,164993,0,1,0
47096,4,3,164996,164996,164999,0,3,3
47097,1,3,164997,164999,165002,2,5,0
47098,6,3,165003,165003,165006,0,3,1
47099,3,1,165006,165006,165007,0,1,0
47100,1,2,165007,165007,165009,0,2,0
47101,1,2,165008,165009,165011,1,3,0
47102,4,3,165012,165012,165015,0,3,1
47103,2,3,165014,165015,165018,1,4,0
47104,5,3,165019,165019,165022,0,3,1
47105,3,2,165022,165022,165024,0,2,0
47106,1,3,165023,165024,165027,1,4,0
47107,4,2,165027,165027,165029,0,2,0
47108,3,3,165030,165030,165033,0,3,1
47109,4,2,165034,165034,165036,0,2,1
47110,6,1,165040,165040,165041,0,1,4
47111,5,3,165045,165045,165048,0,3,4
47112,3,3,165048,165048,165051,0,3,0
47113,5,3,165053,165053,165056,0,3,2
47114,2,3,165055,165056,165059,1,4,0
47115,4,1,165059,165059,165060,0,1,0
47116,1,1,165060,165060,165061,0,1,0
47117,2,3,165062,165062,165065,0,3,1
47118,4,1,165066,165066,165067,0,1,1
47119,1,1,165067,165067,165068,0,1,0
47120,3,1,165070,165070,165071,0,1,2
47121,1,2,165071,165071,165073,0,2,0
47122,2,1,165073,165073,165074,0,1,0
47123,2,3,165075,165075,165078,0,3,1
47124,5,1,165080,165080,165081,0,1,2
47125,6,2,165086,165086,165088,0,2,5
47126,2,1,165088,165088,165089,0,1,0
47127,4,2,165092,165092,165094,0,2,3
47128,5,3,165097,165097,165100,0,3,3
47129,1,2,165098,165100,165102,2,4,0
47130,5,3,165103,165103,165106,0,3,1
47131,6,1,165109,165109,165110,0,1,3
47132,6,1,165115,165115,165116,0,1,5
47133,6,3,165121,165121,165124,0,3,5
47134,3,1,165124,165124,165125,0,1,0
47135,6,1,165130,165130,165131,0,1,5
47136,2,1,165132,165132,165133,0,1,1
47137,5,3,165137,165137,165140,0,3,4
47138,1,3,165138,165140,165143,2,5,0
47139,1,2,165139,165143,165145,4,6,0
47140,5,1,165144,165145,165146,1,2,0
47141,5,3,165149,165149,165152,0,3,3
47142,4,3,165153,165153,165156,0,3,1
47143,4,2,165157,165157,165159,0,2,1
47144,3,1,165160,165160,165161,0,1,1
47145,2,3,165162,165162,165165,0,3,1
47146,5,1,165167,165167,165168,0,1,2
47147,3,3,165170,165170,165173,0,3,2
47148,1,3,165171,165173,165176,2,5,0
47149,5,2,165176,165176,165178,0,2,0
47150,6,3,165182,165182,165185,0,3,4
47151,4,1,165186,165186,165187,0,1,1
47152,6,1,165192,165192,165193,0,1,5
47153,2,1,165194,165194,165195,0,1,1
47154,5,1,165199,165199,165200,0,1,4
47155,3,3,165202,165202,165205,0,3,2
47156,3,3,165205,165205,165208,0,3,0
47157,3,1,165208,165208,165209,0,1,0
47158,4,1,165212,165212,165213,0,1,3
47159,3,1,165215,165215,165216,0,1,2
47160,1,1,165216,165216,165217,0,1,0
47161,2,2,165218,165218,165220,0,2,1
47162,2,2,165220,165220,165222,0,2,0
47163,4,1,165224,165224,165225,0,1,2
47164,6,3,165230,165230,165233,0,3,5
47165,4,2,165234,165234,165236,0,2,1
47166,5,3,165239,165239,165242,0,3,3
47167,3,2,165242,165242,165244,0,2,0
47168,3,2,165245,165245,165247,0,2,1
47169,3,3,165248,165248,165251,0,3,1
47170,3,3,165251,165251,165254,0,3,0
47171,2,3,165253,165254,165257,1,4,0
47172,5,2,165258,165258,165260,0,2,1
47173,1,3,165259,165260,165263,1,4,0
47174,5,2,165264,165264,165266,0,2,1
47175,5,1,165269,165269,165270,0,1,3
47176,5,1,165274,165274,165275,0,1,4
47177,6,3,165280,165280,165283,0,3,5
47178,4,1,165284,165284,165285,0,1,1
47179,5,1,165289,165289,165290,0,1,4
47180,1,1,165290,165290,165291,0,1,0
47181,4,3,165294,165294,165297,0,3,3
47182,6,3,165300,165300,165303,0,3,3
47183,1,3,165301,165303,165306,2,5,0
47184,1,1,165302,165306,165307,4,5,0
47185,5,1,165307,165307,165308,0,1,0
47186,4,1,165311,165311,165312,0,1,3
47187,3,3,165314,165314,165317,0,3,2
47188,5,2,165319,165319,165321,0,2,2
47189,3,2,165322,165322,165324,0,2,1
47190,5,2,165327,165327,165329,0,2,3
47191,6,3,165333,165333,165336,0,3,4
47192,2,1,165335,165336,165337,1,2,0
47193,4,2,165339,165339,165341,0,2,2
47194,2,1,165341,165341,165342,0,1,0
47195,2,3,165343,165343,165346,0,3,1
47196,4,1,165347,165347,165348,0,1,1
47197,2,1,165349,165349,165350,0,1,1
47198,3,2,165352,165352,165354,0,2,2
47199,5,2,165357,165357,165359,0,2,3
47200,6,2,165363,165363,165365,0,2,4
47201,3,3,165366,165366,165369,0,3,1
47202,2,2,165368,165369,165371,1,3,0
47203,1,3,165369,165371,165374,2,5,0
47204,1,1,165370,165374,165375,4,5,0
47205,1,2,165371,165375,165377,4,6,0
47206,6,2,165377,165377,165379,0,2,0
47207,1,2,165378,165379,165381,1,3,0
47208,4,1,165382,165382,165383,0,1,1
47209,6,1,165388,165388,165389,0,1,5
47210,4,2,165392,165392,165394,0,2,3
47211,4,3,165396,165396,165399,0,3,2
47212,5,1,165401,165401,165402,0,1,2
47213,2,2,165403,165403,165405,0,2,1
47214,4,3,165407,165407,165410,0,3,2
47215,4,2,165411,165411,165413,0,2,1
47216,2,2,165413,165413,165415,0,2,0
47217,2,2,165415,165415,165417,0,2,0
47218,6,3,165421,165421,165424,0,3,4
47219,4,2,165425,165425,165427,0,2,1
47220,4,1,165429,165429,165430,0,1,2
47221,3,1,165432,165432,165433,0,1,2
47222,2,2,165434,165434,165436,0,2,1
47223,3,3,165437,165437,165440,0,3,1
47224,5,1,165442,165442,165443,0,1,2
47225,5,2,165447,165447,165449,0,2,4
47226,6,3,165453,165453,165456,0,3,4
47227,2,3,165455,165456,165459,1,4,0
47228,6,2,165461,165461,165463,0,2,2
47229,3,3,165464,165464,165467,0,3,1
47230,5,3,165469,165469,165472,0,3,2
47231,4,3,165473,165473,165476,0,3,1
47232,1,2,165474,165476,165478,2,4,0
47233,6,1,165480,165480,165481,0,1,2
47234,5,2,165485,165485,165487,0,2,4
47235,2,1,165487,165487,165488,0,1,0
47236,1,1,165488,165488,165489,0,1,0
47237,5,3,165493,165493,165496,0,3,4
47238,4,1,165497,165497,165498,0,1,1
47239,3,3,165500,165500,165503,0,3,2
47240,2,2,165502,165503,165505,1,3,0
47241,4,2,165506,165506,165508,0,2,1
47242,4,2,165510,165510,165512,0,2,2
47243,5,1,165515,165515,165516,0,1,3
47244,6,2,165521,165521,165523,0,2,5
47245,6,3,165527,165527,165530,0,3,4
47246,4,3,165531,165531,165534,0,3,1
47247,6,2,165537,165537,165539,0,2,3
47248,4,1,165541,165541,165542,0,1,2
47249,5,3,165546,165546,165549,0,3,4
47250,3,2,165549,165549,165551,0,2,0
47251,6,2,165555,165555,165557,0,2,4
47252,4,2,165559,165559,165561,0,2,2
47253,6,2,165565,165565,165567,0,2,4
47254,5,3,165570,165570,165573,0,3,3
47255,4,2,165574,165574,165576,0,2,1
47256,1,1,165575,165576,165577,1,2,0
47257,5,1,165580,165580,165581,0,1,3
47258,1,3,165581,165581,165584,0,3,0
47259,4,2,165585,165585,165587,0,2,1
47260,2,1,165587,165587,165588,0,1,0
47261,5,3,165592,165592,165595,0,3,4
47262,4,1,165596,165596,165597,0,1,1
47263,3,1,165599,165599,165600,0,1,2
47264,2,3,165601,165601,165604,0,3,1
47265,5,3,165606,165606,165609,0,3,2
47266,5,2,165611,165611,165613,0,2,2
47267,5,1,165616,165616,165617,0,1,3
47268,4,3,165620,165620,165623,0,3,3
47269,4,1,165624,165624,165625,0,1,1
47270,6,3,165630,165630,165633,0,3,5
47271,5,1,165635,165635,165636,0,1,2
47272,5,2,165640,165640,165642,0,2,4
47273,2,3,165642,165642,165645,0,3,0
47274,5,3,165647,165647,165650,0,3,2
47275,2,1,165649,165650,165651,1,2,0
47276,4,1,165653,165653,165654,0,1,2
47277,5,1,165658,165658,165659,0,1,4
47278,2,1,165660,165660,165661,0,1,1
47279,2,3,165662,165662,165665,0,3,1
47280,3,2,165665,165665,165667,0,2,0
47281,3,3,165668,165668,165671,0,3,1
47282,4,3,165672,165672,165675,0,3,1
47283,5,1,165677,165677,165678,0,1,2
47284,4,2,165681,165681,165683,0,2,3
47285,3,3,165684,165684,165687,0,3,1
47286,6,2,165690,165690,165692,0,2,3
47287,2,1,165692,165692,165693,0,1,0
47288,2,3,165694,165694,165697,0,3,1
47289,6,3,165700,165700,165703,0,3,3
47290,6,3,165706,165706,165709,0,3,3
47291,4,1,165710,165710,165711,0,1,1
47292,4,3,165714,165714,165717,0,3,3
47293,2,3,165716,165717,165720,1,4,0
47294,4,2,165720,165720,165722,0,2,0
47295,2,2,165722,165722,165724,0,2,0
47296,1,3,165723,165724,165727,1,4,0
47297,3,3,165726,165727,165730,1,4,0
47298,4,3,165730,165730,165733,0,3,0
47299,6,3,165736,165736,165739,0,3,3
47300,4,2,165740,165740,165742,0,2,1
47301,6,1,165746,165746,165747,0,1,4
47302,2,1,165748,165748,165749,0,1,1
47303,5,1,165753,165753,165754,0,1,4
47304,2,2,165755,165755,165757,0,2,1
47305,6,3,165761,165761,165764,0,3,4
47306,3,3,165764,165764,165767,0,3,0
47307,3,2,165767,165767,165769,0,2,0
47308,2,2,165769,165769,165771,0,2,0
47309,1,3,165770,165771,165774,1,4,0
47310,2,2,165772,165774,165776,2,4,0
47311,6,1,165778,165778,165779,0,1,2
47312,2,3,165780,165780,165783,0,3,1
47313,4,3,165784,165784,165787,0,3,1
47314,4,3,165788,165788,165791,0,3,1
47315,3,2,165791,165791,165793,0,2,0
47316,5,3,165796,165796,165799,0,3,3
47317,1,1,165797,165799,165800,2,3,0
47318,6,2,165803,165803,165805,0,2,3
47319,4,1,165807,165807,165808,0,1,2
47320,3,1,165810,165810,165811,0,1,2
47321,4,3,165814,165814,165817,0,3,3
47322,6,3,165820,165820,165823,0,3,3
47323,6,2,165826,165826,165828,0,2,3
47324,1,1,165827,165828,165829,1,2,0
47325,1,2,165828,165829,165831,1,3,0
47326,3,2,165831,165831,165833,0,2,0
47327,6,3,165837,165837,165840,0,3,4
47328,1,2,165838,165840,165842,2,4,0
47329,4,2,165842,165842,165844,0,2,0
47330,5,2,165847,165847,165849,0,2,3
47331,1,1,165848,165849,165850,1,2,0
47332,6,1,165854,165854,165855,0,1,4
47333,1,1,165855,165855,165856,0,1,0
47334,6,2,165861,165861,165863,0,2,5
47335,6,2,165867,165867,165869,0,2,4
47336,1,1,165868,165869,165870,1,2,0
47337,5,3,165873,165873,165876,0,3,3
47338,6,2,165879,165879,165881,0,2,3
47339,6,3,165885,165885,165888,0,3,4
47340,3,1,165888,165888,165889,0,1,0
47341,4,3,165892,165892,165895,0,3,3
47342,5,1,165897,165897,165898,0,1,2
47343,4,3,165901,165901,165904,0,3,3
47344,4,3,165905,165905,165908,0,3,1
47345,2,3,165907,165908,165911,1,4,0
47346,6,3,165913,165913,165916,0,3,2
47347,5,1,165918,165918,165919,0,1,2
47348,1,1,165919,165919,165920,0,1,0
47349,5,2,165924,165924,165926,0,2,4
47350,3,2,165927,165927,165929,0,2,1
47351,1,2,165928,165929,165931,1,3,0
47352,6,1,165934,165934,165935,0,1,3
47353,5,2,165939,165939,165941,0,2,4
47354,3,2,165942,165942,165944,0,2,1
47355,1,3,165943,165944,165947,1,4,0
47356,6,3,165949,165949,165952,0,3,2
47357,1,3,165950,165952,165955,2,5,0
47358,2,3,165952,165955,165958,3,6,0
47359,2,3,165954,165958,165961,4,7,0
47360,6,1,165960,165961,165962,1,2,0
47361,2,3,165962,165962,165965,0,3,0
47362,3,2,165965,165965,165967,0,2,0
47363,4,1,165969,165969,165970,0,1,2
47364,1,2,165970,165970,165972,0,2,0
47365,5,3,165975,165975,165978,0,3,3
47366,3,2,165978,165978,165980,0,2,0
47367,6,2,165984,165984,165986,0,2,4
47368,5,3,165989,165989,165992,0,3,3
47369,5,3,165994,165994,165997,0,3,2
47370,3,3,165997,165997,166000,0,3,0
47371,4,3,166001,166001,166004,0,3,1
47372,2,3,166003,166004,166007,1,4,0
47373,3,2,166006,166007,166009,1,3,0
47374,3,1,166009,166009,166010,0,1,0
47375,5,1,166014,166014,166015,0,1,4
47376,6,2,166020,166020,166022,0,2,5
47377,5,1,166025,166025,166026,0,1,3
47378,2,2,166027,166027,166029,0,2,1
47379,6,2,166033,166033,166035,0,2,4
47380,3,3,166036,166036,166039,0,3,1
47381,4,1,166040,166040,166041,0,1,1
47382,6,1,166046,166046,166047,0,1,5
47383,5,2,166051,166051,166053,0,2,4
47384,3,3,166054,166054,166057,0,3,1
47385,3,1,166057,166057,166058,0,1,0
47386,2,2,166059,166059,166061,0,2,1
47387,4,1,166063,166063,166064,0,1,2
47388,2,3,166065,166065,166068,0,3,1
47389,5,1,166070,166070,166071,0,1,2
47390,6,1,166076,166076,166077,0,1,5
47391,5,1,166081,166081,166082,0,1,4
47392,3,3,166084,166084,166087,0,3,2
47393,1,1,166085,166087,166088,2,3,0
47394,3,2,166088,166088,166090,0,2,0
47395,2,3,166090,166090,166093,0,3,0
47396,6,3,166096,166096,166099,0,3,3
47397,1,2,166097,166099,166101,2,4,0
47398,6,2,166103,166103,166105,0,2,2
47399,6,1,166109,166109,166110,0,1,4
47400,1,2,166110,166110,166112,0,2,0
47401,3,1,166113,166113,166114,0,1,1
47402,1,2,166114,166114,166116,0,2,0
47403,2,3,166116,166116,166119,0,3,0
47404,6,2,166122,166122,166124,0,2,3
47405,4,3,166126,166126,166129,0,3,2
47406,1,2,166127,166129,166131,2,4,0
47407,1,3,166128,166131,166134,3,6,0
47408,3,2,166131,166134,166136,3,5,0
47409,1,2,166132,166136,166138,4,6,0
47410,3,1,166135,166138,166139,3,4,0
47411,6,1,166141,166141,166142,0,1,2
47412,3,3,166144,166144,166147,0,3,2
47413,1,2,166145,166147,166149,2,4,0
47414,1,1,166146,166149,166150,3,4,0
47415,4,2,166150,166150,166152,0,2,0
47416,4,1,166154,166154,166155,0,1,2
47417,6,3,166160,166160,166163,0,3,5
47418,6,3,166166,166166,166169,0,3,3
47419,2,1,166168,166169,166170,1,2,0
47420,6,1,166174,166174,166175,0,1,4
47421,4,3,166178,166178,166181,0,3,3
47422,3,1,166181,166181,166182,0,1,0
47423,3,1,166184,166184,166185,0,1,2
47424,6,2,166190,166190,166192,0,2,5
47425,6,3,166196,166196,166199,0,3,4
47426,5,3,166201,166201,166204,0,3,2
47427,1,3,166202,166204,166207,2,5,0
47428,6,3,166208,166208,166211,0,3,1
47429,6,1,166214,166214,166215,0,1,3
47430,5,1,166219,166219,166220,0,1,4
47431,6,1,166225,166225,166226,0,1,5
47432,4,3,166229,166229,166232,0,3,3
47433,6,3,166235,166235,166238,0,3,3
47434,6,3,166241,166241,166244,0,3,3
47435,6,1,166247,166247,166248,0,1,3
47436,6,2,166253,166253,166255,0,2,5
47437,4,1,166257,166257,166258,0,1,2
47438,2,1,166259,166259,166260,0,1,1
47439,4,1,166263,166263,166264,0,1,3
47440,1,1,166264,166264,166265,0,1,0
47441,1,3,166265,166265,166268,0,3,0
47442,4,1,166269,166269,166270,0,1,1
47443,1,2,166270,166270,166272,0,2,0
47444,5,3,166275,166275,166278,0,3,3
47445,6,3,166281,166281,166284,0,3,3
47446,1,3,166282,166284,166287,2,5,0
47447,4,3,166286,166287,166290,1,4,0
47448,4,1,166290,166290,166291,0,1,0
47449,2,2,166292,166292,166294,0,2,1
47450,4,1,166296,166296,166297,0,1,2
47451,1,1,166297,166297,166298,0,1,0
47452,4,2,166301,166301,166303,0,2,3
47453,2,2,166303,166303,166305,0,2,0
47454,6,3,166309,166309,166312,0,3,4
47455,3,1,166312,166312,166313,0,1,0
47456,3,1,166315,166315,166316,0,1,2
47457,5,1,166320,166320,166321,0,1,4
47458,2,3,166322,166322,166325,0,3,1
47459,3,2,166325,166325,166327,0,2,0
47460,6,1,166331,166331,166332,0,1,4
47461,1,2,166332,166332,166334,0,2,0
47462,6,3,166338,166338,166341,0,3,4
47463,5,1,166343,166343,166344,0,1,2
47464,1,3,166344,166344,166347,0,3,0
47465,4,2,166348,166348,166350,0,2,1
47466,4,3,166352,166352,166355,0,3,2
47467,2,3,166354,166355,166358,1,4,0
47468,3,2,166357,166358,166360,1,3,0
47469,4,3,166361,166361,166364,0,3,1
47470,5,1,166366,166366,166367,0,1,2
47471,3,3,166369,166369,166372,0,3,2
47472,6,3,166375,166375,166378,0,3,3
47473,2,2,166377,166378,166380,1,3,0
47474,2,2,166379,166380,166382,1,3,0
47475,3,2,166382,166382,166384,0,2,0
47476,4,1,166386,166386,166387,0,1,2
47477,6,1,166392,166392,166393,0,1,5
47478,4,1,166396,166396,166397,0,1,3
47479,2,3,166398,166398,166401,0,3,1
47480,2,2,166400,166401,166403,1,3,0
47481,5,1,166405,166405,166406,0,1,2
47482,3,3,166408,166408,166411,0,3,2
47483,6,1,166414,166414,166415,0,1,3
47484,1,3,166415,166415,166418,0,3,0
47485,4,1,166419,166419,166420,0,1,1
47486,5,2,166424,166424,166426,0,2,4
47487,4,1,166428,166428,166429,0,1,2
47488,6,1,166434,166434,166435,0,1,5
47489,3,2,166437,166437,166439,0,2,2
47490,3,1,166440,166440,166441,0,1,1
47491,5,2,166445,166445,166447,0,2,4
47492,3,1,166448,166448,166449,0,1,1
47493,1,2,166449,166449,166451,0,2,0
47494,4,2,166453,166453,166455,0,2,2
47495,4,2,166457,166457,166459,0,2,2
47496,5,2,166462,166462,166464,0,2,3
47497,5,1,166467,166467,166468,0,1,3
47498,4,3,166471,166471,166474,0,3,3
47499,4,3,166475,166475,166478,0,3,1
47500,4,3,166479,166479,166482,0,3,1
47501,3,3,166482,166482,166485,0,3,0
47502,5,1,166487,166487,166488,0,1,2
47503,5,1,166492,166492,166493,0,1,4
47504,1,2,166493,166493,166495,0,2,0
47505,4,2,166497,166497,166499,0,2,2
47506,4,3,166501,166501,166504,0,3,2
47507,6,3,166507,166507,166510,0,3,3
47508,6,3,166513,166513,166516,0,3,3
47509,2,1,166515,166516,166517,1,2,0
47510,6,2,166521,166521,166523,0,2,4
47511,6,2,166527,166527,166529,0,2,4
47512,1,3,166528,166529,166532,1,4,0
47513,5,3,166533,166533,166536,0,3,1
47514,4,2,166537,166537,166539,0,2,1
47515,6,3,166543,166543,166546,0,3,4
47516,1,2,166544,166546,166548,2,4,0
47517,3,1,166547,166548,166549,1,2,0
47518,5,1,166552,166552,166553,0,1,3
47519,1,1,166553,166553,166554,0,1,0
47520,6,3,166559,166559,166562,0,3,5
47521,3,3,166562,166562,166565,0,3,0
47522,3,2,166565,166565,166567,0,2,0
47523,4,3,166569,166569,166572,0,3,2
47524,2,2,166571,166572,166574,1,3,0
47525,1,1,166572,166574,166575,2,3,0
47526,1,1,166573,166575,166576,2,3,0
47527,2,3,166575,166576,166579,1,4,0
47528,2,1,166577,166579,166580,2,3,0
47529,4,3,166581,166581,166584,0,3,1
47530,4,3,166585,166585,166588,0,3,1
47531,3,3,166588,166588,166591,0,3,0
47532,3,1,166591,166591,166592,0,1,0
47533,3,1,166594,166594,166595,0,1,2
47534,3,2,166597,166597,166599,0,2,2
47535,2,1,166599,166599,166600,0,1,0
47536,1,3,166600,166600,166603,0,3,0
47537,6,3,166606,166606,166609,0,3,3
47538,6,1,166612,166612,166613,0,1,3
47539,3,3,166615,166615,166618,0,3,2
47540,4,3,166619,166619,166622,0,3,1
47541,1,2,166620,166622,166624,2,4,0
47542,1,1,166621,166624,166625,3,4,0
47543,6,3,166627,166627,166630,0,3,2
47544,1,1,166628,166630,166631,2,3,0
47545,2,3,166630,166631,166634,1,4,0
47546,2,3,166632,166634,166637,2,5,0
47547,6,3,166638,166638,166641,0,3,1
47548,2,1,166640,166641,166642,1,2,0
47549,2,3,166642,166642,166645,0,3,0
47550,6,1,166648,166648,166649,0,1,3
47551,2,1,166650,166650,166651,0,1,1
47552,5,1,166655,166655,166656,0,1,4
47553,5,1,166660,166660,166661,0,1,4
47554,1,2,166661,166661,166663,0,2,0
47555,2,3,166663,166663,166666,0,3,0
47556,1,1,166664,166666,166667,2,3,0
47557,2,3,166666,166667,166670,1,4,0
47558,4,1,166670,166670,166671,0,1,0
47559,3,3,166673,166673,166676,0,3,2
47560,5,3,166678,166678,166681,0,3,2
47561,6,3,166684,166684,166687,0,3,3
47562,5,3,166689,166689,166692,0,3,2
47563,4,2,166693,166693,166695,0,2,1
47564,1,1,166694,166695,166696,1,2,0
47565,4,2,166698,166698,166700,0,2,2
47566,6,3,166704,166704,166707,0,3,4
47567,5,1,166709,166709,166710,0,1,2
47568,1,1,166710,166710,166711,0,1,0
47569,1,1,166711,166711,166712,0,1,0
47570,2,2,166713,166713,166715,0,2,1
47571,5,3,166718,166718,166721,0,3,3
47572,6,3,166724,166724,166727,0,3,3
47573,3,2,166727,166727,166729,0,2,0
47574,5,2,166732,166732,166734,0,2,3
47575,2,1,166734,166734,166735,0,1,0
47576,2,2,166736,166736,166738,0,2,1
47577,4,2,166740,166740,166742,0,2,2
47578,6,1,166746,166746,166747,0,1,4
47579,5,3,166751,166751,166754,0,3,4
47580,1,3,166752,166754,166757,2,5,0
47581,4,1,166756,166757,166758,1,2,0
47582,3,3,166759,166759,166762,0,3,1
47583,2,1,166761,166762,166763,1,2,0
47584,6,3,166767,166767,166770,0,3,4
47585,1,2,166768,166770,166772,2,4,0
47586,1,2,166769,166772,166774,3,5,0
47587,1,2,166770,166774,166776,4,6,0
47588,6,1,166776,166776,166777,0,1,0
47589,4,2,166780,166780,166782,0,2,3
47590,3,2,166783,166783,166785,0,2,1
47591,3,2,166786,166786,166788,0,2,1
47592,4,3,166790,166790,166793,0,3,2
47593,4,3,166794,166794,166797,0,3,1
47594,5,2,166799,166799,166801,0,2,2
47595,4,1,166803,166803,166804,0,1,2
47596,5,2,166808,166808,166810,0,2,4
47597,6,3,166814,166814,166817,0,3,4
47598,5,2,166819,166819,166821,0,2,2
47599,3,1,166822,166822,166823,0,1,1
47600,5,2,166827,166827,166829,0,2,4
47601,3,2,166830,166830,166832,0,2,1
47602,2,2,166832,166832,166834,0,2,0
47603,3,2,166835,166835,166837,0,2,1
47604,2,1,166837,166837,166838,0,1,0
47605,5,1,166842,166842,166843,0,1,4
47606,3,2,166845,166845,166847,0,2,2
47607,5,2,166850,166850,166852,0,2,3
47608,5,2,166855,166855,166857,0,2,3
47609,1,2,166856,166857,166859,1,3,0
47610,5,2,166861,166861,166863,0,2,2
47611,2,3,166863,166863,166866,0,3,0
47612,4,1,166867,166867,166868,0,1,1
47613,6,3,166873,166873,166876,0,3,5
47614,6,1,166879,166879,166880,0,1,3
47615,4,3,166883,166883,166886,0,3,3
47616,6,3,166889,166889,166892,0,3,3
47617,3,1,166892,166892,166893,0,1,0
47618,4,2,166896,166896,166898,0,2,3
47619,5,2,166901,166901,166903,0,2,3
47620,3,2,166904,166904,166906,0,2,1
47621,2,1,166906,166906,166907,0,1,0
47622,5,1,166911,166911,166912,0,1,4
47623,6,2,166917,166917,166919,0,2,5
47624,3,3,166920,166920,166923,0,3,1
47625,1,3,166921,166923,166926,2,5,0
47626,2,2,166923,166926,166928,3,5,0
47627,3,1,166926,166928,166929,2,3,0
47628,3,2,166929,166929,166931,0,2,0
47629,5,1,166934,166934,166935,0,1,3
47630,1,2,166935,166935,166937,0,2,0
47631,2,2,166937,166937,166939,0,2,0
47632,2,1,166939,166939,166940,0,1,0
47633,2,1,166941,166941,166942,0,1,1
47634,1,3,166942,166942,166945,0,3,0
47635,1,2,166943,166945,166947,2,4,0
47636,3,1,166946,166947,166948,1,2,0
47637,4,2,166950,166950,166952,0,2,2
47638,1,1,166951,166952,166953,1,2,0
47639,6,1,166957,166957,166958,0,1,4
47640,1,2,166958,166958,166960,0,2,0
47641,1,2,166959,166960,166962,1,3,0
47642,2,2,166961,166962,166964,1,3,0
47643,2,2,166963,166964,166966,1,3,0
47644,4,2,166967,166967,166969,0,2,1
47645,5,3,166972,166972,166975,0,3,3
47646,3,2,166975,166975,166977,0,2,0
47647,6,3,166981,166981,166984,0,3,4
47648,4,2,166985,166985,166987,0,2,1
47649,1,2,166986,166987,166989,1,3,0
47650,3,1,166989,166989,166990,0,1,0
47651,1,1,166990,166990,166991,0,1,0
47652,5,2,166995,166995,166997,0,2,4
47653,4,1,166999,166999,167000,0,1,2
47654,2,2,167001,167001,167003,0,2,1
47655,4,3,167005,167005,167008,0,3,2
47656,1,3,167006,167008,167011,2,5,0
47657,3,3,167009,167011,167014,2,5,0
47658,5,3,167014,167014,167017,0,3,0
47659,2,2,167016,167017,167019,1,3,0
47660,5,3,167021,167021,167024,0,3,2
47661,6,3,167027,167027,167030,0,3,3
47662,4,2,167031,167031,167033,0,2,1
47663,2,3,167033,167033,167036,0,3,0
47664,2,2,167035,167036,167038,1,3,0
47665,6,2,167041,167041,167043,0,2,3
47666,2,2,167043,167043,167045,0,2,0
47667,3,1,167046,167046,167047,0,1,1
47668,6,2,167052,167052,167054,0,2,5
47669,5,2,167057,167057,167059,0,2,3
47670,4,1,167061,167061,167062,0,1,2
47671,4,2,167065,167065,167067,0,2,3
47672,6,2,167071,167071,167073,0,2,4
47673,5,1,167076,167076,167077,0,1,3
47674,4,3,167080,167080,167083,0,3,3
47675,6,3,167086,167086,167089,0,3,3
47676,3,3,167089,167089,167092,0,3,0
47677,2,2,167091,167092,167094,1,3,0
47678,2,2,167093,167094,167096,1,3,0
47679,2,1,167095,167096,167097,1,2,0
47680,5,3,167100,167100,167103,0,3,3
47681,1,1,167101,167103,167104,2,3,0
47682,2,2,167103,167104,167106,1,3,0
47683,6,2,167109,167109,167111,0,2,3
47684,3,2,167112,167112,167114,0,2,1
47685,3,2,167115,167115,167117,0,2,1
47686,6,1,167121,167121,167122,0,1,4
47687,3,2,167124,167124,167126,0,2,2
47688,6,1,167130,167130,167131,0,1,4
47689,2,1,167132,167132,167133,0,1,1
47690,1,3,167133,167133,167136,0,3,0
47691,4,3,167137,167137,167140,0,3,1
47692,1,2,167138,167140,167142,2,4,0
47693,3,3,167141,167142,167145,1,4,0
47694,3,2,167144,167145,167147,1,3,0
47695,4,1,167148,167148,167149,0,1,1
47696,6,3,167154,167154,167157,0,3,5
47697,4,3,167158,167158,167161,0,3,1
47698,1,1,167159,167161,167162,2,3,0
47699,3,2,167162,167162,167164,0,2,0
47700,2,3,167164,167164,167167,0,3,0
47701,4,1,167168,167168,167169,0,1,1
47702,6,1,167174,167174,167175,0,1,5
47703,3,3,167177,167177,167180,0,3,2
47704,3,3,167180,167180,167183,0,3,0
47705,4,1,167184,167184,167185,0,1,1
47706,1,2,167185,167185,167187,0,2,0
47707,5,2,167190,167190,167192,0,2,3
47708,6,1,167196,167196,167197,0,1,4
47709,3,1,167199,167199,167200,0,1,2
47710,3,3,167202,167202,167205,0,3,2
47711,6,1,167208,167208,167209,0,1,3
47712,6,2,167214,167214,167216,0,2,5
47713,2,3,167216,167216,167219,0,3,0
47714,3,2,167219,167219,167221,0,2,0
47715,4,1,167223,167223,167224,0,1,2
47716,2,1,167225,167225,167226,0,1,1
47717,6,2,167231,167231,167233,0,2,5
47718,6,2,167237,167237,167239,0,2,4
47719,5,3,167242,167242,167245,0,3,3
47720,4,1,167246,167246,167247,0,1,1
47721,1,2,167247,167247,167249,0,2,0
47722,2,1,167249,167249,167250,0,1,0
47723,1,3,167250,167250,167253,0,3,0
47724,3,3,167253,167253,167256,0,3,0
47725,3,2,167256,167256,167258,0,2,0
47726,6,2,167262,167262,167264,0,2,4
47727,3,2,167265,167265,167267,0,2,1
47728,4,1,167269,167269,167270,0,1,2
47729,2,3,167271,167271,167274,0,3,1
47730,4,3,167275,167275,167278,0,3,1
47731,6,2,167281,167281,167283,0,2,3
47732,2,3,167283,167283,167286,0,3,0
47733,1,1,167284,167286,167287,2,3,0
47734,6,3,167290,167290,167293,0,3,3
47735,3,2,167293,167293,167295,0,2,0
47736,3,3,167296,167296,167299,0,3,1
47737,1,2,167297,167299,167301,2,4,0
47738,6,2,167303,167303,167305,0,2,2
47739,6,3,167309,167309,167312,0,3,4
47740,3,2,167312,167312,167314,0,2,0
47741,6,1,167318,167318,167319,0,1,4
47742,1,2,167319,167319,167321,0,2,0
47743,3,1,167322,167322,167323,0,1,1
47744,5,1,167327,167327,167328,0,1,4
47745,5,1,167332,167332,167333,0,1,4
47746,6,3,167338,167338,167341,0,3,5
47747,1,2,167339,167341,167343,2,4,0
47748,2,2,167341,167343,167345,2,4,0
47749,3,2,167344,167345,167347,1,3,0
47750,5,2,167349,167349,167351,0,2,2
47751,1,1,167350,167351,167352,1,2,0
47752,2,3,167352,167352,167355,0,3,0
47753,4,2,167356,167356,167358,0,2,1
47754,3,1,167359,167359,167360,0,1,1
47755,5,2,167364,167364,167366,0,2,4
47756,4,1,167368,167368,167369,0,1,2
47757,1,1,167369,167369,167370,0,1,0
47758,5,2,167374,167374,167376,0,2,4
47759,5,2,167379,167379,167381,0,2,3
47760,2,2,167381,167381,167383,0,2,0
47761,4,3,167385,167385,167388,0,3,2
47762,6,1,167391,167391,167392,0,1,3
47763,2,3,167393,167393,167396,0,3,1
47764,6,1,167399,167399,167400,0,1,3
47765,3,3,167402,167402,167405,0,3,2
47766,4,2,167406,167406,167408,0,2,1
47767,5,2,167411,167411,167413,0,2,3
47768,5,2,167416,167416,167418,0,2,3
47769,2,3,167418,167418,167421,0,3,0
47770,3,1,167421,167421,167422,0,1,0
47771,1,2,167422,167422,167424,0,2,0
47772,5,2,167427,167427,167429,0,2,3
47773,4,1,167431,167431,167432,0,1,2
47774,4,2,167435,167435,167437,0,2,3
47775,5,3,167440,167440,167443,0,3,3
47776,3,1,167443,167443,167444,0,1,0
47777,2,3,167445,167445,167448,0,3,1
47778,5,3,167450,167450,167453,0,3,2
47779,3,3,167453,167453,167456,0,3,0
47780,5,1,167458,167458,167459,0,1,2
47781,1,2,167459,167459,167461,0,2,0
47782,6,3,167465,167465,167468,0,3,4
47783,1,3,167466,167468,167471,2,5,0
47784,4,3,167470,167471,167474,1,4,0
47785,1,2,167471,167474,167476,3,5,0
47786,2,3,167473,167476,167479,3,6,0
47787,5,2,167478,167479,167481,1,3,0
47788,3,2,167481,167481,167483,0,2,0
47789,6,1,167487,167487,167488,0,1,4
47790,4,2,167491,167491,167493,0,2,3
47791,6,1,167497,167497,167498,0,1,4
47792,4,2,167501,167501,167503,0,2,3
47793,1,3,167502,167503,167506,1,4,0
47794,2,3,167504,167506,167509,2,5,0
47795,6,2,167510,167510,167512,0,2,1
47796,2,2,167512,167512,167514,0,2,0
47797,1,2,167513,167514,167516,1,3,0
47798,2,2,167515,167516,167518,1,3,0
47799,5,2,167520,167520,167522,0,2,2
47800,1,2,167521,167522,167524,1,3,0
47801,6,1,167527,167527,167528,0,1,3
47802,4,3,167531,167531,167534,0,3,3
47803,3,2,167534,167534,167536,0,2,0
47804,6,2,167540,167540,167542,0,2,4
47805,4,1,167544,167544,167545,0,1,2
47806,3,1,167547,167547,167548,0,1,2
47807,4,1,167551,167551,167552,0,1,3
47808,3,3,167554,167554,167557,0,3,2
47809,2,2,167556,167557,167559,1,3,0
47810,6,2,167562,167562,167564,0,2,3
47811,3,1,167565,167565,167566,0,1,1
47812,3,1,167568,167568,167569,0,1,2
47813,4,1,167572,167572,167573,0,1,3
47814,5,1,167577,167577,167578,0,1,4
47815,3,1,167580,167580,167581,0,1,2
47816,4,3,167584,167584,167587,0,3,3
47817,4,3,167588,167588,167591,0,3,1
47818,3,3,167591,167591,167594,0,3,0
47819,1,2,167592,167594,167596,2,4,0
47820,5,1,167597,167597,167598,0,1,1
47821,2,3,167599,167599,167602,0,3,1
47822,5,1,167604,167604,167605,0,1,2
47823,4,3,167608,167608,167611,0,3,3
47824,5,2,167613,167613,167615,0,2,2
47825,1,3,167614,167615,167618,1,4,0
47826,5,3,167619,167619,167622,0,3,1
47827,6,3,167625,167625,167628,0,3,3
47828,3,3,167628,167628,167631,0,3,0
47829,4,1,167632,167632,167633,0,1,1
47830,1,2,167633,167633,167635,0,2,0
47831,5,3,167638,167638,167641,0,3,3
47832,6,2,167644,167644,167646,0,2,3
47833,5,3,167649,167649,167652,0,3,3
47834,2,2,167651,167652,167654,1,3,0
47835,3,1,167654,167654,167655,0,1,0
47836,6,3,167660,167660,167663,0,3,5
47837,2,1,167662,167663,167664,1,2,0
47838,6,2,167668,167668,167670,0,2,4
47839,1,2,167669,167670,167672,1,3,0
47840,2,2,167671,167672,167674,1,3,0
47841,1,3,167672,167674,167677,2,5,0
47842,3,1,167675,167677,167678,2,3,0
47843,4,3,167679,167679,167682,0,3,1
47844,1,1,167680,167682,167683,2,3,0
47845,2,1,167682,167683,167684,1,2,0
47846,2,3,167684,167684,167687,0,3,0
47847,2,2,167686,167687,167689,1,3,0
47848,2,3,167688,167689,167692,1,4,0
47849,4,1,167692,167692,167693,0,1,0
47850,6,3,167698,167698,167701,0,3,5
47851,5,3,167703,167703,167706,0,3,2
47852,6,1,167709,167709,167710,0,1,3
47853,4,1,167713,167713,167714,0,1,3
47854,6,2,167719,167719,167721,0,2,5
47855,3,1,167722,167722,167723,0,1,1
47856,1,1,167723,167723,167724,0,1,0
47857,5,1,167728,167728,167729,0,1,4
47858,1,2,167729,167729,167731,0,2,0
47859,5,3,167734,167734,167737,0,3,3
47860,1,2,167735,167737,167739,2,4,0
47861,2,1,167737,167739,167740,2,3,0
47862,4,1,167741,167741,167742,0,1,1
47863,1,3,167742,167742,167745,0,3,0
47864,3,2,167745,167745,167747,0,2,0
47865,1,1,167746,167747,167748,1,2,0
47866,5,3,167751,167751,167754,0,3,3
47867,6,3,167757,167757,167760,0,3,3
47868,4,3,167761,167761,167764,0,3,1
47869,4,1,167765,167765,167766,0,1,1
47870,6,2,167771,167771,167773,0,2,5
47871,2,3,167773,167773,167776,0,3,0
47872,6,2,167779,167779,167781,0,2,3
47873,6,2,167785,167785,167787,0,2,4
47874,2,2,167787,167787,167789,0,2,0
47875,4,3,167791,167791,167794,0,3,2
47876,3,3,167794,167794,167797,0,3,0
47877,3,2,167797,167797,167799,0,2,0
47878,5,1,167802,167802,167803,0,1,3
47879,3,1,167805,167805,167806,0,1,2
47880,6,1,167811,167811,167812,0,1,5
47881,2,2,167813,167813,167815,0,2,1
47882,2,3,167815,167815,167818,0,3,0
47883,1,3,167816,167818,167821,2,5,0
47884,3,2,167819,167821,167823,2,4,0
47885,4,2,167823,167823,167825,0,2,0
47886,2,3,167825,167825,167828,0,3,0
47887,4,2,167829,167829,167831,0,2,1
47888,6,1,167835,167835,167836,0,1,4
47889,3,1,167838,167838,167839,0,1,2
47890,2,2,167840,167840,167842,0,2,1
47891,1,2,167841,167842,167844,1,3,0
47892,3,3,167844,167844,167847,0,3,0
47893,6,3,167850,167850,167853,0,3,3
47894,4,1,167854,167854,167855,0,1,1
47895,1,2,167855,167855,167857,0,2,0
47896,4,2,167859,167859,167861,0,2,2
47897,1,2,167860,167861,167863,1,3,0
47898,3,1,167863,167863,167864,0,1,0
47899,4,1,167867,167867,167868,0,1,3
47900,3,2,167870,167870,167872,0,2,2
47901,3,2,167873,167873,167875,0,2,1
47902,4,1,167877,167877,167878,0,1,2
47903,4,3,167881,167881,167884,0,3,3
47904,4,2,167885,167885,167887,0,2,1
47905,6,1,167891,167891,167892,0,1,4
47906,2,3,167893,167893,167896,0,3,1
47907,2,1,167895,167896,167897,1,2,0
47908,6,2,167901,167901,167903,0,2,4
47909,2,3,167903,167903,167906,0,3,0
47910,4,3,167907,167907,167910,0,3,1
47911,1,3,167908,167910,167913,2,5,0
47912,1,3,167909,167913,167916,4,7,0
47913,6,2,167915,167916,167918,1,3,0
47914,1,3,167916,167918,167921,2,5,0
47915,1,2,167917,167921,167923,4,6,0
47916,3,1,167920,167923,167924,3,4,0
47917,4,2,167924,167924,167926,0,2,0
47918,6,1,167930,167930,167931,0,1,4
47919,2,3,167932,167932,167935,0,3,1
47920,4,2,167936,167936,167938,0,2,1
47921,4,1,167940,167940,167941,0,1,2
47922,1,1,167941,167941,167942,0,1,0
47923,3,3,167944,167944,167947,0,3,2
47924,3,3,167947,167947,167950,0,3,0
47925,3,2,167950,167950,167952,0,2,0
47926,3,3,167953,167953,167956,0,3,1
47927,3,2,167956,167956,167958,0,2,0
47928,3,3,167959,167959,167962,0,3,1
47929,5,1,167964,167964,167965,0,1,2
47930,4,2,167968,167968,167970,0,2,3
47931,4,2,167972,167972,167974,0,2,2
47932,3,2,167975,167975,167977,0,2,1
47933,3,2,167978,167978,167980,0,2,1
47934,2,3,167980,167980,167983,0,3,0
47935,2,1,167982,167983,167984,1,2,0
47936,6,3,167988,167988,167991,0,3,4
47937,3,1,167991,167991,167992,0,1,0
47938,1,1,167992,167992,167993,0,1,0
47939,1,2,167993,167993,167995,0,2,0
47940,3,2,167996,167996,167998,0,2,1
47941,6,3,168002,168002,168005,0,3,4
47942,6,1,168008,168008,168009,0,1,3
47943,1,2,168009,168009,168011,0,2,0
47944,3,1,168012,168012,168013,0,1,1
47945,2,2,168014,168014,168016,0,2,1
47946,4,1,168018,168018,168019,0,1,2
47947,4,2,168022,168022,168024,0,2,3
47948,3,1,168025,168025,168026,0,1,1
47949,4,3,168029,168029,168032,0,3,3
47950,3,3,168032,168032,168035,0,3,0
47951,6,1,168038,168038,168039,0,1,3
47952,1,3,168039,168039,168042,0,3,0
47953,3,2,168042,168042,168044,0,2,0
47954,2,2,168044,168044,168046,0,2,0
47955,1,3,168045,168046,168049,1,4,0
47956,3,2,168048,168049,168051,1,3,0
47957,6,1,168054,168054,168055,0,1,3
47958,6,3,168060,168060,168063,0,3,5
47959,3,1,168063,168063,168064,0,1,0
47960,3,1,168066,168066,168067,0,1,2
47961,1,2,168067,168067,168069,0,2,0
47962,2,1,168069,168069,168070,0,1,0
47963,6,3,168075,168075,168078,0,3,5
47964,4,1,168079,168079,168080,0,1,1
47965,4,3,168083,168083,168086,0,3,3
47966,5,1,168088,168088,168089,0,1,2
47967,6,3,168094,168094,168097,0,3,5
47968,2,3,168096,168097,168100,1,4,0
47969,3,1,168099,168100,168101,1,2,0
47970,5,3,168104,168104,168107,0,3,3
47971,1,2,168105,168107,168109,2,4,0
47972,5,2,168110,168110,168112,0,2,1
47973,4,2,168114,168114,168116,0,2,2
47974,1,3,168115,168116,168119,1,4,0
47975,2,2,168117,168119,168121,2,4,0
47976,4,2,168121,168121,168123,0,2,0
47977,3,3,168124,168124,168127,0,3,1
47978,2,3,168126,168127,168130,1,4,0
47979,2,2,168128,168130,168132,2,4,0
47980,1,3,168129,168132,168135,3,6,0
47981,4,3,168133,168135,168138,2,5,0
47982,2,3,168135,168138,168141,3,6,0
47983,4,3,168139,168141,168144,2,5,0
47984,3,1,168142,168144,168145,2,3,0
47985,4,3,168146,168146,168149,0,3,1
47986,4,2,168150,168150,168152,0,2,1
47987,3,1,168153,168153,168154,0,1,1
47988,2,2,168155,168155,168157,0,2,1
47989,5,1,168160,168160,168161,0,1,3
47990,2,1,168162,168162,168163,0,1,1
47991,3,2,168165,168165,168167,0,2,2
47992,6,3,168171,168171,168174,0,3,4
47993,5,1,168176,168176,168177,0,1,2
47994,1,1,168177,168177,168178,0,1,0
47995,4,3,168181,168181,168184,0,3,3
47996,4,2,168185,168185,168187,0,2,1
47997,5,1,168190,168190,168191,0,1,3
47998,6,3,168196,168196,168199,0,3,5
47999,3,1,168199,168199,168200,0,1,0
48000,6,2,168205,168205,168207,0,2,5
48001,2,2,168207,168207,168209,0,2,0
48002,1,2,168208,168209,168211,1,3,0
48003,1,2,168209,168211,168213,2,4,0
48004,3,1,168212,168213,168214,1,2,0
48005,4,2,168216,168216,168218,0,2,2
48006,5,1,168221,168221,168222,0,1,3
48007,5,1,168226,168226,168227,0,1,4
48008,3,2,168229,168229,168231,0,2,2
48009,5,3,168234,168234,168237,0,3,3
48010,6,1,168240,168240,168241,0,1,3
48011,3,3,168243,168243,168246,0,3,2
48012,6,2,168249,168249,168251,0,2,3
48013,3,2,168252,168252,168254,0,2,1
48014,3,2,168255,168255,168257,0,2,1
48015,2,1,168257,168257,168258,0,1,0
48016,6,2,168263,168263,168265,0,2,5
48017,5,1,168268,168268,168269,0,1,3
48018,3,1,168271,168271,168272,0,1,2
48019,2,3,168273,168273,168276,0,3,1
48020,3,2,168276,168276,168278,0,2,0
48021,4,2,168280,168280,168282,0,2,2
48022,4,3,168284,168284,168287,0,3,2
48023,2,1,168286,168287,168288,1,2,0
48024,4,2,168290,168290,168292,0,2,2
48025,4,1,168294,168294,168295,0,1,2
48026,3,3,168297,168297,168300,0,3,2
48027,3,3,168300,168300,168303,0,3,0
48028,3,1,168303,168303,168304,0,1,0
48029,4,2,168307,168307,168309,0,2,3
48030,1,1,168308,168309,168310,1,2,0
48031,2,3,168310,168310,168313,0,3,0
48032,4,1,168314,168314,168315,0,1,1
48033,5,2,168319,168319,168321,0,2,4
48034,1,2,168320,168321,168323,1,3,0
48035,3,1,168323,168323,168324,0,1,0
48036,4,1,168327,168327,168328,0,1,3
48037,3,2,168330,168330,168332,0,2,2
48038,5,1,168335,168335,168336,0,1,3
48039,1,2,168336,168336,168338,0,2,0
48040,3,3,168339,168339,168342,0,3,1
48041,1,2,168340,168342,168344,2,4,0
48042,4,1,168344,168344,168345,0,1,0
48043,1,2,168345,168345,168347,0,2,0
48044,4,1,168349,168349,168350,0,1,2
48045,1,2,168350,168350,168352,0,2,0
48046,2,2,168352,168352,168354,0,2,0
48047,6,3,168358,168358,168361,0,3,4
48048,5,3,168363,168363,168366,0,3,2
48049,1,1,168364,168366,168367,2,3,0
48050,3,1,168367,168367,168368,0,1,0
48051,4,2,168371,168371,168373,0,2,3
48052,3,3,168374,168374,168377,0,3,1
48053,2,2,168376,168377,168379,1,3,0
48054,5,1,168381,168381,168382,0,1,2
48055,3,1,168384,168384,168385,0,1,2
48056,4,2,168388,168388,168390,0,2,3
48057,1,3,168389,168390,168393,1,4,0
48058,2,1,168391,168393,168394,2,3,0
48059,4,2,168395,168395,168397,0,2,1
48060,4,2,168399,168399,168401,0,2,2
48061,1,1,168400,168401,168402,1,2,0
48062,2,3,168402,168402,168405,0,3,0
48063,5,3,168407,168407,168410,0,3,2
48064,1,1,168408,168410,168411,2,3,0
48065,4,3,168412,168412,168415,0,3,1
48066,6,2,168418,168418,168420,0,2,3
48067,6,3,168424,168424,168427,0,3,4
48068,3,1,168427,168427,168428,0,1,0
48069,5,3,168432,168432,168435,0,3,4
48070,4,2,168436,168436,168438,0,2,1
48071,6,3,168442,168442,168445,0,3,4
48072,6,2,168448,168448,168450,0,2,3
48073,2,2,168450,168450,168452,0,2,0
48074,5,1,168455,168455,168456,0,1,3
48075,5,1,168460,168460,168461,0,1,4
48076,5,1,168465,168465,168466,0,1,4
48077,6,1,168471,168471,168472,0,1,5
48078,4,2,168475,168475,168477,0,2,3
48079,1,3,168476,168477,168480,1,4,0
48080,4,2,168480,168480,168482,0,2,0
48081,2,3,168482,168482,168485,0,3,0
48082,6,3,168488,168488,168491,0,3,3
48083,6,3,168494,168494,168497,0,3,3
48084,2,2,168496,168497,168499,1,3,0
48085,4,2,168500,168500,168502,0,2,1
48086,5,1,168505,168505,168506,0,1,3
48087,4,1,168509,168509,168510,0,1,3
48088,2,3,168511,168511,168514,0,3,1
48089,3,2,168514,168514,168516,0,2,0
48090,6,2,168520,168520,168522,0,2,4
48091,5,3,168525,168525,168528,0,3,3
48092,1,3,168526,168528,168531,2,5,0
48093,3,2,168529,168531,168533,2,4,0
48094,6,1,168535,168535,168536,0,1,2
48095,3,3,168538,168538,168541,0,3,2
48096,3,1,168541,168541,168542,0,1,0
48097,6,3,168547,168547,168550,0,3,5
48098,1,2,168548,168550,168552,2,4,0
48099,2,3,168550,168552,168555,2,5,0
48100,6,2,168556,168556,168558,0,2,1
48101,6,1,168562,168562,168563,0,1,4
48102,3,1,168565,168565,168566,0,1,2
48103,6,3,168571,168571,168574,0,3,5
48104,6,2,168577,168577,168579,0,2,3
48105,1,3,168578,168579,168582,1,4,0
48106,5,1,168583,168583,168584,0,1,1
48107,6,2,168589,168589,168591,0,2,5
48108,5,3,168594,168594,168597,0,3,3
48109,3,3,168597,168597,168600,0,3,0
48110,2,3,168599,168600,168603,1,4,0
48111,3,1,168602,168603,168604,1,2,0
48112,4,2,168606,168606,168608,0,2,2
48113,1,3,168607,168608,168611,1,4,0
48114,1,2,168608,168611,168613,3,5,0
48115,6,3,168614,168614,168617,0,3,1
48116,4,3,168618,168618,168621,0,3,1
48117,6,3,168624,168624,168627,0,3,3
48118,2,1,168626,168627,168628,1,2,0
48119,6,2,168632,168632,168634,0,2,4
48120,3,2,168635,168635,168637,0,2,1
48121,4,3,168639,168639,168642,0,3,2
48122,2,1,168641,168642,168643,1,2,0
48123,1,2,168642,168643,168645,1,3,0
48124,3,2,168645,168645,168647,0,2,0
48125,3,3,168648,168648,168651,0,3,1
48126,4,3,168652,168652,168655,0,3,1
48127,1,3,168653,168655,168658,2,5,0
48128,3,2,168656,168658,168660,2,4,0
48129,3,1,168659,168660,168661,1,2,0
48130,5,1,168664,168664,168665,0,1,3
48131,5,2,168669,168669,168671,0,2,4
48132,2,2,168671,168671,168673,0,2,0
48133,5,2,168676,168676,168678,0,2,3
48134,6,2,168682,168682,168684,0,2,4
48135,2,3,168684,168684,168687,0,3,0
48136,1,3,168685,168687,168690,2,5,0
48137,3,3,168688,168690,168693,2,5,0
48138,4,2,168692,168693,168695,1,3,0
48139,3,1,168695,168695,168696,0,1,0
48140,6,3,168701,168701,168704,0,3,5
48141,3,1,168704,168704,168705,0,1,0
48142,3,2,168707,168707,168709,0,2,2
48143,4,1,168711,168711,168712,0,1,2
48144,1,1,168712,168712,168713,0,1,0
48145,5,3,168717,168717,168720,0,3,4
48146,5,1,168722,168722,168723,0,1,2
48147,2,2,168724,168724,168726,0,2,1
48148,1,1,168725,168726,168727,1,2,0
48149,5,2,168730,168730,168732,0,2,3
48150,4,3,168734,168734,168737,0,3,2
48151,1,2,168735,168737,168739,2,4,0
48152,1,2,168736,168739,168741,3,5,0
48153,2,3,168738,168741,168744,3,6,0
48154,2,3,168740,168744,168747,4,7,0
48155,3,2,168743,168747,168749,4,6,0
48156,4,1,168747,168749,168750,2,3,0
48157,6,2,168753,168753,168755,0,2,3
48158,6,1,168759,168759,168760,0,1,4
48159,3,1,168762,168762,168763,0,1,2
48160,4,1,168766,168766,168767,0,1,3
48161,4,3,168770,168770,168773,0,3,3
48162,5,2,168775,168775,168777,0,2,2
48163,1,3,168776,168777,168780,1,4,0
48164,6,3,168782,168782,168785,0,3,2
48165,6,3,168788,168788,168791,0,3,3
48166,6,1,168794,168794,168795,0,1,3
48167,3,2,168797,168797,168799,0,2,2
48168,3,1,168800,168800,168801,0,1,1
48169,6,1,168806,168806,168807,0,1,5
48170,5,3,168811,168811,168814,0,3,4
48171,5,3,168816,168816,168819,0,3,2
48172,4,3,168820,168820,168823,0,3,1
48173,6,2,168826,168826,168828,0,2,3
48174,4,1,168830,168830,168831,0,1,2
48175,3,2,168833,168833,168835,0,2,2
48176,2,2,168835,168835,168837,0,2,0
48177,6,3,168841,168841,168844,0,3,4
48178,5,2,168846,168846,168848,0,2,2
48179,6,2,168852,168852,168854,0,2,4
48180,3,2,168855,168855,168857,0,2,1
48181,6,3,168861,168861,168864,0,3,4
48182,6,3,168867,168867,168870,0,3,3
48183,3,2,168870,168870,168872,0,2,0
48184,2,3,168872,168872,168875,0,3,0
48185,4,3,168876,168876,168879,0,3,1
48186,3,3,168879,168879,168882,0,3,0
48187,4,1,168883,168883,168884,0,1,1
48188,5,1,168888,168888,168889,0,1,4
48189,6,3,168894,168894,168897,0,3,5
48190,6,3,168900,168900,168903,0,3,3
48191,2,1,168902,168903,168904,1,2,0
48192,1,1,168903,168904,168905,1,2,0
48193,5,2,168908,168908,168910,0,2,3
48194,1,2,168909,168910,168912,1,3,0
48195,1,1,168910,168912,168913,2,3,0
48196,3,1,168913,168913,168914,0,1,0
48197,3,3,168916,168916,168919,0,3,2
48198,4,2,168920,168920,168922,0,2,1
48199,4,1,168924,168924,168925,0,1,2
48200,1,2,168925,168925,168927,0,2,0
48201,4,2,168929,168929,168931,0,2,2
48202,5,2,168934,168934,168936,0,2,3
48203,5,2,168939,168939,168941,0,2,3
48204,4,2,168943,168943,168945,0,2,2
48205,3,1,168946,168946,168947,0,1,1
48206,4,2,168950,168950,168952,0,2,3
48207,1,1,168951,168952,168953,1,2,0
48208,1,1,168952,168953,168954,1,2,0
48209,4,3,168956,168956,168959,0,3,2
48210,6,1,168962,168962,168963,0,1,3
48211,5,3,168967,168967,168970,0,3,4
48212,6,1,168973,168973,168974,0,1,3
48213,1,2,168974,168974,168976,0,2,0
48214,6,2,168980,168980,168982,0,2,4
48215,3,3,168983,168983,168986,0,3,1
48216,6,2,168989,168989,168991,0,2,3
48217,6,2,168995,168995,168997,0,2,4
48218,4,3,168999,168999,169002,0,3,2
48219,3,2,169002,169002,169004,0,2,0
48220,1,1,169003,169004,169005,1,2,0
48221,2,2,169005,169005,169007,0,2,0
48222,2,3,169007,169007,169010,0,3,0
48223,3,3,169010,169010,169013,0,3,0
48224,4,3,169014,169014,169017,0,3,1
48225,6,2,169020,169020,169022,0,2,3
48226,6,3,169026,169026,169029,0,3,4
48227,3,1,169029,169029,169030,0,1,0
48228,3,3,169032,169032,169035,0,3,2
48229,2,1,169034,169035,169036,1,2,0
48230,6,2,169040,169040,169042,0,2,4
48231,2,3,169042,169042,169045,0,3,0
48232,5,3,169047,169047,169050,0,3,2
48233,1,3,169048,169050,169053,2,5,0
48234,1,2,169049,169053,169055,4,6,0
48235,2,1,169051,169055,169056,4,5,0
48236,6,1,169057,169057,169058,0,1,1
48237,6,2,169063,169063,169065,0,2,5
48238,3,3,169066,169066,169069,0,3,1
48239,4,1,169070,169070,169071,0,1,1
48240,1,3,169071,169071,169074,0,3,0
48241,5,1,169076,169076,169077,0,1,2
48242,6,2,169082,169082,169084,0,2,5
48243,6,3,169088,169088,169091,0,3,4
48244,4,2,169092,169092,169094,0,2,1
48245,5,1,169097,169097,169098,0,1,3
48246,6,1,169103,169103,169104,0,1,5
48247,4,2,169107,169107,169109,0,2,3
48248,4,2,169111,169111,169113,0,2,2
48249,3,2,169114,169114,169116,0,2,1
48250,1,1,169115,169116,169117,1,2,0
48251,3,2,169118,169118,169120,0,2,1
48252,5,1,169123,169123,169124,0,1,3
48253,3,2,169126,169126,169128,0,2,2
48254,3,2,169129,169129,169131,0,2,1
48255,5,1,169134,169134,169135,0,1,3
48256,1,1,169135,169135,169136,0,1,0
48257,3,3,169138,169138,169141,0,3,2
48258,2,1,169140,169141,169142,1,2,0
48259,5,2,169145,169145,169147,0,2,3
48260,6,1,169151,169151,169152,0,1,4
48261,5,1,169156,169156,169157,0,1,4
48262,1,2,169157,169157,169159,0,2,0
48263,5,1,169162,169162,169163,0,1,3
48264,2,2,169164,169164,169166,0,2,1
48265,3,1,169167,169167,169168,0,1,1
48266,6,3,169173,169173,169176,0,3,5
48267,5,1,169178,169178,169179,0,1,2
48268,6,2,169184,169184,169186,0,2,5
48269,1,2,169185,169186,169188,1,3,0
48270,4,2,169189,169189,169191,0,2,1
48271,6,1,169195,169195,169196,0,1,4
48272,5,2,169200,169200,169202,0,2,4
48273,6,2,169206,169206,169208,0,2,4
48274,1,1,169207,169208,169209,1,2,0
48275,2,3,169209,169209,169212,0,3,0
48276,4,2,169213,169213,169215,0,2,1
48277,5,2,169218,169218,169220,0,2,3
48278,6,3,169224,169224,169227,0,3,4
48279,4,2,169228,169228,169230,0,2,1
48280,6,1,169234,169234,169235,0,1,4
48281,1,1,169235,169235,169236,0,1,0
48282,3,3,169238,169238,169241,0,3,2
48283,4,3,169242,169242,169245,0,3,1
48284,4,1,169246,169246,169247,0,1,1
48285,6,3,169252,169252,169255,0,3,5
48286,2,2,169254,169255,169257,1,3,0
48287,4,3,169258,169258,169261,0,3,1
48288,5,3,169263,169263,169266,0,3,2
48289,3,1,169266,169266,169267,0,1,0
48290,6,1,169272,169272,169273,0,1,5
48291,6,2,169278,169278,169280,0,2,5
48292,1,1,169279,169280,169281,1,2,0
48293,2,1,169281,169281,169282,0,1,0
48294,2,2,169283,169283,169285,0,2,1
48295,3,2,169286,169286,169288,0,2,1
48296,6,2,169292,169292,169294,0,2,4
48297,5,1,169297,169297,169298,0,1,3
48298,4,3,169301,169301,169304,0,3,3
48299,4,2,169305,169305,169307,0,2,1
48300,1,1,169306,169307,169308,1,2,0
48301,2,1,169308,169308,169309,0,1,0
48302,6,1,169314,169314,169315,0,1,5
48303,4,1,169318,169318,169319,0,1,3
48304,5,1,169323,169323,169324,0,1,4
48305,3,2,169326,169326,169328,0,2,2
48306,1,1,169327,169328,169329,1,2,0
48307,4,2,169331,169331,169333,0,2,2
48308,3,1,169334,169334,169335,0,1,1
48309,6,1,169340,169340,169341,0,1,5
48310,1,1,169341,169341,169342,0,1,0
48311,3,3,169344,169344,169347,0,3,2
48312,5,3,169349,169349,169352,0,3,2
48313,2,2,169351,169352,169354,1,3,0
48314,3,1,169354,169354,169355,0,1,0
48315,4,2,169358,169358,169360,0,2,3
48316,6,3,169364,169364,169367,0,3,4
48317,1,1,169365,169367,169368,2,3,0
48318,4,2,169369,169369,169371,0,2,1
48319,2,1,169371,169371,169372,0,1,0
48320,3,3,169374,169374,169377,0,3,2
48321,3,1,169377,169377,169378,0,1,0
48322,2,1,169379,169379,169380,0,1,1
48323,4,3,169383,169383,169386,0,3,3
48324,3,1,169386,169386,169387,0,1,0
48325,3,1,169389,169389,169390,0,1,2
48326,4,1,169393,169393,169394,0,1,3
48327,6,3,169399,169399,169402,0,3,5
48328,6,1,169405,169405,169406,0,1,3
48329,4,1,169409,169409,169410,0,1,3
48330,5,1,169414,169414,169415,0,1,4
48331,4,3,169418,169418,169421,0,3,3
48332,5,3,169423,169423,169426,0,3,2
48333,6,1,169429,169429,169430,0,1,3
48334,2,1,169431,169431,169432,0,1,1
48335,4,1,169435,169435,169436,0,1,3
48336,1,2,169436,169436,169438,0,2,0
48337,5,3,169441,169441,169444,0,3,3
48338,3,1,169444,169444,169445,0,1,0
48339,3,3,169447,169447,169450,0,3,2
48340,4,1,169451,169451,169452,0,1,1
48341,3,3,169454,169454,169457,0,3,2
48342,3,2,169457,169457,169459,0,2,0
48343,4,2,169461,169461,169463,0,2,2
48344,4,1,169465,169465,169466,0,1,2
48345,5,1,169470,169470,169471,0,1,4
48346,1,2,169471,169471,169473,0,2,0
48347,2,2,169473,169473,169475,0,2,0
48348,1,1,169474,169475,169476,1,2,0
48349,1,3,169475,169476,169479,1,4,0
48350,2,3,169477,169479,169482,2,5,0
48351,5,2,169482,169482,169484,0,2,0
48352,6,3,169488,169488,169491,0,3,4
48353,3,3,169491,169491,169494,0,3,0
48354,3,1,169494,169494,169495,0,1,0
48355,1,3,169495,169495,169498,0,3,0
48356,6,3,169501,169501,169504,0,3,3
48357,2,1,169503,169504,169505,1,2,0
48358,4,1,169507,169507,169508,0,1,2
48359,4,1,169511,169511,169512,0,1,3
48360,3,3,169514,169514,169517,0,3,2
48361,3,2,169517,169517,169519,0,2,0
48362,5,3,169522,169522,169525,0,3,3
48363,4,1,169526,169526,169527,0,1,1
48364,3,2,169529,169529,169531,0,2,2
48365,6,2,169535,169535,169537,0,2,4
48366,1,1,169536,169537,169538,1,2,0
48367,6,3,169542,169542,169545,0,3,4
48368,6,1,169548,169548,169549,0,1,3
48369,5,1,169553,169553,169554,0,1,4
48370,6,3,169559,169559,169562,0,3,5
48371,5,1,169564,169564,169565,0,1,2
48372,4,1,169568,169568,169569,0,1,3
48373,3,1,169571,169571,169572,0,1,2
48374,5,3,169576,169576,169579,0,3,4
48375,1,1,169577,169579,169580,2,3,0
48376,4,1,169581,169581,169582,0,1,1
48377,1,2,169582,169582,169584,0,2,0
48378,4,1,169586,169586,169587,0,1,2
48379,4,2,169590,169590,169592,0,2,3
48380,1,3,169591,169592,169595,1,4,0
48381,3,2,169594,169595,169597,1,3,0
48382,4,3,169598,169598,169601,0,3,1
48383,5,2,169603,169603,169605,0,2,2
48384,2,1,169605,169605,169606,0,1,0
48385,2,2,169607,169607,169609,0,2,1
48386,5,2,169612,169612,169614,0,2,3
48387,5,1,169617,169617,169618,0,1,3
48388,1,3,169618,169618,169621,0,3,0
48389,1,1,169619,169621,169622,2,3,0
48390,1,3,169620,169622,169625,2,5,0
48391,3,2,169623,169625,169627,2,4,0
48392,4,2,169627,169627,169629,0,2,0
48393,3,3,169630,169630,169633,0,3,1
48394,5,3,169635,169635,169638,0,3,2
48395,2,2,169637,169638,169640,1,3,0
48396,2,1,169639,169640,169641,1,2,0
48397,2,2,169641,169641,169643,0,2,0
48398,6,3,169647,169647,169650,0,3,4
48399,6,1,169653,169653,169654,0,1,3
48400,3,2,169656,169656,169658,0,2,2
48401,5,3,169661,169661,169664,0,3,3
48402,5,3,169666,169666,169669,0,3,2
48403,2,2,169668,169669,169671,1,3,0
48404,6,2,169674,169674,169676,0,2,3
48405,5,3,169679,169679,169682,0,3,3
48406,1,1,169680,169682,169683,2,3,0
48407,6,3,169686,169686,169689,0,3,3
48408,3,1,169689,169689,169690,0,1,0
48409,1,3,169690,169690,169693,0,3,0
48410,4,3,169694,169694,169697,0,3,1
48411,4,2,169698,169698,169700,0,2,1
48412,4,1,169702,169702,169703,0,1,2
48413,3,1,169705,169705,169706,0,1,2
48414,2,1,169707,169707,169708,0,1,1
48415,3,1,169710,169710,169711,0,1,2
48416,5,2,169715,169715,169717,0,2,4
48417,5,3,169720,169720,169723,0,3,3
48418,6,1,169726,169726,169727,0,1,3
48419,2,3,169728,169728,169731,0,3,1
48420,6,1,169734,169734,169735,0,1,3
48421,4,3,169738,169738,169741,0,3,3
48422,2,3,169740,169741,169744,1,4,0
48423,3,3,169743,169744,169747,1,4,0
48424,6,3,169749,169749,169752,0,3,2
48425,5,3,169754,169754,169757,0,3,2
48426,1,1,169755,169757,169758,2,3,0
48427,4,3,169759,169759,169762,0,3,1
48428,6,3,169765,169765,169768,0,3,3
48429,4,2,169769,169769,169771,0,2,1
48430,2,1,169771,169771,169772,0,1,0
48431,1,3,169772,169772,169775,0,3,0
48432,2,3,169774,169775,169778,1,4,0
48433,4,3,169778,169778,169781,0,3,0
48434,1,2,169779,169781,169783,2,4,0
48435,4,1,169783,169783,169784,0,1,0
48436,4,3,169787,169787,169790,0,3,3
48437,6,1,169793,169793,169794,0,1,3
48438,1,1,169794,169794,169795,0,1,0
48439,5,1,169799,169799,169800,0,1,4
48440,5,1,169804,169804,169805,0,1,4
48441,1,1,169805,169805,169806,0,1,0
48442,3,1,169808,169808,169809,0,1,2
48443,3,3,169811,169811,169814,0,3,2
48444,2,1,169813,169814,169815,1,2,0
48445,2,1,169815,169815,169816,0,1,0
48446,2,2,169817,169817,169819,0,2,1
48447,4,3,169821,169821,169824,0,3,2
48448,4,1,169825,169825,169826,0,1,1
48449,3,1,169828,169828,169829,0,1,2
48450,5,1,169833,169833,169834,0,1,4
48451,5,3,169838,169838,169841,0,3,4
48452,2,3,169840,169841,169844,1,4,0
48453,6,2,169846,169846,169848,0,2,2
48454,3,1,169849,169849,169850,0,1,1
48455,4,1,169853,169853,169854,0,1,3
48456,4,1,169857,169857,169858,0,1,3
48457,5,3,169862,169862,169865,0,3,4
48458,5,2,169867,169867,169869,0,2,2
48459,5,2,169872,169872,169874,0,2,3
48460,1,2,169873,169874,169876,1,3,0
48461,2,1,169875,169876,169877,1,2,0
48462,2,1,169877,169877,169878,0,1,0
48463,1,3,169878,169878,169881,0,3,0
48464,4,2,169882,169882,169884,0,2,1
48465,2,2,169884,169884,169886,0,2,0
48466,4,3,169888,169888,169891,0,3,2
48467,4,1,169892,169892,169893,0,1,1
48468,6,3,169898,169898,169901,0,3,5
48469,2,1,169900,169901,169902,1,2,0
48470,6,2,169906,169906,169908,0,2,4
48471,1,2,169907,169908,169910,1,3,0
48472,3,2,169910,169910,169912,0,2,0
48473,3,3,169913,169913,169916,0,3,1
48474,2,1,169915,169916,169917,1,2,0
48475,5,3,169920,169920,169923,0,3,3
48476,2,2,169922,169923,169925,1,3,0
48477,5,1,169927,169927,169928,0,1,2
48478,5,2,169932,169932,169934,0,2,4
48479,6,1,169938,169938,169939,0,1,4
48480,6,1,169944,169944,169945,0,1,5
48481,5,3,169949,169949,169952,0,3,4
48482,4,3,169953,169953,169956,0,3,1
48483,4,3,169957,169957,169960,0,3,1
48484,2,1,169959,169960,169961,1,2,0
48485,5,3,169964,169964,169967,0,3,3
48486,5,2,169969,169969,169971,0,2,2
48487,3,1,169972,169972,169973,0,1,1
48488,2,1,169974,169974,169975,0,1,1
48489,3,1,169977,169977,169978,0,1,2
48490,4,3,169981,169981,169984,0,3,3
48491,3,1,169984,169984,169985,0,1,0
48492,5,3,169989,169989,169992,0,3,4
48493,4,1,169993,169993,169994,0,1,1
48494,4,3,169997,169997,170000,0,3,3
48495,5,1,170002,170002,170003,0,1,2
48496,5,1,170007,170007,170008,0,1,4
48497,3,3,170010,170010,170013,0,3,2
48498,6,3,170016,170016,170019,0,3,3
48499,6,1,170022,170022,170023,0,1,3
48500,6,1,170028,170028,170029,0,1,5
48501,4,2,170032,170032,170034,0,2,3
48502,6,3,170038,170038,170041,0,3,4
48503,3,3,170041,170041,170044,0,3,0
48504,6,1,170047,170047,170048,0,1,3
48505,3,1,170050,170050,170051,0,1,2
48506,2,1,170052,170052,170053,0,1,1
48507,6,1,170058,170058,170059,0,1,5
48508,3,1,170061,170061,170062,0,1,2
48509,3,1,170064,170064,170065,0,1,2
48510,4,3,170068,170068,170071,0,3,3
48511,3,2,170071,170071,170073,0,2,0
48512,6,1,170077,170077,170078,0,1,4
48513,4,3,170081,170081,170084,0,3,3
48514,1,1,170082,170084,170085,2,3,0
48515,2,2,170084,170085,170087,1,3,0
48516,4,2,170088,170088,170090,0,2,1
48517,4,2,170092,170092,170094,0,2,2
48518,4,2,170096,170096,170098,0,2,2
48519,5,2,170101,170101,170103,0,2,3
48520,5,1,170106,170106,170107,0,1,3
48521,1,1,170107,170107,170108,0,1,0
48522,3,3,170110,170110,170113,0,3,2
48523,3,2,170113,170113,170115,0,2,0
48524,5,1,170118,170118,170119,0,1,3
48525,2,3,170120,170120,170123,0,3,1
48526,5,3,170125,170125,170128,0,3,2
48527,2,2,170127,170128,170130,1,3,0
48528,5,2,170132,170132,170134,0,2,2
48529,1,2,170133,170134,170136,1,3,0
48530,3,1,170136,170136,170137,0,1,0
48531,2,1,170138,170138,170139,0,1,1
48532,5,1,170143,170143,170144,0,1,4
48533,5,3,170148,170148,170151,0,3,4
48534,6,3,170154,170154,170157,0,3,3
48535,1,3,170155,170157,170160,2,5,0
48536,4,2,170159,170160,170162,1,3,0
48537,1,1,170160,170162,170163,2,3,0
48538,5,1,170165,170165,170166,0,1,2
48539,1,2,170166,170166,170168,0,2,0
48540,2,2,170168,170168,170170,0,2,0
48541,5,3,170173,170173,170176,0,3,3
48542,1,2,170174,170176,170178,2,4,0
48543,1,2,170175,170178,170180,3,5,0
48544,3,1,170178,170180,170181,2,3,0
48545,3,3,170181,170181,170184,0,3,0
48546,3,1,170184,170184,170185,0,1,0
48547,5,1,170189,170189,170190,0,1,4
48548,6,2,170195,170195,170197,0,2,5
48549,3,1,170198,170198,170199,0,1,1
48550,4,1,170202,170202,170203,0,1,3
48551,5,2,170207,170207,170209,0,2,4
48552,1,2,170208,170209,170211,1,3,0
48553,6,2,170214,170214,170216,0,2,3
48554,3,2,170217,170217,170219,0,2,1
48555,2,1,170219,170219,170220,0,1,0
48556,5,3,170224,170224,170227,0,3,4
48557,1,3,170225,170227,170230,2,5,0
48558,5,3,170230,170230,170233,0,3,0
48559,1,2,170231,170233,170235,2,4,0
48560,4,1,170235,170235,170236,0,1,0
48561,2,1,170237,170237,170238,0,1,1
48562,4,3,170241,170241,170244,0,3,3
48563,5,1,170246,170246,170247,0,1,2
48564,6,2,170252,170252,170254,0,2,5
48565,1,3,170253,170254,170257,1,4,0
48566,6,3,170259,170259,170262,0,3,2
48567,1,2,170260,170262,170264,2,4,0
48568,4,2,170264,170264,170266,0,2,0
48569,6,2,170270,170270,170272,0,2,4
48570,6,1,170276,170276,170277,0,1,4
48571,2,1,170278,170278,170279,0,1,1
48572,4,1,170282,170282,170283,0,1,3
48573,6,1,170288,170288,170289,0,1,5
48574,3,3,170291,170291,170294,0,3,2
48575,3,1,170294,170294,170295,0,1,0
48576,4,2,170298,170298,170300,0,2,3
48577,5,2,170303,170303,170305,0,2,3
48578,6,3,170309,170309,170312,0,3,4
48579,5,3,170314,170314,170317,0,3,2
48580,1,3,170315,170317,170320,2,5,0
48581,4,2,170319,170320,170322,1,3,0
48582,3,2,170322,170322,170324,0,2,0
48583,5,3,170327,170327,170330,0,3,3
48584,2,3,170329,170330,170333,1,4,0
48585,6,2,170335,170335,170337,0,2,2
48586,2,2,170337,170337,170339,0,2,0
48587,3,1,170340,170340,170341,0,1,1
48588,1,2,170341,170341,170343,0,2,0
48589,3,3,170344,170344,170347,0,3,1
48590,2,2,170346,170347,170349,1,3,0
48591,4,2,170350,170350,170352,0,2,1
48592,2,1,170352,170352,170353,0,1,0
48593,3,3,170355,170355,170358,0,3,2
48594,2,3,170357,170358,170361,1,4,0
48595,4,3,170361,170361,170364,0,3,0
48596,2,2,170363,170364,170366,1,3,0
48597,2,1,170365,170366,170367,1,2,0
48598,6,1,170371,170371,170372,0,1,4
48599,3,3,170374,170374,170377,0,3,2
48600,1,3,170375,170377,170380,2,5,0
48601,2,2,170377,170380,170382,3,5,0
48602,6,3,170383,170383,170386,0,3,1
48603,6,3,170389,170389,170392,0,3,3
48604,1,1,170390,170392,170393,2,3,0
48605,4,2,170394,170394,170396,0,2,1
48606,1,1,170395,170396,170397,1,2,0
48607,3,1,170398,170398,170399,0,1,1
48608,3,3,170401,170401,170404,0,3,2
48609,2,3,170403,170404,170407,1,4,0
48610,5,3,170408,170408,170411,0,3,1
48611,6,1,170414,170414,170415,0,1,3
48612,4,1,170418,170418,170419,0,1,3
48613,2,2,170420,170420,170422,0,2,1
48614,2,1,170422,170422,170423,0,1,0
48615,3,1,170425,170425,170426,0,1,2
48616,6,1,170431,170431,170432,0,1,5
48617,6,3,170437,170437,170440,0,3,5
48618,5,2,170442,170442,170444,0,2,2
48619,3,2,170445,170445,170447,0,2,1
48620,3,2,170448,170448,170450,0,2,1
48621,4,2,170452,170452,170454,0,2,2
48622,6,1,170458,170458,170459,0,1,4
48623,6,3,170464,170464,170467,0,3,5
48624,6,2,170470,170470,170472,0,2,3
48625,6,1,170476,170476,170477,0,1,4
48626,2,3,170478,170478,170481,0,3,1
48627,3,2,170481,170481,170483,0,2,0
48628,1,1,170482,170483,170484,1,2,0
48629,4,1,170486,170486,170487,0,1,2
48630,3,2,170489,170489,170491,0,2,2
48631,1,3,170490,170491,170494,1,4,0
48632,1,1,170491,170494,170495,3,4,0
48633,2,3,170493,170495,170498,2,5,0
48634,5,1,170498,170498,170499,0,1,0
48635,3,3,170501,170501,170504,0,3,2
48636,4,1,170505,170505,170506,0,1,1
48637,2,1,170507,170507,170508,0,1,1
48638,3,3,170510,170510,170513,0,3,2
48639,2,1,170512,170513,170514,1,2,0
48640,1,1,170513,170514,170515,1,2,0
48641,2,3,170515,170515,170518,0,3,0
48642,3,2,170518,170518,170520,0,2,0
48643,4,1,170522,170522,170523,0,1,2
48644,6,1,170528,170528,170529,0,1,5
48645,5,1,170533,170533,170534,0,1,4
48646,2,1,170535,170535,170536,0,1,1
48647,3,3,170538,170538,170541,0,3,2
48648,1,3,170539,170541,170544,2,5,0
48649,2,2,170541,170544,170546,3,5,0
48650,1,3,170542,170546,170549,4,7,0
48651,2,1,170544,170549,170550,5,6,0
48652,6,1,170550,170550,170551,0,1,0
48653,6,1,170556,170556,170557,0,1,5
48654,2,1,170558,170558,170559,0,1,1
48655,4,3,170562,170562,170565,0,3,3
48656,2,2,170564,170565,170567,1,3,0
48657,2,3,170566,170567,170570,1,4,0
48658,4,1,170570,170570,170571,0,1,0
48659,3,1,170573,170573,170574,0,1,2
48660,6,2,170579,170579,170581,0,2,5
48661,3,3,170582,170582,170585,0,3,1
48662,4,1,170586,170586,170587,0,1,1
48663,5,3,170591,170591,170594,0,3,4
48664,2,3,170593,170594,170597,1,4,0
48665,6,1,170599,170599,170600,0,1,2
48666,4,1,170603,170603,170604,0,1,3
48667,6,1,170609,170609,170610,0,1,5
48668,2,1,170611,170611,170612,0,1,1
48669,1,2,170612,170612,170614,0,2,0
48670,2,3,170614,170614,170617,0,3,0
48671,1,3,170615,170617,170620,2,5,0
48672,5,3,170620,170620,170623,0,3,0
48673,1,1,170621,170623,170624,2,3,0
48674,4,2,170625,170625,170627,0,2,1
48675,6,2,170631,170631,170633,0,2,4
48676,6,1,170637,170637,170638,0,1,4
48677,6,3,170643,170643,170646,0,3,5
48678,5,1,170648,170648,170649,0,1,2
48679,3,2,170651,170651,170653,0,2,2
48680,3,2,170654,170654,170656,0,2,1
48681,4,3,170658,170658,170661,0,3,2
48682,6,2,170664,170664,170666,0,2,3
48683,3,3,170667,170667,170670,0,3,1
48684,1,3,170668,170670,170673,2,5,0
48685,2,1,170670,170673,170674,3,4,0
48686,2,3,170672,170674,170677,2,5,0
48687,6,3,170678,170678,170681,0,3,1
48688,4,3,170682,170682,170685,0,3,1
48689,1,1,170683,170685,170686,2,3,0
48690,4,1,170687,170687,170688,0,1,1
48691,6,2,170693,170693,170695,0,2,5
48692,2,3,170695,170695,170698,0,3,0
48693,5,3,170700,170700,170703,0,3,2
48694,3,2,170703,170703,170705,0,2,0
48695,2,3,170705,170705,170708,0,3,0
48696,3,3,170708,170708,170711,0,3,0
48697,3,1,170711,170711,170712,0,1,0
48698,3,1,170714,170714,170715,0,1,2
48699,3,3,170717,170717,170720,0,3,2
48700,2,3,170719,170720,170723,1,4,0
48701,4,2,170723,170723,170725,0,2,0
48702,6,2,170729,170729,170731,0,2,4
48703,2,3,170731,170731,170734,0,3,0
48704,4,2,170735,170735,170737,0,2,1
48705,1,3,170736,170737,170740,1,4,0
48706,6,1,170742,170742,170743,0,1,2
48707,4,1,170746,170746,170747,0,1,3
48708,6,3,170752,170752,170755,0,3,5
48709,2,2,170754,170755,170757,1,3,0
48710,2,3,170756,170757,170760,1,4,0
48711,6,2,170762,170762,170764,0,2,2
48712,5,2,170767,170767,170769,0,2,3
48713,3,3,170770,170770,170773,0,3,1
48714,3,1,170773,170773,170774,0,1,0
48715,5,3,170778,170778,170781,0,3,4
48716,1,2,170779,170781,170783,2,4,0
48717,3,1,170782,170783,170784,1,2,0
48718,2,3,170784,170784,170787,0,3,0
48719,4,1,170788,170788,170789,0,1,1
48720,2,3,170790,170790,170793,0,3,1
48721,4,3,170794,170794,170797,0,3,1
48722,1,3,170795,170797,170800,2,5,0
48723,4,3,170799,170800,170803,1,4,0
48724,5,2,170804,170804,170806,0,2,1
48725,1,1,170805,170806,170807,1,2,0
48726,2,1,170807,170807,170808,0,1,0
48727,3,3,170810,170810,170813,0,3,2
48728,1,2,170811,170813,170815,2,4,0
48729,3,3,170814,170815,170818,1,4,0
48730,1,1,170815,170818,170819,3,4,0
48731,6,2,170821,170821,170823,0,2,2
48732,5,2,170826,170826,170828,0,2,3
48733,5,2,170831,170831,170833,0,2,3
48734,3,1,170834,170834,170835,0,1,1
48735,6,3,170840,170840,170843,0,3,5
48736,5,3,170845,170845,170848,0,3,2
48737,5,1,170850,170850,170851,0,1,2
48738,4,2,170854,170854,170856,0,2,3
48739,2,3,170856,170856,170859,0,3,0
48740,6,3,170862,170862,170865,0,3,3
48741,4,2,170866,170866,170868,0,2,1
48742,3,3,170869,170869,170872,0,3,1
48743,4,3,170873,170873,170876,0,3,1
48744,6,1,170879,170879,170880,0,1,3
48745,2,1,170881,170881,170882,0,1,1
48746,3,3,170884,170884,170887,0,3,2
48747,1,1,170885,170887,170888,2,3,0
48748,4,2,170889,170889,170891,0,2,1
48749,1,2,170890,170891,170893,1,3,0
48750,2,1,170892,170893,170894,1,2,0
48751,3,1,170895,170895,170896,0,1,1
48752,1,2,170896,170896,170898,0,2,0
48753,4,2,170900,170900,170902,0,2,2
48754,3,2,170903,170903,170905,0,2,1
48755,2,1,170905,170905,170906,0,1,0
48756,5,1,170910,170910,170911,0,1,4
48757,6,1,170916,170916,170917,0,1,5
48758,2,3,170918,170918,170921,0,3,1
48759,3,2,170921,170921,170923,0,2,0
48760,6,3,170927,170927,170930,0,3,4
48761,6,2,170933,170933,170935,0,2,3
48762,3,3,170936,170936,170939,0,3,1
48763,4,3,170940,170940,170943,0,3,1
48764,1,2,170941,170943,170945,2,4,0
48765,2,3,170943,170945,170948,2,5,0
48766,4,3,170947,170948,170951,1,4,0
48767,1,1,170948,170951,170952,3,4,0
48768,2,2,170950,170952,170954,2,4,0
48769,3,3,170953,170954,170957,1,4,0
48770,2,3,170955,170957,170960,2,5,0
48771,6,1,170961,170961,170962,0,1,1
48772,4,2,170965,170965,170967,0,2,3
48773,6,3,170971,170971,170974,0,3,4
48774,1,3,170972,170974,170977,2,5,0
48775,3,1,170975,170977,170978,2,3,0
48776,6,1,170981,170981,170982,0,1,3
48777,1,3,170982,170982,170985,0,3,0
48778,3,2,170985,170985,170987,0,2,0
48779,5,2,170990,170990,170992,0,2,3
48780,2,3,170992,170992,170995,0,3,0
48781,3,3,170995,170995,170998,0,3,0
48782,3,3,170998,170998,171001,0,3,0
48783,3,1,171001,171001,171002,0,1,0
48784,6,1,171007,171007,171008,0,1,5
48785,2,2,171009,171009,171011,0,2,1
48786,6,3,171015,171015,171018,0,3,4
48787,6,1,171021,171021,171022,0,1,3
48788,2,2,171023,171023,171025,0,2,1
48789,3,3,171026,171026,171029,0,3,1
48790,6,3,171032,171032,171035,0,3,3
48791,3,3,171035,171035,171038,0,3,0
48792,5,1,171040,171040,171041,0,1,2
48793,4,1,171044,171044,171045,0,1,3
48794,1,2,171045,171045,171047,0,2,0
48795,4,3,171049,171049,171052,0,3,2
48796,4,1,171053,171053,171054,0,1,1
48797,6,3,171059,171059,171062,0,3,5
48798,1,3,171060,171062,171065,2,5,0
48799,3,3,171063,171065,171068,2,5,0
48800,2,2,171065,171068,171070,3,5,0
48801,1,2,171066,171070,171072,4,6,0
48802,5,1,171071,171072,171073,1,2,0
48803,5,3,171076,171076,171079,0,3,3
48804,4,1,171080,171080,171081,0,1,1
48805,3,2,171083,171083,171085,0,2,2
48806,6,3,171089,171089,171092,0,3,4
48807,1,1,171090,171092,171093,2,3,0
48808,5,1,171095,171095,171096,0,1,2
48809,4,3,171099,171099,171102,0,3,3
48810,3,3,171102,171102,171105,0,3,0
48811,2,3,171104,171105,171108,1,4,0
48812,1,3,171105,171108,171111,3,6,0
48813,6,2,171111,171111,171113,0,2,0
48814,2,1,171113,171113,171114,0,1,0
48815,2,1,171115,171115,171116,0,1,1
48816,2,1,171117,171117,171118,0,1,1
48817,5,3,171122,171122,171125,0,3,4
48818,1,3,171123,171125,171128,2,5,0
48819,4,2,171127,171128,171130,1,3,0
48820,5,3,171132,171132,171135,0,3,2
48821,5,3,171137,171137,171140,0,3,2
48822,5,3,171142,171142,171145,0,3,2
48823,6,1,171148,171148,171149,0,1,3
48824,4,2,171152,171152,171154,0,2,3
48825,2,1,171154,171154,171155,0,1,0
48826,6,2,171160,171160,171162,0,2,5
48827,3,3,171163,171163,171166,0,3,1
48828,6,2,171169,171169,171171,0,2,3
48829,3,2,171172,171172,171174,0,2,1
48830,3,1,171175,171175,171176,0,1,1
48831,3,1,171178,171178,171179,0,1,2
48832,4,2,171182,171182,171184,0,2,3
48833,4,1,171186,171186,171187,0,1,2
48834,3,3,171189,171189,171192,0,3,2
48835,4,3,171193,171193,171196,0,3,1
48836,5,2,171198,171198,171200,0,2,2
48837,1,3,171199,171200,171203,1,4,0
48838,1,1,171200,171203,171204,3,4,0
48839,3,2,171203,171204,171206,1,3,0
48840,1,3,171204,171206,171209,2,5,0
48841,1,2,171205,171209,171211,4,6,0
48842,2,1,171207,171211,171212,4,5,0
48843,3,1,171210,171212,171213,2,3,0
48844,6,1,171216,171216,171217,0,1,3
48845,6,3,171222,171222,171225,0,3,5
48846,6,1,171228,171228,171229,0,1,3
48847,1,3,171229,171229,171232,0,3,0
48848,3,2,171232,171232,171234,0,2,0
48849,6,3,171238,171238,171241,0,3,4
48850,1,3,171239,171241,171244,2,5,0
48851,5,3,171244,171244,171247,0,3,0
48852,6,3,171250,171250,171253,0,3,3
48853,1,2,171251,171253,171255,2,4,0
48854,5,2,171256,171256,171258,0,2,1
48855,1,2,171257,171258,171260,1,3,0
48856,6,3,171263,171263,171266,0,3,3
48857,4,3,171267,171267,171270,0,3,1
48858,6,2,171273,171273,171275,0,2,3
48859,2,2,171275,171275,171277,0,2,0
48860,3,2,171278,171278,171280,0,2,1
48861,5,2,171283,171283,171285,0,2,3
48862,6,3,171289,171289,171292,0,3,4
48863,4,3,171293,171293,171296,0,3,1
48864,6,2,171299,171299,171301,0,2,3
48865,4,2,171303,171303,171305,0,2,2
48866,6,2,171309,171309,171311,0,2,4
48867,1,2,171310,171311,171313,1,3,0
48868,3,3,171313,171313,171316,0,3,0
48869,4,3,171317,171317,171320,0,3,1
48870,2,2,171319,171320,171322,1,3,0
48871,2,2,171321,171322,171324,1,3,0
48872,1,3,171322,171324,171327,2,5,0
48873,3,3,171325,171327,171330,2,5,0
48874,4,2,171329,171330,171332,1,3,0
48875,1,3,171330,171332,171335,2,5,0
48876,4,1,171334,171335,171336,1,2,0
48877,6,2,171340,171340,171342,0,2,4
48878,2,1,171342,171342,171343,0,1,0
48879,4,1,171346,171346,171347,0,1,3
48880,4,2,171350,171350,171352,0,2,3
48881,6,2,171356,171356,171358,0,2,4
48882,1,1,171357,171358,171359,1,2,0
48883,5,1,171362,171362,171363,0,1,3
48884,1,1,171363,171363,171364,0,1,0
48885,2,3,171365,171365,171368,0,3,1
48886,2,2,171367,171368,171370,1,3,0
48887,4,2,171371,171371,171373,0,2,1
48888,6,2,171377,171377,171379,0,2,4
48889,4,2,171381,171381,171383,0,2,2
48890,1,2,171382,171383,171385,1,3,0
48891,4,3,171386,171386,171389,0,3,1
48892,6,1,171392,171392,171393,0,1,3
48893,4,2,171396,171396,171398,0,2,3
48894,2,3,171398,171398,171401,0,3,0
48895,3,3,171401,171401,171404,0,3,0
48896,3,3,171404,171404,171407,0,3,0
48897,2,1,171406,171407,171408,1,2,0
48898,5,2,171411,171411,171413,0,2,3
48899,2,3,171413,171413,171416,0,3,0
48900,4,3,171417,171417,171420,0,3,1
48901,4,3,171421,171421,171424,0,3,1
48902,3,2,171424,171424,171426,0,2,0
48903,4,1,171428,171428,171429,0,1,2
48904,6,2,171434,171434,171436,0,2,5
48905,4,3,171438,171438,171441,0,3,2
48906,1,3,171439,171441,171444,2,5,0
48907,3,1,171442,171444,171445,2,3,0
48908,5,3,171447,171447,171450,0,3,2
48909,6,3,171453,171453,171456,0,3,3
48910,2,1,171455,171456,171457,1,2,0
48911,5,1,171460,171460,171461,0,1,3
48912,5,3,171465,171465,171468,0,3,4
48913,6,1,171471,171471,171472,0,1,3
48914,3,1,171474,171474,171475,0,1,2
48915,1,3,171475,171475,171478,0,3,0
48916,5,2,171480,171480,171482,0,2,2
48917,5,2,171485,171485,171487,0,2,3
48918,6,3,171491,171491,171494,0,3,4
48919,6,2,171497,171497,171499,0,2,3
48920,6,2,171503,171503,171505,0,2,4
48921,3,3,171506,171506,171509,0,3,1
48922,6,2,171512,171512,171514,0,2,3
48923,1,3,171513,171514,171517,1,4,0
48924,6,1,171519,171519,171520,0,1,2
48925,1,2,171520,171520,171522,0,2,0
48926,6,3,171526,171526,171529,0,3,4
48927,4,3,171530,171530,171533,0,3,1
48928,5,2,171535,171535,171537,0,2,2
48929,3,3,171538,171538,171541,0,3,1
48930,5,3,171543,171543,171546,0,3,2
48931,5,3,171548,171548,171551,0,3,2
48932,4,3,171552,171552,171555,0,3,1
48933,5,1,171557,171557,171558,0,1,2
48934,2,1,171559,171559,171560,0,1,1
48935,3,1,171562,171562,171563,0,1,2
48936,3,1,171565,171565,171566,0,1,2
48937,2,1,171567,171567,171568,0,1,1
48938,4,3,171571,171571,171574,0,3,3
48939,1,1,171572,171574,171575,2,3,0
48940,1,3,171573,171575,171578,2,5,0
48941,4,2,171577,171578,171580,1,3,0
48942,1,3,171578,171580,171583,2,5,0
48943,2,3,171580,171583,171586,3,6,0
48944,3,3,171583,171586,171589,3,6,0
48945,1,2,171584,171589,171591,5,7,0
48946,1,1,171585,171591,171592,6,7,0
48947,4,1,171589,171592,171593,3,4,0
48948,4,2,171593,171593,171595,0,2,0
48949,6,3,171599,171599,171602,0,3,4
48950,5,2,171604,171604,171606,0,2,2
48951,6,3,171610,171610,171613,0,3,4
48952,5,2,171615,171615,171617,0,2,2
48953,1,2,171616,171617,171619,1,3,0
48954,4,3,171620,171620,171623,0,3,1
48955,1,3,171621,171623,171626,2,5,0
48956,5,3,171626,171626,171629,0,3,0
48957,1,2,171627,171629,171631,2,4,0
48958,1,1,171628,171631,171632,3,4,0
48959,5,2,171633,171633,171635,0,2,1
48960,3,1,171636,171636,171637,0,1,1
48961,1,3,171637,171637,171640,0,3,0
48962,1,3,171638,171640,171643,2,5,0
48963,2,1,171640,171643,171644,3,4,0
48964,5,1,171645,171645,171646,0,1,1
48965,6,2,171651,171651,171653,0,2,5
48966,1,2,171652,171653,171655,1,3,0
48967,4,2,171656,171656,171658,0,2,1
48968,4,1,171660,171660,171661,0,1,2
48969,1,1,171661,171661,171662,0,1,0
48970,3,1,171664,171664,171665,0,1,2
48971,4,1,171668,171668,171669,0,1,3
48972,2,1,171670,171670,171671,0,1,1
48973,1,2,171671,171671,171673,0,2,0
48974,5,2,171676,171676,171678,0,2,3
48975,5,2,171681,171681,171683,0,2,3
48976,5,2,171686,171686,171688,0,2,3
48977,1,2,171687,171688,171690,1,3,0
48978,6,2,171693,171693,171695,0,2,3
48979,4,2,171697,171697,171699,0,2,2
48980,5,3,171702,171702,171705,0,3,3
48981,1,2,171703,171705,171707,2,4,0
48982,4,1,171707,171707,171708,0,1,0
48983,3,2,171710,171710,171712,0,2,2
48984,1,2,171711,171712,171714,1,3,0
48985,1,2,171712,171714,171716,2,4,0
48986,5,3,171717,171717,171720,0,3,1
48987,5,1,171722,171722,171723,0,1,2
48988,2,1,171724,171724,171725,0,1,1
48989,6,2,171730,171730,171732,0,2,5
48990,6,1,171736,171736,171737,0,1,4
48991,5,2,171741,171741,171743,0,2,4
48992,2,2,171743,171743,171745,0,2,0
48993,2,2,171745,171745,171747,0,2,0
48994,1,1,171746,171747,171748,1,2,0
48995,6,3,171752,171752,171755,0,3,4
48996,6,3,171758,171758,171761,0,3,3
48997,4,2,171762,171762,171764,0,2,1
48998,3,3,171765,171765,171768,0,3,1
48999,4,2,171769,171769,171771,0,2,1
49000,2,3,171771,171771,171774,0,3,0
49001,2,1,171773,171774,171775,1,2,0
49002,4,1,171777,171777,171778,0,1,2
49003,1,3,171778,171778,171781,0,3,0
49004,5,2,171783,171783,171785,0,2,2
49005,2,3,171785,171785,171788,0,3,0
49006,6,1,171791,171791,171792,0,1,3
49007,5,3,171796,171796,171799,0,3,4
49008,2,2,171798,171799,171801,1,3,0
49009,5,3,171803,171803,171806,0,3,2
49010,2,1,171805,171806,171807,1,2,0
49011,2,1,171807,171807,171808,0,1,0
49012,6,2,171813,171813,171815,0,2,5
49013,2,1,171815,171815,171816,0,1,0
49014,2,1,171817,171817,171818,0,1,1
49015,6,1,171823,171823,171824,0,1,5
49016,6,3,171829,171829,171832,0,3,5
49017,3,1,171832,171832,171833,0,1,0
49018,6,1,171838,171838,171839,0,1,5
49019,6,3,171844,171844,171847,0,3,5
49020,5,2,171849,171849,171851,0,2,2
49021,5,3,171854,171854,171857,0,3,3
49022,2,3,171856,171857,171860,1,4,0
49023,5,2,171861,171861,171863,0,2,1
49024,4,3,171865,171865,171868,0,3,2
49025,4,2,171869,171869,171871,0,2,1
49026,6,3,171875,171875,171878,0,3,4
49027,5,2,171880,171880,171882,0,2,2
49028,5,1,171885,171885,171886,0,1,3
49029,6,2,171891,171891,171893,0,2,5
49030,1,1,171892,171893,171894,1,2,0
49031,1,2,171893,171894,171896,1,3,0
49032,4,2,171897,171897,171899,0,2,1
49033,6,1,171903,171903,171904,0,1,4
49034,6,2,171909,171909,171911,0,2,5
49035,3,2,171912,171912,171914,0,2,1
49036,4,3,171916,171916,171919,0,3,2
49037,6,2,171922,171922,171924,0,2,3
49038,3,2,171925,171925,171927,0,2,1
49039,1,1,171926,171927,171928,1,2,0
49040,5,1,171931,171931,171932,0,1,3
49041,5,1,171936,171936,171937,0,1,4
49042,5,1,171941,171941,171942,0,1,4
49043,5,1,171946,171946,171947,0,1,4
49044,1,3,171947,171947,171950,0,3,0
49045,5,1,171952,171952,171953,0,1,2
49046,3,1,171955,171955,171956,0,1,2
49047,6,2,171961,171961,171963,0,2,5
49048,6,3,171967,171967,171970,0,3,4
49049,5,1,171972,171972,171973,0,1,2
49050,5,1,171977,171977,171978,0,1,4
49051,1,3,171978,171978,171981,0,3,0
49052,6,3,171984,171984,171987,0,3,3
49053,3,2,171987,171987,171989,0,2,0
49054,4,3,171991,171991,171994,0,3,2
49055,1,3,171992,171994,171997,2,5,0
49056,6,1,171998,171998,171999,0,1,1
49057,3,1,172001,172001,172002,0,1,2
49058,2,3,172003,172003,172006,0,3,1
49059,3,3,172006,172006,172009,0,3,0
49060,5,3,172011,172011,172014,0,3,2
49061,6,1,172017,172017,172018,0,1,3
49062,4,1,172021,172021,172022,0,1,3
49063,3,1,172024,172024,172025,0,1,2
49064,5,3,172029,172029,172032,0,3,4
49065,6,1,172035,172035,172036,0,1,3
49066,2,3,172037,172037,172040,0,3,1
49067,3,1,172040,172040,172041,0,1,0
49068,6,2,172046,172046,172048,0,2,5
49069,1,3,172047,172048,172051,1,4,0
49070,1,1,172048,172051,172052,3,4,0
49071,4,2,172052,172052,172054,0,2,0
49072,6,3,172058,172058,172061,0,3,4
49073,5,1,172063,172063,172064,0,1,2
49074,1,1,172064,172064,172065,0,1,0
49075,3,3,172067,172067,172070,0,3,2
49076,3,3,172070,172070,172073,0,3,0
49077,5,2,172075,172075,172077,0,2,2
49078,5,3,172080,172080,172083,0,3,3
49079,3,2,172083,172083,172085,0,2,0
49080,6,2,172089,172089,172091,0,2,4
49081,2,3,172091,172091,172094,0,3,0
49082,2,1,172093,172094,172095,1,2,0
49083,4,1,172097,172097,172098,0,1,2
49084,5,1,172102,172102,172103,0,1,4
49085,3,1,172105,172105,172106,0,1,2
49086,5,3,172110,172110,172113,0,3,4
49087,1,2,172111,172113,172115,2,4,0
49088,2,2,172113,172115,172117,2,4,0
49089,3,2,172116,172117,172119,1,3,0
49090,3,3,172119,172119,172122,0,3,0
49091,5,3,172124,172124,172127,0,3,2
49092,1,1,172125,172127,172128,2,3,0
49093,1,1,172126,172128,172129,2,3,0
49094,1,2,172127,172129,172131,2,4,0
49095,1,3,172128,172131,172134,3,6,0
49096,2,2,172130,172134,172136,4,6,0
49097,1,2,172131,172136,172138,5,7,0
49098,3,1,172134,172138,172139,4,5,0
49099,6,2,172140,172140,172142,0,2,1
49100,3,1,172143,172143,172144,0,1,1
49101,6,3,172149,172149,172152,0,3,5
49102,2,2,172151,172152,172154,1,3,0
49103,3,2,172154,172154,172156,0,2,0
49104,2,3,172156,172156,172159,0,3,0
49105,5,1,172161,172161,172162,0,1,2
49106,4,1,172165,172165,172166,0,1,3
49107,5,1,172170,172170,172171,0,1,4
49108,6,2,172176,172176,172178,0,2,5
49109,5,3,172181,172181,172184,0,3,3
49110,3,2,172184,172184,172186,0,2,0
49111,3,1,172187,172187,172188,0,1,1
49112,3,3,172190,172190,172193,0,3,2
49113,1,3,172191,172193,172196,2,5,0
49114,1,3,172192,172196,172199,4,7,0
49115,6,1,172198,172199,172200,1,2,0
49116,6,2,172204,172204,172206,0,2,4
49117,2,3,172206,172206,172209,0,3,0
49118,1,3,172207,172209,172212,2,5,0
49119,1,3,172208,172212,172215,4,7,0
49120,6,1,172214,172215,172216,1,2,0
49121,1,2,172215,172216,172218,1,3,0
49122,5,2,172220,172220,172222,0,2,2
49123,6,1,172226,172226,172227,0,1,4
49124,4,1,172230,172230,172231,0,1,3
49125,2,1,172232,172232,172233,0,1,1
49126,4,2,172236,172236,172238,0,2,3
49127,1,3,172237,172238,172241,1,4,0
49128,1,3,172238,172241,172244,3,6,0
49129,5,2,172243,172244,172246,1,3,0
49130,6,3,172249,172249,172252,0,3,3
49131,1,1,172250,172252,172253,2,3,0
49132,4,3,172254,172254,172257,0,3,1
49133,5,3,172259,172259,172262,0,3,2
49134,5,1,172264,172264,172265,0,1,2
49135,2,3,172266,172266,172269,0,3,1
49136,5,2,172271,172271,172273,0,2,2
49137,4,2,172275,172275,172277,0,2,2
49138,3,2,172278,172278,172280,0,2,1
49139,3,1,172281,172281,172282,0,1,1
49140,4,2,172285,172285,172287,0,2,3
49141,5,1,172290,172290,172291,0,1,3
49142,4,1,172294,172294,172295,0,1,3
49143,5,2,172299,172299,172301,0,2,4
49144,3,2,172302,172302,172304,0,2,1
49145,1,1,172303,172304,172305,1,2,0
49146,1,3,172304,172305,172308,1,4,0
49147,3,3,172307,172308,172311,1,4,0
49148,6,3,172313,172313,172316,0,3,2
49149,2,2,172315,172316,172318,1,3,0
49150,2,3,172317,172318,172321,1,4,0
49151,1,2,172318,172321,172323,3,5,0
49152,4,2,172322,172323,172325,1,3,0
49153,1,3,172323,172325,172328,2,5,0
49154,2,2,172325,172328,172330,3,5,0
49155,2,1,172327,172330,172331,3,4,0
49156,1,1,172328,172331,172332,3,4,0
49157,5,3,172333,172333,172336,0,3,1
49158,6,3,172339,172339,172342,0,3,3
49159,1,2,172340,172342,172344,2,4,0
49160,1,2,172341,172344,172346,3,5,0
49161,6,3,172347,172347,172350,0,3,1
49162,1,2,172348,172350,172352,2,4,0
49163,4,1,172352,172352,172353,0,1,0
49164,1,2,172353,172353,172355,0,2,0
49165,5,2,172358,172358,172360,0,2,3
49166,5,3,172363,172363,172366,0,3,3
49167,4,1,172367,172367,172368,0,1,1
49168,6,1,172373,172373,172374,0,1,5
49169,3,1,172376,172376,172377,0,1,2
49170,1,2,172377,172377,172379,0,2,0
49171,4,2,172381,172381,172383,0,2,2
49172,2,3,172383,172383,172386,0,3,0
49173,3,1,172386,172386,172387,0,1,0
49174,6,2,172392,172392,172394,0,2,5
49175,2,3,172394,172394,172397,0,3,0
49176,6,1,172400,172400,172401,0,1,3
49177,6,2,172406,172406,172408,0,2,5
49178,1,2,172407,172408,172410,1,3,0
49179,5,2,172412,172412,172414,0,2,2
49180,1,2,172413,172414,172416,1,3,0
49181,5,2,172418,172418,172420,0,2,2
49182,4,1,172422,172422,172423,0,1,2
49183,5,3,172427,172427,172430,0,3,4
49184,1,1,172428,172430,172431,2,3,0
49185,1,1,172429,172431,172432,2,3,0
49186,2,2,172431,172432,172434,1,3,0
49187,6,3,172437,172437,172440,0,3,3
49188,1,3,172438,172440,172443,2,5,0
49189,5,1,172443,172443,172444,0,1,0
49190,1,3,172444,172444,172447,0,3,0
49191,3,2,172447,172447,172449,0,2,0
49192,4,3,172451,172451,172454,0,3,2
49193,5,2,172456,172456,172458,0,2,2
49194,5,1,172461,172461,172462,0,1,3
49195,4,1,172465,172465,172466,0,1,3
49196,5,2,172470,172470,172472,0,2,4
49197,2,3,172472,172472,172475,0,3,0
49198,1,1,172473,172475,172476,2,3,0
49199,5,1,172478,172478,172479,0,1,2
49200,2,2,172480,172480,172482,0,2,1
49201,5,3,172485,172485,172488,0,3,3
49202,2,2,172487,172488,172490,1,3,0
49203,5,3,172492,172492,172495,0,3,2
49204,5,1,172497,172497,172498,0,1,2
49205,5,1,172502,172502,172503,0,1,4
49206,3,1,172505,172505,172506,0,1,2
49207,6,3,172511,172511,172514,0,3,5
49208,6,3,172517,172517,172520,0,3,3
49209,1,3,172518,172520,172523,2,5,0
49210,1,3,172519,172523,172526,4,7,0
49211,1,3,172520,172526,172529,6,9,0
49212,5,2,172525,172529,172531,4,6,0
49213,5,2,172530,172531,172533,1,3,0
49214,3,2,172533,172533,172535,0,2,0
49215,1,3,172534,172535,172538,1,4,0
49216,1,3,172535,172538,172541,3,6,0
49217,3,1,172538,172541,172542,3,4,0
49218,2,2,172540,172542,172544,2,4,0
49219,3,1,172543,172544,172545,1,2,0
49220,5,1,172548,172548,172549,0,1,3
49221,6,1,172554,172554,172555,0,1,5
49222,4,1,172558,172558,172559,0,1,3
49223,1,3,172559,172559,172562,0,3,0
49224,1,1,172560,172562,172563,2,3,0
49225,1,2,172561,172563,172565,2,4,0
49226,5,2,172566,172566,172568,0,2,1
49227,3,2,172569,172569,172571,0,2,1
49228,3,2,172572,172572,172574,0,2,1
49229,2,2,172574,172574,172576,0,2,0
49230,1,3,172575,172576,172579,1,4,0
49231,4,1,172579,172579,172580,0,1,0
49232,3,3,172582,172582,172585,0,3,2
49233,6,3,172588,172588,172591,0,3,3
49234,3,3,172591,172591,172594,0,3,0
49235,2,1,172593,172594,172595,1,2,0
49236,5,2,172598,172598,172600,0,2,3
49237,2,2,172600,172600,172602,0,2,0
49238,3,3,172603,172603,172606,0,3,1
49239,4,2,172607,172607,172609,0,2,1
49240,6,3,172613,172613,172616,0,3,4
49241,3,2,172616,172616,172618,0,2,0
49242,3,1,172619,172619,172620,0,1,1
49243,1,1,172620,172620,172621,0,1,0
49244,1,1,172621,172621,172622,0,1,0
49245,6,3,172627,172627,172630,0,3,5
49246,2,2,172629,172630,172632,1,3,0
49247,4,3,172633,172633,172636,0,3,1
49248,6,1,172639,172639,172640,0,1,3
49249,5,3,172644,172644,172647,0,3,4
49250,2,2,172646,172647,172649,1,3,0
49251,4,3,172650,172650,172653,0,3,1
49252,4,2,172654,172654,172656,0,2,1
49253,6,3,172660,172660,172663,0,3,4
49254,2,1,172662,172663,172664,1,2,0
49255,4,1,172666,172666,172667,0,1,2
49256,2,2,172668,172668,172670,0,2,1
49257,5,1,172673,172673,172674,0,1,3
49258,6,2,172679,172679,172681,0,2,5
49259,5,1,172684,172684,172685,0,1,3
49260,4,2,172688,172688,172690,0,2,3
49261,2,1,172690,172690,172691,0,1,0
49262,1,3,172691,172691,172694,0,3,0
49263,6,3,172697,172697,172700,0,3,3
49264,1,1,172698,172700,172701,2,3,0
49265,2,2,172700,172701,172703,1,3,0
49266,4,2,172704,172704,172706,0,2,1
49267,5,3,172709,172709,172712,0,3,3
49268,1,3,172710,172712,172715,2,5,0
49269,5,2,172715,172715,172717,0,2,0
49270,2,3,172717,172717,172720,0,3,0
49271,2,3,172719,172720,172723,1,4,0
49272,6,1,172725,172725,172726,0,1,2
49273,3,3,172728,172728,172731,0,3,2
49274,1,1,172729,172731,172732,2,3,0
49275,4,2,172733,172733,172735,0,2,1
49276,4,3,172737,172737,172740,0,3,2
49277,5,1,172742,172742,172743,0,1,2
49278,4,1,172746,172746,172747,0,1,3
49279,3,1,172749,172749,172750,0,1,2
49280,6,3,172755,172755,172758,0,3,5
49281,4,1,172759,172759,172760,0,1,1
49282,2,1,172761,172761,172762,0,1,1
49283,2,2,172763,172763,172765,0,2,1
49284,1,3,172764,172765,172768,1,4,0
49285,3,1,172767,172768,172769,1,2,0
49286,5,1,172772,172772,172773,0,1,3
49287,4,3,172776,172776,172779,0,3,3
49288,4,2,172780,172780,172782,0,2,1
49289,6,2,172786,172786,172788,0,2,4
49290,6,1,172792,172792,172793,0,1,4
49291,5,1,172797,172797,172798,0,1,4
49292,1,1,172798,172798,172799,0,1,0
49293,4,2,172802,172802,172804,0,2,3
49294,1,2,172803,172804,172806,1,3,0
49295,2,1,172805,172806,172807,1,2,0
49296,3,3,172808,172808,172811,0,3,1
49297,2,3,172810,172811,172814,1,4,0
49298,4,3,172814,172814,172817,0,3,0
49299,4,2,172818,172818,172820,0,2,1
49300,5,3,172823,172823,172826,0,3,3
49301,5,2,172828,172828,172830,0,2,2
49302,2,3,172830,172830,172833,0,3,0
49303,6,2,172836,172836,172838,0,2,3
49304,1,2,172837,172838,172840,1,3,0
49305,3,2,172840,172840,172842,0,2,0
49306,5,2,172845,172845,172847,0,2,3
49307,4,1,172849,172849,172850,0,1,2
49308,3,2,172852,172852,172854,0,2,2
49309,3,2,172855,172855,172857,0,2,1
49310,1,1,172856,172857,172858,1,2,0
49311,1,1,172857,172858,172859,1,2,0
49312,1,3,172858,172859,172862,1,4,0
49313,1,1,172859,172862,172863,3,4,0
49314,1,3,172860,172863,172866,3,6,0
49315,6,2,172866,172866,172868,0,2,0
49316,5,3,172871,172871,172874,0,3,3
49317,1,3,172872,172874,172877,2,5,0
49318,5,1,172877,172877,172878,0,1,0
49319,1,2,172878,172878,172880,0,2,0
49320,1,3,172879,172880,172883,1,4,0
49321,2,2,172881,172883,172885,2,4,0
49322,1,2,172882,172885,172887,3,5,0
49323,6,3,172888,172888,172891,0,3,1
49324,5,1,172893,172893,172894,0,1,2
49325,4,3,172897,172897,172900,0,3,3
49326,5,2,172902,172902,172904,0,2,2
49327,2,3,172904,172904,172907,0,3,0
49328,3,1,172907,172907,172908,0,1,0
49329,2,3,172909,172909,172912,0,3,1
49330,5,2,172914,172914,172916,0,2,2
49331,5,1,172919,172919,172920,0,1,3
49332,6,2,172925,172925,172927,0,2,5
49333,1,3,172926,172927,172930,1,4,0
49334,6,2,172932,172932,172934,0,2,2
49335,1,3,172933,172934,172937,1,4,0
49336,6,3,172939,172939,172942,0,3,2
49337,5,3,172944,172944,172947,0,3,2
49338,6,2,172950,172950,172952,0,2,3
49339,3,1,172953,172953,172954,0,1,1
49340,1,2,172954,172954,172956,0,2,0
49341,6,1,172960,172960,172961,0,1,4
49342,3,3,172963,172963,172966,0,3,2
49343,5,1,172968,172968,172969,0,1,2
49344,6,3,172974,172974,172977,0,3,5
49345,2,1,172976,172977,172978,1,2,0
49346,3,3,172979,172979,172982,0,3,1
49347,3,2,172982,172982,172984,0,2,0
49348,1,2,172983,172984,172986,1,3,0
49349,2,2,172985,172986,172988,1,3,0
49350,1,3,172986,172988,172991,2,5,0
49351,2,2,172988,172991,172993,3,5,0
49352,6,2,172994,172994,172996,0,2,1
49353,1,1,172995,172996,172997,1,2,0
49354,1,1,172996,172997,172998,1,2,0
49355,5,2,173001,173001,173003,0,2,3
49356,2,2,173003,173003,173005,0,2,0
49357,2,2,173005,173005,173007,0,2,0
49358,1,3,173006,173007,173010,1,4,0
49359,5,3,173011,173011,173014,0,3,1
49360,2,1,173013,173014,173015,1,2,0
49361,1,1,173014,173015,173016,1,2,0
49362,1,3,173015,173016,173019,1,4,0
49363,4,3,173019,173019,173022,0,3,0
49364,2,3,173021,173022,173025,1,4,0
49365,2,1,173023,173025,173026,2,3,0
49366,3,1,173026,173026,173027,0,1,0
49367,2,1,173028,173028,173029,0,1,1
49368,1,2,173029,173029,173031,0,2,0
49369,2,2,173031,173031,173033,0,2,0
49370,3,3,173034,173034,173037,0,3,1
49371,1,3,173035,173037,173040,2,5,0
49372,4,2,173039,173040,173042,1,3,0
49373,1,3,173040,173042,173045,2,5,0
49374,4,2,173044,173045,173047,1,3,0
49375,6,1,173050,173050,173051,0,1,3
49376,2,1,173052,173052,173053,0,1,1
49377,2,2,173054,173054,173056,0,2,1
49378,3,3,173057,173057,173060,0,3,1
49379,2,1,173059,173060,173061,1,2,0
49380,2,3,173061,173061,173064,0,3,0
49381,2,2,173063,173064,173066,1,3,0
49382,3,3,173066,173066,173069,0,3,0
49383,3,1,173069,173069,173070,0,1,0
49384,1,1,173070,173070,173071,0,1,0
49385,3,3,173073,173073,173076,0,3,2
49386,2,1,173075,173076,173077,1,2,0
49387,5,3,173080,173080,173083,0,3,3
49388,3,3,173083,173083,173086,0,3,0
49389,3,1,173086,173086,173087,0,1,0
49390,2,3,173088,173088,173091,0,3,1
49391,3,1,173091,173091,173092,0,1,0
49392,5,2,173096,173096,173098,0,2,4
49393,5,3,173101,173101,173104,0,3,3
49394,6,1,173107,173107,173108,0,1,3
49395,3,1,173110,173110,173111,0,1,2
49396,1,1,173111,173111,173112,0,1,0
49397,3,2,173114,173114,173116,0,2,2
49398,2,1,173116,173116,173117,0,1,0
49399,4,1,173120,173120,173121,0,1,3
49400,2,2,173122,173122,173124,0,2,1
49401,4,3,173126,173126,173129,0,3,2
49402,5,1,173131,173131,173132,0,1,2
49403,3,1,173134,173134,173135,0,1,2
49404,3,2,173137,173137,173139,0,2,2
49405,4,1,173141,173141,173142,0,1,2
49406,2,2,173143,173143,173145,0,2,1
49407,2,2,173145,173145,173147,0,2,0
49408,1,3,173146,173147,173150,1,4,0
49409,2,3,173148,173150,173153,2,5,0
49410,3,2,173151,173153,173155,2,4,0
49411,6,1,173157,173157,173158,0,1,2
49412,3,2,173160,173160,173162,0,2,2
49413,5,3,173165,173165,173168,0,3,3
49414,1,3,173166,173168,173171,2,5,0
49415,1,3,173167,173171,173174,4,7,0
49416,3,3,173170,173174,173177,4,7,0
49417,6,1,173176,173177,173178,1,2,0
49418,3,2,173179,173179,173181,0,2,1
49419,1,3,173180,173181,173184,1,4,0
49420,1,2,173181,173184,173186,3,5,0
49421,1,2,173182,173186,173188,4,6,0
49422,4,2,173186,173188,173190,2,4,0
49423,4,2,173190,173190,173192,0,2,0
49424,1,3,173191,173192,173195,1,4,0
49425,6,3,173197,173197,173200,0,3,2
49426,2,2,173199,173200,173202,1,3,0
49427,5,2,173204,173204,173206,0,2,2
49428,4,3,173208,173208,173211,0,3,2
49429,4,1,173212,173212,173213,0,1,1
49430,3,3,173215,173215,173218,0,3,2
49431,6,3,173221,173221,173224,0,3,3
49432,6,1,173227,173227,173228,0,1,3
49433,5,3,173232,173232,173235,0,3,4
49434,2,1,173234,173235,173236,1,2,0
49435,1,1,173235,173236,173237,1,2,0
49436,6,2,173241,173241,173243,0,2,4
49437,6,3,173247,173247,173250,0,3,4
49438,6,1,173253,173253,173254,0,1,3
49439,6,2,173259,173259,173261,0,2,5
49440,6,1,173265,173265,173266,0,1,4
49441,1,2,173266,173266,173268,0,2,0
49442,4,2,173270,173270,173272,0,2,2
49443,2,3,173272,173272,173275,0,3,0
49444,2,2,173274,173275,173277,1,3,0
49445,6,2,173280,173280,173282,0,2,3
49446,6,2,173286,173286,173288,0,2,4
49447,6,3,173292,173292,173295,0,3,4
49448,5,1,173297,173297,173298,0,1,2
49449,2,3,173299,173299,173302,0,3,1
49450,1,2,173300,173302,173304,2,4,0
49451,5,1,173305,173305,173306,0,1,1
49452,1,3,173306,173306,173309,0,3,0
49453,5,2,173311,173311,173313,0,2,2
49454,1,3,173312,173313,173316,1,4,0
49455,3,3,173315,173316,173319,1,4,0
49456,3,1,173318,173319,173320,1,2,0
49457,2,3,173320,173320,173323,0,3,0
49458,4,3,173324,173324,173327,0,3,1
49459,5,2,173329,173329,173331,0,2,2
49460,1,2,173330,173331,173333,1,3,0
49461,4,2,173334,173334,173336,0,2,1
49462,2,3,173336,173336,173339,0,3,0
49463,1,3,173337,173339,173342,2,5,0
49464,4,1,173341,173342,173343,1,2,0
49465,6,1,173347,173347,173348,0,1,4
49466,2,3,173349,173349,173352,0,3,1
49467,5,2,173354,173354,173356,0,2,2
49468,6,2,173360,173360,173362,0,2,4
49469,4,2,173364,173364,173366,0,2,2
49470,4,1,173368,173368,173369,0,1,2
49471,5,3,173373,173373,173376,0,3,4
49472,5,1,173378,173378,173379,0,1,2
49473,3,1,173381,173381,173382,0,1,2
49474,6,2,173387,173387,173389,0,2,5
49475,1,1,173388,173389,173390,1,2,0
49476,6,1,173394,173394,173395,0,1,4
49477,2,1,173396,173396,173397,0,1,1
49478,3,1,173399,173399,173400,0,1,2
49479,5,3,173404,173404,173407,0,3,4
49480,1,1,173405,173407,173408,2,3,0
49481,6,2,173411,173411,173413,0,2,3
49482,2,2,173413,173413,173415,0,2,0
49483,2,3,173415,173415,173418,0,3,0
49484,2,2,173417,173418,173420,1,3,0
49485,1,1,173418,173420,173421,2,3,0
49486,6,2,173424,173424,173426,0,2,3
49487,1,2,173425,173426,173428,1,3,0
49488,1,1,173426,173428,173429,2,3,0
49489,1,3,173427,173429,173432,2,5,0
49490,1,3,173428,173432,173435,4,7,0
49491,5,3,173433,173435,173438,2,5,0
49492,5,1,173438,173438,173439,0,1,0
49493,3,2,173441,173441,173443,0,2,2
49494,4,2,173445,173445,173447,0,2,2
49495,4,1,173449,173449,173450,0,1,2
49496,3,3,173452,173452,173455,0,3,2
49497,1,1,173453,173455,173456,2,3,0
49498,3,1,173456,173456,173457,0,1,0
49499,2,3,173458,173458,173461,0,3,1
49500,6,1,173464,173464,173465,0,1,3
49501,1,1,173465,173465,173466,0,1,0
49502,4,1,173469,173469,173470,0,1,3
49503,2,3,173471,173471,173474,0,3,1
49504,5,3,173476,173476,173479,0,3,2
49505,2,2,173478,173479,173481,1,3,0
49506,2,2,173480,173481,173483,1,3,0
49507,3,3,173483,173483,173486,0,3,0
49508,1,3,173484,173486,173489,2,5,0
49509,2,1,173486,173489,173490,3,4,0
49510,1,1,173487,173490,173491,3,4,0
49511,6,3,173493,173493,173496,0,3,2
49512,6,3,173499,173499,173502,0,3,3
49513,5,2,173504,173504,173506,0,2,2
49514,1,3,173505,173506,173509,1,4,0
49515,1,2,173506,173509,173511,3,5,0
49516,5,1,173511,173511,173512,0,1,0
49517,4,1,173515,173515,173516,0,1,3
49518,3,1,173518,173518,173519,0,1,2
49519,2,1,173520,173520,173521,0,1,1
49520,2,3,173522,173522,173525,0,3,1
49521,1,2,173523,173525,173527,2,4,0
49522,4,3,173527,173527,173530,0,3,0
49523,3,3,173530,173530,173533,0,3,0
49524,4,2,173534,173534,173536,0,2,1
49525,6,3,173540,173540,173543,0,3,4
49526,4,2,173544,173544,173546,0,2,1
49527,2,1,173546,173546,173547,0,1,0
49528,4,3,173550,173550,173553,0,3,3
49529,2,2,173552,173553,173555,1,3,0
49530,2,2,173554,173555,173557,1,3,0
49531,3,1,173557,173557,173558,0,1,0
49532,3,1,173560,173560,173561,0,1,2
49533,4,1,173564,173564,173565,0,1,3
49534,2,1,173566,173566,173567,0,1,1
49535,2,1,173568,173568,173569,0,1,1
49536,2,2,173570,173570,173572,0,2,1
49537,5,3,173575,173575,173578,0,3,3
49538,2,3,173577,173578,173581,1,4,0
49539,2,1,173579,173581,173582,2,3,0
49540,3,1,173582,173582,173583,0,1,0
49541,6,3,173588,173588,173591,0,3,5
49542,6,3,173594,173594,173597,0,3,3
49543,3,3,173597,173597,173600,0,3,0
49544,2,2,173599,173600,173602,1,3,0
49545,5,1,173604,173604,173605,0,1,2
49546,6,3,173610,173610,173613,0,3,5
49547,6,2,173616,173616,173618,0,2,3
49548,6,3,173622,173622,173625,0,3,4
49549,3,3,173625,173625,173628,0,3,0
49550,2,1,173627,173628,173629,1,2,0
49551,1,2,173628,173629,173631,1,3,0
49552,2,2,173630,173631,173633,1,3,0
49553,4,2,173634,173634,173636,0,2,1
49554,4,3,173638,173638,173641,0,3,2
49555,4,2,173642,173642,173644,0,2,1
49556,1,1,173643,173644,173645,1,2,0
49557,1,3,173644,173645,173648,1,4,0
49558,1,2,173645,173648,173650,3,5,0
49559,4,1,173649,173650,173651,1,2,0
49560,4,2,173653,173653,173655,0,2,2
49561,4,3,173657,173657,173660,0,3,2
49562,2,1,173659,173660,173661,1,2,0
49563,3,1,173662,173662,173663,0,1,1
49564,2,1,173664,173664,173665,0,1,1
49565,2,2,173666,173666,173668,0,2,1
49566,6,3,173672,173672,173675,0,3,4
49567,4,2,173676,173676,173678,0,2,1
49568,6,1,173682,173682,173683,0,1,4
49569,3,2,173685,173685,173687,0,2,2
49570,4,1,173689,173689,173690,0,1,2
49571,1,3,173690,173690,173693,0,3,0
49572,3,1,173693,173693,173694,0,1,0
49573,2,1,173695,173695,173696,0,1,1
49574,4,3,173699,173699,173702,0,3,3
49575,6,1,173705,173705,173706,0,1,3
49576,3,1,173708,173708,173709,0,1,2
49577,5,2,173713,173713,173715,0,2,4
49578,2,1,173715,173715,173716,0,1,0
49579,5,3,173720,173720,173723,0,3,4
49580,2,2,173722,173723,173725,1,3,0
49581,2,1,173724,173725,173726,1,2,0
49582,5,1,173729,173729,173730,0,1,3
49583,3,1,173732,173732,173733,0,1,2
49584,5,2,173737,173737,173739,0,2,4
49585,6,3,173743,173743,173746,0,3,4
49586,3,1,173746,173746,173747,0,1,0
49587,1,2,173747,173747,173749,0,2,0
49588,1,3,173748,173749,173752,1,4,0
49589,5,1,173753,173753,173754,0,1,1
49590,2,1,173755,173755,173756,0,1,1
49591,2,2,173757,173757,173759,0,2,1
49592,1,3,173758,173759,173762,1,4,0
49593,6,1,173764,173764,173765,0,1,2
49594,3,2,173767,173767,173769,0,2,2
49595,6,2,173773,173773,173775,0,2,4
49596,2,2,173775,173775,173777,0,2,0
49597,2,3,173777,173777,173780,0,3,0
49598,1,3,173778,173780,173783,2,5,0
49599,4,1,173782,173783,173784,1,2,0
49600,5,3,173787,173787,173790,0,3,3
49601,3,2,173790,173790,173792,0,2,0
49602,4,1,173794,173794,173795,0,1,2
49603,3,2,173797,173797,173799,0,2,2
49604,4,1,173801,173801,173802,0,1,2
49605,6,2,173807,173807,173809,0,2,5
49606,5,1,173812,173812,173813,0,1,3
49607,3,3,173815,173815,173818,0,3,2
49608,4,2,173819,173819,173821,0,2,1
49609,4,1,173823,173823,173824,0,1,2
49610,5,3,173828,173828,173831,0,3,4
49611,4,2,173832,173832,173834,0,2,1
49612,4,1,173836,173836,173837,0,1,2
49613,4,1,173840,173840,173841,0,1,3
49614,5,3,173845,173845,173848,0,3,4
49615,5,2,173850,173850,173852,0,2,2
49616,5,2,173855,173855,173857,0,2,3
49617,2,3,173857,173857,173860,0,3,0
49618,5,3,173862,173862,173865,0,3,2
49619,5,3,173867,173867,173870,0,3,2
49620,1,1,173868,173870,173871,2,3,0
49621,2,2,173870,173871,173873,1,3,0
49622,6,3,173876,173876,173879,0,3,3
49623,6,3,173882,173882,173885,0,3,3
49624,3,3,173885,173885,173888,0,3,0
49625,2,3,173887,173888,173891,1,4,0
49626,5,1,173892,173892,173893,0,1,1
49627,2,1,173894,173894,173895,0,1,1
49628,3,3,173897,173897,173900,0,3,2
49629,1,2,173898,173900,173902,2,4,0
49630,5,3,173903,173903,173906,0,3,1
49631,2,3,173905,173906,173909,1,4,0
49632,1,3,173906,173909,173912,3,6,0
49633,2,1,173908,173912,173913,4,5,0
49634,2,2,173910,173913,173915,3,5,0
49635,3,2,173913,173915,173917,2,4,0
49636,6,1,173919,173919,173920,0,1,2
49637,5,1,173924,173924,173925,0,1,4
49638,4,1,173928,173928,173929,0,1,3
49639,6,2,173934,173934,173936,0,2,5
49640,3,1,173937,173937,173938,0,1,1
49641,6,3,173943,173943,173946,0,3,5
49642,4,2,173947,173947,173949,0,2,1
49643,3,3,173950,173950,173953,0,3,1
49644,1,2,173951,173953,173955,2,4,0
49645,5,1,173956,173956,173957,0,1,1
49646,1,3,173957,173957,173960,0,3,0
49647,3,2,173960,173960,173962,0,2,0
49648,4,1,173964,173964,173965,0,1,2
49649,2,1,173966,173966,173967,0,1,1
49650,3,3,173969,173969,173972,0,3,2
49651,1,2,173970,173972,173974,2,4,0
49652,1,1,173971,173974,173975,3,4,0
49653,2,1,173973,173975,173976,2,3,0
49654,4,1,173977,173977,173978,0,1,1
49655,4,3,173981,173981,173984,0,3,3
49656,1,1,173982,173984,173985,2,3,0
49657,1,3,173983,173985,173988,2,5,0
49658,2,2,173985,173988,173990,3,5,0
49659,4,1,173989,173990,173991,1,2,0
49660,2,3,173991,173991,173994,0,3,0
49661,4,1,173995,173995,173996,0,1,1
49662,6,2,174001,174001,174003,0,2,5
49663,3,2,174004,174004,174006,0,2,1
49664,1,2,174005,174006,174008,1,3,0
49665,2,1,174007,174008,174009,1,2,0
49666,4,1,174011,174011,174012,0,1,2
49667,6,2,174017,174017,174019,0,2,5
49668,1,3,174018,174019,174022,1,4,0
49669,5,3,174023,174023,174026,0,3,1
49670,1,1,174024,174026,174027,2,3,0
49671,4,2,174028,174028,174030,0,2,1
49672,2,1,174030,174030,174031,0,1,0
49673,5,2,174035,174035,174037,0,2,4
49674,2,3,174037,174037,174040,0,3,0
49675,3,1,174040,174040,174041,0,1,0
49676,5,3,174045,174045,174048,0,3,4
49677,1,3,174046,174048,174051,2,5,0
49678,1,1,174047,174051,174052,4,5,0
49679,5,1,174052,174052,174053,0,1,0
49680,5,2,174057,174057,174059,0,2,4
49681,3,3,174060,174060,174063,0,3,1
49682,2,3,174062,174063,174066,1,4,0
49683,1,1,174063,174066,174067,3,4,0
49684,6,3,174069,174069,174072,0,3,2
49685,1,3,174070,174072,174075,2,5,0
49686,1,2,174071,174075,174077,4,6,0
49687,4,1,174075,174077,174078,2,3,0
49688,1,1,174076,174078,174079,2,3,0
49689,5,2,174081,174081,174083,0,2,2
49690,5,1,174086,174086,174087,0,1,3
49691,2,2,174088,174088,174090,0,2,1
49692,2,3,174090,174090,174093,0,3,0
49693,4,2,174094,174094,174096,0,2,1
49694,5,1,174099,174099,174100,0,1,3
49695,5,2,174104,174104,174106,0,2,4
49696,3,3,174107,174107,174110,0,3,1
49697,3,1,174110,174110,174111,0,1,0
49698,5,3,174115,174115,174118,0,3,4
49699,2,3,174117,174118,174121,1,4,0
49700,4,3,174121,174121,174124,0,3,0
49701,6,3,174127,174127,174130,0,3,3
49702,6,3,174133,174133,174136,0,3,3
49703,5,2,174138,174138,174140,0,2,2
49704,2,2,174140,174140,174142,0,2,0
49705,2,2,174142,174142,174144,0,2,0
49706,4,3,174146,174146,174149,0,3,2
49707,3,2,174149,174149,174151,0,2,0
49708,2,2,174151,174151,174153,0,2,0
49709,3,1,174154,174154,174155,0,1,1
49710,1,1,174155,174155,174156,0,1,0
49711,4,1,174159,174159,174160,0,1,3
49712,4,1,174163,174163,174164,0,1,3
49713,1,3,174164,174164,174167,0,3,0
49714,5,3,174169,174169,174172,0,3,2
49715,1,1,174170,174172,174173,2,3,0
49716,3,2,174173,174173,174175,0,2,0
49717,6,2,174179,174179,174181,0,2,4
49718,2,3,174181,174181,174184,0,3,0
49719,4,3,174185,174185,174188,0,3,1
49720,4,2,174189,174189,174191,0,2,1
49721,6,3,174195,174195,174198,0,3,4
49722,4,2,174199,174199,174201,0,2,1
49723,3,1,174202,174202,174203,0,1,1
49724,2,2,174204,174204,174206,0,2,1
49725,5,3,174209,174209,174212,0,3,3
49726,3,2,174212,174212,174214,0,2,0
49727,5,3,174217,174217,174220,0,3,3
49728,2,2,174219,174220,174222,1,3,0
49729,5,1,174224,174224,174225,0,1,2
49730,3,2,174227,174227,174229,0,2,2
49731,6,3,174233,174233,174236,0,3,4
49732,1,1,174234,174236,174237,2,3,0
49733,4,2,174238,174238,174240,0,2,1
49734,6,1,174244,174244,174245,0,1,4
49735,1,3,174245,174245,174248,0,3,0
49736,5,1,174250,174250,174251,0,1,2
49737,1,3,174251,174251,174254,0,3,0
49738,1,3,174252,174254,174257,2,5,0
49739,4,1,174256,174257,174258,1,2,0
49740,4,3,174260,174260,174263,0,3,2
49741,1,1,174261,174263,174264,2,3,0
49742,3,3,174264,174264,174267,0,3,0
49743,1,2,174265,174267,174269,2,4,0
49744,6,2,174271,174271,174273,0,2,2
49745,3,1,174274,174274,174275,0,1,1
49746,1,2,174275,174275,174277,0,2,0
49747,5,1,174280,174280,174281,0,1,3
49748,6,2,174286,174286,174288,0,2,5
49749,6,2,174292,174292,174294,0,2,4
49750,5,2,174297,174297,174299,0,2,3
49751,2,2,174299,174299,174301,0,2,0
49752,6,3,174305,174305,174308,0,3,4
49753,4,1,174309,174309,174310,0,1,1
49754,6,1,174315,174315,174316,0,1,5
49755,3,3,174318,174318,174321,0,3,2
49756,1,2,174319,174321,174323,2,4,0
49757,2,2,174321,174323,174325,2,4,0
49758,3,3,174324,174325,174328,1,4,0
49759,2,2,174326,174328,174330,2,4,0
49760,4,1,174330,174330,174331,0,1,0
49761,4,2,174334,174334,174336,0,2,3
49762,1,2,174335,174336,174338,1,3,0
49763,3,1,174338,174338,174339,0,1,0
49764,4,3,174342,174342,174345,0,3,3
49765,1,1,174343,174345,174346,2,3,0
49766,4,3,174347,174347,174350,0,3,1
49767,2,1,174349,174350,174351,1,2,0
49768,5,2,174354,174354,174356,0,2,3
49769,2,3,174356,174356,174359,0,3,0
49770,4,1,174360,174360,174361,0,1,1
49771,6,2,174366,174366,174368,0,2,5
49772,4,3,174370,174370,174373,0,3,2
49773,4,1,174374,174374,174375,0,1,1
49774,3,3,174377,174377,174380,0,3,2
49775,5,3,174382,174382,174385,0,3,2
49776,6,1,174388,174388,174389,0,1,3
49777,5,3,174393,174393,174396,0,3,4
49778,6,3,174399,174399,174402,0,3,3
49779,5,1,174404,174404,174405,0,1,2
49780,6,1,174410,174410,174411,0,1,5
49781,3,2,174413,174413,174415,0,2,2
49782,1,2,174414,174415,174417,1,3,0
49783,2,3,174416,174417,174420,1,4,0
49784,5,2,174421,174421,174423,0,2,1
49785,6,1,174427,174427,174428,0,1,4
49786,4,1,174431,174431,174432,0,1,3
49787,4,1,174435,174435,174436,0,1,3
49788,1,2,174436,174436,174438,0,2,0
49789,6,1,174442,174442,174443,0,1,4
49790,1,2,174443,174443,174445,0,2,0
49791,3,1,174446,174446,174447,0,1,1
49792,6,3,174452,174452,174455,0,3,5
49793,6,3,174458,174458,174461,0,3,3
49794,3,2,174461,174461,174463,0,2,0
49795,1,1,174462,174463,174464,1,2,0
49796,5,2,174467,174467,174469,0,2,3
49797,2,3,174469,174469,174472,0,3,0
49798,6,3,174475,174475,174478,0,3,3
49799,3,2,174478,174478,174480,0,2,0
49800,4,2,174482,174482,174484,0,2,2
49801,4,2,174486,174486,174488,0,2,2
49802,6,1,174492,174492,174493,0,1,4
49803,5,3,174497,174497,174500,0,3,4
49804,2,1,174499,174500,174501,1,2,0
49805,1,3,174500,174501,174504,1,4,0
49806,2,1,174502,174504,174505,2,3,0
49807,2,1,174504,174505,174506,1,2,0
49808,4,1,174508,174508,174509,0,1,2
49809,6,2,174514,174514,174516,0,2,5
49810,4,3,174518,174518,174521,0,3,2
49811,3,1,174521,174521,174522,0,1,0
49812,2,2,174523,174523,174525,0,2,1
49813,4,2,174527,174527,174529,0,2,2
49814,4,3,174531,174531,174534,0,3,2
49815,4,2,174535,174535,174537,0,2,1
49816,3,3,174538,174538,174541,0,3,1
49817,1,1,174539,174541,174542,2,3,0
49818,6,3,174545,174545,174548,0,3,3
49819,5,2,174550,174550,174552,0,2,2
49820,2,2,174552,174552,174554,0,2,0
49821,5,3,174557,174557,174560,0,3,3
49822,3,3,174560,174560,174563,0,3,0
49823,5,1,174565,174565,174566,0,1,2
49824,3,2,174568,174568,174570,0,2,2
49825,1,3,174569,174570,174573,1,4,0
49826,4,3,174573,174573,174576,0,3,0
49827,3,1,174576,174576,174577,0,1,0
49828,2,1,174578,174578,174579,0,1,1
49829,2,1,174580,174580,174581,0,1,1
49830,3,1,174583,174583,174584,0,1,2
49831,3,2,174586,174586,174588,0,2,2
49832,1,3,174587,174588,174591,1,4,0
49833,2,3,174589,174591,174594,2,5,0
49834,1,2,174590,174594,174596,4,6,0
49835,3,3,174593,174596,174599,3,6,0
49836,4,2,174597,174599,174601,2,4,0
49837,2,3,174599,174601,174604,2,5,0
49838,6,1,174605,174605,174606,0,1,1
49839,5,1,174610,174610,174611,0,1,4
49840,3,1,174613,174613,174614,0,1,2
49841,3,1,174616,174616,174617,0,1,2
49842,5,3,174621,174621,174624,0,3,4
49843,1,3,174622,174624,174627,2,5,0
49844,3,1,174625,174627,174628,2,3,0
49845,4,3,174629,174629,174632,0,3,1
49846,3,1,174632,174632,174633,0,1,0
49847,3,3,174635,174635,174638,0,3,2
49848,4,1,174639,174639,174640,0,1,1
49849,5,1,174644,174644,174645,0,1,4
49850,1,2,174645,174645,174647,0,2,0
49851,2,2,174647,174647,174649,0,2,0
49852,1,1,174648,174649,174650,1,2,0
49853,4,3,174652,174652,174655,0,3,2
49854,4,3,174656,174656,174659,0,3,1
49855,5,2,174661,174661,174663,0,2,2
49856,6,1,174667,174667,174668,0,1,4
49857,4,1,174671,174671,174672,0,1,3
49858,4,3,174675,174675,174678,0,3,3
49859,4,3,174679,174679,174682,0,3,1
49860,1,2,174680,174682,174684,2,4,0
49861,4,1,174684,174684,174685,0,1,0
49862,4,1,174688,174688,174689,0,1,3
49863,3,1,174691,174691,174692,0,1,2
49864,2,2,174693,174693,174695,0,2,1
49865,3,1,174696,174696,174697,0,1,1
49866,4,3,174700,174700,174703,0,3,3
49867,1,1,174701,174703,174704,2,3,0
49868,3,3,174704,174704,174707,0,3,0
49869,2,1,174706,174707,174708,1,2,0
49870,1,3,174707,174708,174711,1,4,0
49871,3,3,174710,174711,174714,1,4,0
49872,1,3,174711,174714,174717,3,6,0
49873,5,1,174716,174717,174718,1,2,0
49874,5,3,174721,174721,174724,0,3,3
49875,1,2,174722,174724,174726,2,4,0
49876,1,1,174723,174726,174727,3,4,0
49877,6,2,174729,174729,174731,0,2,2
49878,6,1,174735,174735,174736,0,1,4
49879,5,2,174740,174740,174742,0,2,4
49880,5,3,174745,174745,174748,0,3,3
49881,4,3,174749,174749,174752,0,3,1
49882,4,3,174753,174753,174756,0,3,1
49883,2,1,174755,174756,174757,1,2,0
49884,5,1,174760,174760,174761,0,1,3
49885,4,1,174764,174764,174765,0,1,3
49886,2,2,174766,174766,174768,0,2,1
49887,4,3,174770,174770,174773,0,3,2
49888,2,1,174772,174773,174774,1,2,0
49889,5,1,174777,174777,174778,0,1,3
49890,3,1,174780,174780,174781,0,1,2
49891,4,1,174784,174784,174785,0,1,3
49892,6,1,174790,174790,174791,0,1,5
49893,1,3,174791,174791,174794,0,3,0
49894,5,2,174796,174796,174798,0,2,2
49895,5,1,174801,174801,174802,0,1,3
49896,1,2,174802,174802,174804,0,2,0
49897,5,3,174807,174807,174810,0,3,3
49898,1,3,174808,174810,174813,2,5,0
49899,5,2,174813,174813,174815,0,2,0
49900,3,3,174816,174816,174819,0,3,1
49901,2,2,174818,174819,174821,1,3,0
49902,5,2,174823,174823,174825,0,2,2
49903,2,3,174825,174825,174828,0,3,0
49904,1,1,174826,174828,174829,2,3,0
49905,2,3,174828,174829,174832,1,4,0
49906,2,2,174830,174832,174834,2,4,0
49907,5,1,174835,174835,174836,0,1,1
49908,2,2,174837,174837,174839,0,2,1
49909,6,3,174843,174843,174846,0,3,4
49910,4,1,174847,174847,174848,0,1,1
49911,6,2,174853,174853,174855,0,2,5
49912,6,2,174859,174859,174861,0,2,4
49913,2,3,174861,174861,174864,0,3,0
49914,3,2,174864,174864,174866,0,2,0
49915,5,3,174869,174869,174872,0,3,3
49916,5,3,174874,174874,174877,0,3,2
49917,1,2,174875,174877,174879,2,4,0
49918,5,1,174880,174880,174881,0,1,1
49919,5,2,174885,174885,174887,0,2,4
49920,2,1,174887,174887,174888,0,1,0
49921,3,2,174890,174890,174892,0,2,2
49922,4,2,174894,174894,174896,0,2,2
49923,1,1,174895,174896,174897,1,2,0
49924,1,1,174896,174897,174898,1,2,0
49925,2,3,174898,174898,174901,0,3,0
49926,1,2,174899,174901,174903,2,4,0
49927,4,1,174903,174903,174904,0,1,0
49928,2,3,174905,174905,174908,0,3,1
49929,6,1,174911,174911,174912,0,1,3
49930,6,2,174917,174917,174919,0,2,5
49931,1,2,174918,174919,174921,1,3,0
49932,6,3,174924,174924,174927,0,3,3
49933,4,1,174928,174928,174929,0,1,1
49934,3,2,174931,174931,174933,0,2,2
49935,6,2,174937,174937,174939,0,2,4
49936,2,1,174939,174939,174940,0,1,0
49937,3,2,174942,174942,174944,0,2,2
49938,5,2,174947,174947,174949,0,2,3
49939,4,3,174951,174951,174954,0,3,2
49940,3,3,174954,174954,174957,0,3,0
49941,4,3,174958,174958,174961,0,3,1
49942,4,1,174962,174962,174963,0,1,1
49943,3,1,174965,174965,174966,0,1,2
49944,6,1,174971,174971,174972,0,1,5
49945,5,1,174976,174976,174977,0,1,4
49946,3,2,174979,174979,174981,0,2,2
49947,5,1,174984,174984,174985,0,1,3
49948,3,1,174987,174987,174988,0,1,2
49949,5,2,174992,174992,174994,0,2,4
49950,3,3,174995,174995,174998,0,3,1
49951,4,3,174999,174999,175002,0,3,1
49952,6,3,175005,175005,175008,0,3,3
49953,4,3,175009,175009,175012,0,3,1
49954,5,3,175014,175014,175017,0,3,2
49955,2,3,175016,175017,175020,1,4,0
49956,2,2,175018,175020,175022,2,4,0
49957,4,1,175022,175022,175023,0,1,0
49958,2,3,175024,175024,175027,0,3,1
49959,1,2,175025,175027,175029,2,4,0
49960,3,2,175028,175029,175031,1,3,0
49961,1,1,175029,175031,175032,2,3,0
49962,5,2,175034,175034,175036,0,2,2
49963,1,3,175035,175036,175039,1,4,0
49964,5,2,175040,175040,175042,0,2,1
49965,6,2,175046,175046,175048,0,2,4
49966,4,2,175050,175050,175052,0,2,2
49967,6,2,175056,175056,175058,0,2,4
49968,5,2,175061,175061,175063,0,2,3
49969,5,3,175066,175066,175069,0,3,3
49970,3,1,175069,175069,175070,0,1,0
49971,5,3,175074,175074,175077,0,3,4
49972,2,1,175076,175077,175078,1,2,0
49973,1,2,175077,175078,175080,1,3,0
49974,5,3,175082,175082,175085,0,3,2
49975,2,1,175084,175085,175086,1,2,0
49976,6,1,175090,175090,175091,0,1,4
49977,5,1,175095,175095,175096,0,1,4
49978,1,3,175096,175096,175099,0,3,0
49979,6,2,175102,175102,175104,0,2,3
49980,3,3,175105,175105,175108,0,3,1
49981,3,1,175108,175108,175109,0,1,0
49982,1,3,175109,175109,175112,0,3,0
49983,4,3,175113,175113,175116,0,3,1
49984,6,1,175119,175119,175120,0,1,3
49985,2,2,175121,175121,175123,0,2,1
49986,2,2,175123,175123,175125,0,2,0
49987,5,1,175128,175128,175129,0,1,3
49988,3,2,175131,175131,175133,0,2,2
49989,2,3,175133,175133,175136,0,3,0
49990,2,3,175135,175136,175139,1,4,0
49991,2,3,175137,175139,175142,2,5,0
49992,5,1,175142,175142,175143,0,1,0
49993,4,2,175146,175146,175148,0,2,3
49994,5,1,175151,175151,175152,0,1,3
49995,3,3,175154,175154,175157,0,3,2
49996,3,3,175157,175157,175160,0,3,0
49997,4,2,175161,175161,175163,0,2,1
49998,5,1,175166,175166,175167,0,1,3
49999,6,3,175172,175172,175175,0,3,5
50000,2,1,175174,175175,175176,1,2,0
50001,1,1,175175,175176,175177,1,2,0
50002,3,1,175178,175178,175179,0,1,1
50003,5,1,175183,175183,175184,0,1,4
50004,5,2,175188,175188,175190,0,2,4
50005,3,1,175191,175191,175192,0,1,1
50006,4,3,175195,175195,175198,0,3,3
50007,4,3,175199,175199,175202,0,3,1
50008,2,2,175201,175202,175204,1,3,0
50009,6,3,175207,175207,175210,0,3,3
50010,3,2,175210,175210,175212,0,2,0
50011,1,3,175211,175212,175215,1,4,0
50012,4,1,175215,175215,175216,0,1,0
50013,2,3,175217,175217,175220,0,3,1
50014,2,3,175219,175220,175223,1,4,0
50015,2,3,175221,175223,175226,2,5,0
50016,1,2,175222,175226,175228,4,6,0
50017,3,2,175225,175228,175230,3,5,0
50018,5,3,175230,175230,175233,0,3,0
50019,5,1,175235,175235,175236,0,1,2
50020,2,1,175237,175237,175238,0,1,1
50021,5,1,175242,175242,175243,0,1,4
50022,2,3,175244,175244,175247,0,3,1
50023,5,1,175249,175249,175250,0,1,2
50024,4,2,175253,175253,175255,0,2,3
50025,4,1,175257,175257,175258,0,1,2
50026,2,1,175259,175259,175260,0,1,1
50027,6,2,175265,175265,175267,0,2,5
50028,2,3,175267,175267,175270,0,3,0
50029,1,2,175268,175270,175272,2,4,0
50030,4,1,175272,175272,175273,0,1,0
50031,5,1,175277,175277,175278,0,1,4
50032,2,1,175279,175279,175280,0,1,1
50033,5,2,175284,175284,175286,0,2,4
50034,2,2,175286,175286,175288,0,2,0
50035,6,3,175292,175292,175295,0,3,4
50036,4,1,175296,175296,175297,0,1,1
50037,6,1,175302,175302,175303,0,1,5
50038,6,1,175308,175308,175309,0,1,5
50039,6,2,175314,175314,175316,0,2,5
50040,1,2,175315,175316,175318,1,3,0
50041,3,1,175318,175318,175319,0,1,0
50042,5,3,175323,175323,175326,0,3,4
50043,5,1,175328,175328,175329,0,1,2
50044,2,3,175330,175330,175333,0,3,1
50045,6,2,175336,175336,175338,0,2,3
50046,1,1,175337,175338,175339,1,2,0
50047,5,1,175342,175342,175343,0,1,3
50048,1,2,175343,175343,175345,0,2,0
50049,1,3,175344,175345,175348,1,4,0
50050,4,2,175348,175348,175350,0,2,0
50051,1,3,175349,175350,175353,1,4,0
50052,3,2,175352,175353,175355,1,3,0
50053,1,3,175353,175355,175358,2,5,0
50054,2,1,175355,175358,175359,3,4,0
50055,6,1,175361,175361,175362,0,1,2
50056,5,3,175366,175366,175369,0,3,4
50057,2,1,175368,175369,175370,1,2,0
50058,3,2,175371,175371,175373,0,2,1
50059,3,2,175374,175374,175376,0,2,1
50060,3,2,175377,175377,175379,0,2,1
50061,5,1,175382,175382,175383,0,1,3
50062,5,2,175387,175387,175389,0,2,4
50063,4,3,175391,175391,175394,0,3,2
50064,5,2,175396,175396,175398,0,2,2
50065,1,1,175397,175398,175399,1,2,0
50066,6,3,175403,175403,175406,0,3,4
50067,3,1,175406,175406,175407,0,1,0
50068,5,2,175411,175411,175413,0,2,4
50069,6,3,175417,175417,175420,0,3,4
50070,2,2,175419,175420,175422,1,3,0
50071,1,2,175420,175422,175424,2,4,0
50072,6,1,175426,175426,175427,0,1,2
50073,6,3,175432,175432,175435,0,3,5
50074,5,2,175437,175437,175439,0,2,2
50075,4,1,175441,175441,175442,0,1,2
50076,3,2,175444,175444,175446,0,2,2
50077,4,1,175448,175448,175449,0,1,2
50078,2,2,175450,175450,175452,0,2,1
50079,1,3,175451,175452,175455,1,4,0
50080,5,3,175456,175456,175459,0,3,1
50081,1,2,175457,175459,175461,2,4,0
50082,2,3,175459,175461,175464,2,5,0
50083,6,1,175465,175465,175466,0,1,1
50084,6,2,175471,175471,175473,0,2,5
50085,6,1,175477,175477,175478,0,1,4
50086,4,2,175481,175481,175483,0,2,3
50087,1,1,175482,175483,175484,1,2,0
50088,5,1,175487,175487,175488,0,1,3
50089,6,3,175493,175493,175496,0,3,5
50090,4,1,175497,175497,175498,0,1,1
50091,3,1,175500,175500,175501,0,1,2
50092,1,2,175501,175501,175503,0,2,0
50093,5,3,175506,175506,175509,0,3,3
50094,5,1,175511,175511,175512,0,1,2
50095,6,1,175517,175517,175518,0,1,5
50096,3,3,175520,175520,175523,0,3,2
50097,1,3,175521,175523,175526,2,5,0
50098,2,1,175523,175526,175527,3,4,0
50099,4,3,175527,175527,175530,0,3,0
50100,1,2,175528,175530,175532,2,4,0
50101,1,1,175529,175532,175533,3,4,0
50102,3,2,175532,175533,175535,1,3,0
50103,6,2,175538,175538,175540,0,2,3
50104,5,1,175543,175543,175544,0,1,3
50105,3,1,175546,175546,175547,0,1,2
50106,6,3,175552,175552,175555,0,3,5
50107,1,3,175553,175555,175558,2,5,0
50108,6,3,175559,175559,175562,0,3,1
50109,4,1,175563,175563,175564,0,1,1
50110,5,2,175568,175568,175570,0,2,4
50111,6,3,175574,175574,175577,0,3,4
50112,6,3,175580,175580,175583,0,3,3
50113,6,1,175586,175586,175587,0,1,3
50114,3,3,175589,175589,175592,0,3,2
50115,5,2,175594,175594,175596,0,2,2
50116,6,1,175600,175600,175601,0,1,4
50117,6,2,175606,175606,175608,0,2,5
50118,1,2,175607,175608,175610,1,3,0
50119,3,2,175610,175610,175612,0,2,0
50120,5,1,175615,175615,175616,0,1,3
50121,1,2,175616,175616,175618,0,2,0
50122,4,2,175620,175620,175622,0,2,2
50123,3,3,175623,175623,175626,0,3,1
50124,1,3,175624,175626,175629,2,5,0
50125,5,3,175629,175629,175632,0,3,0
50126,5,1,175634,175634,175635,0,1,2
50127,3,3,175637,175637,175640,0,3,2
50128,4,1,175641,175641,175642,0,1,1
50129,2,1,175643,175643,175644,0,1,1
50130,5,3,175648,175648,175651,0,3,4
50131,1,1,175649,175651,175652,2,3,0
50132,3,1,175652,175652,175653,0,1,0
50133,3,1,175655,175655,175656,0,1,2
50134,3,2,175658,175658,175660,0,2,2
50135,6,1,175664,175664,175665,0,1,4
50136,6,1,175670,175670,175671,0,1,5
50137,5,2,175675,175675,175677,0,2,4
50138,6,3,175681,175681,175684,0,3,4
50139,2,3,175683,175684,175687,1,4,0
50140,3,1,175686,175687,175688,1,2,0
50141,4,1,175690,175690,175691,0,1,2
50142,6,1,175696,175696,175697,0,1,5
50143,6,3,175702,175702,175705,0,3,5
50144,5,3,175707,175707,175710,0,3,2
50145,2,2,175709,175710,175712,1,3,0
50146,4,3,175713,175713,175716,0,3,1
50147,3,2,175716,175716,175718,0,2,0
50148,2,1,175718,175718,175719,0,1,0
50149,4,1,175722,175722,175723,0,1,3
50150,1,2,175723,175723,175725,0,2,0
50151,1,3,175724,175725,175728,1,4,0
50152,6,1,175730,175730,175731,0,1,2
50153,6,2,175736,175736,175738,0,2,5
50154,6,3,175742,175742,175745,0,3,4
50155,3,2,175745,175745,175747,0,2,0
50156,6,2,175751,175751,175753,0,2,4
50157,3,2,175754,175754,175756,0,2,1
50158,1,3,175755,175756,175759,1,4,0
50159,3,2,175758,175759,175761,1,3,0
50160,1,1,175759,175761,175762,2,3,0
50161,2,1,175761,175762,175763,1,2,0
50162,5,2,175766,175766,175768,0,2,3
50163,3,1,175769,175769,175770,0,1,1
50164,2,2,175771,175771,175773,0,2,1
50165,1,1,175772,175773,175774,1,2,0
50166,3,1,175775,175775,175776,0,1,1
50167,3,3,175778,175778,175781,0,3,2
50168,4,1,175782,175782,175783,0,1,1
50169,1,3,175783,175783,175786,0,3,0
50170,4,3,175787,175787,175790,0,3,1
50171,6,1,175793,175793,175794,0,1,3
50172,5,2,175798,175798,175800,0,2,4
50173,4,2,175802,175802,175804,0,2,2
50174,5,2,175807,175807,175809,0,2,3
50175,1,1,175808,175809,175810,1,2,0
50176,2,1,175810,175810,175811,0,1,0
50177,1,1,175811,175811,175812,0,1,0
50178,5,2,175816,175816,175818,0,2,4
50179,3,1,175819,175819,175820,0,1,1
50180,2,1,175821,175821,175822,0,1,1
50181,3,2,175824,175824,175826,0,2,2
50182,5,1,175829,175829,175830,0,1,3
50183,2,1,175831,175831,175832,0,1,1
50184,1,2,175832,175832,175834,0,2,0
50185,1,3,175833,175834,175837,1,4,0
50186,1,1,175834,175837,175838,3,4,0
50187,3,2,175837,175838,175840,1,3,0
50188,6,2,175843,175843,175845,0,2,3
50189,2,2,175845,175845,175847,0,2,0
50190,3,1,175848,175848,175849,0,1,1
50191,6,3,175854,175854,175857,0,3,5
50192,2,2,175856,175857,175859,1,3,0
50193,1,2,175857,175859,175861,2,4,0
50194,5,1,175862,175862,175863,0,1,1
50195,4,2,175866,175866,175868,0,2,3
50196,5,3,175871,175871,175874,0,3,3
50197,5,2,175876,175876,175878,0,2,2
50198,3,1,175879,175879,175880,0,1,1
50199,3,3,175882,175882,175885,0,3,2
50200,4,2,175886,175886,175888,0,2,1
50201,4,1,175890,175890,175891,0,1,2
50202,3,2,175893,175893,175895,0,2,2
50203,2,1,175895,175895,175896,0,1,0
50204,2,1,175897,175897,175898,0,1,1
50205,3,1,175900,175900,175901,0,1,2
50206,2,2,175902,175902,175904,0,2,1
50207,6,2,175908,175908,175910,0,2,4
50208,4,3,175912,175912,175915,0,3,2
50209,6,3,175918,175918,175921,0,3,3
50210,5,2,175923,175923,175925,0,2,2
50211,6,3,175929,175929,175932,0,3,4
50212,4,2,175933,175933,175935,0,2,1
50213,6,1,175939,175939,175940,0,1,4
50214,6,3,175945,175945,175948,0,3,5
50215,5,3,175950,175950,175953,0,3,2
50216,6,2,175956,175956,175958,0,2,3
50217,1,2,175957,175958,175960,1,3,0
50218,6,1,175963,175963,175964,0,1,3
50219,3,2,175966,175966,175968,0,2,2
50220,1,1,175967,175968,175969,1,2,0
50221,4,2,175971,175971,175973,0,2,2
50222,4,1,175975,175975,175976,0,1,2
50223,4,2,175979,175979,175981,0,2,3
50224,3,1,175982,175982,175983,0,1,1
50225,2,1,175984,175984,175985,0,1,1
50226,6,2,175990,175990,175992,0,2,5
50227,2,1,175992,175992,175993,0,1,0
50228,3,2,175995,175995,175997,0,2,2
50229,2,3,175997,175997,176000,0,3,0
50230,2,1,175999,176000,176001,1,2,0
50231,2,3,176001,176001,176004,0,3,0
50232,5,1,176006,176006,176007,0,1,2
50233,3,2,176009,176009,176011,0,2,2
50234,6,1,176015,176015,176016,0,1,4
50235,6,1,176021,176021,176022,0,1,5
50236,4,1,176025,176025,176026,0,1,3
50237,4,1,176029,176029,176030,0,1,3
50238,5,1,176034,176034,176035,0,1,4
50239,5,2,176039,176039,176041,0,2,4
50240,1,1,176040,176041,176042,1,2,0
50241,3,1,176043,176043,176044,0,1,1
50242,4,3,176047,176047,176050,0,3,3
50243,6,1,176053,176053,176054,0,1,3
50244,6,3,176059,176059,176062,0,3,5
50245,1,1,176060,176062,176063,2,3,0
50246,6,2,176066,176066,176068,0,2,3
50247,1,3,176067,176068,176071,1,4,0
50248,6,3,176073,176073,176076,0,3,2
50249,2,2,176075,176076,176078,1,3,0
50250,6,1,176081,176081,176082,0,1,3
50251,2,1,176083,176083,176084,0,1,1
50252,6,2,176089,176089,176091,0,2,5
50253,1,2,176090,176091,176093,1,3,0
50254,5,1,176095,176095,176096,0,1,2
50255,4,3,176099,176099,176102,0,3,3
50256,6,1,176105,176105,176106,0,1,3
50257,4,1,176109,176109,176110,0,1,3
50258,3,1,176112,176112,176113,0,1,2
50259,4,2,176116,176116,176118,0,2,3
50260,3,2,176119,176119,176121,0,2,1
50261,1,1,176120,176121,176122,1,2,0
50262,6,3,176126,176126,176129,0,3,4
50263,6,1,176132,176132,176133,0,1,3
50264,5,3,176137,176137,176140,0,3,4
50265,3,2,176140,176140,176142,0,2,0
50266,3,1,176143,176143,176144,0,1,1
50267,4,2,176147,176147,176149,0,2,3
50268,3,2,176150,176150,176152,0,2,1
50269,4,2,176154,176154,176156,0,2,2
50270,4,1,176158,176158,176159,0,1,2
50271,4,2,176162,176162,176164,0,2,3
50272,3,1,176165,176165,176166,0,1,1
50273,1,2,176166,176166,176168,0,2,0
50274,5,2,176171,176171,176173,0,2,3
50275,6,3,176177,176177,176180,0,3,4
50276,5,3,176182,176182,176185,0,3,2
50277,6,3,176188,176188,176191,0,3,3
50278,1,2,176189,176191,176193,2,4,0
50279,6,1,176195,176195,176196,0,1,2
50280,3,2,176198,176198,176200,0,2,2
50281,6,2,176204,176204,176206,0,2,4
50282,4,2,176208,176208,176210,0,2,2
50283,4,1,176212,176212,176213,0,1,2
50284,3,2,176215,176215,176217,0,2,2
50285,1,2,176216,176217,176219,1,3,0
50286,5,1,176221,176221,176222,0,1,2
50287,5,1,176226,176226,176227,0,1,4
50288,6,3,176232,176232,176235,0,3,5
50289,3,1,176235,176235,176236,0,1,0
50290,4,2,176239,176239,176241,0,2,3
50291,5,3,176244,176244,176247,0,3,3
50292,2,1,176246,176247,176248,1,2,0
50293,4,1,176250,176250,176251,0,1,2
50294,1,1,176251,176251,176252,0,1,0
50295,1,2,176252,176252,176254,0,2,0
50296,2,3,176254,176254,176257,0,3,0
50297,6,3,176260,176260,176263,0,3,3
50298,5,1,176265,176265,176266,0,1,2
50299,3,1,176268,176268,176269,0,1,2
50300,6,2,176274,176274,176276,0,2,5
50301,2,3,176276,176276,176279,0,3,0
50302,6,2,176282,176282,176284,0,2,3
50303,3,2,176285,176285,176287,0,2,1
50304,5,3,176290,176290,176293,0,3,3
50305,1,2,176291,176293,176295,2,4,0
50306,5,3,176296,176296,176299,0,3,1
50307,6,1,176302,176302,176303,0,1,3
50308,4,3,176306,176306,176309,0,3,3
50309,2,1,176308,176309,176310,1,2,0
50310,2,1,176310,176310,176311,0,1,0
50311,3,1,176313,176313,176314,0,1,2
50312,2,3,176315,176315,176318,0,3,1
50313,6,1,176321,176321,176322,0,1,3
50314,5,3,176326,176326,176329,0,3,4
50315,4,1,176330,176330,176331,0,1,1
50316,5,3,176335,176335,176338,0,3,4
50317,6,3,176341,176341,176344,0,3,3
50318,2,2,176343,176344,176346,1,3,0
50319,2,1,176345,176346,176347,1,2,0
50320,4,1,176349,176349,176350,0,1,2
50321,4,1,176353,176353,176354,0,1,3
50322,4,2,176357,176357,176359,0,2,3
50323,1,1,176358,176359,176360,1,2,0
50324,1,1,176359,176360,176361,1,2,0
50325,2,2,176361,176361,176363,0,2,0
50326,5,3,176366,176366,176369,0,3,3
50327,4,3,176370,176370,176373,0,3,1
50328,5,3,176375,176375,176378,0,3,2
50329,1,2,176376,176378,176380,2,4,0
50330,5,1,176381,176381,176382,0,1,1
50331,4,3,176385,176385,176388,0,3,3
50332,6,1,176391,176391,176392,0,1,3
50333,5,2,176396,176396,176398,0,2,4
50334,5,1,176401,176401,176402,0,1,3
50335,1,2,176402,176402,176404,0,2,0
50336,1,3,176403,176404,176407,1,4,0
50337,4,3,176407,176407,176410,0,3,0
50338,3,1,176410,176410,176411,0,1,0
50339,4,2,176414,176414,176416,0,2,3
50340,6,2,176420,176420,176422,0,2,4
50341,5,1,176425,176425,176426,0,1,3
50342,3,3,176428,176428,176431,0,3,2
50343,3,1,176431,176431,176432,0,1,0
50344,6,2,176437,176437,176439,0,2,5
50345,2,3,176439,176439,176442,0,3,0
50346,6,1,176445,176445,176446,0,1,3
50347,4,2,176449,176449,176451,0,2,3
50348,4,1,176453,176453,176454,0,1,2
50349,6,3,176459,176459,176462,0,3,5
50350,4,2,176463,176463,176465,0,2,1
50351,1,1,176464,176465,176466,1,2,0
50352,1,2,176465,176466,176468,1,3,0
50353,5,1,176470,176470,176471,0,1,2
50354,3,1,176473,176473,176474,0,1,2
50355,2,2,176475,176475,176477,0,2,1
50356,2,3,176477,176477,176480,0,3,0
50357,5,2,176482,176482,176484,0,2,2
50358,4,1,176486,176486,176487,0,1,2
50359,1,1,176487,176487,176488,0,1,0
50360,3,1,176490,176490,176491,0,1,2
50361,4,1,176494,176494,176495,0,1,3
50362,1,3,176495,176495,176498,0,3,0
50363,4,1,176499,176499,176500,0,1,1
50364,2,2,176501,176501,176503,0,2,1
50365,5,2,176506,176506,176508,0,2,3
50366,6,3,176512,176512,176515,0,3,4
50367,4,1,176516,176516,176517,0,1,1
50368,1,3,176517,176517,176520,0,3,0
50369,3,3,176520,176520,176523,0,3,0
50370,6,1,176526,176526,176527,0,1,3
50371,5,2,176531,176531,176533,0,2,4
50372,5,2,176536,176536,176538,0,2,3
50373,1,1,176537,176538,176539,1,2,0
50374,4,3,176541,176541,176544,0,3,2
50375,2,3,176543,176544,176547,1,4,0
50376,2,2,176545,176547,176549,2,4,0
50377,3,3,176548,176549,176552,1,4,0
50378,5,2,176553,176553,176555,0,2,1
50379,1,3,176554,176555,176558,1,4,0
50380,5,2,176559,176559,176561,0,2,1
50381,6,2,176565,176565,176567,0,2,4
50382,2,1,176567,176567,176568,0,1,0
50383,6,3,176573,176573,176576,0,3,5
50384,1,3,176574,176576,176579,2,5,0
50385,1,1,176575,176579,176580,4,5,0
50386,2,2,176577,176580,176582,3,5,0
50387,2,1,176579,176582,176583,3,4,0
50388,6,1,176585,176585,176586,0,1,2
50389,6,2,176591,176591,176593,0,2,5
50390,2,2,176593,176593,176595,0,2,0
50391,5,3,176598,176598,176601,0,3,3
50392,1,2,176599,176601,176603,2,4,0
50393,4,3,176603,176603,176606,0,3,0
50394,5,1,176608,176608,176609,0,1,2
50395,6,2,176614,176614,176616,0,2,5
50396,1,1,176615,176616,176617,1,2,0
50397,4,1,176619,176619,176620,0,1,2
50398,3,2,176622,176622,176624,0,2,2
50399,1,2,176623,176624,176626,1,3,0
50400,5,2,176628,176628,176630,0,2,2
50401,4,1,176632,176632,176633,0,1,2
50402,1,1,176633,176633,176634,0,1,0
50403,4,3,176637,176637,176640,0,3,3
50404,2,3,176639,176640,176643,1,4,0
50405,1,2,176640,176643,176645,3,5,0
50406,5,3,176645,176645,176648,0,3,0
50407,6,3,176651,176651,176654,0,3,3
50408,2,2,176653,176654,176656,1,3,0
50409,6,2,176659,176659,176661,0,2,3
50410,4,1,176663,176663,176664,0,1,2
50411,6,2,176669,176669,176671,0,2,5
50412,6,1,176675,176675,176676,0,1,4
50413,3,3,176678,176678,176681,0,3,2
50414,3,2,176681,176681,176683,0,2,0
50415,4,1,176685,176685,176686,0,1,2
50416,1,3,176686,176686,176689,0,3,0
50417,4,2,176690,176690,176692,0,2,1
50418,1,1,176691,176692,176693,1,2,0
50419,1,3,176692,176693,176696,1,4,0
50420,6,2,176698,176698,176700,0,2,2
50421,3,3,176701,176701,176704,0,3,1
50422,3,2,176704,176704,176706,0,2,0
50423,1,3,176705,176706,176709,1,4,0
50424,6,3,176711,176711,176714,0,3,2
50425,5,1,176716,176716,176717,0,1,2
50426,6,1,176722,176722,176723,0,1,5
50427,6,2,176728,176728,176730,0,2,5
50428,1,3,176729,176730,176733,1,4,0
50429,1,1,176730,176733,176734,3,4,0
50430,2,1,176732,176734,176735,2,3,0
50431,5,2,176737,176737,176739,0,2,2
50432,1,1,176738,176739,176740,1,2,0
50433,1,1,176739,176740,176741,1,2,0
50434,1,3,176740,176741,176744,1,4,0
50435,4,3,176744,176744,176747,0,3,0
50436,2,3,176746,176747,176750,1,4,0
50437,5,2,176751,176751,176753,0,2,1
50438,6,2,176757,176757,176759,0,2,4
50439,5,1,176762,176762,176763,0,1,3
50440,3,3,176765,176765,176768,0,3,2
50441,4,3,176769,176769,176772,0,3,1
50442,6,2,176775,176775,176777,0,2,3
50443,5,3,176780,176780,176783,0,3,3
50444,6,2,176786,176786,176788,0,2,3
50445,2,2,176788,176788,176790,0,2,0
50446,3,1,176791,176791,176792,0,1,1
50447,1,1,176792,176792,176793,0,1,0
50448,1,2,176793,176793,176795,0,2,0
50449,5,1,176798,176798,176799,0,1,3
50450,5,1,176803,176803,176804,0,1,4
50451,2,2,176805,176805,176807,0,2,1
50452,3,2,176808,176808,176810,0,2,1
50453,6,3,176814,176814,176817,0,3,4
50454,2,1,176816,176817,176818,1,2,0
50455,1,3,176817,176818,176821,1,4,0
50456,4,3,176821,176821,176824,0,3,0
50457,1,1,176822,176824,176825,2,3,0
50458,3,3,176825,176825,176828,0,3,0
50459,1,2,176826,176828,176830,2,4,0
50460,1,1,176827,176830,176831,3,4,0
50461,5,3,176832,176832,176835,0,3,1
50462,2,2,176834,176835,176837,1,3,0
50463,5,2,176839,176839,176841,0,2,2
50464,4,3,176843,176843,176846,0,3,2
50465,5,2,176848,176848,176850,0,2,2
50466,6,3,176854,176854,176857,0,3,4
50467,1,2,176855,176857,176859,2,4,0
50468,1,1,176856,176859,176860,3,4,0
50469,4,1,176860,176860,176861,0,1,0
50470,6,2,176866,176866,176868,0,2,5
50471,2,1,176868,176868,176869,0,1,0
50472,1,2,176869,176869,176871,0,2,0
50473,2,3,176871,176871,176874,0,3,0
50474,5,3,176876,176876,176879,0,3,2
50475,6,3,176882,176882,176885,0,3,3
50476,3,2,176885,176885,176887,0,2,0
50477,4,2,176889,176889,176891,0,2,2
50478,6,3,176895,176895,176898,0,3,4
50479,4,2,176899,176899,176901,0,2,1
50480,6,2,176905,176905,176907,0,2,4
50481,4,3,176909,176909,176912,0,3,2
50482,3,2,176912,176912,176914,0,2,0
50483,5,2,176917,176917,176919,0,2,3
50484,3,3,176920,176920,176923,0,3,1
50485,2,2,176922,176923,176925,1,3,0
50486,3,1,176925,176925,176926,0,1,0
50487,2,2,176927,176927,176929,0,2,1
50488,1,2,176928,176929,176931,1,3,0
50489,5,3,176933,176933,176936,0,3,2
50490,4,1,176937,176937,176938,0,1,1
50491,2,1,176939,176939,176940,0,1,1
50492,1,2,176940,176940,176942,0,2,0
50493,1,3,176941,176942,176945,1,4,0
50494,1,1,176942,176945,176946,3,4,0
50495,2,2,176944,176946,176948,2,4,0
50496,1,1,176945,176948,176949,3,4,0
50497,4,1,176949,176949,176950,0,1,0
50498,2,2,176951,176951,176953,0,2,1
50499,3,3,176954,176954,176957,0,3,1
50500,4,1,176958,176958,176959,0,1,1
50501,3,2,176961,176961,176963,0,2,2
50502,6,2,176967,176967,176969,0,2,4
50503,6,1,176973,176973,176974,0,1,4
50504,1,1,176974,176974,176975,0,1,0
50505,6,3,176980,176980,176983,0,3,5
50506,6,3,176986,176986,176989,0,3,3
50507,3,2,176989,176989,176991,0,2,0
50508,1,3,176990,176991,176994,1,4,0
50509,2,1,176992,176994,176995,2,3,0
50510,3,2,176995,176995,176997,0,2,0
50511,1,3,176996,176997,177000,1,4,0
50512,4,3,177000,177000,177003,0,3,0
50513,1,3,177001,177003,177006,2,5,0
50514,2,1,177003,177006,177007,3,4,0
50515,3,2,177006,177007,177009,1,3,0
50516,4,2,177010,177010,177012,0,2,1
50517,6,3,177016,177016,177019,0,3,4
50518,2,1,177018,177019,177020,1,2,0
50519,6,2,177024,177024,177026,0,2,4
50520,6,3,177030,177030,177033,0,3,4
50521,5,3,177035,177035,177038,0,3,2
50522,5,2,177040,177040,177042,0,2,2
50523,3,3,177043,177043,177046,0,3,1
50524,2,2,177045,177046,177048,1,3,0
50525,3,1,177048,177048,177049,0,1,0
50526,1,1,177049,177049,177050,0,1,0
50527,3,2,177052,177052,177054,0,2,2
50528,2,1,177054,177054,177055,0,1,0
50529,4,2,177058,177058,177060,0,2,3
50530,3,2,177061,177061,177063,0,2,1
50531,3,1,177064,177064,177065,0,1,1
50532,5,2,177069,177069,177071,0,2,4
50533,4,1,177073,177073,177074,0,1,2
50534,2,3,177075,177075,177078,0,3,1
50535,4,2,177079,177079,177081,0,2,1
50536,2,3,177081,177081,177084,0,3,0
50537,4,2,177085,177085,177087,0,2,1
50538,1,1,177086,177087,177088,1,2,0
50539,6,3,177092,177092,177095,0,3,4
50540,6,3,177098,177098,177101,0,3,3
50541,4,3,177102,177102,177105,0,3,1
50542,5,1,177107,177107,177108,0,1,2
50543,1,1,177108,177108,177109,0,1,0
50544,1,1,177109,177109,177110,0,1,0
50545,5,2,177114,177114,177116,0,2,4
50546,4,2,177118,177118,177120,0,2,2
50547,5,1,177123,177123,177124,0,1,3
50548,5,1,177128,177128,177129,0,1,4
50549,2,1,177130,177130,177131,0,1,1
50550,3,2,177133,177133,177135,0,2,2
50551,3,1,177136,177136,177137,0,1,1
50552,2,2,177138,177138,177140,0,2,1
50553,6,3,177144,177144,177147,0,3,4
50554,2,2,177146,177147,177149,1,3,0
50555,3,1,177149,177149,177150,0,1,0
50556,4,2,177153,177153,177155,0,2,3
50557,2,1,177155,177155,177156,0,1,0
50558,2,3,177157,177157,177160,0,3,1
50559,3,2,177160,177160,177162,0,2,0
50560,5,1,177165,177165,177166,0,1,3
50561,6,2,177171,177171,177173,0,2,5
50562,6,2,177177,177177,177179,0,2,4
50563,3,2,177180,177180,177182,0,2,1
50564,6,3,177186,177186,177189,0,3,4
50565,5,2,177191,177191,177193,0,2,2
50566,3,2,177194,177194,177196,0,2,1
50567,3,1,177197,177197,177198,0,1,1
50568,5,2,177202,177202,177204,0,2,4
50569,3,2,177205,177205,177207,0,2,1
50570,2,2,177207,177207,177209,0,2,0
50571,4,1,177211,177211,177212,0,1,2
50572,3,1,177214,177214,177215,0,1,2
50573,1,2,177215,177215,177217,0,2,0
50574,3,2,177218,177218,177220,0,2,1
50575,1,2,177219,177220,177222,1,3,0
50576,6,3,177225,177225,177228,0,3,3
50577,1,2,177226,177228,177230,2,4,0
50578,3,1,177229,177230,177231,1,2,0
50579,1,3,177230,177231,177234,1,4,0
50580,4,2,177234,177234,177236,0,2,0
50581,1,2,177235,177236,177238,1,3,0
50582,5,3,177240,177240,177243,0,3,2
50583,4,2,177244,177244,177246,0,2,1
50584,3,1,177247,177247,177248,0,1,1
50585,6,1,177253,177253,177254,0,1,5
50586,2,1,177255,177255,177256,0,1,1
50587,2,3,177257,177257,177260,0,3,1
50588,5,2,177262,177262,177264,0,2,2
50589,5,3,177267,177267,177270,0,3,3
50590,3,3,177270,177270,177273,0,3,0
50591,4,2,177274,177274,177276,0,2,1
50592,6,3,177280,177280,177283,0,3,4
50593,3,1,177283,177283,177284,0,1,0
50594,2,2,177285,177285,177287,0,2,1
50595,5,2,177290,177290,177292,0,2,3
50596,3,3,177293,177293,177296,0,3,1
50597,3,3,177296,177296,177299,0,3,0
50598,3,2,177299,177299,177301,0,2,0
50599,1,2,177300,177301,177303,1,3,0
50600,4,1,177304,177304,177305,0,1,1
50601,1,3,177305,177305,177308,0,3,0
50602,6,2,177311,177311,177313,0,2,3
50603,2,3,177313,177313,177316,0,3,0
50604,2,1,177315,177316,177317,1,2,0
50605,5,3,177320,177320,177323,0,3,3
50606,2,2,177322,177323,177325,1,3,0
50607,4,3,177326,177326,177329,0,3,1
50608,5,3,177331,177331,177334,0,3,2
50609,2,3,177333,177334,177337,1,4,0
50610,4,3,177337,177337,177340,0,3,0
50611,4,1,177341,177341,177342,0,1,1
50612,4,3,177345,177345,177348,0,3,3
50613,2,2,177347,177348,177350,1,3,0
50614,6,2,177353,177353,177355,0,2,3
50615,2,1,177355,177355,177356,0,1,0
50616,6,1,177361,177361,177362,0,1,5
50617,1,2,177362,177362,177364,0,2,0
50618,4,1,177366,177366,177367,0,1,2
50619,1,2,177367,177367,177369,0,2,0
50620,3,1,177370,177370,177371,0,1,1
50621,4,1,177374,177374,177375,0,1,3
50622,1,2,177375,177375,177377,0,2,0
50623,3,3,177378,177378,177381,0,3,1
50624,2,1,177380,177381,177382,1,2,0
50625,5,2,177385,177385,177387,0,2,3
50626,5,2,177390,177390,177392,0,2,3
50627,4,2,177394,177394,177396,0,2,2
50628,3,3,177397,177397,177400,0,3,1
50629,4,2,177401,177401,177403,0,2,1
50630,5,2,177406,177406,177408,0,2,3
50631,2,2,177408,177408,177410,0,2,0
50632,2,2,177410,177410,177412,0,2,0
50633,3,3,177413,177413,177416,0,3,1
50634,5,2,177418,177418,177420,0,2,2
50635,2,3,177420,177420,177423,0,3,0
50636,5,1,177425,177425,177426,0,1,2
50637,1,1,177426,177426,177427,0,1,0
50638,6,2,177432,177432,177434,0,2,5
50639,5,3,177437,177437,177440,0,3,3
50640,6,2,177443,177443,177445,0,2,3
50641,6,2,177449,177449,177451,0,2,4
50642,5,3,177454,177454,177457,0,3,3
50643,1,1,177455,177457,177458,2,3,0
50644,2,1,177457,177458,177459,1,2,0
50645,6,2,177463,177463,177465,0,2,4
50646,1,1,177464,177465,177466,1,2,0
50647,1,3,177465,177466,177469,1,4,0
50648,6,3,177471,177471,177474,0,3,2
50649,1,1,177472,177474,177475,2,3,0
50650,4,3,177476,177476,177479,0,3,1
50651,2,1,177478,177479,177480,1,2,0
50652,2,2,177480,177480,177482,0,2,0
50653,3,3,177483,177483,177486,0,3,1
50654,4,1,177487,177487,177488,0,1,1
50655,5,2,177492,177492,177494,0,2,4
50656,4,3,177496,177496,177499,0,3,2
50657,6,2,177502,177502,177504,0,2,3
50658,6,2,177508,177508,177510,0,2,4
50659,4,3,177512,177512,177515,0,3,2
50660,1,1,177513,177515,177516,2,3,0
50661,6,2,177519,177519,177521,0,2,3
50662,6,2,177525,177525,177527,0,2,4
50663,1,1,177526,177527,177528,1,2,0
50664,1,3,177527,177528,177531,1,4,0
50665,4,2,177531,177531,177533,0,2,0
50666,4,3,177535,177535,177538,0,3,2
50667,4,2,177539,177539,177541,0,2,1
50668,2,3,177541,177541,177544,0,3,0
50669,4,2,177545,177545,177547,0,2,1
50670,4,3,177549,177549,177552,0,3,2
50671,3,3,177552,177552,177555,0,3,0
50672,1,2,177553,177555,177557,2,4,0
50673,1,1,177554,177557,177558,3,4,0
50674,4,3,177558,177558,177561,0,3,0
50675,5,1,177563,177563,177564,0,1,2
50676,6,1,177569,177569,177570,0,1,5
50677,3,3,177572,177572,177575,0,3,2
50678,6,2,177578,177578,177580,0,2,3
50679,2,2,177580,177580,177582,0,2,0
50680,3,1,177583,177583,177584,0,1,1
50681,5,2,177588,177588,177590,0,2,4
50682,4,2,177592,177592,177594,0,2,2
50683,6,3,177598,177598,177601,0,3,4
50684,3,2,177601,177601,177603,0,2,0
50685,1,2,177602,177603,177605,1,3,0
50686,3,3,177605,177605,177608,0,3,0
50687,5,3,177610,177610,177613,0,3,2
50688,6,1,177616,177616,177617,0,1,3
50689,6,2,177622,177622,177624,0,2,5
50690,2,3,177624,177624,177627,0,3,0
50691,6,2,177630,177630,177632,0,2,3
50692,1,2,177631,177632,177634,1,3,0
50693,6,3,177637,177637,177640,0,3,3
50694,2,3,177639,177640,177643,1,4,0
50695,1,3,177640,177643,177646,3,6,0
50696,5,1,177645,177646,177647,1,2,0
50697,2,3,177647,177647,177650,0,3,0
50698,4,2,177651,177651,177653,0,2,1
50699,4,3,177655,177655,177658,0,3,2
50700,6,2,177661,177661,177663,0,2,3
50701,2,3,177663,177663,177666,0,3,0
50702,3,1,177666,177666,177667,0,1,0
50703,1,1,177667,177667,177668,0,1,0
50704,5,2,177672,177672,177674,0,2,4
50705,4,1,177676,177676,177677,0,1,2
50706,5,1,177681,177681,177682,0,1,4
50707,4,3,177685,177685,177688,0,3,3
50708,6,3,177691,177691,177694,0,3,3
50709,5,2,177696,177696,177698,0,2,2
50710,2,2,177698,177698,177700,0,2,0
50711,5,1,177703,177703,177704,0,1,3
50712,6,3,177709,177709,177712,0,3,5
50713,1,3,177710,177712,177715,2,5,0
50714,3,1,177713,177715,177716,2,3,0
50715,2,1,177715,177716,177717,1,2,0
50716,2,1,177717,177717,177718,0,1,0
50717,4,1,177721,177721,177722,0,1,3
50718,1,2,177722,177722,177724,0,2,0
50719,6,1,177728,177728,177729,0,1,4
50720,5,3,177733,177733,177736,0,3,4
50721,5,1,177738,177738,177739,0,1,2
50722,2,3,177740,177740,177743,0,3,1
50723,6,3,177746,177746,177749,0,3,3
50724,5,3,177751,177751,177754,0,3,2
50725,6,1,177757,177757,177758,0,1,3
50726,5,2,177762,177762,177764,0,2,4
50727,2,3,177764,177764,177767,0,3,0
50728,4,1,177768,177768,177769,0,1,1
50729,1,3,177769,177769,177772,0,3,0
50730,4,2,177773,177773,177775,0,2,1
50731,5,2,177778,177778,177780,0,2,3
50732,4,1,177782,177782,177783,0,1,2
50733,1,1,177783,177783,177784,0,1,0
50734,2,3,177785,177785,177788,0,3,1
50735,2,3,177787,177788,177791,1,4,0
50736,1,3,177788,177791,177794,3,6,0
50737,6,3,177794,177794,177797,0,3,0
50738,3,1,177797,177797,177798,0,1,0
50739,4,3,177801,177801,177804,0,3,3
50740,3,1,177804,177804,177805,0,1,0
50741,6,1,177810,177810,177811,0,1,5
50742,2,2,177812,177812,177814,0,2,1
50743,5,3,177817,177817,177820,0,3,3
50744,6,1,177823,177823,177824,0,1,3
50745,6,1,177829,177829,177830,0,1,5
50746,3,2,177832,177832,177834,0,2,2
50747,2,2,177834,177834,177836,0,2,0
50748,2,3,177836,177836,177839,0,3,0
50749,5,3,177841,177841,177844,0,3,2
50750,6,2,177847,177847,177849,0,2,3
50751,1,3,177848,177849,177852,1,4,0
50752,5,2,177853,177853,177855,0,2,1
50753,3,3,177856,177856,177859,0,3,1
50754,3,1,177859,177859,177860,0,1,0
50755,6,2,177865,177865,177867,0,2,5
50756,2,3,177867,177867,177870,0,3,0
50757,1,3,177868,177870,177873,2,5,0
50758,4,3,177872,177873,177876,1,4,0
50759,4,1,177876,177876,177877,0,1,0
50760,1,2,177877,177877,177879,0,2,0
50761,1,1,177878,177879,177880,1,2,0
50762,1,1,177879,177880,177881,1,2,0
50763,4,2,177883,177883,177885,0,2,2
50764,6,1,177889,177889,177890,0,1,4
50765,5,2,177894,177894,177896,0,2,4
50766,2,2,177896,177896,177898,0,2,0
50767,4,3,177900,177900,177903,0,3,2
50768,5,1,177905,177905,177906,0,1,2
50769,3,1,177908,177908,177909,0,1,2
50770,1,3,177909,177909,177912,0,3,0
50771,4,3,177913,177913,177916,0,3,1
50772,3,1,177916,177916,177917,0,1,0
50773,4,2,177920,177920,177922,0,2,3
50774,3,1,177923,177923,177924,0,1,1
50775,3,2,177926,177926,177928,0,2,2
50776,3,2,177929,177929,177931,0,2,1
50777,5,3,177934,177934,177937,0,3,3
50778,3,2,177937,177937,177939,0,2,0
50779,4,3,177941,177941,177944,0,3,2
50780,1,2,177942,177944,177946,2,4,0
50781,1,1,177943,177946,177947,3,4,0
50782,1,3,177944,177947,177950,3,6,0
50783,4,1,177948,177950,177951,2,3,0
50784,1,1,177949,177951,177952,2,3,0
50785,4,2,177953,177953,177955,0,2,1
50786,3,1,177956,177956,177957,0,1,1
50787,3,2,177959,177959,177961,0,2,2
50788,5,2,177964,177964,177966,0,2,3
50789,1,2,177965,177966,177968,1,3,0
50790,3,3,177968,177968,177971,0,3,0
50791,4,1,177972,177972,177973,0,1,1
50792,5,2,177977,177977,177979,0,2,4
50793,2,1,177979,177979,177980,0,1,0
50794,1,1,177980,177980,177981,0,1,0
50795,5,1,177985,177985,177986,0,1,4
50796,6,1,177991,177991,177992,0,1,5
50797,1,1,177992,177992,177993,0,1,0
50798,4,3,177996,177996,177999,0,3,3
50799,3,3,177999,177999,178002,0,3,0
50800,3,3,178002,178002,178005,0,3,0
50801,2,2,178004,178005,178007,1,3,0
50802,3,1,178007,178007,178008,0,1,0
50803,5,2,178012,178012,178014,0,2,4
50804,6,3,178018,178018,178021,0,3,4
50805,1,1,178019,178021,178022,2,3,0
50806,2,2,178021,178022,178024,1,3,0
50807,4,3,178025,178025,178028,0,3,1
50808,5,2,178030,178030,178032,0,2,2
50809,6,3,178036,178036,178039,0,3,4
50810,6,2,178042,178042,178044,0,2,3
50811,2,3,178044,178044,178047,0,3,0
50812,3,2,178047,178047,178049,0,2,0
50813,3,1,178050,178050,178051,0,1,1
50814,5,2,178055,178055,178057,0,2,4
50815,6,2,178061,178061,178063,0,2,4
50816,6,1,178067,178067,178068,0,1,4
50817,6,2,178073,178073,178075,0,2,5
50818,3,1,178076,178076,178077,0,1,1
50819,6,3,178082,178082,178085,0,3,5
50820,3,1,178085,178085,178086,0,1,0
50821,6,2,178091,178091,178093,0,2,5
50822,5,2,178096,178096,178098,0,2,3
50823,1,1,178097,178098,178099,1,2,0
50824,4,2,178101,178101,178103,0,2,2
50825,3,1,178104,178104,178105,0,1,1
50826,6,1,178110,178110,178111,0,1,5
50827,2,1,178112,178112,178113,0,1,1
50828,5,2,178117,178117,178119,0,2,4
50829,1,2,178118,178119,178121,1,3,0
50830,2,3,178120,178121,178124,1,4,0
50831,5,3,178125,178125,178128,0,3,1
50832,6,2,178131,178131,178133,0,2,3
50833,6,1,178137,178137,178138,0,1,4
50834,4,2,178141,178141,178143,0,2,3
50835,6,2,178147,178147,178149,0,2,4
50836,1,3,178148,178149,178152,1,4,0
50837,1,3,178149,178152,178155,3,6,0
50838,3,3,178152,178155,178158,3,6,0
50839,4,3,178156,178158,178161,2,5,0
50840,4,3,178160,178161,178164,1,4,0
50841,1,3,178161,178164,178167,3,6,0
50842,6,1,178167,178167,178168,0,1,0
50843,5,3,178172,178172,178175,0,3,4
50844,4,3,178176,178176,178179,0,3,1
50845,1,3,178177,178179,178182,2,5,0
50846,1,3,178178,178182,178185,4,7,0
50847,4,1,178182,178185,178186,3,4,0
50848,2,1,178184,178186,178187,2,3,0
50849,2,1,178186,178187,178188,1,2,0
50850,5,1,178191,178191,178192,0,1,3
50851,6,1,178197,178197,178198,0,1,5
50852,5,1,178202,178202,178203,0,1,4
50853,5,2,178207,178207,178209,0,2,4
50854,1,2,178208,178209,178211,1,3,0
50855,6,3,178214,178214,178217,0,3,3
50856,1,2,178215,178217,178219,2,4,0
50857,1,3,178216,178219,178222,3,6,0
50858,4,2,178220,178222,178224,2,4,0
50859,3,3,178223,178224,178227,1,4,0
50860,5,3,178228,178228,178231,0,3,1
50861,2,3,178230,178231,178234,1,4,0
50862,4,3,178234,178234,178237,0,3,0
50863,2,1,178236,178237,178238,1,2,0
50864,3,3,178239,178239,178242,0,3,1
50865,4,1,178243,178243,178244,0,1,1
50866,6,3,178249,178249,178252,0,3,5
50867,1,1,178250,178252,178253,2,3,0
50868,2,2,178252,178253,178255,1,3,0
50869,5,1,178257,178257,178258,0,1,2
50870,2,1,178259,178259,178260,0,1,1
50871,4,3,178263,178263,178266,0,3,3
50872,2,2,178265,178266,178268,1,3,0
50873,3,2,178268,178268,178270,0,2,0
50874,4,2,178272,178272,178274,0,2,2
50875,3,2,178275,178275,178277,0,2,1
50876,5,2,178280,178280,178282,0,2,3
50877,4,1,178284,178284,178285,0,1,2
50878,2,1,178286,178286,178287,0,1,1
50879,1,2,178287,178287,178289,0,2,0
50880,2,3,178289,178289,178292,0,3,0
50881,5,3,178294,178294,178297,0,3,2
50882,5,1,178299,178299,178300,0,1,2
50883,1,2,178300,178300,178302,0,2,0
50884,1,3,178301,178302,178305,1,4,0
50885,2,1,178303,178305,178306,2,3,0
50886,2,2,178305,178306,178308,1,3,0
50887,3,2,178308,178308,178310,0,2,0
50888,4,2,178312,178312,178314,0,2,2
50889,3,2,178315,178315,178317,0,2,1
50890,1,1,178316,178317,178318,1,2,0
50891,5,3,178321,178321,178324,0,3,3
50892,4,2,178325,178325,178327,0,2,1
50893,4,2,178329,178329,178331,0,2,2
50894,3,1,178332,178332,178333,0,1,1
50895,1,2,178333,178333,178335,0,2,0
50896,2,2,178335,178335,178337,0,2,0
50897,4,1,178339,178339,178340,0,1,2
50898,2,1,178341,178341,178342,0,1,1
50899,1,2,178342,178342,178344,0,2,0
50900,5,2,178347,178347,178349,0,2,3
50901,2,2,178349,178349,178351,0,2,0
50902,1,2,178350,178351,178353,1,3,0
50903,4,2,178354,178354,178356,0,2,1
50904,3,3,178357,178357,178360,0,3,1
50905,6,1,178363,178363,178364,0,1,3
50906,2,2,178365,178365,178367,0,2,1
50907,6,3,178371,178371,178374,0,3,4
50908,4,1,178375,178375,178376,0,1,1
50909,5,3,178380,178380,178383,0,3,4
50910,4,1,178384,178384,178385,0,1,1
50911,3,3,178387,178387,178390,0,3,2
50912,1,1,178388,178390,178391,2,3,0
50913,4,1,178392,178392,178393,0,1,1
50914,4,1,178396,178396,178397,0,1,3
50915,2,1,178398,178398,178399,0,1,1
50916,2,3,178400,178400,178403,0,3,1
50917,3,2,178403,178403,178405,0,2,0
50918,1,2,178404,178405,178407,1,3,0
50919,3,3,178407,178407,178410,0,3,0
50920,3,3,178410,178410,178413,0,3,0
50921,2,2,178412,178413,178415,1,3,0
50922,3,3,178415,178415,178418,0,3,0
50923,4,3,178419,178419,178422,0,3,1
50924,5,3,178424,178424,178427,0,3,2
50925,4,2,178428,178428,178430,0,2,1
50926,3,2,178431,178431,178433,0,2,1
50927,3,1,178434,178434,178435,0,1,1
50928,1,1,178435,178435,178436,0,1,0
50929,1,1,178436,178436,178437,0,1,0
50930,2,2,178438,178438,178440,0,2,1
50931,3,2,178441,178441,178443,0,2,1
50932,6,1,178447,178447,178448,0,1,4
50933,6,3,178453,178453,178456,0,3,5
50934,3,1,178456,178456,178457,0,1,0
50935,5,2,178461,178461,178463,0,2,4
50936,5,2,178466,178466,178468,0,2,3
50937,1,1,178467,178468,178469,1,2,0
50938,3,3,178470,178470,178473,0,3,1
50939,3,3,178473,178473,178476,0,3,0
50940,5,3,178478,178478,178481,0,3,2
50941,4,2,178482,178482,178484,0,2,1
50942,3,2,178485,178485,178487,0,2,1
50943,3,1,178488,178488,178489,0,1,1
50944,3,1,178491,178491,178492,0,1,2
50945,3,2,178494,178494,178496,0,2,2
50946,1,2,178495,178496,178498,1,3,0
50947,6,3,178501,178501,178504,0,3,3
50948,4,1,178505,178505,178506,0,1,1
50949,4,2,178509,178509,178511,0,2,3
50950,1,2,178510,178511,178513,1,3,0
50951,5,3,178515,178515,178518,0,3,2
50952,1,2,178516,178518,178520,2,4,0
50953,5,2,178521,178521,178523,0,2,1
50954,2,1,178523,178523,178524,0,1,0
50955,4,2,178527,178527,178529,0,2,3
50956,3,1,178530,178530,178531,0,1,1
50957,4,2,178534,178534,178536,0,2,3
50958,5,3,178539,178539,178542,0,3,3
50959,1,3,178540,178542,178545,2,5,0
50960,1,3,178541,178545,178548,4,7,0
50961,5,3,178546,178548,178551,2,5,0
50962,4,1,178550,178551,178552,1,2,0
50963,5,3,178555,178555,178558,0,3,3
50964,4,3,178559,178559,178562,0,3,1
50965,1,3,178560,178562,178565,2,5,0
50966,6,1,178566,178566,178567,0,1,1
50967,6,2,178572,178572,178574,0,2,5
50968,1,1,178573,178574,178575,1,2,0
50969,3,3,178576,178576,178579,0,3,1
50970,3,1,178579,178579,178580,0,1,0
50971,6,2,178585,178585,178587,0,2,5
50972,3,2,178588,178588,178590,0,2,1
50973,5,2,178593,178593,178595,0,2,3
50974,4,1,178597,178597,178598,0,1,2
50975,5,1,178602,178602,178603,0,1,4
50976,3,2,178605,178605,178607,0,2,2
50977,2,1,178607,178607,178608,0,1,0
50978,5,2,178612,178612,178614,0,2,4
50979,4,3,178616,178616,178619,0,3,2
50980,4,2,178620,178620,178622,0,2,1
50981,6,3,178626,178626,178629,0,3,4
50982,6,3,178632,178632,178635,0,3,3
50983,2,1,178634,178635,178636,1,2,0
50984,3,1,178637,178637,178638,0,1,1
50985,5,3,178642,178642,178645,0,3,4
50986,5,3,178647,178647,178650,0,3,2
50987,6,1,178653,178653,178654,0,1,3
50988,2,2,178655,178655,178657,0,2,1
50989,5,2,178660,178660,178662,0,2,3
50990,1,3,178661,178662,178665,1,4,0
50991,5,1,178666,178666,178667,0,1,1
50992,3,1,178669,178669,178670,0,1,2
50993,2,2,178671,178671,178673,0,2,1
50994,3,3,178674,178674,178677,0,3,1
50995,1,2,178675,178677,178679,2,4,0
50996,2,3,178677,178679,178682,2,5,0
50997,2,1,178679,178682,178683,3,4,0
50998,1,2,178680,178683,178685,3,5,0
50999,1,3,178681,178685,178688,4,7,0
51000,5,1,178686,178688,178689,2,3,0
51001,4,3,178690,178690,178693,0,3,1
51002,1,2,178691,178693,178695,2,4,0
51003,1,3,178692,178695,178698,3,6,0
51004,2,1,178694,178698,178699,4,5,0
51005,4,1,178698,178699,178700,1,2,0
51006,6,3,178704,178704,178707,0,3,4
51007,3,1,178707,178707,178708,0,1,0
51008,6,3,178713,178713,178716,0,3,5
51009,2,3,178715,178716,178719,1,4,0
51010,4,2,178719,178719,178721,0,2,0
51011,3,1,178722,178722,178723,0,1,1
51012,3,3,178725,178725,178728,0,3,2
51013,1,1,178726,178728,178729,2,3,0
51014,6,2,178732,178732,178734,0,2,3
51015,2,1,178734,178734,178735,0,1,0
51016,1,2,178735,178735,178737,0,2,0
51017,1,1,178736,178737,178738,1,2,0
51018,1,2,178737,178738,178740,1,3,0
51019,6,2,178743,178743,178745,0,2,3
51020,5,2,178748,178748,178750,0,2,3
51021,4,3,178752,178752,178755,0,3,2
51022,5,1,178757,178757,178758,0,1,2
51023,6,1,178763,178763,178764,0,1,5
51024,6,3,178769,178769,178772,0,3,5
51025,4,2,178773,178773,178775,0,2,1
51026,1,2,178774,178775,178777,1,3,0
51027,3,2,178777,178777,178779,0,2,0
51028,6,3,178783,178783,178786,0,3,4
51029,1,2,178784,178786,178788,2,4,0
51030,1,2,178785,178788,178790,3,5,0
51031,5,2,178790,178790,178792,0,2,0
51032,4,2,178794,178794,178796,0,2,2
51033,3,2,178797,178797,178799,0,2,1
51034,4,1,178801,178801,178802,0,1,2
51035,3,2,178804,178804,178806,0,2,2
51036,2,3,178806,178806,178809,0,3,0
51037,5,3,178811,178811,178814,0,3,2
51038,6,2,178817,178817,178819,0,2,3
51039,5,3,178822,178822,178825,0,3,3
51040,2,1,178824,178825,178826,1,2,0
51041,2,3,178826,178826,178829,0,3,0
51042,3,1,178829,178829,178830,0,1,0
51043,3,1,178832,178832,178833,0,1,2
51044,5,3,178837,178837,178840,0,3,4
51045,6,2,178843,178843,178845,0,2,3
51046,2,1,178845,178845,178846,0,1,0
51047,6,3,178851,178851,178854,0,3,5
51048,3,3,178854,178854,178857,0,3,0
51049,2,2,178856,178857,178859,1,3,0
51050,1,2,178857,178859,178861,2,4,0
51051,4,2,178861,178861,178863,0,2,0
51052,2,1,178863,178863,178864,0,1,0
51053,6,3,178869,178869,178872,0,3,5
51054,5,1,178874,178874,178875,0,1,2
51055,2,3,178876,178876,178879,0,3,1
51056,6,3,178882,178882,178885,0,3,3
51057,1,3,178883,178885,178888,2,5,0
51058,6,2,178889,178889,178891,0,2,1
51059,3,1,178892,178892,178893,0,1,1
51060,4,1,178896,178896,178897,0,1,3
51061,6,2,178902,178902,178904,0,2,5
51062,3,1,178905,178905,178906,0,1,1
51063,6,3,178911,178911,178914,0,3,5
51064,1,2,178912,178914,178916,2,4,0
51065,6,2,178918,178918,178920,0,2,2
51066,3,1,178921,178921,178922,0,1,1
51067,1,3,178922,178922,178925,0,3,0
51068,5,1,178927,178927,178928,0,1,2
51069,6,3,178933,178933,178936,0,3,5
51070,4,1,178937,178937,178938,0,1,1
51071,5,1,178942,178942,178943,0,1,4
51072,2,1,178944,178944,178945,0,1,1
51073,4,2,178948,178948,178950,0,2,3
51074,5,3,178953,178953,178956,0,3,3
51075,3,3,178956,178956,178959,0,3,0
51076,1,3,178957,178959,178962,2,5,0
51077,4,1,178961,178962,178963,1,2,0
51078,2,2,178963,178963,178965,0,2,0
51079,5,1,178968,178968,178969,0,1,3
51080,5,2,178973,178973,178975,0,2,4
51081,3,2,178976,178976,178978,0,2,1
51082,3,2,178979,178979,178981,0,2,1
51083,2,1,178981,178981,178982,0,1,0
51084,4,3,178985,178985,178988,0,3,3
51085,1,3,178986,178988,178991,2,5,0
51086,3,1,178989,178991,178992,2,3,0
51087,4,1,178993,178993,178994,0,1,1
51088,4,3,178997,178997,179000,0,3,3
51089,2,2,178999,179000,179002,1,3,0
51090,4,2,179003,179003,179005,0,2,1
51091,3,2,179006,179006,179008,0,2,1
51092,1,1,179007,179008,179009,1,2,0
51093,3,3,179010,179010,179013,0,3,1
51094,4,1,179014,179014,179015,0,1,1
51095,5,2,179019,179019,179021,0,2,4
51096,6,1,179025,179025,179026,0,1,4
51097,5,1,179030,179030,179031,0,1,4
51098,2,1,179032,179032,179033,0,1,1
51099,3,1,179035,179035,179036,0,1,2
51100,2,1,179037,179037,179038,0,1,1
51101,1,3,179038,179038,179041,0,3,0
51102,6,3,179044,179044,179047,0,3,3
51103,1,1,179045,179047,179048,2,3,0
51104,4,2,179049,179049,179051,0,2,1
51105,1,2,179050,179051,179053,1,3,0
51106,3,1,179053,179053,179054,0,1,0
51107,5,2,179058,179058,179060,0,2,4
51108,4,2,179062,179062,179064,0,2,2
51109,2,1,179064,179064,179065,0,1,0
51110,3,1,179067,179067,179068,0,1,2
51111,5,3,179072,179072,179075,0,3,4
51112,2,1,179074,179075,179076,1,2,0
51113,1,3,179075,179076,179079,1,4,0
51114,3,2,179078,179079,179081,1,3,0
51115,2,2,179080,179081,179083,1,3,0
51116,2,3,179082,179083,179086,1,4,0
51117,4,3,179086,179086,179089,0,3,0
51118,6,1,179092,179092,179093,0,1,3
51119,5,2,179097,179097,179099,0,2,4
51120,3,2,179100,179100,179102,0,2,1
51121,5,3,179105,179105,179108,0,3,3
51122,1,3,179106,179108,179111,2,5,0
51123,1,2,179107,179111,179113,4,6,0
51124,1,3,179108,179113,179116,5,8,0
51125,1,2,179109,179116,179118,7,9,0
51126,1,2,179110,179118,179120,8,10,0
51127,3,1,179113,179120,179121,7,8,0
51128,5,1,179118,179121,179122,3,4,0
51129,6,3,179124,179124,179127,0,3,2
51130,2,3,179126,179127,179130,1,4,0
51131,5,2,179131,179131,179133,0,2,1
51132,4,1,179135,179135,179136,0,1,2
51133,3,1,179138,179138,179139,0,1,2
51134,5,2,179143,179143,179145,0,2,4
51135,3,1,179146,179146,179147,0,1,1
51136,6,1,179152,179152,179153,0,1,5
51137,5,1,179157,179157,179158,0,1,4
51138,1,3,179158,179158,179161,0,3,0
51139,3,2,179161,179161,179163,0,2,0
51140,1,2,179162,179163,179165,1,3,0
51141,2,1,179164,179165,179166,1,2,0
51142,6,1,179170,179170,179171,0,1,4
51143,2,3,179172,179172,179175,0,3,1
51144,4,3,179176,179176,179179,0,3,1
51145,1,2,179177,179179,179181,2,4,0
51146,3,1,179180,179181,179182,1,2,0
51147,2,2,179182,179182,179184,0,2,0
51148,4,2,179186,179186,179188,0,2,2
51149,3,2,179189,179189,179191,0,2,1
51150,6,3,179195,179195,179198,0,3,4
51151,2,3,179197,179198,179201,1,4,0
51152,3,3,179200,179201,179204,1,4,0
51153,3,1,179203,179204,179205,1,2,0
51154,1,1,179204,179205,179206,1,2,0
51155,2,3,179206,179206,179209,0,3,0
51156,5,1,179211,179211,179212,0,1,2
51157,1,1,179212,179212,179213,0,1,0
51158,6,1,179218,179218,179219,0,1,5
51159,6,2,179224,179224,179226,0,2,5
51160,4,1,179228,179228,179229,0,1,2
51161,5,1,179233,179233,179234,0,1,4
51162,4,1,179237,179237,179238,0,1,3
51163,2,1,179239,179239,179240,0,1,1
51164,2,3,179241,179241,179244,0,3,1
51165,2,2,179243,179244,179246,1,3,0
51166,1,3,179244,179246,179249,2,5,0
51167,4,1,179248,179249,179250,1,2,0
51168,4,3,179252,179252,179255,0,3,2
51169,1,3,179253,179255,179258,2,5,0
51170,2,3,179255,179258,179261,3,6,0
51171,4,2,179259,179261,179263,2,4,0
51172,5,2,179264,179264,179266,0,2,1
51173,2,1,179266,179266,179267,0,1,0
51174,6,1,179272,179272,179273,0,1,5
51175,5,3,179277,179277,179280,0,3,4
51176,6,3,179283,179283,179286,0,3,3
51177,3,1,179286,179286,179287,0,1,0
51178,6,2,179292,179292,179294,0,2,5
51179,2,2,179294,179294,179296,0,2,0
51180,5,2,179299,179299,179301,0,2,3
51181,4,1,179303,179303,179304,0,1,2
51182,5,2,179308,179308,179310,0,2,4
51183,1,1,179309,179310,179311,1,2,0
51184,6,1,179315,179315,179316,0,1,4
51185,3,2,179318,179318,179320,0,2,2
51186,1,1,179319,179320,179321,1,2,0
51187,6,1,179325,179325,179326,0,1,4
51188,5,1,179330,179330,179331,0,1,4
51189,5,2,179335,179335,179337,0,2,4
51190,3,3,179338,179338,179341,0,3,1
51191,6,1,179344,179344,179345,0,1,3
51192,4,1,179348,179348,179349,0,1,3
51193,4,1,179352,179352,179353,0,1,3
51194,6,3,179358,179358,179361,0,3,5
51195,2,2,179360,179361,179363,1,3,0
51196,6,1,179366,179366,179367,0,1,3
51197,5,1,179371,179371,179372,0,1,4
51198,1,3,179372,179372,179375,0,3,0
51199,4,3,179376,179376,179379,0,3,1
51200,4,1,179380,179380,179381,0,1,1
51201,5,3,179385,179385,179388,0,3,4
51202,3,1,179388,179388,179389,0,1,0
51203,2,2,179390,179390,179392,0,2,1
51204,1,1,179391,179392,179393,1,2,0
51205,5,3,179396,179396,179399,0,3,3
51206,2,1,179398,179399,179400,1,2,0
51207,3,2,179401,179401,179403,0,2,1
51208,4,1,179405,179405,179406,0,1,2
51209,3,3,179408,179408,179411,0,3,2
51210,3,1,179411,179411,179412,0,1,0
51211,5,1,179416,179416,179417,0,1,4
51212,6,1,179422,179422,179423,0,1,5
51213,2,1,179424,179424,179425,0,1,1
51214,4,2,179428,179428,179430,0,2,3
51215,1,3,179429,179430,179433,1,4,0
51216,3,1,179432,179433,179434,1,2,0
51217,4,2,179436,179436,179438,0,2,2
51218,5,3,179441,179441,179444,0,3,3
51219,5,2,179446,179446,179448,0,2,2
51220,4,2,179450,179450,179452,0,2,2
51221,3,2,179453,179453,179455,0,2,1
51222,5,3,179458,179458,179461,0,3,3
51223,5,2,179463,179463,179465,0,2,2
51224,3,2,179466,179466,179468,0,2,1
51225,1,1,179467,179468,179469,1,2,0
51226,4,2,179471,179471,179473,0,2,2
51227,3,1,179474,179474,179475,0,1,1
51228,5,2,179479,179479,179481,0,2,4
51229,1,2,179480,179481,179483,1,3,0
51230,1,2,179481,179483,179485,2,4,0
51231,2,1,179483,179485,179486,2,3,0
51232,2,1,179485,179486,179487,1,2,0
51233,5,1,179490,179490,179491,0,1,3
51234,3,2,179493,179493,179495,0,2,2
51235,1,2,179494,179495,179497,1,3,0
51236,4,3,179498,179498,179501,0,3,1
51237,3,3,179501,179501,179504,0,3,0
51238,6,1,179507,179507,179508,0,1,3
51239,6,2,179513,179513,179515,0,2,5
51240,2,1,179515,179515,179516,0,1,0
51241,3,2,179518,179518,179520,0,2,2
51242,2,3,179520,179520,179523,0,3,0
51243,4,2,179524,179524,179526,0,2,1
51244,6,1,179530,179530,179531,0,1,4
51245,6,3,179536,179536,179539,0,3,5
51246,5,1,179541,179541,179542,0,1,2
51247,2,3,179543,179543,179546,0,3,1
51248,4,1,179547,179547,179548,0,1,1
51249,2,2,179549,179549,179551,0,2,1
51250,4,1,179553,179553,179554,0,1,2
51251,5,2,179558,179558,179560,0,2,4
51252,6,3,179564,179564,179567,0,3,4
51253,3,3,179567,179567,179570,0,3,0
51254,1,3,179568,179570,179573,2,5,0
51255,5,3,179573,179573,179576,0,3,0
51256,3,3,179576,179576,179579,0,3,0
51257,6,2,179582,179582,179584,0,2,3
51258,1,3,179583,179584,179587,1,4,0
51259,1,3,179584,179587,179590,3,6,0
51260,2,3,179586,179590,179593,4,7,0
51261,3,3,179589,179593,179596,4,7,0
51262,3,2,179592,179596,179598,4,6,0
51263,3,3,179595,179598,179601,3,6,0
51264,5,3,179600,179601,179604,1,4,0
51265,4,1,179604,179604,179605,0,1,0
51266,4,2,179608,179608,179610,0,2,3
51267,3,3,179611,179611,179614,0,3,1
51268,3,1,179614,179614,179615,0,1,0
51269,2,3,179616,179616,179619,0,3,1
51270,6,3,179622,179622,179625,0,3,3
51271,5,1,179627,179627,179628,0,1,2
51272,2,3,179629,179629,179632,0,3,1
51273,4,3,179633,179633,179636,0,3,1
51274,2,1,179635,179636,179637,1,2,0
51275,3,3,179638,179638,179641,0,3,1
51276,6,3,179644,179644,179647,0,3,3
51277,5,1,179649,179649,179650,0,1,2
51278,5,3,179654,179654,179657,0,3,4
51279,3,2,179657,179657,179659,0,2,0
51280,5,2,179662,179662,179664,0,2,3
51281,3,3,179665,179665,179668,0,3,1
51282,6,3,179671,179671,179674,0,3,3
51283,4,3,179675,179675,179678,0,3,1
51284,4,2,179679,179679,179681,0,2,1
51285,2,1,179681,179681,179682,0,1,0
51286,4,2,179685,179685,179687,0,2,3
51287,2,1,179687,179687,179688,0,1,0
51288,1,1,179688,179688,179689,0,1,0
51289,2,1,179690,179690,179691,0,1,1
51290,5,3,179695,179695,179698,0,3,4
51291,6,2,179701,179701,179703,0,2,3
51292,1,1,179702,179703,179704,1,2,0
51293,4,3,179706,179706,179709,0,3,2
51294,3,1,179709,179709,179710,0,1,0
51295,5,3,179714,179714,179717,0,3,4
51296,3,2,179717,179717,179719,0,2,0
51297,6,2,179723,179723,179725,0,2,4
51298,6,1,179729,179729,179730,0,1,4
51299,3,2,179732,179732,179734,0,2,2
51300,3,3,179735,179735,179738,0,3,1
51301,6,2,179741,179741,179743,0,2,3
51302,2,3,179743,179743,179746,0,3,0
51303,5,1,179748,179748,179749,0,1,2
51304,2,1,179750,179750,179751,0,1,1
51305,1,3,179751,179751,179754,0,3,0
51306,6,1,179757,179757,179758,0,1,3
51307,6,3,179763,179763,179766,0,3,5
51308,4,1,179767,179767,179768,0,1,1
51309,3,2,179770,179770,179772,0,2,2
51310,2,2,179772,179772,179774,0,2,0
51311,2,3,179774,179774,179777,0,3,0
51312,5,3,179779,179779,179782,0,3,2
51313,4,1,179783,179783,179784,0,1,1
51314,5,3,179788,179788,179791,0,3,4
51315,4,2,179792,179792,179794,0,2,1
51316,1,2,179793,179794,179796,1,3,0
51317,6,3,179799,179799,179802,0,3,3
51318,3,3,179802,179802,179805,0,3,0
51319,4,3,179806,179806,179809,0,3,1
51320,5,2,179811,179811,179813,0,2,2
51321,3,1,179814,179814,179815,0,1,1
51322,6,1,179820,179820,179821,0,1,5
51323,6,2,179826,179826,179828,0,2,5
51324,1,3,179827,179828,179831,1,4,0
51325,4,2,179831,179831,179833,0,2,0
51326,4,2,179835,179835,179837,0,2,2
51327,4,3,179839,179839,179842,0,3,2
51328,4,2,179843,179843,179845,0,2,1
51329,2,3,179845,179845,179848,0,3,0
51330,1,1,179846,179848,179849,2,3,0
51331,6,1,179852,179852,179853,0,1,3
51332,5,1,179857,179857,179858,0,1,4
51333,5,2,179862,179862,179864,0,2,4
51334,2,1,179864,179864,179865,0,1,0
51335,3,3,179867,179867,179870,0,3,2
51336,4,1,179871,179871,179872,0,1,1
51337,1,1,179872,179872,179873,0,1,0
51338,4,3,179876,179876,179879,0,3,3
51339,6,2,179882,179882,179884,0,2,3
51340,3,3,179885,179885,179888,0,3,1
51341,5,1,179890,179890,179891,0,1,2
51342,4,1,179894,179894,179895,0,1,3
51343,3,3,179897,179897,179900,0,3,2
51344,2,3,179899,179900,179903,1,4,0
51345,6,3,179905,179905,179908,0,3,2
51346,3,2,179908,179908,179910,0,2,0
51347,3,2,179911,179911,179913,0,2,1
51348,4,3,179915,179915,179918,0,3,2
51349,5,3,179920,179920,179923,0,3,2
51350,5,3,179925,179925,179928,0,3,2
51351,4,2,179929,179929,179931,0,2,1
51352,1,1,179930,179931,179932,1,2,0
51353,3,1,179933,179933,179934,0,1,1
51354,3,1,179936,179936,179937,0,1,2
51355,6,1,179942,179942,179943,0,1,5
51356,5,2,179947,179947,179949,0,2,4
51357,5,2,179952,179952,179954,0,2,3
51358,3,3,179955,179955,179958,0,3,1
51359,2,1,179957,179958,179959,1,2,0
51360,2,1,179959,179959,179960,0,1,0
51361,2,2,179961,179961,179963,0,2,1
51362,5,2,179966,179966,179968,0,2,3
51363,6,2,179972,179972,179974,0,2,4
51364,1,2,179973,179974,179976,1,3,0
51365,2,2,179975,179976,179978,1,3,0
51366,2,2,179977,179978,179980,1,3,0
51367,3,1,179980,179980,179981,0,1,0
51368,4,2,179984,179984,179986,0,2,3
51369,5,2,179989,179989,179991,0,2,3
51370,5,1,179994,179994,179995,0,1,3
51371,6,3,180000,180000,180003,0,3,5
51372,4,3,180004,180004,180007,0,3,1
51373,1,2,180005,180007,180009,2,4,0
51374,2,2,180007,180009,180011,2,4,0
51375,2,3,180009,180011,180014,2,5,0
51376,2,2,180011,180014,180016,3,5,0
51377,1,3,180012,180016,180019,4,7,0
51378,2,1,180014,180019,180020,5,6,0
51379,4,2,180018,180020,180022,2,4,0
51380,6,1,180024,180024,180025,0,1,2
51381,4,3,180028,180028,180031,0,3,3
51382,6,3,180034,180034,180037,0,3,3
51383,3,3,180037,180037,180040,0,3,0
51384,3,1,180040,180040,180041,0,1,0
51385,2,2,180042,180042,180044,0,2,1
51386,5,2,180047,180047,180049,0,2,3
51387,4,3,180051,180051,180054,0,3,2
51388,2,2,180053,180054,180056,1,3,0
51389,1,1,180054,180056,180057,2,3,0
51390,1,3,180055,180057,180060,2,5,0
51391,3,3,180058,180060,180063,2,5,0
51392,4,2,180062,180063,180065,1,3,0
51393,1,2,180063,180065,180067,2,4,0
51394,3,3,180066,180067,180070,1,4,0
51395,2,1,180068,180070,180071,2,3,0
51396,1,2,180069,180071,180073,2,4,0
51397,2,3,180071,180073,180076,2,5,0
51398,6,2,180077,180077,180079,0,2,1
51399,6,2,180083,180083,180085,0,2,4
51400,1,3,180084,180085,180088,1,4,0
51401,3,2,180087,180088,180090,1,3,0
51402,6,1,180093,180093,180094,0,1,3
51403,3,1,180096,180096,180097,0,1,2
51404,5,1,180101,180101,180102,0,1,4
51405,4,2,180105,180105,180107,0,2,3
51406,5,3,180110,180110,180113,0,3,3
51407,1,3,180111,180113,180116,2,5,0
51408,2,2,180113,180116,180118,3,5,0
51409,2,2,180115,180118,180120,3,5,0
51410,6,3,180121,180121,180124,0,3,1
51411,1,2,180122,180124,180126,2,4,0
51412,5,3,180127,180127,180130,0,3,1
51413,1,3,180128,180130,180133,2,5,0
51414,6,2,180134,180134,180136,0,2,1
51415,3,2,180137,180137,180139,0,2,1
51416,3,2,180140,180140,180142,0,2,1
51417,4,2,180144,180144,180146,0,2,2
51418,1,2,180145,180146,180148,1,3,0
51419,4,2,180149,180149,180151,0,2,1
51420,2,1,180151,180151,180152,0,1,0
51421,1,2,180152,180152,180154,0,2,0
51422,5,1,180157,180157,180158,0,1,3
51423,1,2,180158,180158,180160,0,2,0
51424,3,2,180161,180161,180163,0,2,1
51425,5,3,180166,180166,180169,0,3,3
51426,1,2,180167,180169,180171,2,4,0
51427,5,2,180172,180172,180174,0,2,1
51428,4,1,180176,180176,180177,0,1,2
51429,3,1,180179,180179,180180,0,1,2
51430,3,1,180182,180182,180183,0,1,2
51431,6,1,180188,180188,180189,0,1,5
51432,1,2,180189,180189,180191,0,2,0
51433,6,1,180195,180195,180196,0,1,4
51434,5,3,180200,180200,180203,0,3,4
51435,2,3,180202,180203,180206,1,4,0
51436,5,1,180207,180207,180208,0,1,1
51437,5,3,180212,180212,180215,0,3,4
51438,2,2,180214,180215,180217,1,3,0
51439,1,1,180215,180217,180218,2,3,0
51440,4,2,180219,180219,180221,0,2,1
51441,4,3,180223,180223,180226,0,3,2
51442,2,1,180225,180226,180227,1,2,0
51443,6,2,180231,180231,180233,0,2,4
51444,5,1,180236,180236,180237,0,1,3
51445,6,1,180242,180242,180243,0,1,5
51446,2,3,180244,180244,180247,0,3,1
51447,1,1,180245,180247,180248,2,3,0
51448,6,1,180251,180251,180252,0,1,3
51449,5,1,180256,180256,180257,0,1,4
51450,6,3,180262,180262,180265,0,3,5
51451,4,1,180266,180266,180267,0,1,1
51452,6,2,180272,180272,180274,0,2,5
51453,2,3,180274,180274,180277,0,3,0
51454,6,2,180280,180280,180282,0,2,3
51455,5,2,180285,180285,180287,0,2,3
51456,4,3,180289,180289,180292,0,3,2
51457,5,3,180294,180294,180297,0,3,2
51458,3,1,180297,180297,180298,0,1,0
51459,2,3,180299,180299,180302,0,3,1
51460,4,2,180303,180303,180305,0,2,1
51461,1,3,180304,180305,180308,1,4,0
51462,6,2,180310,180310,180312,0,2,2
51463,2,2,180312,180312,180314,0,2,0
51464,6,1,180318,180318,180319,0,1,4
51465,5,2,180323,180323,180325,0,2,4
51466,1,1,180324,180325,180326,1,2,0
51467,6,1,180330,180330,180331,0,1,4
51468,3,2,180333,180333,180335,0,2,2
51469,2,3,180335,180335,180338,0,3,0
51470,6,3,180341,180341,180344,0,3,3
51471,4,1,180345,180345,180346,0,1,1
51472,5,2,180350,180350,180352,0,2,4
51473,3,3,180353,180353,180356,0,3,1
51474,4,3,180357,180357,180360,0,3,1
51475,3,3,180360,180360,180363,0,3,0
51476,5,3,180365,180365,180368,0,3,2
51477,1,2,180366,180368,180370,2,4,0
51478,5,1,180371,180371,180372,0,1,1
51479,1,3,180372,180372,180375,0,3,0
51480,5,3,180377,180377,180380,0,3,2
51481,5,2,180382,180382,180384,0,2,2
51482,4,1,180386,180386,180387,0,1,2
51483,3,3,180389,180389,180392,0,3,2
51484,1,1,180390,180392,180393,2,3,0
51485,2,1,180392,180393,180394,1,2,0
51486,3,1,180395,180395,180396,0,1,1
51487,4,1,180399,180399,180400,0,1,3
51488,5,3,180404,180404,180407,0,3,4
51489,6,2,180410,180410,180412,0,2,3
51490,1,2,180411,180412,180414,1,3,0
51491,3,1,180414,180414,180415,0,1,0
51492,6,3,180420,180420,180423,0,3,5
51493,4,3,180424,180424,180427,0,3,1
51494,6,1,180430,180430,180431,0,1,3
51495,3,3,180433,180433,180436,0,3,2
51496,4,1,180437,180437,180438,0,1,1
51497,1,1,180438,180438,180439,0,1,0
51498,5,3,180443,180443,180446,0,3,4
51499,2,2,180445,180446,180448,1,3,0
51500,6,3,180451,180451,180454,0,3,3
51501,5,2,180456,180456,180458,0,2,2
51502,4,2,180460,180460,180462,0,2,2
51503,3,3,180463,180463,180466,0,3,1
51504,4,3,180467,180467,180470,0,3,1
51505,5,2,180472,180472,180474,0,2,2
51506,4,2,180476,180476,180478,0,2,2
51507,1,1,180477,180478,180479,1,2,0
51508,5,3,180482,180482,180485,0,3,3
51509,6,3,180488,180488,180491,0,3,3
51510,6,3,180494,180494,180497,0,3,3
51511,3,3,180497,180497,180500,0,3,0
51512,1,3,180498,180500,180503,2,5,0
51513,5,2,180503,180503,180505,0,2,0
51514,3,3,180506,180506,180509,0,3,1
51515,2,3,180508,180509,180512,1,4,0
51516,6,2,180514,180514,180516,0,2,2
51517,4,3,180518,180518,180521,0,3,2
51518,1,2,180519,180521,180523,2,4,0
51519,4,1,180523,180523,180524,0,1,0
51520,5,3,180528,180528,180531,0,3,4
51521,5,3,180533,180533,180536,0,3,2
51522,5,1,180538,180538,180539,0,1,2
51523,4,1,180542,180542,180543,0,1,3
51524,6,1,180548,180548,180549,0,1,5
51525,3,1,180551,180551,180552,0,1,2
51526,2,1,180553,180553,180554,0,1,1
51527,4,1,180557,180557,180558,0,1,3
51528,5,3,180562,180562,180565,0,3,4
51529,2,1,180564,180565,180566,1,2,0
51530,1,3,180565,180566,180569,1,4,0
51531,1,3,180566,180569,180572,3,6,0
51532,5,3,180571,180572,180575,1,4,0
51533,2,3,180573,180575,180578,2,5,0
51534,1,3,180574,180578,180581,4,7,0
51535,5,2,180579,180581,180583,2,4,0
51536,1,3,180580,180583,180586,3,6,0
51537,4,2,180584,180586,180588,2,4,0
51538,4,2,180588,180588,180590,0,2,0
51539,5,2,180593,180593,180595,0,2,3
51540,3,2,180596,180596,180598,0,2,1
51541,2,1,180598,180598,180599,0,1,0
51542,4,1,180602,180602,180603,0,1,3
51543,4,3,180606,180606,180609,0,3,3
51544,5,1,180611,180611,180612,0,1,2
51545,4,2,180615,180615,180617,0,2,3
51546,1,1,180616,180617,180618,1,2,0
51547,3,3,180619,180619,180622,0,3,1
51548,6,2,180625,180625,180627,0,2,3
51549,1,3,180626,180627,180630,1,4,0
51550,6,1,180632,180632,180633,0,1,2
51551,6,2,180638,180638,180640,0,2,5
51552,1,1,180639,180640,180641,1,2,0
51553,1,3,180640,180641,180644,1,4,0
51554,4,1,180644,180644,180645,0,1,0
51555,1,3,180645,180645,180648,0,3,0
51556,3,2,180648,180648,180650,0,2,0
51557,6,3,180654,180654,180657,0,3,4
51558,4,1,180658,180658,180659,0,1,1
51559,2,2,180660,180660,180662,0,2,1
51560,1,3,180661,180662,180665,1,4,0
51561,3,2,180664,180665,180667,1,3,0
51562,6,3,180670,180670,180673,0,3,3
51563,4,2,180674,180674,180676,0,2,1
51564,6,1,180680,180680,180681,0,1,4
51565,6,1,180686,180686,180687,0,1,5
51566,6,2,180692,180692,180694,0,2,5
51567,2,1,180694,180694,180695,0,1,0
51568,6,2,180700,180700,180702,0,2,5
51569,5,3,180705,180705,180708,0,3,3
51570,1,1,180706,180708,180709,2,3,0
51571,5,2,180711,180711,180713,0,2,2
51572,2,2,180713,180713,180715,0,2,0
51573,2,1,180715,180715,180716,0,1,0
51574,6,2,180721,180721,180723,0,2,5
51575,2,3,180723,180723,180726,0,3,0
51576,6,1,180729,180729,180730,0,1,3
51577,6,1,180735,180735,180736,0,1,5
51578,2,1,180737,180737,180738,0,1,1
51579,2,1,180739,180739,180740,0,1,1
51580,3,2,180742,180742,180744,0,2,2
51581,5,2,180747,180747,180749,0,2,3
51582,1,1,180748,180749,180750,1,2,0
51583,4,3,180752,180752,180755,0,3,2
51584,4,2,180756,180756,180758,0,2,1
51585,6,3,180762,180762,180765,0,3,4
51586,6,3,180768,180768,180771,0,3,3
51587,5,1,180773,180773,180774,0,1,2
51588,1,3,180774,180774,180777,0,3,0
51589,3,1,180777,180777,180778,0,1,0
51590,5,1,180782,180782,180783,0,1,4
51591,1,3,180783,180783,180786,0,3,0
51592,6,2,180789,180789,180791,0,2,3
51593,5,1,180794,180794,180795,0,1,3
51594,1,3,180795,180795,180798,0,3,0
51595,5,1,180800,180800,180801,0,1,2
51596,2,3,180802,180802,180805,0,3,1
51597,6,3,180808,180808,180811,0,3,3
51598,4,2,180812,180812,180814,0,2,1
51599,4,2,180816,180816,180818,0,2,2
51600,2,3,180818,180818,180821,0,3,0
51601,2,1,180820,180821,180822,1,2,0
51602,6,3,180826,180826,180829,0,3,4
51603,6,1,180832,180832,180833,0,1,3
51604,3,2,180835,180835,180837,0,2,2
51605,6,2,180841,180841,180843,0,2,4
51606,6,2,180847,180847,180849,0,2,4
51607,3,2,180850,180850,180852,0,2,1
51608,3,1,180853,180853,180854,0,1,1
51609,4,2,180857,180857,180859,0,2,3
51610,4,1,180861,180861,180862,0,1,2
51611,3,2,180864,180864,180866,0,2,2
51612,5,3,180869,180869,180872,0,3,3
51613,2,1,180871,180872,180873,1,2,0
51614,5,1,180876,180876,180877,0,1,3
51615,2,2,180878,180878,180880,0,2,1
51616,3,2,180881,180881,180883,0,2,1
51617,1,3,180882,180883,180886,1,4,0
51618,4,3,180886,180886,180889,0,3,0
51619,4,1,180890,180890,180891,0,1,1
51620,1,1,180891,180891,180892,0,1,0
51621,6,2,180897,180897,180899,0,2,5
51622,3,3,180900,180900,180903,0,3,1
51623,2,1,180902,180903,180904,1,2,0
51624,4,3,180906,180906,180909,0,3,2
51625,1,3,180907,180909,180912,2,5,0
51626,3,3,180910,180912,180915,2,5,0
51627,5,2,180915,180915,180917,0,2,0
51628,2,1,180917,180917,180918,0,1,0
51629,6,3,180923,180923,180926,0,3,5
51630,6,2,180929,180929,180931,0,2,3
51631,5,2,180934,180934,180936,0,2,3
51632,5,2,180939,180939,180941,0,2,3
51633,4,2,180943,180943,180945,0,2,2
51634,5,3,180948,180948,180951,0,3,3
51635,6,2,180954,180954,180956,0,2,3
51636,4,1,180958,180958,180959,0,1,2
51637,4,2,180962,180962,180964,0,2,3
51638,2,2,180964,180964,180966,0,2,0
51639,6,1,180970,180970,180971,0,1,4
51640,1,3,180971,180971,180974,0,3,0
51641,3,3,180974,180974,180977,0,3,0
51642,5,1,180979,180979,180980,0,1,2
51643,2,1,180981,180981,180982,0,1,1
51644,4,2,180985,180985,180987,0,2,3
51645,2,3,180987,180987,180990,0,3,0
51646,6,3,180993,180993,180996,0,3,3
51647,6,1,180999,180999,181000,0,1,3
51648,4,1,181003,181003,181004,0,1,3
51649,6,2,181009,181009,181011,0,2,5
51650,1,1,181010,181011,181012,1,2,0
51651,5,1,181015,181015,181016,0,1,3
51652,2,2,181017,181017,181019,0,2,1
51653,3,3,181020,181020,181023,0,3,1
51654,4,1,181024,181024,181025,0,1,1
51655,5,3,181029,181029,181032,0,3,4
51656,1,2,181030,181032,181034,2,4,0
51657,1,3,181031,181034,181037,3,6,0
51658,4,2,181035,181037,181039,2,4,0
51659,4,1,181039,181039,181040,0,1,0
51660,5,3,181044,181044,181047,0,3,4
51661,2,1,181046,181047,181048,1,2,0
51662,6,2,181052,181052,181054,0,2,4
51663,3,1,181055,181055,181056,0,1,1
51664,4,3,181059,181059,181062,0,3,3
51665,3,1,181062,181062,181063,0,1,0
51666,5,2,181067,181067,181069,0,2,4
51667,2,2,181069,181069,181071,0,2,0
51668,4,1,181073,181073,181074,0,1,2
51669,2,3,181075,181075,181078,0,3,1
51670,4,3,181079,181079,181082,0,3,1
51671,1,1,181080,181082,181083,2,3,0
51672,1,3,181081,181083,181086,2,5,0
51673,1,1,181082,181086,181087,4,5,0
51674,6,3,181088,181088,181091,0,3,1
51675,2,2,181090,181091,181093,1,3,0
51676,3,2,181093,181093,181095,0,2,0
51677,6,3,181099,181099,181102,0,3,4
51678,3,1,181102,181102,181103,0,1,0
51679,2,1,181104,181104,181105,0,1,1
51680,6,3,181110,181110,181113,0,3,5
51681,5,1,181115,181115,181116,0,1,2
51682,1,1,181116,181116,181117,0,1,0
51683,2,2,181118,181118,181120,0,2,1
51684,4,1,181122,181122,181123,0,1,2
51685,3,1,181125,181125,181126,0,1,2
51686,1,3,181126,181126,181129,0,3,0
51687,4,3,181130,181130,181133,0,3,1
51688,3,3,181133,181133,181136,0,3,0
51689,5,2,181138,181138,181140,0,2,2
51690,1,2,181139,181140,181142,1,3,0
51691,4,2,181143,181143,181145,0,2,1
51692,1,1,181144,181145,181146,1,2,0
51693,2,3,181146,181146,181149,0,3,0
51694,1,1,181147,181149,181150,2,3,0
51695,3,3,181150,181150,181153,0,3,0
51696,4,3,181154,181154,181157,0,3,1
51697,4,2,181158,181158,181160,0,2,1
51698,3,3,181161,181161,181164,0,3,1
51699,2,2,181163,181164,181166,1,3,0
51700,1,1,181164,181166,181167,2,3,0
51701,5,1,181169,181169,181170,0,1,2
51702,1,2,181170,181170,181172,0,2,0
51703,6,3,181176,181176,181179,0,3,4
51704,1,2,181177,181179,181181,2,4,0
51705,6,1,181183,181183,181184,0,1,2
51706,6,1,181189,181189,181190,0,1,5
51707,4,3,181193,181193,181196,0,3,3
51708,4,1,181197,181197,181198,0,1,1
51709,5,3,181202,181202,181205,0,3,4
51710,6,1,181208,181208,181209,0,1,3
51711,5,3,181213,181213,181216,0,3,4
51712,5,2,181218,181218,181220,0,2,2
51713,6,3,181224,181224,181227,0,3,4
51714,3,1,181227,181227,181228,0,1,0
51715,3,1,181230,181230,181231,0,1,2
51716,4,3,181234,181234,181237,0,3,3
51717,5,1,181239,181239,181240,0,1,2
51718,2,1,181241,181241,181242,0,1,1
51719,3,1,181244,181244,181245,0,1,2
51720,2,3,181246,181246,181249,0,3,1
51721,6,3,181252,181252,181255,0,3,3
51722,2,1,181254,181255,181256,1,2,0
51723,5,3,181259,181259,181262,0,3,3
51724,5,2,181264,181264,181266,0,2,2
51725,4,1,181268,181268,181269,0,1,2
51726,6,2,181274,181274,181276,0,2,5
51727,2,2,181276,181276,181278,0,2,0
51728,6,1,181282,181282,181283,0,1,4
51729,4,2,181286,181286,181288,0,2,3
51730,1,2,181287,181288,181290,1,3,0
51731,1,3,181288,181290,181293,2,5,0
51732,2,1,181290,181293,181294,3,4,0
51733,4,2,181294,181294,181296,0,2,0
51734,1,3,181295,181296,181299,1,4,0
51735,2,1,181297,181299,181300,2,3,0
51736,5,3,181302,181302,181305,0,3,2
51737,4,1,181306,181306,181307,0,1,1
51738,5,3,181311,181311,181314,0,3,4
51739,2,3,181313,181314,181317,1,4,0
51740,2,1,181315,181317,181318,2,3,0
51741,4,2,181319,181319,181321,0,2,1
51742,6,3,181325,181325,181328,0,3,4
51743,6,1,181331,181331,181332,0,1,3
51744,2,1,181333,181333,181334,0,1,1
51745,6,2,181339,181339,181341,0,2,5
51746,2,2,181341,181341,181343,0,2,0
51747,6,1,181347,181347,181348,0,1,4
51748,5,1,181352,181352,181353,0,1,4
51749,1,1,181353,181353,181354,0,1,0
51750,3,2,181356,181356,181358,0,2,2
51751,5,1,181361,181361,181362,0,1,3
51752,6,3,181367,181367,181370,0,3,5
51753,1,2,181368,181370,181372,2,4,0
51754,5,3,181373,181373,181376,0,3,1
51755,6,1,181379,181379,181380,0,1,3
51756,1,1,181380,181380,181381,0,1,0
51757,3,2,181383,181383,181385,0,2,2
51758,6,1,181389,181389,181390,0,1,4
51759,2,1,181391,181391,181392,0,1,1
51760,5,2,181396,181396,181398,0,2,4
51761,3,1,181399,181399,181400,0,1,1
51762,5,3,181404,181404,181407,0,3,4
51763,3,2,181407,181407,181409,0,2,0
51764,6,2,181413,181413,181415,0,2,4
51765,3,3,181416,181416,181419,0,3,1
51766,1,2,181417,181419,181421,2,4,0
51767,2,2,181419,181421,181423,2,4,0
51768,2,1,181421,181423,181424,2,3,0
51769,2,3,181423,181424,181427,1,4,0
51770,1,3,181424,181427,181430,3,6,0
51771,2,3,181426,181430,181433,4,7,0
51772,5,1,181431,181433,181434,2,3,0
51773,1,3,181432,181434,181437,2,5,0
51774,5,2,181437,181437,181439,0,2,0
51775,6,2,181443,181443,181445,0,2,4
51776,4,3,181447,181447,181450,0,3,2
51777,3,1,181450,181450,181451,0,1,0
51778,3,1,181453,181453,181454,0,1,2
51779,3,1,181456,181456,181457,0,1,2
51780,6,1,181462,181462,181463,0,1,5
51781,4,2,181466,181466,181468,0,2,3
51782,6,1,181472,181472,181473,0,1,4
51783,6,1,181478,181478,181479,0,1,5
51784,6,3,181484,181484,181487,0,3,5
51785,6,3,181490,181490,181493,0,3,3
51786,1,3,181491,181493,181496,2,5,0
51787,4,3,181495,181496,181499,1,4,0
51788,6,3,181501,181501,181504,0,3,2
51789,6,3,181507,181507,181510,0,3,3
51790,3,3,181510,181510,181513,0,3,0
51791,5,3,181515,181515,181518,0,3,2
51792,4,3,181519,181519,181522,0,3,1
51793,4,3,181523,181523,181526,0,3,1
51794,6,2,181529,181529,181531,0,2,3
51795,3,2,181532,181532,181534,0,2,1
51796,3,2,181535,181535,181537,0,2,1
51797,1,3,181536,181537,181540,1,4,0
51798,2,3,181538,181540,181543,2,5,0
51799,6,3,181544,181544,181547,0,3,1
51800,3,2,181547,181547,181549,0,2,0
51801,2,3,181549,181549,181552,0,3,0
51802,4,3,181553,181553,181556,0,3,1
51803,6,3,181559,181559,181562,0,3,3
51804,1,2,181560,181562,181564,2,4,0
51805,2,1,181562,181564,181565,2,3,0
51806,6,2,181568,181568,181570,0,2,3
51807,5,2,181573,181573,181575,0,2,3
51808,3,3,181576,181576,181579,0,3,1
51809,4,2,181580,181580,181582,0,2,1
51810,3,1,181583,181583,181584,0,1,1
51811,3,1,181586,181586,181587,0,1,2
51812,5,2,181591,181591,181593,0,2,4
51813,1,3,181592,181593,181596,1,4,0
51814,4,3,181596,181596,181599,0,3,0
51815,2,3,181598,181599,181602,1,4,0
51816,6,1,181604,181604,181605,0,1,2
51817,3,2,181607,181607,181609,0,2,2
51818,4,1,181611,181611,181612,0,1,2
51819,1,3,181612,181612,181615,0,3,0
51820,5,1,181617,181617,181618,0,1,2
51821,3,1,181620,181620,181621,0,1,2
51822,1,2,181621,181621,181623,0,2,0
51823,6,1,181627,181627,181628,0,1,4
51824,4,3,181631,181631,181634,0,3,3
51825,2,2,181633,181634,181636,1,3,0
51826,6,3,181639,181639,181642,0,3,3
51827,6,3,181645,181645,181648,0,3,3
51828,2,3,181647,181648,181651,1,4,0
51829,5,1,181652,181652,181653,0,1,1
51830,1,3,181653,181653,181656,0,3,0
51831,5,3,181658,181658,181661,0,3,2
51832,6,3,181664,181664,181667,0,3,3
51833,4,2,181668,181668,181670,0,2,1
51834,4,2,181672,181672,181674,0,2,2
51835,2,1,181674,181674,181675,0,1,0
51836,2,1,181676,181676,181677,0,1,1
51837,6,1,181682,181682,181683,0,1,5
51838,6,1,181688,181688,181689,0,1,5
51839,5,1,181693,181693,181694,0,1,4
51840,1,2,181694,181694,181696,0,2,0
51841,1,3,181695,181696,181699,1,4,0
51842,4,1,181699,181699,181700,0,1,0
51843,4,3,181703,181703,181706,0,3,3
51844,1,2,181704,181706,181708,2,4,0
51845,3,3,181707,181708,181711,1,4,0
51846,2,3,181709,181711,181714,2,5,0
51847,4,1,181713,181714,181715,1,2,0
51848,2,1,181715,181715,181716,0,1,0
51849,4,3,181719,181719,181722,0,3,3
51850,4,2,181723,181723,181725,0,2,1
51851,1,3,181724,181725,181728,1,4,0
51852,5,3,181729,181729,181732,0,3,1
51853,4,2,181733,181733,181735,0,2,1
51854,1,1,181734,181735,181736,1,2,0
51855,3,2,181737,181737,181739,0,2,1
51856,4,3,181741,181741,181744,0,3,2
51857,6,3,181747,181747,181750,0,3,3
51858,2,1,181749,181750,181751,1,2,0
51859,6,2,181755,181755,181757,0,2,4
51860,4,1,181759,181759,181760,0,1,2
51861,5,3,181764,181764,181767,0,3,4
51862,4,1,181768,181768,181769,0,1,1
51863,5,2,181773,181773,181775,0,2,4
51864,5,1,181778,181778,181779,0,1,3
51865,2,2,181780,181780,181782,0,2,1
51866,4,3,181784,181784,181787,0,3,2
51867,6,1,181790,181790,181791,0,1,3
51868,1,1,181791,181791,181792,0,1,0
51869,5,3,181796,181796,181799,0,3,4
51870,4,3,181800,181800,181803,0,3,1
51871,5,1,181805,181805,181806,0,1,2
51872,2,3,181807,181807,181810,0,3,1
51873,1,1,181808,181810,181811,2,3,0
51874,4,1,181812,181812,181813,0,1,1
51875,5,1,181817,181817,181818,0,1,4
51876,4,2,181821,181821,181823,0,2,3
51877,6,1,181827,181827,181828,0,1,4
51878,4,1,181831,181831,181832,0,1,3
51879,4,2,181835,181835,181837,0,2,3
51880,3,3,181838,181838,181841,0,3,1
51881,4,1,181842,181842,181843,0,1,1
51882,3,2,181845,181845,181847,0,2,2
51883,2,3,181847,181847,181850,0,3,0
51884,1,3,181848,181850,181853,2,5,0
51885,1,3,181849,181853,181856,4,7,0
51886,5,1,181854,181856,181857,2,3,0
51887,6,1,181860,181860,181861,0,1,3
51888,2,2,181862,181862,181864,0,2,1
51889,1,1,181863,181864,181865,1,2,0
51890,1,1,181864,181865,181866,1,2,0
51891,6,3,181870,181870,181873,0,3,4
51892,6,1,181876,181876,181877,0,1,3
51893,2,1,181878,181878,181879,0,1,1
51894,6,3,181884,181884,181887,0,3,5
51895,2,1,181886,181887,181888,1,2,0
51896,5,3,181891,181891,181894,0,3,3
51897,4,1,181895,181895,181896,0,1,1
51898,1,1,181896,181896,181897,0,1,0
51899,5,2,181901,181901,181903,0,2,4
51900,2,2,181903,181903,181905,0,2,0
51901,4,3,181907,181907,181910,0,3,2
51902,2,1,181909,181910,181911,1,2,0
51903,2,2,181911,181911,181913,0,2,0
51904,2,3,181913,181913,181916,0,3,0
51905,4,3,181917,181917,181920,0,3,1
51906,5,3,181922,181922,181925,0,3,2
51907,4,3,181926,181926,181929,0,3,1
51908,6,3,181932,181932,181935,0,3,3
51909,6,2,181938,181938,181940,0,2,3
51910,3,2,181941,181941,181943,0,2,1
51911,3,3,181944,181944,181947,0,3,1
51912,1,3,181945,181947,181950,2,5,0
51913,6,2,181951,181951,181953,0,2,1
51914,2,1,181953,181953,181954,0,1,0
51915,6,1,181959,181959,181960,0,1,5
51916,5,3,181964,181964,181967,0,3,4
51917,1,3,181965,181967,181970,2,5,0
51918,1,2,181966,181970,181972,4,6,0
51919,6,2,181972,181972,181974,0,2,0
51920,5,2,181977,181977,181979,0,2,3
51921,1,3,181978,181979,181982,1,4,0
51922,6,3,181984,181984,181987,0,3,2
51923,5,3,181989,181989,181992,0,3,2
51924,6,2,181995,181995,181997,0,2,3
51925,1,3,181996,181997,182000,1,4,0
51926,1,2,181997,182000,182002,3,5,0
51927,1,2,181998,182002,182004,4,6,0
51928,1,1,181999,182004,182005,5,6,0
51929,2,2,182001,182005,182007,4,6,0
51930,4,3,182005,182007,182010,2,5,0
51931,1,2,182006,182010,182012,4,6,0
51932,2,2,182008,182012,182014,4,6,0
51933,5,2,182013,182014,182016,1,3,0
51934,5,2,182018,182018,182020,0,2,2
51935,6,2,182024,182024,182026,0,2,4
51936,4,3,182028,182028,182031,0,3,2
51937,5,3,182033,182033,182036,0,3,2
51938,6,2,182039,182039,182041,0,2,3
51939,6,2,182045,182045,182047,0,2,4
51940,1,1,182046,182047,182048,1,2,0
51941,1,1,182047,182048,182049,1,2,0
51942,2,2,182049,182049,182051,0,2,0
51943,6,2,182055,182055,182057,0,2,4
51944,1,3,182056,182057,182060,1,4,0
51945,6,1,182062,182062,182063,0,1,2
51946,2,2,182064,182064,182066,0,2,1
51947,4,2,182068,182068,182070,0,2,2
51948,6,2,182074,182074,182076,0,2,4
51949,3,1,182077,182077,182078,0,1,1
51950,4,3,182081,182081,182084,0,3,3
51951,2,2,182083,182084,182086,1,3,0
51952,6,3,182089,182089,182092,0,3,3
51953,1,1,182090,182092,182093,2,3,0
51954,3,3,182093,182093,182096,0,3,0
51955,1,2,182094,182096,182098,2,4,0
51956,6,2,182100,182100,182102,0,2,2
51957,1,1,182101,182102,182103,1,2,0
51958,4,3,182105,182105,182108,0,3,2
51959,2,2,182107,182108,182110,1,3,0
51960,4,3,182111,182111,182114,0,3,1
51961,2,2,182113,182114,182116,1,3,0
51962,5,2,182118,182118,182120,0,2,2
51963,4,1,182122,182122,182123,0,1,2
51964,4,2,182126,182126,182128,0,2,3
51965,1,2,182127,182128,182130,1,3,0
51966,6,3,182133,182133,182136,0,3,3
51967,1,1,182134,182136,182137,2,3,0
51968,5,3,182139,182139,182142,0,3,2
51969,3,1,182142,182142,182143,0,1,0
51970,5,3,182147,182147,182150,0,3,4
51971,6,3,182153,182153,182156,0,3,3
51972,4,1,182157,182157,182158,0,1,1
51973,3,2,182160,182160,182162,0,2,2
51974,5,1,182165,182165,182166,0,1,3
51975,2,2,182167,182167,182169,0,2,1
51976,3,3,182170,182170,182173,0,3,1
51977,6,1,182176,182176,182177,0,1,3
51978,2,2,182178,182178,182180,0,2,1
51979,5,3,182183,182183,182186,0,3,3
51980,4,1,182187,182187,182188,0,1,1
51981,5,2,182192,182192,182194,0,2,4
51982,1,1,182193,182194,182195,1,2,0
51983,4,2,182197,182197,182199,0,2,2
51984,2,3,182199,182199,182202,0,3,0
51985,2,3,182201,182202,182205,1,4,0
51986,6,3,182207,182207,182210,0,3,2
51987,4,2,182211,182211,182213,0,2,1
51988,2,3,182213,182213,182216,0,3,0
51989,3,1,182216,182216,182217,0,1,0
51990,1,3,182217,182217,182220,0,3,0
51991,2,3,182219,182220,182223,1,4,0
51992,3,1,182222,182223,182224,1,2,0
51993,6,2,182228,182228,182230,0,2,4
51994,4,1,182232,182232,182233,0,1,2
51995,3,1,182235,182235,182236,0,1,2
51996,4,1,182239,182239,182240,0,1,3
51997,6,1,182245,182245,182246,0,1,5
51998,3,3,182248,182248,182251,0,3,2
51999,1,3,182249,182251,182254,2,5,0
52000,5,3,182254,182254,182257,0,3,0
52001,4,1,182258,182258,182259,0,1,1
52002,6,1,182264,182264,182265,0,1,5
52003,1,3,182265,182265,182268,0,3,0
52004,3,1,182268,182268,182269,0,1,0
52005,5,3,182273,182273,182276,0,3,4
52006,2,3,182275,182276,182279,1,4,0
52007,5,3,182280,182280,182283,0,3,1
52008,6,3,182286,182286,182289,0,3,3
52009,4,2,182290,182290,182292,0,2,1
52010,4,2,182294,182294,182296,0,2,2
52011,6,1,182300,182300,182301,0,1,4
52012,4,2,182304,182304,182306,0,2,3
52013,3,2,182307,182307,182309,0,2,1
52014,2,2,182309,182309,182311,0,2,0
52015,1,2,182310,182311,182313,1,3,0
52016,4,1,182314,182314,182315,0,1,1
52017,3,3,182317,182317,182320,0,3,2
52018,6,2,182323,182323,182325,0,2,3
52019,3,2,182326,182326,182328,0,2,1
52020,4,1,182330,182330,182331,0,1,2
52021,6,1,182336,182336,182337,0,1,5
52022,5,2,182341,182341,182343,0,2,4
52023,6,3,182347,182347,182350,0,3,4
52024,1,3,182348,182350,182353,2,5,0
52025,4,2,182352,182353,182355,1,3,0
52026,4,2,182356,182356,182358,0,2,1
52027,6,2,182362,182362,182364,0,2,4
52028,6,3,182368,182368,182371,0,3,4
52029,3,2,182371,182371,182373,0,2,0
52030,2,3,182373,182373,182376,0,3,0
52031,5,1,182378,182378,182379,0,1,2
52032,5,2,182383,182383,182385,0,2,4
52033,4,1,182387,182387,182388,0,1,2
52034,2,2,182389,182389,182391,0,2,1
52035,1,1,182390,182391,182392,1,2,0
52036,1,3,182391,182392,182395,1,4,0
52037,6,3,182397,182397,182400,0,3,2
52038,1,2,182398,182400,182402,2,4,0
52039,2,2,182400,182402,182404,2,4,0
52040,3,2,182403,182404,182406,1,3,0
52041,6,1,182409,182409,182410,0,1,3
52042,4,3,182413,182413,182416,0,3,3
52043,5,3,182418,182418,182421,0,3,2
52044,1,2,182419,182421,182423,2,4,0
52045,3,1,182422,182423,182424,1,2,0
52046,2,1,182424,182424,182425,0,1,0
52047,5,2,182429,182429,182431,0,2,4
52048,1,1,182430,182431,182432,1,2,0
52049,3,3,182433,182433,182436,0,3,1
52050,1,1,182434,182436,182437,2,3,0
52051,2,1,182436,182437,182438,1,2,0
52052,1,1,182437,182438,182439,1,2,0
52053,4,2,182441,182441,182443,0,2,2
52054,2,1,182443,182443,182444,0,1,0
52055,3,1,182446,182446,182447,0,1,2
52056,1,3,182447,182447,182450,0,3,0
52057,6,3,182453,182453,182456,0,3,3
52058,3,3,182456,182456,182459,0,3,0
52059,5,1,182461,182461,182462,0,1,2
52060,5,2,182466,182466,182468,0,2,4
52061,2,1,182468,182468,182469,0,1,0
52062,1,1,182469,182469,182470,0,1,0
52063,2,1,182471,182471,182472,0,1,1
52064,4,3,182475,182475,182478,0,3,3
52065,6,2,182481,182481,182483,0,2,3
52066,2,2,182483,182483,182485,0,2,0
52067,3,3,182486,182486,182489,0,3,1
52068,5,2,182491,182491,182493,0,2,2
52069,1,2,182492,182493,182495,1,3,0
52070,6,1,182498,182498,182499,0,1,3
52071,6,3,182504,182504,182507,0,3,5
52072,1,2,182505,182507,182509,2,4,0
52073,4,3,182509,182509,182512,0,3,0
52074,5,2,182514,182514,182516,0,2,2
52075,3,2,182517,182517,182519,0,2,1
52076,5,2,182522,182522,182524,0,2,3
52077,6,1,182528,182528,182529,0,1,4
52078,3,2,182531,182531,182533,0,2,2
52079,5,2,182536,182536,182538,0,2,3
52080,4,1,182540,182540,182541,0,1,2
52081,1,3,182541,182541,182544,0,3,0
52082,6,3,182547,182547,182550,0,3,3
52083,2,1,182549,182550,182551,1,2,0
52084,6,3,182555,182555,182558,0,3,4
52085,5,3,182560,182560,182563,0,3,2
52086,1,2,182561,182563,182565,2,4,0
52087,6,3,182567,182567,182570,0,3,2
52088,3,1,182570,182570,182571,0,1,0
52089,2,3,182572,182572,182575,0,3,1
52090,1,1,182573,182575,182576,2,3,0
52091,2,2,182575,182576,182578,1,3,0
52092,6,2,182581,182581,182583,0,2,3
52093,5,1,182586,182586,182587,0,1,3
52094,4,2,182590,182590,182592,0,2,3
52095,4,1,182594,182594,182595,0,1,2
52096,2,1,182596,182596,182597,0,1,1
52097,5,3,182601,182601,182604,0,3,4
52098,1,3,182602,182604,182607,2,5,0
52099,2,3,182604,182607,182610,3,6,0
52100,4,3,182608,182610,182613,2,5,0
52101,4,1,182612,182613,182614,1,2,0
52102,1,3,182613,182614,182617,1,4,0
52103,1,3,182614,182617,182620,3,6,0
52104,1,3,182615,182620,182623,5,8,0
52105,5,1,182620,182623,182624,3,4,0
52106,5,2,182625,182625,182627,0,2,1
52107,2,3,182627,182627,182630,0,3,0
52108,4,2,182631,182631,182633,0,2,1
52109,2,3,182633,182633,182636,0,3,0
52110,6,3,182639,182639,182642,0,3,3
52111,3,1,182642,182642,182643,0,1,0
52112,4,1,182646,182646,182647,0,1,3
52113,4,1,182650,182650,182651,0,1,3
52114,3,1,182653,182653,182654,0,1,2
52115,1,2,182654,182654,182656,0,2,0
52116,3,1,182657,182657,182658,0,1,1
52117,5,2,182662,182662,182664,0,2,4
52118,4,2,182666,182666,182668,0,2,2
52119,2,3,182668,182668,182671,0,3,0
52120,4,1,182672,182672,182673,0,1,1
52121,6,1,182678,182678,182679,0,1,5
52122,5,2,182683,182683,182685,0,2,4
52123,6,2,182689,182689,182691,0,2,4
52124,1,1,182690,182691,182692,1,2,0
52125,1,1,182691,182692,182693,1,2,0
52126,3,3,182694,182694,182697,0,3,1
52127,1,1,182695,182697,182698,2,3,0
52128,2,1,182697,182698,182699,1,2,0
52129,4,2,182701,182701,182703,0,2,2
52130,1,1,182702,182703,182704,1,2,0
52131,3,2,182705,182705,182707,0,2,1
52132,3,2,182708,182708,182710,0,2,1
52133,4,1,182712,182712,182713,0,1,2
52134,2,3,182714,182714,182717,0,3,1
52135,3,3,182717,182717,182720,0,3,0
52136,1,3,182718,182720,182723,2,5,0
52137,3,3,182721,182723,182726,2,5,0
52138,4,2,182725,182726,182728,1,3,0
52139,5,1,182730,182730,182731,0,1,2
52140,4,3,182734,182734,182737,0,3,3
52141,5,3,182739,182739,182742,0,3,2
52142,6,1,182745,182745,182746,0,1,3
52143,3,3,182748,182748,182751,0,3,2
52144,3,1,182751,182751,182752,0,1,0
52145,4,1,182755,182755,182756,0,1,3
52146,5,1,182760,182760,182761,0,1,4
52147,5,1,182765,182765,182766,0,1,4
52148,2,1,182767,182767,182768,0,1,1
52149,3,1,182770,182770,182771,0,1,2
52150,1,2,182771,182771,182773,0,2,0
52151,6,2,182777,182777,182779,0,2,4
52152,3,3,182780,182780,182783,0,3,1
52153,3,1,182783,182783,182784,0,1,0
52154,2,1,182785,182785,182786,0,1,1
52155,6,2,182791,182791,182793,0,2,5
52156,3,1,182794,182794,182795,0,1,1
52157,4,1,182798,182798,182799,0,1,3
52158,2,1,182800,182800,182801,0,1,1
52159,2,1,182802,182802,182803,0,1,1
52160,5,1,182807,182807,182808,0,1,4
52161,4,3,182811,182811,182814,0,3,3
52162,5,3,182816,182816,182819,0,3,2
52163,3,3,182819,182819,182822,0,3,0
52164,5,1,182824,182824,182825,0,1,2
52165,5,2,182829,182829,182831,0,2,4
52166,3,3,182832,182832,182835,0,3,1
52167,4,1,182836,182836,182837,0,1,1
52168,1,2,182837,182837,182839,0,2,0
52169,1,2,182838,182839,182841,1,3,0
52170,2,3,182840,182841,182844,1,4,0
52171,3,2,182843,182844,182846,1,3,0
52172,1,1,182844,182846,182847,2,3,0
52173,5,1,182849,182849,182850,0,1,2
52174,3,2,182852,182852,182854,0,2,2
52175,4,1,182856,182856,182857,0,1,2
52176,4,2,182860,182860,182862,0,2,3
52177,4,3,182864,182864,182867,0,3,2
52178,1,3,182865,182867,182870,2,5,0
52179,4,1,182869,182870,182871,1,2,0
52180,5,3,182874,182874,182877,0,3,3
52181,3,1,182877,182877,182878,0,1,0
52182,1,3,182878,182878,182881,0,3,0
52183,6,3,182884,182884,182887,0,3,3
52184,4,3,182888,182888,182891,0,3,1
52185,1,3,182889,182891,182894,2,5,0
52186,3,2,182892,182894,182896,2,4,0
52187,3,3,182895,182896,182899,1,4,0
52188,3,1,182898,182899,182900,1,2,0
52189,4,2,182902,182902,182904,0,2,2
52190,2,3,182904,182904,182907,0,3,0
52191,6,3,182910,182910,182913,0,3,3
52192,3,2,182913,182913,182915,0,2,0
52193,1,2,182914,182915,182917,1,3,0
52194,2,2,182916,182917,182919,1,3,0
52195,6,3,182922,182922,182925,0,3,3
52196,1,2,182923,182925,182927,2,4,0
52197,3,2,182926,182927,182929,1,3,0
52198,1,2,182927,182929,182931,2,4,0
52199,3,1,182930,182931,182932,1,2,0
52200,1,2,182931,182932,182934,1,3,0
52201,6,3,182937,182937,182940,0,3,3
52202,6,1,182943,182943,182944,0,1,3
52203,2,1,182945,182945,182946,0,1,1
52204,6,3,182951,182951,182954,0,3,5
52205,2,2,182953,182954,182956,1,3,0
52206,2,3,182955,182956,182959,1,4,0
52207,4,1,182959,182959,182960,0,1,0
52208,5,1,182964,182964,182965,0,1,4
52209,5,1,182969,182969,182970,0,1,4
52210,4,2,182973,182973,182975,0,2,3
52211,2,1,182975,182975,182976,0,1,0
52212,3,3,182978,182978,182981,0,3,2
52213,6,1,182984,182984,182985,0,1,3
52214,3,3,182987,182987,182990,0,3,2
52215,2,3,182989,182990,182993,1,4,0
52216,5,2,182994,182994,182996,0,2,1
52217,3,3,182997,182997,183000,0,3,1
52218,5,2,183002,183002,183004,0,2,2
52219,6,1,183008,183008,183009,0,1,4
52220,6,2,183014,183014,183016,0,2,5
52221,4,1,183018,183018,183019,0,1,2
52222,6,2,183024,183024,183026,0,2,5
52223,2,3,183026,183026,183029,0,3,0
52224,1,3,183027,183029,183032,2,5,0
52225,4,3,183031,183032,183035,1,4,0
52226,4,3,183035,183035,183038,0,3,0
52227,4,1,183039,183039,183040,0,1,1
52228,2,2,183041,183041,183043,0,2,1
52229,4,3,183045,183045,183048,0,3,2
52230,5,3,183050,183050,183053,0,3,2
52231,2,3,183052,183053,183056,1,4,0
52232,4,3,183056,183056,183059,0,3,0
52233,2,3,183058,183059,183062,1,4,0
52234,2,1,183060,183062,183063,2,3,0
52235,4,1,183064,183064,183065,0,1,1
52236,4,2,183068,183068,183070,0,2,3
52237,5,3,183073,183073,183076,0,3,3
52238,2,1,183075,183076,183077,1,2,0
52239,5,3,183080,183080,183083,0,3,3
52240,6,2,183086,183086,183088,0,2,3
52241,6,3,183092,183092,183095,0,3,4
52242,2,3,183094,183095,183098,1,4,0
52243,3,1,183097,183098,183099,1,2,0
52244,2,1,183099,183099,183100,0,1,0
52245,3,3,183102,183102,183105,0,3,2
52246,3,2,183105,183105,183107,0,2,0
52247,5,1,183110,183110,183111,0,1,3
52248,3,1,183113,183113,183114,0,1,2
52249,2,3,183115,183115,183118,0,3,1
52250,6,1,183121,183121,183122,0,1,3
52251,6,2,183127,183127,183129,0,2,5
52252,6,2,183133,183133,183135,0,2,4
52253,2,1,183135,183135,183136,0,1,0
52254,1,3,183136,183136,183139,0,3,0
52255,1,1,183137,183139,183140,2,3,0
52256,6,1,183143,183143,183144,0,1,3
52257,2,3,183145,183145,183148,0,3,1
52258,2,3,183147,183148,183151,1,4,0
52259,3,2,183150,183151,183153,1,3,0
52260,1,3,183151,183153,183156,2,5,0
52261,6,3,183157,183157,183160,0,3,1
52262,6,3,183163,183163,183166,0,3,3
52263,6,3,183169,183169,183172,0,3,3
52264,6,1,183175,183175,183176,0,1,3
52265,2,2,183177,183177,183179,0,2,1
52266,4,3,183181,183181,183184,0,3,2
52267,4,1,183185,183185,183186,0,1,1
52268,6,2,183191,183191,183193,0,2,5
52269,3,3,183194,183194,183197,0,3,1
52270,3,3,183197,183197,183200,0,3,0
52271,6,3,183203,183203,183206,0,3,3
52272,1,1,183204,183206,183207,2,3,0
52273,6,1,183210,183210,183211,0,1,3
52274,2,2,183212,183212,183214,0,2,1
52275,5,2,183217,183217,183219,0,2,3
52276,3,3,183220,183220,183223,0,3,1
52277,3,3,183223,183223,183226,0,3,0
52278,6,3,183229,183229,183232,0,3,3
52279,6,2,183235,183235,183237,0,2,3
52280,2,1,183237,183237,183238,0,1,0
52281,3,1,183240,183240,183241,0,1,2
52282,3,2,183243,183243,183245,0,2,2
52283,4,1,183247,183247,183248,0,1,2
52284,2,2,183249,183249,183251,0,2,1
52285,4,1,183253,183253,183254,0,1,2
52286,4,2,183257,183257,183259,0,2,3
52287,2,2,183259,183259,183261,0,2,0
52288,6,1,183265,183265,183266,0,1,4
52289,3,1,183268,183268,183269,0,1,2
52290,2,1,183270,183270,183271,0,1,1
52291,2,2,183272,183272,183274,0,2,1
52292,4,2,183276,183276,183278,0,2,2
52293,1,3,183277,183278,183281,1,4,0
52294,1,3,183278,183281,183284,3,6,0
52295,2,1,183280,183284,183285,4,5,0
52296,6,2,183286,183286,183288,0,2,1
52297,3,3,183289,183289,183292,0,3,1
52298,1,2,183290,183292,183294,2,4,0
52299,2,3,183292,183294,183297,2,5,0
52300,4,3,183296,183297,183300,1,4,0
52301,2,2,183298,183300,183302,2,4,0
52302,3,3,183301,183302,183305,1,4,0
52303,1,3,183302,183305,183308,3,6,0
52304,5,1,183307,183308,183309,1,2,0
52305,6,2,183313,183313,183315,0,2,4
52306,6,1,183319,183319,183320,0,1,4
52307,5,2,183324,183324,183326,0,2,4
52308,4,1,183328,183328,183329,0,1,2
52309,4,2,183332,183332,183334,0,2,3
52310,4,2,183336,183336,183338,0,2,2
52311,4,2,183340,183340,183342,0,2,2
52312,2,1,183342,183342,183343,0,1,0
52313,2,2,183344,183344,183346,0,2,1
52314,4,2,183348,183348,183350,0,2,2
52315,4,1,183352,183352,183353,0,1,2
52316,2,2,183354,183354,183356,0,2,1
52317,2,3,183356,183356,183359,0,3,0
52318,6,1,183362,183362,183363,0,1,3
52319,2,3,183364,183364,183367,0,3,1
52320,1,3,183365,183367,183370,2,5,0
52321,5,3,183370,183370,183373,0,3,0
52322,3,2,183373,183373,183375,0,2,0
52323,6,1,183379,183379,183380,0,1,4
52324,2,2,183381,183381,183383,0,2,1
52325,1,1,183382,183383,183384,1,2,0
52326,5,2,183387,183387,183389,0,2,3
52327,1,1,183388,183389,183390,1,2,0
52328,6,3,183394,183394,183397,0,3,4
52329,1,3,183395,183397,183400,2,5,0
52330,6,3,183401,183401,183404,0,3,1
52331,5,2,183406,183406,183408,0,2,2
52332,6,2,183412,183412,183414,0,2,4
52333,4,2,183416,183416,183418,0,2,2
52334,3,3,183419,183419,183422,0,3,1
52335,6,3,183425,183425,183428,0,3,3
52336,1,1,183426,183428,183429,2,3,0
52337,2,2,183428,183429,183431,1,3,0
52338,1,1,183429,183431,183432,2,3,0
52339,3,1,183432,183432,183433,0,1,0
52340,5,1,183437,183437,183438,0,1,4
52341,5,3,183442,183442,183445,0,3,4
52342,3,1,183445,183445,183446,0,1,0
52343,2,2,183447,183447,183449,0,2,1
52344,6,2,183453,183453,183455,0,2,4
52345,3,3,183456,183456,183459,0,3,1
52346,2,1,183458,183459,183460,1,2,0
52347,5,3,183463,183463,183466,0,3,3
52348,6,3,183469,183469,183472,0,3,3
52349,5,3,183474,183474,183477,0,3,2
52350,6,3,183480,183480,183483,0,3,3
52351,2,2,183482,183483,183485,1,3,0
52352,2,2,183484,183485,183487,1,3,0
52353,3,1,183487,183487,183488,0,1,0
52354,3,2,183490,183490,183492,0,2,2
52355,5,1,183495,183495,183496,0,1,3
52356,4,1,183499,183499,183500,0,1,3
52357,1,1,183500,183500,183501,0,1,0
52358,6,2,183506,183506,183508,0,2,5
52359,5,1,183511,183511,183512,0,1,3
52360,1,1,183512,183512,183513,0,1,0
52361,1,2,183513,183513,183515,0,2,0
52362,2,2,183515,183515,183517,0,2,0
52363,1,3,183516,183517,183520,1,4,0
52364,2,2,183518,183520,183522,2,4,0
52365,1,3,183519,183522,183525,3,6,0
52366,4,1,183523,183525,183526,2,3,0
52367,2,3,183525,183526,183529,1,4,0
52368,4,1,183529,183529,183530,0,1,0
52369,6,3,183535,183535,183538,0,3,5
52370,2,3,183537,183538,183541,1,4,0
52371,2,3,183539,183541,183544,2,5,0
52372,3,2,183542,183544,183546,2,4,0
52373,2,1,183544,183546,183547,2,3,0
52374,2,2,183546,183547,183549,1,3,0
52375,1,2,183547,183549,183551,2,4,0
52376,1,2,183548,183551,183553,3,5,0
52377,1,3,183549,183553,183556,4,7,0
52378,1,1,183550,183556,183557,6,7,0
52379,2,3,183552,183557,183560,5,8,0
52380,2,3,183554,183560,183563,6,9,0
52381,4,3,183558,183563,183566,5,8,0
52382,4,3,183562,183566,183569,4,7,0
52383,2,2,183564,183569,183571,5,7,0
52384,5,2,183569,183571,183573,2,4,0
52385,3,1,183572,183573,183574,1,2,0
52386,2,3,183574,183574,183577,0,3,0
52387,2,1,183576,183577,183578,1,2,0
52388,5,1,183581,183581,183582,0,1,3
52389,3,3,183584,183584,183587,0,3,2
52390,4,1,183588,183588,183589,0,1,1
52391,3,3,183591,183591,183594,0,3,2
52392,3,2,183594,183594,183596,0,2,0
52393,2,3,183596,183596,183599,0,3,0
52394,4,1,183600,183600,183601,0,1,1
52395,6,3,183606,183606,183609,0,3,5
52396,3,3,183609,183609,183612,0,3,0
52397,4,2,183613,183613,183615,0,2,1
52398,4,2,183617,183617,183619,0,2,2
52399,5,1,183622,183622,183623,0,1,3
52400,2,2,183624,183624,183626,0,2,1
52401,3,3,183627,183627,183630,0,3,1
52402,6,3,183633,183633,183636,0,3,3
52403,1,3,183634,183636,183639,2,5,0
52404,1,2,183635,183639,183641,4,6,0
52405,3,1,183638,183641,183642,3,4,0
52406,1,1,183639,183642,183643,3,4,0
52407,3,3,183642,183643,183646,1,4,0
52408,6,1,183648,183648,183649,0,1,2
52409,1,3,183649,183649,183652,0,3,0
52410,2,3,183651,183652,183655,1,4,0
52411,5,1,183656,183656,183657,0,1,1
52412,5,1,183661,183661,183662,0,1,4
52413,5,3,183666,183666,183669,0,3,4
52414,2,3,183668,183669,183672,1,4,0
52415,4,1,183672,183672,183673,0,1,0
52416,3,3,183675,183675,183678,0,3,2
52417,6,3,183681,183681,183684,0,3,3
52418,2,1,183683,183684,183685,1,2,0
52419,2,1,183685,183685,183686,0,1,0
52420,1,2,183686,183686,183688,0,2,0
52421,3,2,183689,183689,183691,0,2,1
52422,3,3,183692,183692,183695,0,3,1
52423,4,3,183696,183696,183699,0,3,1
52424,5,3,183701,183701,183704,0,3,2
52425,6,1,183707,183707,183708,0,1,3
52426,4,1,183711,183711,183712,0,1,3
52427,6,1,183717,183717,183718,0,1,5
52428,2,3,183719,183719,183722,0,3,1
52429,2,3,183721,183722,183725,1,4,0
52430,2,2,183723,183725,183727,2,4,0
52431,1,3,183724,183727,183730,3,6,0
52432,4,1,183728,183730,183731,2,3,0
52433,4,2,183732,183732,183734,0,2,1
52434,1,1,183733,183734,183735,1,2,0
52435,4,1,183737,183737,183738,0,1,2
52436,2,1,183739,183739,183740,0,1,1
52437,6,2,183745,183745,183747,0,2,5
52438,5,1,183750,183750,183751,0,1,3
52439,6,2,183756,183756,183758,0,2,5
52440,3,3,183759,183759,183762,0,3,1
52441,3,3,183762,183762,183765,0,3,0
52442,5,2,183767,183767,183769,0,2,2
52443,5,3,183772,183772,183775,0,3,3
52444,6,3,183778,183778,183781,0,3,3
52445,6,1,183784,183784,183785,0,1,3
52446,4,2,183788,183788,183790,0,2,3
52447,2,2,183790,183790,183792,0,2,0
52448,4,2,183794,183794,183796,0,2,2
52449,3,2,183797,183797,183799,0,2,1
52450,3,2,183800,183800,183802,0,2,1
52451,6,3,183806,183806,183809,0,3,4
52452,4,2,183810,183810,183812,0,2,1
52453,4,1,183814,183814,183815,0,1,2
52454,6,2,183820,183820,183822,0,2,5
52455,3,1,183823,183823,183824,0,1,1
52456,2,2,183825,183825,183827,0,2,1
52457,6,2,183831,183831,183833,0,2,4
52458,3,3,183834,183834,183837,0,3,1
52459,4,2,183838,183838,183840,0,2,1
52460,2,3,183840,183840,183843,0,3,0
52461,5,2,183845,183845,183847,0,2,2
52462,3,1,183848,183848,183849,0,1,1
52463,1,3,183849,183849,183852,0,3,0
52464,3,2,183852,183852,183854,0,2,0
52465,6,2,183858,183858,183860,0,2,4
52466,3,2,183861,183861,183863,0,2,1
52467,2,1,183863,183863,183864,0,1,0
52468,4,3,183867,183867,183870,0,3,3
52469,5,2,183872,183872,183874,0,2,2
52470,2,2,183874,183874,183876,0,2,0
52471,6,1,183880,183880,183881,0,1,4
52472,6,2,183886,183886,183888,0,2,5
52473,3,1,183889,183889,183890,0,1,1
52474,3,2,183892,183892,183894,0,2,2
52475,3,3,183895,183895,183898,0,3,1
52476,1,3,183896,183898,183901,2,5,0
52477,6,1,183902,183902,183903,0,1,1
52478,5,1,183907,183907,183908,0,1,4
52479,6,1,183913,183913,183914,0,1,5
52480,5,2,183918,183918,183920,0,2,4
52481,1,1,183919,183920,183921,1,2,0
52482,3,3,183922,183922,183925,0,3,1
52483,1,2,183923,183925,183927,2,4,0
52484,4,3,183927,183927,183930,0,3,0
52485,5,2,183932,183932,183934,0,2,2
52486,1,2,183933,183934,183936,1,3,0
52487,3,2,183936,183936,183938,0,2,0
52488,5,1,183941,183941,183942,0,1,3
52489,6,3,183947,183947,183950,0,3,5
52490,1,1,183948,183950,183951,2,3,0
52491,6,2,183954,183954,183956,0,2,3
52492,6,3,183960,183960,183963,0,3,4
52493,5,3,183965,183965,183968,0,3,2
52494,1,3,183966,183968,183971,2,5,0
52495,4,3,183970,183971,183974,1,4,0
52496,2,3,183972,183974,183977,2,5,0
52497,4,3,183976,183977,183980,1,4,0
52498,5,2,183981,183981,183983,0,2,1
52499,3,3,183984,183984,183987,0,3,1
52500,3,1,183987,183987,183988,0,1,0
52501,3,3,183990,183990,183993,0,3,2
52502,6,1,183996,183996,183997,0,1,3
52503,5,2,184001,184001,184003,0,2,4
52504,2,2,184003,184003,184005,0,2,0
52505,4,3,184007,184007,184010,0,3,2
52506,1,1,184008,184010,184011,2,3,0
52507,4,2,184012,184012,184014,0,2,1
52508,4,3,184016,184016,184019,0,3,2
52509,5,2,184021,184021,184023,0,2,2
52510,2,1,184023,184023,184024,0,1,0
52511,1,1,184024,184024,184025,0,1,0
52512,4,3,184028,184028,184031,0,3,3
52513,4,2,184032,184032,184034,0,2,1
52514,3,3,184035,184035,184038,0,3,1
52515,1,3,184036,184038,184041,2,5,0
52516,4,2,184040,184041,184043,1,3,0
52517,2,1,184042,184043,184044,1,2,0
52518,6,2,184048,184048,184050,0,2,4
52519,3,3,184051,184051,184054,0,3,1
52520,4,2,184055,184055,184057,0,2,1
52521,6,3,184061,184061,184064,0,3,4
52522,1,3,184062,184064,184067,2,5,0
52523,3,2,184065,184067,184069,2,4,0
52524,6,2,184071,184071,184073,0,2,2
52525,1,3,184072,184073,184076,1,4,0
52526,6,2,184078,184078,184080,0,2,2
52527,3,2,184081,184081,184083,0,2,1
52528,1,1,184082,184083,184084,1,2,0
52529,3,2,184085,184085,184087,0,2,1
52530,2,3,184087,184087,184090,0,3,0
52531,2,3,184089,184090,184093,1,4,0
52532,1,2,184090,184093,184095,3,5,0
52533,2,1,184092,184095,184096,3,4,0
52534,3,2,184095,184096,184098,1,3,0
52535,1,1,184096,184098,184099,2,3,0
52536,3,3,184099,184099,184102,0,3,0
52537,4,1,184103,184103,184104,0,1,1
52538,5,2,184108,184108,184110,0,2,4
52539,4,2,184112,184112,184114,0,2,2
52540,6,2,184118,184118,184120,0,2,4
52541,2,1,184120,184120,184121,0,1,0
52542,5,1,184125,184125,184126,0,1,4
52543,6,2,184131,184131,184133,0,2,5
52544,4,1,184135,184135,184136,0,1,2
52545,5,1,184140,184140,184141,0,1,4
52546,3,2,184143,184143,184145,0,2,2
52547,6,3,184149,184149,184152,0,3,4
52548,6,1,184155,184155,184156,0,1,3
52549,6,2,184161,184161,184163,0,2,5
52550,3,2,184164,184164,184166,0,2,1
52551,3,2,184167,184167,184169,0,2,1
52552,1,3,184168,184169,184172,1,4,0
52553,2,2,184170,184172,184174,2,4,0
52554,3,2,184173,184174,184176,1,3,0
52555,6,3,184179,184179,184182,0,3,3
52556,4,2,184183,184183,184185,0,2,1
52557,4,3,184187,184187,184190,0,3,2
52558,4,1,184191,184191,184192,0,1,1
52559,3,3,184194,184194,184197,0,3,2
52560,5,3,184199,184199,184202,0,3,2
52561,3,3,184202,184202,184205,0,3,0
52562,5,3,184207,184207,184210,0,3,2
52563,4,1,184211,184211,184212,0,1,1
52564,2,2,184213,184213,184215,0,2,1
52565,5,1,184218,184218,184219,0,1,3
52566,4,1,184222,184222,184223,0,1,3
52567,2,3,184224,184224,184227,0,3,1
52568,3,1,184227,184227,184228,0,1,0
52569,6,3,184233,184233,184236,0,3,5
52570,6,1,184239,184239,184240,0,1,3
52571,4,3,184243,184243,184246,0,3,3
52572,5,1,184248,184248,184249,0,1,2
52573,2,1,184250,184250,184251,0,1,1
52574,5,1,184255,184255,184256,0,1,4
52575,6,3,184261,184261,184264,0,3,5
52576,3,2,184264,184264,184266,0,2,0
52577,4,1,184268,184268,184269,0,1,2
52578,6,1,184274,184274,184275,0,1,5
52579,6,2,184280,184280,184282,0,2,5
52580,2,2,184282,184282,184284,0,2,0
52581,1,1,184283,184284,184285,1,2,0
52582,4,3,184287,184287,184290,0,3,2
52583,5,1,184292,184292,184293,0,1,2
52584,3,1,184295,184295,184296,0,1,2
52585,1,3,184296,184296,184299,0,3,0
52586,2,3,184298,184299,184302,1,4,0
52587,2,2,184300,184302,184304,2,4,0
52588,3,3,184303,184304,184307,1,4,0
52589,2,2,184305,184307,184309,2,4,0
52590,4,3,184309,184309,184312,0,3,0
52591,1,2,184310,184312,184314,2,4,0
52592,2,1,184312,184314,184315,2,3,0
52593,4,3,184316,184316,184319,0,3,1
52594,6,2,184322,184322,184324,0,2,3
52595,5,2,184327,184327,184329,0,2,3
52596,2,2,184329,184329,184331,0,2,0
52597,2,3,184331,184331,184334,0,3,0
52598,6,1,184337,184337,184338,0,1,3
52599,6,2,184343,184343,184345,0,2,5
52600,2,1,184345,184345,184346,0,1,0
52601,1,2,184346,184346,184348,0,2,0
52602,5,3,184351,184351,184354,0,3,3
52603,6,3,184357,184357,184360,0,3,3
52604,4,2,184361,184361,184363,0,2,1
52605,1,2,184362,184363,184365,1,3,0
52606,1,3,184363,184365,184368,2,5,0
52607,2,1,184365,184368,184369,3,4,0
52608,6,3,184371,184371,184374,0,3,2
52609,4,3,184375,184375,184378,0,3,1
52610,6,3,184381,184381,184384,0,3,3
52611,3,1,184384,184384,184385,0,1,0
52612,4,1,184388,184388,184389,0,1,3
52613,5,3,184393,184393,184396,0,3,4
52614,3,1,184396,184396,184397,0,1,0
52615,5,1,184401,184401,184402,0,1,4
52616,5,2,184406,184406,184408,0,2,4
52617,2,3,184408,184408,184411,0,3,0
52618,1,3,184409,184411,184414,2,5,0
52619,5,1,184414,184414,184415,0,1,0
52620,2,1,184416,184416,184417,0,1,1
52621,4,3,184420,184420,184423,0,3,3
52622,4,1,184424,184424,184425,0,1,1
52623,5,2,184429,184429,184431,0,2,4
52624,6,1,184435,184435,184436,0,1,4
52625,4,3,184439,184439,184442,0,3,3
52626,6,3,184445,184445,184448,0,3,3
52627,6,3,184451,184451,184454,0,3,3
52628,1,2,184452,184454,184456,2,4,0
52629,3,3,184455,184456,184459,1,4,0
52630,5,1,184460,184460,184461,0,1,1
52631,2,3,184462,184462,184465,0,3,1
52632,2,1,184464,184465,184466,1,2,0
52633,3,2,184467,184467,184469,0,2,1
52634,6,3,184473,184473,184476,0,3,4
52635,2,2,184475,184476,184478,1,3,0
52636,5,2,184480,184480,184482,0,2,2
52637,5,3,184485,184485,184488,0,3,3
52638,5,2,184490,184490,184492,0,2,2
52639,4,3,184494,184494,184497,0,3,2
52640,1,2,184495,184497,184499,2,4,0
52641,3,3,184498,184499,184502,1,4,0
52642,5,2,184503,184503,184505,0,2,1
52643,2,3,184505,184505,184508,0,3,0
52644,5,3,184510,184510,184513,0,3,2
52645,5,3,184515,184515,184518,0,3,2
52646,2,1,184517,184518,184519,1,2,0
52647,2,3,184519,184519,184522,0,3,0
52648,4,1,184523,184523,184524,0,1,1
52649,2,2,184525,184525,184527,0,2,1
52650,6,3,184531,184531,184534,0,3,4
52651,4,3,184535,184535,184538,0,3,1
52652,3,1,184538,184538,184539,0,1,0
52653,6,3,184544,184544,184547,0,3,5
52654,5,2,184549,184549,184551,0,2,2
52655,3,2,184552,184552,184554,0,2,1
52656,3,1,184555,184555,184556,0,1,1
52657,3,3,184558,184558,184561,0,3,2
52658,5,1,184563,184563,184564,0,1,2
52659,4,2,184567,184567,184569,0,2,3
52660,6,2,184573,184573,184575,0,2,4
52661,5,3,184578,184578,184581,0,3,3
52662,2,2,184580,184581,184583,1,3,0
52663,6,3,184586,184586,184589,0,3,3
52664,3,1,184589,184589,184590,0,1,0
52665,4,1,184593,184593,184594,0,1,3
52666,6,2,184599,184599,184601,0,2,5
52667,3,2,184602,184602,184604,0,2,1
52668,6,3,184608,184608,184611,0,3,4
52669,4,1,184612,184612,184613,0,1,1
52670,3,2,184615,184615,184617,0,2,2
52671,1,2,184616,184617,184619,1,3,0
52672,5,2,184621,184621,184623,0,2,2
52673,4,1,184625,184625,184626,0,1,2
52674,4,3,184629,184629,184632,0,3,3
52675,4,1,184633,184633,184634,0,1,1
52676,2,3,184635,184635,184638,0,3,1
52677,4,3,184639,184639,184642,0,3,1
52678,2,2,184641,184642,184644,1,3,0
52679,1,2,184642,184644,184646,2,4,0
52680,1,2,184643,184646,184648,3,5,0
52681,3,1,184646,184648,184649,2,3,0
52682,3,3,184649,184649,184652,0,3,0
52683,5,1,184654,184654,184655,0,1,2
52684,2,1,184656,184656,184657,0,1,1
52685,4,3,184660,184660,184663,0,3,3
52686,3,3,184663,184663,184666,0,3,0
52687,3,2,184666,184666,184668,0,2,0
52688,1,3,184667,184668,184671,1,4,0
52689,2,1,184669,184671,184672,2,3,0
52690,1,1,184670,184672,184673,2,3,0
52691,5,2,184675,184675,184677,0,2,2
52692,3,2,184678,184678,184680,0,2,1
52693,3,3,184681,184681,184684,0,3,1
52694,3,3,184684,184684,184687,0,3,0
52695,4,3,184688,184688,184691,0,3,1
52696,3,1,184691,184691,184692,0,1,0
52697,4,1,184695,184695,184696,0,1,3
52698,5,2,184700,184700,184702,0,2,4
52699,2,1,184702,184702,184703,0,1,0
52700,3,3,184705,184705,184708,0,3,2
52701,6,2,184711,184711,184713,0,2,3
52702,4,1,184715,184715,184716,0,1,2
52703,4,2,184719,184719,184721,0,2,3
52704,5,3,184724,184724,184727,0,3,3
52705,6,3,184730,184730,184733,0,3,3
52706,2,2,184732,184733,184735,1,3,0
52707,6,1,184738,184738,184739,0,1,3
52708,5,2,184743,184743,184745,0,2,4
52709,3,1,184746,184746,184747,0,1,1
52710,2,1,184748,184748,184749,0,1,1
52711,3,2,184751,184751,184753,0,2,2
52712,1,2,184752,184753,184755,1,3,0
52713,1,3,184753,184755,184758,2,5,0
52714,6,2,184759,184759,184761,0,2,1
52715,4,1,184763,184763,184764,0,1,2
52716,6,3,184769,184769,184772,0,3,5
52717,6,2,184775,184775,184777,0,2,3
52718,3,1,184778,184778,184779,0,1,1
52719,1,3,184779,184779,184782,0,3,0
52720,1,2,184780,184782,184784,2,4,0
52721,5,2,184785,184785,184787,0,2,1
52722,3,1,184788,184788,184789,0,1,1
52723,1,1,184789,184789,184790,0,1,0
52724,2,3,184791,184791,184794,0,3,1
52725,4,1,184795,184795,184796,0,1,1
52726,6,1,184801,184801,184802,0,1,5
52727,2,3,184803,184803,184806,0,3,1
52728,3,2,184806,184806,184808,0,2,0
52729,5,3,184811,184811,184814,0,3,3
52730,1,1,184812,184814,184815,2,3,0
52731,1,1,184813,184815,184816,2,3,0
52732,1,2,184814,184816,184818,2,4,0
52733,5,2,184819,184819,184821,0,2,1
52734,3,2,184822,184822,184824,0,2,1
52735,6,3,184828,184828,184831,0,3,4
52736,6,2,184834,184834,184836,0,2,3
52737,3,2,184837,184837,184839,0,2,1
52738,4,3,184841,184841,184844,0,3,2
52739,2,3,184843,184844,184847,1,4,0
52740,6,3,184849,184849,184852,0,3,2
52741,2,3,184851,184852,184855,1,4,0
52742,1,2,184852,184855,184857,3,5,0
52743,6,2,184858,184858,184860,0,2,1
52744,4,1,184862,184862,184863,0,1,2
52745,1,2,184863,184863,184865,0,2,0
52746,5,2,184868,184868,184870,0,2,3
52747,4,1,184872,184872,184873,0,1,2
52748,5,2,184877,184877,184879,0,2,4
52749,5,1,184882,184882,184883,0,1,3
52750,1,3,184883,184883,184886,0,3,0
52751,4,1,184887,184887,184888,0,1,1
52752,5,3,184892,184892,184895,0,3,4
52753,4,2,184896,184896,184898,0,2,1
52754,1,2,184897,184898,184900,1,3,0
52755,3,3,184900,184900,184903,0,3,0
52756,5,3,184905,184905,184908,0,3,2
52757,3,1,184908,184908,184909,0,1,0
52758,5,2,184913,184913,184915,0,2,4
52759,2,3,184915,184915,184918,0,3,0
52760,1,3,184916,184918,184921,2,5,0
52761,6,3,184922,184922,184925,0,3,1
52762,4,1,184926,184926,184927,0,1,1
52763,5,3,184931,184931,184934,0,3,4
52764,3,3,184934,184934,184937,0,3,0
52765,2,1,184936,184937,184938,1,2,0
52766,1,1,184937,184938,184939,1,2,0
52767,6,1,184943,184943,184944,0,1,4
52768,5,3,184948,184948,184951,0,3,4
52769,4,3,184952,184952,184955,0,3,1
52770,5,2,184957,184957,184959,0,2,2
52771,2,1,184959,184959,184960,0,1,0
52772,4,2,184963,184963,184965,0,2,3
52773,4,1,184967,184967,184968,0,1,2
52774,4,2,184971,184971,184973,0,2,3
52775,6,3,184977,184977,184980,0,3,4
52776,2,2,184979,184980,184982,1,3,0
52777,4,2,184983,184983,184985,0,2,1
52778,6,2,184989,184989,184991,0,2,4
52779,4,1,184993,184993,184994,0,1,2
52780,3,1,184996,184996,184997,0,1,2
52781,6,2,185002,185002,185004,0,2,5
52782,5,3,185007,185007,185010,0,3,3
52783,6,2,185013,185013,185015,0,2,3
52784,3,3,185016,185016,185019,0,3,1
52785,4,1,185020,185020,185021,0,1,1
52786,1,1,185021,185021,185022,0,1,0
52787,1,1,185022,185022,185023,0,1,0
52788,6,1,185028,185028,185029,0,1,5
52789,2,1,185030,185030,185031,0,1,1
52790,1,1,185031,185031,185032,0,1,0
52791,2,1,185033,185033,185034,0,1,1
52792,1,3,185034,185034,185037,0,3,0
52793,3,2,185037,185037,185039,0,2,0
52794,5,2,185042,185042,185044,0,2,3
52795,4,3,185046,185046,185049,0,3,2
52796,5,3,185051,185051,185054,0,3,2
52797,2,3,185053,185054,185057,1,4,0
52798,4,1,185057,185057,185058,0,1,0
52799,6,1,185063,185063,185064,0,1,5
52800,5,3,185068,185068,185071,0,3,4
52801,6,3,185074,185074,185077,0,3,3
52802,4,3,185078,185078,185081,0,3,1
52803,2,3,185080,185081,185084,1,4,0
52804,6,2,185086,185086,185088,0,2,2
52805,3,2,185089,185089,185091,0,2,1
52806,5,2,185094,185094,185096,0,2,3
52807,4,2,185098,185098,185100,0,2,2
52808,3,3,185101,185101,185104,0,3,1
52809,6,2,185107,185107,185109,0,2,3
52810,4,2,185111,185111,185113,0,2,2
52811,5,1,185116,185116,185117,0,1,3
52812,4,1,185120,185120,185121,0,1,3
52813,3,2,185123,185123,185125,0,2,2
52814,4,1,185127,185127,185128,0,1,2
52815,5,2,185132,185132,185134,0,2,4
52816,3,3,185135,185135,185138,0,3,1
52817,2,3,185137,185138,185141,1,4,0
52818,5,1,185142,185142,185143,0,1,1
52819,2,2,185144,185144,185146,0,2,1
52820,5,1,185149,185149,185150,0,1,3
52821,5,1,185154,185154,185155,0,1,4
52822,5,3,185159,185159,185162,0,3,4
52823,6,3,185165,185165,185168,0,3,3
52824,3,1,185168,185168,185169,0,1,0
52825,6,2,185174,185174,185176,0,2,5
52826,6,3,185180,185180,185183,0,3,4
52827,1,3,185181,185183,185186,2,5,0
52828,5,1,185186,185186,185187,0,1,0
52829,3,1,185189,185189,185190,0,1,2
52830,1,2,185190,185190,185192,0,2,0
52831,1,2,185191,185192,185194,1,3,0
52832,1,2,185192,185194,185196,2,4,0
52833,5,2,185197,185197,185199,0,2,1
52834,2,2,185199,185199,185201,0,2,0
52835,2,3,185201,185201,185204,0,3,0
52836,2,1,185203,185204,185205,1,2,0
52837,1,1,185204,185205,185206,1,2,0
52838,4,1,185208,185208,185209,0,1,2
52839,6,3,185214,185214,185217,0,3,5
52840,3,2,185217,185217,185219,0,2,0
52841,2,3,185219,185219,185222,0,3,0
52842,3,1,185222,185222,185223,0,1,0
52843,2,2,185224,185224,185226,0,2,1
52844,6,3,185230,185230,185233,0,3,4
52845,4,3,185234,185234,185237,0,3,1
52846,6,1,185240,185240,185241,0,1,3
52847,1,2,185241,185241,185243,0,2,0
52848,4,1,185245,185245,185246,0,1,2
52849,3,1,185248,185248,185249,0,1,2
52850,6,2,185254,185254,185256,0,2,5
52851,2,1,185256,185256,185257,0,1,0
52852,2,2,185258,185258,185260,0,2,1
52853,5,2,185263,185263,185265,0,2,3
52854,6,1,185269,185269,185270,0,1,4
52855,3,1,185272,185272,185273,0,1,2
52856,1,1,185273,185273,185274,0,1,0
52857,5,1,185278,185278,185279,0,1,4
52858,5,3,185283,185283,185286,0,3,4
52859,1,3,185284,185286,185289,2,5,0
52860,3,1,185287,185289,185290,2,3,0
52861,3,3,185290,185290,185293,0,3,0
52862,3,1,185293,185293,185294,0,1,0
52863,3,3,185296,185296,185299,0,3,2
52864,2,1,185298,185299,185300,1,2,0
52865,3,2,185301,185301,185303,0,2,1
52866,1,3,185302,185303,185306,1,4,0
52867,4,3,185306,185306,185309,0,3,0
52868,6,2,185312,185312,185314,0,2,3
52869,2,3,185314,185314,185317,0,3,0
52870,6,1,185320,185320,185321,0,1,3
52871,6,3,185326,185326,185329,0,3,5
52872,6,2,185332,185332,185334,0,2,3
52873,4,3,185336,185336,185339,0,3,2
52874,4,3,185340,185340,185343,0,3,1
52875,4,1,185344,185344,185345,0,1,1
52876,1,2,185345,185345,185347,0,2,0
52877,5,2,185350,185350,185352,0,2,3
52878,4,3,185354,185354,185357,0,3,2
52879,4,3,185358,185358,185361,0,3,1
52880,1,1,185359,185361,185362,2,3,0
52881,6,1,185365,185365,185366,0,1,3
52882,6,2,185371,185371,185373,0,2,5
52883,5,2,185376,185376,185378,0,2,3
52884,2,3,185378,185378,185381,0,3,0
52885,2,2,185380,185381,185383,1,3,0
52886,2,2,185382,185383,185385,1,3,0
52887,5,2,185387,185387,185389,0,2,2
52888,1,2,185388,185389,185391,1,3,0
52889,1,1,185389,185391,185392,2,3,0
52890,3,1,185392,185392,185393,0,1,0
52891,4,3,185396,185396,185399,0,3,3
52892,4,1,185400,185400,185401,0,1,1
52893,2,1,185402,185402,185403,0,1,1
52894,5,1,185407,185407,185408,0,1,4
52895,3,1,185410,185410,185411,0,1,2
52896,6,1,185416,185416,185417,0,1,5
52897,3,3,185419,185419,185422,0,3,2
52898,5,1,185424,185424,185425,0,1,2
52899,2,3,185426,185426,185429,0,3,1
52900,6,1,185432,185432,185433,0,1,3
52901,5,1,185437,185437,185438,0,1,4
52902,5,2,185442,185442,185444,0,2,4
52903,3,1,185445,185445,185446,0,1,1
52904,1,3,185446,185446,185449,0,3,0
52905,1,1,185447,185449,185450,2,3,0
52906,3,1,185450,185450,185451,0,1,0
52907,4,3,185454,185454,185457,0,3,3
52908,3,1,185457,185457,185458,0,1,0
52909,1,3,185458,185458,185461,0,3,0
52910,4,3,185462,185462,185465,0,3,1
52911,2,2,185464,185465,185467,1,3,0
52912,4,3,185468,185468,185471,0,3,1
52913,2,2,185470,185471,185473,1,3,0
52914,4,3,185474,185474,185477,0,3,1
52915,3,1,185477,185477,185478,0,1,0
52916,4,1,185481,185481,185482,0,1,3
52917,3,3,185484,185484,185487,0,3,2
52918,6,3,185490,185490,185493,0,3,3
52919,5,2,185495,185495,185497,0,2,2
52920,4,2,185499,185499,185501,0,2,2
52921,1,3,185500,185501,185504,1,4,0
52922,5,3,185505,185505,185508,0,3,1
52923,6,1,185511,185511,185512,0,1,3
52924,1,1,185512,185512,185513,0,1,0
52925,5,1,185517,185517,185518,0,1,4
52926,4,1,185521,185521,185522,0,1,3
52927,6,2,185527,185527,185529,0,2,5
52928,2,2,185529,185529,185531,0,2,0
52929,2,3,185531,185531,185534,0,3,0
52930,3,3,185534,185534,185537,0,3,0
52931,3,3,185537,185537,185540,0,3,0
52932,3,3,185540,185540,185543,0,3,0
52933,5,2,185545,185545,185547,0,2,2
52934,5,2,185550,185550,185552,0,2,3
52935,5,1,185555,185555,185556,0,1,3
52936,4,3,185559,185559,185562,0,3,3
52937,3,3,185562,185562,185565,0,3,0
52938,2,2,185564,185565,185567,1,3,0
52939,6,3,185570,185570,185573,0,3,3
52940,3,2,185573,185573,185575,0,2,0
52941,3,3,185576,185576,185579,0,3,1
52942,3,1,185579,185579,185580,0,1,0
52943,5,1,185584,185584,185585,0,1,4
52944,5,1,185589,185589,185590,0,1,4
52945,3,2,185592,185592,185594,0,2,2
52946,1,3,185593,185594,185597,1,4,0
52947,3,2,185596,185597,185599,1,3,0
52948,4,3,185600,185600,185603,0,3,1
52949,4,1,185604,185604,185605,0,1,1
52950,5,2,185609,185609,185611,0,2,4
52951,2,1,185611,185611,185612,0,1,0
52952,3,1,185614,185614,185615,0,1,2
52953,3,1,185617,185617,185618,0,1,2
52954,3,3,185620,185620,185623,0,3,2
52955,3,3,185623,185623,185626,0,3,0
52956,2,1,185625,185626,185627,1,2,0
52957,5,2,185630,185630,185632,0,2,3
52958,1,3,185631,185632,185635,1,4,0
52959,6,3,185637,185637,185640,0,3,2
52960,3,1,185640,185640,185641,0,1,0
52961,3,2,185643,185643,185645,0,2,2
52962,5,2,185648,185648,185650,0,2,3
52963,3,3,185651,185651,185654,0,3,1
52964,4,1,185655,185655,185656,0,1,1
52965,2,3,185657,185657,185660,0,3,1
52966,4,1,185661,185661,185662,0,1,1
52967,4,3,185665,185665,185668,0,3,3
52968,1,2,185666,185668,185670,2,4,0
52969,6,2,185672,185672,185674,0,2,2
52970,4,2,185676,185676,185678,0,2,2
52971,1,2,185677,185678,185680,1,3,0
52972,2,2,185679,185680,185682,1,3,0
52973,2,3,185681,185682,185685,1,4,0
52974,5,2,185686,185686,185688,0,2,1
52975,4,2,185690,185690,185692,0,2,2
52976,4,3,185694,185694,185697,0,3,2
52977,6,1,185700,185700,185701,0,1,3
52978,1,2,185701,185701,185703,0,2,0
52979,4,3,185705,185705,185708,0,3,2
52980,4,3,185709,185709,185712,0,3,1
52981,2,1,185711,185712,185713,1,2,0
52982,1,3,185712,185713,185716,1,4,0
52983,4,3,185716,185716,185719,0,3,0
52984,4,3,185720,185720,185723,0,3,1
52985,2,2,185722,185723,185725,1,3,0
52986,4,3,185726,185726,185729,0,3,1
52987,5,1,185731,185731,185732,0,1,2
52988,1,3,185732,185732,185735,0,3,0
52989,2,1,185734,185735,185736,1,2,0
52990,2,2,185736,185736,185738,0,2,0
52991,4,2,185740,185740,185742,0,2,2
52992,4,3,185744,185744,185747,0,3,2
52993,4,1,185748,185748,185749,0,1,1
52994,3,3,185751,185751,185754,0,3,2
52995,1,3,185752,185754,185757,2,5,0
52996,6,1,185758,185758,185759,0,1,1
52997,4,2,185762,185762,185764,0,2,3
52998,2,1,185764,185764,185765,0,1,0
52999,5,2,185769,185769,185771,0,2,4
53000,1,2,185770,185771,185773,1,3,0
53001,2,1,185772,185773,185774,1,2,0
53002,2,2,185774,185774,185776,0,2,0
53003,1,2,185775,185776,185778,1,3,0
53004,5,3,185780,185780,185783,0,3,2
53005,5,3,185785,185785,185788,0,3,2
53006,4,1,185789,185789,185790,0,1,1
53007,3,1,185792,185792,185793,0,1,2
53008,2,1,185794,185794,185795,0,1,1
53009,5,1,185799,185799,185800,0,1,4
53010,3,1,185802,185802,185803,0,1,2
53011,2,2,185804,185804,185806,0,2,1
53012,4,3,185808,185808,185811,0,3,2
53013,2,1,185810,185811,185812,1,2,0
53014,4,3,185814,185814,185817,0,3,2
53015,5,3,185819,185819,185822,0,3,2
53016,6,2,185825,185825,185827,0,2,3
53017,5,3,185830,185830,185833,0,3,3
53018,2,3,185832,185833,185836,1,4,0
53019,3,1,185835,185836,185837,1,2,0
53020,4,2,185839,185839,185841,0,2,2
53021,6,2,185845,185845,185847,0,2,4
53022,3,1,185848,185848,185849,0,1,1
53023,4,3,185852,185852,185855,0,3,3
53024,4,3,185856,185856,185859,0,3,1
53025,5,2,185861,185861,185863,0,2,2
53026,3,3,185864,185864,185867,0,3,1
53027,1,3,185865,185867,185870,2,5,0
53028,6,2,185871,185871,185873,0,2,1
53029,5,3,185876,185876,185879,0,3,3
53030,5,2,185881,185881,185883,0,2,2
53031,5,2,185886,185886,185888,0,2,3
53032,3,3,185889,185889,185892,0,3,1
53033,2,1,185891,185892,185893,1,2,0
53034,1,3,185892,185893,185896,1,4,0
53035,6,1,185898,185898,185899,0,1,2
53036,3,3,185901,185901,185904,0,3,2
53037,5,1,185906,185906,185907,0,1,2
53038,2,1,185908,185908,185909,0,1,1
53039,2,2,185910,185910,185912,0,2,1
53040,1,2,185911,185912,185914,1,3,0
53041,2,3,185913,185914,185917,1,4,0
53042,5,2,185918,185918,185920,0,2,1
53043,2,2,185920,185920,185922,0,2,0
53044,1,2,185921,185922,185924,1,3,0
53045,5,3,185926,185926,185929,0,3,2
53046,3,2,185929,185929,185931,0,2,0
53047,3,2,185932,185932,185934,0,2,1
53048,3,1,185935,185935,185936,0,1,1
53049,3,2,185938,185938,185940,0,2,2
53050,2,1,185940,185940,185941,0,1,0
53051,3,2,185943,185943,185945,0,2,2
53052,6,2,185949,185949,185951,0,2,4
53053,5,2,185954,185954,185956,0,2,3
53054,1,2,185955,185956,185958,1,3,0
53055,2,2,185957,185958,185960,1,3,0
53056,6,1,185963,185963,185964,0,1,3
53057,3,3,185966,185966,185969,0,3,2
53058,4,3,185970,185970,185973,0,3,1
53059,6,3,185976,185976,185979,0,3,3
53060,4,2,185980,185980,185982,0,2,1
53061,2,1,185982,185982,185983,0,1,0
53062,2,3,185984,185984,185987,0,3,1
53063,1,3,185985,185987,185990,2,5,0
53064,3,2,185988,185990,185992,2,4,0
53065,4,1,185992,185992,185993,0,1,0
53066,2,3,185994,185994,185997,0,3,1
53067,5,3,185999,185999,186002,0,3,2
53068,3,3,186002,186002,186005,0,3,0
53069,1,3,186003,186005,186008,2,5,0
53070,2,3,186005,186008,186011,3,6,0
53071,1,3,186006,186011,186014,5,8,0
53072,4,2,186010,186014,186016,4,6,0
53073,6,3,186016,186016,186019,0,3,0
53074,5,1,186021,186021,186022,0,1,2
53075,4,2,186025,186025,186027,0,2,3
53076,2,1,186027,186027,186028,0,1,0
53077,1,3,186028,186028,186031,0,3,0
53078,1,2,186029,186031,186033,2,4,0
53079,2,2,186031,186033,186035,2,4,0
53080,6,2,186037,186037,186039,0,2,2
53081,4,2,186041,186041,186043,0,2,2
53082,5,2,186046,186046,186048,0,2,3
53083,6,2,186052,186052,186054,0,2,4
53084,6,1,186058,186058,186059,0,1,4
53085,2,2,186060,186060,186062,0,2,1
53086,6,3,186066,186066,186069,0,3,4
53087,5,3,186071,186071,186074,0,3,2
53088,3,1,186074,186074,186075,0,1,0
53089,1,3,186075,186075,186078,0,3,0
53090,3,2,186078,186078,186080,0,2,0
53091,5,2,186083,186083,186085,0,2,3
53092,2,1,186085,186085,186086,0,1,0
53093,5,3,186090,186090,186093,0,3,4
53094,5,1,186095,186095,186096,0,1,2
53095,4,1,186099,186099,186100,0,1,3
53096,4,3,186103,186103,186106,0,3,3
53097,4,3,186107,186107,186110,0,3,1
53098,5,1,186112,186112,186113,0,1,2
53099,5,1,186117,186117,186118,0,1,4
53100,2,2,186119,186119,186121,0,2,1
53101,2,3,186121,186121,186124,0,3,0
53102,6,3,186127,186127,186130,0,3,3
53103,4,2,186131,186131,186133,0,2,1
53104,4,1,186135,186135,186136,0,1,2
53105,6,3,186141,186141,186144,0,3,5
53106,6,3,186147,186147,186150,0,3,3
53107,1,2,186148,186150,186152,2,4,0
53108,3,2,186151,186152,186154,1,3,0
53109,4,1,186155,186155,186156,0,1,1
53110,1,2,186156,186156,186158,0,2,0
53111,4,3,186160,186160,186163,0,3,2
53112,6,3,186166,186166,186169,0,3,3
53113,5,2,186171,186171,186173,0,2,2
53114,4,1,186175,186175,186176,0,1,2
53115,6,2,186181,186181,186183,0,2,5
53116,2,2,186183,186183,186185,0,2,0
53117,3,3,186186,186186,186189,0,3,1
53118,3,1,186189,186189,186190,0,1,0
53119,3,3,186192,186192,186195,0,3,2
53120,4,1,186196,186196,186197,0,1,1
53121,3,3,186199,186199,186202,0,3,2
53122,4,2,186203,186203,186205,0,2,1
53123,6,2,186209,186209,186211,0,2,4
53124,1,2,186210,186211,186213,1,3,0
53125,2,1,186212,186213,186214,1,2,0
53126,4,1,186216,186216,186217,0,1,2
53127,4,3,186220,186220,186223,0,3,3
53128,3,1,186223,186223,186224,0,1,0
53129,2,2,186225,186225,186227,0,2,1
53130,4,3,186229,186229,186232,0,3,2
53131,3,2,186232,186232,186234,0,2,0
53132,5,2,186237,186237,186239,0,2,3
53133,3,3,186240,186240,186243,0,3,1
53134,1,2,186241,186243,186245,2,4,0
53135,2,1,186243,186245,186246,2,3,0
53136,3,1,186246,186246,186247,0,1,0
53137,3,3,186249,186249,186252,0,3,2
53138,1,1,186250,186252,186253,2,3,0
53139,5,2,186255,186255,186257,0,2,2
53140,5,3,186260,186260,186263,0,3,3
53141,3,1,186263,186263,186264,0,1,0
53142,3,2,186266,186266,186268,0,2,2
53143,1,1,186267,186268,186269,1,2,0
53144,4,1,186271,186271,186272,0,1,2
53145,1,1,186272,186272,186273,0,1,0
53146,6,3,186278,186278,186281,0,3,5
53147,2,2,186280,186281,186283,1,3,0
53148,4,2,186284,186284,186286,0,2,1
53149,3,1,186287,186287,186288,0,1,1
53150,2,3,186289,186289,186292,0,3,1
53151,6,1,186295,186295,186296,0,1,3
53152,1,1,186296,186296,186297,0,1,0
53153,1,2,186297,186297,186299,0,2,0
53154,3,3,186300,186300,186303,0,3,1
53155,6,2,186306,186306,186308,0,2,3
53156,1,2,186307,186308,186310,1,3,0
53157,1,1,186308,186310,186311,2,3,0
53158,5,3,186313,186313,186316,0,3,2
53159,6,1,186319,186319,186320,0,1,3
53160,1,3,186320,186320,186323,0,3,0
53161,6,3,186326,186326,186329,0,3,3
53162,3,2,186329,186329,186331,0,2,0
53163,5,3,186334,186334,186337,0,3,3
53164,5,1,186339,186339,186340,0,1,2
53165,5,2,186344,186344,186346,0,2,4
53166,5,3,186349,186349,186352,0,3,3
53167,3,2,186352,186352,186354,0,2,0
53168,6,2,186358,186358,186360,0,2,4
53169,4,2,186362,186362,186364,0,2,2
53170,6,1,186368,186368,186369,0,1,4
53171,4,3,186372,186372,186375,0,3,3
53172,4,1,186376,186376,186377,0,1,1
53173,3,1,186379,186379,186380,0,1,2
53174,6,3,186385,186385,186388,0,3,5
53175,2,2,186387,186388,186390,1,3,0
53176,3,3,186390,186390,186393,0,3,0
53177,2,1,186392,186393,186394,1,2,0
53178,1,3,186393,186394,186397,1,4,0
53179,5,1,186398,186398,186399,0,1,1
53180,5,2,186403,186403,186405,0,2,4
53181,1,2,186404,186405,186407,1,3,0
53182,5,1,186409,186409,186410,0,1,2
53183,4,3,186413,186413,186416,0,3,3
53184,2,1,186415,186416,186417,1,2,0
53185,6,1,186421,186421,186422,0,1,4
53186,6,1,186427,186427,186428,0,1,5
53187,6,3,186433,186433,186436,0,3,5
53188,1,2,186434,186436,186438,2,4,0
53189,4,2,186438,186438,186440,0,2,0
53190,6,3,186444,186444,186447,0,3,4
53191,1,2,186445,186447,186449,2,4,0
53192,5,2,186450,186450,186452,0,2,1
53193,2,1,186452,186452,186453,0,1,0
53194,5,3,186457,186457,186460,0,3,4
53195,5,1,186462,186462,186463,0,1,2
53196,1,1,186463,186463,186464,0,1,0
53197,5,3,186468,186468,186471,0,3,4
53198,2,3,186470,186471,186474,1,4,0
53199,5,2,186475,186475,186477,0,2,1
53200,3,1,186478,186478,186479,0,1,1
53201,1,3,186479,186479,186482,0,3,0
53202,3,3,186482,186482,186485,0,3,0
53203,5,3,186487,186487,186490,0,3,2
53204,1,1,186488,186490,186491,2,3,0
53205,6,3,186494,186494,186497,0,3,3
53206,2,3,186496,186497,186500,1,4,0
53207,5,1,186501,186501,186502,0,1,1
53208,5,2,186506,186506,186508,0,2,4
53209,4,2,186510,186510,186512,0,2,2
53210,5,1,186515,186515,186516,0,1,3
53211,3,2,186518,186518,186520,0,2,2
53212,2,1,186520,186520,186521,0,1,0
53213,3,3,186523,186523,186526,0,3,2
53214,4,2,186527,186527,186529,0,2,1
53215,6,2,186533,186533,186535,0,2,4
53216,2,2,186535,186535,186537,0,2,0
53217,5,2,186540,186540,186542,0,2,3
53218,1,3,186541,186542,186545,1,4,0
53219,1,1,186542,186545,186546,3,4,0
53220,3,1,186545,186546,186547,1,2,0
53221,4,3,186549,186549,186552,0,3,2
53222,2,1,186551,186552,186553,1,2,0
53223,4,3,186555,186555,186558,0,3,2
53224,2,1,186557,186558,186559,1,2,0
53225,4,1,186561,186561,186562,0,1,2
53226,1,2,186562,186562,186564,0,2,0
53227,5,1,186567,186567,186568,0,1,3
53228,5,1,186572,186572,186573,0,1,4
53229,6,2,186578,186578,186580,0,2,5
53230,1,1,186579,186580,186581,1,2,0
53231,5,1,186584,186584,186585,0,1,3
53232,2,2,186586,186586,186588,0,2,1
53233,1,1,186587,186588,186589,1,2,0
53234,2,3,186589,186589,186592,0,3,0
53235,6,3,186595,186595,186598,0,3,3
53236,6,1,186601,186601,186602,0,1,3
53237,6,2,186607,186607,186609,0,2,5
53238,6,1,186613,186613,186614,0,1,4
53239,6,1,186619,186619,186620,0,1,5
53240,5,3,186624,186624,186627,0,3,4
53241,4,3,186628,186628,186631,0,3,1
53242,6,3,186634,186634,186637,0,3,3
53243,6,2,186640,186640,186642,0,2,3
53244,6,3,186646,186646,186649,0,3,4
53245,2,3,186648,186649,186652,1,4,0
53246,6,3,186654,186654,186657,0,3,2
53247,4,1,186658,186658,186659,0,1,1
53248,5,1,186663,186663,186664,0,1,4
53249,3,2,186666,186666,186668,0,2,2
53250,5,3,186671,186671,186674,0,3,3
53251,2,1,186673,186674,186675,1,2,0
53252,2,2,186675,186675,186677,0,2,0
53253,1,3,186676,186677,186680,1,4,0
53254,6,3,186682,186682,186685,0,3,2
53255,3,1,186685,186685,186686,0,1,0
53256,2,2,186687,186687,186689,0,2,1
53257,2,1,186689,186689,186690,0,1,0
53258,4,1,186693,186693,186694,0,1,3
53259,1,3,186694,186694,186697,0,3,0
53260,1,2,186695,186697,186699,2,4,0
53261,1,1,186696,186699,186700,3,4,0
53262,2,3,186698,186700,186703,2,5,0
53263,1,3,186699,186703,186706,4,7,0
53264,6,2,186705,186706,186708,1,3,0
53265,4,3,186709,186709,186712,0,3,1
53266,1,2,186710,186712,186714,2,4,0
53267,4,2,186714,186714,186716,0,2,0
53268,4,3,186718,186718,186721,0,3,2
53269,3,1,186721,186721,186722,0,1,0
53270,3,1,186724,186724,186725,0,1,2
53271,5,1,186729,186729,186730,0,1,4
53272,5,3,186734,186734,186737,0,3,4
53273,1,1,186735,186737,186738,2,3,0
53274,4,1,186739,186739,186740,0,1,1
53275,2,1,186741,186741,186742,0,1,1
53276,2,3,186743,186743,186746,0,3,1
53277,3,3,186746,186746,186749,0,3,0
53278,4,3,186750,186750,186753,0,3,1
53279,3,3,186753,186753,186756,0,3,0
53280,3,3,186756,186756,186759,0,3,0
53281,4,1,186760,186760,186761,0,1,1
53282,3,3,186763,186763,186766,0,3,2
53283,1,1,186764,186766,186767,2,3,0
53284,4,2,186768,186768,186770,0,2,1
53285,3,1,186771,186771,186772,0,1,1
53286,6,3,186777,186777,186780,0,3,5
53287,2,1,186779,186780,186781,1,2,0
53288,4,2,186783,186783,186785,0,2,2
53289,1,2,186784,186785,186787,1,3,0
53290,6,2,186790,186790,186792,0,2,3
53291,4,3,186794,186794,186797,0,3,2
53292,3,1,186797,186797,186798,0,1,0
53293,4,3,186801,186801,186804,0,3,3
53294,2,1,186803,186804,186805,1,2,0
53295,4,1,186807,186807,186808,0,1,2
53296,6,2,186813,186813,186815,0,2,5
53297,4,2,186817,186817,186819,0,2,2
53298,6,1,186823,186823,186824,0,1,4
53299,4,3,186827,186827,186830,0,3,3
53300,4,3,186831,186831,186834,0,3,1
53301,6,2,186837,186837,186839,0,2,3
53302,5,1,186842,186842,186843,0,1,3
53303,6,1,186848,186848,186849,0,1,5
53304,1,1,186849,186849,186850,0,1,0
53305,3,2,186852,186852,186854,0,2,2
53306,4,3,186856,186856,186859,0,3,2
53307,4,3,186860,186860,186863,0,3,1
53308,3,1,186863,186863,186864,0,1,0
53309,3,2,186866,186866,186868,0,2,2
53310,6,1,186872,186872,186873,0,1,4
53311,5,3,186877,186877,186880,0,3,4
53312,3,1,186880,186880,186881,0,1,0
53313,4,2,186884,186884,186886,0,2,3
53314,2,1,186886,186886,186887,0,1,0
53315,1,1,186887,186887,186888,0,1,0
53316,5,1,186892,186892,186893,0,1,4
53317,4,3,186896,186896,186899,0,3,3
53318,4,2,186900,186900,186902,0,2,1
53319,3,3,186903,186903,186906,0,3,1
53320,1,3,186904,186906,186909,2,5,0
53321,4,3,186908,186909,186912,1,4,0
53322,2,2,186910,186912,186914,2,4,0
53323,3,2,186913,186914,186916,1,3,0
53324,1,3,186914,186916,186919,2,5,0
53325,4,3,186918,186919,186922,1,4,0
53326,4,2,186922,186922,186924,0,2,0
53327,6,3,186928,186928,186931,0,3,4
53328,5,3,186933,186933,186936,0,3,2
53329,4,2,186937,186937,186939,0,2,1
53330,4,3,186941,186941,186944,0,3,2
53331,1,3,186942,186944,186947,2,5,0
53332,5,2,186947,186947,186949,0,2,0
53333,6,1,186953,186953,186954,0,1,4
53334,2,3,186955,186955,186958,0,3,1
53335,2,1,186957,186958,186959,1,2,0
53336,1,2,186958,186959,186961,1,3,0
53337,3,1,186961,186961,186962,0,1,0
53338,3,2,186964,186964,186966,0,2,2
53339,1,3,186965,186966,186969,1,4,0
53340,6,2,186971,186971,186973,0,2,2
53341,4,3,186975,186975,186978,0,3,2
53342,6,1,186981,186981,186982,0,1,3
53343,3,3,186984,186984,186987,0,3,2
53344,4,2,186988,186988,186990,0,2,1
53345,4,1,186992,186992,186993,0,1,2
53346,4,2,186996,186996,186998,0,2,3
53347,6,2,187002,187002,187004,0,2,4
53348,6,1,187008,187008,187009,0,1,4
53349,3,3,187011,187011,187014,0,3,2
53350,6,1,187017,187017,187018,0,1,3
53351,3,2,187020,187020,187022,0,2,2
53352,3,3,187023,187023,187026,0,3,1
53353,3,2,187026,187026,187028,0,2,0
53354,5,1,187031,187031,187032,0,1,3
53355,5,3,187036,187036,187039,0,3,4
53356,5,2,187041,187041,187043,0,2,2
53357,4,3,187045,187045,187048,0,3,2
53358,6,3,187051,187051,187054,0,3,3
53359,4,3,187055,187055,187058,0,3,1
53360,1,2,187056,187058,187060,2,4,0
53361,5,2,187061,187061,187063,0,2,1
53362,3,1,187064,187064,187065,0,1,1
53363,6,2,187070,187070,187072,0,2,5
53364,4,1,187074,187074,187075,0,1,2
53365,6,2,187080,187080,187082,0,2,5
53366,1,1,187081,187082,187083,1,2,0
53367,5,3,187086,187086,187089,0,3,3
53368,4,1,187090,187090,187091,0,1,1
53369,6,3,187096,187096,187099,0,3,5
53370,4,2,187100,187100,187102,0,2,1
53371,5,2,187105,187105,187107,0,2,3
53372,6,3,187111,187111,187114,0,3,4
53373,5,3,187116,187116,187119,0,3,2
53374,1,2,187117,187119,187121,2,4,0
53375,1,1,187118,187121,187122,3,4,0
53376,4,2,187122,187122,187124,0,2,0
53377,3,2,187125,187125,187127,0,2,1
53378,2,2,187127,187127,187129,0,2,0
53379,1,2,187128,187129,187131,1,3,0
53380,2,3,187130,187131,187134,1,4,0
53381,3,2,187133,187134,187136,1,3,0
53382,4,2,187137,187137,187139,0,2,1
53383,6,2,187143,187143,187145,0,2,4
53384,4,3,187147,187147,187150,0,3,2
53385,2,3,187149,187150,187153,1,4,0
53386,3,1,187152,187153,187154,1,2,0
53387,4,1,187156,187156,187157,0,1,2
53388,2,2,187158,187158,187160,0,2,1
53389,3,2,187161,187161,187163,0,2,1
53390,1,3,187162,187163,187166,1,4,0
53391,5,2,187167,187167,187169,0,2,1
53392,6,1,187173,187173,187174,0,1,4
53393,4,2,187177,187177,187179,0,2,3
53394,6,2,187183,187183,187185,0,2,4
53395,2,3,187185,187185,187188,0,3,0
53396,1,2,187186,187188,187190,2,4,0
53397,5,1,187191,187191,187192,0,1,1
53398,1,2,187192,187192,187194,0,2,0
53399,2,3,187194,187194,187197,0,3,0
53400,6,1,187200,187200,187201,0,1,3
53401,6,2,187206,187206,187208,0,2,5
53402,3,2,187209,187209,187211,0,2,1
53403,5,3,187214,187214,187217,0,3,3
53404,6,3,187220,187220,187223,0,3,3
53405,3,1,187223,187223,187224,0,1,0
53406,3,1,187226,187226,187227,0,1,2
53407,3,1,187229,187229,187230,0,1,2
53408,5,3,187234,187234,187237,0,3,4
53409,4,3,187238,187238,187241,0,3,1
53410,2,1,187240,187241,187242,1,2,0
53411,5,2,187245,187245,187247,0,2,3
53412,4,1,187249,187249,187250,0,1,2
53413,1,3,187250,187250,187253,0,3,0
53414,4,2,187254,187254,187256,0,2,1
53415,4,2,187258,187258,187260,0,2,2
53416,1,3,187259,187260,187263,1,4,0
53417,2,2,187261,187263,187265,2,4,0
53418,2,3,187263,187265,187268,2,5,0
53419,2,3,187265,187268,187271,3,6,0
53420,5,3,187270,187271,187274,1,4,0
53421,4,1,187274,187274,187275,0,1,0
53422,6,1,187280,187280,187281,0,1,5
53423,1,1,187281,187281,187282,0,1,0
53424,4,2,187285,187285,187287,0,2,3
53425,3,3,187288,187288,187291,0,3,1
53426,6,3,187294,187294,187297,0,3,3
53427,6,2,187300,187300,187302,0,2,3
53428,3,2,187303,187303,187305,0,2,1
53429,4,3,187307,187307,187310,0,3,2
53430,2,2,187309,187310,187312,1,3,0
53431,1,2,187310,187312,187314,2,4,0
53432,5,2,187315,187315,187317,0,2,1
53433,2,2,187317,187317,187319,0,2,0
53434,2,2,187319,187319,187321,0,2,0
53435,3,1,187322,187322,187323,0,1,1
53436,6,2,187328,187328,187330,0,2,5
53437,6,2,187334,187334,187336,0,2,4
53438,4,2,187338,187338,187340,0,2,2
53439,3,1,187341,187341,187342,0,1,1
53440,6,1,187347,187347,187348,0,1,5
53441,2,1,187349,187349,187350,0,1,1
53442,4,2,187353,187353,187355,0,2,3
53443,2,3,187355,187355,187358,0,3,0
53444,3,3,187358,187358,187361,0,3,0
53445,4,1,187362,187362,187363,0,1,1
53446,1,3,187363,187363,187366,0,3,0
53447,6,2,187369,187369,187371,0,2,3
53448,2,2,187371,187371,187373,0,2,0
53449,5,1,187376,187376,187377,0,1,3
53450,1,1,187377,187377,187378,0,1,0
53451,5,3,187382,187382,187385,0,3,4
53452,4,2,187386,187386,187388,0,2,1
53453,5,2,187391,187391,187393,0,2,3
53454,2,3,187393,187393,187396,0,3,0
53455,2,3,187395,187396,187399,1,4,0
53456,1,3,187396,187399,187402,3,6,0
53457,2,1,187398,187402,187403,4,5,0
53458,6,3,187404,187404,187407,0,3,1
53459,6,2,187410,187410,187412,0,2,3
53460,2,1,187412,187412,187413,0,1,0
53461,6,1,187418,187418,187419,0,1,5
53462,1,1,187419,187419,187420,0,1,0
53463,1,2,187420,187420,187422,0,2,0
53464,5,2,187425,187425,187427,0,2,3
53465,3,1,187428,187428,187429,0,1,1
53466,3,2,187431,187431,187433,0,2,2
53467,5,2,187436,187436,187438,0,2,3
53468,5,3,187441,187441,187444,0,3,3
53469,1,2,187442,187444,187446,2,4,0
53470,5,2,187447,187447,187449,0,2,1
53471,2,2,187449,187449,187451,0,2,0
53472,1,3,187450,187451,187454,1,4,0
53473,6,2,187456,187456,187458,0,2,2
53474,1,1,187457,187458,187459,1,2,0
53475,2,1,187459,187459,187460,0,1,0
53476,4,3,187463,187463,187466,0,3,3
53477,5,1,187468,187468,187469,0,1,2
53478,3,3,187471,187471,187474,0,3,2
53479,1,1,187472,187474,187475,2,3,0
53480,3,2,187475,187475,187477,0,2,0
53481,5,1,187480,187480,187481,0,1,3
53482,1,1,187481,187481,187482,0,1,0
53483,1,2,187482,187482,187484,0,2,0
53484,3,3,187485,187485,187488,0,3,1
53485,5,2,187490,187490,187492,0,2,2
53486,6,1,187496,187496,187497,0,1,4
53487,6,2,187502,187502,187504,0,2,5
53488,3,1,187505,187505,187506,0,1,1
53489,3,3,187508,187508,187511,0,3,2
53490,6,2,187514,187514,187516,0,2,3
53491,4,1,187518,187518,187519,0,1,2
53492,3,3,187521,187521,187524,0,3,2
53493,6,1,187527,187527,187528,0,1,3
53494,3,1,187530,187530,187531,0,1,2
53495,6,1,187536,187536,187537,0,1,5
53496,6,3,187542,187542,187545,0,3,5
53497,5,3,187547,187547,187550,0,3,2
53498,5,3,187552,187552,187555,0,3,2
53499,3,2,187555,187555,187557,0,2,0
53500,2,2,187557,187557,187559,0,2,0
53501,2,2,187559,187559,187561,0,2,0
53502,5,3,187564,187564,187567,0,3,3
53503,5,3,187569,187569,187572,0,3,2
53504,3,2,187572,187572,187574,0,2,0
53505,1,3,187573,187574,187577,1,4,0
53506,3,1,187576,187577,187578,1,2,0
53507,3,2,187579,187579,187581,0,2,1
53508,3,3,187582,187582,187585,0,3,1
53509,3,3,187585,187585,187588,0,3,0
53510,1,2,187586,187588,187590,2,4,0
53511,5,1,187591,187591,187592,0,1,1
53512,1,3,187592,187592,187595,0,3,0
53513,2,3,187594,187595,187598,1,4,0
53514,6,2,187600,187600,187602,0,2,2
53515,5,1,187605,187605,187606,0,1,3
53516,1,3,187606,187606,187609,0,3,0
53517,5,1,187611,187611,187612,0,1,2
53518,2,1,187613,187613,187614,0,1,1
53519,5,3,187618,187618,187621,0,3,4
53520,2,3,187620,187621,187624,1,4,0
53521,2,1,187622,187624,187625,2,3,0
53522,5,3,187627,187627,187630,0,3,2
53523,2,1,187629,187630,187631,1,2,0
53524,6,2,187635,187635,187637,0,2,4
53525,5,2,187640,187640,187642,0,2,3
53526,6,2,187646,187646,187648,0,2,4
53527,5,1,187651,187651,187652,0,1,3
53528,3,1,187654,187654,187655,0,1,2
53529,4,1,187658,187658,187659,0,1,3
53530,3,2,187661,187661,187663,0,2,2
53531,2,2,187663,187663,187665,0,2,0
53532,2,1,187665,187665,187666,0,1,0
53533,5,3,187670,187670,187673,0,3,4
53534,4,3,187674,187674,187677,0,3,1
53535,3,1,187677,187677,187678,0,1,0
53536,1,1,187678,187678,187679,0,1,0
53537,3,1,187681,187681,187682,0,1,2
53538,5,2,187686,187686,187688,0,2,4
53539,3,2,187689,187689,187691,0,2,1
53540,2,1,187691,187691,187692,0,1,0
53541,5,3,187696,187696,187699,0,3,4
53542,2,1,187698,187699,187700,1,2,0
53543,5,2,187703,187703,187705,0,2,3
53544,2,1,187705,187705,187706,0,1,0
53545,3,2,187708,187708,187710,0,2,2
53546,2,3,187710,187710,187713,0,3,0
53547,6,1,187716,187716,187717,0,1,3
53548,6,2,187722,187722,187724,0,2,5
53549,5,2,187727,187727,187729,0,2,3
53550,1,2,187728,187729,187731,1,3,0
53551,6,3,187734,187734,187737,0,3,3
53552,1,3,187735,187737,187740,2,5,0
53553,6,3,187741,187741,187744,0,3,1
53554,5,2,187746,187746,187748,0,2,2
53555,2,3,187748,187748,187751,0,3,0
53556,6,3,187754,187754,187757,0,3,3
53557,2,2,187756,187757,187759,1,3,0
53558,5,1,187761,187761,187762,0,1,2
53559,1,3,187762,187762,187765,0,3,0
53560,5,3,187767,187767,187770,0,3,2
53561,6,1,187773,187773,187774,0,1,3
53562,6,2,187779,187779,187781,0,2,5
53563,2,3,187781,187781,187784,0,3,0
53564,2,3,187783,187784,187787,1,4,0
53565,4,1,187787,187787,187788,0,1,0
53566,2,1,187789,187789,187790,0,1,1
53567,4,1,187793,187793,187794,0,1,3
53568,5,1,187798,187798,187799,0,1,4
53569,2,1,187800,187800,187801,0,1,1
53570,3,1,187803,187803,187804,0,1,2
53571,5,2,187808,187808,187810,0,2,4
53572,2,2,187810,187810,187812,0,2,0
53573,4,3,187814,187814,187817,0,3,2
53574,6,3,187820,187820,187823,0,3,3
53575,1,1,187821,187823,187824,2,3,0
53576,4,2,187825,187825,187827,0,2,1
53577,5,1,187830,187830,187831,0,1,3
53578,1,2,187831,187831,187833,0,2,0
53579,6,1,187837,187837,187838,0,1,4
53580,2,1,187839,187839,187840,0,1,1
53581,1,1,187840,187840,187841,0,1,0
53582,4,3,187844,187844,187847,0,3,3
53583,3,3,187847,187847,187850,0,3,0
53584,6,3,187853,187853,187856,0,3,3
53585,3,2,187856,187856,187858,0,2,0
53586,3,2,187859,187859,187861,0,2,1
53587,2,1,187861,187861,187862,0,1,0
53588,1,1,187862,187862,187863,0,1,0
53589,5,1,187867,187867,187868,0,1,4
53590,4,3,187871,187871,187874,0,3,3
53591,6,2,187877,187877,187879,0,2,3
53592,6,1,187883,187883,187884,0,1,4
53593,1,2,187884,187884,187886,0,2,0
53594,2,1,187886,187886,187887,0,1,0
53595,3,1,187889,187889,187890,0,1,2
53596,3,1,187892,187892,187893,0,1,2
53597,4,1,187896,187896,187897,0,1,3
53598,4,3,187900,187900,187903,0,3,3
53599,5,2,187905,187905,187907,0,2,2
53600,1,1,187906,187907,187908,1,2,0
53601,2,3,187908,187908,187911,0,3,0
53602,1,3,187909,187911,187914,2,5,0
53603,4,2,187913,187914,187916,1,3,0
53604,3,2,187916,187916,187918,0,2,0
53605,4,1,187920,187920,187921,0,1,2
53606,6,1,187926,187926,187927,0,1,5
53607,6,2,187932,187932,187934,0,2,5
53608,2,3,187934,187934,187937,0,3,0
53609,3,3,187937,187937,187940,0,3,0
53610,3,2,187940,187940,187942,0,2,0
53611,1,3,187941,187942,187945,1,4,0
53612,3,3,187944,187945,187948,1,4,0
53613,4,1,187948,187948,187949,0,1,0
53614,5,1,187953,187953,187954,0,1,4
53615,6,2,187959,187959,187961,0,2,5
53616,2,3,187961,187961,187964,0,3,0
53617,2,3,187963,187964,187967,1,4,0
53618,6,1,187969,187969,187970,0,1,2
53619,2,3,187971,187971,187974,0,3,1
53620,3,3,187974,187974,187977,0,3,0
53621,3,1,187977,187977,187978,0,1,0
53622,6,1,187983,187983,187984,0,1,5
53623,6,2,187989,187989,187991,0,2,5
53624,4,1,187993,187993,187994,0,1,2
53625,6,1,187999,187999,188000,0,1,5
53626,4,1,188003,188003,188004,0,1,3
53627,2,2,188005,188005,188007,0,2,1
53628,6,1,188011,188011,188012,0,1,4
53629,3,3,188014,188014,188017,0,3,2
53630,5,1,188019,188019,188020,0,1,2
53631,3,3,188022,188022,188025,0,3,2
53632,4,3,188026,188026,188029,0,3,1
53633,1,1,188027,188029,188030,2,3,0
53634,1,2,188028,188030,188032,2,4,0
53635,1,1,188029,188032,188033,3,4,0
53636,4,2,188033,188033,188035,0,2,0
53637,5,2,188038,188038,188040,0,2,3
53638,5,3,188043,188043,188046,0,3,3
53639,1,2,188044,188046,188048,2,4,0
53640,4,1,188048,188048,188049,0,1,0
53641,4,2,188052,188052,188054,0,2,3
53642,5,1,188057,188057,188058,0,1,3
53643,6,3,188063,188063,188066,0,3,5
53644,1,3,188064,188066,188069,2,5,0
53645,3,2,188067,188069,188071,2,4,0
53646,6,3,188073,188073,188076,0,3,2
53647,6,1,188079,188079,188080,0,1,3
53648,6,3,188085,188085,188088,0,3,5
53649,4,1,188089,188089,188090,0,1,1
53650,5,1,188094,188094,188095,0,1,4
53651,6,1,188100,188100,188101,0,1,5
53652,5,3,188105,188105,188108,0,3,4
53653,1,1,188106,188108,188109,2,3,0
53654,6,2,188112,188112,188114,0,2,3
53655,3,2,188115,188115,188117,0,2,1
53656,5,2,188120,188120,188122,0,2,3
53657,1,3,188121,188122,188125,1,4,0
53658,1,1,188122,188125,188126,3,4,0
53659,1,2,188123,188126,188128,3,5,0
53660,6,2,188129,188129,188131,0,2,1
53661,2,2,188131,188131,188133,0,2,0
53662,6,2,188137,188137,188139,0,2,4
53663,1,1,188138,188139,188140,1,2,0
53664,6,1,188144,188144,188145,0,1,4
53665,4,3,188148,188148,188151,0,3,3
53666,4,1,188152,188152,188153,0,1,1
53667,5,1,188157,188157,188158,0,1,4
53668,6,3,188163,188163,188166,0,3,5
53669,2,3,188165,188166,188169,1,4,0
53670,5,3,188170,188170,188173,0,3,1
53671,5,3,188175,188175,188178,0,3,2
53672,5,3,188180,188180,188183,0,3,2
53673,5,1,188185,188185,188186,0,1,2
53674,6,2,188191,188191,188193,0,2,5
53675,5,3,188196,188196,188199,0,3,3
53676,6,2,188202,188202,188204,0,2,3
53677,6,1,188208,188208,188209,0,1,4
53678,2,1,188210,188210,188211,0,1,1
53679,4,1,188214,188214,188215,0,1,3
53680,5,1,188219,188219,188220,0,1,4
53681,3,2,188222,188222,188224,0,2,2
53682,3,3,188225,188225,188228,0,3,1
53683,5,1,188230,188230,188231,0,1,2
53684,1,3,188231,188231,188234,0,3,0
53685,4,3,188235,188235,188238,0,3,1
53686,6,2,188241,188241,188243,0,2,3
53687,4,1,188245,188245,188246,0,1,2
53688,3,3,188248,188248,188251,0,3,2
53689,6,3,188254,188254,188257,0,3,3
53690,2,2,188256,188257,188259,1,3,0
53691,6,3,188262,188262,188265,0,3,3
53692,4,1,188266,188266,188267,0,1,1
53693,1,2,188267,188267,188269,0,2,0
53694,4,2,188271,188271,188273,0,2,2
53695,3,3,188274,188274,188277,0,3,1
53696,5,1,188279,188279,188280,0,1,2
53697,3,1,188282,188282,188283,0,1,2
53698,5,2,188287,188287,188289,0,2,4
53699,5,1,188292,188292,188293,0,1,3
53700,2,3,188294,188294,188297,0,3,1
53701,1,2,188295,188297,188299,2,4,0
53702,6,2,188301,188301,188303,0,2,2
53703,4,3,188305,188305,188308,0,3,2
53704,2,3,188307,188308,188311,1,4,0
53705,4,3,188311,188311,188314,0,3,0
53706,2,2,188313,188314,188316,1,3,0
53707,6,2,188319,188319,188321,0,2,3
53708,4,2,188323,188323,188325,0,2,2
53709,6,2,188329,188329,188331,0,2,4
53710,1,2,188330,188331,188333,1,3,0
53711,4,2,188334,188334,188336,0,2,1
53712,4,1,188338,188338,188339,0,1,2
53713,1,3,188339,188339,188342,0,3,0
53714,6,3,188345,188345,188348,0,3,3
53715,3,2,188348,188348,188350,0,2,0
53716,4,1,188352,188352,188353,0,1,2
53717,3,1,188355,188355,188356,0,1,2
53718,5,1,188360,188360,188361,0,1,4
53719,3,1,188363,188363,188364,0,1,2
53720,1,2,188364,188364,188366,0,2,0
53721,4,1,188368,188368,188369,0,1,2
53722,2,1,188370,188370,188371,0,1,1
53723,6,3,188376,188376,188379,0,3,5
53724,2,1,188378,188379,188380,1,2,0
53725,6,1,188384,188384,188385,0,1,4
53726,2,2,188386,188386,188388,0,2,1
53727,4,1,188390,188390,188391,0,1,2
53728,4,1,188394,188394,188395,0,1,3
53729,2,1,188396,188396,188397,0,1,1
53730,1,3,188397,188397,188400,0,3,0
53731,5,2,188402,188402,188404,0,2,2
53732,5,2,188407,188407,188409,0,2,3
53733,1,3,188408,188409,188412,1,4,0
53734,5,1,188413,188413,188414,0,1,1
53735,2,2,188415,188415,188417,0,2,1
53736,1,1,188416,188417,188418,1,2,0
53737,5,2,188421,188421,188423,0,2,3
53738,4,2,188425,188425,188427,0,2,2
53739,2,1,188427,188427,188428,0,1,0
53740,6,3,188433,188433,188436,0,3,5
53741,3,2,188436,188436,188438,0,2,0
53742,5,1,188441,188441,188442,0,1,3
53743,3,3,188444,188444,188447,0,3,2
53744,3,1,188447,188447,188448,0,1,0
53745,1,1,188448,188448,188449,0,1,0
53746,2,3,188450,188450,188453,0,3,1
53747,6,2,188456,188456,188458,0,2,3
53748,2,2,188458,188458,188460,0,2,0
53749,1,1,188459,188460,188461,1,2,0
53750,6,1,188465,188465,188466,0,1,4
53751,3,3,188468,188468,188471,0,3,2
53752,5,2,188473,188473,188475,0,2,2
53753,6,2,188479,188479,188481,0,2,4
53754,3,1,188482,188482,188483,0,1,1
53755,6,3,188488,188488,188491,0,3,5
53756,3,1,188491,188491,188492,0,1,0
53757,5,1,188496,188496,188497,0,1,4
53758,4,1,188500,188500,188501,0,1,3
53759,4,2,188504,188504,188506,0,2,3
53760,2,2,188506,188506,188508,0,2,0
53761,6,2,188512,188512,188514,0,2,4
53762,2,3,188514,188514,188517,0,3,0
53763,2,1,188516,188517,188518,1,2,0
53764,1,1,188517,188518,188519,1,2,0
53765,3,2,188520,188520,188522,0,2,1
53766,2,3,188522,188522,188525,0,3,0
53767,6,1,188528,188528,188529,0,1,3
53768,3,1,188531,188531,188532,0,1,2
53769,4,3,188535,188535,188538,0,3,3
53770,3,2,188538,188538,188540,0,2,0
53771,2,1,188540,188540,188541,0,1,0
53772,5,1,188545,188545,188546,0,1,4
53773,4,2,188549,188549,188551,0,2,3
53774,5,1,188554,188554,188555,0,1,3
53775,1,2,188555,188555,188557,0,2,0
53776,6,3,188561,188561,188564,0,3,4
53777,2,2,188563,188564,188566,1,3,0
53778,1,3,188564,188566,188569,2,5,0
53779,5,3,188569,188569,188572,0,3,0
53780,5,1,188574,188574,188575,0,1,2
53781,2,1,188576,188576,188577,0,1,1
53782,5,3,188581,188581,188584,0,3,4
53783,4,3,188585,188585,188588,0,3,1
53784,5,1,188590,188590,188591,0,1,2
53785,6,2,188596,188596,188598,0,2,5
53786,1,2,188597,188598,188600,1,3,0
53787,5,2,188602,188602,188604,0,2,2
53788,3,2,188605,188605,188607,0,2,1
53789,5,2,188610,188610,188612,0,2,3
53790,5,2,188615,188615,188617,0,2,3
53791,2,3,188617,188617,188620,0,3,0
53792,1,1,188618,188620,188621,2,3,0
53793,1,1,188619,188621,188622,2,3,0
53794,5,3,188624,188624,188627,0,3,2
53795,2,3,188626,188627,188630,1,4,0
53796,5,1,188631,188631,188632,0,1,1
53797,3,2,188634,188634,188636,0,2,2
53798,1,3,188635,188636,188639,1,4,0
53799,6,1,188641,188641,188642,0,1,2
53800,6,3,188647,188647,188650,0,3,5
53801,5,2,188652,188652,188654,0,2,2
53802,5,3,188657,188657,188660,0,3,3
53803,4,2,188661,188661,188663,0,2,1
53804,5,3,188666,188666,188669,0,3,3
53805,4,2,188670,188670,188672,0,2,1
53806,3,2,188673,188673,188675,0,2,1
53807,5,1,188678,188678,188679,0,1,3
53808,1,2,188679,188679,188681,0,2,0
53809,4,2,188683,188683,188685,0,2,2
53810,4,3,188687,188687,188690,0,3,2
53811,1,3,188688,188690,188693,2,5,0
53812,3,3,188691,188693,188696,2,5,0
53813,4,1,188695,188696,188697,1,2,0
53814,3,1,188698,188698,188699,0,1,1
53815,2,3,188700,188700,188703,0,3,1
53816,2,1,188702,188703,188704,1,2,0
53817,2,1,188704,188704,188705,0,1,0
53818,4,1,188708,188708,188709,0,1,3
53819,1,1,188709,188709,188710,0,1,0
53820,2,1,188711,188711,188712,0,1,1
53821,3,2,188714,188714,188716,0,2,2
53822,4,3,188718,188718,188721,0,3,2
53823,1,2,188719,188721,188723,2,4,0
53824,5,3,188724,188724,188727,0,3,1
53825,6,1,188730,188730,188731,0,1,3
53826,1,3,188731,188731,188734,0,3,0
53827,5,3,188736,188736,188739,0,3,2
53828,4,3,188740,188740,188743,0,3,1
53829,5,1,188745,188745,188746,0,1,2
53830,1,2,188746,188746,188748,0,2,0
53831,5,3,188751,188751,188754,0,3,3
53832,3,1,188754,188754,188755,0,1,0
53833,2,3,188756,188756,188759,0,3,1
53834,5,3,188761,188761,188764,0,3,2
53835,1,1,188762,188764,188765,2,3,0
53836,2,3,188764,188765,188768,1,4,0
53837,1,3,188765,188768,188771,3,6,0
53838,4,3,188769,188771,188774,2,5,0
53839,1,3,188770,188774,188777,4,7,0
53840,3,3,188773,188777,188780,4,7,0
53841,3,1,188776,188780,188781,4,5,0
53842,6,3,188782,188782,188785,0,3,1
53843,6,2,188788,188788,188790,0,2,3
53844,3,2,188791,188791,188793,0,2,1
53845,4,2,188795,188795,188797,0,2,2
53846,2,2,188797,188797,188799,0,2,0
53847,4,3,188801,188801,188804,0,3,2
53848,2,3,188803,188804,188807,1,4,0
53849,4,3,188807,188807,188810,0,3,0
53850,2,2,188809,188810,188812,1,3,0
53851,4,1,188813,188813,188814,0,1,1
53852,6,2,188819,188819,188821,0,2,5
53853,6,1,188825,188825,188826,0,1,4
53854,6,2,188831,188831,188833,0,2,5
53855,1,3,188832,188833,188836,1,4,0
53856,1,2,188833,188836,188838,3,5,0
53857,6,3,188839,188839,188842,0,3,1
53858,2,2,188841,188842,188844,1,3,0
53859,3,3,188844,188844,188847,0,3,0
53860,4,3,188848,188848,188851,0,3,1
53861,1,3,188849,188851,188854,2,5,0
53862,6,1,188855,188855,188856,0,1,1
53863,6,2,188861,188861,188863,0,2,5
53864,3,3,188864,188864,188867,0,3,1
53865,4,3,188868,188868,188871,0,3,1
53866,6,1,188874,188874,188875,0,1,3
53867,6,3,188880,188880,188883,0,3,5
53868,2,2,188882,188883,188885,1,3,0
53869,2,1,188884,188885,188886,1,2,0
53870,4,1,188888,188888,188889,0,1,2
53871,6,1,188894,188894,188895,0,1,5
53872,3,2,188897,188897,188899,0,2,2
53873,2,2,188899,188899,188901,0,2,0
53874,3,1,188902,188902,188903,0,1,1
53875,6,1,188908,188908,188909,0,1,5
53876,3,3,188911,188911,188914,0,3,2
53877,1,3,188912,188914,188917,2,5,0
53878,2,1,188914,188917,188918,3,4,0
53879,4,1,188918,188918,188919,0,1,0
53880,5,2,188923,188923,188925,0,2,4
53881,6,3,188929,188929,188932,0,3,4
53882,1,3,188930,188932,188935,2,5,0
53883,5,2,188935,188935,188937,0,2,0
53884,3,1,188938,188938,188939,0,1,1
53885,6,3,188944,188944,188947,0,3,5
53886,2,2,188946,188947,188949,1,3,0
53887,3,1,188949,188949,188950,0,1,0
53888,6,1,188955,188955,188956,0,1,5
53889,3,2,188958,188958,188960,0,2,2
53890,5,2,188963,188963,188965,0,2,3
53891,5,1,188968,188968,188969,0,1,3
53892,5,2,188973,188973,188975,0,2,4
53893,1,2,188974,188975,188977,1,3,0
53894,4,2,188978,188978,188980,0,2,1
53895,6,3,188984,188984,188987,0,3,4
53896,4,2,188988,188988,188990,0,2,1
53897,4,3,188992,188992,188995,0,3,2
53898,5,1,188997,188997,188998,0,1,2
53899,2,1,188999,188999,189000,0,1,1
53900,2,3,189001,189001,189004,0,3,1
53901,6,3,189007,189007,189010,0,3,3
53902,1,3,189008,189010,189013,2,5,0
53903,5,2,189013,189013,189015,0,2,0
53904,4,1,189017,189017,189018,0,1,2
53905,4,1,189021,189021,189022,0,1,3
53906,2,2,189023,189023,189025,0,2,1
53907,5,1,189028,189028,189029,0,1,3
53908,1,1,189029,189029,189030,0,1,0
53909,2,3,189031,189031,189034,0,3,1
53910,4,2,189035,189035,189037,0,2,1
53911,2,3,189037,189037,189040,0,3,0
53912,4,3,189041,189041,189044,0,3,1
53913,6,2,189047,189047,189049,0,2,3
53914,5,3,189052,189052,189055,0,3,3
53915,5,1,189057,189057,189058,0,1,2
53916,3,3,189060,189060,189063,0,3,2
53917,1,2,189061,189063,189065,2,4,0
53918,4,3,189065,189065,189068,0,3,0
53919,3,1,189068,189068,189069,0,1,0
53920,4,1,189072,189072,189073,0,1,3
53921,5,3,189077,189077,189080,0,3,4
53922,1,2,189078,189080,189082,2,4,0
53923,3,3,189081,189082,189085,1,4,0
53924,5,1,189086,189086,189087,0,1,1
53925,6,2,189092,189092,189094,0,2,5
53926,1,2,189093,189094,189096,1,3,0
53927,5,3,189098,189098,189101,0,3,2
53928,3,1,189101,189101,189102,0,1,0
53929,6,2,189107,189107,189109,0,2,5
53930,1,3,189108,189109,189112,1,4,0
53931,1,3,189109,189112,189115,3,6,0
53932,1,3,189110,189115,189118,5,8,0
53933,5,3,189115,189118,189121,3,6,0
53934,1,2,189116,189121,189123,5,7,0
53935,1,3,189117,189123,189126,6,9,0
53936,5,1,189122,189126,189127,4,5,0
53937,5,1,189127,189127,189128,0,1,0
53938,2,1,189129,189129,189130,0,1,1
53939,2,3,189131,189131,189134,0,3,1
53940,2,1,189133,189134,189135,1,2,0
53941,3,1,189136,189136,189137,0,1,1
53942,3,1,189139,189139,189140,0,1,2
53943,4,3,189143,189143,189146,0,3,3
53944,5,1,189148,189148,189149,0,1,2
53945,5,2,189153,189153,189155,0,2,4
53946,4,1,189157,189157,189158,0,1,2
53947,5,2,189162,189162,189164,0,2,4
53948,5,3,189167,189167,189170,0,3,3
53949,2,3,189169,189170,189173,1,4,0
53950,6,3,189175,189175,189178,0,3,2
53951,5,1,189180,189180,189181,0,1,2
53952,3,3,189183,189183,189186,0,3,2
53953,4,3,189187,189187,189190,0,3,1
53954,2,1,189189,189190,189191,1,2,0
53955,5,1,189194,189194,189195,0,1,3
53956,3,3,189197,189197,189200,0,3,2
53957,4,2,189201,189201,189203,0,2,1
53958,6,1,189207,189207,189208,0,1,4
53959,1,2,189208,189208,189210,0,2,0
53960,3,1,189211,189211,189212,0,1,1
53961,6,3,189217,189217,189220,0,3,5
53962,3,1,189220,189220,189221,0,1,0
53963,5,2,189225,189225,189227,0,2,4
53964,3,3,189228,189228,189231,0,3,1
53965,5,1,189233,189233,189234,0,1,2
53966,6,1,189239,189239,189240,0,1,5
53967,4,1,189243,189243,189244,0,1,3
53968,6,3,189249,189249,189252,0,3,5
53969,1,3,189250,189252,189255,2,5,0
53970,4,3,189254,189255,189258,1,4,0
53971,5,1,189259,189259,189260,0,1,1
53972,2,3,189261,189261,189264,0,3,1
53973,2,1,189263,189264,189265,1,2,0
53974,5,1,189268,189268,189269,0,1,3
53975,6,3,189274,189274,189277,0,3,5
53976,5,2,189279,189279,189281,0,2,2
53977,6,3,189285,189285,189288,0,3,4
53978,6,3,189291,189291,189294,0,3,3
53979,3,2,189294,189294,189296,0,2,0
53980,5,3,189299,189299,189302,0,3,3
53981,4,2,189303,189303,189305,0,2,1
53982,5,1,189308,189308,189309,0,1,3
53983,1,3,189309,189309,189312,0,3,0
53984,6,2,189315,189315,189317,0,2,3
53985,6,2,189321,189321,189323,0,2,4
53986,3,2,189324,189324,189326,0,2,1
53987,6,1,189330,189330,189331,0,1,4
53988,2,1,189332,189332,189333,0,1,1
53989,5,3,189337,189337,189340,0,3,4
53990,6,2,189343,189343,189345,0,2,3
53991,2,2,189345,189345,189347,0,2,0
53992,6,2,189351,189351,189353,0,2,4
53993,6,2,189357,189357,189359,0,2,4
53994,6,2,189363,189363,189365,0,2,4
53995,1,1,189364,189365,189366,1,2,0
53996,4,3,189368,189368,189371,0,3,2
53997,6,3,189374,189374,189377,0,3,3
53998,6,3,189380,189380,189383,0,3,3
53999,5,1,189385,189385,189386,0,1,2
54000,6,2,189391,189391,189393,0,2,5
54001,3,3,189394,189394,189397,0,3,1
54002,3,1,189397,189397,189398,0,1,0
54003,2,1,189399,189399,189400,0,1,1
54004,2,3,189401,189401,189404,0,3,1
54005,4,2,189405,189405,189407,0,2,1
54006,3,1,189408,189408,189409,0,1,1
54007,4,1,189412,189412,189413,0,1,3
54008,1,1,189413,189413,189414,0,1,0
54009,3,1,189416,189416,189417,0,1,2
54010,5,1,189421,189421,189422,0,1,4
54011,3,1,189424,189424,189425,0,1,2
54012,1,1,189425,189425,189426,0,1,0
54013,2,2,189427,189427,189429,0,2,1
54014,2,2,189429,189429,189431,0,2,0
54015,1,3,189430,189431,189434,1,4,0
54016,6,3,189436,189436,189439,0,3,2
54017,6,1,189442,189442,189443,0,1,3
54018,6,3,189448,189448,189451,0,3,5
54019,1,1,189449,189451,189452,2,3,0
54020,2,2,189451,189452,189454,1,3,0
54021,5,2,189456,189456,189458,0,2,2
54022,3,1,189459,189459,189460,0,1,1
54023,3,3,189462,189462,189465,0,3,2
54024,4,2,189466,189466,189468,0,2,1
54025,3,3,189469,189469,189472,0,3,1
54026,6,3,189475,189475,189478,0,3,3
54027,1,3,189476,189478,189481,2,5,0
54028,2,1,189478,189481,189482,3,4,0
54029,4,3,189482,189482,189485,0,3,0
54030,6,3,189488,189488,189491,0,3,3
54031,5,3,189493,189493,189496,0,3,2
54032,1,2,189494,189496,189498,2,4,0
54033,1,2,189495,189498,189500,3,5,0
54034,1,3,189496,189500,189503,4,7,0
54035,6,2,189502,189503,189505,1,3,0
54036,3,1,189505,189505,189506,0,1,0
54037,4,1,189509,189509,189510,0,1,3
54038,2,1,189511,189511,189512,0,1,1
54039,1,3,189512,189512,189515,0,3,0
54040,1,2,189513,189515,189517,2,4,0
54041,6,3,189519,189519,189522,0,3,2
54042,6,1,189525,189525,189526,0,1,3
54043,4,2,189529,189529,189531,0,2,3
54044,4,1,189533,189533,189534,0,1,2
54045,5,2,189538,189538,189540,0,2,4
54046,1,3,189539,189540,189543,1,4,0
54047,6,1,189545,189545,189546,0,1,2
54048,2,1,189547,189547,189548,0,1,1
54049,4,3,189551,189551,189554,0,3,3
54050,5,3,189556,189556,189559,0,3,2
54051,2,1,189558,189559,189560,1,2,0
54052,4,3,189562,189562,189565,0,3,2
54053,3,2,189565,189565,189567,0,2,0
54054,5,1,189570,189570,189571,0,1,3
54055,3,2,189573,189573,189575,0,2,2
54056,3,1,189576,189576,189577,0,1,1
54057,4,2,189580,189580,189582,0,2,3
54058,1,3,189581,189582,189585,1,4,0
54059,2,2,189583,189585,189587,2,4,0
54060,4,3,189587,189587,189590,0,3,0
54061,3,3,189590,189590,189593,0,3,0
54062,3,3,189593,189593,189596,0,3,0
54063,2,2,189595,189596,189598,1,3,0
54064,4,2,189599,189599,189601,0,2,1
54065,4,1,189603,189603,189604,0,1,2
54066,1,1,189604,189604,189605,0,1,0
54067,5,2,189609,189609,189611,0,2,4
54068,3,1,189612,189612,189613,0,1,1
54069,3,2,189615,189615,189617,0,2,2
54070,4,1,189619,189619,189620,0,1,2
54071,1,1,189620,189620,189621,0,1,0
54072,2,3,189622,189622,189625,0,3,1
54073,3,2,189625,189625,189627,0,2,0
54074,6,3,189631,189631,189634,0,3,4
54075,6,3,189637,189637,189640,0,3,3
54076,6,3,189643,189643,189646,0,3,3
54077,2,3,189645,189646,189649,1,4,0
54078,5,3,189650,189650,189653,0,3,1
54079,3,1,189653,189653,189654,0,1,0
54080,5,2,189658,189658,189660,0,2,4
54081,4,1,189662,189662,189663,0,1,2
54082,2,1,189664,189664,189665,0,1,1
54083,4,2,189668,189668,189670,0,2,3
54084,2,1,189670,189670,189671,0,1,0
54085,3,2,189673,189673,189675,0,2,2
54086,3,3,189676,189676,189679,0,3,1
54087,6,1,189682,189682,189683,0,1,3
54088,2,2,189684,189684,189686,0,2,1
54089,6,2,189690,189690,189692,0,2,4
54090,2,2,189692,189692,189694,0,2,0
54091,2,2,189694,189694,189696,0,2,0
54092,1,3,189695,189696,189699,1,4,0
54093,6,1,189701,189701,189702,0,1,2
54094,2,1,189703,189703,189704,0,1,1
54095,3,1,189706,189706,189707,0,1,2
54096,1,1,189707,189707,189708,0,1,0
54097,5,1,189712,189712,189713,0,1,4
54098,1,1,189713,189713,189714,0,1,0
54099,1,3,189714,189714,189717,0,3,0
54100,2,1,189716,189717,189718,1,2,0
54101,4,1,189720,189720,189721,0,1,2
54102,6,2,189726,189726,189728,0,2,5
54103,5,3,189731,189731,189734,0,3,3
54104,3,1,189734,189734,189735,0,1,0
54105,6,1,189740,189740,189741,0,1,5
54106,3,1,189743,189743,189744,0,1,2
54107,6,1,189749,189749,189750,0,1,5
54108,5,1,189754,189754,189755,0,1,4
54109,1,1,189755,189755,189756,0,1,0
54110,6,3,189761,189761,189764,0,3,5
54111,5,2,189766,189766,189768,0,2,2
54112,1,1,189767,189768,189769,1,2,0
54113,2,3,189769,189769,189772,0,3,0
54114,2,3,189771,189772,189775,1,4,0
54115,3,3,189774,189775,189778,1,4,0
54116,3,2,189777,189778,189780,1,3,0
54117,6,1,189783,189783,189784,0,1,3
54118,3,1,189786,189786,189787,0,1,2
54119,5,2,189791,189791,189793,0,2,4
54120,2,2,189793,189793,189795,0,2,0
54121,3,1,189796,189796,189797,0,1,1
54122,3,3,189799,189799,189802,0,3,2
54123,3,2,189802,189802,189804,0,2,0
54124,1,1,189803,189804,189805,1,2,0
54125,6,1,189809,189809,189810,0,1,4
54126,4,1,189813,189813,189814,0,1,3
54127,4,2,189817,189817,189819,0,2,3
54128,2,1,189819,189819,189820,0,1,0
54129,2,3,189821,189821,189824,0,3,1
54130,2,1,189823,189824,189825,1,2,0
54131,2,2,189825,189825,189827,0,2,0
54132,4,2,189829,189829,189831,0,2,2
54133,5,2,189834,189834,189836,0,2,3
54134,6,3,189840,189840,189843,0,3,4
54135,4,1,189844,189844,189845,0,1,1
54136,3,2,189847,189847,189849,0,2,2
54137,6,2,189853,189853,189855,0,2,4
54138,5,3,189858,189858,189861,0,3,3
54139,3,1,189861,189861,189862,0,1,0
54140,1,2,189862,189862,189864,0,2,0
54141,3,2,189865,189865,189867,0,2,1
54142,5,2,189870,189870,189872,0,2,3
54143,3,2,189873,189873,189875,0,2,1
54144,1,1,189874,189875,189876,1,2,0
54145,3,2,189877,189877,189879,0,2,1
54146,5,2,189882,189882,189884,0,2,3
54147,4,3,189886,189886,189889,0,3,2
54148,5,3,189891,189891,189894,0,3,2
54149,4,1,189895,189895,189896,0,1,1
54150,6,2,189901,189901,189903,0,2,5
54151,1,3,189902,189903,189906,1,4,0
54152,6,2,189908,189908,189910,0,2,2
54153,6,1,189914,189914,189915,0,1,4
54154,2,2,189916,189916,189918,0,2,1
54155,6,1,189922,189922,189923,0,1,4
54156,2,3,189924,189924,189927,0,3,1
54157,6,3,189930,189930,189933,0,3,3
54158,1,3,189931,189933,189936,2,5,0
54159,4,3,189935,189936,189939,1,4,0
54160,3,1,189938,189939,189940,1,2,0
54161,2,1,189940,189940,189941,0,1,0
54162,1,2,189941,189941,189943,0,2,0
54163,5,2,189946,189946,189948,0,2,3
54164,1,1,189947,189948,189949,1,2,0
54165,2,2,189949,189949,189951,0,2,0
54166,1,2,189950,189951,189953,1,3,0
54167,2,3,189952,189953,189956,1,4,0
54168,2,1,189954,189956,189957,2,3,0
54169,2,1,189956,189957,189958,1,2,0
54170,6,2,189962,189962,189964,0,2,4
54171,1,1,189963,189964,189965,1,2,0
54172,4,3,189967,189967,189970,0,3,2
54173,5,3,189972,189972,189975,0,3,2
54174,2,1,189974,189975,189976,1,2,0
54175,6,1,189980,189980,189981,0,1,4
54176,4,1,189984,189984,189985,0,1,3
54177,3,2,189987,189987,189989,0,2,2
54178,1,2,189988,189989,189991,1,3,0
54179,6,1,189994,189994,189995,0,1,3
54180,5,1,189999,189999,190000,0,1,4
54181,4,3,190003,190003,190006,0,3,3
54182,5,3,190008,190008,190011,0,3,2
54183,1,2,190009,190011,190013,2,4,0
54184,2,1,190011,190013,190014,2,3,0
54185,5,2,190016,190016,190018,0,2,2
54186,5,3,190021,190021,190024,0,3,3
54187,6,3,190027,190027,190030,0,3,3
54188,5,1,190032,190032,190033,0,1,2
54189,5,3,190037,190037,190040,0,3,4
54190,1,2,190038,190040,190042,2,4,0
54191,5,3,190043,190043,190046,0,3,1
54192,6,2,190049,190049,190051,0,2,3
54193,4,2,190053,190053,190055,0,2,2
54194,6,1,190059,190059,190060,0,1,4
54195,1,3,190060,190060,190063,0,3,0
54196,4,3,190064,190064,190067,0,3,1
54197,4,2,190068,190068,190070,0,2,1
54198,1,2,190069,190070,190072,1,3,0
54199,5,1,190074,190074,190075,0,1,2
54200,6,3,190080,190080,190083,0,3,5
54201,6,2,190086,190086,190088,0,2,3
54202,4,2,190090,190090,190092,0,2,2
54203,2,2,190092,190092,190094,0,2,0
54204,3,2,190095,190095,190097,0,2,1
54205,1,3,190096,190097,190100,1,4,0
54206,1,3,190097,190100,190103,3,6,0
54207,2,1,190099,190103,190104,4,5,0
54208,5,3,190104,190104,190107,0,3,0
54209,5,2,190109,190109,190111,0,2,2
54210,5,2,190114,190114,190116,0,2,3
54211,5,2,190119,190119,190121,0,2,3
54212,5,3,190124,190124,190127,0,3,3
54213,3,2,190127,190127,190129,0,2,0
54214,6,2,190133,190133,190135,0,2,4
54215,4,2,190137,190137,190139,0,2,2
54216,6,3,190143,190143,190146,0,3,4
54217,3,2,190146,190146,190148,0,2,0
54218,3,1,190149,190149,190150,0,1,1
54219,6,2,190155,190155,190157,0,2,5
54220,5,2,190160,190160,190162,0,2,3
54221,2,3,190162,190162,190165,0,3,0
54222,3,1,190165,190165,190166,0,1,0
54223,3,2,190168,190168,190170,0,2,2
54224,6,2,190174,190174,190176,0,2,4
54225,6,2,190180,190180,190182,0,2,4
54226,5,2,190185,190185,190187,0,2,3
54227,1,2,190186,190187,190189,1,3,0
54228,1,1,190187,190189,190190,2,3,0
54229,5,2,190192,190192,190194,0,2,2
54230,2,1,190194,190194,190195,0,1,0
54231,2,1,190196,190196,190197,0,1,1
54232,5,2,190201,190201,190203,0,2,4
54233,5,1,190206,190206,190207,0,1,3
54234,6,3,190212,190212,190215,0,3,5
54235,2,2,190214,190215,190217,1,3,0
54236,6,1,190220,190220,190221,0,1,3
54237,6,1,190226,190226,190227,0,1,5
54238,1,1,190227,190227,190228,0,1,0
54239,4,2,190231,190231,190233,0,2,3
54240,4,1,190235,190235,190236,0,1,2
54241,2,2,190237,190237,190239,0,2,1
54242,5,3,190242,190242,190245,0,3,3
54243,2,1,190244,190245,190246,1,2,0
54244,3,2,190247,190247,190249,0,2,1
54245,1,3,190248,190249,190252,1,4,0
54246,1,2,190249,190252,190254,3,5,0
54247,6,2,190255,190255,190257,0,2,1
54248,1,2,190256,190257,190259,1,3,0
54249,6,1,190262,190262,190263,0,1,3
54250,5,1,190267,190267,190268,0,1,4
54251,4,1,190271,190271,190272,0,1,3
54252,4,1,190275,190275,190276,0,1,3
54253,1,2,190276,190276,190278,0,2,0
54254,1,1,190277,190278,190279,1,2,0
54255,2,1,190279,190279,190280,0,1,0
54256,4,2,190283,190283,190285,0,2,3
54257,2,3,190285,190285,190288,0,3,0
54258,1,1,190286,190288,190289,2,3,0
54259,2,3,190288,190289,190292,1,4,0
54260,3,3,190291,190292,190295,1,4,0
54261,1,1,190292,190295,190296,3,4,0
54262,1,1,190293,190296,190297,3,4,0
54263,1,1,190294,190297,190298,3,4,0
54264,1,1,190295,190298,190299,3,4,0
54265,5,2,190300,190300,190302,0,2,1
54266,3,3,190303,190303,190306,0,3,1
54267,6,2,190309,190309,190311,0,2,3
54268,3,3,190312,190312,190315,0,3,1
54269,2,2,190314,190315,190317,1,3,0
54270,6,3,190320,190320,190323,0,3,3
54271,3,2,190323,190323,190325,0,2,0
54272,4,2,190327,190327,190329,0,2,2
54273,6,2,190333,190333,190335,0,2,4
54274,3,3,190336,190336,190339,0,3,1
54275,3,3,190339,190339,190342,0,3,0
54276,3,2,190342,190342,190344,0,2,0
54277,3,3,190345,190345,190348,0,3,1
54278,4,2,190349,190349,190351,0,2,1
54279,6,1,190355,190355,190356,0,1,4
54280,4,1,190359,190359,190360,0,1,3
54281,6,2,190365,190365,190367,0,2,5
54282,2,1,190367,190367,190368,0,1,0
54283,6,1,190373,190373,190374,0,1,5
54284,1,2,190374,190374,190376,0,2,0
54285,5,3,190379,190379,190382,0,3,3
54286,3,1,190382,190382,190383,0,1,0
54287,4,3,190386,190386,190389,0,3,3
54288,4,3,190390,190390,190393,0,3,1
54289,1,3,190391,190393,190396,2,5,0
54290,1,1,190392,190396,190397,4,5,0
54291,3,2,190395,190397,190399,2,4,0
54292,4,1,190399,190399,190400,0,1,0
54293,4,3,190403,190403,190406,0,3,3
54294,1,2,190404,190406,190408,2,4,0
54295,2,3,190406,190408,190411,2,5,0
54296,1,1,190407,190411,190412,4,5,0
54297,2,2,190409,190412,190414,3,5,0
54298,4,1,190413,190414,190415,1,2,0
54299,6,2,190419,190419,190421,0,2,4
54300,6,2,190425,190425,190427,0,2,4
54301,6,3,190431,190431,190434,0,3,4
54302,2,3,190433,190434,190437,1,4,0
54303,5,1,190438,190438,190439,0,1,1
54304,6,1,190444,190444,190445,0,1,5
54305,3,2,190447,190447,190449,0,2,2
54306,1,2,190448,190449,190451,1,3,0
54307,6,3,190454,190454,190457,0,3,3
54308,5,2,190459,190459,190461,0,2,2
54309,2,3,190461,190461,190464,0,3,0
54310,4,3,190465,190465,190468,0,3,1
54311,3,1,190468,190468,190469,0,1,0
54312,6,2,190474,190474,190476,0,2,5
54313,2,3,190476,190476,190479,0,3,0
54314,1,2,190477,190479,190481,2,4,0
54315,3,3,190480,190481,190484,1,4,0
54316,4,3,190484,190484,190487,0,3,0
54317,5,1,190489,190489,190490,0,1,2
54318,4,1,190493,190493,190494,0,1,3
54319,4,3,190497,190497,190500,0,3,3
54320,4,2,190501,190501,190503,0,2,1
54321,1,1,190502,190503,190504,1,2,0
54322,4,3,190506,190506,190509,0,3,2
54323,4,2,190510,190510,190512,0,2,1
54324,1,3,190511,190512,190515,1,4,0
54325,3,2,190514,190515,190517,1,3,0
54326,3,3,190517,190517,190520,0,3,0
54327,4,2,190521,190521,190523,0,2,1
54328,6,3,190527,190527,190530,0,3,4
54329,4,2,190531,190531,190533,0,2,1
54330,4,3,190535,190535,190538,0,3,2
54331,2,2,190537,190538,190540,1,3,0
54332,5,2,190542,190542,190544,0,2,2
54333,3,1,190545,190545,190546,0,1,1
54334,4,1,190549,190549,190550,0,1,3
54335,1,1,190550,190550,190551,0,1,0
54336,1,1,190551,190551,190552,0,1,0
54337,5,1,190556,190556,190557,0,1,4
54338,3,1,190559,190559,190560,0,1,2
54339,3,1,190562,190562,190563,0,1,2
54340,5,3,190567,190567,190570,0,3,4
54341,1,3,190568,190570,190573,2,5,0
54342,5,3,190573,190573,190576,0,3,0
54343,2,1,190575,190576,190577,1,2,0
54344,2,3,190577,190577,190580,0,3,0
54345,2,1,190579,190580,190581,1,2,0
54346,2,2,190581,190581,190583,0,2,0
54347,3,3,190584,190584,190587,0,3,1
54348,5,1,190589,190589,190590,0,1,2
54349,3,3,190592,190592,190595,0,3,2
54350,6,1,190598,190598,190599,0,1,3
54351,3,1,190601,190601,190602,0,1,2
54352,3,1,190604,190604,190605,0,1,2
54353,1,1,190605,190605,190606,0,1,0
54354,5,1,190610,190610,190611,0,1,4
54355,6,3,190616,190616,190619,0,3,5
54356,4,1,190620,190620,190621,0,1,1
54357,3,2,190623,190623,190625,0,2,2
54358,4,3,190627,190627,190630,0,3,2
54359,4,3,190631,190631,190634,0,3,1
54360,5,2,190636,190636,190638,0,2,2
54361,5,2,190641,190641,190643,0,2,3
54362,2,2,190643,190643,190645,0,2,0
54363,5,1,190648,190648,190649,0,1,3
54364,4,3,190652,190652,190655,0,3,3
54365,6,3,190658,190658,190661,0,3,3
54366,3,2,190661,190661,190663,0,2,0
54367,6,1,190667,190667,190668,0,1,4
54368,2,2,190669,190669,190671,0,2,1
54369,5,1,190674,190674,190675,0,1,3
54370,2,3,190676,190676,190679,0,3,1
54371,3,2,190679,190679,190681,0,2,0
54372,5,1,190684,190684,190685,0,1,3
54373,5,3,190689,190689,190692,0,3,4
54374,3,2,190692,190692,190694,0,2,0
54375,2,1,190694,190694,190695,0,1,0
54376,2,3,190696,190696,190699,0,3,1
54377,3,3,190699,190699,190702,0,3,0
54378,2,2,190701,190702,190704,1,3,0
54379,1,1,190702,190704,190705,2,3,0
54380,6,1,190708,190708,190709,0,1,3
54381,6,2,190714,190714,190716,0,2,5
54382,5,2,190719,190719,190721,0,2,3
54383,2,3,190721,190721,190724,0,3,0
54384,6,1,190727,190727,190728,0,1,3
54385,1,1,190728,190728,190729,0,1,0
54386,4,3,190732,190732,190735,0,3,3
54387,6,2,190738,190738,190740,0,2,3
54388,3,3,190741,190741,190744,0,3,1
54389,5,1,190746,190746,190747,0,1,2
54390,4,1,190750,190750,190751,0,1,3
54391,3,1,190753,190753,190754,0,1,2
54392,4,2,190757,190757,190759,0,2,3
54393,2,1,190759,190759,190760,0,1,0
54394,3,1,190762,190762,190763,0,1,2
54395,6,3,190768,190768,190771,0,3,5
54396,1,2,190769,190771,190773,2,4,0
54397,6,1,190775,190775,190776,0,1,2
54398,1,1,190776,190776,190777,0,1,0
54399,3,2,190779,190779,190781,0,2,2
54400,1,2,190780,190781,190783,1,3,0
54401,6,2,190786,190786,190788,0,2,3
54402,2,3,190788,190788,190791,0,3,0
54403,2,3,190790,190791,190794,1,4,0
54404,5,3,190795,190795,190798,0,3,1
54405,3,3,190798,190798,190801,0,3,0
54406,5,3,190803,190803,190806,0,3,2
54407,3,2,190806,190806,190808,0,2,0
54408,6,3,190812,190812,190815,0,3,4
54409,1,2,190813,190815,190817,2,4,0
54410,2,2,190815,190817,190819,2,4,0
54411,4,3,190819,190819,190822,0,3,0
54412,1,1,190820,190822,190823,2,3,0
54413,2,1,190822,190823,190824,1,2,0
54414,5,2,190827,190827,190829,0,2,3
54415,2,2,190829,190829,190831,0,2,0
54416,6,3,190835,190835,190838,0,3,4
54417,2,3,190837,190838,190841,1,4,0
54418,1,1,190838,190841,190842,3,4,0
54419,6,2,190844,190844,190846,0,2,2
54420,4,3,190848,190848,190851,0,3,2
54421,4,2,190852,190852,190854,0,2,1
54422,2,1,190854,190854,190855,0,1,0
54423,4,3,190858,190858,190861,0,3,3
54424,4,3,190862,190862,190865,0,3,1
54425,3,1,190865,190865,190866,0,1,0
54426,1,2,190866,190866,190868,0,2,0
54427,5,3,190871,190871,190874,0,3,3
54428,4,2,190875,190875,190877,0,2,1
54429,3,3,190878,190878,190881,0,3,1
54430,3,2,190881,190881,190883,0,2,0
54431,1,2,190882,190883,190885,1,3,0
54432,4,3,190886,190886,190889,0,3,1
54433,4,3,190890,190890,190893,0,3,1
54434,1,2,190891,190893,190895,2,4,0
54435,2,1,190893,190895,190896,2,3,0
54436,6,1,190899,190899,190900,0,1,3
54437,3,3,190902,190902,190905,0,3,2
54438,1,2,190903,190905,190907,2,4,0
54439,2,3,190905,190907,190910,2,5,0
54440,4,1,190909,190910,190911,1,2,0
54441,5,2,190914,190914,190916,0,2,3
54442,6,3,190920,190920,190923,0,3,4
54443,3,1,190923,190923,190924,0,1,0
54444,5,3,190928,190928,190931,0,3,4
54445,2,1,190930,190931,190932,1,2,0
54446,2,3,190932,190932,190935,0,3,0
54447,5,1,190937,190937,190938,0,1,2
54448,2,1,190939,190939,190940,0,1,1
54449,4,1,190943,190943,190944,0,1,3
54450,3,1,190946,190946,190947,0,1,2
54451,5,3,190951,190951,190954,0,3,4
54452,3,2,190954,190954,190956,0,2,0
54453,6,2,190960,190960,190962,0,2,4
54454,5,2,190965,190965,190967,0,2,3
54455,5,2,190970,190970,190972,0,2,3
54456,2,2,190972,190972,190974,0,2,0
54457,2,3,190974,190974,190977,0,3,0
54458,6,3,190980,190980,190983,0,3,3
54459,3,1,190983,190983,190984,0,1,0
54460,1,3,190984,190984,190987,0,3,0
54461,4,2,190988,190988,190990,0,2,1
54462,1,1,190989,190990,190991,1,2,0
54463,5,1,190994,190994,190995,0,1,3
54464,5,1,190999,190999,191000,0,1,4
54465,2,3,191001,191001,191004,0,3,1
54466,3,3,191004,191004,191007,0,3,0
54467,2,2,191006,191007,191009,1,3,0
54468,4,2,191010,191010,191012,0,2,1
54469,2,2,191012,191012,191014,0,2,0
54470,2,1,191014,191014,191015,0,1,0
54471,4,1,191018,191018,191019,0,1,3
54472,4,1,191022,191022,191023,0,1,3
54473,6,3,191028,191028,191031,0,3,5
54474,6,2,191034,191034,191036,0,2,3
54475,2,2,191036,191036,191038,0,2,0
54476,2,1,191038,191038,191039,0,1,0
54477,4,1,191042,191042,191043,0,1,3
54478,5,1,191047,191047,191048,0,1,4
54479,6,3,191053,191053,191056,0,3,5
54480,4,1,191057,191057,191058,0,1,1
54481,3,1,191060,191060,191061,0,1,2
54482,2,2,191062,191062,191064,0,2,1
54483,3,1,191065,191065,191066,0,1,1
54484,1,3,191066,191066,191069,0,3,0
54485,3,2,191069,191069,191071,0,2,0
54486,4,3,191073,191073,191076,0,3,2
54487,3,2,191076,191076,191078,0,2,0
54488,3,1,191079,191079,191080,0,1,1
54489,2,2,191081,191081,191083,0,2,1
54490,1,2,191082,191083,191085,1,3,0
54491,2,3,191084,191085,191088,1,4,0
54492,1,2,191085,191088,191090,3,5,0
54493,2,3,191087,191090,191093,3,6,0
54494,2,1,191089,191093,191094,4,5,0
54495,5,3,191094,191094,191097,0,3,0
54496,5,3,191099,191099,191102,0,3,2
54497,6,2,191105,191105,191107,0,2,3
54498,6,1,191111,191111,191112,0,1,4
54499,6,2,191117,191117,191119,0,2,5
54500,3,2,191120,191120,191122,0,2,1
54501,4,3,191124,191124,191127,0,3,2
54502,3,3,191127,191127,191130,0,3,0
54503,2,3,191129,191130,191133,1,4,0
54504,3,2,191132,191133,191135,1,3,0
54505,4,3,191136,191136,191139,0,3,1
54506,1,1,191137,191139,191140,2,3,0
54507,6,1,191143,191143,191144,0,1,3
54508,3,1,191146,191146,191147,0,1,2
54509,3,2,191149,191149,191151,0,2,2
54510,4,1,191153,191153,191154,0,1,2
54511,5,2,191158,191158,191160,0,2,4
54512,3,3,191161,191161,191164,0,3,1
54513,4,1,191165,191165,191166,0,1,1
54514,4,2,191169,191169,191171,0,2,3
54515,2,1,191171,191171,191172,0,1,0
54516,5,2,191176,191176,191178,0,2,4
54517,4,1,191180,191180,191181,0,1,2
54518,2,1,191182,191182,191183,0,1,1
54519,6,3,191188,191188,191191,0,3,5
54520,2,1,191190,191191,191192,1,2,0
54521,5,2,191195,191195,191197,0,2,3
54522,6,3,191201,191201,191204,0,3,4
54523,6,3,191207,191207,191210,0,3,3
54524,5,2,191212,191212,191214,0,2,2
54525,1,3,191213,191214,191217,1,4,0
54526,3,2,191216,191217,191219,1,3,0
54527,5,3,191221,191221,191224,0,3,2
54528,5,1,191226,191226,191227,0,1,2
54529,2,2,191228,191228,191230,0,2,1
54530,4,3,191232,191232,191235,0,3,2
54531,1,3,191233,191235,191238,2,5,0
54532,2,3,191235,191238,191241,3,6,0
54533,2,2,191237,191241,191243,4,6,0
54534,1,2,191238,191243,191245,5,7,0
54535,1,3,191239,191245,191248,6,9,0
54536,5,1,191244,191248,191249,4,5,0
54537,3,3,191247,191249,191252,2,5,0
54538,6,2,191253,191253,191255,0,2,1
54539,3,3,191256,191256,191259,0,3,1
54540,3,2,191259,191259,191261,0,2,0
54541,5,1,191264,191264,191265,0,1,3
54542,3,1,191267,191267,191268,0,1,2
54543,1,3,191268,191268,191271,0,3,0
54544,5,3,191273,191273,191276,0,3,2
54545,3,3,191276,191276,191279,0,3,0
54546,6,2,191282,191282,191284,0,2,3
54547,4,2,191286,191286,191288,0,2,2
54548,4,3,191290,191290,191293,0,3,2
54549,6,3,191296,191296,191299,0,3,3
54550,5,2,191301,191301,191303,0,2,2
54551,6,1,191307,191307,191308,0,1,4
54552,3,1,191310,191310,191311,0,1,2
54553,1,2,191311,191311,191313,0,2,0
54554,6,1,191317,191317,191318,0,1,4
54555,1,3,191318,191318,191321,0,3,0
54556,4,1,191322,191322,191323,0,1,1
54557,2,3,191324,191324,191327,0,3,1
54558,2,2,191326,191327,191329,1,3,0
54559,2,3,191328,191329,191332,1,4,0
54560,6,3,191334,191334,191337,0,3,2
54561,5,1,191339,191339,191340,0,1,2
54562,1,1,191340,191340,191341,0,1,0
54563,1,3,191341,191341,191344,0,3,0
54564,2,1,191343,191344,191345,1,2,0
54565,5,2,191348,191348,191350,0,2,3
54566,2,3,191350,191350,191353,0,3,0
54567,5,3,191355,191355,191358,0,3,2
54568,5,2,191360,191360,191362,0,2,2
54569,5,3,191365,191365,191368,0,3,3
54570,1,1,191366,191368,191369,2,3,0
54571,3,2,191369,191369,191371,0,2,0
54572,6,3,191375,191375,191378,0,3,4
54573,4,1,191379,191379,191380,0,1,1
54574,3,3,191382,191382,191385,0,3,2
54575,2,2,191384,191385,191387,1,3,0
54576,6,2,191390,191390,191392,0,2,3
54577,1,1,191391,191392,191393,1,2,0
54578,1,3,191392,191393,191396,1,4,0
54579,2,3,191394,191396,191399,2,5,0
54580,4,2,191398,191399,191401,1,3,0
54581,5,3,191403,191403,191406,0,3,2
54582,6,2,191409,191409,191411,0,2,3
54583,3,1,191412,191412,191413,0,1,1
54584,5,1,191417,191417,191418,0,1,4
54585,4,1,191421,191421,191422,0,1,3
54586,4,3,191425,191425,191428,0,3,3
54587,1,1,191426,191428,191429,2,3,0
54588,1,2,191427,191429,191431,2,4,0
54589,3,1,191430,191431,191432,1,2,0
54590,4,3,191434,191434,191437,0,3,2
54591,3,3,191437,191437,191440,0,3,0
54592,6,3,191443,191443,191446,0,3,3
54593,5,2,191448,191448,191450,0,2,2
54594,6,3,191454,191454,191457,0,3,4
54595,1,3,191455,191457,191460,2,5,0
54596,5,2,191460,191460,191462,0,2,0
54597,3,3,191463,191463,191466,0,3,1
54598,1,1,191464,191466,191467,2,3,0
54599,6,1,191470,191470,191471,0,1,3
54600,2,2,191472,191472,191474,0,2,1
54601,6,3,191478,191478,191481,0,3,4
54602,2,3,191480,191481,191484,1,4,0
54603,1,2,191481,191484,191486,3,5,0
54604,2,2,191483,191486,191488,3,5,0
54605,1,3,191484,191488,191491,4,7,0
54606,3,3,191487,191491,191494,4,7,0
54607,4,3,191491,191494,191497,3,6,0
54608,5,3,191496,191497,191500,1,4,0
54609,6,2,191502,191502,191504,0,2,2
54610,3,3,191505,191505,191508,0,3,1
54611,6,2,191511,191511,191513,0,2,3
54612,2,2,191513,191513,191515,0,2,0
54613,3,2,191516,191516,191518,0,2,1
54614,1,1,191517,191518,191519,1,2,0
54615,3,1,191520,191520,191521,0,1,1
54616,3,3,191523,191523,191526,0,3,2
54617,4,3,191527,191527,191530,0,3,1
54618,1,2,191528,191530,191532,2,4,0
54619,6,3,191534,191534,191537,0,3,2
54620,2,2,191536,191537,191539,1,3,0
54621,1,2,191537,191539,191541,2,4,0
54622,1,3,191538,191541,191544,3,6,0
54623,4,2,191542,191544,191546,2,4,0
54624,5,1,191547,191547,191548,0,1,1
54625,4,3,191551,191551,191554,0,3,3
54626,6,2,191557,191557,191559,0,2,3
54627,6,1,191563,191563,191564,0,1,4
54628,4,1,191567,191567,191568,0,1,3
54629,4,2,191571,191571,191573,0,2,3
54630,3,3,191574,191574,191577,0,3,1
54631,4,2,191578,191578,191580,0,2,1
54632,2,2,191580,191580,191582,0,2,0
54633,6,3,191586,191586,191589,0,3,4
54634,5,1,191591,191591,191592,0,1,2
54635,2,3,191593,191593,191596,0,3,1
54636,3,1,191596,191596,191597,0,1,0
54637,2,3,191598,191598,191601,0,3,1
54638,3,3,191601,191601,191604,0,3,0
54639,5,1,191606,191606,191607,0,1,2
54640,6,3,191612,191612,191615,0,3,5
54641,2,2,191614,191615,191617,1,3,0
54642,3,1,191617,191617,191618,0,1,0
54643,3,3,191620,191620,191623,0,3,2
54644,4,1,191624,191624,191625,0,1,1
54645,4,2,191628,191628,191630,0,2,3
54646,4,3,191632,191632,191635,0,3,2
54647,3,2,191635,191635,191637,0,2,0
54648,5,1,191640,191640,191641,0,1,3
54649,6,1,191646,191646,191647,0,1,5
54650,4,2,191650,191650,191652,0,2,3
54651,4,3,191654,191654,191657,0,3,2
54652,4,1,191658,191658,191659,0,1,1
54653,6,3,191664,191664,191667,0,3,5
54654,4,1,191668,191668,191669,0,1,1
54655,6,3,191674,191674,191677,0,3,5
54656,3,2,191677,191677,191679,0,2,0
54657,5,3,191682,191682,191685,0,3,3
54658,4,2,191686,191686,191688,0,2,1
54659,5,3,191691,191691,191694,0,3,3
54660,4,1,191695,191695,191696,0,1,1
54661,3,1,191698,191698,191699,0,1,2
54662,3,1,191701,191701,191702,0,1,2
54663,1,3,191702,191702,191705,0,3,0
54664,5,2,191707,191707,191709,0,2,2
54665,2,3,191709,191709,191712,0,3,0
54666,3,2,191712,191712,191714,0,2,0
54667,3,2,191715,191715,191717,0,2,1
54668,6,3,191721,191721,191724,0,3,4
54669,3,3,191724,191724,191727,0,3,0
54670,2,2,191726,191727,191729,1,3,0
54671,5,2,191731,191731,191733,0,2,2
54672,3,3,191734,191734,191737,0,3,1
54673,5,2,191739,191739,191741,0,2,2
54674,5,1,191744,191744,191745,0,1,3
54675,3,2,191747,191747,191749,0,2,2
54676,6,3,191753,191753,191756,0,3,4
54677,6,3,191759,191759,191762,0,3,3
54678,5,3,191764,191764,191767,0,3,2
54679,4,2,191768,191768,191770,0,2,1
54680,6,1,191774,191774,191775,0,1,4
54681,6,1,191780,191780,191781,0,1,5
54682,6,3,191786,191786,191789,0,3,5
54683,4,2,191790,191790,191792,0,2,1
54684,4,3,191794,191794,191797,0,3,2
54685,5,3,191799,191799,191802,0,3,2
54686,3,3,191802,191802,191805,0,3,0
54687,2,1,191804,191805,191806,1,2,0
54688,5,2,191809,191809,191811,0,2,3
54689,3,3,191812,191812,191815,0,3,1
54690,5,1,191817,191817,191818,0,1,2
54691,2,2,191819,191819,191821,0,2,1
54692,4,3,191823,191823,191826,0,3,2
54693,5,2,191828,191828,191830,0,2,2
54694,4,1,191832,191832,191833,0,1,2
54695,4,3,191836,191836,191839,0,3,3
54696,3,1,191839,191839,191840,0,1,0
54697,1,1,191840,191840,191841,0,1,0
54698,3,3,191843,191843,191846,0,3,2
54699,6,2,191849,191849,191851,0,2,3
54700,4,2,191853,191853,191855,0,2,2
54701,6,1,191859,191859,191860,0,1,4
54702,4,1,191863,191863,191864,0,1,3
54703,1,3,191864,191864,191867,0,3,0
54704,4,1,191868,191868,191869,0,1,1
54705,4,1,191872,191872,191873,0,1,3
54706,5,1,191877,191877,191878,0,1,4
54707,6,1,191883,191883,191884,0,1,5
54708,6,1,191889,191889,191890,0,1,5
54709,2,3,191891,191891,191894,0,3,1
54710,5,2,191896,191896,191898,0,2,2
54711,3,3,191899,191899,191902,0,3,1
54712,1,2,191900,191902,191904,2,4,0
54713,3,1,191903,191904,191905,1,2,0
54714,6,1,191909,191909,191910,0,1,4
54715,5,1,191914,191914,191915,0,1,4
54716,4,1,191918,191918,191919,0,1,3
54717,3,1,191921,191921,191922,0,1,2
54718,6,3,191927,191927,191930,0,3,5
54719,3,1,191930,191930,191931,0,1,0
54720,6,1,191936,191936,191937,0,1,5
54721,5,3,191941,191941,191944,0,3,4
54722,6,2,191947,191947,191949,0,2,3
54723,4,1,191951,191951,191952,0,1,2
54724,3,2,191954,191954,191956,0,2,2
54725,3,2,191957,191957,191959,0,2,1
54726,2,3,191959,191959,191962,0,3,0
54727,6,2,191965,191965,191967,0,2,3
54728,6,1,191971,191971,191972,0,1,4
54729,4,3,191975,191975,191978,0,3,3
54730,1,3,191976,191978,191981,2,5,0
54731,3,2,191979,191981,191983,2,4,0
54732,4,3,191983,191983,191986,0,3,0
54733,4,1,191987,191987,191988,0,1,1
54734,1,1,191988,191988,191989,0,1,0
54735,5,1,191993,191993,191994,0,1,4
54736,2,2,191995,191995,191997,0,2,1
54737,4,1,191999,191999,192000,0,1,2
54738,6,3,192005,192005,192008,0,3,5
54739,4,1,192009,192009,192010,0,1,1
54740,2,1,192011,192011,192012,0,1,1
54741,4,2,192015,192015,192017,0,2,3
54742,3,2,192018,192018,192020,0,2,1
54743,5,1,192023,192023,192024,0,1,3
54744,4,1,192027,192027,192028,0,1,3
54745,6,2,192033,192033,192035,0,2,5
54746,1,1,192034,192035,192036,1,2,0
54747,5,3,192039,192039,192042,0,3,3
54748,5,2,192044,192044,192046,0,2,2
54749,6,3,192050,192050,192053,0,3,4
54750,3,3,192053,192053,192056,0,3,0
54751,1,1,192054,192056,192057,2,3,0
54752,1,3,192055,192057,192060,2,5,0
54753,4,1,192059,192060,192061,1,2,0
54754,1,2,192060,192061,192063,1,3,0
54755,4,3,192064,192064,192067,0,3,1
54756,4,3,192068,192068,192071,0,3,1
54757,4,2,192072,192072,192074,0,2,1
54758,3,3,192075,192075,192078,0,3,1
54759,6,3,192081,192081,192084,0,3,3
54760,4,2,192085,192085,192087,0,2,1
54761,4,3,192089,192089,192092,0,3,2
54762,2,1,192091,192092,192093,1,2,0
54763,3,3,192094,192094,192097,0,3,1
54764,3,3,192097,192097,192100,0,3,0
54765,2,1,192099,192100,192101,1,2,0
54766,5,1,192104,192104,192105,0,1,3
54767,5,3,192109,192109,192112,0,3,4
54768,1,3,192110,192112,192115,2,5,0
54769,2,2,192112,192115,192117,3,5,0
54770,6,3,192118,192118,192121,0,3,1
54771,6,1,192124,192124,192125,0,1,3
54772,3,1,192127,192127,192128,0,1,2
54773,5,3,192132,192132,192135,0,3,4
54774,2,1,192134,192135,192136,1,2,0
54775,1,2,192135,192136,192138,1,3,0
54776,1,1,192136,192138,192139,2,3,0
54777,3,2,192139,192139,192141,0,2,0
54778,5,2,192144,192144,192146,0,2,3
54779,3,3,192147,192147,192150,0,3,1
54780,3,1,192150,192150,192151,0,1,0
54781,2,3,192152,192152,192155,0,3,1
54782,2,1,192154,192155,192156,1,2,0
54783,3,1,192157,192157,192158,0,1,1
54784,2,1,192159,192159,192160,0,1,1
54785,4,1,192163,192163,192164,0,1,3
54786,4,2,192167,192167,192169,0,2,3
54787,6,2,192173,192173,192175,0,2,4
54788,4,1,192177,192177,192178,0,1,2
54789,5,3,192182,192182,192185,0,3,4
54790,2,3,192184,192185,192188,1,4,0
54791,5,1,192189,192189,192190,0,1,1
54792,2,3,192191,192191,192194,0,3,1
54793,6,1,192197,192197,192198,0,1,3
54794,1,2,192198,192198,192200,0,2,0
54795,2,3,192200,192200,192203,0,3,0
54796,3,1,192203,192203,192204,0,1,0
54797,4,1,192207,192207,192208,0,1,3
54798,5,3,192212,192212,192215,0,3,4
54799,6,1,192218,192218,192219,0,1,3
54800,3,2,192221,192221,192223,0,2,2
54801,2,2,192223,192223,192225,0,2,0
54802,6,1,192229,192229,192230,0,1,4
54803,6,3,192235,192235,192238,0,3,5
54804,4,1,192239,192239,192240,0,1,1
54805,1,3,192240,192240,192243,0,3,0
54806,2,1,192242,192243,192244,1,2,0
54807,2,3,192244,192244,192247,0,3,0
54808,1,1,192245,192247,192248,2,3,0
54809,2,3,192247,192248,192251,1,4,0
54810,3,3,192250,192251,192254,1,4,0
54811,6,2,192256,192256,192258,0,2,2
54812,3,1,192259,192259,192260,0,1,1
54813,3,3,192262,192262,192265,0,3,2
54814,1,1,192263,192265,192266,2,3,0
54815,2,1,192265,192266,192267,1,2,0
54816,1,3,192266,192267,192270,1,4,0
54817,2,1,192268,192270,192271,2,3,0
54818,6,2,192274,192274,192276,0,2,3
54819,4,1,192278,192278,192279,0,1,2
54820,4,1,192282,192282,192283,0,1,3
54821,2,3,192284,192284,192287,0,3,1
54822,2,1,192286,192287,192288,1,2,0
54823,3,2,192289,192289,192291,0,2,1
54824,1,2,192290,192291,192293,1,3,0
54825,6,1,192296,192296,192297,0,1,3
54826,6,3,192302,192302,192305,0,3,5
54827,4,1,192306,192306,192307,0,1,1
54828,4,3,192310,192310,192313,0,3,3
54829,1,1,192311,192313,192314,2,3,0
54830,6,3,192317,192317,192320,0,3,3
54831,5,2,192322,192322,192324,0,2,2
54832,4,3,192326,192326,192329,0,3,2
54833,2,1,192328,192329,192330,1,2,0
54834,3,2,192331,192331,192333,0,2,1
54835,2,2,192333,192333,192335,0,2,0
54836,2,3,192335,192335,192338,0,3,0
54837,6,3,192341,192341,192344,0,3,3
54838,4,1,192345,192345,192346,0,1,1
54839,5,3,192350,192350,192353,0,3,4
54840,4,3,192354,192354,192357,0,3,1
54841,2,1,192356,192357,192358,1,2,0
54842,3,3,192359,192359,192362,0,3,1
54843,5,3,192364,192364,192367,0,3,2
54844,2,3,192366,192367,192370,1,4,0
54845,6,1,192372,192372,192373,0,1,2
54846,2,1,192374,192374,192375,0,1,1
54847,4,3,192378,192378,192381,0,3,3
54848,1,2,192379,192381,192383,2,4,0
54849,6,3,192385,192385,192388,0,3,2
54850,5,1,192390,192390,192391,0,1,2
54851,6,1,192396,192396,192397,0,1,5
54852,1,3,192397,192397,192400,0,3,0
54853,5,3,192402,192402,192405,0,3,2
54854,2,2,192404,192405,192407,1,3,0
54855,2,3,192406,192407,192410,1,4,0
54856,4,1,192410,192410,192411,0,1,0
54857,6,2,192416,192416,192418,0,2,5
54858,4,1,192420,192420,192421,0,1,2
54859,1,2,192421,192421,192423,0,2,0
54860,6,2,192427,192427,192429,0,2,4
54861,4,1,192431,192431,192432,0,1,2
54862,2,2,192433,192433,192435,0,2,1
54863,6,3,192439,192439,192442,0,3,4
54864,3,1,192442,192442,192443,0,1,0
54865,5,3,192447,192447,192450,0,3,4
54866,3,1,192450,192450,192451,0,1,0
54867,3,1,192453,192453,192454,0,1,2
54868,1,2,192454,192454,192456,0,2,0
54869,2,2,192456,192456,192458,0,2,0
54870,3,1,192459,192459,192460,0,1,1
54871,5,1,192464,192464,192465,0,1,4
54872,2,1,192466,192466,192467,0,1,1
54873,4,1,192470,192470,192471,0,1,3
54874,6,2,192476,192476,192478,0,2,5
54875,1,2,192477,192478,192480,1,3,0
54876,3,3,192480,192480,192483,0,3,0
54877,6,1,192486,192486,192487,0,1,3
54878,3,1,192489,192489,192490,0,1,2
54879,2,3,192491,192491,192494,0,3,1
54880,3,1,192494,192494,192495,0,1,0
54881,5,3,192499,192499,192502,0,3,4
54882,1,2,192500,192502,192504,2,4,0
54883,4,1,192504,192504,192505,0,1,0
54884,2,1,192506,192506,192507,0,1,1
54885,1,3,192507,192507,192510,0,3,0
54886,3,2,192510,192510,192512,0,2,0
54887,6,2,192516,192516,192518,0,2,4
54888,2,2,192518,192518,192520,0,2,0
54889,3,3,192521,192521,192524,0,3,1
54890,2,1,192523,192524,192525,1,2,0
54891,1,2,192524,192525,192527,1,3,0
54892,2,3,192526,192527,192530,1,4,0
54893,1,3,192527,192530,192533,3,6,0
54894,2,2,192529,192533,192535,4,6,0
54895,3,3,192532,192535,192538,3,6,0
54896,1,1,192533,192538,192539,5,6,0
54897,2,3,192535,192539,192542,4,7,0
54898,6,1,192541,192542,192543,1,2,0
54899,1,1,192542,192543,192544,1,2,0
54900,5,1,192547,192547,192548,0,1,3
54901,3,1,192550,192550,192551,0,1,2
54902,4,3,192554,192554,192557,0,3,3
54903,5,2,192559,192559,192561,0,2,2
54904,5,1,192564,192564,192565,0,1,3
54905,1,3,192565,192565,192568,0,3,0
54906,5,1,192570,192570,192571,0,1,2
54907,1,1,192571,192571,192572,0,1,0
54908,3,2,192574,192574,192576,0,2,2
54909,2,3,192576,192576,192579,0,3,0
54910,2,3,192578,192579,192582,1,4,0
54911,3,3,192581,192582,192585,1,4,0
54912,2,3,192583,192585,192588,2,5,0
54913,6,2,192589,192589,192591,0,2,1
54914,6,3,192595,192595,192598,0,3,4
54915,1,2,192596,192598,192600,2,4,0
54916,6,3,192602,192602,192605,0,3,2
54917,6,1,192608,192608,192609,0,1,3
54918,1,3,192609,192609,192612,0,3,0
54919,3,3,192612,192612,192615,0,3,0
54920,6,3,192618,192618,192621,0,3,3
54921,4,1,192622,192622,192623,0,1,1
54922,4,1,192626,192626,192627,0,1,3
54923,2,1,192628,192628,192629,0,1,1
54924,1,1,192629,192629,192630,0,1,0
54925,3,2,192632,192632,192634,0,2,2
54926,6,1,192638,192638,192639,0,1,4
54927,6,2,192644,192644,192646,0,2,5
54928,4,2,192648,192648,192650,0,2,2
54929,4,1,192652,192652,192653,0,1,2
54930,5,3,192657,192657,192660,0,3,4
54931,5,2,192662,192662,192664,0,2,2
54932,1,3,192663,192664,192667,1,4,0
54933,2,2,192665,192667,192669,2,4,0
54934,5,3,192670,192670,192673,0,3,1
54935,6,1,192676,192676,192677,0,1,3
54936,5,1,192681,192681,192682,0,1,4
54937,4,1,192685,192685,192686,0,1,3
54938,2,3,192687,192687,192690,0,3,1
54939,1,1,192688,192690,192691,2,3,0
54940,2,2,192690,192691,192693,1,3,0
54941,6,1,192696,192696,192697,0,1,3
54942,4,3,192700,192700,192703,0,3,3
54943,6,2,192706,192706,192708,0,2,3
54944,5,1,192711,192711,192712,0,1,3
54945,6,3,192717,192717,192720,0,3,5
54946,5,3,192722,192722,192725,0,3,2
54947,2,1,192724,192725,192726,1,2,0
54948,1,2,192725,192726,192728,1,3,0
54949,6,3,192731,192731,192734,0,3,3
54950,4,1,192735,192735,192736,0,1,1
54951,6,3,192741,192741,192744,0,3,5
54952,6,1,192747,192747,192748,0,1,3
54953,4,2,192751,192751,192753,0,2,3
54954,6,2,192757,192757,192759,0,2,4
54955,2,2,192759,192759,192761,0,2,0
54956,6,1,192765,192765,192766,0,1,4
54957,5,1,192770,192770,192771,0,1,4
54958,6,1,192776,192776,192777,0,1,5
54959,1,2,192777,192777,192779,0,2,0
54960,4,1,192781,192781,192782,0,1,2
54961,4,2,192785,192785,192787,0,2,3
54962,6,2,192791,192791,192793,0,2,4
54963,3,1,192794,192794,192795,0,1,1
54964,6,2,192800,192800,192802,0,2,5
54965,6,3,192806,192806,192809,0,3,4
54966,4,3,192810,192810,192813,0,3,1
54967,2,3,192812,192813,192816,1,4,0
54968,6,3,192818,192818,192821,0,3,2
54969,3,2,192821,192821,192823,0,2,0
54970,6,1,192827,192827,192828,0,1,4
54971,3,2,192830,192830,192832,0,2,2
54972,3,1,192833,192833,192834,0,1,1
54973,1,3,192834,192834,192837,0,3,0
54974,4,3,192838,192838,192841,0,3,1
54975,4,1,192842,192842,192843,0,1,1
54976,4,2,192846,192846,192848,0,2,3
54977,3,3,192849,192849,192852,0,3,1
54978,3,3,192852,192852,192855,0,3,0
54979,6,2,192858,192858,192860,0,2,3
54980,6,2,192864,192864,192866,0,2,4
54981,6,1,192870,192870,192871,0,1,4
54982,4,2,192874,192874,192876,0,2,3
54983,1,2,192875,192876,192878,1,3,0
54984,3,1,192878,192878,192879,0,1,0
54985,5,3,192883,192883,192886,0,3,4
54986,3,2,192886,192886,192888,0,2,0
54987,3,1,192889,192889,192890,0,1,1
54988,4,1,192893,192893,192894,0,1,3
54989,4,3,192897,192897,192900,0,3,3
54990,1,1,192898,192900,192901,2,3,0
54991,5,3,192903,192903,192906,0,3,2
54992,1,1,192904,192906,192907,2,3,0
54993,6,2,192910,192910,192912,0,2,3
54994,3,1,192913,192913,192914,0,1,1
54995,4,1,192917,192917,192918,0,1,3
54996,6,3,192923,192923,192926,0,3,5
54997,3,3,192926,192926,192929,0,3,0
54998,5,1,192931,192931,192932,0,1,2
54999,4,2,192935,192935,192937,0,2,3
55000,4,2,192939,192939,192941,0,2,2
55001,1,2,192940,192941,192943,1,3,0
55002,5,3,192945,192945,192948,0,3,2
55003,1,1,192946,192948,192949,2,3,0
55004,1,1,192947,192949,192950,2,3,0
55005,2,1,192949,192950,192951,1,2,0
55006,1,2,192950,192951,192953,1,3,0
55007,2,1,192952,192953,192954,1,2,0
55008,4,1,192956,192956,192957,0,1,2
55009,4,3,192960,192960,192963,0,3,3
55010,4,3,192964,192964,192967,0,3,1
55011,2,3,192966,192967,192970,1,4,0
55012,3,1,192969,192970,192971,1,2,0
55013,4,3,192973,192973,192976,0,3,2
55014,5,2,192978,192978,192980,0,2,2
55015,1,2,192979,192980,192982,1,3,0
55016,5,1,192984,192984,192985,0,1,2
55017,1,1,192985,192985,192986,0,1,0
55018,4,1,192989,192989,192990,0,1,3
55019,6,1,192995,192995,192996,0,1,5
55020,4,2,192999,192999,193001,0,2,3
55021,1,1,193000,193001,193002,1,2,0
55022,3,1,193003,193003,193004,0,1,1
55023,4,2,193007,193007,193009,0,2,3
55024,1,3,193008,193009,193012,1,4,0
55025,1,2,193009,193012,193014,3,5,0
55026,4,1,193013,193014,193015,1,2,0
55027,6,2,193019,193019,193021,0,2,4
55028,6,3,193025,193025,193028,0,3,4
55029,6,1,193031,193031,193032,0,1,3
55030,3,1,193034,193034,193035,0,1,2
55031,1,1,193035,193035,193036,0,1,0
55032,1,3,193036,193036,193039,0,3,0
55033,5,3,193041,193041,193044,0,3,2
55034,4,2,193045,193045,193047,0,2,1
55035,1,1,193046,193047,193048,1,2,0
55036,4,1,193050,193050,193051,0,1,2
55037,2,3,193052,193052,193055,0,3,1
55038,4,1,193056,193056,193057,0,1,1
55039,5,1,193061,193061,193062,0,1,4
55040,6,3,193067,193067,193070,0,3,5
55041,1,1,193068,193070,193071,2,3,0
55042,3,2,193071,193071,193073,0,2,0
55043,5,3,193076,193076,193079,0,3,3
55044,2,1,193078,193079,193080,1,2,0
55045,3,2,193081,193081,193083,0,2,1
55046,5,3,193086,193086,193089,0,3,3
55047,2,3,193088,193089,193092,1,4,0
55048,3,1,193091,193092,193093,1,2,0
55049,5,1,193096,193096,193097,0,1,3
55050,1,3,193097,193097,193100,0,3,0
55051,2,3,193099,193100,193103,1,4,0
55052,1,1,193100,193103,193104,3,4,0
55053,2,1,193102,193104,193105,2,3,0
55054,3,1,193105,193105,193106,0,1,0
55055,3,1,193108,193108,193109,0,1,2
55056,3,1,193111,193111,193112,0,1,2
55057,2,3,193113,193113,193116,0,3,1
55058,4,3,193117,193117,193120,0,3,1
55059,6,3,193123,193123,193126,0,3,3
55060,3,1,193126,193126,193127,0,1,0
55061,2,2,193128,193128,193130,0,2,1
55062,6,3,193134,193134,193137,0,3,4
55063,1,2,193135,193137,193139,2,4,0
55064,4,1,193139,193139,193140,0,1,0
55065,6,3,193145,193145,193148,0,3,5
55066,1,1,193146,193148,193149,2,3,0
55067,5,1,193151,193151,193152,0,1,2
55068,2,2,193153,193153,193155,0,2,1
55069,3,2,193156,193156,193158,0,2,1
55070,5,3,193161,193161,193164,0,3,3
55071,6,3,193167,193167,193170,0,3,3
55072,4,3,193171,193171,193174,0,3,1
55073,3,3,193174,193174,193177,0,3,0
55074,5,1,193179,193179,193180,0,1,2
55075,2,1,193181,193181,193182,0,1,1
55076,6,2,193187,193187,193189,0,2,5
55077,4,1,193191,193191,193192,0,1,2
55078,1,1,193192,193192,193193,0,1,0
55079,6,2,193198,193198,193200,0,2,5
55080,3,2,193201,193201,193203,0,2,1
55081,5,3,193206,193206,193209,0,3,3
55082,6,1,193212,193212,193213,0,1,3
55083,6,3,193218,193218,193221,0,3,5
55084,4,3,193222,193222,193225,0,3,1
55085,5,3,193227,193227,193230,0,3,2
55086,3,1,193230,193230,193231,0,1,0
55087,5,3,193235,193235,193238,0,3,4
55088,6,3,193241,193241,193244,0,3,3
55089,5,3,193246,193246,193249,0,3,2
55090,6,1,193252,193252,193253,0,1,3
55091,4,1,193256,193256,193257,0,1,3
55092,5,2,193261,193261,193263,0,2,4
55093,5,1,193266,193266,193267,0,1,3
55094,5,3,193271,193271,193274,0,3,4
55095,2,2,193273,193274,193276,1,3,0
55096,3,3,193276,193276,193279,0,3,0
55097,6,2,193282,193282,193284,0,2,3
55098,4,2,193286,193286,193288,0,2,2
55099,2,1,193288,193288,193289,0,1,0
55100,5,1,193293,193293,193294,0,1,4
55101,3,3,193296,193296,193299,0,3,2
55102,3,2,193299,193299,193301,0,2,0
55103,4,2,193303,193303,193305,0,2,2
55104,5,3,193308,193308,193311,0,3,3
55105,3,1,193311,193311,193312,0,1,0
55106,6,3,193317,193317,193320,0,3,5
55107,4,2,193321,193321,193323,0,2,1
55108,1,2,193322,193323,193325,1,3,0
55109,1,1,193323,193325,193326,2,3,0
55110,4,3,193327,193327,193330,0,3,1
55111,6,2,193333,193333,193335,0,2,3
55112,1,1,193334,193335,193336,1,2,0
55113,4,3,193338,193338,193341,0,3,2
55114,1,3,193339,193341,193344,2,5,0
55115,4,3,193343,193344,193347,1,4,0
55116,4,3,193347,193347,193350,0,3,0
55117,2,2,193349,193350,193352,1,3,0
55118,3,3,193352,193352,193355,0,3,0
55119,5,3,193357,193357,193360,0,3,2
55120,3,3,193360,193360,193363,0,3,0
55121,3,2,193363,193363,193365,0,2,0
55122,2,2,193365,193365,193367,0,2,0
55123,6,3,193371,193371,193374,0,3,4
55124,4,3,193375,193375,193378,0,3,1
55125,2,1,193377,193378,193379,1,2,0
55126,3,2,193380,193380,193382,0,2,1
55127,4,2,193384,193384,193386,0,2,2
55128,2,1,193386,193386,193387,0,1,0
55129,5,2,193391,193391,193393,0,2,4
55130,6,1,193397,193397,193398,0,1,4
55131,6,2,193403,193403,193405,0,2,5
55132,6,1,193409,193409,193410,0,1,4
55133,5,2,193414,193414,193416,0,2,4
55134,1,1,193415,193416,193417,1,2,0
55135,6,1,193421,193421,193422,0,1,4
55136,5,1,193426,193426,193427,0,1,4
55137,5,3,193431,193431,193434,0,3,4
55138,1,1,193432,193434,193435,2,3,0
55139,1,3,193433,193435,193438,2,5,0
55140,3,1,193436,193438,193439,2,3,0
55141,5,1,193441,193441,193442,0,1,2
55142,6,3,193447,193447,193450,0,3,5
55143,3,2,193450,193450,193452,0,2,0
55144,4,1,193454,193454,193455,0,1,2
55145,4,1,193458,193458,193459,0,1,3
55146,6,3,193464,193464,193467,0,3,5
55147,3,1,193467,193467,193468,0,1,0
55148,5,1,193472,193472,193473,0,1,4
55149,1,2,193473,193473,193475,0,2,0
55150,3,3,193476,193476,193479,0,3,1
55151,2,1,193478,193479,193480,1,2,0
55152,1,2,193479,193480,193482,1,3,0
55153,6,1,193485,193485,193486,0,1,3
55154,2,2,193487,193487,193489,0,2,1
55155,4,3,193491,193491,193494,0,3,2
55156,4,1,193495,193495,193496,0,1,1
55157,4,2,193499,193499,193501,0,2,3
55158,1,1,193500,193501,193502,1,2,0
55159,2,3,193502,193502,193505,0,3,0
55160,4,3,193506,193506,193509,0,3,1
55161,5,2,193511,193511,193513,0,2,2
55162,5,1,193516,193516,193517,0,1,3
55163,4,2,193520,193520,193522,0,2,3
55164,2,3,193522,193522,193525,0,3,0
55165,3,3,193525,193525,193528,0,3,0
55166,4,3,193529,193529,193532,0,3,1
55167,4,3,193533,193533,193536,0,3,1
55168,5,3,193538,193538,193541,0,3,2
55169,2,2,193540,193541,193543,1,3,0
55170,4,2,193544,193544,193546,0,2,1
55171,2,3,193546,193546,193549,0,3,0
55172,2,2,193548,193549,193551,1,3,0
55173,2,2,193550,193551,193553,1,3,0
55174,1,3,193551,193553,193556,2,5,0
55175,3,2,193554,193556,193558,2,4,0
55176,5,1,193559,193559,193560,0,1,1
55177,2,1,193561,193561,193562,0,1,1
55178,6,2,193567,193567,193569,0,2,5
55179,6,1,193573,193573,193574,0,1,4
55180,3,3,193576,193576,193579,0,3,2
55181,1,1,193577,193579,193580,2,3,0
55182,5,3,193582,193582,193585,0,3,2
55183,3,1,193585,193585,193586,0,1,0
55184,4,2,193589,193589,193591,0,2,3
55185,6,1,193595,193595,193596,0,1,4
55186,2,2,193597,193597,193599,0,2,1
55187,2,2,193599,193599,193601,0,2,0
55188,6,2,193605,193605,193607,0,2,4
55189,6,3,193611,193611,193614,0,3,4
55190,2,3,193613,193614,193617,1,4,0
55191,3,2,193616,193617,193619,1,3,0
55192,4,2,193620,193620,193622,0,2,1
55193,4,3,193624,193624,193627,0,3,2
55194,3,2,193627,193627,193629,0,2,0
55195,1,1,193628,193629,193630,1,2,0
55196,3,2,193631,193631,193633,0,2,1
55197,3,3,193634,193634,193637,0,3,1
55198,1,3,193635,193637,193640,2,5,0
55199,1,2,193636,193640,193642,4,6,0
55200,6,2,193642,193642,193644,0,2,0
55201,2,2,193644,193644,193646,0,2,0
55202,2,1,193646,193646,193647,0,1,0
55203,6,1,193652,193652,193653,0,1,5
55204,4,3,193656,193656,193659,0,3,3
55205,2,2,193658,193659,193661,1,3,0
55206,2,1,193660,193661,193662,1,2,0
55207,1,2,193661,193662,193664,1,3,0
55208,5,1,193666,193666,193667,0,1,2
55209,4,1,193670,193670,193671,0,1,3
55210,2,1,193672,193672,193673,0,1,1
55211,2,2,193674,193674,193676,0,2,1
55212,4,2,193678,193678,193680,0,2,2
55213,3,2,193681,193681,193683,0,2,1
55214,2,1,193683,193683,193684,0,1,0
55215,3,3,193686,193686,193689,0,3,2
55216,6,1,193692,193692,193693,0,1,3
55217,2,2,193694,193694,193696,0,2,1
55218,2,2,193696,193696,193698,0,2,0
55219,3,3,193699,193699,193702,0,3,1
55220,4,3,193703,193703,193706,0,3,1
55221,1,3,193704,193706,193709,2,5,0
55222,3,1,193707,193709,193710,2,3,0
55223,5,1,193712,193712,193713,0,1,2
55224,6,2,193718,193718,193720,0,2,5
55225,6,1,193724,193724,193725,0,1,4
55226,6,2,193730,193730,193732,0,2,5
55227,4,1,193734,193734,193735,0,1,2
55228,5,1,193739,193739,193740,0,1,4
55229,4,1,193743,193743,193744,0,1,3
55230,6,1,193749,193749,193750,0,1,5
55231,5,3,193754,193754,193757,0,3,4
55232,3,3,193757,193757,193760,0,3,0
55233,2,3,193759,193760,193763,1,4,0
55234,2,1,193761,193763,193764,2,3,0
55235,1,3,193762,193764,193767,2,5,0
55236,1,3,193763,193767,193770,4,7,0
55237,3,3,193766,193770,193773,4,7,0
55238,6,3,193772,193773,193776,1,4,0
55239,6,2,193778,193778,193780,0,2,2
55240,6,2,193784,193784,193786,0,2,4
55241,3,3,193787,193787,193790,0,3,1
55242,6,3,193793,193793,193796,0,3,3
55243,6,2,193799,193799,193801,0,2,3
55244,5,3,193804,193804,193807,0,3,3
55245,3,2,193807,193807,193809,0,2,0
55246,1,3,193808,193809,193812,1,4,0
55247,1,2,193809,193812,193814,3,5,0
55248,5,2,193814,193814,193816,0,2,0
55249,5,2,193819,193819,193821,0,2,3
55250,1,2,193820,193821,193823,1,3,0
55251,6,1,193826,193826,193827,0,1,3
55252,2,1,193828,193828,193829,0,1,1
55253,5,3,193833,193833,193836,0,3,4
55254,3,2,193836,193836,193838,0,2,0
55255,1,1,193837,193838,193839,1,2,0
55256,6,2,193843,193843,193845,0,2,4
55257,5,1,193848,193848,193849,0,1,3
55258,5,3,193853,193853,193856,0,3,4
55259,4,2,193857,193857,193859,0,2,1
55260,5,3,193862,193862,193865,0,3,3
55261,3,2,193865,193865,193867,0,2,0
55262,1,2,193866,193867,193869,1,3,0
55263,3,2,193869,193869,193871,0,2,0
55264,4,2,193873,193873,193875,0,2,2
55265,6,2,193879,193879,193881,0,2,4
55266,4,2,193883,193883,193885,0,2,2
55267,6,2,193889,193889,193891,0,2,4
55268,5,2,193894,193894,193896,0,2,3
55269,3,3,193897,193897,193900,0,3,1
55270,3,3,193900,193900,193903,0,3,0
55271,2,1,193902,193903,193904,1,2,0
55272,5,3,193907,193907,193910,0,3,3
55273,2,1,193909,193910,193911,1,2,0
55274,5,3,193914,193914,193917,0,3,3
55275,6,2,193920,193920,193922,0,2,3
55276,3,2,193923,193923,193925,0,2,1
55277,1,1,193924,193925,193926,1,2,0
55278,3,3,193927,193927,193930,0,3,1
55279,3,3,193930,193930,193933,0,3,0
55280,5,2,193935,193935,193937,0,2,2
55281,5,3,193940,193940,193943,0,3,3
55282,1,3,193941,193943,193946,2,5,0
55283,6,3,193947,193947,193950,0,3,1
55284,1,2,193948,193950,193952,2,4,0
55285,5,2,193953,193953,193955,0,2,1
55286,3,1,193956,193956,193957,0,1,1
55287,1,3,193957,193957,193960,0,3,0
55288,6,1,193963,193963,193964,0,1,3
55289,1,1,193964,193964,193965,0,1,0
55290,2,1,193966,193966,193967,0,1,1
55291,3,3,193969,193969,193972,0,3,2
55292,3,1,193972,193972,193973,0,1,0
55293,4,3,193976,193976,193979,0,3,3
55294,1,2,193977,193979,193981,2,4,0
55295,6,2,193983,193983,193985,0,2,2
55296,3,3,193986,193986,193989,0,3,1
55297,5,2,193991,193991,193993,0,2,2
55298,2,2,193993,193993,193995,0,2,0
55299,5,3,193998,193998,194001,0,3,3
55300,4,1,194002,194002,194003,0,1,1
55301,4,1,194006,194006,194007,0,1,3
55302,1,2,194007,194007,194009,0,2,0
55303,6,3,194013,194013,194016,0,3,4
55304,5,1,194018,194018,194019,0,1,2
55305,1,1,194019,194019,194020,0,1,0
55306,4,3,194023,194023,194026,0,3,3
55307,1,3,194024,194026,194029,2,5,0
55308,5,1,194029,194029,194030,0,1,0
55309,5,2,194034,194034,194036,0,2,4
55310,6,1,194040,194040,194041,0,1,4
55311,2,1,194042,194042,194043,0,1,1
55312,1,1,194043,194043,194044,0,1,0
55313,3,3,194046,194046,194049,0,3,2
55314,4,1,194050,194050,194051,0,1,1
55315,4,2,194054,194054,194056,0,2,3
55316,4,2,194058,194058,194060,0,2,2
55317,2,1,194060,194060,194061,0,1,0
55318,3,1,194063,194063,194064,0,1,2
55319,5,2,194068,194068,194070,0,2,4
55320,3,1,194071,194071,194072,0,1,1
55321,5,1,194076,194076,194077,0,1,4
55322,5,3,194081,194081,194084,0,3,4
55323,3,3,194084,194084,194087,0,3,0
55324,6,3,194090,194090,194093,0,3,3
55325,4,2,194094,194094,194096,0,2,1
55326,3,3,194097,194097,194100,0,3,1
55327,4,1,194101,194101,194102,0,1,1
55328,2,2,194103,194103,194105,0,2,1
55329,1,3,194104,194105,194108,1,4,0
55330,5,3,194109,194109,194112,0,3,1
55331,3,1,194112,194112,194113,0,1,0
55332,5,3,194117,194117,194120,0,3,4
55333,6,1,194123,194123,194124,0,1,3
55334,4,1,194127,194127,194128,0,1,3
55335,2,1,194129,194129,194130,0,1,1
55336,1,3,194130,194130,194133,0,3,0
55337,6,1,194136,194136,194137,0,1,3
55338,3,1,194139,194139,194140,0,1,2
55339,2,3,194141,194141,194144,0,3,1
55340,3,2,194144,194144,194146,0,2,0
55341,2,3,194146,194146,194149,0,3,0
55342,3,2,194149,194149,194151,0,2,0
55343,4,1,194153,194153,194154,0,1,2
55344,2,1,194155,194155,194156,0,1,1
55345,1,3,194156,194156,194159,0,3,0
55346,4,1,194160,194160,194161,0,1,1
55347,5,2,194165,194165,194167,0,2,4
55348,2,2,194167,194167,194169,0,2,0
55349,1,2,194168,194169,194171,1,3,0
55350,5,2,194173,194173,194175,0,2,2
55351,5,2,194178,194178,194180,0,2,3
55352,6,1,194184,194184,194185,0,1,4
55353,4,2,194188,194188,194190,0,2,3
55354,2,3,194190,194190,194193,0,3,0
55355,1,3,194191,194193,194196,2,5,0
55356,2,3,194193,194196,194199,3,6,0
55357,6,3,194199,194199,194202,0,3,0
55358,6,3,194205,194205,194208,0,3,3
55359,2,3,194207,194208,194211,1,4,0
55360,6,3,194213,194213,194216,0,3,2
55361,1,2,194214,194216,194218,2,4,0
55362,5,3,194219,194219,194222,0,3,1
55363,4,3,194223,194223,194226,0,3,1
55364,3,1,194226,194226,194227,0,1,0
55365,6,1,194232,194232,194233,0,1,5
55366,2,2,194234,194234,194236,0,2,1
55367,5,3,194239,194239,194242,0,3,3
55368,6,3,194245,194245,194248,0,3,3
55369,1,2,194246,194248,194250,2,4,0
55370,2,2,194248,194250,194252,2,4,0
55371,6,3,194254,194254,194257,0,3,2
55372,3,2,194257,194257,194259,0,2,0
55373,4,3,194261,194261,194264,0,3,2
55374,5,1,194266,194266,194267,0,1,2
55375,4,1,194270,194270,194271,0,1,3
55376,1,1,194271,194271,194272,0,1,0
55377,4,3,194275,194275,194278,0,3,3
55378,3,1,194278,194278,194279,0,1,0
55379,2,2,194280,194280,194282,0,2,1
55380,3,1,194283,194283,194284,0,1,1
55381,2,2,194285,194285,194287,0,2,1
55382,6,2,194291,194291,194293,0,2,4
55383,1,3,194292,194293,194296,1,4,0
55384,6,2,194298,194298,194300,0,2,2
55385,5,1,194303,194303,194304,0,1,3
55386,5,3,194308,194308,194311,0,3,4
55387,6,3,194314,194314,194317,0,3,3
55388,4,1,194318,194318,194319,0,1,1
55389,5,3,194323,194323,194326,0,3,4
55390,5,2,194328,194328,194330,0,2,2
55391,2,2,194330,194330,194332,0,2,0
55392,3,1,194333,194333,194334,0,1,1
55393,2,2,194335,194335,194337,0,2,1
55394,5,2,194340,194340,194342,0,2,3
55395,3,1,194343,194343,194344,0,1,1
55396,3,3,194346,194346,194349,0,3,2
55397,2,2,194348,194349,194351,1,3,0
55398,4,2,194352,194352,194354,0,2,1
55399,4,1,194356,194356,194357,0,1,2
55400,3,1,194359,194359,194360,0,1,2
55401,6,2,194365,194365,194367,0,2,5
55402,2,2,194367,194367,194369,0,2,0
55403,1,2,194368,194369,194371,1,3,0
55404,1,3,194369,194371,194374,2,5,0
55405,3,1,194372,194374,194375,2,3,0
55406,2,3,194374,194375,194378,1,4,0
55407,3,1,194377,194378,194379,1,2,0
55408,6,3,194383,194383,194386,0,3,4
55409,4,1,194387,194387,194388,0,1,1
55410,2,2,194389,194389,194391,0,2,1
55411,1,1,194390,194391,194392,1,2,0
55412,2,1,194392,194392,194393,0,1,0
55413,1,2,194393,194393,194395,0,2,0
55414,4,3,194397,194397,194400,0,3,2
55415,6,3,194403,194403,194406,0,3,3
55416,2,2,194405,194406,194408,1,3,0
55417,3,1,194408,194408,194409,0,1,0
55418,3,1,194411,194411,194412,0,1,2
55419,4,2,194415,194415,194417,0,2,3
55420,6,2,194421,194421,194423,0,2,4
55421,5,1,194426,194426,194427,0,1,3
55422,3,1,194429,194429,194430,0,1,2
55423,5,2,194434,194434,194436,0,2,4
55424,3,1,194437,194437,194438,0,1,1
55425,1,2,194438,194438,194440,0,2,0
55426,5,3,194443,194443,194446,0,3,3
55427,2,1,194445,194446,194447,1,2,0
55428,4,3,194449,194449,194452,0,3,2
55429,5,1,194454,194454,194455,0,1,2
55430,4,3,194458,194458,194461,0,3,3
55431,5,3,194463,194463,194466,0,3,2
55432,3,3,194466,194466,194469,0,3,0
55433,5,1,194471,194471,194472,0,1,2
55434,5,3,194476,194476,194479,0,3,4
55435,6,2,194482,194482,194484,0,2,3
55436,5,2,194487,194487,194489,0,2,3
55437,6,1,194493,194493,194494,0,1,4
55438,6,1,194499,194499,194500,0,1,5
55439,3,3,194502,194502,194505,0,3,2
55440,4,2,194506,194506,194508,0,2,1
55441,5,2,194511,194511,194513,0,2,3
55442,1,2,194512,194513,194515,1,3,0
55443,1,2,194513,194515,194517,2,4,0
55444,6,2,194519,194519,194521,0,2,2
55445,1,1,194520,194521,194522,1,2,0
55446,5,2,194525,194525,194527,0,2,3
55447,3,3,194528,194528,194531,0,3,1
55448,5,1,194533,194533,194534,0,1,2
55449,3,3,194536,194536,194539,0,3,2
55450,2,3,194538,194539,194542,1,4,0
55451,4,3,194542,194542,194545,0,3,0
55452,3,3,194545,194545,194548,0,3,0
55453,2,3,194547,194548,194551,1,4,0
55454,6,2,194553,194553,194555,0,2,2
55455,6,2,194559,194559,194561,0,2,4
55456,2,1,194561,194561,194562,0,1,0
55457,6,2,194567,194567,194569,0,2,5
55458,3,2,194570,194570,194572,0,2,1
55459,2,3,194572,194572,194575,0,3,0
55460,2,2,194574,194575,194577,1,3,0
55461,3,3,194577,194577,194580,0,3,0
55462,3,3,194580,194580,194583,0,3,0
55463,3,1,194583,194583,194584,0,1,0
55464,3,1,194586,194586,194587,0,1,2
55465,2,1,194588,194588,194589,0,1,1
55466,2,2,194590,194590,194592,0,2,1
55467,5,1,194595,194595,194596,0,1,3
55468,4,2,194599,194599,194601,0,2,3
55469,1,2,194600,194601,194603,1,3,0
55470,6,3,194606,194606,194609,0,3,3
55471,5,2,194611,194611,194613,0,2,2
55472,3,2,194614,194614,194616,0,2,1
55473,2,2,194616,194616,194618,0,2,0
55474,5,1,194621,194621,194622,0,1,3
55475,2,2,194623,194623,194625,0,2,1
55476,2,2,194625,194625,194627,0,2,0
55477,5,1,194630,194630,194631,0,1,3
55478,4,3,194634,194634,194637,0,3,3
55479,1,1,194635,194637,194638,2,3,0
55480,6,2,194641,194641,194643,0,2,3
55481,6,1,194647,194647,194648,0,1,4
55482,5,3,194652,194652,194655,0,3,4
55483,6,3,194658,194658,194661,0,3,3
55484,1,3,194659,194661,194664,2,5,0
55485,3,1,194662,194664,194665,2,3,0
55486,2,1,194664,194665,194666,1,2,0
55487,3,3,194667,194667,194670,0,3,1
55488,2,2,194669,194670,194672,1,3,0
55489,6,2,194675,194675,194677,0,2,3
55490,1,1,194676,194677,194678,1,2,0
55491,4,1,194680,194680,194681,0,1,2
55492,5,3,194685,194685,194688,0,3,4
55493,6,1,194691,194691,194692,0,1,3
55494,4,2,194695,194695,194697,0,2,3
55495,5,1,194700,194700,194701,0,1,3
55496,2,1,194702,194702,194703,0,1,1
55497,5,2,194707,194707,194709,0,2,4
55498,5,3,194712,194712,194715,0,3,3
55499,4,1,194716,194716,194717,0,1,1
55500,5,2,194721,194721,194723,0,2,4
55501,2,2,194723,194723,194725,0,2,0
55502,5,3,194728,194728,194731,0,3,3
55503,4,3,194732,194732,194735,0,3,1
55504,6,1,194738,194738,194739,0,1,3
55505,6,3,194744,194744,194747,0,3,5
55506,6,2,194750,194750,194752,0,2,3
55507,3,3,194753,194753,194756,0,3,1
55508,5,2,194758,194758,194760,0,2,2
55509,3,3,194761,194761,194764,0,3,1
55510,5,2,194766,194766,194768,0,2,2
55511,4,1,194770,194770,194771,0,1,2
55512,3,1,194773,194773,194774,0,1,2
55513,2,3,194775,194775,194778,0,3,1
55514,2,2,194777,194778,194780,1,3,0
55515,1,1,194778,194780,194781,2,3,0
55516,6,2,194784,194784,194786,0,2,3
55517,1,2,194785,194786,194788,1,3,0
55518,2,3,194787,194788,194791,1,4,0
55519,2,2,194789,194791,194793,2,4,0
55520,3,2,194792,194793,194795,1,3,0
55521,6,1,194798,194798,194799,0,1,3
55522,3,1,194801,194801,194802,0,1,2
55523,3,3,194804,194804,194807,0,3,2
55524,2,1,194806,194807,194808,1,2,0
55525,6,1,194812,194812,194813,0,1,4
55526,6,3,194818,194818,194821,0,3,5
55527,5,2,194823,194823,194825,0,2,2
55528,1,3,194824,194825,194828,1,4,0
55529,4,2,194828,194828,194830,0,2,0
55530,1,3,194829,194830,194833,1,4,0
55531,1,1,194830,194833,194834,3,4,0
55532,5,1,194835,194835,194836,0,1,1
55533,5,1,194840,194840,194841,0,1,4
55534,3,2,194843,194843,194845,0,2,2
55535,6,3,194849,194849,194852,0,3,4
55536,1,2,194850,194852,194854,2,4,0
55537,5,1,194855,194855,194856,0,1,1
55538,6,2,194861,194861,194863,0,2,5
55539,2,2,194863,194863,194865,0,2,0
55540,6,1,194869,194869,194870,0,1,4
55541,6,1,194875,194875,194876,0,1,5
55542,6,3,194881,194881,194884,0,3,5
55543,6,2,194887,194887,194889,0,2,3
55544,3,2,194890,194890,194892,0,2,1
55545,1,1,194891,194892,194893,1,2,0
55546,1,3,194892,194893,194896,1,4,0
55547,2,3,194894,194896,194899,2,5,0
55548,1,1,194895,194899,194900,4,5,0
55549,3,3,194898,194900,194903,2,5,0
55550,3,3,194901,194903,194906,2,5,0
55551,2,3,194903,194906,194909,3,6,0
55552,3,2,194906,194909,194911,3,5,0
55553,3,1,194909,194911,194912,2,3,0
55554,4,1,194913,194913,194914,0,1,1
55555,3,2,194916,194916,194918,0,2,2
55556,1,2,194917,194918,194920,1,3,0
55557,6,3,194923,194923,194926,0,3,3
55558,5,2,194928,194928,194930,0,2,2
55559,3,2,194931,194931,194933,0,2,1
55560,5,2,194936,194936,194938,0,2,3
55561,2,1,194938,194938,194939,0,1,0
55562,4,2,194942,194942,194944,0,2,3
55563,5,2,194947,194947,194949,0,2,3
55564,5,3,194952,194952,194955,0,3,3
55565,6,2,194958,194958,194960,0,2,3
55566,3,1,194961,194961,194962,0,1,1
55567,6,3,194967,194967,194970,0,3,5
55568,3,2,194970,194970,194972,0,2,0
55569,4,2,194974,194974,194976,0,2,2
55570,5,1,194979,194979,194980,0,1,3
55571,1,3,194980,194980,194983,0,3,0
55572,2,1,194982,194983,194984,1,2,0
55573,6,2,194988,194988,194990,0,2,4
55574,3,2,194991,194991,194993,0,2,1
55575,6,1,194997,194997,194998,0,1,4
55576,2,3,194999,194999,195002,0,3,1
55577,4,2,195003,195003,195005,0,2,1
55578,2,3,195005,195005,195008,0,3,0
55579,4,2,195009,195009,195011,0,2,1
55580,5,1,195014,195014,195015,0,1,3
55581,1,3,195015,195015,195018,0,3,0
55582,5,3,195020,195020,195023,0,3,2
55583,2,1,195022,195023,195024,1,2,0
55584,6,1,195028,195028,195029,0,1,4
55585,4,3,195032,195032,195035,0,3,3
55586,4,1,195036,195036,195037,0,1,1
55587,3,3,195039,195039,195042,0,3,2
55588,5,3,195044,195044,195047,0,3,2
55589,3,1,195047,195047,195048,0,1,0
55590,1,2,195048,195048,195050,0,2,0
55591,6,2,195054,195054,195056,0,2,4
55592,5,2,195059,195059,195061,0,2,3
55593,1,2,195060,195061,195063,1,3,0
55594,1,1,195061,195063,195064,2,3,0
55595,3,1,195064,195064,195065,0,1,0
55596,5,2,195069,195069,195071,0,2,4
55597,1,2,195070,195071,195073,1,3,0
55598,3,2,195073,195073,195075,0,2,0
55599,3,3,195076,195076,195079,0,3,1
55600,5,3,195081,195081,195084,0,3,2
55601,5,1,195086,195086,195087,0,1,2
55602,3,1,195089,195089,195090,0,1,2
55603,1,3,195090,195090,195093,0,3,0
55604,3,1,195093,195093,195094,0,1,0
55605,3,3,195096,195096,195099,0,3,2
55606,3,3,195099,195099,195102,0,3,0
55607,1,2,195100,195102,195104,2,4,0
55608,5,3,195105,195105,195108,0,3,1
55609,5,1,195110,195110,195111,0,1,2
55610,2,2,195112,195112,195114,0,2,1
55611,2,1,195114,195114,195115,0,1,0
55612,1,1,195115,195115,195116,0,1,0
55613,6,3,195121,195121,195124,0,3,5
55614,1,3,195122,195124,195127,2,5,0
55615,6,1,195128,195128,195129,0,1,1
55616,1,3,195129,195129,195132,0,3,0
55617,1,3,195130,195132,195135,2,5,0
55618,3,3,195133,195135,195138,2,5,0
55619,2,1,195135,195138,195139,3,4,0
55620,3,3,195138,195139,195142,1,4,0
55621,1,3,195139,195142,195145,3,6,0
55622,1,2,195140,195145,195147,5,7,0
55623,4,2,195144,195147,195149,3,5,0
55624,4,1,195148,195149,195150,1,2,0
55625,1,2,195149,195150,195152,1,3,0
55626,1,3,195150,195152,195155,2,5,0
55627,6,1,195156,195156,195157,0,1,1
55628,5,3,195161,195161,195164,0,3,4
55629,5,2,195166,195166,195168,0,2,2
55630,2,1,195168,195168,195169,0,1,0
55631,2,1,195170,195170,195171,0,1,1
55632,6,3,195176,195176,195179,0,3,5
55633,4,1,195180,195180,195181,0,1,1
55634,1,2,195181,195181,195183,0,2,0
55635,6,1,195187,195187,195188,0,1,4
55636,5,2,195192,195192,195194,0,2,4
55637,1,2,195193,195194,195196,1,3,0
55638,4,1,195197,195197,195198,0,1,1
55639,4,1,195201,195201,195202,0,1,3
55640,1,2,195202,195202,195204,0,2,0
55641,5,2,195207,195207,195209,0,2,3
55642,4,3,195211,195211,195214,0,3,2
55643,2,2,195213,195214,195216,1,3,0
55644,5,1,195218,195218,195219,0,1,2
55645,6,3,195224,195224,195227,0,3,5
55646,2,2,195226,195227,195229,1,3,0
55647,4,1,195230,195230,195231,0,1,1
55648,5,2,195235,195235,195237,0,2,4
55649,6,3,195241,195241,195244,0,3,4
55650,6,3,195247,195247,195250,0,3,3
55651,3,1,195250,195250,195251,0,1,0
55652,1,2,195251,195251,195253,0,2,0
55653,4,3,195255,195255,195258,0,3,2
55654,3,3,195258,195258,195261,0,3,0
55655,1,1,195259,195261,195262,2,3,0
55656,4,2,195263,195263,195265,0,2,1
55657,4,2,195267,195267,195269,0,2,2
55658,3,1,195270,195270,195271,0,1,1
55659,2,1,195272,195272,195273,0,1,1
55660,2,1,195274,195274,195275,0,1,1
55661,6,1,195280,195280,195281,0,1,5
55662,3,3,195283,195283,195286,0,3,2
55663,6,1,195289,195289,195290,0,1,3
55664,5,1,195294,195294,195295,0,1,4
55665,6,2,195300,195300,195302,0,2,5
55666,3,3,195303,195303,195306,0,3,1
55667,1,3,195304,195306,195309,2,5,0
55668,6,1,195310,195310,195311,0,1,1
55669,4,3,195314,195314,195317,0,3,3
55670,3,3,195317,195317,195320,0,3,0
55671,2,3,195319,195320,195323,1,4,0
55672,6,1,195325,195325,195326,0,1,2
55673,4,3,195329,195329,195332,0,3,3
55674,6,3,195335,195335,195338,0,3,3
55675,2,1,195337,195338,195339,1,2,0
55676,1,3,195338,195339,195342,1,4,0
55677,4,2,195342,195342,195344,0,2,0
55678,1,1,195343,195344,195345,1,2,0
55679,1,1,195344,195345,195346,1,2,0
55680,5,3,195349,195349,195352,0,3,3
55681,4,1,195353,195353,195354,0,1,1
55682,2,3,195355,195355,195358,0,3,1
55683,4,3,195359,195359,195362,0,3,1
55684,4,2,195363,195363,195365,0,2,1
55685,2,3,195365,195365,195368,0,3,0
55686,2,3,195367,195368,195371,1,4,0
55687,4,2,195371,195371,195373,0,2,0
55688,1,3,195372,195373,195376,1,4,0
55689,3,1,195375,195376,195377,1,2,0
55690,5,1,195380,195380,195381,0,1,3
55691,2,2,195382,195382,195384,0,2,1
55692,5,3,195387,195387,195390,0,3,3
55693,3,2,195390,195390,195392,0,2,0
55694,4,2,195394,195394,195396,0,2,2
55695,6,2,195400,195400,195402,0,2,4
55696,4,1,195404,195404,195405,0,1,2
55697,4,2,195408,195408,195410,0,2,3
55698,2,3,195410,195410,195413,0,3,0
55699,6,1,195416,195416,195417,0,1,3
55700,2,3,195418,195418,195421,0,3,1
55701,2,3,195420,195421,195424,1,4,0
55702,5,2,195425,195425,195427,0,2,1
55703,4,1,195429,195429,195430,0,1,2
55704,2,1,195431,195431,195432,0,1,1
55705,5,1,195436,195436,195437,0,1,4
55706,4,1,195440,195440,195441,0,1,3
55707,4,2,195444,195444,195446,0,2,3
55708,1,1,195445,195446,195447,1,2,0
55709,5,1,195450,195450,195451,0,1,3
55710,3,2,195453,195453,195455,0,2,2
55711,2,1,195455,195455,195456,0,1,0
55712,4,2,195459,195459,195461,0,2,3
55713,5,3,195464,195464,195467,0,3,3
55714,3,1,195467,195467,195468,0,1,0
55715,4,2,195471,195471,195473,0,2,3
55716,1,3,195472,195473,195476,1,4,0
55717,4,3,195476,195476,195479,0,3,0
55718,4,3,195480,195480,195483,0,3,1
55719,3,1,195483,195483,195484,0,1,0
55720,6,1,195489,195489,195490,0,1,5
55721,4,1,195493,195493,195494,0,1,3
55722,6,1,195499,195499,195500,0,1,5
55723,6,3,195505,195505,195508,0,3,5
55724,4,3,195509,195509,195512,0,3,1
55725,2,2,195511,195512,195514,1,3,0
55726,2,3,195513,195514,195517,1,4,0
55727,2,3,195515,195517,195520,2,5,0
55728,1,3,195516,195520,195523,4,7,0
55729,5,1,195521,195523,195524,2,3,0
55730,5,3,195526,195526,195529,0,3,2
55731,1,2,195527,195529,195531,2,4,0
55732,6,3,195533,195533,195536,0,3,2
55733,1,3,195534,195536,195539,2,5,0
55734,3,1,195537,195539,195540,2,3,0
55735,5,3,195542,195542,195545,0,3,2
55736,3,3,195545,195545,195548,0,3,0
55737,5,2,195550,195550,195552,0,2,2
55738,2,1,195552,195552,195553,0,1,0
55739,5,2,195557,195557,195559,0,2,4
55740,1,1,195558,195559,195560,1,2,0
55741,6,2,195564,195564,195566,0,2,4
55742,5,1,195569,195569,195570,0,1,3
55743,3,3,195572,195572,195575,0,3,2
55744,5,2,195577,195577,195579,0,2,2
55745,3,1,195580,195580,195581,0,1,1
55746,3,3,195583,195583,195586,0,3,2
55747,1,1,195584,195586,195587,2,3,0
55748,2,2,195586,195587,195589,1,3,0
55749,4,2,195590,195590,195592,0,2,1
55750,2,3,195592,195592,195595,0,3,0
55751,3,3,195595,195595,195598,0,3,0
55752,6,1,195601,195601,195602,0,1,3
55753,1,1,195602,195602,195603,0,1,0
55754,2,3,195604,195604,195607,0,3,1
55755,6,1,195610,195610,195611,0,1,3
55756,1,3,195611,195611,195614,0,3,0
55757,1,1,195612,195614,195615,2,3,0
55758,3,1,195615,195615,195616,0,1,0
55759,3,2,195618,195618,195620,0,2,2
55760,6,3,195624,195624,195627,0,3,4
55761,1,2,195625,195627,195629,2,4,0
55762,6,3,195631,195631,195634,0,3,2
55763,6,3,195637,195637,195640,0,3,3
55764,1,1,195638,195640,195641,2,3,0
55765,4,2,195642,195642,195644,0,2,1
55766,6,3,195648,195648,195651,0,3,4
55767,1,2,195649,195651,195653,2,4,0
55768,6,2,195655,195655,195657,0,2,2
55769,2,1,195657,195657,195658,0,1,0
55770,4,2,195661,195661,195663,0,2,3
55771,3,3,195664,195664,195667,0,3,1
55772,3,3,195667,195667,195670,0,3,0
55773,5,1,195672,195672,195673,0,1,2
55774,2,2,195674,195674,195676,0,2,1
55775,6,3,195680,195680,195683,0,3,4
55776,3,2,195683,195683,195685,0,2,0
55777,4,1,195687,195687,195688,0,1,2
55778,2,1,195689,195689,195690,0,1,1
55779,3,2,195692,195692,195694,0,2,2
55780,1,2,195693,195694,195696,1,3,0
55781,6,3,195699,195699,195702,0,3,3
55782,3,1,195702,195702,195703,0,1,0
55783,1,3,195703,195703,195706,0,3,0
55784,5,1,195708,195708,195709,0,1,2
55785,6,1,195714,195714,195715,0,1,5
55786,2,1,195716,195716,195717,0,1,1
55787,1,1,195717,195717,195718,0,1,0
55788,4,2,195721,195721,195723,0,2,3
55789,1,1,195722,195723,195724,1,2,0
55790,1,2,195723,195724,195726,1,3,0
55791,4,1,195727,195727,195728,0,1,1
55792,3,2,195730,195730,195732,0,2,2
55793,4,2,195734,195734,195736,0,2,2
55794,6,2,195740,195740,195742,0,2,4
55795,5,2,195745,195745,195747,0,2,3
55796,3,3,195748,195748,195751,0,3,1
55797,4,1,195752,195752,195753,0,1,1
55798,3,3,195755,195755,195758,0,3,2
55799,3,1,195758,195758,195759,0,1,0
55800,4,1,195762,195762,195763,0,1,3
55801,6,3,195768,195768,195771,0,3,5
55802,4,2,195772,195772,195774,0,2,1
55803,4,3,195776,195776,195779,0,3,2
55804,6,3,195782,195782,195785,0,3,3
55805,6,2,195788,195788,195790,0,2,3
55806,4,3,195792,195792,195795,0,3,2
55807,3,1,195795,195795,195796,0,1,0
55808,2,2,195797,195797,195799,0,2,1
55809,1,1,195798,195799,195800,1,2,0
55810,4,3,195802,195802,195805,0,3,2
55811,3,2,195805,195805,195807,0,2,0
55812,1,1,195806,195807,195808,1,2,0
55813,2,3,195808,195808,195811,0,3,0
55814,2,2,195810,195811,195813,1,3,0
55815,5,2,195815,195815,195817,0,2,2
55816,5,3,195820,195820,195823,0,3,3
55817,4,2,195824,195824,195826,0,2,1
55818,3,1,195827,195827,195828,0,1,1
55819,1,1,195828,195828,195829,0,1,0
55820,2,2,195830,195830,195832,0,2,1
55821,5,1,195835,195835,195836,0,1,3
55822,5,2,195840,195840,195842,0,2,4
55823,6,3,195846,195846,195849,0,3,4
55824,2,3,195848,195849,195852,1,4,0
55825,3,2,195851,195852,195854,1,3,0
55826,1,2,195852,195854,195856,2,4,0
55827,3,2,195855,195856,195858,1,3,0
55828,6,1,195861,195861,195862,0,1,3
55829,3,1,195864,195864,195865,0,1,2
55830,4,1,195868,195868,195869,0,1,3
55831,4,1,195872,195872,195873,0,1,3
55832,4,3,195876,195876,195879,0,3,3
55833,6,2,195882,195882,195884,0,2,3
55834,3,2,195885,195885,195887,0,2,1
55835,4,2,195889,195889,195891,0,2,2
55836,6,3,195895,195895,195898,0,3,4
55837,3,1,195898,195898,195899,0,1,0
55838,3,1,195901,195901,195902,0,1,2
55839,1,1,195902,195902,195903,0,1,0
55840,3,1,195905,195905,195906,0,1,2
55841,2,1,195907,195907,195908,0,1,1
55842,6,1,195913,195913,195914,0,1,5
55843,1,2,195914,195914,195916,0,2,0
55844,6,2,195920,195920,195922,0,2,4
55845,4,2,195924,195924,195926,0,2,2
55846,1,1,195925,195926,195927,1,2,0
55847,3,3,195928,195928,195931,0,3,1
55848,3,2,195931,195931,195933,0,2,0
55849,6,3,195937,195937,195940,0,3,4
55850,6,3,195943,195943,195946,0,3,3
55851,5,1,195948,195948,195949,0,1,2
55852,4,3,195952,195952,195955,0,3,3
55853,2,3,195954,195955,195958,1,4,0
55854,5,1,195959,195959,195960,0,1,1
55855,5,1,195964,195964,195965,0,1,4
55856,2,1,195966,195966,195967,0,1,1
55857,6,2,195972,195972,195974,0,2,5
55858,3,3,195975,195975,195978,0,3,1
55859,2,2,195977,195978,195980,1,3,0
55860,5,2,195982,195982,195984,0,2,2
55861,3,1,195985,195985,195986,0,1,1
55862,5,1,195990,195990,195991,0,1,4
55863,6,2,195996,195996,195998,0,2,5
55864,1,3,195997,195998,196001,1,4,0
55865,5,2,196002,196002,196004,0,2,1
55866,1,3,196003,196004,196007,1,4,0
55867,3,2,196006,196007,196009,1,3,0
55868,3,3,196009,196009,196012,0,3,0
55869,2,3,196011,196012,196015,1,4,0
55870,5,2,196016,196016,196018,0,2,1
55871,1,3,196017,196018,196021,1,4,0
55872,5,1,196022,196022,196023,0,1,1
55873,3,1,196025,196025,196026,0,1,2
55874,5,1,196030,196030,196031,0,1,4
55875,4,3,196034,196034,196037,0,3,3
55876,5,3,196039,196039,196042,0,3,2
55877,4,1,196043,196043,196044,0,1,1
55878,2,2,196045,196045,196047,0,2,1
55879,2,3,196047,196047,196050,0,3,0
55880,6,2,196053,196053,196055,0,2,3
55881,4,1,196057,196057,196058,0,1,2
55882,5,2,196062,196062,196064,0,2,4
55883,6,2,196068,196068,196070,0,2,4
55884,6,3,196074,196074,196077,0,3,4
55885,3,1,196077,196077,196078,0,1,0
55886,6,2,196083,196083,196085,0,2,5
55887,3,2,196086,196086,196088,0,2,1
55888,3,1,196089,196089,196090,0,1,1
55889,6,2,196095,196095,196097,0,2,5
55890,3,2,196098,196098,196100,0,2,1
55891,2,3,196100,196100,196103,0,3,0
55892,5,3,196105,196105,196108,0,3,2
55893,1,3,196106,196108,196111,2,5,0
55894,2,2,196108,196111,196113,3,5,0
55895,6,3,196114,196114,196117,0,3,1
55896,5,2,196119,196119,196121,0,2,2
55897,1,1,196120,196121,196122,1,2,0
55898,2,3,196122,196122,196125,0,3,0
55899,3,3,196125,196125,196128,0,3,0
55900,2,1,196127,196128,196129,1,2,0
55901,6,2,196133,196133,196135,0,2,4
55902,3,1,196136,196136,196137,0,1,1
55903,5,3,196141,196141,196144,0,3,4
55904,3,2,196144,196144,196146,0,2,0
55905,3,1,196147,196147,196148,0,1,1
55906,3,3,196150,196150,196153,0,3,2
55907,1,2,196151,196153,196155,2,4,0
55908,2,1,196153,196155,196156,2,3,0
55909,4,2,196157,196157,196159,0,2,1
55910,6,1,196163,196163,196164,0,1,4
55911,2,2,196165,196165,196167,0,2,1
55912,5,3,196170,196170,196173,0,3,3
55913,1,2,196171,196173,196175,2,4,0
55914,2,3,196173,196175,196178,2,5,0
55915,4,1,196177,196178,196179,1,2,0
55916,4,3,196181,196181,196184,0,3,2
55917,5,3,196186,196186,196189,0,3,2
55918,2,2,196188,196189,196191,1,3,0
55919,4,3,196192,196192,196195,0,3,1
55920,4,3,196196,196196,196199,0,3,1
55921,6,1,196202,196202,196203,0,1,3
55922,3,1,196205,196205,196206,0,1,2
55923,5,2,196210,196210,196212,0,2,4
55924,4,3,196214,196214,196217,0,3,2
55925,4,1,196218,196218,196219,0,1,1
55926,1,3,196219,196219,196222,0,3,0
55927,1,2,196220,196222,196224,2,4,0
55928,6,3,196226,196226,196229,0,3,2
55929,3,3,196229,196229,196232,0,3,0
55930,2,2,196231,196232,196234,1,3,0
55931,1,3,196232,196234,196237,2,5,0
55932,4,2,196236,196237,196239,1,3,0
55933,5,1,196241,196241,196242,0,1,2
55934,4,2,196245,196245,196247,0,2,3
55935,6,3,196251,196251,196254,0,3,4
55936,6,3,196257,196257,196260,0,3,3
55937,4,2,196261,196261,196263,0,2,1
55938,4,2,196265,196265,196267,0,2,2
55939,4,2,196269,196269,196271,0,2,2
55940,5,3,196274,196274,196277,0,3,3
55941,3,2,196277,196277,196279,0,2,0
55942,3,2,196280,196280,196282,0,2,1
55943,2,3,196282,196282,196285,0,3,0
55944,5,3,196287,196287,196290,0,3,2
55945,6,2,196293,196293,196295,0,2,3
55946,6,1,196299,196299,196300,0,1,4
55947,4,2,196303,196303,196305,0,2,3
55948,1,2,196304,196305,196307,1,3,0
55949,6,3,196310,196310,196313,0,3,3
55950,3,2,196313,196313,196315,0,2,0
55951,4,2,196317,196317,196319,0,2,2
55952,1,2,196318,196319,196321,1,3,0
55953,5,3,196323,196323,196326,0,3,2
55954,3,3,196326,196326,196329,0,3,0
55955,4,1,196330,196330,196331,0,1,1
55956,2,2,196332,196332,196334,0,2,1
55957,6,1,196338,196338,196339,0,1,4
55958,5,3,196343,196343,196346,0,3,4
55959,3,2,196346,196346,196348,0,2,0
55960,1,2,196347,196348,196350,1,3,0
55961,6,1,196353,196353,196354,0,1,3
55962,5,1,196358,196358,196359,0,1,4
55963,5,2,196363,196363,196365,0,2,4
55964,4,2,196367,196367,196369,0,2,2
55965,1,1,196368,196369,196370,1,2,0
55966,1,1,196369,196370,196371,1,2,0
55967,4,2,196373,196373,196375,0,2,2
55968,6,3,196379,196379,196382,0,3,4
55969,3,2,196382,196382,196384,0,2,0
55970,1,1,196383,196384,196385,1,2,0
55971,6,1,196389,196389,196390,0,1,4
55972,2,3,196391,196391,196394,0,3,1
55973,1,3,196392,196394,196397,2,5,0
55974,3,3,196395,196397,196400,2,5,0
55975,1,1,196396,196400,196401,4,5,0
55976,5,1,196401,196401,196402,0,1,0
55977,1,1,196402,196402,196403,0,1,0
55978,3,1,196405,196405,196406,0,1,2
55979,5,1,196410,196410,196411,0,1,4
55980,6,1,196416,196416,196417,0,1,5
55981,5,1,196421,196421,196422,0,1,4
55982,6,3,196427,196427,196430,0,3,5
55983,4,2,196431,196431,196433,0,2,1
55984,3,2,196434,196434,196436,0,2,1
55985,1,2,196435,196436,196438,1,3,0
55986,2,2,196437,196438,196440,1,3,0
55987,4,1,196441,196441,196442,0,1,1
55988,2,1,196443,196443,196444,0,1,1
55989,3,3,196446,196446,196449,0,3,2
55990,6,2,196452,196452,196454,0,2,3
55991,3,3,196455,196455,196458,0,3,1
55992,5,3,196460,196460,196463,0,3,2
55993,2,2,196462,196463,196465,1,3,0
55994,4,1,196466,196466,196467,0,1,1
55995,2,1,196468,196468,196469,0,1,1
55996,4,2,196472,196472,196474,0,2,3
55997,3,3,196475,196475,196478,0,3,1
55998,3,1,196478,196478,196479,0,1,0
55999,1,3,196479,196479,196482,0,3,0
56000,6,2,196485,196485,196487,0,2,3
56001,2,1,196487,196487,196488,0,1,0
56002,5,2,196492,196492,196494,0,2,4
56003,6,2,196498,196498,196500,0,2,4
56004,6,3,196504,196504,196507,0,3,4
56005,5,1,196509,196509,196510,0,1,2
56006,3,1,196512,196512,196513,0,1,2
56007,5,3,196517,196517,196520,0,3,4
56008,6,1,196523,196523,196524,0,1,3
56009,1,3,196524,196524,196527,0,3,0
56010,1,3,196525,196527,196530,2,5,0
56011,2,2,196527,196530,196532,3,5,0
56012,2,3,196529,196532,196535,3,6,0
56013,1,2,196530,196535,196537,5,7,0
56014,1,3,196531,196537,196540,6,9,0
56015,5,2,196536,196540,196542,4,6,0
56016,3,2,196539,196542,196544,3,5,0
56017,5,1,196544,196544,196545,0,1,0
56018,1,1,196545,196545,196546,0,1,0
56019,3,3,196548,196548,196551,0,3,2
56020,5,1,196553,196553,196554,0,1,2
56021,6,3,196559,196559,196562,0,3,5
56022,2,3,196561,196562,196565,1,4,0
56023,2,1,196563,196565,196566,2,3,0
56024,1,2,196564,196566,196568,2,4,0
56025,2,1,196566,196568,196569,2,3,0
56026,3,1,196569,196569,196570,0,1,0
56027,6,3,196575,196575,196578,0,3,5
56028,1,1,196576,196578,196579,2,3,0
56029,5,2,196581,196581,196583,0,2,2
56030,1,3,196582,196583,196586,1,4,0
56031,4,3,196586,196586,196589,0,3,0
56032,1,3,196587,196589,196592,2,5,0
56033,4,1,196591,196592,196593,1,2,0
56034,1,1,196592,196593,196594,1,2,0
56035,5,1,196597,196597,196598,0,1,3
56036,2,1,196599,196599,196600,0,1,1
56037,5,1,196604,196604,196605,0,1,4
56038,2,2,196606,196606,196608,0,2,1
56039,5,3,196611,196611,196614,0,3,3
56040,5,1,196616,196616,196617,0,1,2
56041,6,3,196622,196622,196625,0,3,5
56042,6,1,196628,196628,196629,0,1,3
56043,6,2,196634,196634,196636,0,2,5
56044,5,3,196639,196639,196642,0,3,3
56045,4,1,196643,196643,196644,0,1,1
56046,2,3,196645,196645,196648,0,3,1
56047,5,3,196650,196650,196653,0,3,2
56048,3,1,196653,196653,196654,0,1,0
56049,1,2,196654,196654,196656,0,2,0
56050,4,3,196658,196658,196661,0,3,2
56051,6,2,196664,196664,196666,0,2,3
56052,4,2,196668,196668,196670,0,2,2
56053,4,1,196672,196672,196673,0,1,2
56054,2,3,196674,196674,196677,0,3,1
56055,3,2,196677,196677,196679,0,2,0
56056,6,2,196683,196683,196685,0,2,4
56057,2,1,196685,196685,196686,0,1,0
56058,5,1,196690,196690,196691,0,1,4
56059,4,2,196694,196694,196696,0,2,3
56060,6,1,196700,196700,196701,0,1,4
56061,2,2,196702,196702,196704,0,2,1
56062,3,1,196705,196705,196706,0,1,1
56063,6,2,196711,196711,196713,0,2,5
56064,5,3,196716,196716,196719,0,3,3
56065,3,3,196719,196719,196722,0,3,0
56066,4,3,196723,196723,196726,0,3,1
56067,6,1,196729,196729,196730,0,1,3
56068,6,3,196735,196735,196738,0,3,5
56069,5,2,196740,196740,196742,0,2,2
56070,3,1,196743,196743,196744,0,1,1
56071,5,1,196748,196748,196749,0,1,4
56072,1,2,196749,196749,196751,0,2,0
56073,1,2,196750,196751,196753,1,3,0
56074,1,1,196751,196753,196754,2,3,0
56075,4,2,196755,196755,196757,0,2,1
56076,4,2,196759,196759,196761,0,2,2
56077,5,2,196764,196764,196766,0,2,3
56078,4,3,196768,196768,196771,0,3,2
56079,4,1,196772,196772,196773,0,1,1
56080,1,3,196773,196773,196776,0,3,0
56081,3,2,196776,196776,196778,0,2,0
56082,2,3,196778,196778,196781,0,3,0
56083,2,2,196780,196781,196783,1,3,0
56084,3,3,196783,196783,196786,0,3,0
56085,1,1,196784,196786,196787,2,3,0
56086,4,2,196788,196788,196790,0,2,1
56087,1,3,196789,196790,196793,1,4,0
56088,1,2,196790,196793,196795,3,5,0
56089,3,1,196793,196795,196796,2,3,0
56090,4,3,196797,196797,196800,0,3,1
56091,1,3,196798,196800,196803,2,5,0
56092,4,1,196802,196803,196804,1,2,0
56093,6,1,196808,196808,196809,0,1,4
56094,1,2,196809,196809,196811,0,2,0
56095,3,3,196812,196812,196815,0,3,1
56096,2,3,196814,196815,196818,1,4,0
56097,1,3,196815,196818,196821,3,6,0
56098,5,2,196820,196821,196823,1,3,0
56099,3,3,196823,196823,196826,0,3,0
56100,2,2,196825,196826,196828,1,3,0
56101,6,2,196831,196831,196833,0,2,3
56102,3,3,196834,196834,196837,0,3,1
56103,2,2,196836,196837,196839,1,3,0
56104,2,3,196838,196839,196842,1,4,0
56105,1,3,196839,196842,196845,3,6,0
56106,3,2,196842,196845,196847,3,5,0
56107,5,1,196847,196847,196848,0,1,0
56108,6,2,196853,196853,196855,0,2,5
56109,5,1,196858,196858,196859,0,1,3
56110,2,3,196860,196860,196863,0,3,1
56111,1,2,196861,196863,196865,2,4,0
56112,2,1,196863,196865,196866,2,3,0
56113,2,1,196865,196866,196867,1,2,0
56114,6,3,196871,196871,196874,0,3,4
56115,4,3,196875,196875,196878,0,3,1
56116,2,1,196877,196878,196879,1,2,0
56117,1,3,196878,196879,196882,1,4,0
56118,4,1,196882,196882,196883,0,1,0
56119,1,2,196883,196883,196885,0,2,0
56120,2,2,196885,196885,196887,0,2,0
56121,2,2,196887,196887,196889,0,2,0
56122,5,1,196892,196892,196893,0,1,3
56123,5,1,196897,196897,196898,0,1,4
56124,4,2,196901,196901,196903,0,2,3
56125,2,2,196903,196903,196905,0,2,0
56126,4,2,196907,196907,196909,0,2,2
56127,5,1,196912,196912,196913,0,1,3
56128,2,3,196914,196914,196917,0,3,1
56129,3,2,196917,196917,196919,0,2,0
56130,2,3,196919,196919,196922,0,3,0
56131,6,3,196925,196925,196928,0,3,3
56132,3,3,196928,196928,196931,0,3,0
56133,6,2,196934,196934,196936,0,2,3
56134,1,1,196935,196936,196937,1,2,0
56135,5,3,196940,196940,196943,0,3,3
56136,1,1,196941,196943,196944,2,3,0
56137,3,1,196944,196944,196945,0,1,0
56138,3,1,196947,196947,196948,0,1,2
56139,2,1,196949,196949,196950,0,1,1
56140,1,1,196950,196950,196951,0,1,0
56141,3,1,196953,196953,196954,0,1,2
56142,3,1,196956,196956,196957,0,1,2
56143,5,2,196961,196961,196963,0,2,4
56144,6,3,196967,196967,196970,0,3,4
56145,6,2,196973,196973,196975,0,2,3
56146,2,1,196975,196975,196976,0,1,0
56147,1,1,196976,196976,196977,0,1,0
56148,1,3,196977,196977,196980,0,3,0
56149,3,1,196980,196980,196981,0,1,0
56150,6,3,196986,196986,196989,0,3,5
56151,6,3,196992,196992,196995,0,3,3
56152,1,3,196993,196995,196998,2,5,0
56153,4,2,196997,196998,197000,1,3,0
56154,1,1,196998,197000,197001,2,3,0
56155,1,1,196999,197001,197002,2,3,0
56156,5,3,197004,197004,197007,0,3,2
56157,4,1,197008,197008,197009,0,1,1
56158,1,3,197009,197009,197012,0,3,0
56159,4,2,197013,197013,197015,0,2,1
56160,1,2,197014,197015,197017,1,3,0
56161,4,3,197018,197018,197021,0,3,1
56162,4,3,197022,197022,197025,0,3,1
56163,5,1,197027,197027,197028,0,1,2
56164,1,2,197028,197028,197030,0,2,0
56165,1,1,197029,197030,197031,1,2,0
56166,6,3,197035,197035,197038,0,3,4
56167,4,1,197039,197039,197040,0,1,1
56168,3,2,197042,197042,197044,0,2,2
56169,3,3,197045,197045,197048,0,3,1
56170,5,2,197050,197050,197052,0,2,2
56171,4,1,197054,197054,197055,0,1,2
56172,2,1,197056,197056,197057,0,1,1
56173,1,3,197057,197057,197060,0,3,0
56174,6,3,197063,197063,197066,0,3,3
56175,2,1,197065,197066,197067,1,2,0
56176,6,1,197071,197071,197072,0,1,4
56177,1,1,197072,197072,197073,0,1,0
56178,3,2,197075,197075,197077,0,2,2
56179,3,3,197078,197078,197081,0,3,1
56180,1,2,197079,197081,197083,2,4,0
56181,3,2,197082,197083,197085,1,3,0
56182,2,3,197084,197085,197088,1,4,0
56183,2,2,197086,197088,197090,2,4,0
56184,1,1,197087,197090,197091,3,4,0
56185,1,2,197088,197091,197093,3,5,0
56186,3,3,197091,197093,197096,2,5,0
56187,5,3,197096,197096,197099,0,3,0
56188,2,2,197098,197099,197101,1,3,0
56189,2,2,197100,197101,197103,1,3,0
56190,5,2,197105,197105,197107,0,2,2
56191,5,3,197110,197110,197113,0,3,3
56192,4,3,197114,197114,197117,0,3,1
56193,5,1,197119,197119,197120,0,1,2
56194,6,3,197125,197125,197128,0,3,5
56195,6,2,197131,197131,197133,0,2,3
56196,1,3,197132,197133,197136,1,4,0
56197,4,1,197136,197136,197137,0,1,0
56198,2,1,197138,197138,197139,0,1,1
56199,1,2,197139,197139,197141,0,2,0
56200,5,3,197144,197144,197147,0,3,3
56201,2,3,197146,197147,197150,1,4,0
56202,1,2,197147,197150,197152,3,5,0
56203,3,3,197150,197152,197155,2,5,0
56204,5,1,197155,197155,197156,0,1,0
56205,3,2,197158,197158,197160,0,2,2
56206,4,3,197162,197162,197165,0,3,2
56207,1,1,197163,197165,197166,2,3,0
56208,1,1,197164,197166,197167,2,3,0
56209,6,1,197170,197170,197171,0,1,3
56210,5,3,197175,197175,197178,0,3,4
56211,1,2,197176,197178,197180,2,4,0
56212,6,1,197182,197182,197183,0,1,2
56213,4,1,197186,197186,197187,0,1,3
56214,4,2,197190,197190,197192,0,2,3
56215,6,3,197196,197196,197199,0,3,4
56216,6,2,197202,197202,197204,0,2,3
56217,1,3,197203,197204,197207,1,4,0
56218,3,1,197206,197207,197208,1,2,0
56219,5,2,197211,197211,197213,0,2,3
56220,1,2,197212,197213,197215,1,3,0
56221,2,2,197214,197215,197217,1,3,0
56222,6,3,197220,197220,197223,0,3,3
56223,4,3,197224,197224,197227,0,3,1
56224,3,2,197227,197227,197229,0,2,0
56225,5,1,197232,197232,197233,0,1,3
56226,6,2,197238,197238,197240,0,2,5
56227,1,3,197239,197240,197243,1,4,0
56228,1,1,197240,197243,197244,3,4,0
56229,6,2,197246,197246,197248,0,2,2
56230,4,1,197250,197250,197251,0,1,2
56231,2,2,197252,197252,197254,0,2,1
56232,2,1,197254,197254,197255,0,1,0
56233,4,3,197258,197258,197261,0,3,3
56234,4,2,197262,197262,197264,0,2,1
56235,1,3,197263,197264,197267,1,4,0
56236,2,2,197265,197267,197269,2,4,0
56237,2,3,197267,197269,197272,2,5,0
56238,4,3,197271,197272,197275,1,4,0
56239,4,2,197275,197275,197277,0,2,0
56240,6,3,197281,197281,197284,0,3,4
56241,1,2,197282,197284,197286,2,4,0
56242,6,3,197288,197288,197291,0,3,2
56243,1,2,197289,197291,197293,2,4,0
56244,1,2,197290,197293,197295,3,5,0
56245,3,3,197293,197295,197298,2,5,0
56246,5,1,197298,197298,197299,0,1,0
56247,3,2,197301,197301,197303,0,2,2
56248,6,1,197307,197307,197308,0,1,4
56249,4,1,197311,197311,197312,0,1,3
56250,5,3,197316,197316,197319,0,3,4
56251,4,1,197320,197320,197321,0,1,1
56252,1,1,197321,197321,197322,0,1,0
56253,6,1,197327,197327,197328,0,1,5
56254,2,3,197329,197329,197332,0,3,1
56255,6,1,197335,197335,197336,0,1,3
56256,4,1,197339,197339,197340,0,1,3
56257,3,2,197342,197342,197344,0,2,2
56258,1,3,197343,197344,197347,1,4,0
56259,3,3,197346,197347,197350,1,4,0
56260,3,2,197349,197350,197352,1,3,0
56261,1,3,197350,197352,197355,2,5,0
56262,1,3,197351,197355,197358,4,7,0
56263,4,2,197355,197358,197360,3,5,0
56264,6,2,197361,197361,197363,0,2,1
56265,3,2,197364,197364,197366,0,2,1
56266,6,1,197370,197370,197371,0,1,4
56267,3,3,197373,197373,197376,0,3,2
56268,2,3,197375,197376,197379,1,4,0
56269,3,3,197378,197379,197382,1,4,0
56270,4,3,197382,197382,197385,0,3,0
56271,2,1,197384,197385,197386,1,2,0
56272,2,2,197386,197386,197388,0,2,0
56273,1,3,197387,197388,197391,1,4,0
56274,3,1,197390,197391,197392,1,2,0
56275,6,1,197396,197396,197397,0,1,4
56276,5,2,197401,197401,197403,0,2,4
56277,1,2,197402,197403,197405,1,3,0
56278,5,3,197407,197407,197410,0,3,2
56279,2,1,197409,197410,197411,1,2,0
56280,3,2,197412,197412,197414,0,2,1
56281,1,3,197413,197414,197417,1,4,0
56282,4,3,197417,197417,197420,0,3,0
56283,6,3,197423,197423,197426,0,3,3
56284,3,3,197426,197426,197429,0,3,0
56285,6,3,197432,197432,197435,0,3,3
56286,2,1,197434,197435,197436,1,2,0
56287,5,3,197439,197439,197442,0,3,3
56288,1,2,197440,197442,197444,2,4,0
56289,2,2,197442,197444,197446,2,4,0
56290,5,2,197447,197447,197449,0,2,1
56291,1,3,197448,197449,197452,1,4,0
56292,4,1,197452,197452,197453,0,1,0
56293,6,3,197458,197458,197461,0,3,5
56294,4,1,197462,197462,197463,0,1,1
56295,4,2,197466,197466,197468,0,2,3
56296,3,2,197469,197469,197471,0,2,1
56297,6,2,197475,197475,197477,0,2,4
56298,5,1,197480,197480,197481,0,1,3
56299,6,3,197486,197486,197489,0,3,5
56300,5,2,197491,197491,197493,0,2,2
56301,3,3,197494,197494,197497,0,3,1
56302,1,3,197495,197497,197500,2,5,0
56303,3,3,197498,197500,197503,2,5,0
56304,2,1,197500,197503,197504,3,4,0
56305,4,2,197504,197504,197506,0,2,0
56306,3,3,197507,197507,197510,0,3,1
56307,6,2,197513,197513,197515,0,2,3
56308,5,3,197518,197518,197521,0,3,3
56309,5,3,197523,197523,197526,0,3,2
56310,4,3,197527,197527,197530,0,3,1
56311,5,1,197532,197532,197533,0,1,2
56312,3,3,197535,197535,197538,0,3,2
56313,6,2,197541,197541,197543,0,2,3
56314,1,2,197542,197543,197545,1,3,0
56315,2,3,197544,197545,197548,1,4,0
56316,1,1,197545,197548,197549,3,4,0
56317,1,1,197546,197549,197550,3,4,0
56318,6,1,197552,197552,197553,0,1,2
56319,1,2,197553,197553,197555,0,2,0
56320,6,2,197559,197559,197561,0,2,4
56321,3,1,197562,197562,197563,0,1,1
56322,5,2,197567,197567,197569,0,2,4
56323,1,3,197568,197569,197572,1,4,0
56324,6,2,197574,197574,197576,0,2,2
56325,5,1,197579,197579,197580,0,1,3
56326,4,2,197583,197583,197585,0,2,3
56327,5,3,197588,197588,197591,0,3,3
56328,6,1,197594,197594,197595,0,1,3
56329,3,2,197597,197597,197599,0,2,2
56330,6,3,197603,197603,197606,0,3,4
56331,6,2,197609,197609,197611,0,2,3
56332,3,2,197612,197612,197614,0,2,1
56333,1,3,197613,197614,197617,1,4,0
56334,5,2,197618,197618,197620,0,2,1
56335,2,2,197620,197620,197622,0,2,0
56336,1,2,197621,197622,197624,1,3,0
56337,2,2,197623,197624,197626,1,3,0
56338,5,3,197628,197628,197631,0,3,2
56339,2,2,197630,197631,197633,1,3,0
56340,4,2,197634,197634,197636,0,2,1
56341,1,3,197635,197636,197639,1,4,0
56342,2,2,197637,197639,197641,2,4,0
56343,2,2,197639,197641,197643,2,4,0
56344,1,1,197640,197643,197644,3,4,0
56345,1,2,197641,197644,197646,3,5,0
56346,5,3,197646,197646,197649,0,3,0
56347,4,2,197650,197650,197652,0,2,1
56348,4,2,197654,197654,197656,0,2,2
56349,4,3,197658,197658,197661,0,3,2
56350,6,3,197664,197664,197667,0,3,3
56351,3,2,197667,197667,197669,0,2,0
56352,3,2,197670,197670,197672,0,2,1
56353,3,2,197673,197673,197675,0,2,1
56354,1,2,197674,197675,197677,1,3,0
56355,3,1,197677,197677,197678,0,1,0
56356,5,2,197682,197682,197684,0,2,4
56357,5,2,197687,197687,197689,0,2,3
56358,6,1,197693,197693,197694,0,1,4
56359,4,1,197697,197697,197698,0,1,3
56360,6,2,197703,197703,197705,0,2,5
56361,1,1,197704,197705,197706,1,2,0
56362,5,2,197709,197709,197711,0,2,3
56363,1,2,197710,197711,197713,1,3,0
56364,6,2,197716,197716,197718,0,2,3
56365,2,3,197718,197718,197721,0,3,0
56366,3,3,197721,197721,197724,0,3,0
56367,6,1,197727,197727,197728,0,1,3
56368,4,1,197731,197731,197732,0,1,3
56369,5,2,197736,197736,197738,0,2,4
56370,5,1,197741,197741,197742,0,1,3
56371,2,1,197743,197743,197744,0,1,1
56372,2,2,197745,197745,197747,0,2,1
56373,1,1,197746,197747,197748,1,2,0
56374,6,3,197752,197752,197755,0,3,4
56375,1,3,197753,197755,197758,2,5,0
56376,1,3,197754,197758,197761,4,7,0
56377,6,3,197760,197761,197764,1,4,0
56378,2,1,197762,197764,197765,2,3,0
56379,5,3,197767,197767,197770,0,3,2
56380,1,1,197768,197770,197771,2,3,0
56381,2,2,197770,197771,197773,1,3,0
56382,4,3,197774,197774,197777,0,3,1
56383,3,2,197777,197777,197779,0,2,0
56384,3,1,197780,197780,197781,0,1,1
56385,5,2,197785,197785,197787,0,2,4
56386,4,1,197789,197789,197790,0,1,2
56387,6,3,197795,197795,197798,0,3,5
56388,2,2,197797,197798,197800,1,3,0
56389,5,3,197802,197802,197805,0,3,2
56390,2,2,197804,197805,197807,1,3,0
56391,4,3,197808,197808,197811,0,3,1
56392,5,1,197813,197813,197814,0,1,2
56393,5,3,197818,197818,197821,0,3,4
56394,3,2,197821,197821,197823,0,2,0
56395,5,3,197826,197826,197829,0,3,3
56396,1,3,197827,197829,197832,2,5,0
56397,5,3,197832,197832,197835,0,3,0
56398,4,1,197836,197836,197837,0,1,1
56399,6,3,197842,197842,197845,0,3,5
56400,6,3,197848,197848,197851,0,3,3
56401,6,1,197854,197854,197855,0,1,3
56402,5,3,197859,197859,197862,0,3,4
56403,6,2,197865,197865,197867,0,2,3
56404,6,2,197871,197871,197873,0,2,4
56405,4,2,197875,197875,197877,0,2,2
56406,2,1,197877,197877,197878,0,1,0
56407,1,2,197878,197878,197880,0,2,0
56408,3,2,197881,197881,197883,0,2,1
56409,1,3,197882,197883,197886,1,4,0
56410,2,2,197884,197886,197888,2,4,0
56411,2,2,197886,197888,197890,2,4,0
56412,3,3,197889,197890,197893,1,4,0
56413,4,3,197893,197893,197896,0,3,0
56414,1,2,197894,197896,197898,2,4,0
56415,2,2,197896,197898,197900,2,4,0
56416,6,1,197902,197902,197903,0,1,2
56417,2,2,197904,197904,197906,0,2,1
56418,3,3,197907,197907,197910,0,3,1
56419,1,1,197908,197910,197911,2,3,0
56420,1,1,197909,197911,197912,2,3,0
56421,1,3,197910,197912,197915,2,5,0
56422,3,3,197913,197915,197918,2,5,0
56423,6,3,197919,197919,197922,0,3,1
56424,5,3,197924,197924,197927,0,3,2
56425,2,1,197926,197927,197928,1,2,0
56426,5,3,197931,197931,197934,0,3,3
56427,6,3,197937,197937,197940,0,3,3
56428,4,3,197941,197941,197944,0,3,1
56429,5,3,197946,197946,197949,0,3,2
56430,2,2,197948,197949,197951,1,3,0
56431,3,1,197951,197951,197952,0,1,0
56432,3,2,197954,197954,197956,0,2,2
56433,4,2,197958,197958,197960,0,2,2
56434,5,3,197963,197963,197966,0,3,3
56435,6,2,197969,197969,197971,0,2,3
56436,3,3,197972,197972,197975,0,3,1
56437,2,2,197974,197975,197977,1,3,0
56438,5,3,197979,197979,197982,0,3,2
56439,1,1,197980,197982,197983,2,3,0
56440,2,3,197982,197983,197986,1,4,0
56441,2,1,197984,197986,197987,2,3,0
56442,3,3,197987,197987,197990,0,3,0
56443,2,1,197989,197990,197991,1,2,0
56444,3,1,197992,197992,197993,0,1,1
56445,4,3,197996,197996,197999,0,3,3
56446,4,3,198000,198000,198003,0,3,1
56447,2,2,198002,198003,198005,1,3,0
56448,2,1,198004,198005,198006,1,2,0
56449,3,2,198007,198007,198009,0,2,1
56450,5,1,198012,198012,198013,0,1,3
56451,3,3,198015,198015,198018,0,3,2
56452,2,3,198017,198018,198021,1,4,0
56453,3,3,198020,198021,198024,1,4,0
56454,1,3,198021,198024,198027,3,6,0
56455,4,3,198025,198027,198030,2,5,0
56456,6,2,198031,198031,198033,0,2,1
56457,1,3,198032,198033,198036,1,4,0
56458,6,2,198038,198038,198040,0,2,2
56459,6,2,198044,198044,198046,0,2,4
56460,4,1,198048,198048,198049,0,1,2
56461,2,3,198050,198050,198053,0,3,1
56462,1,3,198051,198053,198056,2,5,0
56463,2,3,198053,198056,198059,3,6,0
56464,5,1,198058,198059,198060,1,2,0
56465,1,1,198059,198060,198061,1,2,0
56466,4,2,198063,198063,198065,0,2,2
56467,5,2,198068,198068,198070,0,2,3
56468,5,2,198073,198073,198075,0,2,3
56469,1,2,198074,198075,198077,1,3,0
56470,1,3,198075,198077,198080,2,5,0
56471,3,1,198078,198080,198081,2,3,0
56472,3,1,198081,198081,198082,0,1,0
56473,5,2,198086,198086,198088,0,2,4
56474,3,1,198089,198089,198090,0,1,1
56475,6,3,198095,198095,198098,0,3,5
56476,6,3,198101,198101,198104,0,3,3
56477,2,3,198103,198104,198107,1,4,0
56478,6,2,198109,198109,198111,0,2,2
56479,4,3,198113,198113,198116,0,3,2
56480,5,3,198118,198118,198121,0,3,2
56481,6,3,198124,198124,198127,0,3,3
56482,1,3,198125,198127,198130,2,5,0
56483,1,2,198126,198130,198132,4,6,0
56484,5,2,198131,198132,198134,1,3,0
56485,1,1,198132,198134,198135,2,3,0
56486,5,2,198137,198137,198139,0,2,2
56487,3,2,198140,198140,198142,0,2,1
56488,6,2,198146,198146,198148,0,2,4
56489,1,2,198147,198148,198150,1,3,0
56490,5,3,198152,198152,198155,0,3,2
56491,3,1,198155,198155,198156,0,1,0
56492,1,1,198156,198156,198157,0,1,0
56493,6,3,198162,198162,198165,0,3,5
56494,3,1,198165,198165,198166,0,1,0
56495,3,2,198168,198168,198170,0,2,2
56496,3,1,198171,198171,198172,0,1,1
56497,6,1,198177,198177,198178,0,1,5
56498,3,1,198180,198180,198181,0,1,2
56499,1,1,198181,198181,198182,0,1,0
56500,5,3,198186,198186,198189,0,3,4
56501,2,3,198188,198189,198192,1,4,0
56502,3,3,198191,198192,198195,1,4,0
56503,6,2,198197,198197,198199,0,2,2
56504,2,3,198199,198199,198202,0,3,0
56505,5,3,198204,198204,198207,0,3,2
56506,1,1,198205,198207,198208,2,3,0
56507,2,1,198207,198208,198209,1,2,0
56508,4,2,198211,198211,198213,0,2,2
56509,6,3,198217,198217,198220,0,3,4
56510,5,3,198222,198222,198225,0,3,2
56511,3,2,198225,198225,198227,0,2,0
56512,6,2,198231,198231,198233,0,2,4
56513,3,3,198234,198234,198237,0,3,1
56514,3,3,198237,198237,198240,0,3,0
56515,1,1,198238,198240,198241,2,3,0
56516,1,2,198239,198241,198243,2,4,0
56517,2,2,198241,198243,198245,2,4,0
56518,3,1,198244,198245,198246,1,2,0
56519,3,1,198247,198247,198248,0,1,1
56520,5,1,198252,198252,198253,0,1,4
56521,6,1,198258,198258,198259,0,1,5
56522,6,1,198264,198264,198265,0,1,5
56523,2,3,198266,198266,198269,0,3,1
56524,4,3,198270,198270,198273,0,3,1
56525,5,2,198275,198275,198277,0,2,2
56526,5,1,198280,198280,198281,0,1,3
56527,3,3,198283,198283,198286,0,3,2
56528,5,3,198288,198288,198291,0,3,2
56529,4,3,198292,198292,198295,0,3,1
56530,4,3,198296,198296,198299,0,3,1
56531,1,2,198297,198299,198301,2,4,0
56532,3,3,198300,198301,198304,1,4,0
56533,3,1,198303,198304,198305,1,2,0
56534,1,1,198304,198305,198306,1,2,0
56535,3,1,198307,198307,198308,0,1,1
56536,4,2,198311,198311,198313,0,2,3
56537,6,1,198317,198317,198318,0,1,4
56538,2,1,198319,198319,198320,0,1,1
56539,4,2,198323,198323,198325,0,2,3
56540,6,2,198329,198329,198331,0,2,4
56541,3,1,198332,198332,198333,0,1,1
56542,4,3,198336,198336,198339,0,3,3
56543,5,1,198341,198341,198342,0,1,2
56544,5,3,198346,198346,198349,0,3,4
56545,5,1,198351,198351,198352,0,1,2
56546,2,1,198353,198353,198354,0,1,1
56547,1,2,198354,198354,198356,0,2,0
56548,5,3,198359,198359,198362,0,3,3
56549,3,2,198362,198362,198364,0,2,0
56550,1,1,198363,198364,198365,1,2,0
56551,1,2,198364,198365,198367,1,3,0
56552,4,3,198368,198368,198371,0,3,1
56553,3,2,198371,198371,198373,0,2,0
56554,5,2,198376,198376,198378,0,2,3
56555,5,2,198381,198381,198383,0,2,3
56556,2,2,198383,198383,198385,0,2,0
56557,2,3,198385,198385,198388,0,3,0
56558,6,1,198391,198391,198392,0,1,3
56559,1,1,198392,198392,198393,0,1,0
56560,3,2,198395,198395,198397,0,2,2
56561,1,2,198396,198397,198399,1,3,0
56562,4,1,198400,198400,198401,0,1,1
56563,1,2,198401,198401,198403,0,2,0
56564,3,2,198404,198404,198406,0,2,1
56565,3,2,198407,198407,198409,0,2,1
56566,2,3,198409,198409,198412,0,3,0
56567,6,3,198415,198415,198418,0,3,3
56568,4,1,198419,198419,198420,0,1,1
56569,1,2,198420,198420,198422,0,2,0
56570,4,1,198424,198424,198425,0,1,2
56571,2,1,198426,198426,198427,0,1,1
56572,1,3,198427,198427,198430,0,3,0
56573,1,2,198428,198430,198432,2,4,0
56574,5,3,198433,198433,198436,0,3,1
56575,6,3,198439,198439,198442,0,3,3
56576,3,3,198442,198442,198445,0,3,0
56577,1,1,198443,198445,198446,2,3,0
56578,4,1,198447,198447,198448,0,1,1
56579,6,1,198453,198453,198454,0,1,5
56580,4,2,198457,198457,198459,0,2,3
56581,6,2,198463,198463,198465,0,2,4
56582,4,1,198467,198467,198468,0,1,2
56583,1,3,198468,198468,198471,0,3,0
56584,2,2,198470,198471,198473,1,3,0
56585,1,2,198471,198473,198475,2,4,0
56586,6,3,198477,198477,198480,0,3,2
56587,1,2,198478,198480,198482,2,4,0
56588,3,1,198481,198482,198483,1,2,0
56589,6,3,198487,198487,198490,0,3,4
56590,6,2,198493,198493,198495,0,2,3
56591,2,2,198495,198495,198497,0,2,0
56592,3,2,198498,198498,198500,0,2,1
56593,5,2,198503,198503,198505,0,2,3
56594,6,1,198509,198509,198510,0,1,4
56595,3,3,198512,198512,198515,0,3,2
56596,4,1,198516,198516,198517,0,1,1
56597,5,3,198521,198521,198524,0,3,4
56598,5,1,198526,198526,198527,0,1,2
56599,5,3,198531,198531,198534,0,3,4
56600,4,1,198535,198535,198536,0,1,1
56601,3,1,198538,198538,198539,0,1,2
56602,4,1,198542,198542,198543,0,1,3
56603,6,1,198548,198548,198549,0,1,5
56604,4,1,198552,198552,198553,0,1,3
56605,1,2,198553,198553,198555,0,2,0
56606,4,1,198557,198557,198558,0,1,2
56607,5,2,198562,198562,198564,0,2,4
56608,2,3,198564,198564,198567,0,3,0
56609,3,2,198567,198567,198569,0,2,0
56610,5,1,198572,198572,198573,0,1,3
56611,2,2,198574,198574,198576,0,2,1
56612,6,3,198580,198580,198583,0,3,4
56613,1,2,198581,198583,198585,2,4,0
56614,4,3,198585,198585,198588,0,3,0
56615,3,2,198588,198588,198590,0,2,0
56616,4,1,198592,198592,198593,0,1,2
56617,1,3,198593,198593,198596,0,3,0
56618,4,1,198597,198597,198598,0,1,1
56619,2,2,198599,198599,198601,0,2,1
56620,1,1,198600,198601,198602,1,2,0
56621,1,3,198601,198602,198605,1,4,0
56622,3,1,198604,198605,198606,1,2,0
56623,1,1,198605,198606,198607,1,2,0
56624,4,1,198609,198609,198610,0,1,2
56625,6,2,198615,198615,198617,0,2,5
56626,2,3,198617,198617,198620,0,3,0
56627,2,1,198619,198620,198621,1,2,0
56628,5,2,198624,198624,198626,0,2,3
56629,4,3,198628,198628,198631,0,3,2
56630,3,1,198631,198631,198632,0,1,0
56631,5,2,198636,198636,198638,0,2,4
56632,5,1,198641,198641,198642,0,1,3
56633,4,2,198645,198645,198647,0,2,3
56634,2,2,198647,198647,198649,0,2,0
56635,5,2,198652,198652,198654,0,2,3
56636,3,2,198655,198655,198657,0,2,1
56637,6,1,198661,198661,198662,0,1,4
56638,6,2,198667,198667,198669,0,2,5
56639,2,2,198669,198669,198671,0,2,0
56640,5,3,198674,198674,198677,0,3,3
56641,4,2,198678,198678,198680,0,2,1
56642,1,3,198679,198680,198683,1,4,0
56643,5,2,198684,198684,198686,0,2,1
56644,5,2,198689,198689,198691,0,2,3
56645,4,2,198693,198693,198695,0,2,2
56646,3,2,198696,198696,198698,0,2,1
56647,2,3,198698,198698,198701,0,3,0
56648,3,1,198701,198701,198702,0,1,0
56649,5,3,198706,198706,198709,0,3,4
56650,4,1,198710,198710,198711,0,1,1
56651,1,3,198711,198711,198714,0,3,0
56652,6,3,198717,198717,198720,0,3,3
56653,6,2,198723,198723,198725,0,2,3
56654,3,2,198726,198726,198728,0,2,1
56655,1,2,198727,198728,198730,1,3,0
56656,6,2,198733,198733,198735,0,2,3
56657,4,1,198737,198737,198738,0,1,2
56658,5,1,198742,198742,198743,0,1,4
56659,5,3,198747,198747,198750,0,3,4
56660,2,1,198749,198750,198751,1,2,0
56661,3,1,198752,198752,198753,0,1,1
56662,4,3,198756,198756,198759,0,3,3
56663,3,3,198759,198759,198762,0,3,0
56664,1,3,198760,198762,198765,2,5,0
56665,4,2,198764,198765,198767,1,3,0
56666,5,3,198769,198769,198772,0,3,2
56667,3,3,198772,198772,198775,0,3,0
56668,3,2,198775,198775,198777,0,2,0
56669,2,2,198777,198777,198779,0,2,0
56670,3,3,198780,198780,198783,0,3,1
56671,5,2,198785,198785,198787,0,2,2
56672,1,1,198786,198787,198788,1,2,0
56673,3,3,198789,198789,198792,0,3,1
56674,6,2,198795,198795,198797,0,2,3
56675,6,3,198801,198801,198804,0,3,4
56676,4,3,198805,198805,198808,0,3,1
56677,1,1,198806,198808,198809,2,3,0
56678,6,2,198812,198812,198814,0,2,3
56679,1,3,198813,198814,198817,1,4,0
56680,4,1,198817,198817,198818,0,1,0
56681,1,3,198818,198818,198821,0,3,0
56682,6,1,198824,198824,198825,0,1,3
56683,2,1,198826,198826,198827,0,1,1
56684,5,3,198831,198831,198834,0,3,4
56685,4,2,198835,198835,198837,0,2,1
56686,5,2,198840,198840,198842,0,2,3
56687,4,2,198844,198844,198846,0,2,2
56688,2,1,198846,198846,198847,0,1,0
56689,4,2,198850,198850,198852,0,2,3
56690,4,3,198854,198854,198857,0,3,2
56691,3,2,198857,198857,198859,0,2,0
56692,1,2,198858,198859,198861,1,3,0
56693,5,2,198863,198863,198865,0,2,2
56694,6,1,198869,198869,198870,0,1,4
56695,6,1,198875,198875,198876,0,1,5
56696,3,1,198878,198878,198879,0,1,2
56697,2,3,198880,198880,198883,0,3,1
56698,2,1,198882,198883,198884,1,2,0
56699,6,2,198888,198888,198890,0,2,4
56700,6,1,198894,198894,198895,0,1,4
56701,5,3,198899,198899,198902,0,3,4
56702,2,1,198901,198902,198903,1,2,0
56703,4,3,198905,198905,198908,0,3,2
56704,1,3,198906,198908,198911,2,5,0
56705,2,3,198908,198911,198914,3,6,0
56706,4,1,198912,198914,198915,2,3,0
56707,4,2,198916,198916,198918,0,2,1
56708,2,2,198918,198918,198920,0,2,0
56709,1,1,198919,198920,198921,1,2,0
56710,6,1,198925,198925,198926,0,1,4
56711,5,1,198930,198930,198931,0,1,4
56712,6,3,198936,198936,198939,0,3,5
56713,2,2,198938,198939,198941,1,3,0
56714,3,1,198941,198941,198942,0,1,0
56715,1,1,198942,198942,198943,0,1,0
56716,6,1,198948,198948,198949,0,1,5
56717,2,3,198950,198950,198953,0,3,1
56718,2,1,198952,198953,198954,1,2,0
56719,3,1,198955,198955,198956,0,1,1
56720,4,2,198959,198959,198961,0,2,3
56721,2,2,198961,198961,198963,0,2,0
56722,6,3,198967,198967,198970,0,3,4
56723,2,1,198969,198970,198971,1,2,0
56724,2,2,198971,198971,198973,0,2,0
56725,1,1,198972,198973,198974,1,2,0
56726,6,1,198978,198978,198979,0,1,4
56727,6,1,198984,198984,198985,0,1,5
56728,1,2,198985,198985,198987,0,2,0
56729,6,3,198991,198991,198994,0,3,4
56730,1,3,198992,198994,198997,2,5,0
56731,4,3,198996,198997,199000,1,4,0
56732,1,2,198997,199000,199002,3,5,0
56733,2,3,198999,199002,199005,3,6,0
56734,3,2,199002,199005,199007,3,5,0
56735,3,1,199005,199007,199008,2,3,0
56736,2,3,199007,199008,199011,1,4,0
56737,1,1,199008,199011,199012,3,4,0
56738,4,1,199012,199012,199013,0,1,0
56739,6,1,199018,199018,199019,0,1,5
56740,5,2,199023,199023,199025,0,2,4
56741,2,1,199025,199025,199026,0,1,0
56742,2,3,199027,199027,199030,0,3,1
56743,2,1,199029,199030,199031,1,2,0
56744,4,2,199033,199033,199035,0,2,2
56745,3,3,199036,199036,199039,0,3,1
56746,4,2,199040,199040,199042,0,2,1
56747,1,1,199041,199042,199043,1,2,0
56748,6,2,199047,199047,199049,0,2,4
56749,5,2,199052,199052,199054,0,2,3
56750,1,1,199053,199054,199055,1,2,0
56751,1,2,199054,199055,199057,1,3,0
56752,3,2,199057,199057,199059,0,2,0
56753,5,2,199062,199062,199064,0,2,3
56754,1,1,199063,199064,199065,1,2,0
56755,5,3,199068,199068,199071,0,3,3
56756,2,3,199070,199071,199074,1,4,0
56757,1,3,199071,199074,199077,3,6,0
56758,2,1,199073,199077,199078,4,5,0
56759,3,2,199076,199078,199080,2,4,0
56760,1,2,199077,199080,199082,3,5,0
56761,4,1,199081,199082,199083,1,2,0
56762,5,1,199086,199086,199087,0,1,3
56763,4,1,199090,199090,199091,0,1,3
56764,2,2,199092,199092,199094,0,2,1
56765,6,2,199098,199098,199100,0,2,4
56766,5,1,199103,199103,199104,0,1,3
56767,3,1,199106,199106,199107,0,1,2
56768,6,1,199112,199112,199113,0,1,5
56769,5,3,199117,199117,199120,0,3,4
56770,2,2,199119,199120,199122,1,3,0
56771,2,2,199121,199122,199124,1,3,0
56772,3,2,199124,199124,199126,0,2,0
56773,1,2,199125,199126,199128,1,3,0
56774,6,1,199131,199131,199132,0,1,3
56775,1,2,199132,199132,199134,0,2,0
56776,3,1,199135,199135,199136,0,1,1
56777,5,3,199140,199140,199143,0,3,4
56778,4,1,199144,199144,199145,0,1,1
56779,4,3,199148,199148,199151,0,3,3
56780,1,2,199149,199151,199153,2,4,0
56781,5,1,199154,199154,199155,0,1,1
56782,6,3,199160,199160,199163,0,3,5
56783,6,2,199166,199166,199168,0,2,3
56784,5,3,199171,199171,199174,0,3,3
56785,2,2,199173,199174,199176,1,3,0
56786,3,1,199176,199176,199177,0,1,0
56787,2,1,199178,199178,199179,0,1,1
56788,6,2,199184,199184,199186,0,2,5
56789,5,1,199189,199189,199190,0,1,3
56790,6,2,199195,199195,199197,0,2,5
56791,4,2,199199,199199,199201,0,2,2
56792,5,1,199204,199204,199205,0,1,3
56793,2,3,199206,199206,199209,0,3,1
56794,4,3,199210,199210,199213,0,3,1
56795,4,2,199214,199214,199216,0,2,1
56796,6,3,199220,199220,199223,0,3,4
56797,6,3,199226,199226,199229,0,3,3
56798,2,1,199228,199229,199230,1,2,0
56799,6,2,199234,199234,199236,0,2,4
56800,2,1,199236,199236,199237,0,1,0
56801,6,2,199242,199242,199244,0,2,5
56802,1,3,199243,199244,199247,1,4,0
56803,1,2,199244,199247,199249,3,5,0
56804,2,1,199246,199249,199250,3,4,0
56805,4,3,199250,199250,199253,0,3,0
56806,3,3,199253,199253,199256,0,3,0
56807,4,2,199257,199257,199259,0,2,1
56808,4,2,199261,199261,199263,0,2,2
56809,6,3,199267,199267,199270,0,3,4
56810,2,2,199269,199270,199272,1,3,0
56811,4,1,199273,199273,199274,0,1,1
56812,3,3,199276,199276,199279,0,3,2
56813,2,1,199278,199279,199280,1,2,0
56814,2,3,199280,199280,199283,0,3,0
56815,3,1,199283,199283,199284,0,1,0
56816,1,1,199284,199284,199285,0,1,0
56817,6,1,199290,199290,199291,0,1,5
56818,2,2,199292,199292,199294,0,2,1
56819,2,2,199294,199294,199296,0,2,0
56820,2,2,199296,199296,199298,0,2,0
56821,5,1,199301,199301,199302,0,1,3
56822,2,3,199303,199303,199306,0,3,1
56823,1,1,199304,199306,199307,2,3,0
56824,2,1,199306,199307,199308,1,2,0
56825,3,1,199309,199309,199310,0,1,1
56826,2,2,199311,199311,199313,0,2,1
56827,3,3,199314,199314,199317,0,3,1
56828,6,1,199320,199320,199321,0,1,3
56829,3,2,199323,199323,199325,0,2,2
56830,5,1,199328,199328,199329,0,1,3
56831,5,2,199333,199333,199335,0,2,4
56832,3,3,199336,199336,199339,0,3,1
56833,2,1,199338,199339,199340,1,2,0
56834,6,2,199344,199344,199346,0,2,4
56835,4,1,199348,199348,199349,0,1,2
56836,4,2,199352,199352,199354,0,2,3
56837,6,3,199358,199358,199361,0,3,4
56838,2,3,199360,199361,199364,1,4,0
56839,1,3,199361,199364,199367,3,6,0
56840,2,1,199363,199367,199368,4,5,0
56841,3,3,199366,199368,199371,2,5,0
56842,3,3,199369,199371,199374,2,5,0
56843,5,3,199374,199374,199377,0,3,0
56844,4,2,199378,199378,199380,0,2,1
56845,5,3,199383,199383,199386,0,3,3
56846,6,1,199389,199389,199390,0,1,3
56847,6,3,199395,199395,199398,0,3,5
56848,2,1,199397,199398,199399,1,2,0
56849,2,1,199399,199399,199400,0,1,0
56850,2,2,199401,199401,199403,0,2,1
56851,4,3,199405,199405,199408,0,3,2
56852,6,1,199411,199411,199412,0,1,3
56853,6,3,199417,199417,199420,0,3,5
56854,1,3,199418,199420,199423,2,5,0
56855,6,2,199424,199424,199426,0,2,1
56856,3,2,199427,199427,199429,0,2,1
56857,4,3,199431,199431,199434,0,3,2
56858,3,3,199434,199434,199437,0,3,0
56859,4,2,199438,199438,199440,0,2,1
56860,3,3,199441,199441,199444,0,3,1
56861,3,3,199444,199444,199447,0,3,0
56862,3,2,199447,199447,199449,0,2,0
56863,2,2,199449,199449,199451,0,2,0
56864,2,3,199451,199451,199454,0,3,0
56865,3,1,199454,199454,199455,0,1,0
56866,5,3,199459,199459,199462,0,3,4
56867,6,2,199465,199465,199467,0,2,3
56868,5,1,199470,199470,199471,0,1,3
56869,5,1,199475,199475,199476,0,1,4
56870,1,3,199476,199476,199479,0,3,0
56871,3,1,199479,199479,199480,0,1,0
56872,3,3,199482,199482,199485,0,3,2
56873,2,2,199484,199485,199487,1,3,0
56874,2,3,199486,199487,199490,1,4,0
56875,1,3,199487,199490,199493,3,6,0
56876,1,2,199488,199493,199495,5,7,0
56877,2,1,199490,199495,199496,5,6,0
56878,3,2,199493,199496,199498,3,5,0
56879,1,3,199494,199498,199501,4,7,0
56880,4,1,199498,199501,199502,3,4,0
56881,3,1,199501,199502,199503,1,2,0
56882,4,2,199505,199505,199507,0,2,2
56883,4,2,199509,199509,199511,0,2,2
56884,4,1,199513,199513,199514,0,1,2
56885,5,1,199518,199518,199519,0,1,4
56886,2,2,199520,199520,199522,0,2,1
56887,3,2,199523,199523,199525,0,2,1
56888,6,1,199529,199529,199530,0,1,4
56889,1,3,199530,199530,199533,0,3,0
56890,2,1,199532,199533,199534,1,2,0
56891,3,1,199535,199535,199536,0,1,1
56892,3,3,199538,199538,199541,0,3,2
56893,3,3,199541,199541,199544,0,3,0
56894,3,3,199544,199544,199547,0,3,0
56895,4,2,199548,199548,199550,0,2,1
56896,5,3,199553,199553,199556,0,3,3
56897,4,3,199557,199557,199560,0,3,1
56898,5,3,199562,199562,199565,0,3,2
56899,1,2,199563,199565,199567,2,4,0
56900,6,1,199569,199569,199570,0,1,2
56901,4,2,199573,199573,199575,0,2,3
56902,4,1,199577,199577,199578,0,1,2
56903,6,2,199583,199583,199585,0,2,5
56904,5,3,199588,199588,199591,0,3,3
56905,6,2,199594,199594,199596,0,2,3
56906,3,1,199597,199597,199598,0,1,1
56907,2,1,199599,199599,199600,0,1,1
56908,3,2,199602,199602,199604,0,2,2
56909,4,2,199606,199606,199608,0,2,2
56910,6,1,199612,199612,199613,0,1,4
56911,5,1,199617,199617,199618,0,1,4
56912,6,3,199623,199623,199626,0,3,5
56913,6,3,199629,199629,199632,0,3,3
56914,4,1,199633,199633,199634,0,1,1
56915,1,1,199634,199634,199635,0,1,0
56916,4,3,199638,199638,199641,0,3,3
56917,6,1,199644,199644,199645,0,1,3
56918,5,3,199649,199649,199652,0,3,4
56919,2,2,199651,199652,199654,1,3,0
56920,4,2,199655,199655,199657,0,2,1
56921,6,1,199661,199661,199662,0,1,4
56922,2,3,199663,199663,199666,0,3,1
56923,2,2,199665,199666,199668,1,3,0
56924,6,1,199671,199671,199672,0,1,3
56925,3,3,199674,199674,199677,0,3,2
56926,4,1,199678,199678,199679,0,1,1
56927,1,1,199679,199679,199680,0,1,0
56928,5,1,199684,199684,199685,0,1,4
56929,6,1,199690,199690,199691,0,1,5
56930,5,3,199695,199695,199698,0,3,4
56931,5,3,199700,199700,199703,0,3,2
56932,2,3,199702,199703,199706,1,4,0
56933,4,3,199706,199706,199709,0,3,0
56934,2,2,199708,199709,199711,1,3,0
56935,1,2,199709,199711,199713,2,4,0
56936,6,2,199715,199715,199717,0,2,2
56937,6,2,199721,199721,199723,0,2,4
56938,3,1,199724,199724,199725,0,1,1
56939,1,3,199725,199725,199728,0,3,0
56940,6,3,199731,199731,199734,0,3,3
56941,1,2,199732,199734,199736,2,4,0
56942,2,3,199734,199736,199739,2,5,0
56943,3,3,199737,199739,199742,2,5,0
56944,6,1,199743,199743,199744,0,1,1
56945,2,2,199745,199745,199747,0,2,1
56946,3,2,199748,199748,199750,0,2,1
56947,2,2,199750,199750,199752,0,2,0
56948,2,1,199752,199752,199753,0,1,0
56949,3,1,199755,199755,199756,0,1,2
56950,6,2,199761,199761,199763,0,2,5
56951,4,2,199765,199765,199767,0,2,2
56952,3,1,199768,199768,199769,0,1,1
56953,3,2,199771,199771,199773,0,2,2
56954,1,2,199772,199773,199775,1,3,0
56955,2,2,199774,199775,199777,1,3,0
56956,4,1,199778,199778,199779,0,1,1
56957,4,3,199782,199782,199785,0,3,3
56958,1,1,199783,199785,199786,2,3,0
56959,5,2,199788,199788,199790,0,2,2
56960,4,2,199792,199792,199794,0,2,2
56961,5,1,199797,199797,199798,0,1,3
56962,5,1,199802,199802,199803,0,1,4
56963,3,1,199805,199805,199806,0,1,2
56964,3,2,199808,199808,199810,0,2,2
56965,5,2,199813,199813,199815,0,2,3
56966,6,1,199819,199819,199820,0,1,4
56967,5,1,199824,199824,199825,0,1,4
56968,4,2,199828,199828,199830,0,2,3
56969,2,3,199830,199830,199833,0,3,0
56970,5,2,199835,199835,199837,0,2,2
56971,3,2,199838,199838,199840,0,2,1
56972,5,2,199843,199843,199845,0,2,3
56973,3,3,199846,199846,199849,0,3,1
56974,2,1,199848,199849,199850,1,2,0
56975,5,2,199853,199853,199855,0,2,3
56976,5,2,199858,199858,199860,0,2,3
56977,6,2,199864,199864,199866,0,2,4
56978,1,1,199865,199866,199867,1,2,0
56979,3,1,199868,199868,199869,0,1,1
56980,5,3,199873,199873,199876,0,3,4
56981,2,2,199875,199876,199878,1,3,0
56982,1,1,199876,199878,199879,2,3,0
56983,4,2,199880,199880,199882,0,2,1
56984,6,1,199886,199886,199887,0,1,4
56985,5,3,199891,199891,199894,0,3,4
56986,4,3,199895,199895,199898,0,3,1
56987,3,1,199898,199898,199899,0,1,0
56988,5,1,199903,199903,199904,0,1,4
56989,1,2,199904,199904,199906,0,2,0
56990,1,3,199905,199906,199909,1,4,0
56991,1,1,199906,199909,199910,3,4,0
56992,5,2,199911,199911,199913,0,2,1
56993,4,3,199915,199915,199918,0,3,2
56994,2,1,199917,199918,199919,1,2,0
56995,1,3,199918,199919,199922,1,4,0
56996,4,2,199922,199922,199924,0,2,0
56997,6,1,199928,199928,199929,0,1,4
56998,5,3,199933,199933,199936,0,3,4
56999,3,3,199936,199936,199939,0,3,0
57000,2,2,199938,199939,199941,1,3,0
57001,4,2,199942,199942,199944,0,2,1
57002,3,1,199945,199945,199946,0,1,1
57003,6,1,199951,199951,199952,0,1,5
57004,5,1,199956,199956,199957,0,1,4
57005,5,3,199961,199961,199964,0,3,4
57006,5,1,199966,199966,199967,0,1,2
57007,1,3,199967,199967,199970,0,3,0
57008,6,1,199973,199973,199974,0,1,3
57009,2,3,199975,199975,199978,0,3,1
57010,5,2,199980,199980,199982,0,2,2
57011,3,3,199983,199983,199986,0,3,1
57012,5,3,199988,199988,199991,0,3,2
57013,5,1,199993,199993,199994,0,1,2
57014,6,2,199999,199999,200001,0,2,5
57015,3,3,200002,200002,200005,0,3,1
57016,3,1,200005,200005,200006,0,1,0
57017,6,2,200011,200011,200013,0,2,5
57018,5,2,200016,200016,200018,0,2,3
57019,6,2,200022,200022,200024,0,2,4
57020,3,1,200025,200025,200026,0,1,1
57021,6,2,200031,200031,200033,0,2,5
57022,1,2,200032,200033,200035,1,3,0
57023,5,1,200037,200037,200038,0,1,2
57024,2,1,200039,200039,200040,0,1,1
57025,3,1,200042,200042,200043,0,1,2
57026,4,2,200046,200046,200048,0,2,3
57027,2,3,200048,200048,200051,0,3,0
57028,4,2,200052,200052,200054,0,2,1
57029,3,3,200055,200055,200058,0,3,1
57030,5,3,200060,200060,200063,0,3,2
57031,5,3,200065,200065,200068,0,3,2
57032,4,2,200069,200069,200071,0,2,1
57033,1,3,200070,200071,200074,1,4,0
57034,6,2,200076,200076,200078,0,2,2
57035,1,3,200077,200078,200081,1,4,0
57036,3,2,200080,200081,200083,1,3,0
57037,6,1,200086,200086,200087,0,1,3
57038,3,3,200089,200089,200092,0,3,2
57039,1,2,200090,200092,200094,2,4,0
57040,3,2,200093,200094,200096,1,3,0
57041,4,1,200097,200097,200098,0,1,1
57042,5,3,200102,200102,200105,0,3,4
57043,1,3,200103,200105,200108,2,5,0
57044,3,1,200106,200108,200109,2,3,0
57045,4,2,200110,200110,200112,0,2,1
57046,1,1,200111,200112,200113,1,2,0
57047,5,2,200116,200116,200118,0,2,3
57048,1,1,200117,200118,200119,1,2,0
57049,3,1,200120,200120,200121,0,1,1
57050,4,2,200124,200124,200126,0,2,3
57051,5,3,200129,200129,200132,0,3,3
57052,1,1,200130,200132,200133,2,3,0
57053,4,2,200134,200134,200136,0,2,1
57054,4,1,200138,200138,200139,0,1,2
57055,4,3,200142,200142,200145,0,3,3
57056,4,3,200146,200146,200149,0,3,1
57057,1,1,200147,200149,200150,2,3,0
57058,6,3,200153,200153,200156,0,3,3
57059,1,3,200154,200156,200159,2,5,0
57060,2,2,200156,200159,200161,3,5,0
57061,6,1,200162,200162,200163,0,1,1
57062,3,3,200165,200165,200168,0,3,2
57063,6,1,200171,200171,200172,0,1,3
57064,4,1,200175,200175,200176,0,1,3
57065,3,3,200178,200178,200181,0,3,2
57066,3,3,200181,200181,200184,0,3,0
57067,1,2,200182,200184,200186,2,4,0
57068,3,3,200185,200186,200189,1,4,0
57069,4,1,200189,200189,200190,0,1,0
57070,1,2,200190,200190,200192,0,2,0
57071,6,3,200196,200196,200199,0,3,4
57072,3,3,200199,200199,200202,0,3,0
57073,3,2,200202,200202,200204,0,2,0
57074,2,2,200204,200204,200206,0,2,0
57075,6,1,200210,200210,200211,0,1,4
57076,6,1,200216,200216,200217,0,1,5
57077,4,2,200220,200220,200222,0,2,3
57078,6,3,200226,200226,200229,0,3,4
57079,2,3,200228,200229,200232,1,4,0
57080,4,1,200232,200232,200233,0,1,0
57081,4,1,200236,200236,200237,0,1,3
57082,4,2,200240,200240,200242,0,2,3
57083,3,3,200243,200243,200246,0,3,1
57084,2,3,200245,200246,200249,1,4,0
57085,5,1,200250,200250,200251,0,1,1
57086,2,2,200252,200252,200254,0,2,1
57087,2,3,200254,200254,200257,0,3,0
57088,4,2,200258,200258,200260,0,2,1
57089,1,3,200259,200260,200263,1,4,0
57090,2,2,200261,200263,200265,2,4,0
57091,2,2,200263,200265,200267,2,4,0
57092,1,1,200264,200267,200268,3,4,0
57093,4,1,200268,200268,200269,0,1,0
57094,3,1,200271,200271,200272,0,1,2
57095,6,3,200277,200277,200280,0,3,5
57096,5,1,200282,200282,200283,0,1,2
57097,2,1,200284,200284,200285,0,1,1
57098,6,1,200290,200290,200291,0,1,5
57099,2,2,200292,200292,200294,0,2,1
57100,4,3,200296,200296,200299,0,3,2
57101,3,1,200299,200299,200300,0,1,0
57102,2,3,200301,200301,200304,0,3,1
57103,3,1,200304,200304,200305,0,1,0
57104,6,3,200310,200310,200313,0,3,5
57105,6,2,200316,200316,200318,0,2,3
57106,1,2,200317,200318,200320,1,3,0
57107,3,3,200320,200320,200323,0,3,0
57108,4,1,200324,200324,200325,0,1,1
57109,3,1,200327,200327,200328,0,1,2
57110,2,1,200329,200329,200330,0,1,1
57111,1,2,200330,200330,200332,0,2,0
57112,5,1,200335,200335,200336,0,1,3
57113,3,3,200338,200338,200341,0,3,2
57114,5,1,200343,200343,200344,0,1,2
57115,5,3,200348,200348,200351,0,3,4
57116,3,3,200351,200351,200354,0,3,0
57117,2,1,200353,200354,200355,1,2,0
57118,1,2,200354,200355,200357,1,3,0
57119,5,3,200359,200359,200362,0,3,2
57120,3,3,200362,200362,200365,0,3,0
57121,4,3,200366,200366,200369,0,3,1
57122,3,3,200369,200369,200372,0,3,0
57123,2,3,200371,200372,200375,1,4,0
57124,6,2,200377,200377,200379,0,2,2
57125,2,2,200379,200379,200381,0,2,0
57126,6,3,200385,200385,200388,0,3,4
57127,2,3,200387,200388,200391,1,4,0
57128,1,3,200388,200391,200394,3,6,0
57129,4,2,200392,200394,200396,2,4,0
57130,3,1,200395,200396,200397,1,2,0
57131,3,1,200398,200398,200399,0,1,1
57132,1,1,200399,200399,200400,0,1,0
57133,5,3,200404,200404,200407,0,3,4
57134,6,1,200410,200410,200411,0,1,3
57135,4,3,200414,200414,200417,0,3,3
57136,4,3,200418,200418,200421,0,3,1
57137,1,3,200419,200421,200424,2,5,0
57138,1,1,200420,200424,200425,4,5,0
57139,1,3,200421,200425,200428,4,7,0
57140,4,3,200425,200428,200431,3,6,0
57141,6,2,200431,200431,200433,0,2,0
57142,2,1,200433,200433,200434,0,1,0
57143,2,3,200435,200435,200438,0,3,1
57144,3,3,200438,200438,200441,0,3,0
57145,1,1,200439,200441,200442,2,3,0
57146,3,1,200442,200442,200443,0,1,0
57147,1,3,200443,200443,200446,0,3,0
57148,4,2,200447,200447,200449,0,2,1
57149,1,3,200448,200449,200452,1,4,0
57150,1,2,200449,200452,200454,3,5,0
57151,6,1,200455,200455,200456,0,1,1
57152,4,2,200459,200459,200461,0,2,3
57153,3,1,200462,200462,200463,0,1,1
57154,5,3,200467,200467,200470,0,3,4
57155,6,2,200473,200473,200475,0,2,3
57156,6,3,200479,200479,200482,0,3,4
57157,4,2,200483,200483,200485,0,2,1
57158,3,2,200486,200486,200488,0,2,1
57159,6,2,200492,200492,200494,0,2,4
57160,6,3,200498,200498,200501,0,3,4
57161,5,1,200503,200503,200504,0,1,2
57162,5,3,200508,200508,200511,0,3,4
57163,6,2,200514,200514,200516,0,2,3
57164,6,3,200520,200520,200523,0,3,4
57165,2,1,200522,200523,200524,1,2,0
57166,1,1,200523,200524,200525,1,2,0
57167,3,3,200526,200526,200529,0,3,1
57168,6,3,200532,200532,200535,0,3,3
57169,3,2,200535,200535,200537,0,2,0
57170,5,3,200540,200540,200543,0,3,3
57171,1,3,200541,200543,200546,2,5,0
57172,6,3,200547,200547,200550,0,3,1
57173,1,3,200548,200550,200553,2,5,0
57174,6,1,200554,200554,200555,0,1,1
57175,2,1,200556,200556,200557,0,1,1
57176,6,1,200562,200562,200563,0,1,5
57177,2,3,200564,200564,200567,0,3,1
57178,2,3,200566,200567,200570,1,4,0
57179,1,2,200567,200570,200572,3,5,0
57180,4,2,200571,200572,200574,1,3,0
57181,4,1,200575,200575,200576,0,1,1
57182,2,2,200577,200577,200579,0,2,1
57183,1,2,200578,200579,200581,1,3,0
57184,2,1,200580,200581,200582,1,2,0
57185,2,3,200582,200582,200585,0,3,0
57186,4,1,200586,200586,200587,0,1,1
57187,2,1,200588,200588,200589,0,1,1
57188,4,1,200592,200592,200593,0,1,3
57189,2,1,200594,200594,200595,0,1,1
57190,4,3,200598,200598,200601,0,3,3
57191,3,1,200601,200601,200602,0,1,0
57192,1,1,200602,200602,200603,0,1,0
57193,6,1,200608,200608,200609,0,1,5
57194,6,1,200614,200614,200615,0,1,5
57195,2,3,200616,200616,200619,0,3,1
57196,5,1,200621,200621,200622,0,1,2
57197,5,3,200626,200626,200629,0,3,4
57198,1,1,200627,200629,200630,2,3,0
57199,5,3,200632,200632,200635,0,3,2
57200,5,1,200637,200637,200638,0,1,2
57201,4,2,200641,200641,200643,0,2,3
57202,4,3,200645,200645,200648,0,3,2
57203,1,1,200646,200648,200649,2,3,0
57204,4,3,200650,200650,200653,0,3,1
57205,6,1,200656,200656,200657,0,1,3
57206,1,2,200657,200657,200659,0,2,0
57207,6,1,200663,200663,200664,0,1,4
57208,6,3,200669,200669,200672,0,3,5
57209,4,2,200673,200673,200675,0,2,1
57210,5,2,200678,200678,200680,0,2,3
57211,3,2,200681,200681,200683,0,2,1
57212,3,1,200684,200684,200685,0,1,1
57213,4,1,200688,200688,200689,0,1,3
57214,2,2,200690,200690,200692,0,2,1
57215,1,3,200691,200692,200695,1,4,0
57216,2,1,200693,200695,200696,2,3,0
57217,5,2,200698,200698,200700,0,2,2
57218,4,3,200702,200702,200705,0,3,2
57219,2,2,200704,200705,200707,1,3,0
57220,3,3,200707,200707,200710,0,3,0
57221,5,2,200712,200712,200714,0,2,2
57222,5,2,200717,200717,200719,0,2,3
57223,1,3,200718,200719,200722,1,4,0
57224,3,2,200721,200722,200724,1,3,0
57225,6,2,200727,200727,200729,0,2,3
57226,2,1,200729,200729,200730,0,1,0
57227,2,2,200731,200731,200733,0,2,1
57228,5,1,200736,200736,200737,0,1,3
57229,3,1,200739,200739,200740,0,1,2
57230,4,1,200743,200743,200744,0,1,3
57231,5,3,200748,200748,200751,0,3,4
57232,6,2,200754,200754,200756,0,2,3
57233,3,2,200757,200757,200759,0,2,1
57234,1,3,200758,200759,200762,1,4,0
57235,3,1,200761,200762,200763,1,2,0
57236,5,3,200766,200766,200769,0,3,3
57237,4,3,200770,200770,200773,0,3,1
57238,5,3,200775,200775,200778,0,3,2
57239,1,1,200776,200778,200779,2,3,0
57240,4,3,200780,200780,200783,0,3,1
57241,1,2,200781,200783,200785,2,4,0
57242,5,2,200786,200786,200788,0,2,1
57243,1,1,200787,200788,200789,1,2,0
57244,4,3,200791,200791,200794,0,3,2
57245,5,3,200796,200796,200799,0,3,2
57246,6,2,200802,200802,200804,0,2,3
57247,1,3,200803,200804,200807,1,4,0
57248,1,1,200804,200807,200808,3,4,0
57249,4,1,200808,200808,200809,0,1,0
57250,2,1,200810,200810,200811,0,1,1
57251,3,3,200813,200813,200816,0,3,2
57252,2,2,200815,200816,200818,1,3,0
57253,6,2,200821,200821,200823,0,2,3
57254,3,2,200824,200824,200826,0,2,1
57255,3,3,200827,200827,200830,0,3,1
57256,4,2,200831,200831,200833,0,2,1
57257,6,1,200837,200837,200838,0,1,4
57258,4,2,200841,200841,200843,0,2,3
57259,1,1,200842,200843,200844,1,2,0
57260,2,2,200844,200844,200846,0,2,0
57261,6,3,200850,200850,200853,0,3,4
57262,5,2,200855,200855,200857,0,2,2
57263,2,2,200857,200857,200859,0,2,0
57264,3,2,200860,200860,200862,0,2,1
57265,4,3,200864,200864,200867,0,3,2
57266,4,2,200868,200868,200870,0,2,1
57267,1,2,200869,200870,200872,1,3,0
57268,5,2,200874,200874,200876,0,2,2
57269,1,3,200875,200876,200879,1,4,0
57270,2,2,200877,200879,200881,2,4,0
57271,5,2,200882,200882,200884,0,2,1
57272,3,1,200885,200885,200886,0,1,1
57273,3,3,200888,200888,200891,0,3,2
57274,6,1,200894,200894,200895,0,1,3
57275,2,1,200896,200896,200897,0,1,1
57276,3,2,200899,200899,200901,0,2,2
57277,6,1,200905,200905,200906,0,1,4
57278,1,1,200906,200906,200907,0,1,0
57279,2,2,200908,200908,200910,0,2,1
57280,3,1,200911,200911,200912,0,1,1
57281,2,3,200913,200913,200916,0,3,1
57282,3,2,200916,200916,200918,0,2,0
57283,1,1,200917,200918,200919,1,2,0
57284,5,3,200922,200922,200925,0,3,3
57285,4,3,200926,200926,200929,0,3,1
57286,3,3,200929,200929,200932,0,3,0
57287,2,1,200931,200932,200933,1,2,0
57288,4,1,200935,200935,200936,0,1,2
57289,1,2,200936,200936,200938,0,2,0
57290,1,2,200937,200938,200940,1,3,0
57291,2,1,200939,200940,200941,1,2,0
57292,1,2,200940,200941,200943,1,3,0
57293,6,1,200946,200946,200947,0,1,3
57294,6,2,200952,200952,200954,0,2,5
57295,3,3,200955,200955,200958,0,3,1
57296,6,3,200961,200961,200964,0,3,3
57297,1,3,200962,200964,200967,2,5,0
57298,6,3,200968,200968,200971,0,3,1
57299,5,3,200973,200973,200976,0,3,2
57300,3,1,200976,200976,200977,0,1,0
57301,1,1,200977,200977,200978,0,1,0
57302,1,2,200978,200978,200980,0,2,0
57303,3,1,200981,200981,200982,0,1,1
57304,6,2,200987,200987,200989,0,2,5
57305,6,1,200993,200993,200994,0,1,4
57306,1,3,200994,200994,200997,0,3,0
57307,1,3,200995,200997,201000,2,5,0
57308,5,3,201000,201000,201003,0,3,0
57309,2,2,201002,201003,201005,1,3,0
57310,4,3,201006,201006,201009,0,3,1
57311,4,1,201010,201010,201011,0,1,1
57312,1,1,201011,201011,201012,0,1,0
57313,6,3,201017,201017,201020,0,3,5
57314,4,3,201021,201021,201024,0,3,1
57315,2,2,201023,201024,201026,1,3,0
57316,2,3,201025,201026,201029,1,4,0
57317,2,3,201027,201029,201032,2,5,0
57318,4,2,201031,201032,201034,1,3,0
57319,5,2,201036,201036,201038,0,2,2
57320,1,3,201037,201038,201041,1,4,0
57321,3,2,201040,201041,201043,1,3,0
57322,1,2,201041,201043,201045,2,4,0
57323,5,1,201046,201046,201047,0,1,1
57324,6,3,201052,201052,201055,0,3,5
57325,1,1,201053,201055,201056,2,3,0
57326,5,3,201058,201058,201061,0,3,2
57327,1,1,201059,201061,201062,2,3,0
57328,4,1,201063,201063,201064,0,1,1
57329,6,2,201069,201069,201071,0,2,5
57330,6,2,201075,201075,201077,0,2,4
57331,5,3,201080,201080,201083,0,3,3
57332,2,1,201082,201083,201084,1,2,0
57333,3,1,201085,201085,201086,0,1,1
57334,3,3,201088,201088,201091,0,3,2
57335,5,3,201093,201093,201096,0,3,2
57336,1,3,201094,201096,201099,2,5,0
57337,3,1,201097,201099,201100,2,3,0
57338,6,2,201103,201103,201105,0,2,3
57339,3,3,201106,201106,201109,0,3,1
57340,5,3,201111,201111,201114,0,3,2
57341,2,1,201113,201114,201115,1,2,0
57342,6,3,201119,201119,201122,0,3,4
57343,5,1,201124,201124,201125,0,1,2
57344,5,2,201129,201129,201131,0,2,4
57345,6,3,201135,201135,201138,0,3,4
57346,4,3,201139,201139,201142,0,3,1
57347,4,3,201143,201143,201146,0,3,1
57348,4,3,201147,201147,201150,0,3,1
57349,5,1,201152,201152,201153,0,1,2
57350,2,3,201154,201154,201157,0,3,1
57351,3,2,201157,201157,201159,0,2,0
57352,6,2,201163,201163,201165,0,2,4
57353,3,1,201166,201166,201167,0,1,1
57354,6,1,201172,201172,201173,0,1,5
57355,4,1,201176,201176,201177,0,1,3
57356,6,2,201182,201182,201184,0,2,5
57357,4,3,201186,201186,201189,0,3,2
57358,6,1,201192,201192,201193,0,1,3
57359,1,3,201193,201193,201196,0,3,0
57360,1,1,201194,201196,201197,2,3,0
57361,3,1,201197,201197,201198,0,1,0
57362,2,2,201199,201199,201201,0,2,1
57363,6,1,201205,201205,201206,0,1,4
57364,2,2,201207,201207,201209,0,2,1
57365,3,1,201210,201210,201211,0,1,1
57366,6,1,201216,201216,201217,0,1,5
57367,1,1,201217,201217,201218,0,1,0
57368,1,3,201218,201218,201221,0,3,0
57369,4,3,201222,201222,201225,0,3,1
57370,6,2,201228,201228,201230,0,2,3
57371,1,1,201229,201230,201231,1,2,0
57372,2,1,201231,201231,201232,0,1,0
57373,3,2,201234,201234,201236,0,2,2
57374,6,3,201240,201240,201243,0,3,4
57375,2,3,201242,201243,201246,1,4,0
57376,6,3,201248,201248,201251,0,3,2
57377,5,1,201253,201253,201254,0,1,2
57378,3,3,201256,201256,201259,0,3,2
57379,4,2,201260,201260,201262,0,2,1
57380,1,1,201261,201262,201263,1,2,0
57381,1,2,201262,201263,201265,1,3,0
57382,3,2,201265,201265,201267,0,2,0
57383,1,3,201266,201267,201270,1,4,0
57384,5,2,201271,201271,201273,0,2,1
57385,5,1,201276,201276,201277,0,1,3
57386,6,2,201282,201282,201284,0,2,5
57387,1,3,201283,201284,201287,1,4,0
57388,1,1,201284,201287,201288,3,4,0
57389,3,3,201287,201288,201291,1,4,0
57390,4,3,201291,201291,201294,0,3,0
57391,5,3,201296,201296,201299,0,3,2
57392,2,1,201298,201299,201300,1,2,0
57393,5,3,201303,201303,201306,0,3,3
57394,6,3,201309,201309,201312,0,3,3
57395,5,3,201314,201314,201317,0,3,2
57396,4,2,201318,201318,201320,0,2,1
57397,3,2,201321,201321,201323,0,2,1
57398,2,1,201323,201323,201324,0,1,0
57399,1,1,201324,201324,201325,0,1,0
57400,6,3,201330,201330,201333,0,3,5
57401,6,1,201336,201336,201337,0,1,3
57402,3,1,201339,201339,201340,0,1,2
57403,4,2,201343,201343,201345,0,2,3
57404,4,1,201347,201347,201348,0,1,2
57405,4,1,201351,201351,201352,0,1,3
57406,6,2,201357,201357,201359,0,2,5
57407,1,1,201358,201359,201360,1,2,0
57408,6,3,201364,201364,201367,0,3,4
57409,5,3,201369,201369,201372,0,3,2
57410,3,3,201372,201372,201375,0,3,0
57411,6,1,201378,201378,201379,0,1,3
57412,4,2,201382,201382,201384,0,2,3
57413,3,2,201385,201385,201387,0,2,1
57414,4,2,201389,201389,201391,0,2,2
57415,6,3,201395,201395,201398,0,3,4
57416,5,1,201400,201400,201401,0,1,2
57417,4,3,201404,201404,201407,0,3,3
57418,4,1,201408,201408,201409,0,1,1
57419,2,1,201410,201410,201411,0,1,1
57420,5,1,201415,201415,201416,0,1,4
57421,5,1,201420,201420,201421,0,1,4
57422,2,2,201422,201422,201424,0,2,1
57423,2,3,201424,201424,201427,0,3,0
57424,3,3,201427,201427,201430,0,3,0
57425,6,1,201433,201433,201434,0,1,3
57426,6,3,201439,201439,201442,0,3,5
57427,4,1,201443,201443,201444,0,1,1
57428,3,1,201446,201446,201447,0,1,2
57429,3,2,201449,201449,201451,0,2,2
57430,3,3,201452,201452,201455,0,3,1
57431,4,1,201456,201456,201457,0,1,1
57432,2,1,201458,201458,201459,0,1,1
57433,4,1,201462,201462,201463,0,1,3
57434,6,2,201468,201468,201470,0,2,5
57435,6,1,201474,201474,201475,0,1,4
57436,4,3,201478,201478,201481,0,3,3
57437,6,2,201484,201484,201486,0,2,3
57438,6,3,201490,201490,201493,0,3,4
57439,5,2,201495,201495,201497,0,2,2
57440,5,2,201500,201500,201502,0,2,3
57441,4,1,201504,201504,201505,0,1,2
57442,6,1,201510,201510,201511,0,1,5
57443,1,1,201511,201511,201512,0,1,0
57444,6,2,201517,201517,201519,0,2,5
57445,2,1,201519,201519,201520,0,1,0
57446,3,1,201522,201522,201523,0,1,2
57447,3,2,201525,201525,201527,0,2,2
57448,4,1,201529,201529,201530,0,1,2
57449,4,1,201533,201533,201534,0,1,3
57450,6,2,201539,201539,201541,0,2,5
57451,1,2,201540,201541,201543,1,3,0
57452,6,1,201546,201546,201547,0,1,3
57453,5,2,201551,201551,201553,0,2,4
57454,2,1,201553,201553,201554,0,1,0
57455,6,2,201559,201559,201561,0,2,5
57456,6,3,201565,201565,201568,0,3,4
57457,5,1,201570,201570,201571,0,1,2
57458,6,2,201576,201576,201578,0,2,5
57459,5,2,201581,201581,201583,0,2,3
57460,6,2,201587,201587,201589,0,2,4
57461,3,1,201590,201590,201591,0,1,1
57462,1,1,201591,201591,201592,0,1,0
57463,4,2,201595,201595,201597,0,2,3
57464,2,3,201597,201597,201600,0,3,0
57465,5,1,201602,201602,201603,0,1,2
57466,5,1,201607,201607,201608,0,1,4
57467,1,1,201608,201608,201609,0,1,0
57468,2,3,201610,201610,201613,0,3,1
57469,2,1,201612,201613,201614,1,2,0
57470,3,3,201615,201615,201618,0,3,1
57471,1,2,201616,201618,201620,2,4,0
57472,2,3,201618,201620,201623,2,5,0
57473,5,1,201623,201623,201624,0,1,0
57474,6,1,201629,201629,201630,0,1,5
57475,4,1,201633,201633,201634,0,1,3
57476,1,1,201634,201634,201635,0,1,0
57477,3,3,201637,201637,201640,0,3,2
57478,3,1,201640,201640,201641,0,1,0
57479,6,3,201646,201646,201649,0,3,5
57480,3,3,201649,201649,201652,0,3,0
57481,2,3,201651,201652,201655,1,4,0
57482,3,3,201654,201655,201658,1,4,0
57483,2,2,201656,201658,201660,2,4,0
57484,4,3,201660,201660,201663,0,3,0
57485,3,1,201663,201663,201664,0,1,0
57486,2,2,201665,201665,201667,0,2,1
57487,2,3,201667,201667,201670,0,3,0
57488,1,1,201668,201670,201671,2,3,0
57489,1,1,201669,201671,201672,2,3,0
57490,2,1,201671,201672,201673,1,2,0
57491,1,1,201672,201673,201674,1,2,0
57492,1,1,201673,201674,201675,1,2,0
57493,6,1,201679,201679,201680,0,1,4
57494,5,2,201684,201684,201686,0,2,4
57495,6,3,201690,201690,201693,0,3,4
57496,3,1,201693,201693,201694,0,1,0
57497,1,3,201694,201694,201697,0,3,0
57498,5,1,201699,201699,201700,0,1,2
57499,1,1,201700,201700,201701,0,1,0
57500,3,1,201703,201703,201704,0,1,2
57501,6,2,201709,201709,201711,0,2,5
57502,1,1,201710,201711,201712,1,2,0
57503,6,2,201716,201716,201718,0,2,4
57504,5,3,201721,201721,201724,0,3,3
57505,1,1,201722,201724,201725,2,3,0
57506,2,2,201724,201725,201727,1,3,0
57507,4,3,201728,201728,201731,0,3,1
57508,4,2,201732,201732,201734,0,2,1
57509,2,3,201734,201734,201737,0,3,0
57510,5,2,201739,201739,201741,0,2,2
57511,1,1,201740,201741,201742,1,2,0
57512,6,2,201746,201746,201748,0,2,4
57513,4,1,201750,201750,201751,0,1,2
57514,2,2,201752,201752,201754,0,2,1
57515,6,1,201758,201758,201759,0,1,4
57516,3,2,201761,201761,201763,0,2,2
57517,6,3,201767,201767,201770,0,3,4
57518,2,1,201769,201770,201771,1,2,0
57519,2,3,201771,201771,201774,0,3,0
57520,3,1,201774,201774,201775,0,1,0
57521,3,3,201777,201777,201780,0,3,2
57522,4,3,201781,201781,201784,0,3,1
57523,1,3,201782,201784,201787,2,5,0
57524,2,2,201784,201787,201789,3,5,0
57525,4,3,201788,201789,201792,1,4,0
57526,1,2,201789,201792,201794,3,5,0
57527,6,1,201795,201795,201796,0,1,1
57528,5,1,201800,201800,201801,0,1,4
57529,1,1,201801,201801,201802,0,1,0
57530,5,1,201806,201806,201807,0,1,4
57531,5,1,201811,201811,201812,0,1,4
57532,2,1,201813,201813,201814,0,1,1
57533,3,1,201816,201816,201817,0,1,2
57534,2,3,201818,201818,201821,0,3,1
57535,1,1,201819,201821,201822,2,3,0
57536,1,1,201820,201822,201823,2,3,0
57537,3,3,201823,201823,201826,0,3,0
57538,5,2,201828,201828,201830,0,2,2
57539,1,3,201829,201830,201833,1,4,0
57540,2,2,201831,201833,201835,2,4,0
57541,2,1,201833,201835,201836,2,3,0
57542,1,2,201834,201836,201838,2,4,0
57543,4,2,201838,201838,201840,0,2,0
57544,5,3,201843,201843,201846,0,3,3
57545,2,2,201845,201846,201848,1,3,0
57546,4,1,201849,201849,201850,0,1,1
57547,4,1,201853,201853,201854,0,1,3
57548,4,1,201857,201857,201858,0,1,3
57549,2,3,201859,201859,201862,0,3,1
57550,2,1,201861,201862,201863,1,2,0
57551,1,2,201862,201863,201865,1,3,0
57552,5,1,201867,201867,201868,0,1,2
57553,1,2,201868,201868,201870,0,2,0
57554,1,2,201869,201870,201872,1,3,0
57555,6,1,201875,201875,201876,0,1,3
57556,1,2,201876,201876,201878,0,2,0
57557,4,1,201880,201880,201881,0,1,2
57558,2,2,201882,201882,201884,0,2,1
57559,3,2,201885,201885,201887,0,2,1
57560,2,3,201887,201887,201890,0,3,0
57561,2,2,201889,201890,201892,1,3,0
57562,5,2,201894,201894,201896,0,2,2
57563,5,1,201899,201899,201900,0,1,3
57564,3,1,201902,201902,201903,0,1,2
57565,2,3,201904,201904,201907,0,3,1
57566,2,3,201906,201907,201910,1,4,0
57567,4,3,201910,201910,201913,0,3,0
57568,3,1,201913,201913,201914,0,1,0
57569,3,3,201916,201916,201919,0,3,2
57570,2,1,201918,201919,201920,1,2,0
57571,1,3,201919,201920,201923,1,4,0
57572,5,2,201924,201924,201926,0,2,1
57573,3,1,201927,201927,201928,0,1,1
57574,4,3,201931,201931,201934,0,3,3
57575,6,3,201937,201937,201940,0,3,3
57576,2,1,201939,201940,201941,1,2,0
57577,5,1,201944,201944,201945,0,1,3
57578,6,2,201950,201950,201952,0,2,5
57579,6,1,201956,201956,201957,0,1,4
57580,5,2,201961,201961,201963,0,2,4
57581,5,1,201966,201966,201967,0,1,3
57582,4,3,201970,201970,201973,0,3,3
57583,6,1,201976,201976,201977,0,1,3
57584,5,2,201981,201981,201983,0,2,4
57585,4,1,201985,201985,201986,0,1,2
57586,2,1,201987,201987,201988,0,1,1
57587,6,1,201993,201993,201994,0,1,5
57588,3,3,201996,201996,201999,0,3,2
57589,1,2,201997,201999,202001,2,4,0
57590,3,2,202000,202001,202003,1,3,0
57591,1,2,202001,202003,202005,2,4,0
57592,6,1,202007,202007,202008,0,1,2
57593,3,3,202010,202010,202013,0,3,2
57594,3,3,202013,202013,202016,0,3,0
57595,3,3,202016,202016,202019,0,3,0
57596,5,1,202021,202021,202022,0,1,2
57597,6,1,202027,202027,202028,0,1,5
57598,5,2,202032,202032,202034,0,2,4
57599,2,2,202034,202034,202036,0,2,0
57600,6,1,202040,202040,202041,0,1,4
57601,1,3,202041,202041,202044,0,3,0
57602,6,2,202047,202047,202049,0,2,3
57603,4,3,202051,202051,202054,0,3,2
57604,3,3,202054,202054,202057,0,3,0
57605,6,1,202060,202060,202061,0,1,3
57606,2,1,202062,202062,202063,0,1,1
57607,3,2,202065,202065,202067,0,2,2
57608,4,3,202069,202069,202072,0,3,2
57609,6,2,202075,202075,202077,0,2,3
57610,6,1,202081,202081,202082,0,1,4
57611,3,1,202084,202084,202085,0,1,2
57612,1,1,202085,202085,202086,0,1,0
57613,6,1,202091,202091,202092,0,1,5
57614,3,1,202094,202094,202095,0,1,2
57615,3,2,202097,202097,202099,0,2,2
57616,1,3,202098,202099,202102,1,4,0
57617,2,3,202100,202102,202105,2,5,0
57618,3,2,202103,202105,202107,2,4,0
57619,5,2,202108,202108,202110,0,2,1
57620,1,2,202109,202110,202112,1,3,0
57621,5,1,202114,202114,202115,0,1,2
57622,5,3,202119,202119,202122,0,3,4
57623,5,1,202124,202124,202125,0,1,2
57624,3,3,202127,202127,202130,0,3,2
57625,4,3,202131,202131,202134,0,3,1
57626,1,2,202132,202134,202136,2,4,0
57627,4,1,202136,202136,202137,0,1,0
57628,5,2,202141,202141,202143,0,2,4
57629,6,2,202147,202147,202149,0,2,4
57630,3,3,202150,202150,202153,0,3,1
57631,2,3,202152,202153,202156,1,4,0
57632,3,3,202155,202156,202159,1,4,0
57633,4,2,202159,202159,202161,0,2,0
57634,6,2,202165,202165,202167,0,2,4
57635,6,3,202171,202171,202174,0,3,4
57636,3,1,202174,202174,202175,0,1,0
57637,4,1,202178,202178,202179,0,1,3
57638,1,2,202179,202179,202181,0,2,0
57639,5,1,202184,202184,202185,0,1,3
57640,4,1,202188,202188,202189,0,1,3
57641,2,1,202190,202190,202191,0,1,1
57642,6,2,202196,202196,202198,0,2,5
57643,4,2,202200,202200,202202,0,2,2
57644,2,2,202202,202202,202204,0,2,0
57645,4,2,202206,202206,202208,0,2,2
57646,3,3,202209,202209,202212,0,3,1
57647,5,2,202214,202214,202216,0,2,2
57648,4,2,202218,202218,202220,0,2,2
57649,1,2,202219,202220,202222,1,3,0
57650,6,1,202225,202225,202226,0,1,3
57651,4,3,202229,202229,202232,0,3,3
57652,2,2,202231,202232,202234,1,3,0
57653,3,1,202234,202234,202235,0,1,0
57654,5,3,202239,202239,202242,0,3,4
57655,4,2,202243,202243,202245,0,2,1
57656,2,2,202245,202245,202247,0,2,0
57657,2,1,202247,202247,202248,0,1,0
57658,4,3,202251,202251,202254,0,3,3
57659,2,1,202253,202254,202255,1,2,0
57660,4,1,202257,202257,202258,0,1,2
57661,5,3,202262,202262,202265,0,3,4
57662,4,3,202266,202266,202269,0,3,1
57663,1,1,202267,202269,202270,2,3,0
57664,1,2,202268,202270,202272,2,4,0
57665,6,3,202274,202274,202277,0,3,2
57666,1,1,202275,202277,202278,2,3,0
57667,4,2,202279,202279,202281,0,2,1
57668,6,1,202285,202285,202286,0,1,4
57669,2,3,202287,202287,202290,0,3,1
57670,1,1,202288,202290,202291,2,3,0
57671,1,3,202289,202291,202294,2,5,0
57672,6,1,202295,202295,202296,0,1,1
57673,1,1,202296,202296,202297,0,1,0
57674,6,1,202302,202302,202303,0,1,5
57675,5,2,202307,202307,202309,0,2,4
57676,6,1,202313,202313,202314,0,1,4
57677,4,1,202317,202317,202318,0,1,3
57678,2,1,202319,202319,202320,0,1,1
57679,1,3,202320,202320,202323,0,3,0
57680,6,3,202326,202326,202329,0,3,3
57681,4,3,202330,202330,202333,0,3,1
57682,1,3,202331,202333,202336,2,5,0
57683,2,1,202333,202336,202337,3,4,0
57684,6,2,202339,202339,202341,0,2,2
57685,5,2,202344,202344,202346,0,2,3
57686,6,2,202350,202350,202352,0,2,4
57687,6,3,202356,202356,202359,0,3,4
57688,5,1,202361,202361,202362,0,1,2
57689,2,2,202363,202363,202365,0,2,1
57690,4,1,202367,202367,202368,0,1,2
57691,3,3,202370,202370,202373,0,3,2
57692,5,3,202375,202375,202378,0,3,2
57693,5,2,202380,202380,202382,0,2,2
57694,3,1,202383,202383,202384,0,1,1
57695,1,2,202384,202384,202386,0,2,0
57696,4,2,202388,202388,202390,0,2,2
57697,2,2,202390,202390,202392,0,2,0
57698,1,1,202391,202392,202393,1,2,0
57699,4,3,202395,202395,202398,0,3,2
57700,4,2,202399,202399,202401,0,2,1
57701,4,3,202403,202403,202406,0,3,2
57702,4,2,202407,202407,202409,0,2,1
57703,1,1,202408,202409,202410,1,2,0
57704,4,1,202412,202412,202413,0,1,2
57705,4,2,202416,202416,202418,0,2,3
57706,4,2,202420,202420,202422,0,2,2
57707,3,3,202423,202423,202426,0,3,1
57708,3,3,202426,202426,202429,0,3,0
57709,1,3,202427,202429,202432,2,5,0
57710,3,3,202430,202432,202435,2,5,0
57711,4,1,202434,202435,202436,1,2,0
57712,1,2,202435,202436,202438,1,3,0
57713,5,1,202440,202440,202441,0,1,2
57714,1,1,202441,202441,202442,0,1,0
57715,6,2,202447,202447,202449,0,2,5
57716,1,3,202448,202449,202452,1,4,0
57717,4,2,202452,202452,202454,0,2,0
57718,2,3,202454,202454,202457,0,3,0
57719,3,3,202457,202457,202460,0,3,0
57720,5,2,202462,202462,202464,0,2,2
57721,4,1,202466,202466,202467,0,1,2
57722,1,3,202467,202467,202470,0,3,0
57723,5,2,202472,202472,202474,0,2,2
57724,4,3,202476,202476,202479,0,3,2
57725,1,1,202477,202479,202480,2,3,0
57726,2,2,202479,202480,202482,1,3,0
57727,2,3,202481,202482,202485,1,4,0
57728,1,3,202482,202485,202488,3,6,0
57729,1,3,202483,202488,202491,5,8,0
57730,3,3,202486,202491,202494,5,8,0
57731,3,1,202489,202494,202495,5,6,0
57732,2,3,202491,202495,202498,4,7,0
57733,2,1,202493,202498,202499,5,6,0
57734,1,3,202494,202499,202502,5,8,0
57735,1,3,202495,202502,202505,7,10,0
57736,3,1,202498,202505,202506,7,8,0
57737,1,3,202499,202506,202509,7,10,0
57738,5,3,202504,202509,202512,5,8,0
57739,6,1,202510,202512,202513,2,3,0
57740,2,2,202512,202513,202515,1,3,0
57741,6,2,202518,202518,202520,0,2,3
57742,3,3,202521,202521,202524,0,3,1
57743,3,2,202524,202524,202526,0,2,0
57744,6,3,202530,202530,202533,0,3,4
57745,2,3,202532,202533,202536,1,4,0
57746,2,2,202534,202536,202538,2,4,0
57747,3,2,202537,202538,202540,1,3,0
57748,1,1,202538,202540,202541,2,3,0
57749,6,2,202544,202544,202546,0,2,3
57750,3,3,202547,202547,202550,0,3,1
57751,3,3,202550,202550,202553,0,3,0
57752,6,3,202556,202556,202559,0,3,3
57753,5,3,202561,202561,202564,0,3,2
57754,1,2,202562,202564,202566,2,4,0
57755,6,3,202568,202568,202571,0,3,2
57756,5,2,202573,202573,202575,0,2,2
57757,6,1,202579,202579,202580,0,1,4
57758,3,1,202582,202582,202583,0,1,2
57759,1,2,202583,202583,202585,0,2,0
57760,5,2,202588,202588,202590,0,2,3
57761,5,2,202593,202593,202595,0,2,3
57762,3,3,202596,202596,202599,0,3,1
57763,6,3,202602,202602,202605,0,3,3
57764,2,1,202604,202605,202606,1,2,0
57765,3,1,202607,202607,202608,0,1,1
57766,1,2,202608,202608,202610,0,2,0
57767,2,1,202610,202610,202611,0,1,0
57768,5,2,202615,202615,202617,0,2,4
57769,2,3,202617,202617,202620,0,3,0
57770,1,3,202618,202620,202623,2,5,0
57771,3,3,202621,202623,202626,2,5,0
57772,6,3,202627,202627,202630,0,3,1
57773,1,3,202628,202630,202633,2,5,0
57774,5,3,202633,202633,202636,0,3,0
57775,4,1,202637,202637,202638,0,1,1
57776,6,2,202643,202643,202645,0,2,5
57777,6,1,202649,202649,202650,0,1,4
57778,2,2,202651,202651,202653,0,2,1
57779,6,3,202657,202657,202660,0,3,4
57780,2,2,202659,202660,202662,1,3,0
57781,3,3,202662,202662,202665,0,3,0
57782,5,1,202667,202667,202668,0,1,2
57783,3,2,202670,202670,202672,0,2,2
57784,4,2,202674,202674,202676,0,2,2
57785,3,1,202677,202677,202678,0,1,1
57786,5,3,202682,202682,202685,0,3,4
57787,5,3,202687,202687,202690,0,3,2
57788,2,2,202689,202690,202692,1,3,0
57789,3,1,202692,202692,202693,0,1,0
57790,5,2,202697,202697,202699,0,2,4
57791,2,2,202699,202699,202701,0,2,0
57792,5,1,202704,202704,202705,0,1,3
57793,1,1,202705,202705,202706,0,1,0
57794,4,1,202709,202709,202710,0,1,3
57795,2,2,202711,202711,202713,0,2,1
57796,2,1,202713,202713,202714,0,1,0
57797,5,1,202718,202718,202719,0,1,4
57798,5,2,202723,202723,202725,0,2,4
57799,5,3,202728,202728,202731,0,3,3
57800,1,3,202729,202731,202734,2,5,0
57801,5,2,202734,202734,202736,0,2,0
57802,1,3,202735,202736,202739,1,4,0
57803,2,3,202737,202739,202742,2,5,0
57804,4,1,202741,202742,202743,1,2,0
57805,6,3,202747,202747,202750,0,3,4
57806,4,3,202751,202751,202754,0,3,1
57807,6,1,202757,202757,202758,0,1,3
57808,4,2,202761,202761,202763,0,2,3
57809,4,2,202765,202765,202767,0,2,2
57810,3,3,202768,202768,202771,0,3,1
57811,1,3,202769,202771,202774,2,5,0
57812,5,2,202774,202774,202776,0,2,0
57813,5,2,202779,202779,202781,0,2,3
57814,1,1,202780,202781,202782,1,2,0
57815,3,1,202783,202783,202784,0,1,1
57816,6,3,202789,202789,202792,0,3,5
57817,1,2,202790,202792,202794,2,4,0
57818,4,2,202794,202794,202796,0,2,0
57819,3,1,202797,202797,202798,0,1,1
57820,5,1,202802,202802,202803,0,1,4
57821,4,3,202806,202806,202809,0,3,3
57822,4,3,202810,202810,202813,0,3,1
57823,5,1,202815,202815,202816,0,1,2
57824,5,2,202820,202820,202822,0,2,4
57825,2,1,202822,202822,202823,0,1,0
57826,5,2,202827,202827,202829,0,2,4
57827,1,1,202828,202829,202830,1,2,0
57828,5,1,202833,202833,202834,0,1,3
57829,6,1,202839,202839,202840,0,1,5
57830,4,2,202843,202843,202845,0,2,3
57831,5,2,202848,202848,202850,0,2,3
57832,5,2,202853,202853,202855,0,2,3
57833,3,3,202856,202856,202859,0,3,1
57834,2,3,202858,202859,202862,1,4,0
57835,3,3,202861,202862,202865,1,4,0
57836,5,2,202866,202866,202868,0,2,1
57837,3,3,202869,202869,202872,0,3,1
57838,5,3,202874,202874,202877,0,3,2
57839,1,2,202875,202877,202879,2,4,0
57840,2,3,202877,202879,202882,2,5,0
57841,1,2,202878,202882,202884,4,6,0
57842,6,2,202884,202884,202886,0,2,0
57843,2,3,202886,202886,202889,0,3,0
57844,3,1,202889,202889,202890,0,1,0
57845,2,3,202891,202891,202894,0,3,1
57846,1,2,202892,202894,202896,2,4,0
57847,2,3,202894,202896,202899,2,5,0
57848,2,1,202896,202899,202900,3,4,0
57849,1,2,202897,202900,202902,3,5,0
57850,6,2,202903,202903,202905,0,2,1
57851,4,1,202907,202907,202908,0,1,2
57852,2,2,202909,202909,202911,0,2,1
57853,6,1,202915,202915,202916,0,1,4
57854,4,2,202919,202919,202921,0,2,3
57855,5,1,202924,202924,202925,0,1,3
57856,2,2,202926,202926,202928,0,2,1
57857,3,1,202929,202929,202930,0,1,1
57858,6,3,202935,202935,202938,0,3,5
57859,5,2,202940,202940,202942,0,2,2
57860,4,1,202944,202944,202945,0,1,2
57861,6,1,202950,202950,202951,0,1,5
57862,3,3,202953,202953,202956,0,3,2
57863,2,2,202955,202956,202958,1,3,0
57864,3,2,202958,202958,202960,0,2,0
57865,6,1,202964,202964,202965,0,1,4
57866,1,3,202965,202965,202968,0,3,0
57867,4,2,202969,202969,202971,0,2,1
57868,4,1,202973,202973,202974,0,1,2
57869,5,3,202978,202978,202981,0,3,4
57870,1,3,202979,202981,202984,2,5,0
57871,1,3,202980,202984,202987,4,7,0
57872,5,3,202985,202987,202990,2,5,0
57873,4,2,202989,202990,202992,1,3,0
57874,5,1,202994,202994,202995,0,1,2
57875,5,1,202999,202999,203000,0,1,4
57876,3,3,203002,203002,203005,0,3,2
57877,3,1,203005,203005,203006,0,1,0
57878,6,3,203011,203011,203014,0,3,5
57879,1,3,203012,203014,203017,2,5,0
57880,4,2,203016,203017,203019,1,3,0
57881,1,3,203017,203019,203022,2,5,0
57882,4,2,203021,203022,203024,1,3,0
57883,3,2,203024,203024,203026,0,2,0
57884,3,2,203027,203027,203029,0,2,1
57885,5,1,203032,203032,203033,0,1,3
57886,5,1,203037,203037,203038,0,1,4
57887,3,1,203040,203040,203041,0,1,2
57888,2,1,203042,203042,203043,0,1,1
57889,5,1,203047,203047,203048,0,1,4
57890,3,1,203050,203050,203051,0,1,2
57891,1,2,203051,203051,203053,0,2,0
57892,3,1,203054,203054,203055,0,1,1
57893,4,2,203058,203058,203060,0,2,3
57894,4,3,203062,203062,203065,0,3,2
57895,3,3,203065,203065,203068,0,3,0
57896,2,2,203067,203068,203070,1,3,0
57897,3,3,203070,203070,203073,0,3,0
57898,4,2,203074,203074,203076,0,2,1
57899,6,1,203080,203080,203081,0,1,4
57900,1,2,203081,203081,203083,0,2,0
57901,6,2,203087,203087,203089,0,2,4
57902,2,2,203089,203089,203091,0,2,0
57903,4,2,203093,203093,203095,0,2,2
57904,3,2,203096,203096,203098,0,2,1
57905,3,1,203099,203099,203100,0,1,1
57906,6,3,203105,203105,203108,0,3,5
57907,6,2,203111,203111,203113,0,2,3
57908,5,2,203116,203116,203118,0,2,3
57909,1,2,203117,203118,203120,1,3,0
57910,2,3,203119,203120,203123,1,4,0
57911,4,1,203123,203123,203124,0,1,0
57912,4,2,203127,203127,203129,0,2,3
57913,6,1,203133,203133,203134,0,1,4
57914,1,1,203134,203134,203135,0,1,0
57915,3,2,203137,203137,203139,0,2,2
57916,6,1,203143,203143,203144,0,1,4
57917,3,3,203146,203146,203149,0,3,2
57918,5,3,203151,203151,203154,0,3,2
57919,1,2,203152,203154,203156,2,4,0
57920,4,2,203156,203156,203158,0,2,0
57921,1,2,203157,203158,203160,1,3,0
57922,5,3,203162,203162,203165,0,3,2
57923,4,3,203166,203166,203169,0,3,1
57924,5,1,203171,203171,203172,0,1,2
57925,1,3,203172,203172,203175,0,3,0
57926,5,3,203177,203177,203180,0,3,2
57927,2,1,203179,203180,203181,1,2,0
57928,5,2,203184,203184,203186,0,2,3
57929,1,1,203185,203186,203187,1,2,0
57930,3,3,203188,203188,203191,0,3,1
57931,3,3,203191,203191,203194,0,3,0
57932,3,1,203194,203194,203195,0,1,0
57933,5,3,203199,203199,203202,0,3,4
57934,3,1,203202,203202,203203,0,1,0
57935,1,1,203203,203203,203204,0,1,0
57936,2,3,203205,203205,203208,0,3,1
57937,4,2,203209,203209,203211,0,2,1
57938,4,1,203213,203213,203214,0,1,2
57939,2,1,203215,203215,203216,0,1,1
57940,2,1,203217,203217,203218,0,1,1
57941,2,3,203219,203219,203222,0,3,1
57942,2,3,203221,203222,203225,1,4,0
57943,5,1,203226,203226,203227,0,1,1
57944,6,2,203232,203232,203234,0,2,5
57945,6,2,203238,203238,203240,0,2,4
57946,1,3,203239,203240,203243,1,4,0
57947,3,2,203242,203243,203245,1,3,0
57948,2,1,203244,203245,203246,1,2,0
57949,6,3,203250,203250,203253,0,3,4
57950,1,3,203251,203253,203256,2,5,0
57951,3,2,203254,203256,203258,2,4,0
57952,1,1,203255,203258,203259,3,4,0
57953,1,3,203256,203259,203262,3,6,0
57954,5,1,203261,203262,203263,1,2,0
57955,3,1,203264,203264,203265,0,1,1
57956,1,3,203265,203265,203268,0,3,0
57957,2,2,203267,203268,203270,1,3,0
57958,1,2,203268,203270,203272,2,4,0
57959,5,3,203273,203273,203276,0,3,1
57960,2,2,203275,203276,203278,1,3,0
57961,5,1,203280,203280,203281,0,1,2
57962,6,3,203286,203286,203289,0,3,5
57963,1,3,203287,203289,203292,2,5,0
57964,4,2,203291,203292,203294,1,3,0
57965,3,1,203294,203294,203295,0,1,0
57966,5,2,203299,203299,203301,0,2,4
57967,1,1,203300,203301,203302,1,2,0
57968,5,1,203305,203305,203306,0,1,3
57969,5,1,203310,203310,203311,0,1,4
57970,1,2,203311,203311,203313,0,2,0
57971,1,2,203312,203313,203315,1,3,0
57972,1,2,203313,203315,203317,2,4,0
57973,3,1,203316,203317,203318,1,2,0
57974,6,1,203322,203322,203323,0,1,4
57975,6,2,203328,203328,203330,0,2,5
57976,3,3,203331,203331,203334,0,3,1
57977,1,2,203332,203334,203336,2,4,0
57978,3,1,203335,203336,203337,1,2,0
57979,3,3,203338,203338,203341,0,3,1
57980,3,1,203341,203341,203342,0,1,0
57981,4,2,203345,203345,203347,0,2,3
57982,4,1,203349,203349,203350,0,1,2
57983,6,2,203355,203355,203357,0,2,5
57984,6,1,203361,203361,203362,0,1,4
57985,2,1,203363,203363,203364,0,1,1
57986,4,3,203367,203367,203370,0,3,3
57987,4,1,203371,203371,203372,0,1,1
57988,6,3,203377,203377,203380,0,3,5
57989,5,2,203382,203382,203384,0,2,2
57990,3,1,203385,203385,203386,0,1,1
57991,4,2,203389,203389,203391,0,2,3
57992,3,2,203392,203392,203394,0,2,1
57993,1,1,203393,203394,203395,1,2,0
57994,6,1,203399,203399,203400,0,1,4
57995,1,1,203400,203400,203401,0,1,0
57996,6,3,203406,203406,203409,0,3,5
57997,3,1,203409,203409,203410,0,1,0
57998,4,3,203413,203413,203416,0,3,3
57999,1,3,203414,203416,203419,2,5,0
58000,4,3,203418,203419,203422,1,4,0
58001,3,3,203421,203422,203425,1,4,0
58002,4,2,203425,203425,203427,0,2,0
58003,2,3,203427,203427,203430,0,3,0
58004,1,1,203428,203430,203431,2,3,0
58005,5,2,203433,203433,203435,0,2,2
58006,1,2,203434,203435,203437,1,3,0
58007,4,1,203438,203438,203439,0,1,1
58008,2,3,203440,203440,203443,0,3,1
58009,5,2,203445,203445,203447,0,2,2
58010,3,1,203448,203448,203449,0,1,1
58011,6,3,203454,203454,203457,0,3,5
58012,5,2,203459,203459,203461,0,2,2
58013,1,2,203460,203461,203463,1,3,0
58014,5,1,203465,203465,203466,0,1,2
58015,3,1,203468,203468,203469,0,1,2
58016,5,2,203473,203473,203475,0,2,4
58017,3,1,203476,203476,203477,0,1,1
58018,6,1,203482,203482,203483,0,1,5
58019,4,2,203486,203486,203488,0,2,3
58020,1,2,203487,203488,203490,1,3,0
58021,4,3,203491,203491,203494,0,3,1
58022,2,3,203493,203494,203497,1,4,0
58023,5,2,203498,203498,203500,0,2,1
58024,5,1,203503,203503,203504,0,1,3
58025,6,1,203509,203509,203510,0,1,5
58026,3,3,203512,203512,203515,0,3,2
58027,2,3,203514,203515,203518,1,4,0
58028,3,1,203517,203518,203519,1,2,0
58029,5,1,203522,203522,203523,0,1,3
58030,1,3,203523,203523,203526,0,3,0
58031,1,2,203524,203526,203528,2,4,0
58032,1,3,203525,203528,203531,3,6,0
58033,6,1,203531,203531,203532,0,1,0
58034,4,1,203535,203535,203536,0,1,3
58035,5,3,203540,203540,203543,0,3,4
58036,5,1,203545,203545,203546,0,1,2
58037,3,1,203548,203548,203549,0,1,2
58038,1,1,203549,203549,203550,0,1,0
58039,1,2,203550,203550,203552,0,2,0
58040,1,1,203551,203552,203553,1,2,0
58041,5,3,203556,203556,203559,0,3,3
58042,6,3,203562,203562,203565,0,3,3
58043,1,3,203563,203565,203568,2,5,0
58044,2,1,203565,203568,203569,3,4,0
58045,3,3,203568,203569,203572,1,4,0
58046,4,2,203572,203572,203574,0,2,0
58047,3,2,203575,203575,203577,0,2,1
58048,2,3,203577,203577,203580,0,3,0
58049,3,1,203580,203580,203581,0,1,0
58050,2,3,203582,203582,203585,0,3,1
58051,5,3,203587,203587,203590,0,3,2
58052,6,2,203593,203593,203595,0,2,3
58053,1,1,203594,203595,203596,1,2,0
58054,4,2,203598,203598,203600,0,2,2
58055,1,2,203599,203600,203602,1,3,0
58056,3,1,203602,203602,203603,0,1,0
58057,3,1,203605,203605,203606,0,1,2
58058,5,1,203610,203610,203611,0,1,4
58059,3,3,203613,203613,203616,0,3,2
58060,2,2,203615,203616,203618,1,3,0
58061,6,1,203621,203621,203622,0,1,3
58062,4,1,203625,203625,203626,0,1,3
58063,2,3,203627,203627,203630,0,3,1
58064,4,1,203631,203631,203632,0,1,1
58065,5,3,203636,203636,203639,0,3,4
58066,1,3,203637,203639,203642,2,5,0
58067,3,1,203640,203642,203643,2,3,0
58068,6,3,203646,203646,203649,0,3,3
58069,6,3,203652,203652,203655,0,3,3
58070,3,1,203655,203655,203656,0,1,0
58071,2,1,203657,203657,203658,0,1,1
58072,1,1,203658,203658,203659,0,1,0
58073,5,1,203663,203663,203664,0,1,4
58074,6,3,203669,203669,203672,0,3,5
58075,3,2,203672,203672,203674,0,2,0
58076,1,1,203673,203674,203675,1,2,0
58077,2,1,203675,203675,203676,0,1,0
58078,2,3,203677,203677,203680,0,3,1
58079,3,3,203680,203680,203683,0,3,0
58080,2,3,203682,203683,203686,1,4,0
58081,5,3,203687,203687,203690,0,3,1
58082,6,3,203693,203693,203696,0,3,3
58083,3,3,203696,203696,203699,0,3,0
58084,2,1,203698,203699,203700,1,2,0
58085,4,1,203702,203702,203703,0,1,2
58086,1,2,203703,203703,203705,0,2,0
58087,1,2,203704,203705,203707,1,3,0
58088,6,1,203710,203710,203711,0,1,3
58089,1,3,203711,203711,203714,0,3,0
58090,6,3,203717,203717,203720,0,3,3
58091,1,3,203718,203720,203723,2,5,0
58092,2,3,203720,203723,203726,3,6,0
58093,2,3,203722,203726,203729,4,7,0
58094,3,3,203725,203729,203732,4,7,0
58095,3,3,203728,203732,203735,4,7,0
58096,1,3,203729,203735,203738,6,9,0
58097,3,1,203732,203738,203739,6,7,0
58098,6,2,203738,203739,203741,1,3,0
58099,4,1,203742,203742,203743,0,1,1
58100,3,3,203745,203745,203748,0,3,2
58101,2,2,203747,203748,203750,1,3,0
58102,1,3,203748,203750,203753,2,5,0
58103,4,2,203752,203753,203755,1,3,0
58104,2,3,203754,203755,203758,1,4,0
58105,4,2,203758,203758,203760,0,2,0
58106,1,3,203759,203760,203763,1,4,0
58107,3,1,203762,203763,203764,1,2,0
58108,1,2,203763,203764,203766,1,3,0
58109,2,2,203765,203766,203768,1,3,0
58110,5,3,203770,203770,203773,0,3,2
58111,2,1,203772,203773,203774,1,2,0
58112,1,2,203773,203774,203776,1,3,0
58113,5,2,203778,203778,203780,0,2,2
58114,4,3,203782,203782,203785,0,3,2
58115,2,3,203784,203785,203788,1,4,0
58116,3,1,203787,203788,203789,1,2,0
58117,2,2,203789,203789,203791,0,2,0
58118,4,2,203793,203793,203795,0,2,2
58119,1,2,203794,203795,203797,1,3,0
58120,1,2,203795,203797,203799,2,4,0
58121,4,3,203799,203799,203802,0,3,0
58122,5,1,203804,203804,203805,0,1,2
58123,6,2,203810,203810,203812,0,2,5
58124,2,3,203812,203812,203815,0,3,0
58125,1,3,203813,203815,203818,2,5,0
58126,4,2,203817,203818,203820,1,3,0
58127,2,2,203819,203820,203822,1,3,0
58128,6,1,203825,203825,203826,0,1,3
58129,3,2,203828,203828,203830,0,2,2
58130,6,1,203834,203834,203835,0,1,4
58131,5,1,203839,203839,203840,0,1,4
58132,6,3,203845,203845,203848,0,3,5
58133,1,2,203846,203848,203850,2,4,0
58134,1,1,203847,203850,203851,3,4,0
58135,4,1,203851,203851,203852,0,1,0
58136,6,1,203857,203857,203858,0,1,5
58137,6,1,203863,203863,203864,0,1,5
58138,4,3,203867,203867,203870,0,3,3
58139,3,1,203870,203870,203871,0,1,0
58140,6,3,203876,203876,203879,0,3,5
58141,6,2,203882,203882,203884,0,2,3
58142,2,1,203884,203884,203885,0,1,0
58143,6,1,203890,203890,203891,0,1,5
58144,3,1,203893,203893,203894,0,1,2
58145,3,2,203896,203896,203898,0,2,2
58146,4,3,203900,203900,203903,0,3,2
58147,1,1,203901,203903,203904,2,3,0
58148,4,1,203905,203905,203906,0,1,1
58149,3,3,203908,203908,203911,0,3,2
58150,2,3,203910,203911,203914,1,4,0
58151,3,2,203913,203914,203916,1,3,0
58152,5,2,203918,203918,203920,0,2,2
58153,6,1,203924,203924,203925,0,1,4
58154,4,2,203928,203928,203930,0,2,3
58155,5,3,203933,203933,203936,0,3,3
58156,3,2,203936,203936,203938,0,2,0
58157,4,3,203940,203940,203943,0,3,2
58158,5,2,203945,203945,203947,0,2,2
58159,3,3,203948,203948,203951,0,3,1
58160,2,1,203950,203951,203952,1,2,0
58161,6,1,203956,203956,203957,0,1,4
58162,3,3,203959,203959,203962,0,3,2
58163,6,3,203965,203965,203968,0,3,3
58164,4,2,203969,203969,203971,0,2,1
58165,6,2,203975,203975,203977,0,2,4
58166,5,3,203980,203980,203983,0,3,3
58167,1,2,203981,203983,203985,2,4,0
58168,3,1,203984,203985,203986,1,2,0
58169,5,3,203989,203989,203992,0,3,3
58170,6,3,203995,203995,203998,0,3,3
58171,2,3,203997,203998,204001,1,4,0
58172,6,2,204003,204003,204005,0,2,2
58173,6,2,204009,204009,204011,0,2,4
58174,4,1,204013,204013,204014,0,1,2
58175,6,1,204019,204019,204020,0,1,5
58176,4,1,204023,204023,204024,0,1,3
58177,6,2,204029,204029,204031,0,2,5
58178,4,1,204033,204033,204034,0,1,2
58179,4,2,204037,204037,204039,0,2,3
58180,3,1,204040,204040,204041,0,1,1
58181,5,1,204045,204045,204046,0,1,4
58182,3,2,204048,204048,204050,0,2,2
58183,1,1,204049,204050,204051,1,2,0
58184,1,3,204050,204051,204054,1,4,0
58185,6,2,204056,204056,204058,0,2,2
58186,6,3,204062,204062,204065,0,3,4
58187,6,2,204068,204068,204070,0,2,3
58188,6,1,204074,204074,204075,0,1,4
58189,6,2,204080,204080,204082,0,2,5
58190,6,1,204086,204086,204087,0,1,4
58191,4,2,204090,204090,204092,0,2,3
58192,3,2,204093,204093,204095,0,2,1
58193,6,2,204099,204099,204101,0,2,4
58194,2,2,204101,204101,204103,0,2,0
58195,3,2,204104,204104,204106,0,2,1
58196,3,1,204107,204107,204108,0,1,1
58197,5,3,204112,204112,204115,0,3,4
58198,3,1,204115,204115,204116,0,1,0
58199,5,2,204120,204120,204122,0,2,4
58200,2,3,204122,204122,204125,0,3,0
58201,6,1,204128,204128,204129,0,1,3
58202,6,3,204134,204134,204137,0,3,5
58203,4,1,204138,204138,204139,0,1,1
58204,1,3,204139,204139,204142,0,3,0
58205,3,2,204142,204142,204144,0,2,0
58206,2,1,204144,204144,204145,0,1,0
58207,1,1,204145,204145,204146,0,1,0
58208,5,2,204150,204150,204152,0,2,4
58209,1,2,204151,204152,204154,1,3,0
58210,2,3,204153,204154,204157,1,4,0
58211,1,1,204154,204157,204158,3,4,0
58212,6,3,204160,204160,204163,0,3,2
58213,1,3,204161,204163,204166,2,5,0
58214,2,1,204163,204166,204167,3,4,0
58215,4,1,204167,204167,204168,0,1,0
58216,5,1,204172,204172,204173,0,1,4
58217,4,1,204176,204176,204177,0,1,3
58218,4,1,204180,204180,204181,0,1,3
58219,4,3,204184,204184,204187,0,3,3
58220,6,3,204190,204190,204193,0,3,3
58221,4,3,204194,204194,204197,0,3,1
58222,2,2,204196,204197,204199,1,3,0
58223,2,1,204198,204199,204200,1,2,0
58224,6,1,204204,204204,204205,0,1,4
58225,5,2,204209,204209,204211,0,2,4
58226,5,3,204214,204214,204217,0,3,3
58227,1,3,204215,204217,204220,2,5,0
58228,6,1,204221,204221,204222,0,1,1
58229,2,1,204223,204223,204224,0,1,1
58230,2,2,204225,204225,204227,0,2,1
58231,4,3,204229,204229,204232,0,3,2
58232,3,1,204232,204232,204233,0,1,0
58233,2,3,204234,204234,204237,0,3,1
58234,3,3,204237,204237,204240,0,3,0
58235,5,3,204242,204242,204245,0,3,2
58236,3,2,204245,204245,204247,0,2,0
58237,3,1,204248,204248,204249,0,1,1
58238,4,3,204252,204252,204255,0,3,3
58239,6,3,204258,204258,204261,0,3,3
58240,3,1,204261,204261,204262,0,1,0
58241,2,1,204263,204263,204264,0,1,1
58242,4,1,204267,204267,204268,0,1,3
58243,6,2,204273,204273,204275,0,2,5
58244,6,1,204279,204279,204280,0,1,4
58245,2,2,204281,204281,204283,0,2,1
58246,1,2,204282,204283,204285,1,3,0
58247,6,1,204288,204288,204289,0,1,3
58248,6,1,204294,204294,204295,0,1,5
58249,5,1,204299,204299,204300,0,1,4
58250,2,3,204301,204301,204304,0,3,1
58251,6,3,204307,204307,204310,0,3,3
58252,5,2,204312,204312,204314,0,2,2
58253,6,2,204318,204318,204320,0,2,4
58254,5,1,204323,204323,204324,0,1,3
58255,6,3,204329,204329,204332,0,3,5
58256,2,3,204331,204332,204335,1,4,0
58257,6,2,204337,204337,204339,0,2,2
58258,4,3,204341,204341,204344,0,3,2
58259,5,2,204346,204346,204348,0,2,2
58260,3,3,204349,204349,204352,0,3,1
58261,6,2,204355,204355,204357,0,2,3
58262,3,3,204358,204358,204361,0,3,1
58263,3,3,204361,204361,204364,0,3,0
58264,6,1,204367,204367,204368,0,1,3
58265,6,2,204373,204373,204375,0,2,5
58266,2,3,204375,204375,204378,0,3,0
58267,5,1,204380,204380,204381,0,1,2
58268,1,3,204381,204381,204384,0,3,0
58269,3,2,204384,204384,204386,0,2,0
58270,4,3,204388,204388,204391,0,3,2
58271,2,2,204390,204391,204393,1,3,0
58272,2,3,204392,204393,204396,1,4,0
58273,5,2,204397,204397,204399,0,2,1
58274,4,2,204401,204401,204403,0,2,2
58275,3,2,204404,204404,204406,0,2,1
58276,3,2,204407,204407,204409,0,2,1
58277,4,3,204411,204411,204414,0,3,2
58278,2,1,204413,204414,204415,1,2,0
58279,6,3,204419,204419,204422,0,3,4
58280,3,2,204422,204422,204424,0,2,0
58281,4,1,204426,204426,204427,0,1,2
58282,5,2,204431,204431,204433,0,2,4
58283,1,2,204432,204433,204435,1,3,0
58284,1,1,204433,204435,204436,2,3,0
58285,6,2,204439,204439,204441,0,2,3
58286,3,1,204442,204442,204443,0,1,1
58287,5,2,204447,204447,204449,0,2,4
58288,6,3,204453,204453,204456,0,3,4
58289,1,3,204454,204456,204459,2,5,0
58290,1,3,204455,204459,204462,4,7,0
58291,5,2,204460,204462,204464,2,4,0
58292,4,2,204464,204464,204466,0,2,0
58293,1,1,204465,204466,204467,1,2,0
58294,2,3,204467,204467,204470,0,3,0
58295,2,3,204469,204470,204473,1,4,0
58296,2,1,204471,204473,204474,2,3,0
58297,5,3,204476,204476,204479,0,3,2
58298,4,3,204480,204480,204483,0,3,1
58299,6,2,204486,204486,204488,0,2,3
58300,6,2,204492,204492,204494,0,2,4
58301,1,2,204493,204494,204496,1,3,0
58302,3,2,204496,204496,204498,0,2,0
58303,2,1,204498,204498,204499,0,1,0
58304,3,2,204501,204501,204503,0,2,2
58305,4,3,204505,204505,204508,0,3,2
58306,2,2,204507,204508,204510,1,3,0
58307,3,3,204510,204510,204513,0,3,0
58308,2,2,204512,204513,204515,1,3,0
58309,2,1,204514,204515,204516,1,2,0
58310,1,1,204515,204516,204517,1,2,0
58311,6,2,204521,204521,204523,0,2,4
58312,2,2,204523,204523,204525,0,2,0
58313,3,2,204526,204526,204528,0,2,1
58314,2,3,204528,204528,204531,0,3,0
58315,2,2,204530,204531,204533,1,3,0
58316,2,3,204532,204533,204536,1,4,0
58317,2,3,204534,204536,204539,2,5,0
58318,3,1,204537,204539,204540,2,3,0
58319,6,1,204543,204543,204544,0,1,3
58320,1,2,204544,204544,204546,0,2,0
58321,4,2,204548,204548,204550,0,2,2
58322,5,2,204553,204553,204555,0,2,3
58323,1,2,204554,204555,204557,1,3,0
58324,2,1,204556,204557,204558,1,2,0
58325,1,3,204557,204558,204561,1,4,0
58326,3,1,204560,204561,204562,1,2,0
58327,6,2,204566,204566,204568,0,2,4
58328,6,2,204572,204572,204574,0,2,4
58329,1,2,204573,204574,204576,1,3,0
58330,4,3,204577,204577,204580,0,3,1
58331,3,3,204580,204580,204583,0,3,0
58332,2,2,204582,204583,204585,1,3,0
58333,4,3,204586,204586,204589,0,3,1
58334,5,3,204591,204591,204594,0,3,2
58335,2,3,204593,204594,204597,1,4,0
58336,3,1,204596,204597,204598,1,2,0
58337,4,3,204600,204600,204603,0,3,2
58338,4,2,204604,204604,204606,0,2,1
58339,2,2,204606,204606,204608,0,2,0
58340,1,3,204607,204608,204611,1,4,0
58341,3,1,204610,204611,204612,1,2,0
58342,2,3,204612,204612,204615,0,3,0
58343,3,1,204615,204615,204616,0,1,0
58344,5,2,204620,204620,204622,0,2,4
58345,1,2,204621,204622,204624,1,3,0
58346,4,3,204625,204625,204628,0,3,1
58347,1,1,204626,204628,204629,2,3,0
58348,2,3,204628,204629,204632,1,4,0
58349,4,3,204632,204632,204635,0,3,0
58350,1,3,204633,204635,204638,2,5,0
58351,6,1,204639,204639,204640,0,1,1
58352,3,1,204642,204642,204643,0,1,2
58353,4,1,204646,204646,204647,0,1,3
58354,5,2,204651,204651,204653,0,2,4
58355,6,3,204657,204657,204660,0,3,4
58356,3,1,204660,204660,204661,0,1,0
58357,5,3,204665,204665,204668,0,3,4
58358,6,1,204671,204671,204672,0,1,3
58359,5,3,204676,204676,204679,0,3,4
58360,4,3,204680,204680,204683,0,3,1
58361,2,1,204682,204683,204684,1,2,0
58362,3,1,204685,204685,204686,0,1,1
58363,2,2,204687,204687,204689,0,2,1
58364,4,3,204691,204691,204694,0,3,2
58365,6,1,204697,204697,204698,0,1,3
58366,2,2,204699,204699,204701,0,2,1
58367,4,3,204703,204703,204706,0,3,2
58368,4,3,204707,204707,204710,0,3,1
58369,4,1,204711,204711,204712,0,1,1
58370,6,1,204717,204717,204718,0,1,5
58371,2,1,204719,204719,204720,0,1,1
58372,5,2,204724,204724,204726,0,2,4
58373,6,3,204730,204730,204733,0,3,4
58374,2,3,204732,204733,204736,1,4,0
58375,5,1,204737,204737,204738,0,1,1
58376,1,2,204738,204738,204740,0,2,0
58377,3,2,204741,204741,204743,0,2,1
58378,3,3,204744,204744,204747,0,3,1
58379,5,2,204749,204749,204751,0,2,2
58380,4,3,204753,204753,204756,0,3,2
58381,6,3,204759,204759,204762,0,3,3
58382,6,1,204765,204765,204766,0,1,3
58383,6,1,204771,204771,204772,0,1,5
58384,6,3,204777,204777,204780,0,3,5
58385,4,3,204781,204781,204784,0,3,1
58386,2,1,204783,204784,204785,1,2,0
58387,4,1,204787,204787,204788,0,1,2
58388,2,1,204789,204789,204790,0,1,1
58389,4,3,204793,204793,204796,0,3,3
58390,2,3,204795,204796,204799,1,4,0
58391,1,2,204796,204799,204801,3,5,0
58392,1,3,204797,204801,204804,4,7,0
58393,6,2,204803,204804,204806,1,3,0
58394,6,2,204809,204809,204811,0,2,3
58395,5,2,204814,204814,204816,0,2,3
58396,4,2,204818,204818,204820,0,2,2
58397,4,1,204822,204822,204823,0,1,2
58398,3,3,204825,204825,204828,0,3,2
58399,3,1,204828,204828,204829,0,1,0
58400,5,1,204833,204833,204834,0,1,4
58401,2,1,204835,204835,204836,0,1,1
58402,1,2,204836,204836,204838,0,2,0
58403,3,3,204839,204839,204842,0,3,1
58404,5,1,204844,204844,204845,0,1,2
58405,6,2,204850,204850,204852,0,2,5
58406,5,2,204855,204855,204857,0,2,3
58407,6,1,204861,204861,204862,0,1,4
58408,4,1,204865,204865,204866,0,1,3
58409,3,3,204868,204868,204871,0,3,2
58410,3,1,204871,204871,204872,0,1,0
58411,6,1,204877,204877,204878,0,1,5
58412,2,3,204879,204879,204882,0,3,1
58413,5,1,204884,204884,204885,0,1,2
58414,3,3,204887,204887,204890,0,3,2
58415,5,2,204892,204892,204894,0,2,2
58416,5,3,204897,204897,204900,0,3,3
58417,5,2,204902,204902,204904,0,2,2
58418,1,2,204903,204904,204906,1,3,0
58419,6,2,204909,204909,204911,0,2,3
58420,1,1,204910,204911,204912,1,2,0
58421,3,1,204913,204913,204914,0,1,1
58422,2,2,204915,204915,204917,0,2,1
58423,2,1,204917,204917,204918,0,1,0
58424,1,1,204918,204918,204919,0,1,0
58425,4,1,204922,204922,204923,0,1,3
58426,4,2,204926,204926,204928,0,2,3
58427,6,3,204932,204932,204935,0,3,4
58428,4,2,204936,204936,204938,0,2,1
58429,6,1,204942,204942,204943,0,1,4
58430,3,2,204945,204945,204947,0,2,2
58431,6,1,204951,204951,204952,0,1,4
58432,1,2,204952,204952,204954,0,2,0
58433,5,2,204957,204957,204959,0,2,3
58434,1,1,204958,204959,204960,1,2,0
58435,5,1,204963,204963,204964,0,1,3
58436,5,3,204968,204968,204971,0,3,4
58437,5,3,204973,204973,204976,0,3,2
58438,6,1,204979,204979,204980,0,1,3
58439,3,2,204982,204982,204984,0,2,2
58440,5,3,204987,204987,204990,0,3,3
58441,5,2,204992,204992,204994,0,2,2
58442,1,3,204993,204994,204997,1,4,0
58443,3,1,204996,204997,204998,1,2,0
58444,3,2,204999,204999,205001,0,2,1
58445,5,2,205004,205004,205006,0,2,3
58446,6,3,205010,205010,205013,0,3,4
58447,2,3,205012,205013,205016,1,4,0
58448,4,1,205016,205016,205017,0,1,0
58449,4,2,205020,205020,205022,0,2,3
58450,2,1,205022,205022,205023,0,1,0
58451,5,2,205027,205027,205029,0,2,4
58452,1,2,205028,205029,205031,1,3,0
58453,6,2,205034,205034,205036,0,2,3
58454,6,1,205040,205040,205041,0,1,4
58455,1,1,205041,205041,205042,0,1,0
58456,6,2,205047,205047,205049,0,2,5
58457,2,3,205049,205049,205052,0,3,0
58458,4,3,205053,205053,205056,0,3,1
58459,3,3,205056,205056,205059,0,3,0
58460,5,2,205061,205061,205063,0,2,2
58461,1,2,205062,205063,205065,1,3,0
58462,3,3,205065,205065,205068,0,3,0
58463,6,2,205071,205071,205073,0,2,3
58464,2,2,205073,205073,205075,0,2,0
58465,6,1,205079,205079,205080,0,1,4
58466,5,2,205084,205084,205086,0,2,4
58467,6,2,205090,205090,205092,0,2,4
58468,4,3,205094,205094,205097,0,3,2
58469,3,3,205097,205097,205100,0,3,0
58470,5,2,205102,205102,205104,0,2,2
58471,3,3,205105,205105,205108,0,3,1
58472,1,3,205106,205108,205111,2,5,0
58473,3,2,205109,205111,205113,2,4,0
58474,3,2,205112,205113,205115,1,3,0
58475,2,2,205114,205115,205117,1,3,0
58476,3,1,205117,205117,205118,0,1,0
58477,5,1,205122,205122,205123,0,1,4
58478,6,3,205128,205128,205131,0,3,5
58479,4,2,205132,205132,205134,0,2,1
58480,6,2,205138,205138,205140,0,2,4
58481,5,2,205143,205143,205145,0,2,3
58482,4,2,205147,205147,205149,0,2,2
58483,6,1,205153,205153,205154,0,1,4
58484,5,3,205158,205158,205161,0,3,4
58485,5,3,205163,205163,205166,0,3,2
58486,4,3,205167,205167,205170,0,3,1
58487,2,1,205169,205170,205171,1,2,0
58488,5,2,205174,205174,205176,0,2,3
58489,3,3,205177,205177,205180,0,3,1
58490,3,2,205180,205180,205182,0,2,0
58491,5,2,205185,205185,205187,0,2,3
58492,3,1,205188,205188,205189,0,1,1
58493,4,2,205192,205192,205194,0,2,3
58494,3,3,205195,205195,205198,0,3,1
58495,3,1,205198,205198,205199,0,1,0
58496,5,3,205203,205203,205206,0,3,4
58497,1,2,205204,205206,205208,2,4,0
58498,2,3,205206,205208,205211,2,5,0
58499,4,1,205210,205211,205212,1,2,0
58500,3,2,205213,205213,205215,0,2,1
58501,4,1,205217,205217,205218,0,1,2
58502,6,3,205223,205223,205226,0,3,5
58503,2,2,205225,205226,205228,1,3,0
58504,6,3,205231,205231,205234,0,3,3
58505,5,1,205236,205236,205237,0,1,2
58506,3,2,205239,205239,205241,0,2,2
58507,2,1,205241,205241,205242,0,1,0
58508,5,2,205246,205246,205248,0,2,4
58509,4,1,205250,205250,205251,0,1,2
58510,6,3,205256,205256,205259,0,3,5
58511,6,3,205262,205262,205265,0,3,3
58512,6,2,205268,205268,205270,0,2,3
58513,1,3,205269,205270,205273,1,4,0
58514,2,2,205271,205273,205275,2,4,0
58515,4,1,205275,205275,205276,0,1,0
58516,5,2,205280,205280,205282,0,2,4
58517,5,3,205285,205285,205288,0,3,3
58518,6,1,205291,205291,205292,0,1,3
58519,3,1,205294,205294,205295,0,1,2
58520,3,3,205297,205297,205300,0,3,2
58521,2,2,205299,205300,205302,1,3,0
58522,6,3,205305,205305,205308,0,3,3
58523,3,1,205308,205308,205309,0,1,0
58524,2,1,205310,205310,205311,0,1,1
58525,6,1,205316,205316,205317,0,1,5
58526,6,2,205322,205322,205324,0,2,5
58527,4,2,205326,205326,205328,0,2,2
58528,6,1,205332,205332,205333,0,1,4
58529,4,1,205336,205336,205337,0,1,3
58530,4,3,205340,205340,205343,0,3,3
58531,6,1,205346,205346,205347,0,1,3
58532,1,2,205347,205347,205349,0,2,0
58533,3,3,205350,205350,205353,0,3,1
58534,3,3,205353,205353,205356,0,3,0
58535,1,1,205354,205356,205357,2,3,0
58536,6,1,205360,205360,205361,0,1,3
58537,3,1,205363,205363,205364,0,1,2
58538,3,3,205366,205366,205369,0,3,2
58539,2,3,205368,205369,205372,1,4,0
58540,4,1,205372,205372,205373,0,1,0
58541,1,2,205373,205373,205375,0,2,0
58542,2,1,205375,205375,205376,0,1,0
58543,4,3,205379,205379,205382,0,3,3
58544,4,1,205383,205383,205384,0,1,1
58545,5,1,205388,205388,205389,0,1,4
58546,6,2,205394,205394,205396,0,2,5
58547,3,3,205397,205397,205400,0,3,1
58548,5,2,205402,205402,205404,0,2,2
58549,2,2,205404,205404,205406,0,2,0
58550,1,1,205405,205406,205407,1,2,0
58551,2,1,205407,205407,205408,0,1,0
58552,4,1,205411,205411,205412,0,1,3
58553,3,1,205414,205414,205415,0,1,2
58554,4,3,205418,205418,205421,0,3,3
58555,2,1,205420,205421,205422,1,2,0
58556,2,2,205422,205422,205424,0,2,0
58557,6,3,205428,205428,205431,0,3,4
58558,1,3,205429,205431,205434,2,5,0
58559,1,3,205430,205434,205437,4,7,0
58560,3,2,205433,205437,205439,4,6,0
58561,2,2,205435,205439,205441,4,6,0
58562,6,1,205441,205441,205442,0,1,0
58563,1,2,205442,205442,205444,0,2,0
58564,2,2,205444,205444,205446,0,2,0
58565,5,2,205449,205449,205451,0,2,3
58566,5,1,205454,205454,205455,0,1,3
58567,6,3,205460,205460,205463,0,3,5
58568,5,3,205465,205465,205468,0,3,2
58569,4,3,205469,205469,205472,0,3,1
58570,1,2,205470,205472,205474,2,4,0
58571,3,2,205473,205474,205476,1,3,0
58572,5,3,205478,205478,205481,0,3,2
58573,5,2,205483,205483,205485,0,2,2
58574,5,2,205488,205488,205490,0,2,3
58575,5,2,205493,205493,205495,0,2,3
58576,1,2,205494,205495,205497,1,3,0
58577,3,1,205497,205497,205498,0,1,0
58578,6,1,205503,205503,205504,0,1,5
58579,4,1,205507,205507,205508,0,1,3
58580,6,2,205513,205513,205515,0,2,5
58581,5,1,205518,205518,205519,0,1,3
58582,5,3,205523,205523,205526,0,3,4
58583,1,2,205524,205526,205528,2,4,0
58584,1,3,205525,205528,205531,3,6,0
58585,5,1,205530,205531,205532,1,2,0
58586,5,1,205535,205535,205536,0,1,3
58587,4,3,205539,205539,205542,0,3,3
58588,4,3,205543,205543,205546,0,3,1
58589,5,3,205548,205548,205551,0,3,2
58590,1,2,205549,205551,205553,2,4,0
58591,5,3,205554,205554,205557,0,3,1
58592,3,3,205557,205557,205560,0,3,0
58593,3,1,205560,205560,205561,0,1,0
58594,2,3,205562,205562,205565,0,3,1
58595,5,2,205567,205567,205569,0,2,2
58596,1,3,205568,205569,205572,1,4,0
58597,1,2,205569,205572,205574,3,5,0
58598,6,2,205575,205575,205577,0,2,1
58599,2,1,205577,205577,205578,0,1,0
58600,4,3,205581,205581,205584,0,3,3
58601,1,1,205582,205584,205585,2,3,0
58602,1,3,205583,205585,205588,2,5,0
58603,6,1,205589,205589,205590,0,1,1
58604,1,2,205590,205590,205592,0,2,0
58605,4,3,205594,205594,205597,0,3,2
58606,3,3,205597,205597,205600,0,3,0
58607,5,2,205602,205602,205604,0,2,2
58608,5,1,205607,205607,205608,0,1,3
58609,3,3,205610,205610,205613,0,3,2
58610,6,3,205616,205616,205619,0,3,3
58611,5,1,205621,205621,205622,0,1,2
58612,5,1,205626,205626,205627,0,1,4
58613,6,2,205632,205632,205634,0,2,5
58614,3,2,205635,205635,205637,0,2,1
58615,5,3,205640,205640,205643,0,3,3
58616,6,3,205646,205646,205649,0,3,3
58617,6,1,205652,205652,205653,0,1,3
58618,3,1,205655,205655,205656,0,1,2
58619,2,1,205657,205657,205658,0,1,1
58620,3,2,205660,205660,205662,0,2,2
58621,4,1,205664,205664,205665,0,1,2
58622,5,1,205669,205669,205670,0,1,4
58623,1,3,205670,205670,205673,0,3,0
58624,5,1,205675,205675,205676,0,1,2
58625,4,3,205679,205679,205682,0,3,3
58626,4,1,205683,205683,205684,0,1,1
58627,2,1,205685,205685,205686,0,1,1
58628,1,1,205686,205686,205687,0,1,0
58629,5,1,205691,205691,205692,0,1,4
58630,1,3,205692,205692,205695,0,3,0
58631,3,1,205695,205695,205696,0,1,0
58632,1,3,205696,205696,205699,0,3,0
58633,1,3,205697,205699,205702,2,5,0
58634,3,3,205700,205702,205705,2,5,0
58635,4,2,205704,205705,205707,1,3,0
58636,3,2,205707,205707,205709,0,2,0
58637,3,3,205710,205710,205713,0,3,1
58638,3,1,205713,205713,205714,0,1,0
58639,4,3,205717,205717,205720,0,3,3
58640,2,1,205719,205720,205721,1,2,0
58641,6,1,205725,205725,205726,0,1,4
58642,6,3,205731,205731,205734,0,3,5
58643,2,3,205733,205734,205737,1,4,0
58644,5,2,205738,205738,205740,0,2,1
58645,5,2,205743,205743,205745,0,2,3
58646,4,1,205747,205747,205748,0,1,2
58647,6,2,205753,205753,205755,0,2,5
58648,4,1,205757,205757,205758,0,1,2
58649,2,2,205759,205759,205761,0,2,1
58650,1,3,205760,205761,205764,1,4,0
58651,2,2,205762,205764,205766,2,4,0
58652,6,3,205768,205768,205771,0,3,2
58653,2,3,205770,205771,205774,1,4,0
58654,2,1,205772,205774,205775,2,3,0
58655,6,3,205778,205778,205781,0,3,3
58656,2,1,205780,205781,205782,1,2,0
58657,6,2,205786,205786,205788,0,2,4
58658,2,2,205788,205788,205790,0,2,0
58659,3,2,205791,205791,205793,0,2,1
58660,6,3,205797,205797,205800,0,3,4
58661,4,3,205801,205801,205804,0,3,1
58662,4,3,205805,205805,205808,0,3,1
58663,5,3,205810,205810,205813,0,3,2
58664,5,2,205815,205815,205817,0,2,2
58665,1,2,205816,205817,205819,1,3,0
58666,5,1,205821,205821,205822,0,1,2
58667,1,3,205822,205822,205825,0,3,0
58668,2,1,205824,205825,205826,1,2,0
58669,5,2,205829,205829,205831,0,2,3
58670,6,2,205835,205835,205837,0,2,4
58671,3,2,205838,205838,205840,0,2,1
58672,1,3,205839,205840,205843,1,4,0
58673,2,3,205841,205843,205846,2,5,0
58674,1,1,205842,205846,205847,4,5,0
58675,6,3,205848,205848,205851,0,3,1
58676,1,3,205849,205851,205854,2,5,0
58677,2,3,205851,205854,205857,3,6,0
58678,5,3,205856,205857,205860,1,4,0
58679,1,2,205857,205860,205862,3,5,0
58680,4,1,205861,205862,205863,1,2,0
58681,5,2,205866,205866,205868,0,2,3
58682,1,2,205867,205868,205870,1,3,0
58683,6,1,205873,205873,205874,0,1,3
58684,6,3,205879,205879,205882,0,3,5
58685,6,2,205885,205885,205887,0,2,3
58686,1,1,205886,205887,205888,1,2,0
58687,3,2,205889,205889,205891,0,2,1
58688,4,2,205893,205893,205895,0,2,2
58689,2,2,205895,205895,205897,0,2,0
58690,1,2,205896,205897,205899,1,3,0
58691,3,3,205899,205899,205902,0,3,0
58692,4,1,205903,205903,205904,0,1,1
58693,6,1,205909,205909,205910,0,1,5
58694,4,1,205913,205913,205914,0,1,3
58695,1,3,205914,205914,205917,0,3,0
58696,3,2,205917,205917,205919,0,2,0
58697,1,2,205918,205919,205921,1,3,0
58698,2,2,205920,205921,205923,1,3,0
58699,5,3,205925,205925,205928,0,3,2
58700,5,1,205930,205930,205931,0,1,2
58701,5,3,205935,205935,205938,0,3,4
58702,3,3,205938,205938,205941,0,3,0
58703,2,2,205940,205941,205943,1,3,0
58704,2,1,205942,205943,205944,1,2,0
58705,2,1,205944,205944,205945,0,1,0
58706,3,2,205947,205947,205949,0,2,2
58707,4,1,205951,205951,205952,0,1,2
58708,3,2,205954,205954,205956,0,2,2
58709,2,2,205956,205956,205958,0,2,0
58710,4,3,205960,205960,205963,0,3,2
58711,6,1,205966,205966,205967,0,1,3
58712,4,1,205970,205970,205971,0,1,3
58713,2,2,205972,205972,205974,0,2,1
58714,1,1,205973,205974,205975,1,2,0
58715,5,1,205978,205978,205979,0,1,3
58716,6,1,205984,205984,205985,0,1,5
58717,2,2,205986,205986,205988,0,2,1
58718,3,3,205989,205989,205992,0,3,1
58719,2,1,205991,205992,205993,1,2,0
58720,4,3,205995,205995,205998,0,3,2
58721,6,1,206001,206001,206002,0,1,3
58722,3,2,206004,206004,206006,0,2,2
58723,4,1,206008,206008,206009,0,1,2
58724,1,2,206009,206009,206011,0,2,0
58725,1,1,206010,206011,206012,1,2,0
58726,5,2,206015,206015,206017,0,2,3
58727,4,3,206019,206019,206022,0,3,2
58728,6,2,206025,206025,206027,0,2,3
58729,1,2,206026,206027,206029,1,3,0
58730,6,3,206032,206032,206035,0,3,3
58731,4,2,206036,206036,206038,0,2,1
58732,3,2,206039,206039,206041,0,2,1
58733,1,3,206040,206041,206044,1,4,0
58734,3,2,206043,206044,206046,1,3,0
58735,4,2,206047,206047,206049,0,2,1
58736,3,1,206050,206050,206051,0,1,1
58737,5,2,206055,206055,206057,0,2,4
58738,1,1,206056,206057,206058,1,2,0
58739,2,1,206058,206058,206059,0,1,0
58740,3,1,206061,206061,206062,0,1,2
58741,4,2,206065,206065,206067,0,2,3
58742,1,1,206066,206067,206068,1,2,0
58743,2,3,206068,206068,206071,0,3,0
58744,4,3,206072,206072,206075,0,3,1
58745,5,3,206077,206077,206080,0,3,2
58746,1,2,206078,206080,206082,2,4,0
58747,2,2,206080,206082,206084,2,4,0
58748,1,2,206081,206084,206086,3,5,0
58749,6,3,206087,206087,206090,0,3,1
58750,2,1,206089,206090,206091,1,2,0
58751,4,1,206093,206093,206094,0,1,2
58752,3,1,206096,206096,206097,0,1,2
58753,3,3,206099,206099,206102,0,3,2
58754,5,3,206104,206104,206107,0,3,2
58755,4,3,206108,206108,206111,0,3,1
58756,1,3,206109,206111,206114,2,5,0
58757,2,2,206111,206114,206116,3,5,0
58758,1,1,206112,206116,206117,4,5,0
58759,1,2,206113,206117,206119,4,6,0
58760,6,1,206119,206119,206120,0,1,0
58761,5,2,206124,206124,206126,0,2,4
58762,1,3,206125,206126,206129,1,4,0
58763,6,1,206131,206131,206132,0,1,2
58764,2,2,206133,206133,206135,0,2,1
58765,1,1,206134,206135,206136,1,2,0
58766,1,3,206135,206136,206139,1,4,0
58767,1,2,206136,206139,206141,3,5,0
58768,3,2,206139,206141,206143,2,4,0
58769,4,1,206143,206143,206144,0,1,0
58770,5,2,206148,206148,206150,0,2,4
58771,1,1,206149,206150,206151,1,2,0
58772,2,1,206151,206151,206152,0,1,0
58773,4,2,206155,206155,206157,0,2,3
58774,1,2,206156,206157,206159,1,3,0
58775,2,1,206158,206159,206160,1,2,0
58776,3,2,206161,206161,206163,0,2,1
58777,5,2,206166,206166,206168,0,2,3
58778,4,1,206170,206170,206171,0,1,2
58779,5,2,206175,206175,206177,0,2,4
58780,4,3,206179,206179,206182,0,3,2
58781,3,1,206182,206182,206183,0,1,0
58782,2,1,206184,206184,206185,0,1,1
58783,4,1,206188,206188,206189,0,1,3
58784,2,1,206190,206190,206191,0,1,1
58785,3,1,206193,206193,206194,0,1,2
58786,3,2,206196,206196,206198,0,2,2
58787,1,3,206197,206198,206201,1,4,0
58788,3,3,206200,206201,206204,1,4,0
58789,2,3,206202,206204,206207,2,5,0
58790,4,2,206206,206207,206209,1,3,0
58791,2,2,206208,206209,206211,1,3,0
58792,1,3,206209,206211,206214,2,5,0
58793,5,1,206214,206214,206215,0,1,0
58794,6,3,206220,206220,206223,0,3,5
58795,6,3,206226,206226,206229,0,3,3
58796,2,2,206228,206229,206231,1,3,0
58797,2,2,206230,206231,206233,1,3,0
58798,1,3,206231,206233,206236,2,5,0
58799,2,1,206233,206236,206237,3,4,0
58800,5,2,206238,206238,206240,0,2,1
58801,1,3,206239,206240,206243,1,4,0
58802,6,3,206245,206245,206248,0,3,2
58803,3,3,206248,206248,206251,0,3,0
58804,2,1,206250,206251,206252,1,2,0
58805,6,3,206256,206256,206259,0,3,4
58806,4,1,206260,206260,206261,0,1,1
58807,6,3,206266,206266,206269,0,3,5
58808,5,2,206271,206271,206273,0,2,2
58809,6,3,206277,206277,206280,0,3,4
58810,1,3,206278,206280,206283,2,5,0
58811,3,1,206281,206283,206284,2,3,0
58812,3,3,206284,206284,206287,0,3,0
58813,5,1,206289,206289,206290,0,1,2
58814,3,2,206292,206292,206294,0,2,2
58815,6,1,206298,206298,206299,0,1,4
58816,1,3,206299,206299,206302,0,3,0
58817,4,2,206303,206303,206305,0,2,1
58818,2,1,206305,206305,206306,0,1,0
58819,3,1,206308,206308,206309,0,1,2
58820,1,1,206309,206309,206310,0,1,0
58821,2,1,206311,206311,206312,0,1,1
58822,3,2,206314,206314,206316,0,2,2
58823,5,1,206319,206319,206320,0,1,3
58824,1,2,206320,206320,206322,0,2,0
58825,2,2,206322,206322,206324,0,2,0
58826,5,2,206327,206327,206329,0,2,3
58827,1,3,206328,206329,206332,1,4,0
58828,2,3,206330,206332,206335,2,5,0
58829,6,3,206336,206336,206339,0,3,1
58830,1,2,206337,206339,206341,2,4,0
58831,2,1,206339,206341,206342,2,3,0
58832,5,2,206344,206344,206346,0,2,2
58833,4,1,206348,206348,206349,0,1,2
58834,2,3,206350,206350,206353,0,3,1
58835,5,1,206355,206355,206356,0,1,2
58836,3,2,206358,206358,206360,0,2,2
58837,4,2,206362,206362,206364,0,2,2
58838,3,3,206365,206365,206368,0,3,1
58839,4,3,206369,206369,206372,0,3,1
58840,2,1,206371,206372,206373,1,2,0
58841,4,1,206375,206375,206376,0,1,2
58842,5,2,206380,206380,206382,0,2,4
58843,6,3,206386,206386,206389,0,3,4
58844,3,1,206389,206389,206390,0,1,0
58845,4,1,206393,206393,206394,0,1,3
58846,1,1,206394,206394,206395,0,1,0
58847,1,1,206395,206395,206396,0,1,0
58848,5,2,206400,206400,206402,0,2,4
58849,3,2,206403,206403,206405,0,2,1
58850,4,3,206407,206407,206410,0,3,2
58851,2,1,206409,206410,206411,1,2,0
58852,1,1,206410,206411,206412,1,2,0
58853,1,1,206411,206412,206413,1,2,0
58854,3,3,206414,206414,206417,0,3,1
58855,2,3,206416,206417,206420,1,4,0
58856,6,2,206422,206422,206424,0,2,2
58857,6,2,206428,206428,206430,0,2,4
58858,5,3,206433,206433,206436,0,3,3
58859,2,1,206435,206436,206437,1,2,0
58860,6,2,206441,206441,206443,0,2,4
58861,2,1,206443,206443,206444,0,1,0
58862,1,3,206444,206444,206447,0,3,0
58863,3,1,206447,206447,206448,0,1,0
58864,6,1,206453,206453,206454,0,1,5
58865,6,3,206459,206459,206462,0,3,5
58866,4,2,206463,206463,206465,0,2,1
58867,2,2,206465,206465,206467,0,2,0
58868,1,3,206466,206467,206470,1,4,0
58869,3,2,206469,206470,206472,1,3,0
58870,1,2,206470,206472,206474,2,4,0
58871,1,3,206471,206474,206477,3,6,0
58872,1,3,206472,206477,206480,5,8,0
58873,2,3,206474,206480,206483,6,9,0
58874,5,2,206479,206483,206485,4,6,0
58875,1,3,206480,206485,206488,5,8,0
58876,3,2,206483,206488,206490,5,7,0
58877,5,1,206488,206490,206491,2,3,0
58878,5,3,206493,206493,206496,0,3,2
58879,4,3,206497,206497,206500,0,3,1
58880,2,3,206499,206500,206503,1,4,0
58881,3,3,206502,206503,206506,1,4,0
58882,3,3,206505,206506,206509,1,4,0
58883,4,2,206509,206509,206511,0,2,0
58884,5,3,206514,206514,206517,0,3,3
58885,3,2,206517,206517,206519,0,2,0
58886,2,2,206519,206519,206521,0,2,0
58887,1,3,206520,206521,206524,1,4,0
58888,1,1,206521,206524,206525,3,4,0
58889,3,1,206524,206525,206526,1,2,0
58890,6,2,206530,206530,206532,0,2,4
58891,2,2,206532,206532,206534,0,2,0
58892,3,1,206535,206535,206536,0,1,1
58893,3,1,206538,206538,206539,0,1,2
58894,6,1,206544,206544,206545,0,1,5
58895,3,1,206547,206547,206548,0,1,2
58896,2,2,206549,206549,206551,0,2,1
58897,5,2,206554,206554,206556,0,2,3
58898,2,2,206556,206556,206558,0,2,0
58899,5,3,206561,206561,206564,0,3,3
58900,3,2,206564,206564,206566,0,2,0
58901,5,1,206569,206569,206570,0,1,3
58902,2,1,206571,206571,206572,0,1,1
58903,2,3,206573,206573,206576,0,3,1
58904,1,1,206574,206576,206577,2,3,0
58905,1,3,206575,206577,206580,2,5,0
58906,3,2,206578,206580,206582,2,4,0
58907,1,1,206579,206582,206583,3,4,0
58908,2,2,206581,206583,206585,2,4,0
58909,6,3,206587,206587,206590,0,3,2
58910,2,1,206589,206590,206591,1,2,0
58911,3,3,206592,206592,206595,0,3,1
58912,5,1,206597,206597,206598,0,1,2
58913,1,2,206598,206598,206600,0,2,0
58914,3,2,206601,206601,206603,0,2,1
58915,4,1,206605,206605,206606,0,1,2
58916,3,3,206608,206608,206611,0,3,2
58917,2,2,206610,206611,206613,1,3,0
58918,3,2,206613,206613,206615,0,2,0
58919,6,3,206619,206619,206622,0,3,4
58920,4,1,206623,206623,206624,0,1,1
58921,5,2,206628,206628,206630,0,2,4
58922,6,2,206634,206634,206636,0,2,4
58923,6,2,206640,206640,206642,0,2,4
58924,5,2,206645,206645,206647,0,2,3
58925,3,3,206648,206648,206651,0,3,1
58926,3,2,206651,206651,206653,0,2,0
58927,4,1,206655,206655,206656,0,1,2
58928,4,2,206659,206659,206661,0,2,3
58929,6,2,206665,206665,206667,0,2,4
58930,5,2,206670,206670,206672,0,2,3
58931,4,3,206674,206674,206677,0,3,2
58932,5,3,206679,206679,206682,0,3,2
58933,4,2,206683,206683,206685,0,2,1
58934,1,2,206684,206685,206687,1,3,0
58935,5,1,206689,206689,206690,0,1,2
58936,3,3,206692,206692,206695,0,3,2
58937,2,3,206694,206695,206698,1,4,0
58938,5,2,206699,206699,206701,0,2,1
58939,1,1,206700,206701,206702,1,2,0
58940,3,1,206703,206703,206704,0,1,1
58941,6,3,206709,206709,206712,0,3,5
58942,1,2,206710,206712,206714,2,4,0
58943,6,1,206716,206716,206717,0,1,2
58944,1,1,206717,206717,206718,0,1,0
58945,5,3,206722,206722,206725,0,3,4
58946,1,3,206723,206725,206728,2,5,0
58947,5,1,206728,206728,206729,0,1,0
58948,4,1,206732,206732,206733,0,1,3
58949,6,2,206738,206738,206740,0,2,5
58950,5,2,206743,206743,206745,0,2,3
58951,6,3,206749,206749,206752,0,3,4
58952,3,1,206752,206752,206753,0,1,0
58953,2,2,206754,206754,206756,0,2,1
58954,1,2,206755,206756,206758,1,3,0
58955,2,1,206757,206758,206759,1,2,0
58956,6,2,206763,206763,206765,0,2,4
58957,2,1,206765,206765,206766,0,1,0
58958,1,2,206766,206766,206768,0,2,0
58959,3,1,206769,206769,206770,0,1,1
58960,4,3,206773,206773,206776,0,3,3
58961,3,3,206776,206776,206779,0,3,0
58962,3,2,206779,206779,206781,0,2,0
58963,3,1,206782,206782,206783,0,1,1
58964,1,3,206783,206783,206786,0,3,0
58965,4,1,206787,206787,206788,0,1,1
58966,1,2,206788,206788,206790,0,2,0
58967,4,2,206792,206792,206794,0,2,2
58968,6,2,206798,206798,206800,0,2,4
58969,3,2,206801,206801,206803,0,2,1
58970,2,1,206803,206803,206804,0,1,0
58971,4,2,206807,206807,206809,0,2,3
58972,5,2,206812,206812,206814,0,2,3
58973,1,2,206813,206814,206816,1,3,0
58974,2,2,206815,206816,206818,1,3,0
58975,5,1,206820,206820,206821,0,1,2
58976,6,3,206826,206826,206829,0,3,5
58977,3,2,206829,206829,206831,0,2,0
58978,2,2,206831,206831,206833,0,2,0
58979,6,2,206837,206837,206839,0,2,4
58980,1,1,206838,206839,206840,1,2,0
58981,5,1,206843,206843,206844,0,1,3
58982,6,3,206849,206849,206852,0,3,5
58983,4,2,206853,206853,206855,0,2,1
58984,1,1,206854,206855,206856,1,2,0
58985,2,3,206856,206856,206859,0,3,0
58986,4,1,206860,206860,206861,0,1,1
58987,6,3,206866,206866,206869,0,3,5
58988,4,3,206870,206870,206873,0,3,1
58989,3,2,206873,206873,206875,0,2,0
58990,6,2,206879,206879,206881,0,2,4
58991,1,2,206880,206881,206883,1,3,0
58992,6,1,206886,206886,206887,0,1,3
58993,4,2,206890,206890,206892,0,2,3
58994,4,1,206894,206894,206895,0,1,2
58995,3,2,206897,206897,206899,0,2,2
58996,4,1,206901,206901,206902,0,1,2
58997,1,2,206902,206902,206904,0,2,0
58998,3,3,206905,206905,206908,0,3,1
58999,5,1,206910,206910,206911,0,1,2
59000,4,2,206914,206914,206916,0,2,3
59001,3,3,206917,206917,206920,0,3,1
59002,6,3,206923,206923,206926,0,3,3
59003,6,2,206929,206929,206931,0,2,3
59004,3,1,206932,206932,206933,0,1,1
59005,1,1,206933,206933,206934,0,1,0
59006,3,2,206936,206936,206938,0,2,2
59007,4,1,206940,206940,206941,0,1,2
59008,3,2,206943,206943,206945,0,2,2
59009,6,3,206949,206949,206952,0,3,4
59010,5,3,206954,206954,206957,0,3,2
59011,2,3,206956,206957,206960,1,4,0
59012,6,1,206962,206962,206963,0,1,2
59013,3,1,206965,206965,206966,0,1,2
59014,6,2,206971,206971,206973,0,2,5
59015,6,2,206977,206977,206979,0,2,4
59016,3,3,206980,206980,206983,0,3,1
59017,2,2,206982,206983,206985,1,3,0
59018,1,2,206983,206985,206987,2,4,0
59019,2,2,206985,206987,206989,2,4,0
59020,6,1,206991,206991,206992,0,1,2
59021,6,2,206997,206997,206999,0,2,5
59022,2,1,206999,206999,207000,0,1,0
59023,6,3,207005,207005,207008,0,3,5
59024,6,3,207011,207011,207014,0,3,3
59025,6,1,207017,207017,207018,0,1,3
59026,3,2,207020,207020,207022,0,2,2
59027,4,1,207024,207024,207025,0,1,2
59028,1,2,207025,207025,207027,0,2,0
59029,2,1,207027,207027,207028,0,1,0
59030,3,1,207030,207030,207031,0,1,2
59031,1,2,207031,207031,207033,0,2,0
59032,3,1,207034,207034,207035,0,1,1
59033,6,2,207040,207040,207042,0,2,5
59034,6,3,207046,207046,207049,0,3,4
59035,3,2,207049,207049,207051,0,2,0
59036,2,3,207051,207051,207054,0,3,0
59037,5,1,207056,207056,207057,0,1,2
59038,2,1,207058,207058,207059,0,1,1
59039,5,1,207063,207063,207064,0,1,4
59040,4,2,207067,207067,207069,0,2,3
59041,4,3,207071,207071,207074,0,3,2
59042,6,1,207077,207077,207078,0,1,3
59043,3,2,207080,207080,207082,0,2,2
59044,2,3,207082,207082,207085,0,3,0
59045,3,1,207085,207085,207086,0,1,0
59046,3,3,207088,207088,207091,0,3,2
59047,3,1,207091,207091,207092,0,1,0
59048,6,3,207097,207097,207100,0,3,5
59049,5,1,207102,207102,207103,0,1,2
59050,6,2,207108,207108,207110,0,2,5
59051,1,1,207109,207110,207111,1,2,0
59052,2,2,207111,207111,207113,0,2,0
59053,6,2,207117,207117,207119,0,2,4
59054,5,1,207122,207122,207123,0,1,3
59055,3,1,207125,207125,207126,0,1,2
59056,5,1,207130,207130,207131,0,1,4
59057,4,2,207134,207134,207136,0,2,3
59058,6,2,207140,207140,207142,0,2,4
59059,2,3,207142,207142,207145,0,3,0
59060,6,2,207148,207148,207150,0,2,3
59061,2,2,207150,207150,207152,0,2,0
59062,2,2,207152,207152,207154,0,2,0
59063,6,2,207158,207158,207160,0,2,4
59064,4,2,207162,207162,207164,0,2,2
59065,2,1,207164,207164,207165,0,1,0
59066,3,1,207167,207167,207168,0,1,2
59067,2,3,207169,207169,207172,0,3,1
59068,1,2,207170,207172,207174,2,4,0
59069,3,3,207173,207174,207177,1,4,0
59070,3,3,207176,207177,207180,1,4,0
59071,3,1,207179,207180,207181,1,2,0
59072,4,3,207183,207183,207186,0,3,2
59073,5,3,207188,207188,207191,0,3,2
59074,2,2,207190,207191,207193,1,3,0
59075,6,3,207196,207196,207199,0,3,3
59076,2,2,207198,207199,207201,1,3,0
59077,3,3,207201,207201,207204,0,3,0
59078,6,3,207207,207207,207210,0,3,3
59079,3,1,207210,207210,207211,0,1,0
59080,1,2,207211,207211,207213,0,2,0
59081,2,2,207213,207213,207215,0,2,0
59082,2,1,207215,207215,207216,0,1,0
59083,4,3,207219,207219,207222,0,3,3
59084,1,1,207220,207222,207223,2,3,0
59085,1,1,207221,207223,207224,2,3,0
59086,2,1,207223,207224,207225,1,2,0
59087,5,3,207228,207228,207231,0,3,3
59088,5,1,207233,207233,207234,0,1,2
59089,2,1,207235,207235,207236,0,1,1
59090,6,3,207241,207241,207244,0,3,5
59091,3,1,207244,207244,207245,0,1,0
59092,2,2,207246,207246,207248,0,2,1
59093,2,1,207248,207248,207249,0,1,0
59094,2,3,207250,207250,207253,0,3,1
59095,4,2,207254,207254,207256,0,2,1
59096,2,1,207256,207256,207257,0,1,0
59097,3,1,207259,207259,207260,0,1,2
59098,3,2,207262,207262,207264,0,2,2
59099,3,1,207265,207265,207266,0,1,1
59100,2,2,207267,207267,207269,0,2,1
59101,5,1,207272,207272,207273,0,1,3
59102,5,1,207277,207277,207278,0,1,4
59103,5,2,207282,207282,207284,0,2,4
59104,1,2,207283,207284,207286,1,3,0
59105,1,3,207284,207286,207289,2,5,0
59106,4,3,207288,207289,207292,1,4,0
59107,2,1,207290,207292,207293,2,3,0
59108,3,2,207293,207293,207295,0,2,0
59109,5,1,207298,207298,207299,0,1,3
59110,5,3,207303,207303,207306,0,3,4
59111,4,1,207307,207307,207308,0,1,1
59112,1,3,207308,207308,207311,0,3,0
59113,6,1,207314,207314,207315,0,1,3
59114,2,1,207316,207316,207317,0,1,1
59115,2,3,207318,207318,207321,0,3,1
59116,2,1,207320,207321,207322,1,2,0
59117,2,1,207322,207322,207323,0,1,0
59118,1,2,207323,207323,207325,0,2,0
59119,3,2,207326,207326,207328,0,2,1
59120,5,2,207331,207331,207333,0,2,3
59121,2,1,207333,207333,207334,0,1,0
59122,3,1,207336,207336,207337,0,1,2
59123,2,2,207338,207338,207340,0,2,1
59124,5,1,207343,207343,207344,0,1,3
59125,4,1,207347,207347,207348,0,1,3
59126,6,3,207353,207353,207356,0,3,5
59127,2,2,207355,207356,207358,1,3,0
59128,4,1,207359,207359,207360,0,1,1
59129,2,3,207361,207361,207364,0,3,1
59130,3,2,207364,207364,207366,0,2,0
59131,6,1,207370,207370,207371,0,1,4
59132,2,2,207372,207372,207374,0,2,1
59133,3,3,207375,207375,207378,0,3,1
59134,6,1,207381,207381,207382,0,1,3
59135,5,2,207386,207386,207388,0,2,4
59136,2,3,207388,207388,207391,0,3,0
59137,4,3,207392,207392,207395,0,3,1
59138,3,3,207395,207395,207398,0,3,0
59139,5,1,207400,207400,207401,0,1,2
59140,5,3,207405,207405,207408,0,3,4
59141,2,2,207407,207408,207410,1,3,0
59142,3,3,207410,207410,207413,0,3,0
59143,3,2,207413,207413,207415,0,2,0
59144,1,1,207414,207415,207416,1,2,0
59145,5,1,207419,207419,207420,0,1,3
59146,4,3,207423,207423,207426,0,3,3
59147,4,1,207427,207427,207428,0,1,1
59148,1,3,207428,207428,207431,0,3,0
59149,1,3,207429,207431,207434,2,5,0
59150,2,2,207431,207434,207436,3,5,0
59151,5,3,207436,207436,207439,0,3,0
59152,2,2,207438,207439,207441,1,3,0
59153,1,2,207439,207441,207443,2,4,0
59154,6,3,207445,207445,207448,0,3,2
59155,1,3,207446,207448,207451,2,5,0
59156,2,2,207448,207451,207453,3,5,0
59157,6,1,207454,207454,207455,0,1,1
59158,6,3,207460,207460,207463,0,3,5
59159,2,2,207462,207463,207465,1,3,0
59160,5,3,207467,207467,207470,0,3,2
59161,5,2,207472,207472,207474,0,2,2
59162,2,2,207474,207474,207476,0,2,0
59163,4,3,207478,207478,207481,0,3,2
59164,2,1,207480,207481,207482,1,2,0
59165,4,2,207484,207484,207486,0,2,2
59166,1,2,207485,207486,207488,1,3,0
59167,1,2,207486,207488,207490,2,4,0
59168,3,1,207489,207490,207491,1,2,0
59169,6,2,207495,207495,207497,0,2,4
59170,5,1,207500,207500,207501,0,1,3
59171,4,3,207504,207504,207507,0,3,3
59172,6,2,207510,207510,207512,0,2,3
59173,2,3,207512,207512,207515,0,3,0
59174,2,2,207514,207515,207517,1,3,0
59175,5,2,207519,207519,207521,0,2,2
59176,4,2,207523,207523,207525,0,2,2
59177,6,3,207529,207529,207532,0,3,4
59178,2,2,207531,207532,207534,1,3,0
59179,1,1,207532,207534,207535,2,3,0
59180,6,2,207538,207538,207540,0,2,3
59181,3,1,207541,207541,207542,0,1,1
59182,3,2,207544,207544,207546,0,2,2
59183,2,2,207546,207546,207548,0,2,0
59184,4,3,207550,207550,207553,0,3,2
59185,2,3,207552,207553,207556,1,4,0
59186,5,1,207557,207557,207558,0,1,1
59187,6,2,207563,207563,207565,0,2,5
59188,3,1,207566,207566,207567,0,1,1
59189,2,3,207568,207568,207571,0,3,1
59190,2,1,207570,207571,207572,1,2,0
59191,1,2,207571,207572,207574,1,3,0
59192,5,3,207576,207576,207579,0,3,2
59193,1,2,207577,207579,207581,2,4,0
59194,5,1,207582,207582,207583,0,1,1
59195,5,2,207587,207587,207589,0,2,4
59196,5,2,207592,207592,207594,0,2,3
59197,1,3,207593,207594,207597,1,4,0
59198,2,1,207595,207597,207598,2,3,0
59199,6,1,207601,207601,207602,0,1,3
59200,2,1,207603,207603,207604,0,1,1
59201,1,1,207604,207604,207605,0,1,0
59202,6,1,207610,207610,207611,0,1,5
59203,4,1,207614,207614,207615,0,1,3
59204,3,2,207617,207617,207619,0,2,2
59205,4,1,207621,207621,207622,0,1,2
59206,5,3,207626,207626,207629,0,3,4
59207,6,3,207632,207632,207635,0,3,3
59208,4,3,207636,207636,207639,0,3,1
59209,1,1,207637,207639,207640,2,3,0
59210,4,1,207641,207641,207642,0,1,1
59211,1,1,207642,207642,207643,0,1,0
59212,4,1,207646,207646,207647,0,1,3
59213,4,1,207650,207650,207651,0,1,3
59214,3,3,207653,207653,207656,0,3,2
59215,2,1,207655,207656,207657,1,2,0
59216,1,2,207656,207657,207659,1,3,0
59217,4,3,207660,207660,207663,0,3,1
59218,3,1,207663,207663,207664,0,1,0
59219,5,3,207668,207668,207671,0,3,4
59220,4,2,207672,207672,207674,0,2,1
59221,1,1,207673,207674,207675,1,2,0
59222,5,2,207678,207678,207680,0,2,3
59223,1,1,207679,207680,207681,1,2,0
59224,5,2,207684,207684,207686,0,2,3
59225,1,2,207685,207686,207688,1,3,0
59226,3,2,207688,207688,207690,0,2,0
59227,2,2,207690,207690,207692,0,2,0
59228,6,3,207696,207696,207699,0,3,4
59229,4,1,207700,207700,207701,0,1,1
59230,2,3,207702,207702,207705,0,3,1
59231,3,1,207705,207705,207706,0,1,0
59232,4,3,207709,207709,207712,0,3,3
59233,2,2,207711,207712,207714,1,3,0
59234,2,2,207713,207714,207716,1,3,0
59235,1,3,207714,207716,207719,2,5,0
59236,2,3,207716,207719,207722,3,6,0
59237,2,2,207718,207722,207724,4,6,0
59238,5,2,207723,207724,207726,1,3,0
59239,4,2,207727,207727,207729,0,2,1
59240,3,1,207730,207730,207731,0,1,1
59241,1,2,207731,207731,207733,0,2,0
59242,1,3,207732,207733,207736,1,4,0
59243,6,2,207738,207738,207740,0,2,2
59244,2,3,207740,207740,207743,0,3,0
59245,2,2,207742,207743,207745,1,3,0
59246,6,2,207748,207748,207750,0,2,3
59247,3,3,207751,207751,207754,0,3,1
59248,4,1,207755,207755,207756,0,1,1
59249,6,1,207761,207761,207762,0,1,5
59250,2,2,207763,207763,207765,0,2,1
59251,4,1,207767,207767,207768,0,1,2
59252,3,3,207770,207770,207773,0,3,2
59253,1,3,207771,207773,207776,2,5,0
59254,2,1,207773,207776,207777,3,4,0
59255,4,2,207777,207777,207779,0,2,0
59256,2,2,207779,207779,207781,0,2,0
59257,4,1,207783,207783,207784,0,1,2
59258,4,2,207787,207787,207789,0,2,3
59259,6,1,207793,207793,207794,0,1,4
59260,5,2,207798,207798,207800,0,2,4
59261,4,3,207802,207802,207805,0,3,2
59262,1,2,207803,207805,207807,2,4,0
59263,3,2,207806,207807,207809,1,3,0
59264,4,1,207810,207810,207811,0,1,1
59265,6,1,207816,207816,207817,0,1,5
59266,1,2,207817,207817,207819,0,2,0
59267,6,2,207823,207823,207825,0,2,4
59268,3,2,207826,207826,207828,0,2,1
59269,6,1,207832,207832,207833,0,1,4
59270,5,2,207837,207837,207839,0,2,4
59271,3,2,207840,207840,207842,0,2,1
59272,6,1,207846,207846,207847,0,1,4
59273,5,1,207851,207851,207852,0,1,4
59274,6,2,207857,207857,207859,0,2,5
59275,6,2,207863,207863,207865,0,2,4
59276,5,2,207868,207868,207870,0,2,3
59277,5,1,207873,207873,207874,0,1,3
59278,3,1,207876,207876,207877,0,1,2
59279,5,3,207881,207881,207884,0,3,4
59280,4,3,207885,207885,207888,0,3,1
59281,1,2,207886,207888,207890,2,4,0
59282,4,3,207890,207890,207893,0,3,0
59283,1,1,207891,207893,207894,2,3,0
59284,3,3,207894,207894,207897,0,3,0
59285,1,2,207895,207897,207899,2,4,0
59286,2,1,207897,207899,207900,2,3,0
59287,4,2,207901,207901,207903,0,2,1
59288,1,1,207902,207903,207904,1,2,0
59289,3,1,207905,207905,207906,0,1,1
59290,1,1,207906,207906,207907,0,1,0
59291,1,1,207907,207907,207908,0,1,0
59292,4,1,207911,207911,207912,0,1,3
59293,3,3,207914,207914,207917,0,3,2
59294,1,1,207915,207917,207918,2,3,0
59295,1,2,207916,207918,207920,2,4,0
59296,5,1,207921,207921,207922,0,1,1
59297,6,3,207927,207927,207930,0,3,5
59298,5,2,207932,207932,207934,0,2,2
59299,2,2,207934,207934,207936,0,2,0
59300,4,1,207938,207938,207939,0,1,2
59301,4,2,207942,207942,207944,0,2,3
59302,6,2,207948,207948,207950,0,2,4
59303,2,2,207950,207950,207952,0,2,0
59304,5,3,207955,207955,207958,0,3,3
59305,6,1,207961,207961,207962,0,1,3
59306,3,1,207964,207964,207965,0,1,2
59307,3,1,207967,207967,207968,0,1,2
59308,2,2,207969,207969,207971,0,2,1
59309,4,3,207973,207973,207976,0,3,2
59310,3,3,207976,207976,207979,0,3,0
59311,1,2,207977,207979,207981,2,4,0
59312,3,2,207980,207981,207983,1,3,0
59313,6,1,207986,207986,207987,0,1,3
59314,4,1,207990,207990,207991,0,1,3
59315,5,2,207995,207995,207997,0,2,4
59316,3,1,207998,207998,207999,0,1,1
59317,5,1,208003,208003,208004,0,1,4
59318,6,3,208009,208009,208012,0,3,5
59319,6,2,208015,208015,208017,0,2,3
59320,2,2,208017,208017,208019,0,2,0
59321,6,2,208023,208023,208025,0,2,4
59322,2,1,208025,208025,208026,0,1,0
59323,4,1,208029,208029,208030,0,1,3
59324,2,1,208031,208031,208032,0,1,1
59325,3,3,208034,208034,208037,0,3,2
59326,6,3,208040,208040,208043,0,3,3
59327,5,3,208045,208045,208048,0,3,2
59328,4,2,208049,208049,208051,0,2,1
59329,4,1,208053,208053,208054,0,1,2
59330,1,2,208054,208054,208056,0,2,0
59331,6,3,208060,208060,208063,0,3,4
59332,3,2,208063,208063,208065,0,2,0
59333,3,2,208066,208066,208068,0,2,1
59334,5,1,208071,208071,208072,0,1,3
59335,5,2,208076,208076,208078,0,2,4
59336,6,2,208082,208082,208084,0,2,4
59337,6,1,208088,208088,208089,0,1,4
59338,5,1,208093,208093,208094,0,1,4
59339,5,2,208098,208098,208100,0,2,4
59340,2,3,208100,208100,208103,0,3,0
59341,4,3,208104,208104,208107,0,3,1
59342,4,2,208108,208108,208110,0,2,1
59343,2,1,208110,208110,208111,0,1,0
59344,4,2,208114,208114,208116,0,2,3
59345,5,3,208119,208119,208122,0,3,3
59346,1,3,208120,208122,208125,2,5,0
59347,5,1,208125,208125,208126,0,1,0
59348,2,1,208127,208127,208128,0,1,1
59349,3,1,208130,208130,208131,0,1,2
59350,6,1,208136,208136,208137,0,1,5
59351,5,1,208141,208141,208142,0,1,4
59352,6,1,208147,208147,208148,0,1,5
59353,4,2,208151,208151,208153,0,2,3
59354,6,1,208157,208157,208158,0,1,4
59355,3,2,208160,208160,208162,0,2,2
59356,1,1,208161,208162,208163,1,2,0
59357,4,3,208165,208165,208168,0,3,2
59358,1,3,208166,208168,208171,2,5,0
59359,6,2,208172,208172,208174,0,2,1
59360,1,2,208173,208174,208176,1,3,0
59361,1,2,208174,208176,208178,2,4,0
59362,6,2,208180,208180,208182,0,2,2
59363,3,3,208183,208183,208186,0,3,1
59364,4,2,208187,208187,208189,0,2,1
59365,5,3,208192,208192,208195,0,3,3
59366,2,3,208194,208195,208198,1,4,0
59367,2,1,208196,208198,208199,2,3,0
59368,1,2,208197,208199,208201,2,4,0
59369,6,1,208203,208203,208204,0,1,2
59370,1,2,208204,208204,208206,0,2,0
59371,1,2,208205,208206,208208,1,3,0
59372,1,3,208206,208208,208211,2,5,0
59373,6,3,208212,208212,208215,0,3,1
59374,1,2,208213,208215,208217,2,4,0
59375,6,3,208219,208219,208222,0,3,2
59376,1,3,208220,208222,208225,2,5,0
59377,4,2,208224,208225,208227,1,3,0
59378,6,2,208230,208230,208232,0,2,3
59379,4,3,208234,208234,208237,0,3,2
59380,5,2,208239,208239,208241,0,2,2
59381,6,3,208245,208245,208248,0,3,4
59382,2,1,208247,208248,208249,1,2,0
59383,5,1,208252,208252,208253,0,1,3
59384,2,3,208254,208254,208257,0,3,1
59385,3,3,208257,208257,208260,0,3,0
59386,1,1,208258,208260,208261,2,3,0
59387,1,3,208259,208261,208264,2,5,0
59388,1,2,208260,208264,208266,4,6,0
59389,4,2,208264,208266,208268,2,4,0
59390,6,1,208270,208270,208271,0,1,2
59391,4,2,208274,208274,208276,0,2,3
59392,6,3,208280,208280,208283,0,3,4
59393,2,2,208282,208283,208285,1,3,0
59394,6,3,208288,208288,208291,0,3,3
59395,4,2,208292,208292,208294,0,2,1
59396,4,1,208296,208296,208297,0,1,2
59397,2,3,208298,208298,208301,0,3,1
59398,1,2,208299,208301,208303,2,4,0
59399,6,3,208305,208305,208308,0,3,2
59400,6,3,208311,208311,208314,0,3,3
59401,1,2,208312,208314,208316,2,4,0
59402,5,3,208317,208317,208320,0,3,1
59403,3,1,208320,208320,208321,0,1,0
59404,4,3,208324,208324,208327,0,3,3
59405,4,1,208328,208328,208329,0,1,1
59406,5,3,208333,208333,208336,0,3,4
59407,5,1,208338,208338,208339,0,1,2
59408,1,1,208339,208339,208340,0,1,0
59409,4,3,208343,208343,208346,0,3,3
59410,2,3,208345,208346,208349,1,4,0
59411,5,2,208350,208350,208352,0,2,1
59412,1,1,208351,208352,208353,1,2,0
59413,1,2,208352,208353,208355,1,3,0
59414,3,1,208355,208355,208356,0,1,0
59415,5,2,208360,208360,208362,0,2,4
59416,2,1,208362,208362,208363,0,1,0
59417,3,1,208365,208365,208366,0,1,2
59418,2,2,208367,208367,208369,0,2,1
59419,5,2,208372,208372,208374,0,2,3
59420,4,1,208376,208376,208377,0,1,2
59421,6,3,208382,208382,208385,0,3,5
59422,5,2,208387,208387,208389,0,2,2
59423,2,1,208389,208389,208390,0,1,0
59424,2,1,208391,208391,208392,0,1,1
59425,6,2,208397,208397,208399,0,2,5
59426,2,2,208399,208399,208401,0,2,0
59427,5,1,208404,208404,208405,0,1,3
59428,4,3,208408,208408,208411,0,3,3
59429,2,3,208410,208411,208414,1,4,0
59430,2,2,208412,208414,208416,2,4,0
59431,2,3,208414,208416,208419,2,5,0
59432,1,2,208415,208419,208421,4,6,0
59433,2,1,208417,208421,208422,4,5,0
59434,5,3,208422,208422,208425,0,3,0
59435,5,2,208427,208427,208429,0,2,2
59436,1,3,208428,208429,208432,1,4,0
59437,6,2,208434,208434,208436,0,2,2
59438,1,3,208435,208436,208439,1,4,0
59439,1,1,208436,208439,208440,3,4,0
59440,2,3,208438,208440,208443,2,5,0
59441,2,3,208440,208443,208446,3,6,0
59442,6,2,208446,208446,208448,0,2,0
59443,4,1,208450,208450,208451,0,1,2
59444,6,3,208456,208456,208459,0,3,5
59445,5,2,208461,208461,208463,0,2,2
59446,4,2,208465,208465,208467,0,2,2
59447,3,2,208468,208468,208470,0,2,1
59448,1,2,208469,208470,208472,1,3,0
59449,6,2,208475,208475,208477,0,2,3
59450,2,2,208477,208477,208479,0,2,0
59451,2,2,208479,208479,208481,0,2,0
59452,5,1,208484,208484,208485,0,1,3
59453,2,2,208486,208486,208488,0,2,1
59454,6,1,208492,208492,208493,0,1,4
59455,2,3,208494,208494,208497,0,3,1
59456,1,2,208495,208497,208499,2,4,0
59457,6,3,208501,208501,208504,0,3,2
59458,3,1,208504,208504,208505,0,1,0
59459,4,2,208508,208508,208510,0,2,3
59460,1,1,208509,208510,208511,1,2,0
59461,1,3,208510,208511,208514,1,4,0
59462,3,3,208513,208514,208517,1,4,0
59463,4,2,208517,208517,208519,0,2,0
59464,4,1,208521,208521,208522,0,1,2
59465,2,2,208523,208523,208525,0,2,1
59466,4,3,208527,208527,208530,0,3,2
59467,3,2,208530,208530,208532,0,2,0
59468,4,3,208534,208534,208537,0,3,2
59469,1,1,208535,208537,208538,2,3,0
59470,3,1,208538,208538,208539,0,1,0
59471,3,3,208541,208541,208544,0,3,2
59472,2,2,208543,208544,208546,1,3,0
59473,4,3,208547,208547,208550,0,3,1
59474,4,3,208551,208551,208554,0,3,1
59475,4,3,208555,208555,208558,0,3,1
59476,4,2,208559,208559,208561,0,2,1
59477,2,2,208561,208561,208563,0,2,0
59478,5,1,208566,208566,208567,0,1,3
59479,4,3,208570,208570,208573,0,3,3
59480,4,1,208574,208574,208575,0,1,1
59481,1,1,208575,208575,208576,0,1,0
59482,4,3,208579,208579,208582,0,3,3
59483,2,1,208581,208582,208583,1,2,0
59484,5,2,208586,208586,208588,0,2,3
59485,5,2,208591,208591,208593,0,2,3
59486,4,1,208595,208595,208596,0,1,2
59487,3,3,208598,208598,208601,0,3,2
59488,6,1,208604,208604,208605,0,1,3
59489,3,1,208607,208607,208608,0,1,2
59490,2,2,208609,208609,208611,0,2,1
59491,4,2,208613,208613,208615,0,2,2
59492,4,1,208617,208617,208618,0,1,2
59493,4,3,208621,208621,208624,0,3,3
59494,4,1,208625,208625,208626,0,1,1
59495,2,3,208627,208627,208630,0,3,1
59496,4,1,208631,208631,208632,0,1,1
59497,4,3,208635,208635,208638,0,3,3
59498,1,3,208636,208638,208641,2,5,0
59499,2,2,208638,208641,208643,3,5,0
59500,5,3,208643,208643,208646,0,3,0
59501,2,1,208645,208646,208647,1,2,0
59502,6,1,208651,208651,208652,0,1,4
59503,1,1,208652,208652,208653,0,1,0
59504,5,3,208657,208657,208660,0,3,4
59505,6,2,208663,208663,208665,0,2,3
59506,4,3,208667,208667,208670,0,3,2
59507,3,3,208670,208670,208673,0,3,0
59508,3,2,208673,208673,208675,0,2,0
59509,4,1,208677,208677,208678,0,1,2
59510,3,2,208680,208680,208682,0,2,2
59511,2,2,208682,208682,208684,0,2,0
59512,1,3,208683,208684,208687,1,4,0
59513,1,1,208684,208687,208688,3,4,0
59514,4,2,208688,208688,208690,0,2,0
59515,2,1,208690,208690,208691,0,1,0
59516,4,1,208694,208694,208695,0,1,3
59517,5,3,208699,208699,208702,0,3,4
59518,1,3,208700,208702,208705,2,5,0
59519,3,1,208703,208705,208706,2,3,0
59520,1,1,208704,208706,208707,2,3,0
59521,1,3,208705,208707,208710,2,5,0
59522,5,2,208710,208710,208712,0,2,0
59523,3,2,208713,208713,208715,0,2,1
59524,5,1,208718,208718,208719,0,1,3
59525,5,3,208723,208723,208726,0,3,4
59526,6,2,208729,208729,208731,0,2,3
59527,1,3,208730,208731,208734,1,4,0
59528,1,3,208731,208734,208737,3,6,0
59529,6,3,208737,208737,208740,0,3,0
59530,1,3,208738,208740,208743,2,5,0
59531,6,2,208744,208744,208746,0,2,1
59532,3,2,208747,208747,208749,0,2,1
59533,2,2,208749,208749,208751,0,2,0
59534,1,2,208750,208751,208753,1,3,0
59535,1,2,208751,208753,208755,2,4,0
59536,2,3,208753,208755,208758,2,5,0
59537,6,3,208759,208759,208762,0,3,1
59538,2,3,208761,208762,208765,1,4,0
59539,5,1,208766,208766,208767,0,1,1
59540,6,2,208772,208772,208774,0,2,5
59541,5,2,208777,208777,208779,0,2,3
59542,4,2,208781,208781,208783,0,2,2
59543,4,2,208785,208785,208787,0,2,2
59544,4,2,208789,208789,208791,0,2,2
59545,6,2,208795,208795,208797,0,2,4
59546,3,1,208798,208798,208799,0,1,1
59547,3,3,208801,208801,208804,0,3,2
59548,4,1,208805,208805,208806,0,1,1
59549,6,2,208811,208811,208813,0,2,5
59550,2,1,208813,208813,208814,0,1,0
59551,4,1,208817,208817,208818,0,1,3
59552,3,1,208820,208820,208821,0,1,2
59553,4,2,208824,208824,208826,0,2,3
59554,3,3,208827,208827,208830,0,3,1
59555,6,3,208833,208833,208836,0,3,3
59556,2,3,208835,208836,208839,1,4,0
59557,6,3,208841,208841,208844,0,3,2
59558,5,3,208846,208846,208849,0,3,2
59559,3,3,208849,208849,208852,0,3,0
59560,4,3,208853,208853,208856,0,3,1
59561,6,2,208859,208859,208861,0,2,3
59562,2,1,208861,208861,208862,0,1,0
59563,1,3,208862,208862,208865,0,3,0
59564,2,3,208864,208865,208868,1,4,0
59565,5,3,208869,208869,208872,0,3,1
59566,3,3,208872,208872,208875,0,3,0
59567,4,2,208876,208876,208878,0,2,1
59568,1,3,208877,208878,208881,1,4,0
59569,3,3,208880,208881,208884,1,4,0
59570,2,1,208882,208884,208885,2,3,0
59571,4,1,208886,208886,208887,0,1,1
59572,5,3,208891,208891,208894,0,3,4
59573,1,1,208892,208894,208895,2,3,0
59574,6,2,208898,208898,208900,0,2,3
59575,2,3,208900,208900,208903,0,3,0
59576,6,2,208906,208906,208908,0,2,3
59577,1,1,208907,208908,208909,1,2,0
59578,4,2,208911,208911,208913,0,2,2
59579,4,3,208915,208915,208918,0,3,2
59580,3,1,208918,208918,208919,0,1,0
59581,3,3,208921,208921,208924,0,3,2
59582,3,3,208924,208924,208927,0,3,0
59583,3,3,208927,208927,208930,0,3,0
59584,4,2,208931,208931,208933,0,2,1
59585,6,2,208937,208937,208939,0,2,4
59586,2,3,208939,208939,208942,0,3,0
59587,3,3,208942,208942,208945,0,3,0
59588,2,1,208944,208945,208946,1,2,0
59589,1,2,208945,208946,208948,1,3,0
59590,6,3,208951,208951,208954,0,3,3
59591,2,1,208953,208954,208955,1,2,0
59592,4,2,208957,208957,208959,0,2,2
59593,1,3,208958,208959,208962,1,4,0
59594,3,1,208961,208962,208963,1,2,0
59595,4,3,208965,208965,208968,0,3,2
59596,1,2,208966,208968,208970,2,4,0
59597,4,1,208970,208970,208971,0,1,0
59598,2,1,208972,208972,208973,0,1,1
59599,1,3,208973,208973,208976,0,3,0
59600,2,2,208975,208976,208978,1,3,0
59601,6,2,208981,208981,208983,0,2,3
59602,4,1,208985,208985,208986,0,1,2
59603,1,2,208986,208986,208988,0,2,0
59604,1,1,208987,208988,208989,1,2,0
59605,6,2,208993,208993,208995,0,2,4
59606,2,2,208995,208995,208997,0,2,0
59607,2,1,208997,208997,208998,0,1,0
59608,6,3,209003,209003,209006,0,3,5
59609,1,2,209004,209006,209008,2,4,0
59610,5,3,209009,209009,209012,0,3,1
59611,2,2,209011,209012,209014,1,3,0
59612,6,3,209017,209017,209020,0,3,3
59613,4,1,209021,209021,209022,0,1,1
59614,5,1,209026,209026,209027,0,1,4
59615,3,3,209029,209029,209032,0,3,2
59616,2,2,209031,209032,209034,1,3,0
59617,3,3,209034,209034,209037,0,3,0
59618,2,3,209036,209037,209040,1,4,0
59619,3,3,209039,209040,209043,1,4,0
59620,4,2,209043,209043,209045,0,2,0
59621,4,2,209047,209047,209049,0,2,2
59622,3,2,209050,209050,209052,0,2,1
59623,2,3,209052,209052,209055,0,3,0
59624,3,3,209055,209055,209058,0,3,0
59625,4,3,209059,209059,209062,0,3,1
59626,6,2,209065,209065,209067,0,2,3
59627,3,2,209068,209068,209070,0,2,1
59628,4,3,209072,209072,209075,0,3,2
59629,4,1,209076,209076,209077,0,1,1
59630,6,3,209082,209082,209085,0,3,5
59631,5,3,209087,209087,209090,0,3,2
59632,3,1,209090,209090,209091,0,1,0
59633,1,3,209091,209091,209094,0,3,0
59634,2,1,209093,209094,209095,1,2,0
59635,5,3,209098,209098,209101,0,3,3
59636,6,3,209104,209104,209107,0,3,3
59637,2,2,209106,209107,209109,1,3,0
59638,2,1,209108,209109,209110,1,2,0
59639,6,2,209114,209114,209116,0,2,4
59640,1,3,209115,209116,209119,1,4,0
59641,6,2,209121,209121,209123,0,2,2
59642,3,2,209124,209124,209126,0,2,1
59643,4,2,209128,209128,209130,0,2,2
59644,4,3,209132,209132,209135,0,3,2
59645,6,1,209138,209138,209139,0,1,3
59646,3,2,209141,209141,209143,0,2,2
59647,4,3,209145,209145,209148,0,3,2
59648,5,3,209150,209150,209153,0,3,2
59649,1,3,209151,209153,209156,2,5,0
59650,6,2,209157,209157,209159,0,2,1
59651,2,2,209159,209159,209161,0,2,0
59652,2,2,209161,209161,209163,0,2,0
59653,6,2,209167,209167,209169,0,2,4
59654,5,1,209172,209172,209173,0,1,3
59655,1,3,209173,209173,209176,0,3,0
59656,2,2,209175,209176,209178,1,3,0
59657,1,3,209176,209178,209181,2,5,0
59658,5,3,209181,209181,209184,0,3,0
59659,1,1,209182,209184,209185,2,3,0
59660,2,1,209184,209185,209186,1,2,0
59661,2,1,209186,209186,209187,0,1,0
59662,1,3,209187,209187,209190,0,3,0
59663,2,1,209189,209190,209191,1,2,0
59664,6,2,209195,209195,209197,0,2,4
59665,3,3,209198,209198,209201,0,3,1
59666,2,3,209200,209201,209204,1,4,0
59667,2,1,209202,209204,209205,2,3,0
59668,5,2,209207,209207,209209,0,2,2
59669,4,2,209211,209211,209213,0,2,2
59670,2,2,209213,209213,209215,0,2,0
59671,4,3,209217,209217,209220,0,3,2
59672,4,2,209221,209221,209223,0,2,1
59673,2,2,209223,209223,209225,0,2,0
59674,2,2,209225,209225,209227,0,2,0
59675,3,2,209228,209228,209230,0,2,1
59676,3,2,209231,209231,209233,0,2,1
59677,3,1,209234,209234,209235,0,1,1
59678,5,2,209239,209239,209241,0,2,4
59679,2,1,209241,209241,209242,0,1,0
59680,2,2,209243,209243,209245,0,2,1
59681,4,3,209247,209247,209250,0,3,2
59682,2,3,209249,209250,209253,1,4,0
59683,6,1,209255,209255,209256,0,1,2
59684,2,1,209257,209257,209258,0,1,1
59685,2,3,209259,209259,209262,0,3,1
59686,3,2,209262,209262,209264,0,2,0
59687,6,2,209268,209268,209270,0,2,4
59688,3,3,209271,209271,209274,0,3,1
59689,3,1,209274,209274,209275,0,1,0
59690,2,2,209276,209276,209278,0,2,1
59691,6,1,209282,209282,209283,0,1,4
59692,5,1,209287,209287,209288,0,1,4
59693,6,1,209293,209293,209294,0,1,5
59694,6,2,209299,209299,209301,0,2,5
59695,5,3,209304,209304,209307,0,3,3
59696,1,1,209305,209307,209308,2,3,0
59697,3,2,209308,209308,209310,0,2,0
59698,5,1,209313,209313,209314,0,1,3
59699,6,3,209319,209319,209322,0,3,5
59700,2,2,209321,209322,209324,1,3,0
59701,6,2,209327,209327,209329,0,2,3
59702,6,1,209333,209333,209334,0,1,4
59703,4,3,209337,209337,209340,0,3,3
59704,1,1,209338,209340,209341,2,3,0
59705,4,2,209342,209342,209344,0,2,1
59706,1,1,209343,209344,209345,1,2,0
59707,1,1,209344,209345,209346,1,2,0
59708,5,1,209349,209349,209350,0,1,3
59709,1,1,209350,209350,209351,0,1,0
59710,6,1,209356,209356,209357,0,1,5
59711,4,1,209360,209360,209361,0,1,3
59712,2,2,209362,209362,209364,0,2,1
59713,4,2,209366,209366,209368,0,2,2
59714,3,2,209369,209369,209371,0,2,1
59715,2,2,209371,209371,209373,0,2,0
59716,2,2,209373,209373,209375,0,2,0
59717,6,2,209379,209379,209381,0,2,4
59718,3,1,209382,209382,209383,0,1,1
59719,4,1,209386,209386,209387,0,1,3
59720,5,3,209391,209391,209394,0,3,4
59721,4,2,209395,209395,209397,0,2,1
59722,5,2,209400,209400,209402,0,2,3
59723,1,3,209401,209402,209405,1,4,0
59724,5,3,209406,209406,209409,0,3,1
59725,3,3,209409,209409,209412,0,3,0
59726,3,1,209412,209412,209413,0,1,0
59727,3,3,209415,209415,209418,0,3,2
59728,1,3,209416,209418,209421,2,5,0
59729,3,3,209419,209421,209424,2,5,0
59730,6,1,209425,209425,209426,0,1,1
59731,2,3,209427,209427,209430,0,3,1
59732,5,1,209432,209432,209433,0,1,2
59733,3,3,209435,209435,209438,0,3,2
59734,4,1,209439,209439,209440,0,1,1
59735,6,1,209445,209445,209446,0,1,5
59736,2,2,209447,209447,209449,0,2,1
59737,2,1,209449,209449,209450,0,1,0
59738,4,2,209453,209453,209455,0,2,3
59739,5,1,209458,209458,209459,0,1,3
59740,6,2,209464,209464,209466,0,2,5
59741,2,3,209466,209466,209469,0,3,0
59742,1,2,209467,209469,209471,2,4,0
59743,1,2,209468,209471,209473,3,5,0
59744,5,1,209473,209473,209474,0,1,0
59745,3,1,209476,209476,209477,0,1,2
59746,1,2,209477,209477,209479,0,2,0
59747,4,1,209481,209481,209482,0,1,2
59748,6,3,209487,209487,209490,0,3,5
59749,1,2,209488,209490,209492,2,4,0
59750,3,1,209491,209492,209493,1,2,0
59751,2,2,209493,209493,209495,0,2,0
59752,2,2,209495,209495,209497,0,2,0
59753,2,2,209497,209497,209499,0,2,0
59754,2,2,209499,209499,209501,0,2,0
59755,3,3,209502,209502,209505,0,3,1
59756,1,1,209503,209505,209506,2,3,0
59757,4,3,209507,209507,209510,0,3,1
59758,6,3,209513,209513,209516,0,3,3
59759,5,1,209518,209518,209519,0,1,2
59760,1,3,209519,209519,209522,0,3,0
59761,5,1,209524,209524,209525,0,1,2
59762,4,2,209528,209528,209530,0,2,3
59763,2,1,209530,209530,209531,0,1,0
59764,5,3,209535,209535,209538,0,3,4
59765,1,3,209536,209538,209541,2,5,0
59766,4,3,209540,209541,209544,1,4,0
59767,5,3,209545,209545,209548,0,3,1
59768,2,3,209547,209548,209551,1,4,0
59769,4,3,209551,209551,209554,0,3,0
59770,5,2,209556,209556,209558,0,2,2
59771,5,3,209561,209561,209564,0,3,3
59772,2,3,209563,209564,209567,1,4,0
59773,1,3,209564,209567,209570,3,6,0
59774,4,1,209568,209570,209571,2,3,0
59775,4,3,209572,209572,209575,0,3,1
59776,2,1,209574,209575,209576,1,2,0
59777,3,3,209577,209577,209580,0,3,1
59778,5,1,209582,209582,209583,0,1,2
59779,5,2,209587,209587,209589,0,2,4
59780,6,1,209593,209593,209594,0,1,4
59781,3,2,209596,209596,209598,0,2,2
59782,6,1,209602,209602,209603,0,1,4
59783,5,2,209607,209607,209609,0,2,4
59784,4,2,209611,209611,209613,0,2,2
59785,5,3,209616,209616,209619,0,3,3
59786,4,2,209620,209620,209622,0,2,1
59787,4,1,209624,209624,209625,0,1,2
59788,6,2,209630,209630,209632,0,2,5
59789,2,2,209632,209632,209634,0,2,0
59790,2,2,209634,209634,209636,0,2,0
59791,3,1,209637,209637,209638,0,1,1
59792,3,1,209640,209640,209641,0,1,2
59793,2,1,209642,209642,209643,0,1,1
59794,2,1,209644,209644,209645,0,1,1
59795,1,1,209645,209645,209646,0,1,0
59796,1,1,209646,209646,209647,0,1,0
59797,4,2,209650,209650,209652,0,2,3
59798,3,1,209653,209653,209654,0,1,1
59799,6,3,209659,209659,209662,0,3,5
59800,1,2,209660,209662,209664,2,4,0
59801,3,2,209663,209664,209666,1,3,0
59802,4,3,209667,209667,209670,0,3,1
59803,5,1,209672,209672,209673,0,1,2
59804,2,2,209674,209674,209676,0,2,1
59805,5,3,209679,209679,209682,0,3,3
59806,1,2,209680,209682,209684,2,4,0
59807,2,2,209682,209684,209686,2,4,0
59808,3,3,209685,209686,209689,1,4,0
59809,6,2,209691,209691,209693,0,2,2
59810,2,2,209693,209693,209695,0,2,0
59811,4,2,209697,209697,209699,0,2,2
59812,3,1,209700,209700,209701,0,1,1
59813,1,2,209701,209701,209703,0,2,0
59814,4,1,209705,209705,209706,0,1,2
59815,6,2,209711,209711,209713,0,2,5
59816,2,3,209713,209713,209716,0,3,0
59817,1,3,209714,209716,209719,2,5,0
59818,3,1,209717,209719,209720,2,3,0
59819,3,1,209720,209720,209721,0,1,0
59820,1,1,209721,209721,209722,0,1,0
59821,6,1,209727,209727,209728,0,1,5
59822,5,1,209732,209732,209733,0,1,4
59823,5,3,209737,209737,209740,0,3,4
59824,1,1,209738,209740,209741,2,3,0
59825,5,2,209743,209743,209745,0,2,2
59826,2,1,209745,209745,209746,0,1,0
59827,1,3,209746,209746,209749,0,3,0
59828,6,1,209752,209752,209753,0,1,3
59829,4,3,209756,209756,209759,0,3,3
59830,5,3,209761,209761,209764,0,3,2
59831,3,2,209764,209764,209766,0,2,0
59832,2,1,209766,209766,209767,0,1,0
59833,2,3,209768,209768,209771,0,3,1
59834,2,2,209770,209771,209773,1,3,0
59835,5,3,209775,209775,209778,0,3,2
59836,6,3,209781,209781,209784,0,3,3
59837,1,1,209782,209784,209785,2,3,0
59838,2,1,209784,209785,209786,1,2,0
59839,6,2,209790,209790,209792,0,2,4
59840,5,1,209795,209795,209796,0,1,3
59841,2,1,209797,209797,209798,0,1,1
59842,1,2,209798,209798,209800,0,2,0
59843,1,3,209799,209800,209803,1,4,0
59844,4,3,209803,209803,209806,0,3,0
59845,2,3,209805,209806,209809,1,4,0
59846,1,2,209806,209809,209811,3,5,0
59847,5,3,209811,209811,209814,0,3,0
59848,5,2,209816,209816,209818,0,2,2
59849,5,1,209821,209821,209822,0,1,3
59850,1,2,209822,209822,209824,0,2,0
59851,3,3,209825,209825,209828,0,3,1
59852,2,3,209827,209828,209831,1,4,0
59853,6,1,209833,209833,209834,0,1,2
59854,3,1,209836,209836,209837,0,1,2
59855,5,1,209841,209841,209842,0,1,4
59856,1,3,209842,209842,209845,0,3,0
59857,3,2,209845,209845,209847,0,2,0
59858,5,3,209850,209850,209853,0,3,3
59859,1,3,209851,209853,209856,2,5,0
59860,4,1,209855,209856,209857,1,2,0
59861,5,2,209860,209860,209862,0,2,3
59862,6,1,209866,209866,209867,0,1,4
59863,6,2,209872,209872,209874,0,2,5
59864,6,1,209878,209878,209879,0,1,4
59865,5,2,209883,209883,209885,0,2,4
59866,2,3,209885,209885,209888,0,3,0
59867,3,1,209888,209888,209889,0,1,0
59868,5,2,209893,209893,209895,0,2,4
59869,2,2,209895,209895,209897,0,2,0
59870,4,3,209899,209899,209902,0,3,2
59871,4,2,209903,209903,209905,0,2,1
59872,6,1,209909,209909,209910,0,1,4
59873,2,3,209911,209911,209914,0,3,1
59874,6,1,209917,209917,209918,0,1,3
59875,6,1,209923,209923,209924,0,1,5
59876,3,2,209926,209926,209928,0,2,2
59877,3,3,209929,209929,209932,0,3,1
59878,2,3,209931,209932,209935,1,4,0
59879,5,3,209936,209936,209939,0,3,1
59880,1,3,209937,209939,209942,2,5,0
59881,4,1,209941,209942,209943,1,2,0
59882,1,3,209942,209943,209946,1,4,0
59883,1,2,209943,209946,209948,3,5,0
59884,3,1,209946,209948,209949,2,3,0
59885,3,2,209949,209949,209951,0,2,0
59886,2,2,209951,209951,209953,0,2,0
59887,5,1,209956,209956,209957,0,1,3
59888,4,3,209960,209960,209963,0,3,3
59889,6,3,209966,209966,209969,0,3,3
59890,6,1,209972,209972,209973,0,1,3
59891,5,3,209977,209977,209980,0,3,4
59892,2,1,209979,209980,209981,1,2,0
59893,2,2,209981,209981,209983,0,2,0
59894,1,3,209982,209983,209986,1,4,0
59895,6,2,209988,209988,209990,0,2,2
59896,4,2,209992,209992,209994,0,2,2
59897,1,2,209993,209994,209996,1,3,0
59898,2,2,209995,209996,209998,1,3,0
59899,1,2,209996,209998,210000,2,4,0
59900,4,3,210000,210000,210003,0,3,0
59901,2,2,210002,210003,210005,1,3,0
59902,6,3,210008,210008,210011,0,3,3
59903,6,2,210014,210014,210016,0,2,3
59904,4,3,210018,210018,210021,0,3,2
59905,4,2,210022,210022,210024,0,2,1
59906,3,2,210025,210025,210027,0,2,1
59907,2,3,210027,210027,210030,0,3,0
59908,4,3,210031,210031,210034,0,3,1
59909,6,2,210037,210037,210039,0,2,3
59910,2,2,210039,210039,210041,0,2,0
59911,5,1,210044,210044,210045,0,1,3
59912,5,3,210049,210049,210052,0,3,4
59913,5,1,210054,210054,210055,0,1,2
59914,3,1,210057,210057,210058,0,1,2
59915,3,1,210060,210060,210061,0,1,2
59916,1,2,210061,210061,210063,0,2,0
59917,5,3,210066,210066,210069,0,3,3
59918,5,2,210071,210071,210073,0,2,2
59919,3,3,210074,210074,210077,0,3,1
59920,6,2,210080,210080,210082,0,2,3
59921,4,1,210084,210084,210085,0,1,2
59922,2,1,210086,210086,210087,0,1,1
59923,1,3,210087,210087,210090,0,3,0
59924,4,2,210091,210091,210093,0,2,1
59925,2,1,210093,210093,210094,0,1,0
59926,1,1,210094,210094,210095,0,1,0
59927,5,3,210099,210099,210102,0,3,4
59928,4,1,210103,210103,210104,0,1,1
59929,6,2,210109,210109,210111,0,2,5
59930,2,2,210111,210111,210113,0,2,0
59931,5,1,210116,210116,210117,0,1,3
59932,3,3,210119,210119,210122,0,3,2
59933,6,2,210125,210125,210127,0,2,3
59934,3,3,210128,210128,210131,0,3,1
59935,4,3,210132,210132,210135,0,3,1
59936,4,3,210136,210136,210139,0,3,1
59937,5,3,210141,210141,210144,0,3,2
59938,4,1,210145,210145,210146,0,1,1
59939,3,1,210148,210148,210149,0,1,2
59940,2,2,210150,210150,210152,0,2,1
59941,3,3,210153,210153,210156,0,3,1
59942,2,1,210155,210156,210157,1,2,0
59943,3,2,210158,210158,210160,0,2,1
59944,3,2,210161,210161,210163,0,2,1
59945,1,3,210162,210163,210166,1,4,0
59946,3,2,210165,210166,210168,1,3,0
59947,4,1,210169,210169,210170,0,1,1
59948,5,2,210174,210174,210176,0,2,4
59949,1,2,210175,210176,210178,1,3,0
59950,2,3,210177,210178,210181,1,4,0
59951,6,3,210183,210183,210186,0,3,2
59952,3,3,210186,210186,210189,0,3,0
59953,4,2,210190,210190,210192,0,2,1
59954,3,1,210193,210193,210194,0,1,1
59955,4,1,210197,210197,210198,0,1,3
59956,5,3,210202,210202,210205,0,3,4
59957,4,2,210206,210206,210208,0,2,1
59958,6,3,210212,210212,210215,0,3,4
59959,5,1,210217,210217,210218,0,1,2
59960,1,1,210218,210218,210219,0,1,0
59961,2,1,210220,210220,210221,0,1,1
59962,6,1,210226,210226,210227,0,1,5
59963,6,1,210232,210232,210233,0,1,5
59964,5,2,210237,210237,210239,0,2,4
59965,4,1,210241,210241,210242,0,1,2
59966,6,1,210247,210247,210248,0,1,5
59967,6,2,210253,210253,210255,0,2,5
59968,5,2,210258,210258,210260,0,2,3
59969,4,3,210262,210262,210265,0,3,2
59970,3,2,210265,210265,210267,0,2,0
59971,2,3,210267,210267,210270,0,3,0
59972,6,3,210273,210273,210276,0,3,3
59973,6,3,210279,210279,210282,0,3,3
59974,3,2,210282,210282,210284,0,2,0
59975,1,3,210283,210284,210287,1,4,0
59976,1,2,210284,210287,210289,3,5,0
59977,3,3,210287,210289,210292,2,5,0
59978,1,3,210288,210292,210295,4,7,0
59979,6,3,210294,210295,210298,1,4,0
59980,4,3,210298,210298,210301,0,3,0
59981,4,1,210302,210302,210303,0,1,1
59982,2,3,210304,210304,210307,0,3,1
59983,1,2,210305,210307,210309,2,4,0
59984,6,3,210311,210311,210314,0,3,2
59985,2,1,210313,210314,210315,1,2,0
59986,5,3,210318,210318,210321,0,3,3
59987,2,1,210320,210321,210322,1,2,0
59988,5,3,210325,210325,210328,0,3,3
59989,6,2,210331,210331,210333,0,2,3
59990,1,1,210332,210333,210334,1,2,0
59991,4,2,210336,210336,210338,0,2,2
59992,6,1,210342,210342,210343,0,1,4
59993,6,2,210348,210348,210350,0,2,5
59994,6,2,210354,210354,210356,0,2,4
59995,3,3,210357,210357,210360,0,3,1
59996,5,2,210362,210362,210364,0,2,2
59997,1,3,210363,210364,210367,1,4,0
59998,4,2,210367,210367,210369,0,2,0
59999,2,1,210369,210369,210370,0,1,0
60000,4,3,210373,210373,210376,0,3,3
60001,2,1,210375,210376,210377,1,2,0
60002,3,1,210378,210378,210379,0,1,1
60003,6,2,210384,210384,210386,0,2,5
60004,4,3,210388,210388,210391,0,3,2
60005,6,2,210394,210394,210396,0,2,3
60006,1,1,210395,210396,210397,1,2,0
60007,1,2,210396,210397,210399,1,3,0
60008,1,3,210397,210399,210402,2,5,0
60009,4,1,210401,210402,210403,1,2,0
60010,5,3,210406,210406,210409,0,3,3
60011,5,1,210411,210411,210412,0,1,2
60012,1,1,210412,210412,210413,0,1,0
60013,1,1,210413,210413,210414,0,1,0
60014,6,1,210419,210419,210420,0,1,5
60015,4,1,210423,210423,210424,0,1,3
60016,2,3,210425,210425,210428,0,3,1
60017,6,1,210431,210431,210432,0,1,3
60018,2,1,210433,210433,210434,0,1,1
60019,2,3,210435,210435,210438,0,3,1
60020,2,3,210437,210438,210441,1,4,0
60021,3,2,210440,210441,210443,1,3,0
60022,2,2,210442,210443,210445,1,3,0
60023,2,3,210444,210445,210448,1,4,0
60024,1,2,210445,210448,210450,3,5,0
60025,6,2,210451,210451,210453,0,2,1
60026,3,3,210454,210454,210457,0,3,1
60027,3,2,210457,210457,210459,0,2,0
60028,5,1,210462,210462,210463,0,1,3
60029,6,1,210468,210468,210469,0,1,5
60030,4,1,210472,210472,210473,0,1,3
60031,6,3,210478,210478,210481,0,3,5
60032,2,3,210480,210481,210484,1,4,0
60033,2,1,210482,210484,210485,2,3,0
60034,4,3,210486,210486,210489,0,3,1
60035,3,2,210489,210489,210491,0,2,0
60036,3,3,210492,210492,210495,0,3,1
60037,4,1,210496,210496,210497,0,1,1
60038,2,1,210498,210498,210499,0,1,1
60039,6,3,210504,210504,210507,0,3,5
60040,5,3,210509,210509,210512,0,3,2
60041,5,3,210514,210514,210517,0,3,2
60042,3,2,210517,210517,210519,0,2,0
60043,5,2,210522,210522,210524,0,2,3
60044,2,1,210524,210524,210525,0,1,0
60045,4,2,210528,210528,210530,0,2,3
60046,5,3,210533,210533,210536,0,3,3
60047,3,1,210536,210536,210537,0,1,0
60048,4,1,210540,210540,210541,0,1,3
60049,5,2,210545,210545,210547,0,2,4
60050,5,2,210550,210550,210552,0,2,3
60051,4,3,210554,210554,210557,0,3,2
60052,6,1,210560,210560,210561,0,1,3
60053,6,3,210566,210566,210569,0,3,5
60054,5,3,210571,210571,210574,0,3,2
60055,5,3,210576,210576,210579,0,3,2
60056,6,1,210582,210582,210583,0,1,3
60057,4,1,210586,210586,210587,0,1,3
60058,1,1,210587,210587,210588,0,1,0
60059,6,2,210593,210593,210595,0,2,5
60060,5,3,210598,210598,210601,0,3,3
60061,1,1,210599,210601,210602,2,3,0
60062,2,2,210601,210602,210604,1,3,0
60063,5,2,210606,210606,210608,0,2,2
60064,2,1,210608,210608,210609,0,1,0
60065,2,2,210610,210610,210612,0,2,1
60066,1,1,210611,210612,210613,1,2,0
60067,2,3,210613,210613,210616,0,3,0
60068,1,3,210614,210616,210619,2,5,0
60069,5,3,210619,210619,210622,0,3,0
60070,3,2,210622,210622,210624,0,2,0
60071,2,2,210624,210624,210626,0,2,0
60072,5,1,210629,210629,210630,0,1,3
60073,4,2,210633,210633,210635,0,2,3
60074,2,3,210635,210635,210638,0,3,0
60075,2,2,210637,210638,210640,1,3,0
60076,4,2,210641,210641,210643,0,2,1
60077,6,2,210647,210647,210649,0,2,4
60078,2,2,210649,210649,210651,0,2,0
60079,3,1,210652,210652,210653,0,1,1
60080,2,1,210654,210654,210655,0,1,1
60081,5,3,210659,210659,210662,0,3,4
60082,1,1,210660,210662,210663,2,3,0
60083,4,3,210664,210664,210667,0,3,1
60084,3,2,210667,210667,210669,0,2,0
60085,3,3,210670,210670,210673,0,3,1
60086,1,1,210671,210673,210674,2,3,0
60087,6,1,210677,210677,210678,0,1,3
60088,6,2,210683,210683,210685,0,2,5
60089,3,3,210686,210686,210689,0,3,1
60090,2,2,210688,210689,210691,1,3,0
60091,3,2,210691,210691,210693,0,2,0
60092,3,2,210694,210694,210696,0,2,1
60093,6,1,210700,210700,210701,0,1,4
60094,5,2,210705,210705,210707,0,2,4
60095,3,2,210708,210708,210710,0,2,1
60096,5,1,210713,210713,210714,0,1,3
60097,4,1,210717,210717,210718,0,1,3
60098,6,2,210723,210723,210725,0,2,5
60099,3,2,210726,210726,210728,0,2,1
60100,1,2,210727,210728,210730,1,3,0
60101,6,2,210733,210733,210735,0,2,3
60102,4,3,210737,210737,210740,0,3,2
60103,4,3,210741,210741,210744,0,3,1
60104,2,1,210743,210744,210745,1,2,0
60105,6,2,210749,210749,210751,0,2,4
60106,3,2,210752,210752,210754,0,2,1
60107,4,1,210756,210756,210757,0,1,2
60108,6,1,210762,210762,210763,0,1,5
60109,4,1,210766,210766,210767,0,1,3
60110,2,1,210768,210768,210769,0,1,1
60111,4,3,210772,210772,210775,0,3,3
60112,3,3,210775,210775,210778,0,3,0
60113,4,3,210779,210779,210782,0,3,1
60114,6,1,210785,210785,210786,0,1,3
60115,4,1,210789,210789,210790,0,1,3
60116,1,3,210790,210790,210793,0,3,0
60117,6,3,210796,210796,210799,0,3,3
60118,3,1,210799,210799,210800,0,1,0
60119,2,1,210801,210801,210802,0,1,1
60120,5,2,210806,210806,210808,0,2,4
60121,3,3,210809,210809,210812,0,3,1
60122,6,1,210815,210815,210816,0,1,3
60123,5,1,210820,210820,210821,0,1,4
60124,3,2,210823,210823,210825,0,2,2
60125,6,1,210829,210829,210830,0,1,4
60126,5,3,210834,210834,210837,0,3,4
60127,2,1,210836,210837,210838,1,2,0
60128,1,1,210837,210838,210839,1,2,0
60129,1,1,210838,210839,210840,1,2,0
60130,4,3,210842,210842,210845,0,3,2
60131,4,3,210846,210846,210849,0,3,1
60132,6,2,210852,210852,210854,0,2,3
60133,2,1,210854,210854,210855,0,1,0
60134,4,2,210858,210858,210860,0,2,3
60135,3,3,210861,210861,210864,0,3,1
60136,5,3,210866,210866,210869,0,3,2
60137,5,1,210871,210871,210872,0,1,2
60138,4,3,210875,210875,210878,0,3,3
60139,2,1,210877,210878,210879,1,2,0
60140,4,3,210881,210881,210884,0,3,2
60141,4,2,210885,210885,210887,0,2,1
60142,1,2,210886,210887,210889,1,3,0
60143,5,2,210891,210891,210893,0,2,2
60144,5,2,210896,210896,210898,0,2,3
60145,6,1,210902,210902,210903,0,1,4
60146,6,3,210908,210908,210911,0,3,5
60147,1,2,210909,210911,210913,2,4,0
60148,3,2,210912,210913,210915,1,3,0
60149,3,1,210915,210915,210916,0,1,0
60150,3,1,210918,210918,210919,0,1,2
60151,6,2,210924,210924,210926,0,2,5
60152,3,3,210927,210927,210930,0,3,1
60153,5,1,210932,210932,210933,0,1,2
60154,3,3,210935,210935,210938,0,3,2
60155,6,1,210941,210941,210942,0,1,3
60156,4,1,210945,210945,210946,0,1,3
60157,1,1,210946,210946,210947,0,1,0
60158,4,3,210950,210950,210953,0,3,3
60159,4,2,210954,210954,210956,0,2,1
60160,1,2,210955,210956,210958,1,3,0
60161,3,3,210958,210958,210961,0,3,0
60162,3,1,210961,210961,210962,0,1,0
60163,4,3,210965,210965,210968,0,3,3
60164,2,1,210967,210968,210969,1,2,0
60165,2,3,210969,210969,210972,0,3,0
60166,6,2,210975,210975,210977,0,2,3
60167,1,2,210976,210977,210979,1,3,0
60168,3,3,210979,210979,210982,0,3,0
60169,3,3,210982,210982,210985,0,3,0
60170,4,3,210986,210986,210989,0,3,1
60171,4,3,210990,210990,210993,0,3,1
60172,1,1,210991,210993,210994,2,3,0
60173,6,3,210997,210997,211000,0,3,3
60174,5,3,211002,211002,211005,0,3,2
60175,4,2,211006,211006,211008,0,2,1
60176,1,3,211007,211008,211011,1,4,0
60177,2,1,211009,211011,211012,2,3,0
60178,2,3,211011,211012,211015,1,4,0
60179,3,3,211014,211015,211018,1,4,0
60180,3,1,211017,211018,211019,1,2,0
60181,5,2,211022,211022,211024,0,2,3
60182,4,1,211026,211026,211027,0,1,2
60183,1,3,211027,211027,211030,0,3,0
60184,6,3,211033,211033,211036,0,3,3
60185,3,2,211036,211036,211038,0,2,0
60186,2,1,211038,211038,211039,0,1,0
60187,5,2,211043,211043,211045,0,2,4
60188,4,3,211047,211047,211050,0,3,2
60189,1,1,211048,211050,211051,2,3,0
60190,3,1,211051,211051,211052,0,1,0
60191,2,3,211053,211053,211056,0,3,1
60192,2,1,211055,211056,211057,1,2,0
60193,6,1,211061,211061,211062,0,1,4
60194,3,2,211064,211064,211066,0,2,2
60195,4,2,211068,211068,211070,0,2,2
60196,6,1,211074,211074,211075,0,1,4
60197,3,2,211077,211077,211079,0,2,2
60198,4,3,211081,211081,211084,0,3,2
60199,1,2,211082,211084,211086,2,4,0
60200,2,1,211084,211086,211087,2,3,0
60201,5,1,211089,211089,211090,0,1,2
60202,6,3,211095,211095,211098,0,3,5
60203,4,1,211099,211099,211100,0,1,1
60204,6,3,211105,211105,211108,0,3,5
60205,6,1,211111,211111,211112,0,1,3
60206,5,3,211116,211116,211119,0,3,4
60207,4,3,211120,211120,211123,0,3,1
60208,5,3,211125,211125,211128,0,3,2
60209,5,3,211130,211130,211133,0,3,2
60210,5,2,211135,211135,211137,0,2,2
60211,2,3,211137,211137,211140,0,3,0
60212,6,2,211143,211143,211145,0,2,3
60213,3,1,211146,211146,211147,0,1,1
60214,5,3,211151,211151,211154,0,3,4
60215,1,1,211152,211154,211155,2,3,0
60216,6,1,211158,211158,211159,0,1,3
60217,5,2,211163,211163,211165,0,2,4
60218,6,2,211169,211169,211171,0,2,4
60219,1,2,211170,211171,211173,1,3,0
60220,3,1,211173,211173,211174,0,1,0
60221,4,3,211177,211177,211180,0,3,3
60222,1,2,211178,211180,211182,2,4,0
60223,3,2,211181,211182,211184,1,3,0
60224,4,2,211185,211185,211187,0,2,1
60225,2,2,211187,211187,211189,0,2,0
60226,4,3,211191,211191,211194,0,3,2
60227,2,2,211193,211194,211196,1,3,0
60228,4,1,211197,211197,211198,0,1,1
60229,3,2,211200,211200,211202,0,2,2
60230,3,2,211203,211203,211205,0,2,1
60231,5,3,211208,211208,211211,0,3,3
60232,6,2,211214,211214,211216,0,2,3
60233,6,3,211220,211220,211223,0,3,4
60234,5,2,211225,211225,211227,0,2,2
60235,2,2,211227,211227,211229,0,2,0
60236,4,1,211231,211231,211232,0,1,2
60237,6,2,211237,211237,211239,0,2,5
60238,3,1,211240,211240,211241,0,1,1
60239,3,1,211243,211243,211244,0,1,2
60240,2,2,211245,211245,211247,0,2,1
60241,4,2,211249,211249,211251,0,2,2
60242,6,1,211255,211255,211256,0,1,4
60243,4,1,211259,211259,211260,0,1,3
60244,5,1,211264,211264,211265,0,1,4
60245,2,2,211266,211266,211268,0,2,1
60246,6,3,211272,211272,211275,0,3,4
60247,2,2,211274,211275,211277,1,3,0
60248,3,2,211277,211277,211279,0,2,0
60249,5,1,211282,211282,211283,0,1,3
60250,6,2,211288,211288,211290,0,2,5
60251,3,2,211291,211291,211293,0,2,1
60252,3,3,211294,211294,211297,0,3,1
60253,4,1,211298,211298,211299,0,1,1
60254,6,3,211304,211304,211307,0,3,5
60255,2,1,211306,211307,211308,1,2,0
60256,3,1,211309,211309,211310,0,1,1
60257,6,1,211315,211315,211316,0,1,5
60258,2,1,211317,211317,211318,0,1,1
60259,4,3,211321,211321,211324,0,3,3
60260,3,1,211324,211324,211325,0,1,0
60261,3,1,211327,211327,211328,0,1,2
60262,1,1,211328,211328,211329,0,1,0
60263,2,2,211330,211330,211332,0,2,1
60264,2,3,211332,211332,211335,0,3,0
60265,2,1,211334,211335,211336,1,2,0
60266,6,2,211340,211340,211342,0,2,4
60267,3,2,211343,211343,211345,0,2,1
60268,2,3,211345,211345,211348,0,3,0
60269,2,1,211347,211348,211349,1,2,0
60270,1,2,211348,211349,211351,1,3,0
60271,3,2,211351,211351,211353,0,2,0
60272,5,2,211356,211356,211358,0,2,3
60273,6,1,211362,211362,211363,0,1,4
60274,5,3,211367,211367,211370,0,3,4
60275,4,3,211371,211371,211374,0,3,1
60276,3,1,211374,211374,211375,0,1,0
60277,4,1,211378,211378,211379,0,1,3
60278,1,2,211379,211379,211381,0,2,0
60279,4,2,211383,211383,211385,0,2,2
60280,3,2,211386,211386,211388,0,2,1
60281,3,1,211389,211389,211390,0,1,1
60282,4,3,211393,211393,211396,0,3,3
60283,2,1,211395,211396,211397,1,2,0
60284,1,3,211396,211397,211400,1,4,0
60285,2,3,211398,211400,211403,2,5,0
60286,3,1,211401,211403,211404,2,3,0
60287,2,1,211403,211404,211405,1,2,0
60288,5,3,211408,211408,211411,0,3,3
60289,6,2,211414,211414,211416,0,2,3
60290,2,3,211416,211416,211419,0,3,0
60291,1,3,211417,211419,211422,2,5,0
60292,3,1,211420,211422,211423,2,3,0
60293,3,3,211423,211423,211426,0,3,0
60294,5,1,211428,211428,211429,0,1,2
60295,6,3,211434,211434,211437,0,3,5
60296,3,3,211437,211437,211440,0,3,0
60297,1,2,211438,211440,211442,2,4,0
60298,1,2,211439,211442,211444,3,5,0
60299,6,3,211445,211445,211448,0,3,1
60300,3,2,211448,211448,211450,0,2,0
60301,1,2,211449,211450,211452,1,3,0
60302,2,3,211451,211452,211455,1,4,0
60303,2,2,211453,211455,211457,2,4,0
60304,6,3,211459,211459,211462,0,3,2
60305,2,2,211461,211462,211464,1,3,0
60306,3,2,211464,211464,211466,0,2,0
60307,3,1,211467,211467,211468,0,1,1
60308,6,3,211473,211473,211476,0,3,5
60309,5,3,211478,211478,211481,0,3,2
60310,6,1,211484,211484,211485,0,1,3
60311,5,2,211489,211489,211491,0,2,4
60312,1,3,211490,211491,211494,1,4,0
60313,1,2,211491,211494,211496,3,5,0
60314,2,3,211493,211496,211499,3,6,0
60315,3,3,211496,211499,211502,3,6,0
60316,5,3,211501,211502,211505,1,4,0
60317,3,3,211504,211505,211508,1,4,0
60318,3,1,211507,211508,211509,1,2,0
60319,3,1,211510,211510,211511,0,1,1
60320,2,2,211512,211512,211514,0,2,1
60321,2,1,211514,211514,211515,0,1,0
60322,2,2,211516,211516,211518,0,2,1
60323,6,2,211522,211522,211524,0,2,4
60324,6,3,211528,211528,211531,0,3,4
60325,3,2,211531,211531,211533,0,2,0
60326,3,2,211534,211534,211536,0,2,1
60327,3,3,211537,211537,211540,0,3,1
60328,1,2,211538,211540,211542,2,4,0
60329,3,2,211541,211542,211544,1,3,0
60330,1,2,211542,211544,211546,2,4,0
60331,2,2,211544,211546,211548,2,4,0
60332,2,3,211546,211548,211551,2,5,0
60333,6,1,211552,211552,211553,0,1,1
60334,6,2,211558,211558,211560,0,2,5
60335,6,1,211564,211564,211565,0,1,4
60336,1,3,211565,211565,211568,0,3,0
60337,5,2,211570,211570,211572,0,2,2
60338,3,3,211573,211573,211576,0,3,1
60339,2,1,211575,211576,211577,1,2,0
60340,6,1,211581,211581,211582,0,1,4
60341,4,3,211585,211585,211588,0,3,3
60342,6,2,211591,211591,211593,0,2,3
60343,6,3,211597,211597,211600,0,3,4
60344,2,2,211599,211600,211602,1,3,0
60345,4,3,211603,211603,211606,0,3,1
60346,2,2,211605,211606,211608,1,3,0
60347,3,3,211608,211608,211611,0,3,0
60348,2,3,211610,211611,211614,1,4,0
60349,5,2,211615,211615,211617,0,2,1
60350,2,3,211617,211617,211620,0,3,0
60351,1,2,211618,211620,211622,2,4,0
60352,4,3,211622,211622,211625,0,3,0
60353,3,1,211625,211625,211626,0,1,0
60354,2,1,211627,211627,211628,0,1,1
60355,4,1,211631,211631,211632,0,1,3
60356,2,1,211633,211633,211634,0,1,1
60357,3,2,211636,211636,211638,0,2,2
60358,6,3,211642,211642,211645,0,3,4
60359,4,1,211646,211646,211647,0,1,1
60360,3,2,211649,211649,211651,0,2,2
60361,1,3,211650,211651,211654,1,4,0
60362,1,2,211651,211654,211656,3,5,0
60363,4,2,211655,211656,211658,1,3,0
60364,6,2,211661,211661,211663,0,2,3
60365,5,2,211666,211666,211668,0,2,3
60366,1,3,211667,211668,211671,1,4,0
60367,5,2,211672,211672,211674,0,2,1
60368,2,3,211674,211674,211677,0,3,0
60369,5,1,211679,211679,211680,0,1,2
60370,5,1,211684,211684,211685,0,1,4
60371,1,3,211685,211685,211688,0,3,0
60372,1,2,211686,211688,211690,2,4,0
60373,2,2,211688,211690,211692,2,4,0
60374,3,3,211691,211692,211695,1,4,0
60375,4,3,211695,211695,211698,0,3,0
60376,1,1,211696,211698,211699,2,3,0
60377,2,1,211698,211699,211700,1,2,0
60378,6,3,211704,211704,211707,0,3,4
60379,6,1,211710,211710,211711,0,1,3
60380,6,1,211716,211716,211717,0,1,5
60381,3,3,211719,211719,211722,0,3,2
60382,5,1,211724,211724,211725,0,1,2
60383,3,1,211727,211727,211728,0,1,2
60384,6,1,211733,211733,211734,0,1,5
60385,3,2,211736,211736,211738,0,2,2
60386,4,1,211740,211740,211741,0,1,2
60387,6,2,211746,211746,211748,0,2,5
60388,5,2,211751,211751,211753,0,2,3
60389,5,1,211756,211756,211757,0,1,3
60390,3,1,211759,211759,211760,0,1,2
60391,4,1,211763,211763,211764,0,1,3
60392,3,3,211766,211766,211769,0,3,2
60393,1,3,211767,211769,211772,2,5,0
60394,3,1,211770,211772,211773,2,3,0
60395,3,3,211773,211773,211776,0,3,0
60396,6,3,211779,211779,211782,0,3,3
60397,3,3,211782,211782,211785,0,3,0
60398,3,1,211785,211785,211786,0,1,0
60399,6,3,211791,211791,211794,0,3,5
60400,1,2,211792,211794,211796,2,4,0
60401,5,1,211797,211797,211798,0,1,1
60402,4,1,211801,211801,211802,0,1,3
60403,4,1,211805,211805,211806,0,1,3
60404,1,1,211806,211806,211807,0,1,0
60405,1,2,211807,211807,211809,0,2,0
60406,3,2,211810,211810,211812,0,2,1
60407,1,1,211811,211812,211813,1,2,0
60408,6,3,211817,211817,211820,0,3,4
60409,2,1,211819,211820,211821,1,2,0
60410,1,3,211820,211821,211824,1,4,0
60411,3,2,211823,211824,211826,1,3,0
60412,2,2,211825,211826,211828,1,3,0
60413,4,3,211829,211829,211832,0,3,1
60414,3,2,211832,211832,211834,0,2,0
60415,3,2,211835,211835,211837,0,2,1
60416,2,3,211837,211837,211840,0,3,0
60417,1,1,211838,211840,211841,2,3,0
60418,3,2,211841,211841,211843,0,2,0
60419,2,1,211843,211843,211844,0,1,0
60420,5,3,211848,211848,211851,0,3,4
60421,6,1,211854,211854,211855,0,1,3
60422,1,3,211855,211855,211858,0,3,0
60423,3,3,211858,211858,211861,0,3,0
60424,4,1,211862,211862,211863,0,1,1
60425,4,2,211866,211866,211868,0,2,3
60426,5,3,211871,211871,211874,0,3,3
60427,5,1,211876,211876,211877,0,1,2
60428,5,1,211881,211881,211882,0,1,4
60429,2,2,211883,211883,211885,0,2,1
60430,4,3,211887,211887,211890,0,3,2
60431,6,1,211893,211893,211894,0,1,3
60432,3,2,211896,211896,211898,0,2,2
60433,6,3,211902,211902,211905,0,3,4
60434,6,1,211908,211908,211909,0,1,3
60435,2,1,211910,211910,211911,0,1,1
60436,4,2,211914,211914,211916,0,2,3
60437,6,1,211920,211920,211921,0,1,4
60438,3,1,211923,211923,211924,0,1,2
60439,6,3,211929,211929,211932,0,3,5
60440,5,3,211934,211934,211937,0,3,2
60441,3,2,211937,211937,211939,0,2,0
60442,1,1,211938,211939,211940,1,2,0
60443,5,2,211943,211943,211945,0,2,3
60444,3,2,211946,211946,211948,0,2,1
60445,4,2,211950,211950,211952,0,2,2
60446,1,3,211951,211952,211955,1,4,0
60447,2,1,211953,211955,211956,2,3,0
60448,2,1,211955,211956,211957,1,2,0
60449,6,1,211961,211961,211962,0,1,4
60450,6,1,211967,211967,211968,0,1,5
60451,6,3,211973,211973,211976,0,3,5
60452,2,2,211975,211976,211978,1,3,0
60453,3,3,211978,211978,211981,0,3,0
60454,2,2,211980,211981,211983,1,3,0
60455,1,3,211981,211983,211986,2,5,0
60456,2,1,211983,211986,211987,3,4,0
60457,6,2,211989,211989,211991,0,2,2
60458,6,3,211995,211995,211998,0,3,4
60459,6,1,212001,212001,212002,0,1,3
60460,4,1,212005,212005,212006,0,1,3
60461,6,3,212011,212011,212014,0,3,5
60462,4,2,212015,212015,212017,0,2,1
60463,3,2,212018,212018,212020,0,2,1
60464,1,2,212019,212020,212022,1,3,0
60465,5,3,212024,212024,212027,0,3,2
60466,4,3,212028,212028,212031,0,3,1
60467,3,3,212031,212031,212034,0,3,0
60468,2,1,212033,212034,212035,1,2,0
60469,2,2,212035,212035,212037,0,2,0
60470,3,1,212038,212038,212039,0,1,1
60471,5,3,212043,212043,212046,0,3,4
60472,2,1,212045,212046,212047,1,2,0
60473,6,2,212051,212051,212053,0,2,4
60474,3,1,212054,212054,212055,0,1,1
60475,4,3,212058,212058,212061,0,3,3
60476,3,2,212061,212061,212063,0,2,0
60477,5,2,212066,212066,212068,0,2,3
60478,6,2,212072,212072,212074,0,2,4
60479,6,1,212078,212078,212079,0,1,4
60480,5,2,212083,212083,212085,0,2,4
60481,5,3,212088,212088,212091,0,3,3
60482,3,1,212091,212091,212092,0,1,0
60483,5,3,212096,212096,212099,0,3,4
60484,4,2,212100,212100,212102,0,2,1
60485,3,3,212103,212103,212106,0,3,1
60486,3,1,212106,212106,212107,0,1,0
60487,6,1,212112,212112,212113,0,1,5
60488,6,1,212118,212118,212119,0,1,5
60489,2,2,212120,212120,212122,0,2,1
60490,5,3,212125,212125,212128,0,3,3
60491,5,1,212130,212130,212131,0,1,2
60492,4,2,212134,212134,212136,0,2,3
60493,6,2,212140,212140,212142,0,2,4
60494,3,3,212143,212143,212146,0,3,1
60495,3,3,212146,212146,212149,0,3,0
60496,2,3,212148,212149,212152,1,4,0
60497,5,3,212153,212153,212156,0,3,1
60498,3,1,212156,212156,212157,0,1,0
60499,3,1,212159,212159,212160,0,1,2
60500,6,1,212165,212165,212166,0,1,5
60501,4,3,212169,212169,212172,0,3,3
60502,1,2,212170,212172,212174,2,4,0
60503,1,3,212171,212174,212177,3,6,0
60504,4,2,212175,212177,212179,2,4,0
60505,6,1,212181,212181,212182,0,1,2
60506,5,2,212186,212186,212188,0,2,4
60507,3,2,212189,212189,212191,0,2,1
60508,6,2,212195,212195,212197,0,2,4
60509,3,2,212198,212198,212200,0,2,1
60510,2,3,212200,212200,212203,0,3,0
60511,1,3,212201,212203,212206,2,5,0
60512,6,3,212207,212207,212210,0,3,1
60513,2,3,212209,212210,212213,1,4,0
60514,4,1,212213,212213,212214,0,1,0
60515,5,2,212218,212218,212220,0,2,4
60516,6,2,212224,212224,212226,0,2,4
60517,1,3,212225,212226,212229,1,4,0
60518,5,3,212230,212230,212233,0,3,1
60519,3,2,212233,212233,212235,0,2,0
60520,5,1,212238,212238,212239,0,1,3
60521,4,3,212242,212242,212245,0,3,3
60522,2,3,212244,212245,212248,1,4,0
60523,3,3,212247,212248,212251,1,4,0
60524,4,3,212251,212251,212254,0,3,0
60525,4,3,212255,212255,212258,0,3,1
60526,2,3,212257,212258,212261,1,4,0
60527,5,3,212262,212262,212265,0,3,1
60528,3,3,212265,212265,212268,0,3,0
60529,3,1,212268,212268,212269,0,1,0
60530,4,3,212272,212272,212275,0,3,3
60531,2,3,212274,212275,212278,1,4,0
60532,5,2,212279,212279,212281,0,2,1
60533,2,3,212281,212281,212284,0,3,0
60534,1,1,212282,212284,212285,2,3,0
60535,6,3,212288,212288,212291,0,3,3
60536,2,2,212290,212291,212293,1,3,0
60537,6,2,212296,212296,212298,0,2,3
60538,2,2,212298,212298,212300,0,2,0
60539,2,2,212300,212300,212302,0,2,0
60540,5,2,212305,212305,212307,0,2,3
60541,4,2,212309,212309,212311,0,2,2
60542,1,1,212310,212311,212312,1,2,0
60543,4,3,212314,212314,212317,0,3,2
60544,4,2,212318,212318,212320,0,2,1
60545,3,1,212321,212321,212322,0,1,1
60546,6,2,212327,212327,212329,0,2,5
60547,6,2,212333,212333,212335,0,2,4
60548,4,1,212337,212337,212338,0,1,2
60549,1,3,212338,212338,212341,0,3,0
60550,6,3,212344,212344,212347,0,3,3
60551,5,3,212349,212349,212352,0,3,2
60552,4,3,212353,212353,212356,0,3,1
60553,2,1,212355,212356,212357,1,2,0
60554,5,2,212360,212360,212362,0,2,3
60555,6,1,212366,212366,212367,0,1,4
60556,3,3,212369,212369,212372,0,3,2
60557,3,2,212372,212372,212374,0,2,0
60558,1,3,212373,212374,212377,1,4,0
60559,6,2,212379,212379,212381,0,2,2
60560,5,1,212384,212384,212385,0,1,3
60561,4,1,212388,212388,212389,0,1,3
60562,5,2,212393,212393,212395,0,2,4
60563,4,2,212397,212397,212399,0,2,2
60564,6,2,212403,212403,212405,0,2,4
60565,2,1,212405,212405,212406,0,1,0
60566,4,1,212409,212409,212410,0,1,3
60567,5,1,212414,212414,212415,0,1,4
60568,4,1,212418,212418,212419,0,1,3
60569,2,1,212420,212420,212421,0,1,1
60570,4,3,212424,212424,212427,0,3,3
60571,3,3,212427,212427,212430,0,3,0
60572,1,3,212428,212430,212433,2,5,0
60573,1,1,212429,212433,212434,4,5,0
60574,4,3,212433,212434,212437,1,4,0
60575,5,3,212438,212438,212441,0,3,1
60576,4,1,212442,212442,212443,0,1,1
60577,4,1,212446,212446,212447,0,1,3
60578,1,2,212447,212447,212449,0,2,0
60579,4,2,212451,212451,212453,0,2,2
60580,2,1,212453,212453,212454,0,1,0
60581,3,2,212456,212456,212458,0,2,2
60582,3,1,212459,212459,212460,0,1,1
60583,1,1,212460,212460,212461,0,1,0
60584,5,1,212465,212465,212466,0,1,4
60585,4,1,212469,212469,212470,0,1,3
60586,4,1,212473,212473,212474,0,1,3
60587,2,3,212475,212475,212478,0,3,1
60588,2,3,212477,212478,212481,1,4,0
60589,4,3,212481,212481,212484,0,3,0
60590,2,3,212483,212484,212487,1,4,0
60591,3,3,212486,212487,212490,1,4,0
60592,5,2,212491,212491,212493,0,2,1
60593,3,3,212494,212494,212497,0,3,1
60594,3,2,212497,212497,212499,0,2,0
60595,4,2,212501,212501,212503,0,2,2
60596,3,3,212504,212504,212507,0,3,1
60597,1,3,212505,212507,212510,2,5,0
60598,1,2,212506,212510,212512,4,6,0
60599,1,3,212507,212512,212515,5,8,0
60600,6,1,212513,212515,212516,2,3,0
60601,1,3,212514,212516,212519,2,5,0
60602,3,1,212517,212519,212520,2,3,0
60603,2,2,212519,212520,212522,1,3,0
60604,1,3,212520,212522,212525,2,5,0
60605,6,2,212526,212526,212528,0,2,1
60606,3,3,212529,212529,212532,0,3,1
60607,2,3,212531,212532,212535,1,4,0
60608,2,2,212533,212535,212537,2,4,0
60609,2,3,212535,212537,212540,2,5,0
60610,3,2,212538,212540,212542,2,4,0
60611,1,3,212539,212542,212545,3,6,0
60612,6,3,212545,212545,212548,0,3,0
60613,2,2,212547,212548,212550,1,3,0
60614,3,2,212550,212550,212552,0,2,0
60615,4,1,212554,212554,212555,0,1,2
60616,6,2,212560,212560,212562,0,2,5
60617,3,1,212563,212563,212564,0,1,1
60618,6,3,212569,212569,212572,0,3,5
60619,6,3,212575,212575,212578,0,3,3
60620,3,1,212578,212578,212579,0,1,0
60621,5,2,212583,212583,212585,0,2,4
60622,3,1,212586,212586,212587,0,1,1
60623,4,3,212590,212590,212593,0,3,3
60624,5,3,212595,212595,212598,0,3,2
60625,6,2,212601,212601,212603,0,2,3
60626,5,1,212606,212606,212607,0,1,3
60627,3,3,212609,212609,212612,0,3,2
60628,1,3,212610,212612,212615,2,5,0
60629,4,2,212614,212615,212617,1,3,0
60630,5,1,212619,212619,212620,0,1,2
60631,3,2,212622,212622,212624,0,2,2
60632,4,2,212626,212626,212628,0,2,2
60633,6,2,212632,212632,212634,0,2,4
60634,6,3,212638,212638,212641,0,3,4
60635,1,2,212639,212641,212643,2,4,0
60636,5,3,212644,212644,212647,0,3,1
60637,6,2,212650,212650,212652,0,2,3
60638,4,1,212654,212654,212655,0,1,2
60639,4,1,212658,212658,212659,0,1,3
60640,1,2,212659,212659,212661,0,2,0
60641,1,3,212660,212661,212664,1,4,0
60642,2,3,212662,212664,212667,2,5,0
60643,2,2,212664,212667,212669,3,5,0
60644,6,3,212670,212670,212673,0,3,1
60645,5,2,212675,212675,212677,0,2,2
60646,2,1,212677,212677,212678,0,1,0
60647,6,2,212683,212683,212685,0,2,5
60648,5,3,212688,212688,212691,0,3,3
60649,6,2,212694,212694,212696,0,2,3
60650,6,3,212700,212700,212703,0,3,4
60651,4,3,212704,212704,212707,0,3,1
60652,4,2,212708,212708,212710,0,2,1
60653,6,3,212714,212714,212717,0,3,4
60654,6,3,212720,212720,212723,0,3,3
60655,4,3,212724,212724,212727,0,3,1
60656,6,3,212730,212730,212733,0,3,3
60657,5,3,212735,212735,212738,0,3,2
60658,6,1,212741,212741,212742,0,1,3
60659,3,3,212744,212744,212747,0,3,2
60660,6,1,212750,212750,212751,0,1,3
60661,2,1,212752,212752,212753,0,1,1
60662,4,3,212756,212756,212759,0,3,3
60663,3,2,212759,212759,212761,0,2,0
60664,4,2,212763,212763,212765,0,2,2
60665,3,3,212766,212766,212769,0,3,1
60666,2,2,212768,212769,212771,1,3,0
60667,1,2,212769,212771,212773,2,4,0
60668,5,1,212774,212774,212775,0,1,1
60669,1,2,212775,212775,212777,0,2,0
60670,4,1,212779,212779,212780,0,1,2
60671,4,2,212783,212783,212785,0,2,3
60672,4,2,212787,212787,212789,0,2,2
60673,6,3,212793,212793,212796,0,3,4
60674,4,2,212797,212797,212799,0,2,1
60675,5,3,212802,212802,212805,0,3,3
60676,2,3,212804,212805,212808,1,4,0
60677,2,1,212806,212808,212809,2,3,0
60678,1,1,212807,212809,212810,2,3,0
60679,3,3,212810,212810,212813,0,3,0
60680,1,2,212811,212813,212815,2,4,0
60681,1,1,212812,212815,212816,3,4,0
60682,3,3,212815,212816,212819,1,4,0
60683,6,1,212821,212821,212822,0,1,2
60684,3,2,212824,212824,212826,0,2,2
60685,2,2,212826,212826,212828,0,2,0
60686,1,3,212827,212828,212831,1,4,0
60687,4,2,212831,212831,212833,0,2,0
60688,5,2,212836,212836,212838,0,2,3
60689,4,3,212840,212840,212843,0,3,2
60690,6,3,212846,212846,212849,0,3,3
60691,5,1,212851,212851,212852,0,1,2
60692,3,3,212854,212854,212857,0,3,2
60693,2,3,212856,212857,212860,1,4,0
60694,3,1,212859,212860,212861,1,2,0
60695,4,3,212863,212863,212866,0,3,2
60696,1,1,212864,212866,212867,2,3,0
60697,2,2,212866,212867,212869,1,3,0
60698,1,1,212867,212869,212870,2,3,0
60699,3,3,212870,212870,212873,0,3,0
60700,3,2,212873,212873,212875,0,2,0
60701,2,1,212875,212875,212876,0,1,0
60702,3,2,212878,212878,212880,0,2,2
60703,5,2,212883,212883,212885,0,2,3
60704,5,2,212888,212888,212890,0,2,3
60705,2,3,212890,212890,212893,0,3,0
60706,5,3,212895,212895,212898,0,3,2
60707,4,3,212899,212899,212902,0,3,1
60708,6,2,212905,212905,212907,0,2,3
60709,1,3,212906,212907,212910,1,4,0
60710,5,2,212911,212911,212913,0,2,1
60711,2,1,212913,212913,212914,0,1,0
60712,5,2,212918,212918,212920,0,2,4
60713,6,3,212924,212924,212927,0,3,4
60714,3,1,212927,212927,212928,0,1,0
60715,4,3,212931,212931,212934,0,3,3
60716,4,1,212935,212935,212936,0,1,1
60717,5,3,212940,212940,212943,0,3,4
60718,2,2,212942,212943,212945,1,3,0
60719,6,1,212948,212948,212949,0,1,3
60720,4,3,212952,212952,212955,0,3,3
60721,2,3,212954,212955,212958,1,4,0
60722,4,2,212958,212958,212960,0,2,0
60723,6,1,212964,212964,212965,0,1,4
60724,5,2,212969,212969,212971,0,2,4
60725,5,1,212974,212974,212975,0,1,3
60726,4,3,212978,212978,212981,0,3,3
60727,6,1,212984,212984,212985,0,1,3
60728,1,2,212985,212985,212987,0,2,0
60729,2,1,212987,212987,212988,0,1,0
60730,1,1,212988,212988,212989,0,1,0
60731,4,1,212992,212992,212993,0,1,3
60732,1,1,212993,212993,212994,0,1,0
60733,1,2,212994,212994,212996,0,2,0
60734,2,1,212996,212996,212997,0,1,0
60735,4,1,213000,213000,213001,0,1,3
60736,6,3,213006,213006,213009,0,3,5
60737,6,1,213012,213012,213013,0,1,3
60738,4,3,213016,213016,213019,0,3,3
60739,6,3,213022,213022,213025,0,3,3
60740,2,3,213024,213025,213028,1,4,0
60741,3,1,213027,213028,213029,1,2,0
60742,3,2,213030,213030,213032,0,2,1
60743,5,2,213035,213035,213037,0,2,3
60744,5,3,213040,213040,213043,0,3,3
60745,2,1,213042,213043,213044,1,2,0
60746,1,2,213043,213044,213046,1,3,0
60747,6,1,213049,213049,213050,0,1,3
60748,3,3,213052,213052,213055,0,3,2
60749,3,3,213055,213055,213058,0,3,0
60750,4,3,213059,213059,213062,0,3,1
60751,2,3,213061,213062,213065,1,4,0
60752,1,1,213062,213065,213066,3,4,0
60753,1,1,213063,213066,213067,3,4,0
60754,4,2,213067,213067,213069,0,2,0
60755,5,3,213072,213072,213075,0,3,3
60756,4,3,213076,213076,213079,0,3,1
60757,4,2,213080,213080,213082,0,2,1
60758,5,3,213085,213085,213088,0,3,3
60759,4,3,213089,213089,213092,0,3,1
60760,4,2,213093,213093,213095,0,2,1
60761,2,1,213095,213095,213096,0,1,0
60762,3,3,213098,213098,213101,0,3,2
60763,6,2,213104,213104,213106,0,2,3
60764,2,3,213106,213106,213109,0,3,0
60765,2,2,213108,213109,213111,1,3,0
60766,4,3,213112,213112,213115,0,3,1
60767,4,2,213116,213116,213118,0,2,1
60768,3,3,213119,213119,213122,0,3,1
60769,2,3,213121,213122,213125,1,4,0
60770,5,2,213126,213126,213128,0,2,1
60771,4,1,213130,213130,213131,0,1,2
60772,6,1,213136,213136,213137,0,1,5
60773,6,1,213142,213142,213143,0,1,5
60774,6,1,213148,213148,213149,0,1,5
60775,4,1,213152,213152,213153,0,1,3
60776,5,2,213157,213157,213159,0,2,4
60777,5,3,213162,213162,213165,0,3,3
60778,4,1,213166,213166,213167,0,1,1
60779,4,2,213170,213170,213172,0,2,3
60780,6,2,213176,213176,213178,0,2,4
60781,2,2,213178,213178,213180,0,2,0
60782,2,3,213180,213180,213183,0,3,0
60783,3,2,213183,213183,213185,0,2,0
60784,5,2,213188,213188,213190,0,2,3
60785,2,3,213190,213190,213193,0,3,0
60786,1,1,213191,213193,213194,2,3,0
60787,2,1,213193,213194,213195,1,2,0
60788,6,3,213199,213199,213202,0,3,4
60789,2,3,213201,213202,213205,1,4,0
60790,6,2,213207,213207,213209,0,2,2
60791,6,3,213213,213213,213216,0,3,4
60792,3,1,213216,213216,213217,0,1,0
60793,4,3,213220,213220,213223,0,3,3
60794,4,1,213224,213224,213225,0,1,1
60795,2,3,213226,213226,213229,0,3,1
60796,3,2,213229,213229,213231,0,2,0
60797,5,2,213234,213234,213236,0,2,3
60798,4,1,213238,213238,213239,0,1,2
60799,6,2,213244,213244,213246,0,2,5
60800,4,1,213248,213248,213249,0,1,2
60801,3,2,213251,213251,213253,0,2,2
60802,4,2,213255,213255,213257,0,2,2
60803,4,3,213259,213259,213262,0,3,2
60804,5,1,213264,213264,213265,0,1,2
60805,6,2,213270,213270,213272,0,2,5
60806,4,2,213274,213274,213276,0,2,2
60807,3,2,213277,213277,213279,0,2,1
60808,5,2,213282,213282,213284,0,2,3
60809,2,1,213284,213284,213285,0,1,0
60810,5,2,213289,213289,213291,0,2,4
60811,3,3,213292,213292,213295,0,3,1
60812,5,1,213297,213297,213298,0,1,2
60813,1,2,213298,213298,213300,0,2,0
60814,4,1,213302,213302,213303,0,1,2
60815,3,3,213305,213305,213308,0,3,2
60816,4,1,213309,213309,213310,0,1,1
60817,4,1,213313,213313,213314,0,1,3
60818,1,3,213314,213314,213317,0,3,0
60819,3,2,213317,213317,213319,0,2,0
60820,3,1,213320,213320,213321,0,1,1
60821,2,1,213322,213322,213323,0,1,1
60822,2,2,213324,213324,213326,0,2,1
60823,4,3,213328,213328,213331,0,3,2
60824,3,2,213331,213331,213333,0,2,0
60825,3,3,213334,213334,213337,0,3,1
60826,5,2,213339,213339,213341,0,2,2
60827,3,2,213342,213342,213344,0,2,1
60828,3,3,213345,213345,213348,0,3,1
60829,5,2,213350,213350,213352,0,2,2
60830,2,2,213352,213352,213354,0,2,0
60831,6,1,213358,213358,213359,0,1,4
60832,1,2,213359,213359,213361,0,2,0
60833,2,3,213361,213361,213364,0,3,0
60834,4,2,213365,213365,213367,0,2,1
60835,2,3,213367,213367,213370,0,3,0
60836,2,3,213369,213370,213373,1,4,0
60837,2,2,213371,213373,213375,2,4,0
60838,5,3,213376,213376,213379,0,3,1
60839,1,2,213377,213379,213381,2,4,0
60840,3,1,213380,213381,213382,1,2,0
60841,2,2,213382,213382,213384,0,2,0
60842,4,3,213386,213386,213389,0,3,2
60843,5,3,213391,213391,213394,0,3,2
60844,2,2,213393,213394,213396,1,3,0
60845,1,1,213394,213396,213397,2,3,0
60846,5,1,213399,213399,213400,0,1,2
60847,1,1,213400,213400,213401,0,1,0
60848,2,1,213402,213402,213403,0,1,1
60849,1,2,213403,213403,213405,0,2,0
60850,1,1,213404,213405,213406,1,2,0
60851,3,2,213407,213407,213409,0,2,1
60852,6,1,213413,213413,213414,0,1,4
60853,5,3,213418,213418,213421,0,3,4
60854,1,3,213419,213421,213424,2,5,0
60855,3,3,213422,213424,213427,2,5,0
60856,2,3,213424,213427,213430,3,6,0
60857,6,2,213430,213430,213432,0,2,0
60858,5,2,213435,213435,213437,0,2,3
60859,3,3,213438,213438,213441,0,3,1
60860,6,2,213444,213444,213446,0,2,3
60861,4,1,213448,213448,213449,0,1,2
60862,1,2,213449,213449,213451,0,2,0
60863,3,2,213452,213452,213454,0,2,1
60864,6,3,213458,213458,213461,0,3,4
60865,1,3,213459,213461,213464,2,5,0
60866,6,2,213465,213465,213467,0,2,1
60867,5,1,213470,213470,213471,0,1,3
60868,4,3,213474,213474,213477,0,3,3
60869,2,1,213476,213477,213478,1,2,0
60870,3,2,213479,213479,213481,0,2,1
60871,4,2,213483,213483,213485,0,2,2
60872,6,2,213489,213489,213491,0,2,4
60873,5,2,213494,213494,213496,0,2,3
60874,5,2,213499,213499,213501,0,2,3
60875,6,2,213505,213505,213507,0,2,4
60876,4,1,213509,213509,213510,0,1,2
60877,4,1,213513,213513,213514,0,1,3
60878,2,3,213515,213515,213518,0,3,1
60879,3,1,213518,213518,213519,0,1,0
60880,4,2,213522,213522,213524,0,2,3
60881,1,1,213523,213524,213525,1,2,0
60882,4,3,213527,213527,213530,0,3,2
60883,3,2,213530,213530,213532,0,2,0
60884,1,3,213531,213532,213535,1,4,0
60885,4,3,213535,213535,213538,0,3,0
60886,2,1,213537,213538,213539,1,2,0
60887,5,2,213542,213542,213544,0,2,3
60888,3,1,213545,213545,213546,0,1,1
60889,6,2,213551,213551,213553,0,2,5
60890,2,1,213553,213553,213554,0,1,0
60891,3,1,213556,213556,213557,0,1,2
60892,3,3,213559,213559,213562,0,3,2
60893,6,2,213565,213565,213567,0,2,3
60894,3,1,213568,213568,213569,0,1,1
60895,3,3,213571,213571,213574,0,3,2
60896,5,2,213576,213576,213578,0,2,2
60897,6,3,213582,213582,213585,0,3,4
60898,5,2,213587,213587,213589,0,2,2
60899,1,2,213588,213589,213591,1,3,0
60900,5,1,213593,213593,213594,0,1,2
60901,1,2,213594,213594,213596,0,2,0
60902,4,1,213598,213598,213599,0,1,2
60903,5,3,213603,213603,213606,0,3,4
60904,6,3,213609,213609,213612,0,3,3
60905,4,2,213613,213613,213615,0,2,1
60906,4,1,213617,213617,213618,0,1,2
60907,3,2,213620,213620,213622,0,2,2
60908,5,2,213625,213625,213627,0,2,3
60909,4,3,213629,213629,213632,0,3,2
60910,6,2,213635,213635,213637,0,2,3
60911,5,2,213640,213640,213642,0,2,3
60912,1,2,213641,213642,213644,1,3,0
60913,4,1,213645,213645,213646,0,1,1
60914,3,3,213648,213648,213651,0,3,2
60915,5,2,213653,213653,213655,0,2,2
60916,3,1,213656,213656,213657,0,1,1
60917,3,2,213659,213659,213661,0,2,2
60918,4,2,213663,213663,213665,0,2,2
60919,4,2,213667,213667,213669,0,2,2
60920,5,2,213672,213672,213674,0,2,3
60921,1,3,213673,213674,213677,1,4,0
60922,5,2,213678,213678,213680,0,2,1
60923,2,2,213680,213680,213682,0,2,0
60924,1,2,213681,213682,213684,1,3,0
60925,1,3,213682,213684,213687,2,5,0
60926,6,2,213688,213688,213690,0,2,1
60927,6,3,213694,213694,213697,0,3,4
60928,4,1,213698,213698,213699,0,1,1
60929,1,1,213699,213699,213700,0,1,0
60930,5,3,213704,213704,213707,0,3,4
60931,6,3,213710,213710,213713,0,3,3
60932,6,3,213716,213716,213719,0,3,3
60933,6,2,213722,213722,213724,0,2,3
60934,6,2,213728,213728,213730,0,2,4
60935,3,1,213731,213731,213732,0,1,1
60936,1,2,213732,213732,213734,0,2,0
60937,3,2,213735,213735,213737,0,2,1
60938,6,3,213741,213741,213744,0,3,4
60939,4,3,213745,213745,213748,0,3,1
60940,6,1,213751,213751,213752,0,1,3
60941,5,2,213756,213756,213758,0,2,4
60942,1,1,213757,213758,213759,1,2,0
60943,6,3,213763,213763,213766,0,3,4
60944,4,2,213767,213767,213769,0,2,1
60945,5,2,213772,213772,213774,0,2,3
60946,2,3,213774,213774,213777,0,3,0
60947,5,2,213779,213779,213781,0,2,2
60948,1,2,213780,213781,213783,1,3,0
60949,6,3,213786,213786,213789,0,3,3
60950,1,2,213787,213789,213791,2,4,0
60951,2,1,213789,213791,213792,2,3,0
60952,6,3,213795,213795,213798,0,3,3
60953,2,1,213797,213798,213799,1,2,0
60954,3,1,213800,213800,213801,0,1,1
60955,2,1,213802,213802,213803,0,1,1
60956,4,1,213806,213806,213807,0,1,3
60957,2,2,213808,213808,213810,0,2,1
60958,1,3,213809,213810,213813,1,4,0
60959,4,3,213813,213813,213816,0,3,0
60960,4,3,213817,213817,213820,0,3,1
60961,5,3,213822,213822,213825,0,3,2
60962,6,1,213828,213828,213829,0,1,3
60963,1,3,213829,213829,213832,0,3,0
60964,5,3,213834,213834,213837,0,3,2
60965,4,2,213838,213838,213840,0,2,1
60966,1,3,213839,213840,213843,1,4,0
60967,5,2,213844,213844,213846,0,2,1
60968,5,2,213849,213849,213851,0,2,3
60969,1,2,213850,213851,213853,1,3,0
60970,4,1,213854,213854,213855,0,1,1
60971,2,1,213856,213856,213857,0,1,1
60972,5,3,213861,213861,213864,0,3,4
60973,1,2,213862,213864,213866,2,4,0
60974,3,1,213865,213866,213867,1,2,0
60975,3,1,213868,213868,213869,0,1,1
60976,4,1,213872,213872,213873,0,1,3
60977,6,1,213878,213878,213879,0,1,5
60978,2,1,213880,213880,213881,0,1,1
60979,2,2,213882,213882,213884,0,2,1
60980,3,1,213885,213885,213886,0,1,1
60981,6,1,213891,213891,213892,0,1,5
60982,2,1,213893,213893,213894,0,1,1
60983,5,1,213898,213898,213899,0,1,4
60984,6,3,213904,213904,213907,0,3,5
60985,1,1,213905,213907,213908,2,3,0
60986,3,3,213908,213908,213911,0,3,0
60987,2,2,213910,213911,213913,1,3,0
60988,6,2,213916,213916,213918,0,2,3
60989,5,3,213921,213921,213924,0,3,3
60990,1,1,213922,213924,213925,2,3,0
60991,4,2,213926,213926,213928,0,2,1
60992,5,2,213931,213931,213933,0,2,3
60993,5,3,213936,213936,213939,0,3,3
60994,4,3,213940,213940,213943,0,3,1
60995,5,2,213945,213945,213947,0,2,2
60996,6,1,213951,213951,213952,0,1,4
60997,3,3,213954,213954,213957,0,3,2
60998,3,1,213957,213957,213958,0,1,0
60999,5,3,213962,213962,213965,0,3,4
61000,2,1,213964,213965,213966,1,2,0
61001,2,2,213966,213966,213968,0,2,0
61002,2,3,213968,213968,213971,0,3,0
61003,1,3,213969,213971,213974,2,5,0
61004,4,2,213973,213974,213976,1,3,0
61005,5,2,213978,213978,213980,0,2,2
61006,2,1,213980,213980,213981,0,1,0
61007,5,1,213985,213985,213986,0,1,4
61008,6,3,213991,213991,213994,0,3,5
61009,3,1,213994,213994,213995,0,1,0
61010,6,2,214000,214000,214002,0,2,5
61011,1,2,214001,214002,214004,1,3,0
61012,2,2,214003,214004,214006,1,3,0
61013,2,2,214005,214006,214008,1,3,0
61014,3,1,214008,214008,214009,0,1,0
61015,3,1,214011,214011,214012,0,1,2
61016,2,3,214013,214013,214016,0,3,1
61017,2,2,214015,214016,214018,1,3,0
61018,3,1,214018,214018,214019,0,1,0
61019,1,3,214019,214019,214022,0,3,0
61020,2,1,214021,214022,214023,1,2,0
61021,5,3,214026,214026,214029,0,3,3
61022,6,2,214032,214032,214034,0,2,3
61023,6,1,214038,214038,214039,0,1,4
61024,3,2,214041,214041,214043,0,2,2
61025,1,1,214042,214043,214044,1,2,0
61026,3,2,214045,214045,214047,0,2,1
61027,1,2,214046,214047,214049,1,3,0
61028,5,1,214051,214051,214052,0,1,2
61029,6,2,214057,214057,214059,0,2,5
61030,2,1,214059,214059,214060,0,1,0
61031,3,2,214062,214062,214064,0,2,2
61032,3,2,214065,214065,214067,0,2,1
61033,1,3,214066,214067,214070,1,4,0
61034,5,2,214071,214071,214073,0,2,1
61035,6,3,214077,214077,214080,0,3,4
61036,3,2,214080,214080,214082,0,2,0
61037,5,1,214085,214085,214086,0,1,3
61038,5,1,214090,214090,214091,0,1,4
61039,6,1,214096,214096,214097,0,1,5
61040,6,1,214102,214102,214103,0,1,5
61041,5,1,214107,214107,214108,0,1,4
61042,1,1,214108,214108,214109,0,1,0
61043,1,1,214109,214109,214110,0,1,0
61044,5,3,214114,214114,214117,0,3,4
61045,3,3,214117,214117,214120,0,3,0
61046,3,3,214120,214120,214123,0,3,0
61047,5,2,214125,214125,214127,0,2,2
61048,5,3,214130,214130,214133,0,3,3
61049,4,2,214134,214134,214136,0,2,1
61050,4,2,214138,214138,214140,0,2,2
61051,6,3,214144,214144,214147,0,3,4
61052,4,3,214148,214148,214151,0,3,1
61053,5,3,214153,214153,214156,0,3,2
61054,5,3,214158,214158,214161,0,3,2
61055,4,3,214162,214162,214165,0,3,1
61056,2,3,214164,214165,214168,1,4,0
61057,5,2,214169,214169,214171,0,2,1
61058,5,3,214174,214174,214177,0,3,3
61059,1,1,214175,214177,214178,2,3,0
61060,2,2,214177,214178,214180,1,3,0
61061,5,1,214182,214182,214183,0,1,2
61062,3,1,214185,214185,214186,0,1,2
61063,4,1,214189,214189,214190,0,1,3
61064,6,1,214195,214195,214196,0,1,5
61065,6,1,214201,214201,214202,0,1,5
61066,3,1,214204,214204,214205,0,1,2
61067,1,3,214205,214205,214208,0,3,0
61068,4,1,214209,214209,214210,0,1,1
61069,1,3,214210,214210,214213,0,3,0
61070,4,2,214214,214214,214216,0,2,1
61071,6,3,214220,214220,214223,0,3,4
61072,1,3,214221,214223,214226,2,5,0
61073,5,1,214226,214226,214227,0,1,0
61074,6,2,214232,214232,214234,0,2,5
61075,6,3,214238,214238,214241,0,3,4
61076,4,3,214242,214242,214245,0,3,1
61077,1,1,214243,214245,214246,2,3,0
61078,4,1,214247,214247,214248,0,1,1
61079,3,3,214250,214250,214253,0,3,2
61080,6,1,214256,214256,214257,0,1,3
61081,5,2,214261,214261,214263,0,2,4
61082,4,1,214265,214265,214266,0,1,2
61083,2,3,214267,214267,214270,0,3,1
61084,2,1,214269,214270,214271,1,2,0
61085,5,2,214274,214274,214276,0,2,3
61086,4,1,214278,214278,214279,0,1,2
61087,3,1,214281,214281,214282,0,1,2
61088,5,3,214286,214286,214289,0,3,4
61089,3,2,214289,214289,214291,0,2,0
61090,3,2,214292,214292,214294,0,2,1
61091,5,3,214297,214297,214300,0,3,3
61092,3,3,214300,214300,214303,0,3,0
61093,5,1,214305,214305,214306,0,1,2
61094,2,3,214307,214307,214310,0,3,1
61095,5,1,214312,214312,214313,0,1,2
61096,6,1,214318,214318,214319,0,1,5
61097,6,1,214324,214324,214325,0,1,5
61098,2,2,214326,214326,214328,0,2,1
61099,5,3,214331,214331,214334,0,3,3
61100,3,2,214334,214334,214336,0,2,0
61101,3,2,214337,214337,214339,0,2,1
61102,2,2,214339,214339,214341,0,2,0
61103,5,3,214344,214344,214347,0,3,3
61104,1,1,214345,214347,214348,2,3,0
61105,6,2,214351,214351,214353,0,2,3
61106,5,3,214356,214356,214359,0,3,3
61107,6,2,214362,214362,214364,0,2,3
61108,6,1,214368,214368,214369,0,1,4
61109,1,3,214369,214369,214372,0,3,0
61110,2,1,214371,214372,214373,1,2,0
61111,5,1,214376,214376,214377,0,1,3
61112,6,2,214382,214382,214384,0,2,5
61113,1,2,214383,214384,214386,1,3,0
61114,3,1,214386,214386,214387,0,1,0
61115,5,3,214391,214391,214394,0,3,4
61116,2,2,214393,214394,214396,1,3,0
61117,4,3,214397,214397,214400,0,3,1
61118,3,2,214400,214400,214402,0,2,0
61119,1,1,214401,214402,214403,1,2,0
61120,2,1,214403,214403,214404,0,1,0
61121,6,2,214409,214409,214411,0,2,5
61122,5,1,214414,214414,214415,0,1,3
61123,1,2,214415,214415,214417,0,2,0
61124,5,2,214420,214420,214422,0,2,3
61125,3,2,214423,214423,214425,0,2,1
61126,5,1,214428,214428,214429,0,1,3
61127,5,1,214433,214433,214434,0,1,4
61128,3,1,214436,214436,214437,0,1,2
61129,1,1,214437,214437,214438,0,1,0
61130,1,2,214438,214438,214440,0,2,0
61131,5,3,214443,214443,214446,0,3,3
61132,5,1,214448,214448,214449,0,1,2
61133,4,1,214452,214452,214453,0,1,3
61134,1,3,214453,214453,214456,0,3,0
61135,4,2,214457,214457,214459,0,2,1
61136,1,2,214458,214459,214461,1,3,0
61137,4,2,214462,214462,214464,0,2,1
61138,5,2,214467,214467,214469,0,2,3
61139,2,2,214469,214469,214471,0,2,0
61140,1,3,214470,214471,214474,1,4,0
61141,4,2,214474,214474,214476,0,2,0
61142,6,3,214480,214480,214483,0,3,4
61143,4,2,214484,214484,214486,0,2,1
61144,4,3,214488,214488,214491,0,3,2
61145,3,1,214491,214491,214492,0,1,0
61146,1,1,214492,214492,214493,0,1,0
61147,4,3,214496,214496,214499,0,3,3
61148,1,1,214497,214499,214500,2,3,0
61149,2,3,214499,214500,214503,1,4,0
61150,5,2,214504,214504,214506,0,2,1
61151,1,1,214505,214506,214507,1,2,0
61152,4,2,214509,214509,214511,0,2,2
61153,2,1,214511,214511,214512,0,1,0
61154,3,1,214514,214514,214515,0,1,2
61155,1,3,214515,214515,214518,0,3,0
61156,6,2,214521,214521,214523,0,2,3
61157,5,2,214526,214526,214528,0,2,3
61158,4,2,214530,214530,214532,0,2,2
61159,1,3,214531,214532,214535,1,4,0
61160,1,1,214532,214535,214536,3,4,0
61161,4,3,214536,214536,214539,0,3,0
61162,4,3,214540,214540,214543,0,3,1
61163,6,3,214546,214546,214549,0,3,3
61164,1,2,214547,214549,214551,2,4,0
61165,2,1,214549,214551,214552,2,3,0
61166,2,2,214551,214552,214554,1,3,0
61167,5,1,214556,214556,214557,0,1,2
61168,2,3,214558,214558,214561,0,3,1
61169,1,2,214559,214561,214563,2,4,0
61170,1,2,214560,214563,214565,3,5,0
61171,5,2,214565,214565,214567,0,2,0
61172,1,2,214566,214567,214569,1,3,0
61173,4,1,214570,214570,214571,0,1,1
61174,4,3,214574,214574,214577,0,3,3
61175,2,3,214576,214577,214580,1,4,0
61176,6,1,214582,214582,214583,0,1,2
61177,6,1,214588,214588,214589,0,1,5
61178,5,2,214593,214593,214595,0,2,4
61179,5,2,214598,214598,214600,0,2,3
61180,4,1,214602,214602,214603,0,1,2
61181,6,2,214608,214608,214610,0,2,5
61182,5,1,214613,214613,214614,0,1,3
61183,5,1,214618,214618,214619,0,1,4
61184,5,1,214623,214623,214624,0,1,4
61185,6,2,214629,214629,214631,0,2,5
61186,2,1,214631,214631,214632,0,1,0
61187,2,2,214633,214633,214635,0,2,1
61188,5,3,214638,214638,214641,0,3,3
61189,5,3,214643,214643,214646,0,3,2
61190,6,1,214649,214649,214650,0,1,3
61191,6,3,214655,214655,214658,0,3,5
61192,2,2,214657,214658,214660,1,3,0
61193,2,2,214659,214660,214662,1,3,0
61194,2,3,214661,214662,214665,1,4,0
61195,3,3,214664,214665,214668,1,4,0
61196,1,3,214665,214668,214671,3,6,0
61197,6,3,214671,214671,214674,0,3,0
61198,2,3,214673,214674,214677,1,4,0
61199,5,2,214678,214678,214680,0,2,1
61200,4,1,214682,214682,214683,0,1,2
61201,1,3,214683,214683,214686,0,3,0
61202,2,3,214685,214686,214689,1,4,0
61203,2,1,214687,214689,214690,2,3,0
61204,3,1,214690,214690,214691,0,1,0
61205,2,3,214692,214692,214695,0,3,1
61206,2,1,214694,214695,214696,1,2,0
61207,4,2,214698,214698,214700,0,2,2
61208,3,3,214701,214701,214704,0,3,1
61209,5,3,214706,214706,214709,0,3,2
61210,5,2,214711,214711,214713,0,2,2
61211,6,1,214717,214717,214718,0,1,4
61212,3,1,214720,214720,214721,0,1,2
61213,6,3,214726,214726,214729,0,3,5
61214,3,1,214729,214729,214730,0,1,0
61215,4,3,214733,214733,214736,0,3,3
61216,1,2,214734,214736,214738,2,4,0
61217,1,1,214735,214738,214739,3,4,0
61218,3,2,214738,214739,214741,1,3,0
61219,2,1,214740,214741,214742,1,2,0
61220,6,2,214746,214746,214748,0,2,4
61221,6,2,214752,214752,214754,0,2,4
61222,6,1,214758,214758,214759,0,1,4
61223,5,1,214763,214763,214764,0,1,4
61224,4,3,214767,214767,214770,0,3,3
61225,4,1,214771,214771,214772,0,1,1
61226,1,2,214772,214772,214774,0,2,0
61227,1,3,214773,214774,214777,1,4,0
61228,2,1,214775,214777,214778,2,3,0
61229,3,3,214778,214778,214781,0,3,0
61230,2,3,214780,214781,214784,1,4,0
61231,1,3,214781,214784,214787,3,6,0
61232,2,1,214783,214787,214788,4,5,0
61233,5,2,214788,214788,214790,0,2,0
61234,4,2,214792,214792,214794,0,2,2
61235,3,2,214795,214795,214797,0,2,1
61236,1,3,214796,214797,214800,1,4,0
61237,4,1,214800,214800,214801,0,1,0
61238,5,1,214805,214805,214806,0,1,4
61239,5,3,214810,214810,214813,0,3,4
61240,6,1,214816,214816,214817,0,1,3
61241,5,1,214821,214821,214822,0,1,4
61242,2,2,214823,214823,214825,0,2,1
61243,3,3,214826,214826,214829,0,3,1
61244,6,3,214832,214832,214835,0,3,3
61245,2,2,214834,214835,214837,1,3,0
61246,6,3,214840,214840,214843,0,3,3
61247,3,3,214843,214843,214846,0,3,0
61248,4,3,214847,214847,214850,0,3,1
61249,1,3,214848,214850,214853,2,5,0
61250,3,1,214851,214853,214854,2,3,0
61251,4,1,214855,214855,214856,0,1,1
61252,6,2,214861,214861,214863,0,2,5
61253,1,1,214862,214863,214864,1,2,0
61254,1,3,214863,214864,214867,1,4,0
61255,4,3,214867,214867,214870,0,3,0
61256,2,3,214869,214870,214873,1,4,0
61257,4,3,214873,214873,214876,0,3,0
61258,4,2,214877,214877,214879,0,2,1
61259,5,3,214882,214882,214885,0,3,3
61260,1,2,214883,214885,214887,2,4,0
61261,5,2,214888,214888,214890,0,2,1
61262,3,2,214891,214891,214893,0,2,1
61263,3,1,214894,214894,214895,0,1,1
61264,6,1,214900,214900,214901,0,1,5
61265,4,2,214904,214904,214906,0,2,3
61266,5,3,214909,214909,214912,0,3,3
61267,6,1,214915,214915,214916,0,1,3
61268,2,3,214917,214917,214920,0,3,1
61269,4,1,214921,214921,214922,0,1,1
61270,6,1,214927,214927,214928,0,1,5
61271,1,2,214928,214928,214930,0,2,0
61272,2,1,214930,214930,214931,0,1,0
61273,2,3,214932,214932,214935,0,3,1
61274,2,1,214934,214935,214936,1,2,0
61275,6,3,214940,214940,214943,0,3,4
61276,4,3,214944,214944,214947,0,3,1
61277,6,2,214950,214950,214952,0,2,3
61278,5,1,214955,214955,214956,0,1,3
61279,5,1,214960,214960,214961,0,1,4
61280,4,3,214964,214964,214967,0,3,3
61281,2,2,214966,214967,214969,1,3,0
61282,6,3,214972,214972,214975,0,3,3
61283,5,1,214977,214977,214978,0,1,2
61284,6,1,214983,214983,214984,0,1,5
61285,1,1,214984,214984,214985,0,1,0
61286,6,2,214990,214990,214992,0,2,5
61287,2,2,214992,214992,214994,0,2,0
61288,4,3,214996,214996,214999,0,3,2
61289,6,3,215002,215002,215005,0,3,3
61290,2,3,215004,215005,215008,1,4,0
61291,1,3,215005,215008,215011,3,6,0
61292,6,2,215011,215011,215013,0,2,0
61293,1,2,215012,215013,215015,1,3,0
61294,4,3,215016,215016,215019,0,3,1
61295,2,3,215018,215019,215022,1,4,0
61296,1,2,215019,215022,215024,3,5,0
61297,5,3,215024,215024,215027,0,3,0
61298,3,2,215027,215027,215029,0,2,0
61299,5,2,215032,215032,215034,0,2,3
61300,6,2,215038,215038,215040,0,2,4
61301,1,2,215039,215040,215042,1,3,0
61302,2,1,215041,215042,215043,1,2,0
61303,2,3,215043,215043,215046,0,3,0
61304,2,3,215045,215046,215049,1,4,0
61305,6,3,215051,215051,215054,0,3,2
61306,5,2,215056,215056,215058,0,2,2
61307,1,1,215057,215058,215059,1,2,0
61308,1,3,215058,215059,215062,1,4,0
61309,3,2,215061,215062,215064,1,3,0
61310,2,2,215063,215064,215066,1,3,0
61311,6,2,215069,215069,215071,0,2,3
61312,2,3,215071,215071,215074,0,3,0
61313,3,1,215074,215074,215075,0,1,0
61314,6,2,215080,215080,215082,0,2,5
61315,6,1,215086,215086,215087,0,1,4
61316,2,3,215088,215088,215091,0,3,1
61317,1,1,215089,215091,215092,2,3,0
61318,1,1,215090,215092,215093,2,3,0
61319,2,2,215092,215093,215095,1,3,0
61320,4,2,215096,215096,215098,0,2,1
61321,1,1,215097,215098,215099,1,2,0
61322,5,1,215102,215102,215103,0,1,3
61323,5,2,215107,215107,215109,0,2,4
61324,2,2,215109,215109,215111,0,2,0
61325,3,1,215112,215112,215113,0,1,1
61326,1,2,215113,215113,215115,0,2,0
61327,6,3,215119,215119,215122,0,3,4
61328,6,1,215125,215125,215126,0,1,3
61329,2,2,215127,215127,215129,0,2,1
61330,4,3,215131,215131,215134,0,3,2
61331,6,2,215137,215137,215139,0,2,3
61332,6,1,215143,215143,215144,0,1,4
61333,1,1,215144,215144,215145,0,1,0
61334,3,1,215147,215147,215148,0,1,2
61335,2,2,215149,215149,215151,0,2,1
61336,4,3,215153,215153,215156,0,3,2
61337,2,2,215155,215156,215158,1,3,0
61338,6,2,215161,215161,215163,0,2,3
61339,4,2,215165,215165,215167,0,2,2
61340,2,2,215167,215167,215169,0,2,0
61341,6,1,215173,215173,215174,0,1,4
61342,3,1,215176,215176,215177,0,1,2
61343,4,2,215180,215180,215182,0,2,3
61344,6,3,215186,215186,215189,0,3,4
61345,4,3,215190,215190,215193,0,3,1
61346,5,2,215195,215195,215197,0,2,2
61347,5,1,215200,215200,215201,0,1,3
61348,6,3,215206,215206,215209,0,3,5
61349,5,2,215211,215211,215213,0,2,2
61350,3,2,215214,215214,215216,0,2,1
61351,6,2,215220,215220,215222,0,2,4
61352,2,1,215222,215222,215223,0,1,0
61353,1,1,215223,215223,215224,0,1,0
61354,1,1,215224,215224,215225,0,1,0
61355,4,3,215228,215228,215231,0,3,3
61356,5,1,215233,215233,215234,0,1,2
61357,6,3,215239,215239,215242,0,3,5
61358,1,2,215240,215242,215244,2,4,0
61359,5,1,215245,215245,215246,0,1,1
61360,3,3,215248,215248,215251,0,3,2
61361,4,1,215252,215252,215253,0,1,1
61362,3,3,215255,215255,215258,0,3,2
61363,3,2,215258,215258,215260,0,2,0
61364,4,3,215262,215262,215265,0,3,2
61365,3,2,215265,215265,215267,0,2,0
61366,5,3,215270,215270,215273,0,3,3
61367,3,1,215273,215273,215274,0,1,0
61368,2,3,215275,215275,215278,0,3,1
61369,3,3,215278,215278,215281,0,3,0
61370,2,2,215280,215281,215283,1,3,0
61371,5,1,215285,215285,215286,0,1,2
61372,2,2,215287,215287,215289,0,2,1
61373,3,1,215290,215290,215291,0,1,1
61374,6,3,215296,215296,215299,0,3,5
61375,5,1,215301,215301,215302,0,1,2
61376,2,2,215303,215303,215305,0,2,1
61377,5,2,215308,215308,215310,0,2,3
61378,1,3,215309,215310,215313,1,4,0
61379,4,3,215313,215313,215316,0,3,0
61380,6,2,215319,215319,215321,0,2,3
61381,1,2,215320,215321,215323,1,3,0
61382,5,3,215325,215325,215328,0,3,2
61383,1,2,215326,215328,215330,2,4,0
61384,2,1,215328,215330,215331,2,3,0
61385,1,2,215329,215331,215333,2,4,0
61386,2,3,215331,215333,215336,2,5,0
61387,6,2,215337,215337,215339,0,2,1
61388,2,1,215339,215339,215340,0,1,0
61389,5,1,215344,215344,215345,0,1,4
61390,4,2,215348,215348,215350,0,2,3
61391,6,2,215354,215354,215356,0,2,4
61392,6,3,215360,215360,215363,0,3,4
61393,4,3,215364,215364,215367,0,3,1
61394,1,3,215365,215367,215370,2,5,0
61395,4,2,215369,215370,215372,1,3,0
61396,6,3,215375,215375,215378,0,3,3
61397,1,2,215376,215378,215380,2,4,0
61398,2,3,215378,215380,215383,2,5,0
61399,4,1,215382,215383,215384,1,2,0
61400,3,1,215385,215385,215386,0,1,1
61401,3,2,215388,215388,215390,0,2,2
61402,1,3,215389,215390,215393,1,4,0
61403,3,2,215392,215393,215395,1,3,0
61404,2,3,215394,215395,215398,1,4,0
61405,1,1,215395,215398,215399,3,4,0
61406,3,1,215398,215399,215400,1,2,0
61407,6,3,215404,215404,215407,0,3,4
61408,4,2,215408,215408,215410,0,2,1
61409,6,3,215414,215414,215417,0,3,4
61410,3,2,215417,215417,215419,0,2,0
61411,5,1,215422,215422,215423,0,1,3
61412,2,1,215424,215424,215425,0,1,1
61413,2,1,215426,215426,215427,0,1,1
61414,1,2,215427,215427,215429,0,2,0
61415,1,2,215428,215429,215431,1,3,0
61416,2,2,215430,215431,215433,1,3,0
61417,4,3,215434,215434,215437,0,3,1
61418,4,2,215438,215438,215440,0,2,1
61419,1,3,215439,215440,215443,1,4,0
61420,2,3,215441,215443,215446,2,5,0
61421,6,3,215447,215447,215450,0,3,1
61422,3,2,215450,215450,215452,0,2,0
61423,5,1,215455,215455,215456,0,1,3
61424,5,2,215460,215460,215462,0,2,4
61425,2,1,215462,215462,215463,0,1,0
61426,1,1,215463,215463,215464,0,1,0
61427,4,1,215467,215467,215468,0,1,3
61428,2,3,215469,215469,215472,0,3,1
61429,2,1,215471,215472,215473,1,2,0
61430,2,2,215473,215473,215475,0,2,0
61431,3,2,215476,215476,215478,0,2,1
61432,4,2,215480,215480,215482,0,2,2
61433,3,3,215483,215483,215486,0,3,1
61434,2,3,215485,215486,215489,1,4,0
61435,4,3,215489,215489,215492,0,3,0
61436,1,3,215490,215492,215495,2,5,0
61437,1,2,215491,215495,215497,4,6,0
61438,2,1,215493,215497,215498,4,5,0
61439,2,2,215495,215498,215500,3,5,0
61440,6,1,215501,215501,215502,0,1,1
61441,6,2,215507,215507,215509,0,2,5
61442,6,2,215513,215513,215515,0,2,4
61443,2,1,215515,215515,215516,0,1,0
61444,1,2,215516,215516,215518,0,2,0
61445,3,3,215519,215519,215522,0,3,1
61446,3,2,215522,215522,215524,0,2,0
61447,5,2,215527,215527,215529,0,2,3
61448,4,3,215531,215531,215534,0,3,2
61449,6,1,215537,215537,215538,0,1,3
61450,4,2,215541,215541,215543,0,2,3
61451,3,1,215544,215544,215545,0,1,1
61452,6,2,215550,215550,215552,0,2,5
61453,2,1,215552,215552,215553,0,1,0
61454,1,2,215553,215553,215555,0,2,0
61455,4,3,215557,215557,215560,0,3,2
61456,6,1,215563,215563,215564,0,1,3
61457,1,1,215564,215564,215565,0,1,0
61458,4,3,215568,215568,215571,0,3,3
61459,2,2,215570,215571,215573,1,3,0
61460,2,1,215572,215573,215574,1,2,0
61461,6,1,215578,215578,215579,0,1,4
61462,2,1,215580,215580,215581,0,1,1
61463,6,3,215586,215586,215589,0,3,5
61464,2,2,215588,215589,215591,1,3,0
61465,1,1,215589,215591,215592,2,3,0
61466,5,3,215594,215594,215597,0,3,2
61467,5,3,215599,215599,215602,0,3,2
61468,5,1,215604,215604,215605,0,1,2
61469,3,3,215607,215607,215610,0,3,2
61470,1,3,215608,215610,215613,2,5,0
61471,4,1,215612,215613,215614,1,2,0
61472,1,3,215613,215614,215617,1,4,0
61473,1,1,215614,215617,215618,3,4,0
61474,1,2,215615,215618,215620,3,5,0
61475,3,2,215618,215620,215622,2,4,0
61476,4,3,215622,215622,215625,0,3,0
61477,3,1,215625,215625,215626,0,1,0
61478,3,1,215628,215628,215629,0,1,2
61479,1,2,215629,215629,215631,0,2,0
61480,4,2,215633,215633,215635,0,2,2
61481,1,2,215634,215635,215637,1,3,0
61482,5,2,215639,215639,215641,0,2,2
61483,3,3,215642,215642,215645,0,3,1
61484,6,2,215648,215648,215650,0,2,3
61485,2,1,215650,215650,215651,0,1,0
61486,2,1,215652,215652,215653,0,1,1
61487,5,3,215657,215657,215660,0,3,4
61488,1,3,215658,215660,215663,2,5,0
61489,3,3,215661,215663,215666,2,5,0
61490,5,1,215666,215666,215667,0,1,0
61491,5,2,215671,215671,215673,0,2,4
61492,4,2,215675,215675,215677,0,2,2
61493,2,2,215677,215677,215679,0,2,0
61494,1,3,215678,215679,215682,1,4,0
61495,2,2,215680,215682,215684,2,4,0
61496,1,3,215681,215684,215687,3,6,0
61497,5,3,215686,215687,215690,1,4,0
61498,3,2,215689,215690,215692,1,3,0
61499,2,3,215691,215692,215695,1,4,0
61500,3,1,215694,215695,215696,1,2,0
61501,1,3,215695,215696,215699,1,4,0
61502,5,1,215700,215700,215701,0,1,1
61503,4,2,215704,215704,215706,0,2,3
61504,3,3,215707,215707,215710,0,3,1
61505,3,2,215710,215710,215712,0,2,0
61506,4,3,215714,215714,215717,0,3,2
61507,6,2,215720,215720,215722,0,2,3
61508,1,2,215721,215722,215724,1,3,0
61509,5,2,215726,215726,215728,0,2,2
61510,6,3,215732,215732,215735,0,3,4
61511,4,2,215736,215736,215738,0,2,1
61512,5,2,215741,215741,215743,0,2,3
61513,2,2,215743,215743,215745,0,2,0
61514,5,2,215748,215748,215750,0,2,3
61515,1,1,215749,215750,215751,1,2,0
61516,6,1,215755,215755,215756,0,1,4
61517,1,3,215756,215756,215759,0,3,0
61518,6,3,215762,215762,215765,0,3,3
61519,2,1,215764,215765,215766,1,2,0
61520,5,3,215769,215769,215772,0,3,3
61521,6,1,215775,215775,215776,0,1,3
61522,2,3,215777,215777,215780,0,3,1
61523,2,1,215779,215780,215781,1,2,0
61524,6,3,215785,215785,215788,0,3,4
61525,6,3,215791,215791,215794,0,3,3
61526,6,3,215797,215797,215800,0,3,3
61527,3,1,215800,215800,215801,0,1,0
61528,5,2,215805,215805,215807,0,2,4
61529,5,3,215810,215810,215813,0,3,3
61530,6,3,215816,215816,215819,0,3,3
61531,6,3,215822,215822,215825,0,3,3
61532,2,3,215824,215825,215828,1,4,0
61533,5,3,215829,215829,215832,0,3,1
61534,6,1,215835,215835,215836,0,1,3
61535,3,3,215838,215838,215841,0,3,2
61536,4,1,215842,215842,215843,0,1,1
61537,4,1,215846,215846,215847,0,1,3
61538,5,1,215851,215851,215852,0,1,4
61539,5,1,215856,215856,215857,0,1,4
61540,2,2,215858,215858,215860,0,2,1
61541,3,1,215861,215861,215862,0,1,1
61542,1,1,215862,215862,215863,0,1,0
61543,4,3,215866,215866,215869,0,3,3
61544,5,1,215871,215871,215872,0,1,2
61545,4,3,215875,215875,215878,0,3,3
61546,1,2,215876,215878,215880,2,4,0
61547,2,2,215878,215880,215882,2,4,0
61548,1,1,215879,215882,215883,3,4,0
61549,6,3,215885,215885,215888,0,3,2
61550,1,2,215886,215888,215890,2,4,0
61551,4,3,215890,215890,215893,0,3,0
61552,1,1,215891,215893,215894,2,3,0
61553,3,3,215894,215894,215897,0,3,0
61554,6,3,215900,215900,215903,0,3,3
61555,2,2,215902,215903,215905,1,3,0
61556,3,1,215905,215905,215906,0,1,0
61557,3,3,215908,215908,215911,0,3,2
61558,5,2,215913,215913,215915,0,2,2
61559,6,3,215919,215919,215922,0,3,4
61560,2,1,215921,215922,215923,1,2,0
61561,3,1,215924,215924,215925,0,1,1
61562,1,1,215925,215925,215926,0,1,0
61563,3,1,215928,215928,215929,0,1,2
61564,3,3,215931,215931,215934,0,3,2
61565,6,2,215937,215937,215939,0,2,3
61566,5,3,215942,215942,215945,0,3,3
61567,1,3,215943,215945,215948,2,5,0
61568,5,2,215948,215948,215950,0,2,0
61569,3,1,215951,215951,215952,0,1,1
61570,3,2,215954,215954,215956,0,2,2
61571,2,2,215956,215956,215958,0,2,0
61572,2,1,215958,215958,215959,0,1,0
61573,4,3,215962,215962,215965,0,3,3
61574,4,1,215966,215966,215967,0,1,1
61575,5,1,215971,215971,215972,0,1,4
61576,3,2,215974,215974,215976,0,2,2
61577,6,2,215980,215980,215982,0,2,4
61578,4,2,215984,215984,215986,0,2,2
61579,4,1,215988,215988,215989,0,1,2
61580,1,3,215989,215989,215992,0,3,0
61581,1,2,215990,215992,215994,2,4,0
61582,4,2,215994,215994,215996,0,2,0
61583,3,1,215997,215997,215998,0,1,1
61584,5,3,216002,216002,216005,0,3,4
61585,6,1,216008,216008,216009,0,1,3
61586,3,2,216011,216011,216013,0,2,2
61587,4,2,216015,216015,216017,0,2,2
61588,2,3,216017,216017,216020,0,3,0
61589,1,1,216018,216020,216021,2,3,0
61590,1,1,216019,216021,216022,2,3,0
61591,6,3,216025,216025,216028,0,3,3
61592,6,2,216031,216031,216033,0,2,3
61593,5,3,216036,216036,216039,0,3,3
61594,2,2,216038,216039,216041,1,3,0
61595,2,3,216040,216041,216044,1,4,0
61596,5,3,216045,216045,216048,0,3,1
61597,3,3,216048,216048,216051,0,3,0
61598,6,2,216054,216054,216056,0,2,3
61599,2,1,216056,216056,216057,0,1,0
61600,3,1,216059,216059,216060,0,1,2
61601,1,3,216060,216060,216063,0,3,0
61602,1,1,216061,216063,216064,2,3,0
61603,4,1,216065,216065,216066,0,1,1
61604,3,1,216068,216068,216069,0,1,2
61605,6,3,216074,216074,216077,0,3,5
61606,2,2,216076,216077,216079,1,3,0
61607,3,1,216079,216079,216080,0,1,0
61608,1,3,216080,216080,216083,0,3,0
61609,6,1,216086,216086,216087,0,1,3
61610,5,2,216091,216091,216093,0,2,4
61611,1,1,216092,216093,216094,1,2,0
61612,2,3,216094,216094,216097,0,3,0
61613,6,3,216100,216100,216103,0,3,3
61614,5,3,216105,216105,216108,0,3,2
61615,6,3,216111,216111,216114,0,3,3
61616,4,1,216115,216115,216116,0,1,1
61617,5,3,216120,216120,216123,0,3,4
61618,2,3,216122,216123,216126,1,4,0
61619,5,3,216127,216127,216130,0,3,1
61620,4,2,216131,216131,216133,0,2,1
61621,5,2,216136,216136,216138,0,2,3
61622,1,2,216137,216138,216140,1,3,0
61623,2,1,216139,216140,216141,1,2,0
61624,5,2,216144,216144,216146,0,2,3
61625,2,3,216146,216146,216149,0,3,0
61626,4,1,216150,216150,216151,0,1,1
61627,2,3,216152,216152,216155,0,3,1
61628,2,1,216154,216155,216156,1,2,0
61629,5,1,216159,216159,216160,0,1,3
61630,2,1,216161,216161,216162,0,1,1
61631,5,3,216166,216166,216169,0,3,4
61632,2,3,216168,216169,216172,1,4,0
61633,4,2,216172,216172,216174,0,2,0
61634,3,1,216175,216175,216176,0,1,1
61635,5,2,216180,216180,216182,0,2,4
61636,1,1,216181,216182,216183,1,2,0
61637,3,1,216184,216184,216185,0,1,1
61638,2,2,216186,216186,216188,0,2,1
61639,4,2,216190,216190,216192,0,2,2
61640,3,1,216193,216193,216194,0,1,1
61641,1,2,216194,216194,216196,0,2,0
61642,1,3,216195,216196,216199,1,4,0
61643,3,1,216198,216199,216200,1,2,0
61644,5,2,216203,216203,216205,0,2,3
61645,1,2,216204,216205,216207,1,3,0
61646,1,1,216205,216207,216208,2,3,0
61647,3,3,216208,216208,216211,0,3,0
61648,4,2,216212,216212,216214,0,2,1
61649,1,3,216213,216214,216217,1,4,0
61650,4,1,216217,216217,216218,0,1,0
61651,2,3,216219,216219,216222,0,3,1
61652,2,1,216221,216222,216223,1,2,0
61653,4,3,216225,216225,216228,0,3,2
61654,6,1,216231,216231,216232,0,1,3
61655,4,3,216235,216235,216238,0,3,3
61656,2,1,216237,216238,216239,1,2,0
61657,5,1,216242,216242,216243,0,1,3
61658,1,2,216243,216243,216245,0,2,0
61659,2,1,216245,216245,216246,0,1,0
61660,4,1,216249,216249,216250,0,1,3
61661,5,1,216254,216254,216255,0,1,4
61662,3,1,216257,216257,216258,0,1,2
61663,4,1,216261,216261,216262,0,1,3
61664,6,1,216267,216267,216268,0,1,5
61665,3,1,216270,216270,216271,0,1,2
61666,1,3,216271,216271,216274,0,3,0
61667,5,2,216276,216276,216278,0,2,2
61668,4,1,216280,216280,216281,0,1,2
61669,4,3,216284,216284,216287,0,3,3
61670,3,1,216287,216287,216288,0,1,0
61671,2,2,216289,216289,216291,0,2,1
61672,6,2,216295,216295,216297,0,2,4
61673,2,3,216297,216297,216300,0,3,0
61674,3,3,216300,216300,216303,0,3,0
61675,6,1,216306,216306,216307,0,1,3
61676,6,3,216312,216312,216315,0,3,5
61677,5,3,216317,216317,216320,0,3,2
61678,1,1,216318,216320,216321,2,3,0
61679,5,2,216323,216323,216325,0,2,2
61680,1,2,216324,216325,216327,1,3,0
61681,1,3,216325,216327,216330,2,5,0
61682,1,3,216326,216330,216333,4,7,0
61683,1,1,216327,216333,216334,6,7,0
61684,5,2,216332,216334,216336,2,4,0
61685,4,3,216336,216336,216339,0,3,0
61686,2,3,216338,216339,216342,1,4,0
61687,6,2,216344,216344,216346,0,2,2
61688,2,3,216346,216346,216349,0,3,0
61689,6,1,216352,216352,216353,0,1,3
61690,4,1,216356,216356,216357,0,1,3
61691,6,3,216362,216362,216365,0,3,5
61692,6,3,216368,216368,216371,0,3,3
61693,5,1,216373,216373,216374,0,1,2
61694,5,3,216378,216378,216381,0,3,4
61695,3,1,216381,216381,216382,0,1,0
61696,4,3,216385,216385,216388,0,3,3
61697,1,1,216386,216388,216389,2,3,0
61698,5,3,216391,216391,216394,0,3,2
61699,2,2,216393,216394,216396,1,3,0
61700,1,2,216394,216396,216398,2,4,0
61701,5,2,216399,216399,216401,0,2,1
61702,3,1,216402,216402,216403,0,1,1
61703,3,3,216405,216405,216408,0,3,2
61704,3,3,216408,216408,216411,0,3,0
61705,6,3,216414,216414,216417,0,3,3
61706,1,3,216415,216417,216420,2,5,0
61707,3,1,216418,216420,216421,2,3,0
61708,4,1,216422,216422,216423,0,1,1
61709,4,2,216426,216426,216428,0,2,3
61710,3,1,216429,216429,216430,0,1,1
61711,2,1,216431,216431,216432,0,1,1
61712,1,1,216432,216432,216433,0,1,0
61713,4,2,216436,216436,216438,0,2,3
61714,5,3,216441,216441,216444,0,3,3
61715,3,2,216444,216444,216446,0,2,0
61716,5,3,216449,216449,216452,0,3,3
61717,4,1,216453,216453,216454,0,1,1
61718,2,1,216455,216455,216456,0,1,1
61719,6,1,216461,216461,216462,0,1,5
61720,5,1,216466,216466,216467,0,1,4
61721,3,1,216469,216469,216470,0,1,2
61722,2,1,216471,216471,216472,0,1,1
61723,3,3,216474,216474,216477,0,3,2
61724,4,1,216478,216478,216479,0,1,1
61725,5,3,216483,216483,216486,0,3,4
61726,3,2,216486,216486,216488,0,2,0
61727,4,3,216490,216490,216493,0,3,2
61728,3,1,216493,216493,216494,0,1,0
61729,5,2,216498,216498,216500,0,2,4
61730,2,2,216500,216500,216502,0,2,0
61731,6,2,216506,216506,216508,0,2,4
61732,5,1,216511,216511,216512,0,1,3
61733,5,1,216516,216516,216517,0,1,4
61734,3,2,216519,216519,216521,0,2,2
61735,4,2,216523,216523,216525,0,2,2
61736,4,1,216527,216527,216528,0,1,2
61737,6,3,216533,216533,216536,0,3,5
61738,6,1,216539,216539,216540,0,1,3
61739,3,3,216542,216542,216545,0,3,2
61740,5,3,216547,216547,216550,0,3,2
61741,3,2,216550,216550,216552,0,2,0
61742,1,2,216551,216552,216554,1,3,0
61743,3,3,216554,216554,216557,0,3,0
61744,3,2,216557,216557,216559,0,2,0
61745,3,3,216560,216560,216563,0,3,1
61746,6,2,216566,216566,216568,0,2,3
61747,4,2,216570,216570,216572,0,2,2
61748,3,3,216573,216573,216576,0,3,1
61749,2,2,216575,216576,216578,1,3,0
61750,1,3,216576,216578,216581,2,5,0
61751,3,2,216579,216581,216583,2,4,0
61752,3,1,216582,216583,216584,1,2,0
61753,2,2,216584,216584,216586,0,2,0
61754,1,2,216585,216586,216588,1,3,0
61755,5,2,216590,216590,216592,0,2,2
61756,4,2,216594,216594,216596,0,2,2
61757,5,2,216599,216599,216601,0,2,3
61758,1,1,216600,216601,216602,1,2,0
61759,6,3,216606,216606,216609,0,3,4
61760,2,1,216608,216609,216610,1,2,0
61761,6,1,216614,216614,216615,0,1,4
61762,5,1,216619,216619,216620,0,1,4
61763,6,1,216625,216625,216626,0,1,5
61764,5,1,216630,216630,216631,0,1,4
61765,1,3,216631,216631,216634,0,3,0
61766,4,3,216635,216635,216638,0,3,1
61767,2,3,216637,216638,216641,1,4,0
61768,3,1,216640,216641,216642,1,2,0
61769,5,3,216645,216645,216648,0,3,3
61770,1,1,216646,216648,216649,2,3,0
61771,5,3,216651,216651,216654,0,3,2
61772,3,3,216654,216654,216657,0,3,0
61773,2,3,216656,216657,216660,1,4,0
61774,4,3,216660,216660,216663,0,3,0
61775,4,3,216664,216664,216667,0,3,1
61776,5,2,216669,216669,216671,0,2,2
61777,5,2,216674,216674,216676,0,2,3
61778,5,2,216679,216679,216681,0,2,3
61779,1,1,216680,216681,216682,1,2,0
61780,4,1,216684,216684,216685,0,1,2
61781,3,2,216687,216687,216689,0,2,2
61782,4,1,216691,216691,216692,0,1,2
61783,5,2,216696,216696,216698,0,2,4
61784,4,2,216700,216700,216702,0,2,2
61785,1,2,216701,216702,216704,1,3,0
61786,3,3,216704,216704,216707,0,3,0
61787,1,2,216705,216707,216709,2,4,0
61788,5,2,216710,216710,216712,0,2,1
61789,6,2,216716,216716,216718,0,2,4
61790,5,2,216721,216721,216723,0,2,3
61791,6,2,216727,216727,216729,0,2,4
61792,4,2,216731,216731,216733,0,2,2
61793,6,2,216737,216737,216739,0,2,4
61794,2,3,216739,216739,216742,0,3,0
61795,4,3,216743,216743,216746,0,3,1
61796,2,3,216745,216746,216749,1,4,0
61797,5,3,216750,216750,216753,0,3,1
61798,4,3,216754,216754,216757,0,3,1
61799,4,2,216758,216758,216760,0,2,1
61800,4,1,216762,216762,216763,0,1,2
61801,5,3,216767,216767,216770,0,3,4
61802,5,1,216772,216772,216773,0,1,2
61803,4,3,216776,216776,216779,0,3,3
61804,1,3,216777,216779,216782,2,5,0
61805,1,1,216778,216782,216783,4,5,0
61806,3,1,216781,216783,216784,2,3,0
61807,5,1,216786,216786,216787,0,1,2
61808,3,1,216789,216789,216790,0,1,2
61809,4,2,216793,216793,216795,0,2,3
61810,6,1,216799,216799,216800,0,1,4
61811,2,1,216801,216801,216802,0,1,1
61812,4,1,216805,216805,216806,0,1,3
61813,2,1,216807,216807,216808,0,1,1
61814,2,3,216809,216809,216812,0,3,1
61815,2,3,216811,216812,216815,1,4,0
61816,2,3,216813,216815,216818,2,5,0
61817,5,2,216818,216818,216820,0,2,0
61818,5,1,216823,216823,216824,0,1,3
61819,6,3,216829,216829,216832,0,3,5
61820,1,2,216830,216832,216834,2,4,0
61821,5,1,216835,216835,216836,0,1,1
61822,3,3,216838,216838,216841,0,3,2
61823,2,2,216840,216841,216843,1,3,0
61824,3,1,216843,216843,216844,0,1,0
61825,2,1,216845,216845,216846,0,1,1
61826,3,3,216848,216848,216851,0,3,2
61827,1,3,216849,216851,216854,2,5,0
61828,2,3,216851,216854,216857,3,6,0
61829,3,1,216854,216857,216858,3,4,0
61830,4,3,216858,216858,216861,0,3,0
61831,4,1,216862,216862,216863,0,1,1
61832,4,2,216866,216866,216868,0,2,3
61833,1,2,216867,216868,216870,1,3,0
61834,2,2,216869,216870,216872,1,3,0
61835,5,2,216874,216874,216876,0,2,2
61836,5,1,216879,216879,216880,0,1,3
61837,1,1,216880,216880,216881,0,1,0
61838,4,2,216884,216884,216886,0,2,3
61839,4,3,216888,216888,216891,0,3,2
61840,5,2,216893,216893,216895,0,2,2
61841,2,3,216895,216895,216898,0,3,0
61842,6,2,216901,216901,216903,0,2,3
61843,4,3,216905,216905,216908,0,3,2
61844,2,1,216907,216908,216909,1,2,0
61845,4,3,216911,216911,216914,0,3,2
61846,1,2,216912,216914,216916,2,4,0
61847,3,1,216915,216916,216917,1,2,0
61848,1,2,216916,216917,216919,1,3,0
61849,6,3,216922,216922,216925,0,3,3
61850,6,3,216928,216928,216931,0,3,3
61851,4,3,216932,216932,216935,0,3,1
61852,2,1,216934,216935,216936,1,2,0
61853,4,3,216938,216938,216941,0,3,2
61854,3,2,216941,216941,216943,0,2,0
61855,1,3,216942,216943,216946,1,4,0
61856,6,1,216948,216948,216949,0,1,2
61857,1,3,216949,216949,216952,0,3,0
61858,2,1,216951,216952,216953,1,2,0
61859,2,2,216953,216953,216955,0,2,0
61860,5,2,216958,216958,216960,0,2,3
61861,2,1,216960,216960,216961,0,1,0
61862,5,3,216965,216965,216968,0,3,4
61863,3,2,216968,216968,216970,0,2,0
61864,6,1,216974,216974,216975,0,1,4
61865,6,3,216980,216980,216983,0,3,5
61866,2,1,216982,216983,216984,1,2,0
61867,2,1,216984,216984,216985,0,1,0
61868,6,3,216990,216990,216993,0,3,5
61869,1,3,216991,216993,216996,2,5,0
61870,4,2,216995,216996,216998,1,3,0
61871,1,2,216996,216998,217000,2,4,0
61872,5,2,217001,217001,217003,0,2,1
61873,4,2,217005,217005,217007,0,2,2
61874,5,2,217010,217010,217012,0,2,3
61875,6,1,217016,217016,217017,0,1,4
61876,4,3,217020,217020,217023,0,3,3
61877,5,2,217025,217025,217027,0,2,2
61878,2,3,217027,217027,217030,0,3,0
61879,1,1,217028,217030,217031,2,3,0
61880,5,1,217033,217033,217034,0,1,2
61881,4,3,217037,217037,217040,0,3,3
61882,4,1,217041,217041,217042,0,1,1
61883,3,2,217044,217044,217046,0,2,2
61884,4,3,217048,217048,217051,0,3,2
61885,6,1,217054,217054,217055,0,1,3
61886,6,1,217060,217060,217061,0,1,5
61887,2,2,217062,217062,217064,0,2,1
61888,4,1,217066,217066,217067,0,1,2
61889,2,2,217068,217068,217070,0,2,1
61890,3,3,217071,217071,217074,0,3,1
61891,2,1,217073,217074,217075,1,2,0
61892,4,3,217077,217077,217080,0,3,2
61893,6,2,217083,217083,217085,0,2,3
61894,5,1,217088,217088,217089,0,1,3
61895,5,3,217093,217093,217096,0,3,4
61896,2,1,217095,217096,217097,1,2,0
61897,1,2,217096,217097,217099,1,3,0
61898,3,1,217099,217099,217100,0,1,0
61899,6,2,217105,217105,217107,0,2,5
61900,6,1,217111,217111,217112,0,1,4
61901,1,3,217112,217112,217115,0,3,0
61902,1,1,217113,217115,217116,2,3,0
61903,4,2,217117,217117,217119,0,2,1
61904,1,1,217118,217119,217120,1,2,0
61905,5,1,217123,217123,217124,0,1,3
61906,6,1,217129,217129,217130,0,1,5
61907,4,3,217133,217133,217136,0,3,3
61908,4,2,217137,217137,217139,0,2,1
61909,1,2,217138,217139,217141,1,3,0
61910,5,3,217143,217143,217146,0,3,2
61911,4,2,217147,217147,217149,0,2,1
61912,6,2,217153,217153,217155,0,2,4
61913,6,1,217159,217159,217160,0,1,4
61914,1,2,217160,217160,217162,0,2,0
61915,6,1,217166,217166,217167,0,1,4
61916,1,3,217167,217167,217170,0,3,0
61917,4,2,217171,217171,217173,0,2,1
61918,5,1,217176,217176,217177,0,1,3
61919,6,3,217182,217182,217185,0,3,5
61920,4,1,217186,217186,217187,0,1,1
61921,3,2,217189,217189,217191,0,2,2
61922,5,1,217194,217194,217195,0,1,3
61923,5,1,217199,217199,217200,0,1,4
61924,1,3,217200,217200,217203,0,3,0
61925,3,3,217203,217203,217206,0,3,0
61926,5,3,217208,217208,217211,0,3,2
61927,1,1,217209,217211,217212,2,3,0
61928,5,1,217214,217214,217215,0,1,2
61929,4,3,217218,217218,217221,0,3,3
61930,3,2,217221,217221,217223,0,2,0
61931,3,2,217224,217224,217226,0,2,1
61932,4,2,217228,217228,217230,0,2,2
61933,2,3,217230,217230,217233,0,3,0
61934,2,3,217232,217233,217236,1,4,0
61935,4,3,217236,217236,217239,0,3,0
61936,5,3,217241,217241,217244,0,3,2
61937,2,2,217243,217244,217246,1,3,0
61938,1,2,217244,217246,217248,2,4,0
61939,2,1,217246,217248,217249,2,3,0
61940,6,2,217252,217252,217254,0,2,3
61941,3,2,217255,217255,217257,0,2,1
61942,3,1,217258,217258,217259,0,1,1
61943,4,1,217262,217262,217263,0,1,3
61944,5,1,217267,217267,217268,0,1,4
61945,4,2,217271,217271,217273,0,2,3
61946,5,2,217276,217276,217278,0,2,3
61947,6,2,217282,217282,217284,0,2,4
61948,1,3,217283,217284,217287,1,4,0
61949,5,1,217288,217288,217289,0,1,1
61950,2,1,217290,217290,217291,0,1,1
61951,4,3,217294,217294,217297,0,3,3
61952,6,2,217300,217300,217302,0,2,3
61953,1,3,217301,217302,217305,1,4,0
61954,2,1,217303,217305,217306,2,3,0
61955,2,1,217305,217306,217307,1,2,0
61956,5,2,217310,217310,217312,0,2,3
61957,3,2,217313,217313,217315,0,2,1
61958,6,2,217319,217319,217321,0,2,4
61959,6,3,217325,217325,217328,0,3,4
61960,5,3,217330,217330,217333,0,3,2
61961,5,3,217335,217335,217338,0,3,2
61962,1,2,217336,217338,217340,2,4,0
61963,4,3,217340,217340,217343,0,3,0
61964,5,3,217345,217345,217348,0,3,2
61965,3,2,217348,217348,217350,0,2,0
61966,6,2,217354,217354,217356,0,2,4
61967,2,3,217356,217356,217359,0,3,0
61968,4,3,217360,217360,217363,0,3,1
61969,1,1,217361,217363,217364,2,3,0
61970,4,1,217365,217365,217366,0,1,1
61971,1,1,217366,217366,217367,0,1,0
61972,4,3,217370,217370,217373,0,3,3
61973,2,3,217372,217373,217376,1,4,0
61974,4,1,217376,217376,217377,0,1,0
61975,1,2,217377,217377,217379,0,2,0
61976,4,1,217381,217381,217382,0,1,2
61977,6,1,217387,217387,217388,0,1,5
61978,4,2,217391,217391,217393,0,2,3
61979,1,2,217392,217393,217395,1,3,0
61980,4,1,217396,217396,217397,0,1,1
61981,6,2,217402,217402,217404,0,2,5
61982,3,2,217405,217405,217407,0,2,1
61983,6,1,217411,217411,217412,0,1,4
61984,5,1,217416,217416,217417,0,1,4
61985,5,1,217421,217421,217422,0,1,4
61986,1,3,217422,217422,217425,0,3,0
61987,2,3,217424,217425,217428,1,4,0
61988,2,3,217426,217428,217431,2,5,0
61989,1,1,217427,217431,217432,4,5,0
61990,4,1,217431,217432,217433,1,2,0
61991,6,2,217437,217437,217439,0,2,4
61992,2,1,217439,217439,217440,0,1,0
61993,6,3,217445,217445,217448,0,3,5
61994,1,2,217446,217448,217450,2,4,0
61995,3,2,217449,217450,217452,1,3,0
61996,3,2,217452,217452,217454,0,2,0
61997,3,1,217455,217455,217456,0,1,1
61998,5,2,217460,217460,217462,0,2,4
61999,6,3,217466,217466,217469,0,3,4
62000,3,3,217469,217469,217472,0,3,0
62001,3,3,217472,217472,217475,0,3,0
62002,2,3,217474,217475,217478,1,4,0
62003,3,1,217477,217478,217479,1,2,0
62004,2,3,217479,217479,217482,0,3,0
62005,1,2,217480,217482,217484,2,4,0
62006,3,2,217483,217484,217486,1,3,0
62007,3,3,217486,217486,217489,0,3,0
62008,4,3,217490,217490,217493,0,3,1
62009,4,1,217494,217494,217495,0,1,1
62010,1,1,217495,217495,217496,0,1,0
62011,1,2,217496,217496,217498,0,2,0
62012,3,1,217499,217499,217500,0,1,1
62013,3,2,217502,217502,217504,0,2,2
62014,3,3,217505,217505,217508,0,3,1
62015,6,3,217511,217511,217514,0,3,3
62016,5,3,217516,217516,217519,0,3,2
62017,2,3,217518,217519,217522,1,4,0
62018,5,1,217523,217523,217524,0,1,1
62019,2,1,217525,217525,217526,0,1,1
62020,5,2,217530,217530,217532,0,2,4
62021,5,2,217535,217535,217537,0,2,3
62022,1,3,217536,217537,217540,1,4,0
62023,3,1,217539,217540,217541,1,2,0
62024,3,3,217542,217542,217545,0,3,1
62025,6,1,217548,217548,217549,0,1,3
62026,2,1,217550,217550,217551,0,1,1
62027,1,1,217551,217551,217552,0,1,0
62028,2,2,217553,217553,217555,0,2,1
62029,3,2,217556,217556,217558,0,2,1
62030,3,2,217559,217559,217561,0,2,1
62031,4,3,217563,217563,217566,0,3,2
62032,4,2,217567,217567,217569,0,2,1
62033,2,3,217569,217569,217572,0,3,0
62034,2,3,217571,217572,217575,1,4,0
62035,1,1,217572,217575,217576,3,4,0
62036,3,3,217575,217576,217579,1,4,0
62037,5,2,217580,217580,217582,0,2,1
62038,2,3,217582,217582,217585,0,3,0
62039,5,2,217587,217587,217589,0,2,2
62040,1,2,217588,217589,217591,1,3,0
62041,3,3,217591,217591,217594,0,3,0
62042,2,3,217593,217594,217597,1,4,0
62043,4,2,217597,217597,217599,0,2,0
62044,2,2,217599,217599,217601,0,2,0
62045,4,2,217603,217603,217605,0,2,2
62046,3,3,217606,217606,217609,0,3,1
62047,2,2,217608,217609,217611,1,3,0
62048,1,1,217609,217611,217612,2,3,0
62049,1,2,217610,217612,217614,2,4,0
62050,4,1,217614,217614,217615,0,1,0
62051,4,2,217618,217618,217620,0,2,3
62052,6,2,217624,217624,217626,0,2,4
62053,6,2,217630,217630,217632,0,2,4
62054,2,3,217632,217632,217635,0,3,0
62055,2,2,217634,217635,217637,1,3,0
62056,1,2,217635,217637,217639,2,4,0
62057,4,1,217639,217639,217640,0,1,0
62058,1,2,217640,217640,217642,0,2,0
62059,4,2,217644,217644,217646,0,2,2
62060,1,1,217645,217646,217647,1,2,0
62061,3,1,217648,217648,217649,0,1,1
62062,1,3,217649,217649,217652,0,3,0
62063,2,2,217651,217652,217654,1,3,0
62064,6,1,217657,217657,217658,0,1,3
62065,1,1,217658,217658,217659,0,1,0
62066,4,3,217662,217662,217665,0,3,3
62067,2,3,217664,217665,217668,1,4,0
62068,2,3,217666,217668,217671,2,5,0
62069,6,2,217672,217672,217674,0,2,1
62070,6,2,217678,217678,217680,0,2,4
62071,3,2,217681,217681,217683,0,2,1
62072,3,2,217684,217684,217686,0,2,1
62073,1,2,217685,217686,217688,1,3,0
62074,1,1,217686,217688,217689,2,3,0
62075,1,1,217687,217689,217690,2,3,0
62076,5,3,217692,217692,217695,0,3,2
62077,2,3,217694,217695,217698,1,4,0
62078,4,3,217698,217698,217701,0,3,0
62079,2,1,217700,217701,217702,1,2,0
62080,4,3,217704,217704,217707,0,3,2
62081,2,3,217706,217707,217710,1,4,0
62082,5,1,217711,217711,217712,0,1,1
62083,2,2,217713,217713,217715,0,2,1
62084,3,3,217716,217716,217719,0,3,1
62085,1,1,217717,217719,217720,2,3,0
62086,3,2,217720,217720,217722,0,2,0
62087,3,2,217723,217723,217725,0,2,1
62088,1,1,217724,217725,217726,1,2,0
62089,5,3,217729,217729,217732,0,3,3
62090,5,3,217734,217734,217737,0,3,2
62091,3,1,217737,217737,217738,0,1,0
62092,3,3,217740,217740,217743,0,3,2
62093,4,1,217744,217744,217745,0,1,1
62094,4,3,217748,217748,217751,0,3,3
62095,2,3,217750,217751,217754,1,4,0
62096,1,1,217751,217754,217755,3,4,0
62097,1,1,217752,217755,217756,3,4,0
62098,2,3,217754,217756,217759,2,5,0
62099,1,1,217755,217759,217760,4,5,0
62100,2,1,217757,217760,217761,3,4,0
62101,6,1,217763,217763,217764,0,1,2
62102,5,1,217768,217768,217769,0,1,4
62103,5,3,217773,217773,217776,0,3,4
62104,2,2,217775,217776,217778,1,3,0
62105,1,1,217776,217778,217779,2,3,0
62106,3,3,217779,217779,217782,0,3,0
62107,2,2,217781,217782,217784,1,3,0
62108,6,3,217787,217787,217790,0,3,3
62109,5,2,217792,217792,217794,0,2,2
62110,2,3,217794,217794,217797,0,3,0
62111,1,1,217795,217797,217798,2,3,0
62112,3,2,217798,217798,217800,0,2,0
62113,1,1,217799,217800,217801,1,2,0
62114,3,1,217802,217802,217803,0,1,1
62115,6,3,217808,217808,217811,0,3,5
62116,5,1,217813,217813,217814,0,1,2
62117,2,1,217815,217815,217816,0,1,1
62118,5,2,217820,217820,217822,0,2,4
62119,6,3,217826,217826,217829,0,3,4
62120,3,2,217829,217829,217831,0,2,0
62121,1,1,217830,217831,217832,1,2,0
62122,1,1,217831,217832,217833,1,2,0
62123,5,3,217836,217836,217839,0,3,3
62124,3,3,217839,217839,217842,0,3,0
62125,2,3,217841,217842,217845,1,4,0
62126,5,1,217846,217846,217847,0,1,1
62127,2,3,217848,217848,217851,0,3,1
62128,4,2,217852,217852,217854,0,2,1
62129,3,2,217855,217855,217857,0,2,1
62130,4,2,217859,217859,217861,0,2,2
62131,2,3,217861,217861,217864,0,3,0
62132,5,3,217866,217866,217869,0,3,2
62133,3,1,217869,217869,217870,0,1,0
62134,3,2,217872,217872,217874,0,2,2
62135,6,2,217878,217878,217880,0,2,4
62136,1,2,217879,217880,217882,1,3,0
62137,3,2,217882,217882,217884,0,2,0
62138,6,2,217888,217888,217890,0,2,4
62139,6,1,217894,217894,217895,0,1,4
62140,4,1,217898,217898,217899,0,1,3
62141,3,3,217901,217901,217904,0,3,2
62142,1,1,217902,217904,217905,2,3,0
62143,2,1,217904,217905,217906,1,2,0
62144,2,2,217906,217906,217908,0,2,0
62145,2,2,217908,217908,217910,0,2,0
62146,5,2,217913,217913,217915,0,2,3
62147,1,1,217914,217915,217916,1,2,0
62148,1,3,217915,217916,217919,1,4,0
62149,1,3,217916,217919,217922,3,6,0
62150,1,1,217917,217922,217923,5,6,0
62151,6,1,217923,217923,217924,0,1,0
62152,6,2,217929,217929,217931,0,2,5
62153,3,2,217932,217932,217934,0,2,1
62154,4,1,217936,217936,217937,0,1,2
62155,4,1,217940,217940,217941,0,1,3
62156,6,3,217946,217946,217949,0,3,5
62157,2,2,217948,217949,217951,1,3,0
62158,5,2,217953,217953,217955,0,2,2
62159,3,1,217956,217956,217957,0,1,1
62160,1,2,217957,217957,217959,0,2,0
62161,4,1,217961,217961,217962,0,1,2
62162,5,2,217966,217966,217968,0,2,4
62163,4,2,217970,217970,217972,0,2,2
62164,6,2,217976,217976,217978,0,2,4
62165,5,1,217981,217981,217982,0,1,3
62166,6,3,217987,217987,217990,0,3,5
62167,6,2,217993,217993,217995,0,2,3
62168,3,1,217996,217996,217997,0,1,1
62169,2,2,217998,217998,218000,0,2,1
62170,6,1,218004,218004,218005,0,1,4
62171,4,2,218008,218008,218010,0,2,3
62172,6,2,218014,218014,218016,0,2,4
62173,1,2,218015,218016,218018,1,3,0
62174,5,3,218020,218020,218023,0,3,2
62175,4,3,218024,218024,218027,0,3,1
62176,5,1,218029,218029,218030,0,1,2
62177,2,2,218031,218031,218033,0,2,1
62178,1,3,218032,218033,218036,1,4,0
62179,1,1,218033,218036,218037,3,4,0
62180,3,2,218036,218037,218039,1,3,0
62181,6,1,218042,218042,218043,0,1,3
62182,5,3,218047,218047,218050,0,3,4
62183,5,1,218052,218052,218053,0,1,2
62184,2,1,218054,218054,218055,0,1,1
62185,3,3,218057,218057,218060,0,3,2
62186,5,1,218062,218062,218063,0,1,2
62187,2,2,218064,218064,218066,0,2,1
62188,4,2,218068,218068,218070,0,2,2
62189,1,1,218069,218070,218071,1,2,0
62190,6,1,218075,218075,218076,0,1,4
62191,6,2,218081,218081,218083,0,2,5
62192,3,1,218084,218084,218085,0,1,1
62193,4,3,218088,218088,218091,0,3,3
62194,5,2,218093,218093,218095,0,2,2
62195,3,3,218096,218096,218099,0,3,1
62196,3,1,218099,218099,218100,0,1,0
62197,2,2,218101,218101,218103,0,2,1
62198,1,1,218102,218103,218104,1,2,0
62199,6,2,218108,218108,218110,0,2,4
62200,2,2,218110,218110,218112,0,2,0
62201,2,2,218112,218112,218114,0,2,0
62202,5,3,218117,218117,218120,0,3,3
62203,1,1,218118,218120,218121,2,3,0
62204,2,2,218120,218121,218123,1,3,0
62205,4,2,218124,218124,218126,0,2,1
62206,1,2,218125,218126,218128,1,3,0
62207,2,3,218127,218128,218131,1,4,0
62208,4,3,218131,218131,218134,0,3,0
62209,6,3,218137,218137,218140,0,3,3
62210,6,2,218143,218143,218145,0,2,3
62211,1,1,218144,218145,218146,1,2,0
62212,4,3,218148,218148,218151,0,3,2
62213,5,1,218153,218153,218154,0,1,2
62214,3,1,218156,218156,218157,0,1,2
62215,6,3,218162,218162,218165,0,3,5
62216,3,2,218165,218165,218167,0,2,0
62217,1,1,218166,218167,218168,1,2,0
62218,4,2,218170,218170,218172,0,2,2
62219,6,3,218176,218176,218179,0,3,4
62220,1,2,218177,218179,218181,2,4,0
62221,3,1,218180,218181,218182,1,2,0
62222,4,1,218184,218184,218185,0,1,2
62223,3,2,218187,218187,218189,0,2,2
62224,1,2,218188,218189,218191,1,3,0
62225,6,1,218194,218194,218195,0,1,3
62226,5,3,218199,218199,218202,0,3,4
62227,5,1,218204,218204,218205,0,1,2
62228,2,2,218206,218206,218208,0,2,1
62229,2,3,218208,218208,218211,0,3,0
62230,4,3,218212,218212,218215,0,3,1
62231,6,2,218218,218218,218220,0,2,3
62232,3,1,218221,218221,218222,0,1,1
62233,3,3,218224,218224,218227,0,3,2
62234,1,2,218225,218227,218229,2,4,0
62235,3,1,218228,218229,218230,1,2,0
62236,1,3,218229,218230,218233,1,4,0
62237,3,2,218232,218233,218235,1,3,0
62238,5,3,218237,218237,218240,0,3,2
62239,6,1,218243,218243,218244,0,1,3
62240,2,3,218245,218245,218248,0,3,1
62241,4,2,218249,218249,218251,0,2,1
62242,2,1,218251,218251,218252,0,1,0
62243,1,1,218252,218252,218253,0,1,0
62244,3,1,218255,218255,218256,0,1,2
62245,4,1,218259,218259,218260,0,1,3
62246,3,1,218262,218262,218263,0,1,2
62247,2,2,218264,218264,218266,0,2,1
62248,6,2,218270,218270,218272,0,2,4
62249,3,1,218273,218273,218274,0,1,1
62250,1,1,218274,218274,218275,0,1,0
62251,3,2,218277,218277,218279,0,2,2
62252,2,3,218279,218279,218282,0,3,0
62253,4,3,218283,218283,218286,0,3,1
62254,3,1,218286,218286,218287,0,1,0
62255,3,3,218289,218289,218292,0,3,2
62256,4,3,218293,218293,218296,0,3,1
62257,1,1,218294,218296,218297,2,3,0
62258,4,1,218298,218298,218299,0,1,1
62259,3,1,218301,218301,218302,0,1,2
62260,1,3,218302,218302,218305,0,3,0
62261,1,2,218303,218305,218307,2,4,0
62262,6,3,218309,218309,218312,0,3,2
62263,2,2,218311,218312,218314,1,3,0
62264,2,2,218313,218314,218316,1,3,0
62265,6,3,218319,218319,218322,0,3,3
62266,3,3,218322,218322,218325,0,3,0
62267,3,3,218325,218325,218328,0,3,0
62268,6,2,218331,218331,218333,0,2,3
62269,3,1,218334,218334,218335,0,1,1
62270,3,1,218337,218337,218338,0,1,2
62271,6,3,218343,218343,218346,0,3,5
62272,3,1,218346,218346,218347,0,1,0
62273,2,1,218348,218348,218349,0,1,1
62274,4,3,218352,218352,218355,0,3,3
62275,5,3,218357,218357,218360,0,3,2
62276,5,3,218362,218362,218365,0,3,2
62277,4,2,218366,218366,218368,0,2,1
62278,3,3,218369,218369,218372,0,3,1
62279,5,3,218374,218374,218377,0,3,2
62280,3,3,218377,218377,218380,0,3,0
62281,5,2,218382,218382,218384,0,2,2
62282,6,2,218388,218388,218390,0,2,4
62283,4,2,218392,218392,218394,0,2,2
62284,5,3,218397,218397,218400,0,3,3
62285,4,1,218401,218401,218402,0,1,1
62286,1,3,218402,218402,218405,0,3,0
62287,2,1,218404,218405,218406,1,2,0
62288,3,3,218407,218407,218410,0,3,1
62289,4,3,218411,218411,218414,0,3,1
62290,6,1,218417,218417,218418,0,1,3
62291,4,3,218421,218421,218424,0,3,3
62292,1,1,218422,218424,218425,2,3,0
62293,6,2,218428,218428,218430,0,2,3
62294,1,2,218429,218430,218432,1,3,0
62295,2,1,218431,218432,218433,1,2,0
62296,3,3,218434,218434,218437,0,3,1
62297,6,3,218440,218440,218443,0,3,3
62298,5,2,218445,218445,218447,0,2,2
62299,6,2,218451,218451,218453,0,2,4
62300,6,3,218457,218457,218460,0,3,4
62301,1,2,218458,218460,218462,2,4,0
62302,1,3,218459,218462,218465,3,6,0
62303,3,2,218462,218465,218467,3,5,0
62304,3,3,218465,218467,218470,2,5,0
62305,1,1,218466,218470,218471,4,5,0
62306,5,2,218471,218471,218473,0,2,0
62307,4,2,218475,218475,218477,0,2,2
62308,3,1,218478,218478,218479,0,1,1
62309,5,3,218483,218483,218486,0,3,4
62310,4,2,218487,218487,218489,0,2,1
62311,6,1,218493,218493,218494,0,1,4
62312,4,1,218497,218497,218498,0,1,3
62313,1,1,218498,218498,218499,0,1,0
62314,6,3,218504,218504,218507,0,3,5
62315,2,2,218506,218507,218509,1,3,0
62316,2,2,218508,218509,218511,1,3,0
62317,1,3,218509,218511,218514,2,5,0
62318,5,1,218514,218514,218515,0,1,0
62319,2,1,218516,218516,218517,0,1,1
62320,3,1,218519,218519,218520,0,1,2
62321,3,3,218522,218522,218525,0,3,2
62322,1,3,218523,218525,218528,2,5,0
62323,2,3,218525,218528,218531,3,6,0
62324,3,3,218528,218531,218534,3,6,0
62325,4,1,218532,218534,218535,2,3,0
62326,6,3,218538,218538,218541,0,3,3
62327,4,2,218542,218542,218544,0,2,1
62328,5,3,218547,218547,218550,0,3,3
62329,4,3,218551,218551,218554,0,3,1
62330,3,1,218554,218554,218555,0,1,0
62331,1,3,218555,218555,218558,0,3,0
62332,3,3,218558,218558,218561,0,3,0
62333,3,1,218561,218561,218562,0,1,0
62334,5,2,218566,218566,218568,0,2,4
62335,1,2,218567,218568,218570,1,3,0
62336,3,1,218570,218570,218571,0,1,0
62337,3,3,218573,218573,218576,0,3,2
62338,6,1,218579,218579,218580,0,1,3
62339,6,1,218585,218585,218586,0,1,5
62340,2,3,218587,218587,218590,0,3,1
62341,6,2,218593,218593,218595,0,2,3
62342,1,3,218594,218595,218598,1,4,0
62343,2,2,218596,218598,218600,2,4,0
62344,3,3,218599,218600,218603,1,4,0
62345,3,2,218602,218603,218605,1,3,0
62346,5,1,218607,218607,218608,0,1,2
62347,5,2,218612,218612,218614,0,2,4
62348,3,2,218615,218615,218617,0,2,1
62349,4,2,218619,218619,218621,0,2,2
62350,6,2,218625,218625,218627,0,2,4
62351,3,3,218628,218628,218631,0,3,1
62352,3,1,218631,218631,218632,0,1,0
62353,6,2,218637,218637,218639,0,2,5
62354,3,1,218640,218640,218641,0,1,1
62355,3,3,218643,218643,218646,0,3,2
62356,4,1,218647,218647,218648,0,1,1
62357,1,2,218648,218648,218650,0,2,0
62358,3,1,218651,218651,218652,0,1,1
62359,6,3,218657,218657,218660,0,3,5
62360,5,3,218662,218662,218665,0,3,2
62361,2,2,218664,218665,218667,1,3,0
62362,2,2,218666,218667,218669,1,3,0
62363,3,1,218669,218669,218670,0,1,0
62364,1,2,218670,218670,218672,0,2,0
62365,1,1,218671,218672,218673,1,2,0
62366,6,3,218677,218677,218680,0,3,4
62367,6,3,218683,218683,218686,0,3,3
62368,5,2,218688,218688,218690,0,2,2
62369,4,2,218692,218692,218694,0,2,2
62370,2,3,218694,218694,218697,0,3,0
62371,4,1,218698,218698,218699,0,1,1
62372,4,2,218702,218702,218704,0,2,3
62373,2,3,218704,218704,218707,0,3,0
62374,3,2,218707,218707,218709,0,2,0
62375,3,3,218710,218710,218713,0,3,1
62376,4,2,218714,218714,218716,0,2,1
62377,4,3,218718,218718,218721,0,3,2
62378,5,1,218723,218723,218724,0,1,2
62379,2,3,218725,218725,218728,0,3,1
62380,5,1,218730,218730,218731,0,1,2
62381,6,1,218736,218736,218737,0,1,5
62382,5,1,218741,218741,218742,0,1,4
62383,4,1,218745,218745,218746,0,1,3
62384,5,2,218750,218750,218752,0,2,4
62385,4,3,218754,218754,218757,0,3,2
62386,1,3,218755,218757,218760,2,5,0
62387,2,1,218757,218760,218761,3,4,0
62388,5,3,218762,218762,218765,0,3,1
62389,5,3,218767,218767,218770,0,3,2
62390,5,3,218772,218772,218775,0,3,2
62391,4,2,218776,218776,218778,0,2,1
62392,1,2,218777,218778,218780,1,3,0
62393,2,3,218779,218780,218783,1,4,0
62394,1,2,218780,218783,218785,3,5,0
62395,3,2,218783,218785,218787,2,4,0
62396,2,1,218785,218787,218788,2,3,0
62397,5,3,218790,218790,218793,0,3,2
62398,3,3,218793,218793,218796,0,3,0
62399,2,1,218795,218796,218797,1,2,0
62400,3,3,218798,218798,218801,0,3,1
62401,4,3,218802,218802,218805,0,3,1
62402,5,2,218807,218807,218809,0,2,2
62403,2,3,218809,218809,218812,0,3,0
62404,6,3,218815,218815,218818,0,3,3
62405,4,2,218819,218819,218821,0,2,1
62406,3,1,218822,218822,218823,0,1,1
62407,3,3,218825,218825,218828,0,3,2
62408,4,3,218829,218829,218832,0,3,1
62409,5,3,218834,218834,218837,0,3,2
62410,6,1,218840,218840,218841,0,1,3
62411,3,2,218843,218843,218845,0,2,2
62412,5,1,218848,218848,218849,0,1,3
62413,6,2,218854,218854,218856,0,2,5
62414,5,3,218859,218859,218862,0,3,3
62415,4,3,218863,218863,218866,0,3,1
62416,5,2,218868,218868,218870,0,2,2
62417,1,2,218869,218870,218872,1,3,0
62418,3,1,218872,218872,218873,0,1,0
62419,5,1,218877,218877,218878,0,1,4
62420,6,3,218883,218883,218886,0,3,5
62421,3,2,218886,218886,218888,0,2,0
62422,5,2,218891,218891,218893,0,2,3
62423,6,3,218897,218897,218900,0,3,4
62424,3,1,218900,218900,218901,0,1,0
62425,2,3,218902,218902,218905,0,3,1
62426,6,2,218908,218908,218910,0,2,3
62427,5,1,218913,218913,218914,0,1,3
62428,1,1,218914,218914,218915,0,1,0
62429,4,2,218918,218918,218920,0,2,3
62430,4,1,218922,218922,218923,0,1,2
62431,5,1,218927,218927,218928,0,1,4
62432,1,3,218928,218928,218931,0,3,0
62433,5,2,218933,218933,218935,0,2,2
62434,4,3,218937,218937,218940,0,3,2
62435,1,2,218938,218940,218942,2,4,0
62436,3,3,218941,218942,218945,1,4,0
62437,1,2,218942,218945,218947,3,5,0
62438,3,1,218945,218947,218948,2,3,0
62439,4,2,218949,218949,218951,0,2,1
62440,2,1,218951,218951,218952,0,1,0
62441,5,3,218956,218956,218959,0,3,4
62442,3,1,218959,218959,218960,0,1,0
62443,6,1,218965,218965,218966,0,1,5
62444,3,2,218968,218968,218970,0,2,2
62445,1,3,218969,218970,218973,1,4,0
62446,1,1,218970,218973,218974,3,4,0
62447,4,2,218974,218974,218976,0,2,0
62448,5,2,218979,218979,218981,0,2,3
62449,1,1,218980,218981,218982,1,2,0
62450,5,2,218985,218985,218987,0,2,3
62451,3,1,218988,218988,218989,0,1,1
62452,6,3,218994,218994,218997,0,3,5
62453,3,2,218997,218997,218999,0,2,0
62454,6,1,219003,219003,219004,0,1,4
62455,1,2,219004,219004,219006,0,2,0
62456,1,3,219005,219006,219009,1,4,0
62457,5,2,219010,219010,219012,0,2,1
62458,3,3,219013,219013,219016,0,3,1
62459,4,1,219017,219017,219018,0,1,1
62460,5,3,219022,219022,219025,0,3,4
62461,1,2,219023,219025,219027,2,4,0
62462,2,1,219025,219027,219028,2,3,0
62463,3,2,219028,219028,219030,0,2,0
62464,4,3,219032,219032,219035,0,3,2
62465,1,2,219033,219035,219037,2,4,0
62466,3,1,219036,219037,219038,1,2,0
62467,2,1,219038,219038,219039,0,1,0
62468,6,1,219044,219044,219045,0,1,5
62469,4,1,219048,219048,219049,0,1,3
62470,2,1,219050,219050,219051,0,1,1
62471,6,2,219056,219056,219058,0,2,5
62472,1,1,219057,219058,219059,1,2,0
62473,6,2,219063,219063,219065,0,2,4
62474,4,1,219067,219067,219068,0,1,2
62475,5,3,219072,219072,219075,0,3,4
62476,1,2,219073,219075,219077,2,4,0
62477,5,1,219078,219078,219079,0,1,1
62478,6,1,219084,219084,219085,0,1,5
62479,1,2,219085,219085,219087,0,2,0
62480,2,1,219087,219087,219088,0,1,0
62481,3,3,219090,219090,219093,0,3,2
62482,4,2,219094,219094,219096,0,2,1
62483,3,3,219097,219097,219100,0,3,1
62484,4,1,219101,219101,219102,0,1,1
62485,3,3,219104,219104,219107,0,3,2
62486,5,3,219109,219109,219112,0,3,2
62487,1,2,219110,219112,219114,2,4,0
62488,1,2,219111,219114,219116,3,5,0
62489,2,3,219113,219116,219119,3,6,0
62490,6,1,219119,219119,219120,0,1,0
62491,3,3,219122,219122,219125,0,3,2
62492,1,3,219123,219125,219128,2,5,0
62493,5,2,219128,219128,219130,0,2,0
62494,3,1,219131,219131,219132,0,1,1
62495,5,1,219136,219136,219137,0,1,4
62496,5,2,219141,219141,219143,0,2,4
62497,5,3,219146,219146,219149,0,3,3
62498,4,2,219150,219150,219152,0,2,1
62499,4,2,219154,219154,219156,0,2,2
62500,3,1,219157,219157,219158,0,1,1
62501,3,2,219160,219160,219162,0,2,2
62502,2,3,219162,219162,219165,0,3,0
62503,4,1,219166,219166,219167,0,1,1
62504,4,2,219170,219170,219172,0,2,3
62505,1,1,219171,219172,219173,1,2,0
62506,1,1,219172,219173,219174,1,2,0
62507,4,2,219176,219176,219178,0,2,2
62508,4,2,219180,219180,219182,0,2,2
62509,2,2,219182,219182,219184,0,2,0
62510,6,3,219188,219188,219191,0,3,4
62511,3,3,219191,219191,219194,0,3,0
62512,3,1,219194,219194,219195,0,1,0
62513,6,3,219200,219200,219203,0,3,5
62514,3,1,219203,219203,219204,0,1,0
62515,1,2,219204,219204,219206,0,2,0
62516,3,2,219207,219207,219209,0,2,1
62517,5,3,219212,219212,219215,0,3,3
62518,4,3,219216,219216,219219,0,3,1
62519,5,1,219221,219221,219222,0,1,2
62520,3,3,219224,219224,219227,0,3,2
62521,5,3,219229,219229,219232,0,3,2
62522,1,3,219230,219232,219235,2,5,0
62523,5,3,219235,219235,219238,0,3,0
62524,6,2,219241,219241,219243,0,2,3
62525,5,2,219246,219246,219248,0,2,3
62526,4,3,219250,219250,219253,0,3,2
62527,1,3,219251,219253,219256,2,5,0
62528,3,1,219254,219256,219257,2,3,0
62529,5,3,219259,219259,219262,0,3,2
62530,4,1,219263,219263,219264,0,1,1
62531,4,2,219267,219267,219269,0,2,3
62532,4,1,219271,219271,219272,0,1,2
62533,1,2,219272,219272,219274,0,2,0
62534,6,3,219278,219278,219281,0,3,4
62535,2,1,219280,219281,219282,1,2,0
62536,2,2,219282,219282,219284,0,2,0
62537,4,3,219286,219286,219289,0,3,2
62538,6,1,219292,219292,219293,0,1,3
62539,4,3,219296,219296,219299,0,3,3
62540,2,2,219298,219299,219301,1,3,0
62541,4,3,219302,219302,219305,0,3,1
62542,2,3,219304,219305,219308,1,4,0
62543,4,3,219308,219308,219311,0,3,0
62544,4,3,219312,219312,219315,0,3,1
62545,2,1,219314,219315,219316,1,2,0
62546,5,3,219319,219319,219322,0,3,3
62547,1,3,219320,219322,219325,2,5,0
62548,3,3,219323,219325,219328,2,5,0
62549,4,1,219327,219328,219329,1,2,0
62550,5,2,219332,219332,219334,0,2,3
62551,6,1,219338,219338,219339,0,1,4
62552,5,3,219343,219343,219346,0,3,4
62553,2,1,219345,219346,219347,1,2,0
62554,2,2,219347,219347,219349,0,2,0
62555,2,2,219349,219349,219351,0,2,0
62556,1,2,219350,219351,219353,1,3,0
62557,6,2,219356,219356,219358,0,2,3
62558,3,2,219359,219359,219361,0,2,1
62559,5,2,219364,219364,219366,0,2,3
62560,2,1,219366,219366,219367,0,1,0
62561,6,3,219372,219372,219375,0,3,5
62562,6,2,219378,219378,219380,0,2,3
62563,2,3,219380,219380,219383,0,3,0
62564,2,1,219382,219383,219384,1,2,0
62565,4,2,219386,219386,219388,0,2,2
62566,5,3,219391,219391,219394,0,3,3
62567,1,1,219392,219394,219395,2,3,0
62568,6,2,219398,219398,219400,0,2,3
62569,5,1,219403,219403,219404,0,1,3
62570,2,1,219405,219405,219406,0,1,1
62571,2,3,219407,219407,219410,0,3,1
62572,3,2,219410,219410,219412,0,2,0
62573,6,1,219416,219416,219417,0,1,4
62574,3,3,219419,219419,219422,0,3,2
62575,6,3,219425,219425,219428,0,3,3
62576,2,1,219427,219428,219429,1,2,0
62577,1,2,219428,219429,219431,1,3,0
62578,3,2,219431,219431,219433,0,2,0
62579,4,1,219435,219435,219436,0,1,2
62580,5,1,219440,219440,219441,0,1,4
62581,2,2,219442,219442,219444,0,2,1
62582,4,2,219446,219446,219448,0,2,2
62583,3,1,219449,219449,219450,0,1,1
62584,5,3,219454,219454,219457,0,3,4
62585,6,3,219460,219460,219463,0,3,3
62586,6,2,219466,219466,219468,0,2,3
62587,5,2,219471,219471,219473,0,2,3
62588,5,3,219476,219476,219479,0,3,3
62589,1,3,219477,219479,219482,2,5,0
62590,4,3,219481,219482,219485,1,4,0
62591,3,3,219484,219485,219488,1,4,0
62592,1,1,219485,219488,219489,3,4,0
62593,4,2,219489,219489,219491,0,2,0
62594,6,3,219495,219495,219498,0,3,4
62595,1,2,219496,219498,219500,2,4,0
62596,4,1,219500,219500,219501,0,1,0
62597,4,1,219504,219504,219505,0,1,3
62598,6,1,219510,219510,219511,0,1,5
62599,6,2,219516,219516,219518,0,2,5
62600,2,2,219518,219518,219520,0,2,0
62601,6,1,219524,219524,219525,0,1,4
62602,6,3,219530,219530,219533,0,3,5
62603,4,2,219534,219534,219536,0,2,1
62604,5,1,219539,219539,219540,0,1,3
62605,4,2,219543,219543,219545,0,2,3
62606,3,3,219546,219546,219549,0,3,1
62607,1,1,219547,219549,219550,2,3,0
62608,5,2,219552,219552,219554,0,2,2
62609,4,2,219556,219556,219558,0,2,2
62610,5,3,219561,219561,219564,0,3,3
62611,4,2,219565,219565,219567,0,2,1
62612,4,2,219569,219569,219571,0,2,2
62613,6,1,219575,219575,219576,0,1,4
62614,3,3,219578,219578,219581,0,3,2
62615,5,3,219583,219583,219586,0,3,2
62616,6,1,219589,219589,219590,0,1,3
62617,5,1,219594,219594,219595,0,1,4
62618,2,3,219596,219596,219599,0,3,1
62619,1,2,219597,219599,219601,2,4,0
62620,1,3,219598,219601,219604,3,6,0
62621,5,3,219603,219604,219607,1,4,0
62622,4,1,219607,219607,219608,0,1,0
62623,6,1,219613,219613,219614,0,1,5
62624,2,2,219615,219615,219617,0,2,1
62625,5,3,219620,219620,219623,0,3,3
62626,5,2,219625,219625,219627,0,2,2
62627,1,3,219626,219627,219630,1,4,0
62628,5,3,219631,219631,219634,0,3,1
62629,5,1,219636,219636,219637,0,1,2
62630,4,2,219640,219640,219642,0,2,3
62631,2,2,219642,219642,219644,0,2,0
62632,2,2,219644,219644,219646,0,2,0
62633,2,2,219646,219646,219648,0,2,0
62634,3,2,219649,219649,219651,0,2,1
62635,5,2,219654,219654,219656,0,2,3
62636,2,3,219656,219656,219659,0,3,0
62637,1,3,219657,219659,219662,2,5,0
62638,6,2,219663,219663,219665,0,2,1
62639,5,2,219668,219668,219670,0,2,3
62640,5,2,219673,219673,219675,0,2,3
62641,3,3,219676,219676,219679,0,3,1
62642,3,1,219679,219679,219680,0,1,0
62643,1,1,219680,219680,219681,0,1,0
62644,5,2,219685,219685,219687,0,2,4
62645,5,2,219690,219690,219692,0,2,3
62646,1,3,219691,219692,219695,1,4,0
62647,1,2,219692,219695,219697,3,5,0
62648,6,3,219698,219698,219701,0,3,1
62649,6,1,219704,219704,219705,0,1,3
62650,4,2,219708,219708,219710,0,2,3
62651,3,1,219711,219711,219712,0,1,1
62652,2,3,219713,219713,219716,0,3,1
62653,6,1,219719,219719,219720,0,1,3
62654,2,1,219721,219721,219722,0,1,1
62655,6,3,219727,219727,219730,0,3,5
62656,6,1,219733,219733,219734,0,1,3
62657,1,3,219734,219734,219737,0,3,0
62658,5,2,219739,219739,219741,0,2,2
62659,2,3,219741,219741,219744,0,3,0
62660,2,1,219743,219744,219745,1,2,0
62661,4,2,219747,219747,219749,0,2,2
62662,1,3,219748,219749,219752,1,4,0
62663,2,2,219750,219752,219754,2,4,0
62664,3,1,219753,219754,219755,1,2,0
62665,5,1,219758,219758,219759,0,1,3
62666,4,3,219762,219762,219765,0,3,3
62667,3,1,219765,219765,219766,0,1,0
62668,1,3,219766,219766,219769,0,3,0
62669,3,3,219769,219769,219772,0,3,0
62670,4,1,219773,219773,219774,0,1,1
62671,1,2,219774,219774,219776,0,2,0
62672,5,1,219779,219779,219780,0,1,3
62673,2,3,219781,219781,219784,0,3,1
62674,2,3,219783,219784,219787,1,4,0
62675,1,1,219784,219787,219788,3,4,0
62676,4,3,219788,219788,219791,0,3,0
62677,4,3,219792,219792,219795,0,3,1
62678,6,3,219798,219798,219801,0,3,3
62679,5,2,219803,219803,219805,0,2,2
62680,3,1,219806,219806,219807,0,1,1
62681,5,2,219811,219811,219813,0,2,4
62682,1,2,219812,219813,219815,1,3,0
62683,5,3,219817,219817,219820,0,3,2
62684,1,2,219818,219820,219822,2,4,0
62685,5,1,219823,219823,219824,0,1,1
62686,3,2,219826,219826,219828,0,2,2
62687,2,2,219828,219828,219830,0,2,0
62688,5,2,219833,219833,219835,0,2,3
62689,4,3,219837,219837,219840,0,3,2
62690,4,1,219841,219841,219842,0,1,1
62691,4,2,219845,219845,219847,0,2,3
62692,1,1,219846,219847,219848,1,2,0
62693,4,3,219850,219850,219853,0,3,2
62694,5,2,219855,219855,219857,0,2,2
62695,2,3,219857,219857,219860,0,3,0
62696,3,2,219860,219860,219862,0,2,0
62697,1,3,219861,219862,219865,1,4,0
62698,6,3,219867,219867,219870,0,3,2
62699,4,2,219871,219871,219873,0,2,1
62700,3,1,219874,219874,219875,0,1,1
62701,5,1,219879,219879,219880,0,1,4
62702,2,2,219881,219881,219883,0,2,1
62703,3,3,219884,219884,219887,0,3,1
62704,6,3,219890,219890,219893,0,3,3
62705,1,1,219891,219893,219894,2,3,0
62706,1,1,219892,219894,219895,2,3,0
62707,6,1,219898,219898,219899,0,1,3
62708,6,1,219904,219904,219905,0,1,5
62709,1,1,219905,219905,219906,0,1,0
62710,2,3,219907,219907,219910,0,3,1
62711,2,3,219909,219910,219913,1,4,0
62712,5,2,219914,219914,219916,0,2,1
62713,3,3,219917,219917,219920,0,3,1
62714,1,2,219918,219920,219922,2,4,0
62715,6,2,219924,219924,219926,0,2,2
62716,2,3,219926,219926,219929,0,3,0
62717,4,1,219930,219930,219931,0,1,1
62718,6,1,219936,219936,219937,0,1,5
62719,3,2,219939,219939,219941,0,2,2
62720,2,3,219941,219941,219944,0,3,0
62721,2,1,219943,219944,219945,1,2,0
62722,5,1,219948,219948,219949,0,1,3
62723,1,1,219949,219949,219950,0,1,0
62724,2,1,219951,219951,219952,0,1,1
62725,1,3,219952,219952,219955,0,3,0
62726,5,1,219957,219957,219958,0,1,2
62727,2,1,219959,219959,219960,0,1,1
62728,1,1,219960,219960,219961,0,1,0
62729,3,2,219963,219963,219965,0,2,2
62730,1,1,219964,219965,219966,1,2,0
62731,6,3,219970,219970,219973,0,3,4
62732,2,3,219972,219973,219976,1,4,0
62733,1,3,219973,219976,219979,3,6,0
62734,4,3,219977,219979,219982,2,5,0
62735,2,1,219979,219982,219983,3,4,0
62736,5,1,219984,219984,219985,0,1,1
62737,6,2,219990,219990,219992,0,2,5
62738,4,2,219994,219994,219996,0,2,2
62739,2,2,219996,219996,219998,0,2,0
62740,3,2,219999,219999,220001,0,2,1
62741,4,1,220003,220003,220004,0,1,2
62742,1,1,220004,220004,220005,0,1,0
62743,3,3,220007,220007,220010,0,3,2
62744,4,1,220011,220011,220012,0,1,1
62745,2,1,220013,220013,220014,0,1,1
62746,3,2,220016,220016,220018,0,2,2
62747,3,3,220019,220019,220022,0,3,1
62748,6,3,220025,220025,220028,0,3,3
62749,6,1,220031,220031,220032,0,1,3
62750,5,3,220036,220036,220039,0,3,4
62751,6,2,220042,220042,220044,0,2,3
62752,3,3,220045,220045,220048,0,3,1
62753,2,1,220047,220048,220049,1,2,0
62754,4,3,220051,220051,220054,0,3,2
62755,5,1,220056,220056,220057,0,1,2
62756,5,1,220061,220061,220062,0,1,4
62757,5,3,220066,220066,220069,0,3,4
62758,6,2,220072,220072,220074,0,2,3
62759,1,3,220073,220074,220077,1,4,0
62760,6,1,220079,220079,220080,0,1,2
62761,4,3,220083,220083,220086,0,3,3
62762,6,1,220089,220089,220090,0,1,3
62763,2,3,220091,220091,220094,0,3,1
62764,6,2,220097,220097,220099,0,2,3
62765,4,1,220101,220101,220102,0,1,2
62766,4,1,220105,220105,220106,0,1,3
62767,3,1,220108,220108,220109,0,1,2
62768,1,1,220109,220109,220110,0,1,0
62769,1,1,220110,220110,220111,0,1,0
62770,1,3,220111,220111,220114,0,3,0
62771,2,3,220113,220114,220117,1,4,0
62772,5,3,220118,220118,220121,0,3,1
62773,5,3,220123,220123,220126,0,3,2
62774,4,1,220127,220127,220128,0,1,1
62775,5,2,220132,220132,220134,0,2,4
62776,6,2,220138,220138,220140,0,2,4
62777,2,1,220140,220140,220141,0,1,0
62778,5,1,220145,220145,220146,0,1,4
62779,6,2,220151,220151,220153,0,2,5
62780,4,3,220155,220155,220158,0,3,2
62781,5,3,220160,220160,220163,0,3,2
62782,5,1,220165,220165,220166,0,1,2
62783,6,2,220171,220171,220173,0,2,5
62784,3,1,220174,220174,220175,0,1,1
62785,5,2,220179,220179,220181,0,2,4
62786,5,1,220184,220184,220185,0,1,3
62787,6,3,220190,220190,220193,0,3,5
62788,3,2,220193,220193,220195,0,2,0
62789,5,2,220198,220198,220200,0,2,3
62790,4,1,220202,220202,220203,0,1,2
62791,3,3,220205,220205,220208,0,3,2
62792,4,2,220209,220209,220211,0,2,1
62793,6,3,220215,220215,220218,0,3,4
62794,1,1,220216,220218,220219,2,3,0
62795,3,1,220219,220219,220220,0,1,0
62796,4,1,220223,220223,220224,0,1,3
62797,3,3,220226,220226,220229,0,3,2
62798,5,2,220231,220231,220233,0,2,2
62799,3,3,220234,220234,220237,0,3,1
62800,3,2,220237,220237,220239,0,2,0
62801,5,3,220242,220242,220245,0,3,3
62802,6,2,220248,220248,220250,0,2,3
62803,5,3,220253,220253,220256,0,3,3
62804,5,3,220258,220258,220261,0,3,2
62805,4,2,220262,220262,220264,0,2,1
62806,4,2,220266,220266,220268,0,2,2
62807,2,2,220268,220268,220270,0,2,0
62808,1,3,220269,220270,220273,1,4,0
62809,6,2,220275,220275,220277,0,2,2
62810,5,1,220280,220280,220281,0,1,3
62811,6,3,220286,220286,220289,0,3,5
62812,1,3,220287,220289,220292,2,5,0
62813,4,3,220291,220292,220295,1,4,0
62814,5,2,220296,220296,220298,0,2,1
62815,1,1,220297,220298,220299,1,2,0
62816,3,3,220300,220300,220303,0,3,1
62817,1,1,220301,220303,220304,2,3,0
62818,5,1,220306,220306,220307,0,1,2
62819,1,3,220307,220307,220310,0,3,0
62820,5,1,220312,220312,220313,0,1,2
62821,3,2,220315,220315,220317,0,2,2
62822,5,2,220320,220320,220322,0,2,3
62823,1,3,220321,220322,220325,1,4,0
62824,5,2,220326,220326,220328,0,2,1
62825,4,3,220330,220330,220333,0,3,2
62826,2,2,220332,220333,220335,1,3,0
62827,2,3,220334,220335,220338,1,4,0
62828,1,3,220335,220338,220341,3,6,0
62829,3,3,220338,220341,220344,3,6,0
62830,4,1,220342,220344,220345,2,3,0
62831,4,3,220346,220346,220349,0,3,1
62832,3,3,220349,220349,220352,0,3,0
62833,4,3,220353,220353,220356,0,3,1
62834,6,3,220359,220359,220362,0,3,3
62835,5,2,220364,220364,220366,0,2,2
62836,2,3,220366,220366,220369,0,3,0
62837,5,3,220371,220371,220374,0,3,2
62838,3,1,220374,220374,220375,0,1,0
62839,2,3,220376,220376,220379,0,3,1
62840,4,3,220380,220380,220383,0,3,1
62841,3,3,220383,220383,220386,0,3,0
62842,4,1,220387,220387,220388,0,1,1
62843,4,2,220391,220391,220393,0,2,3
62844,2,3,220393,220393,220396,0,3,0
62845,5,3,220398,220398,220401,0,3,2
62846,6,3,220404,220404,220407,0,3,3
62847,5,1,220409,220409,220410,0,1,2
62848,4,3,220413,220413,220416,0,3,3
62849,2,3,220415,220416,220419,1,4,0
62850,1,3,220416,220419,220422,3,6,0
62851,6,3,220422,220422,220425,0,3,0
62852,2,2,220424,220425,220427,1,3,0
62853,1,3,220425,220427,220430,2,5,0
62854,1,3,220426,220430,220433,4,7,0
62855,6,2,220432,220433,220435,1,3,0
62856,3,1,220435,220435,220436,0,1,0
62857,3,3,220438,220438,220441,0,3,2
62858,1,3,220439,220441,220444,2,5,0
62859,4,1,220443,220444,220445,1,2,0
62860,5,2,220448,220448,220450,0,2,3
62861,4,2,220452,220452,220454,0,2,2
62862,5,2,220457,220457,220459,0,2,3
62863,2,1,220459,220459,220460,0,1,0
62864,4,1,220463,220463,220464,0,1,3
62865,6,2,220469,220469,220471,0,2,5
62866,5,2,220474,220474,220476,0,2,3
62867,6,2,220480,220480,220482,0,2,4
62868,2,2,220482,220482,220484,0,2,0
62869,6,1,220488,220488,220489,0,1,4
62870,2,3,220490,220490,220493,0,3,1
62871,2,3,220492,220493,220496,1,4,0
62872,5,2,220497,220497,220499,0,2,1
62873,2,3,220499,220499,220502,0,3,0
62874,1,2,220500,220502,220504,2,4,0
62875,1,1,220501,220504,220505,3,4,0
62876,2,3,220503,220505,220508,2,5,0
62877,5,1,220508,220508,220509,0,1,0
62878,6,1,220514,220514,220515,0,1,5
62879,4,1,220518,220518,220519,0,1,3
62880,6,2,220524,220524,220526,0,2,5
62881,3,1,220527,220527,220528,0,1,1
62882,3,1,220530,220530,220531,0,1,2
62883,3,3,220533,220533,220536,0,3,2
62884,6,3,220539,220539,220542,0,3,3
62885,5,1,220544,220544,220545,0,1,2
62886,2,1,220546,220546,220547,0,1,1
62887,6,1,220552,220552,220553,0,1,5
62888,2,1,220554,220554,220555,0,1,1
62889,2,1,220556,220556,220557,0,1,1
62890,4,1,220560,220560,220561,0,1,3
62891,6,2,220566,220566,220568,0,2,5
62892,4,2,220570,220570,220572,0,2,2
62893,1,3,220571,220572,220575,1,4,0
62894,2,2,220573,220575,220577,2,4,0
62895,3,3,220576,220577,220580,1,4,0
62896,5,2,220581,220581,220583,0,2,1
62897,4,2,220585,220585,220587,0,2,2
62898,5,1,220590,220590,220591,0,1,3
62899,5,1,220595,220595,220596,0,1,4
62900,1,2,220596,220596,220598,0,2,0
62901,1,1,220597,220598,220599,1,2,0
62902,6,2,220603,220603,220605,0,2,4
62903,2,2,220605,220605,220607,0,2,0
62904,3,1,220608,220608,220609,0,1,1
62905,4,3,220612,220612,220615,0,3,3
62906,2,1,220614,220615,220616,1,2,0
62907,1,2,220615,220616,220618,1,3,0
62908,6,3,220621,220621,220624,0,3,3
62909,2,2,220623,220624,220626,1,3,0
62910,1,1,220624,220626,220627,2,3,0
62911,2,2,220626,220627,220629,1,3,0
62912,6,2,220632,220632,220634,0,2,3
62913,2,2,220634,220634,220636,0,2,0
62914,4,3,220638,220638,220641,0,3,2
62915,3,2,220641,220641,220643,0,2,0
62916,1,3,220642,220643,220646,1,4,0
62917,6,1,220648,220648,220649,0,1,2
62918,6,2,220654,220654,220656,0,2,5
62919,4,3,220658,220658,220661,0,3,2
62920,6,3,220664,220664,220667,0,3,3
62921,5,1,220669,220669,220670,0,1,2
62922,2,1,220671,220671,220672,0,1,1
62923,1,2,220672,220672,220674,0,2,0
62924,2,2,220674,220674,220676,0,2,0
62925,1,1,220675,220676,220677,1,2,0
62926,4,2,220679,220679,220681,0,2,2
62927,5,2,220684,220684,220686,0,2,3
62928,5,3,220689,220689,220692,0,3,3
62929,3,3,220692,220692,220695,0,3,0
62930,5,3,220697,220697,220700,0,3,2
62931,2,3,220699,220700,220703,1,4,0
62932,6,3,220705,220705,220708,0,3,2
62933,1,3,220706,220708,220711,2,5,0
62934,1,1,220707,220711,220712,4,5,0
62935,5,1,220712,220712,220713,0,1,0
62936,4,3,220716,220716,220719,0,3,3
62937,5,3,220721,220721,220724,0,3,2
62938,3,2,220724,220724,220726,0,2,0
62939,2,1,220726,220726,220727,0,1,0
62940,4,3,220730,220730,220733,0,3,3
62941,3,3,220733,220733,220736,0,3,0
62942,3,2,220736,220736,220738,0,2,0
62943,5,2,220741,220741,220743,0,2,3
62944,2,1,220743,220743,220744,0,1,0
62945,2,1,220745,220745,220746,0,1,1
62946,2,1,220747,220747,220748,0,1,1
62947,3,3,220750,220750,220753,0,3,2
62948,2,2,220752,220753,220755,1,3,0
62949,3,3,220755,220755,220758,0,3,0
62950,1,2,220756,220758,220760,2,4,0
62951,3,3,220759,220760,220763,1,4,0
62952,5,3,220764,220764,220767,0,3,1
62953,2,1,220766,220767,220768,1,2,0
62954,4,2,220770,220770,220772,0,2,2
62955,1,2,220771,220772,220774,1,3,0
62956,2,3,220773,220774,220777,1,4,0
62957,1,2,220774,220777,220779,3,5,0
62958,3,2,220777,220779,220781,2,4,0
62959,2,1,220779,220781,220782,2,3,0
62960,2,2,220781,220782,220784,1,3,0
62961,6,2,220787,220787,220789,0,2,3
62962,4,2,220791,220791,220793,0,2,2
62963,2,2,220793,220793,220795,0,2,0
62964,3,3,220796,220796,220799,0,3,1
62965,4,1,220800,220800,220801,0,1,1
62966,1,3,220801,220801,220804,0,3,0
62967,6,2,220807,220807,220809,0,2,3
62968,1,2,220808,220809,220811,1,3,0
62969,5,3,220813,220813,220816,0,3,2
62970,6,2,220819,220819,220821,0,2,3
62971,6,1,220825,220825,220826,0,1,4
62972,4,3,220829,220829,220832,0,3,3
62973,3,1,220832,220832,220833,0,1,0
62974,3,3,220835,220835,220838,0,3,2
62975,1,1,220836,220838,220839,2,3,0
62976,5,1,220841,220841,220842,0,1,2
62977,6,1,220847,220847,220848,0,1,5
62978,6,3,220853,220853,220856,0,3,5
62979,3,3,220856,220856,220859,0,3,0
62980,2,2,220858,220859,220861,1,3,0
62981,2,1,220860,220861,220862,1,2,0
62982,1,2,220861,220862,220864,1,3,0
62983,3,3,220864,220864,220867,0,3,0
62984,1,1,220865,220867,220868,2,3,0
62985,3,2,220868,220868,220870,0,2,0
62986,1,1,220869,220870,220871,1,2,0
62987,2,2,220871,220871,220873,0,2,0
62988,6,1,220877,220877,220878,0,1,4
62989,5,2,220882,220882,220884,0,2,4
62990,5,2,220887,220887,220889,0,2,3
62991,5,2,220892,220892,220894,0,2,3
62992,3,3,220895,220895,220898,0,3,1
62993,6,2,220901,220901,220903,0,2,3
62994,1,1,220902,220903,220904,1,2,0
62995,3,2,220905,220905,220907,0,2,1
62996,3,2,220908,220908,220910,0,2,1
62997,6,3,220914,220914,220917,0,3,4
62998,6,1,220920,220920,220921,0,1,3
62999,1,2,220921,220921,220923,0,2,0
63000,2,3,220923,220923,220926,0,3,0
63001,2,1,220925,220926,220927,1,2,0
63002,1,3,220926,220927,220930,1,4,0
63003,4,3,220930,220930,220933,0,3,0
63004,1,3,220931,220933,220936,2,5,0
63005,2,1,220933,220936,220937,3,4,0
63006,5,1,220938,220938,220939,0,1,1
63007,1,3,220939,220939,220942,0,3,0
63008,2,1,220941,220942,220943,1,2,0
63009,5,2,220946,220946,220948,0,2,3
63010,6,1,220952,220952,220953,0,1,4
63011,3,1,220955,220955,220956,0,1,2
63012,3,1,220958,220958,220959,0,1,2
63013,3,1,220961,220961,220962,0,1,2
63014,4,1,220965,220965,220966,0,1,3
63015,6,2,220971,220971,220973,0,2,5
63016,1,2,220972,220973,220975,1,3,0
63017,2,1,220974,220975,220976,1,2,0
63018,1,1,220975,220976,220977,1,2,0
63019,2,1,220977,220977,220978,0,1,0
63020,5,3,220982,220982,220985,0,3,4
63021,1,3,220983,220985,220988,2,5,0
63022,1,3,220984,220988,220991,4,7,0
63023,6,1,220990,220991,220992,1,2,0
63024,4,1,220994,220994,220995,0,1,2
63025,4,2,220998,220998,221000,0,2,3
63026,1,3,220999,221000,221003,1,4,0
63027,5,2,221004,221004,221006,0,2,1
63028,3,2,221007,221007,221009,0,2,1
63029,4,3,221011,221011,221014,0,3,2
63030,6,2,221017,221017,221019,0,2,3
63031,4,1,221021,221021,221022,0,1,2
63032,3,1,221024,221024,221025,0,1,2
63033,1,1,221025,221025,221026,0,1,0
63034,6,1,221031,221031,221032,0,1,5
63035,5,2,221036,221036,221038,0,2,4
63036,4,3,221040,221040,221043,0,3,2
63037,2,3,221042,221043,221046,1,4,0
63038,1,1,221043,221046,221047,3,4,0
63039,1,3,221044,221047,221050,3,6,0
63040,3,3,221047,221050,221053,3,6,0
63041,4,3,221051,221053,221056,2,5,0
63042,6,2,221057,221057,221059,0,2,1
63043,4,2,221061,221061,221063,0,2,2
63044,6,3,221067,221067,221070,0,3,4
63045,5,1,221072,221072,221073,0,1,2
63046,3,2,221075,221075,221077,0,2,2
63047,6,1,221081,221081,221082,0,1,4
63048,3,1,221084,221084,221085,0,1,2
63049,4,1,221088,221088,221089,0,1,3
63050,1,3,221089,221089,221092,0,3,0
63051,2,1,221091,221092,221093,1,2,0
63052,2,2,221093,221093,221095,0,2,0
63053,2,1,221095,221095,221096,0,1,0
63054,5,3,221100,221100,221103,0,3,4
63055,4,1,221104,221104,221105,0,1,1
63056,1,2,221105,221105,221107,0,2,0
63057,4,1,221109,221109,221110,0,1,2
63058,4,3,221113,221113,221116,0,3,3
63059,2,1,221115,221116,221117,1,2,0
63060,2,1,221117,221117,221118,0,1,0
63061,5,2,221122,221122,221124,0,2,4
63062,6,3,221128,221128,221131,0,3,4
63063,4,3,221132,221132,221135,0,3,1
63064,1,2,221133,221135,221137,2,4,0
63065,4,2,221137,221137,221139,0,2,0
63066,2,2,221139,221139,221141,0,2,0
63067,5,1,221144,221144,221145,0,1,3
63068,3,2,221147,221147,221149,0,2,2
63069,5,3,221152,221152,221155,0,3,3
63070,5,2,221157,221157,221159,0,2,2
63071,5,3,221162,221162,221165,0,3,3
63072,6,2,221168,221168,221170,0,2,3
63073,4,1,221172,221172,221173,0,1,2
63074,3,1,221175,221175,221176,0,1,2
63075,4,2,221179,221179,221181,0,2,3
63076,3,2,221182,221182,221184,0,2,1
63077,1,2,221183,221184,221186,1,3,0
63078,2,2,221185,221186,221188,1,3,0
63079,3,3,221188,221188,221191,0,3,0
63080,6,1,221194,221194,221195,0,1,3
63081,2,3,221196,221196,221199,0,3,1
63082,1,2,221197,221199,221201,2,4,0
63083,1,3,221198,221201,221204,3,6,0
63084,2,2,221200,221204,221206,4,6,0
63085,2,2,221202,221206,221208,4,6,0
63086,3,3,221205,221208,221211,3,6,0
63087,1,1,221206,221211,221212,5,6,0
63088,5,1,221211,221212,221213,1,2,0
63089,1,3,221212,221213,221216,1,4,0
63090,4,3,221216,221216,221219,0,3,0
63091,3,3,221219,221219,221222,0,3,0
63092,3,2,221222,221222,221224,0,2,0
63093,2,2,221224,221224,221226,0,2,0
63094,2,1,221226,221226,221227,0,1,0
63095,4,3,221230,221230,221233,0,3,3
63096,5,1,221235,221235,221236,0,1,2
63097,2,1,221237,221237,221238,0,1,1
63098,6,3,221243,221243,221246,0,3,5
63099,4,3,221247,221247,221250,0,3,1
63100,3,3,221250,221250,221253,0,3,0
63101,3,3,221253,221253,221256,0,3,0
63102,5,2,221258,221258,221260,0,2,2
63103,3,3,221261,221261,221264,0,3,1
63104,5,2,221266,221266,221268,0,2,2
63105,1,3,221267,221268,221271,1,4,0
63106,1,1,221268,221271,221272,3,4,0
63107,1,1,221269,221272,221273,3,4,0
63108,4,1,221273,221273,221274,0,1,0
63109,6,2,221279,221279,221281,0,2,5
63110,4,2,221283,221283,221285,0,2,2
63111,2,1,221285,221285,221286,0,1,0
63112,6,2,221291,221291,221293,0,2,5
63113,5,2,221296,221296,221298,0,2,3
63114,4,3,221300,221300,221303,0,3,2
63115,4,1,221304,221304,221305,0,1,1
63116,2,2,221306,221306,221308,0,2,1
63117,2,1,221308,221308,221309,0,1,0
63118,5,1,221313,221313,221314,0,1,4
63119,3,2,221316,221316,221318,0,2,2
63120,5,2,221321,221321,221323,0,2,3
63121,5,3,221326,221326,221329,0,3,3
63122,1,2,221327,221329,221331,2,4,0
63123,1,1,221328,221331,221332,3,4,0
63124,6,1,221334,221334,221335,0,1,2
63125,3,1,221337,221337,221338,0,1,2
63126,4,3,221341,221341,221344,0,3,3
63127,4,2,221345,221345,221347,0,2,1
63128,4,2,221349,221349,221351,0,2,2
63129,4,2,221353,221353,221355,0,2,2
63130,5,2,221358,221358,221360,0,2,3
63131,4,2,221362,221362,221364,0,2,2
63132,1,1,221363,221364,221365,1,2,0
63133,5,2,221368,221368,221370,0,2,3
63134,2,3,221370,221370,221373,0,3,0
63135,1,2,221371,221373,221375,2,4,0
63136,1,2,221372,221375,221377,3,5,0
63137,4,1,221376,221377,221378,1,2,0
63138,3,2,221379,221379,221381,0,2,1
63139,6,3,221385,221385,221388,0,3,4
63140,2,3,221387,221388,221391,1,4,0
63141,6,1,221393,221393,221394,0,1,2
63142,4,1,221397,221397,221398,0,1,3
63143,5,3,221402,221402,221405,0,3,4
63144,5,1,221407,221407,221408,0,1,2
63145,5,3,221412,221412,221415,0,3,4
63146,6,2,221418,221418,221420,0,2,3
63147,1,1,221419,221420,221421,1,2,0
63148,2,3,221421,221421,221424,0,3,0
63149,2,1,221423,221424,221425,1,2,0
63150,6,1,221429,221429,221430,0,1,4
63151,3,1,221432,221432,221433,0,1,2
63152,6,1,221438,221438,221439,0,1,5
63153,1,2,221439,221439,221441,0,2,0
63154,1,3,221440,221441,221444,1,4,0
63155,2,3,221442,221444,221447,2,5,0
63156,5,1,221447,221447,221448,0,1,0
63157,2,2,221449,221449,221451,0,2,1
63158,3,1,221452,221452,221453,0,1,1
63159,3,1,221455,221455,221456,0,1,2
63160,4,3,221459,221459,221462,0,3,3
63161,4,1,221463,221463,221464,0,1,1
63162,2,3,221465,221465,221468,0,3,1
63163,5,3,221470,221470,221473,0,3,2
63164,5,3,221475,221475,221478,0,3,2
63165,3,2,221478,221478,221480,0,2,0
63166,2,1,221480,221480,221481,0,1,0
63167,1,3,221481,221481,221484,0,3,0
63168,6,2,221487,221487,221489,0,2,3
63169,6,1,221493,221493,221494,0,1,4
63170,4,1,221497,221497,221498,0,1,3
63171,6,1,221503,221503,221504,0,1,5
63172,2,1,221505,221505,221506,0,1,1
63173,6,1,221511,221511,221512,0,1,5
63174,2,3,221513,221513,221516,0,3,1
63175,5,3,221518,221518,221521,0,3,2
63176,3,1,221521,221521,221522,0,1,0
63177,3,1,221524,221524,221525,0,1,2
63178,2,3,221526,221526,221529,0,3,1
63179,2,3,221528,221529,221532,1,4,0
63180,6,3,221534,221534,221537,0,3,2
63181,1,1,221535,221537,221538,2,3,0
63182,4,3,221539,221539,221542,0,3,1
63183,6,1,221545,221545,221546,0,1,3
63184,5,1,221550,221550,221551,0,1,4
63185,2,3,221552,221552,221555,0,3,1
63186,1,3,221553,221555,221558,2,5,0
63187,6,1,221559,221559,221560,0,1,1
63188,1,1,221560,221560,221561,0,1,0
63189,6,2,221566,221566,221568,0,2,5
63190,5,1,221571,221571,221572,0,1,3
63191,4,1,221575,221575,221576,0,1,3
63192,6,2,221581,221581,221583,0,2,5
63193,6,1,221587,221587,221588,0,1,4
63194,4,1,221591,221591,221592,0,1,3
63195,5,2,221596,221596,221598,0,2,4
63196,1,3,221597,221598,221601,1,4,0
63197,4,2,221601,221601,221603,0,2,0
63198,5,1,221606,221606,221607,0,1,3
63199,1,1,221607,221607,221608,0,1,0
63200,5,1,221612,221612,221613,0,1,4
63201,3,2,221615,221615,221617,0,2,2
63202,6,1,221621,221621,221622,0,1,4
63203,4,1,221625,221625,221626,0,1,3
63204,6,3,221631,221631,221634,0,3,5
63205,3,1,221634,221634,221635,0,1,0
63206,5,1,221639,221639,221640,0,1,4
63207,6,1,221645,221645,221646,0,1,5
63208,5,1,221650,221650,221651,0,1,4
63209,4,3,221654,221654,221657,0,3,3
63210,1,2,221655,221657,221659,2,4,0
63211,5,1,221660,221660,221661,0,1,1
63212,2,3,221662,221662,221665,0,3,1
63213,1,2,221663,221665,221667,2,4,0
63214,4,3,221667,221667,221670,0,3,0
63215,2,2,221669,221670,221672,1,3,0
63216,1,1,221670,221672,221673,2,3,0
63217,3,3,221673,221673,221676,0,3,0
63218,5,1,221678,221678,221679,0,1,2
63219,2,3,221680,221680,221683,0,3,1
63220,1,1,221681,221683,221684,2,3,0
63221,2,1,221683,221684,221685,1,2,0
63222,1,3,221684,221685,221688,1,4,0
63223,4,2,221688,221688,221690,0,2,0
63224,6,2,221694,221694,221696,0,2,4
63225,2,1,221696,221696,221697,0,1,0
63226,5,3,221701,221701,221704,0,3,4
63227,5,3,221706,221706,221709,0,3,2
63228,5,1,221711,221711,221712,0,1,2
63229,3,1,221714,221714,221715,0,1,2
63230,2,3,221716,221716,221719,0,3,1
63231,3,1,221719,221719,221720,0,1,0
63232,2,2,221721,221721,221723,0,2,1
63233,4,2,221725,221725,221727,0,2,2
63234,5,1,221730,221730,221731,0,1,3
63235,6,3,221736,221736,221739,0,3,5
63236,5,3,221741,221741,221744,0,3,2
63237,1,2,221742,221744,221746,2,4,0
63238,1,1,221743,221746,221747,3,4,0
63239,1,2,221744,221747,221749,3,5,0
63240,5,3,221749,221749,221752,0,3,0
63241,2,1,221751,221752,221753,1,2,0
63242,3,3,221754,221754,221757,0,3,1
63243,1,3,221755,221757,221760,2,5,0
63244,4,3,221759,221760,221763,1,4,0
63245,2,1,221761,221763,221764,2,3,0
63246,2,3,221763,221764,221767,1,4,0
63247,2,3,221765,221767,221770,2,5,0
63248,3,3,221768,221770,221773,2,5,0
63249,3,3,221771,221773,221776,2,5,0
63250,4,2,221775,221776,221778,1,3,0
63251,2,2,221777,221778,221780,1,3,0
63252,4,2,221781,221781,221783,0,2,1
63253,2,1,221783,221783,221784,0,1,0
63254,4,3,221787,221787,221790,0,3,3
63255,6,3,221793,221793,221796,0,3,3
63256,4,1,221797,221797,221798,0,1,1
63257,5,1,221802,221802,221803,0,1,4
63258,5,3,221807,221807,221810,0,3,4
63259,4,3,221811,221811,221814,0,3,1
63260,3,2,221814,221814,221816,0,2,0
63261,2,2,221816,221816,221818,0,2,0
63262,6,2,221822,221822,221824,0,2,4
63263,1,2,221823,221824,221826,1,3,0
63264,2,2,221825,221826,221828,1,3,0
63265,3,2,221828,221828,221830,0,2,0
63266,6,3,221834,221834,221837,0,3,4
63267,2,2,221836,221837,221839,1,3,0
63268,5,1,221841,221841,221842,0,1,2
63269,2,1,221843,221843,221844,0,1,1
63270,1,1,221844,221844,221845,0,1,0
63271,2,1,221846,221846,221847,0,1,1
63272,2,1,221848,221848,221849,0,1,1
63273,5,3,221853,221853,221856,0,3,4
63274,1,2,221854,221856,221858,2,4,0
63275,3,2,221857,221858,221860,1,3,0
63276,4,1,221861,221861,221862,0,1,1
63277,3,3,221864,221864,221867,0,3,2
63278,1,3,221865,221867,221870,2,5,0
63279,3,3,221868,221870,221873,2,5,0
63280,2,2,221870,221873,221875,3,5,0
63281,6,3,221876,221876,221879,0,3,1
63282,5,3,221881,221881,221884,0,3,2
63283,5,1,221886,221886,221887,0,1,2
63284,2,1,221888,221888,221889,0,1,1
63285,3,3,221891,221891,221894,0,3,2
63286,5,3,221896,221896,221899,0,3,2
63287,5,3,221901,221901,221904,0,3,2
63288,2,2,221903,221904,221906,1,3,0
63289,4,1,221907,221907,221908,0,1,1
63290,3,1,221910,221910,221911,0,1,2
63291,5,1,221915,221915,221916,0,1,4
63292,6,1,221921,221921,221922,0,1,5
63293,5,1,221926,221926,221927,0,1,4
63294,4,1,221930,221930,221931,0,1,3
63295,1,1,221931,221931,221932,0,1,0
63296,2,2,221933,221933,221935,0,2,1
63297,6,1,221939,221939,221940,0,1,4
63298,5,2,221944,221944,221946,0,2,4
63299,1,3,221945,221946,221949,1,4,0
63300,2,3,221947,221949,221952,2,5,0
63301,3,1,221950,221952,221953,2,3,0
63302,3,3,221953,221953,221956,0,3,0
63303,4,3,221957,221957,221960,0,3,1
63304,1,1,221958,221960,221961,2,3,0
63305,5,1,221963,221963,221964,0,1,2
63306,6,2,221969,221969,221971,0,2,5
63307,3,1,221972,221972,221973,0,1,1
63308,5,1,221977,221977,221978,0,1,4
63309,5,3,221982,221982,221985,0,3,4
63310,1,3,221983,221985,221988,2,5,0
63311,4,2,221987,221988,221990,1,3,0
63312,3,2,221990,221990,221992,0,2,0
63313,1,1,221991,221992,221993,1,2,0
63314,4,3,221995,221995,221998,0,3,2
63315,6,1,222001,222001,222002,0,1,3
63316,3,3,222004,222004,222007,0,3,2
63317,3,2,222007,222007,222009,0,2,0
63318,1,1,222008,222009,222010,1,2,0
63319,5,2,222013,222013,222015,0,2,3
63320,5,1,222018,222018,222019,0,1,3
63321,5,1,222023,222023,222024,0,1,4
63322,5,3,222028,222028,222031,0,3,4
63323,3,3,222031,222031,222034,0,3,0
63324,1,1,222032,222034,222035,2,3,0
63325,6,1,222038,222038,222039,0,1,3
63326,2,1,222040,222040,222041,0,1,1
63327,4,2,222044,222044,222046,0,2,3
63328,5,2,222049,222049,222051,0,2,3
63329,5,2,222054,222054,222056,0,2,3
63330,3,3,222057,222057,222060,0,3,1
63331,4,1,222061,222061,222062,0,1,1
63332,3,3,222064,222064,222067,0,3,2
63333,1,3,222065,222067,222070,2,5,0
63334,4,2,222069,222070,222072,1,3,0
63335,4,2,222073,222073,222075,0,2,1
63336,6,1,222079,222079,222080,0,1,4
63337,6,1,222085,222085,222086,0,1,5
63338,5,1,222090,222090,222091,0,1,4
63339,5,1,222095,222095,222096,0,1,4
63340,6,1,222101,222101,222102,0,1,5
63341,5,3,222106,222106,222109,0,3,4
63342,5,3,222111,222111,222114,0,3,2
63343,4,3,222115,222115,222118,0,3,1
63344,4,3,222119,222119,222122,0,3,1
63345,5,3,222124,222124,222127,0,3,2
63346,1,1,222125,222127,222128,2,3,0
63347,5,2,222130,222130,222132,0,2,2
63348,4,3,222134,222134,222137,0,3,2
63349,3,1,222137,222137,222138,0,1,0
63350,4,1,222141,222141,222142,0,1,3
63351,5,1,222146,222146,222147,0,1,4
63352,1,3,222147,222147,222150,0,3,0
63353,3,2,222150,222150,222152,0,2,0
63354,1,3,222151,222152,222155,1,4,0
63355,6,2,222157,222157,222159,0,2,2
63356,5,1,222162,222162,222163,0,1,3
63357,5,2,222167,222167,222169,0,2,4
63358,1,3,222168,222169,222172,1,4,0
63359,2,3,222170,222172,222175,2,5,0
63360,5,2,222175,222175,222177,0,2,0
63361,2,3,222177,222177,222180,0,3,0
63362,2,2,222179,222180,222182,1,3,0
63363,5,3,222184,222184,222187,0,3,2
63364,3,2,222187,222187,222189,0,2,0
63365,4,2,222191,222191,222193,0,2,2
63366,5,1,222196,222196,222197,0,1,3
63367,1,3,222197,222197,222200,0,3,0
63368,4,3,222201,222201,222204,0,3,1
63369,3,1,222204,222204,222205,0,1,0
63370,1,3,222205,222205,222208,0,3,0
63371,4,1,222209,222209,222210,0,1,1
63372,5,1,222214,222214,222215,0,1,4
63373,3,2,222217,222217,222219,0,2,2
63374,5,1,222222,222222,222223,0,1,3
63375,3,1,222225,222225,222226,0,1,2
63376,1,3,222226,222226,222229,0,3,0
63377,2,3,222228,222229,222232,1,4,0
63378,3,1,222231,222232,222233,1,2,0
63379,5,1,222236,222236,222237,0,1,3
63380,5,2,222241,222241,222243,0,2,4
63381,4,3,222245,222245,222248,0,3,2
63382,3,3,222248,222248,222251,0,3,0
63383,4,3,222252,222252,222255,0,3,1
63384,3,3,222255,222255,222258,0,3,0
63385,1,2,222256,222258,222260,2,4,0
63386,4,1,222260,222260,222261,0,1,0
63387,5,1,222265,222265,222266,0,1,4
63388,4,1,222269,222269,222270,0,1,3
63389,4,2,222273,222273,222275,0,2,3
63390,3,3,222276,222276,222279,0,3,1
63391,3,2,222279,222279,222281,0,2,0
63392,1,2,222280,222281,222283,1,3,0
63393,2,2,222282,222283,222285,1,3,0
63394,5,2,222287,222287,222289,0,2,2
63395,2,1,222289,222289,222290,0,1,0
63396,3,2,222292,222292,222294,0,2,2
63397,3,3,222295,222295,222298,0,3,1
63398,2,3,222297,222298,222301,1,4,0
63399,2,1,222299,222301,222302,2,3,0
63400,1,1,222300,222302,222303,2,3,0
63401,4,1,222304,222304,222305,0,1,1
63402,2,1,222306,222306,222307,0,1,1
63403,5,1,222311,222311,222312,0,1,4
63404,6,2,222317,222317,222319,0,2,5
63405,2,1,222319,222319,222320,0,1,0
63406,2,2,222321,222321,222323,0,2,1
63407,4,2,222325,222325,222327,0,2,2
63408,4,3,222329,222329,222332,0,3,2
63409,1,2,222330,222332,222334,2,4,0
63410,1,1,222331,222334,222335,3,4,0
63411,2,1,222333,222335,222336,2,3,0
63412,4,3,222337,222337,222340,0,3,1
63413,3,2,222340,222340,222342,0,2,0
63414,6,2,222346,222346,222348,0,2,4
63415,3,2,222349,222349,222351,0,2,1
63416,3,3,222352,222352,222355,0,3,1
63417,2,3,222354,222355,222358,1,4,0
63418,1,3,222355,222358,222361,3,6,0
63419,2,2,222357,222361,222363,4,6,0
63420,4,3,222361,222363,222366,2,5,0
63421,6,3,222367,222367,222370,0,3,1
63422,6,1,222373,222373,222374,0,1,3
63423,5,2,222378,222378,222380,0,2,4
63424,4,3,222382,222382,222385,0,3,2
63425,4,3,222386,222386,222389,0,3,1
63426,2,2,222388,222389,222391,1,3,0
63427,3,2,222391,222391,222393,0,2,0
63428,6,3,222397,222397,222400,0,3,4
63429,4,2,222401,222401,222403,0,2,1
63430,6,3,222407,222407,222410,0,3,4
63431,1,2,222408,222410,222412,2,4,0
63432,4,2,222412,222412,222414,0,2,0
63433,5,1,222417,222417,222418,0,1,3
63434,1,3,222418,222418,222421,0,3,0
63435,3,2,222421,222421,222423,0,2,0
63436,1,1,222422,222423,222424,1,2,0
63437,1,1,222423,222424,222425,1,2,0
63438,4,2,222427,222427,222429,0,2,2
63439,4,2,222431,222431,222433,0,2,2
63440,5,1,222436,222436,222437,0,1,3
63441,2,1,222438,222438,222439,0,1,1
63442,5,1,222443,222443,222444,0,1,4
63443,5,1,222448,222448,222449,0,1,4
63444,6,2,222454,222454,222456,0,2,5
63445,4,3,222458,222458,222461,0,3,2
63446,2,3,222460,222461,222464,1,4,0
63447,3,2,222463,222464,222466,1,3,0
63448,2,3,222465,222466,222469,1,4,0
63449,2,2,222467,222469,222471,2,4,0
63450,3,2,222470,222471,222473,1,3,0
63451,1,1,222471,222473,222474,2,3,0
63452,3,2,222474,222474,222476,0,2,0
63453,6,2,222480,222480,222482,0,2,4
63454,1,1,222481,222482,222483,1,2,0
63455,5,3,222486,222486,222489,0,3,3
63456,3,1,222489,222489,222490,0,1,0
63457,2,1,222491,222491,222492,0,1,1
63458,3,2,222494,222494,222496,0,2,2
63459,5,1,222499,222499,222500,0,1,3
63460,6,3,222505,222505,222508,0,3,5
63461,3,3,222508,222508,222511,0,3,0
63462,2,1,222510,222511,222512,1,2,0
63463,2,2,222512,222512,222514,0,2,0
63464,6,2,222518,222518,222520,0,2,4
63465,5,3,222523,222523,222526,0,3,3
63466,2,3,222525,222526,222529,1,4,0
63467,6,3,222531,222531,222534,0,3,2
63468,4,1,222535,222535,222536,0,1,1
63469,4,2,222539,222539,222541,0,2,3
63470,1,1,222540,222541,222542,1,2,0
63471,2,1,222542,222542,222543,0,1,0
63472,6,3,222548,222548,222551,0,3,5
63473,3,3,222551,222551,222554,0,3,0
63474,2,1,222553,222554,222555,1,2,0
63475,6,2,222559,222559,222561,0,2,4
63476,3,3,222562,222562,222565,0,3,1
63477,2,1,222564,222565,222566,1,2,0
63478,6,3,222570,222570,222573,0,3,4
63479,2,3,222572,222573,222576,1,4,0
63480,5,3,222577,222577,222580,0,3,1
63481,6,2,222583,222583,222585,0,2,3
63482,3,1,222586,222586,222587,0,1,1
63483,5,3,222591,222591,222594,0,3,4
63484,3,2,222594,222594,222596,0,2,0
63485,1,3,222595,222596,222599,1,4,0
63486,3,2,222598,222599,222601,1,3,0
63487,4,3,222602,222602,222605,0,3,1
63488,4,1,222606,222606,222607,0,1,1
63489,4,1,222610,222610,222611,0,1,3
63490,2,1,222612,222612,222613,0,1,1
63491,3,1,222615,222615,222616,0,1,2
63492,4,3,222619,222619,222622,0,3,3
63493,5,1,222624,222624,222625,0,1,2
63494,3,3,222627,222627,222630,0,3,2
63495,3,3,222630,222630,222633,0,3,0
63496,5,1,222635,222635,222636,0,1,2
63497,4,3,222639,222639,222642,0,3,3
63498,4,2,222643,222643,222645,0,2,1
63499,1,3,222644,222645,222648,1,4,0
63500,3,1,222647,222648,222649,1,2,0
63501,3,1,222650,222650,222651,0,1,1
63502,1,2,222651,222651,222653,0,2,0
63503,3,1,222654,222654,222655,0,1,1
63504,3,3,222657,222657,222660,0,3,2
63505,2,1,222659,222660,222661,1,2,0
63506,5,2,222664,222664,222666,0,2,3
63507,5,2,222669,222669,222671,0,2,3
63508,4,1,222673,222673,222674,0,1,2
63509,5,2,222678,222678,222680,0,2,4
63510,5,2,222683,222683,222685,0,2,3
63511,3,3,222686,222686,222689,0,3,1
63512,6,3,222692,222692,222695,0,3,3
63513,5,2,222697,222697,222699,0,2,2
63514,5,2,222702,222702,222704,0,2,3
63515,2,1,222704,222704,222705,0,1,0
63516,3,2,222707,222707,222709,0,2,2
63517,4,2,222711,222711,222713,0,2,2
63518,3,1,222714,222714,222715,0,1,1
63519,5,2,222719,222719,222721,0,2,4
63520,6,3,222725,222725,222728,0,3,4
63521,3,3,222728,222728,222731,0,3,0
63522,5,1,222733,222733,222734,0,1,2
63523,4,2,222737,222737,222739,0,2,3
63524,2,1,222739,222739,222740,0,1,0
63525,5,2,222744,222744,222746,0,2,4
63526,3,3,222747,222747,222750,0,3,1
63527,2,3,222749,222750,222753,1,4,0
63528,1,3,222750,222753,222756,3,6,0
63529,2,1,222752,222756,222757,4,5,0
63530,3,2,222755,222757,222759,2,4,0
63531,2,3,222757,222759,222762,2,5,0
63532,5,2,222762,222762,222764,0,2,0
63533,5,1,222767,222767,222768,0,1,3
63534,3,3,222770,222770,222773,0,3,2
63535,1,2,222771,222773,222775,2,4,0
63536,5,2,222776,222776,222778,0,2,1
63537,3,2,222779,222779,222781,0,2,1
63538,5,1,222784,222784,222785,0,1,3
63539,1,1,222785,222785,222786,0,1,0
63540,1,2,222786,222786,222788,0,2,0
63541,4,2,222790,222790,222792,0,2,2
63542,5,3,222795,222795,222798,0,3,3
63543,5,1,222800,222800,222801,0,1,2
63544,2,2,222802,222802,222804,0,2,1
63545,5,3,222807,222807,222810,0,3,3
63546,4,1,222811,222811,222812,0,1,1
63547,6,2,222817,222817,222819,0,2,5
63548,5,3,222822,222822,222825,0,3,3
63549,6,3,222828,222828,222831,0,3,3
63550,2,1,222830,222831,222832,1,2,0
63551,1,3,222831,222832,222835,1,4,0
63552,3,3,222834,222835,222838,1,4,0
63553,6,1,222840,222840,222841,0,1,2
63554,5,3,222845,222845,222848,0,3,4
63555,6,1,222851,222851,222852,0,1,3
63556,1,2,222852,222852,222854,0,2,0
63557,6,2,222858,222858,222860,0,2,4
63558,4,3,222862,222862,222865,0,3,2
63559,1,1,222863,222865,222866,2,3,0
63560,6,3,222869,222869,222872,0,3,3
63561,1,2,222870,222872,222874,2,4,0
63562,5,3,222875,222875,222878,0,3,1
63563,1,2,222876,222878,222880,2,4,0
63564,2,2,222878,222880,222882,2,4,0
63565,6,2,222884,222884,222886,0,2,2
63566,2,3,222886,222886,222889,0,3,0
63567,3,1,222889,222889,222890,0,1,0
63568,4,3,222893,222893,222896,0,3,3
63569,5,3,222898,222898,222901,0,3,2
63570,5,3,222903,222903,222906,0,3,2
63571,2,2,222905,222906,222908,1,3,0
63572,3,1,222908,222908,222909,0,1,0
63573,3,3,222911,222911,222914,0,3,2
63574,1,2,222912,222914,222916,2,4,0
63575,2,1,222914,222916,222917,2,3,0
63576,2,1,222916,222917,222918,1,2,0
63577,3,3,222919,222919,222922,0,3,1
63578,1,3,222920,222922,222925,2,5,0
63579,1,2,222921,222925,222927,4,6,0
63580,3,2,222924,222927,222929,3,5,0
63581,2,1,222926,222929,222930,3,4,0
63582,4,2,222930,222930,222932,0,2,0
63583,4,3,222934,222934,222937,0,3,2
63584,4,3,222938,222938,222941,0,3,1
63585,5,2,222943,222943,222945,0,2,2
63586,4,2,222947,222947,222949,0,2,2
63587,6,3,222953,222953,222956,0,3,4
63588,6,2,222959,222959,222961,0,2,3
63589,4,3,222963,222963,222966,0,3,2
63590,6,1,222969,222969,222970,0,1,3
63591,6,2,222975,222975,222977,0,2,5
63592,6,1,222981,222981,222982,0,1,4
63593,5,1,222986,222986,222987,0,1,4
63594,6,1,222992,222992,222993,0,1,5
63595,5,2,222997,222997,222999,0,2,4
63596,4,1,223001,223001,223002,0,1,2
63597,2,3,223003,223003,223006,0,3,1
63598,4,3,223007,223007,223010,0,3,1
63599,5,1,223012,223012,223013,0,1,2
63600,3,3,223015,223015,223018,0,3,2
63601,6,3,223021,223021,223024,0,3,3
63602,3,2,223024,223024,223026,0,2,0
63603,6,3,223030,223030,223033,0,3,4
63604,5,2,223035,223035,223037,0,2,2
63605,4,3,223039,223039,223042,0,3,2
63606,5,1,223044,223044,223045,0,1,2
63607,3,2,223047,223047,223049,0,2,2
63608,3,1,223050,223050,223051,0,1,1
63609,4,2,223054,223054,223056,0,2,3
63610,3,1,223057,223057,223058,0,1,1
63611,5,3,223062,223062,223065,0,3,4
63612,5,3,223067,223067,223070,0,3,2
63613,4,2,223071,223071,223073,0,2,1
63614,5,3,223076,223076,223079,0,3,3
63615,1,1,223077,223079,223080,2,3,0
63616,5,1,223082,223082,223083,0,1,2
63617,6,2,223088,223088,223090,0,2,5
63618,1,2,223089,223090,223092,1,3,0
63619,6,1,223095,223095,223096,0,1,3
63620,3,3,223098,223098,223101,0,3,2
63621,5,1,223103,223103,223104,0,1,2
63622,5,2,223108,223108,223110,0,2,4
63623,6,2,223114,223114,223116,0,2,4
63624,6,1,223120,223120,223121,0,1,4
63625,1,3,223121,223121,223124,0,3,0
63626,3,3,223124,223124,223127,0,3,0
63627,1,2,223125,223127,223129,2,4,0
63628,1,2,223126,223129,223131,3,5,0
63629,6,2,223132,223132,223134,0,2,1
63630,3,2,223135,223135,223137,0,2,1
63631,2,3,223137,223137,223140,0,3,0
63632,5,3,223142,223142,223145,0,3,2
63633,4,2,223146,223146,223148,0,2,1
63634,1,2,223147,223148,223150,1,3,0
63635,1,2,223148,223150,223152,2,4,0
63636,3,3,223151,223152,223155,1,4,0
63637,3,3,223154,223155,223158,1,4,0
63638,4,2,223158,223158,223160,0,2,0
63639,6,3,223164,223164,223167,0,3,4
63640,2,3,223166,223167,223170,1,4,0
63641,4,2,223170,223170,223172,0,2,0
63642,3,1,223173,223173,223174,0,1,1
63643,5,2,223178,223178,223180,0,2,4
63644,4,3,223182,223182,223185,0,3,2
63645,2,3,223184,223185,223188,1,4,0
63646,5,1,223189,223189,223190,0,1,1
63647,4,2,223193,223193,223195,0,2,3
63648,6,3,223199,223199,223202,0,3,4
63649,4,2,223203,223203,223205,0,2,1
63650,2,3,223205,223205,223208,0,3,0
63651,4,2,223209,223209,223211,0,2,1
63652,6,2,223215,223215,223217,0,2,4
63653,2,3,223217,223217,223220,0,3,0
63654,5,2,223222,223222,223224,0,2,2
63655,6,1,223228,223228,223229,0,1,4
63656,6,2,223234,223234,223236,0,2,5
63657,6,1,223240,223240,223241,0,1,4
63658,3,2,223243,223243,223245,0,2,2
63659,6,1,223249,223249,223250,0,1,4
63660,4,2,223253,223253,223255,0,2,3
63661,5,1,223258,223258,223259,0,1,3
63662,4,2,223262,223262,223264,0,2,3
63663,6,3,223268,223268,223271,0,3,4
63664,1,1,223269,223271,223272,2,3,0
63665,1,2,223270,223272,223274,2,4,0
63666,4,3,223274,223274,223277,0,3,0
63667,2,3,223276,223277,223280,1,4,0
63668,5,2,223281,223281,223283,0,2,1
63669,5,3,223286,223286,223289,0,3,3
63670,4,2,223290,223290,223292,0,2,1
63671,4,1,223294,223294,223295,0,1,2
63672,5,3,223299,223299,223302,0,3,4
63673,6,2,223305,223305,223307,0,2,3
63674,6,3,223311,223311,223314,0,3,4
63675,6,3,223317,223317,223320,0,3,3
63676,3,2,223320,223320,223322,0,2,0
63677,4,2,223324,223324,223326,0,2,2
63678,3,2,223327,223327,223329,0,2,1
63679,6,2,223333,223333,223335,0,2,4
63680,5,2,223338,223338,223340,0,2,3
63681,6,2,223344,223344,223346,0,2,4
63682,6,1,223350,223350,223351,0,1,4
63683,1,1,223351,223351,223352,0,1,0
63684,4,2,223355,223355,223357,0,2,3
63685,1,2,223356,223357,223359,1,3,0
63686,4,2,223360,223360,223362,0,2,1
63687,2,1,223362,223362,223363,0,1,0
63688,3,1,223365,223365,223366,0,1,2
63689,2,3,223367,223367,223370,0,3,1
63690,5,2,223372,223372,223374,0,2,2
63691,6,3,223378,223378,223381,0,3,4
63692,5,1,223383,223383,223384,0,1,2
63693,4,3,223387,223387,223390,0,3,3
63694,6,1,223393,223393,223394,0,1,3
63695,3,2,223396,223396,223398,0,2,2
63696,6,1,223402,223402,223403,0,1,4
63697,4,1,223406,223406,223407,0,1,3
63698,5,1,223411,223411,223412,0,1,4
63699,5,3,223416,223416,223419,0,3,4
63700,3,3,223419,223419,223422,0,3,0
63701,6,2,223425,223425,223427,0,2,3
63702,5,2,223430,223430,223432,0,2,3
63703,5,3,223435,223435,223438,0,3,3
63704,5,3,223440,223440,223443,0,3,2
63705,5,3,223445,223445,223448,0,3,2
63706,2,2,223447,223448,223450,1,3,0
63707,3,1,223450,223450,223451,0,1,0
63708,2,2,223452,223452,223454,0,2,1
63709,4,2,223456,223456,223458,0,2,2
63710,2,1,223458,223458,223459,0,1,0
63711,6,3,223464,223464,223467,0,3,5
63712,1,2,223465,223467,223469,2,4,0
63713,5,1,223470,223470,223471,0,1,1
63714,5,3,223475,223475,223478,0,3,4
63715,4,2,223479,223479,223481,0,2,1
63716,4,2,223483,223483,223485,0,2,2
63717,3,3,223486,223486,223489,0,3,1
63718,2,3,223488,223489,223492,1,4,0
63719,1,1,223489,223492,223493,3,4,0
63720,6,2,223495,223495,223497,0,2,2
63721,6,3,223501,223501,223504,0,3,4
63722,3,2,223504,223504,223506,0,2,0
63723,6,2,223510,223510,223512,0,2,4
63724,5,3,223515,223515,223518,0,3,3
63725,1,3,223516,223518,223521,2,5,0
63726,3,2,223519,223521,223523,2,4,0
63727,2,3,223521,223523,223526,2,5,0
63728,5,2,223526,223526,223528,0,2,0
63729,3,2,223529,223529,223531,0,2,1
63730,1,2,223530,223531,223533,1,3,0
63731,4,1,223534,223534,223535,0,1,1
63732,5,2,223539,223539,223541,0,2,4
63733,4,1,223543,223543,223544,0,1,2
63734,1,1,223544,223544,223545,0,1,0
63735,5,2,223549,223549,223551,0,2,4
63736,2,1,223551,223551,223552,0,1,0
63737,6,3,223557,223557,223560,0,3,5
63738,3,2,223560,223560,223562,0,2,0
63739,4,3,223564,223564,223567,0,3,2
63740,5,3,223569,223569,223572,0,3,2
63741,6,1,223575,223575,223576,0,1,3
63742,2,3,223577,223577,223580,0,3,1
63743,3,1,223580,223580,223581,0,1,0
63744,2,2,223582,223582,223584,0,2,1
63745,2,1,223584,223584,223585,0,1,0
63746,3,1,223587,223587,223588,0,1,2
63747,6,2,223593,223593,223595,0,2,5
63748,6,1,223599,223599,223600,0,1,4
63749,4,1,223603,223603,223604,0,1,3
63750,2,2,223605,223605,223607,0,2,1
63751,5,2,223610,223610,223612,0,2,3
63752,2,3,223612,223612,223615,0,3,0
63753,2,2,223614,223615,223617,1,3,0
63754,5,1,223619,223619,223620,0,1,2
63755,4,1,223623,223623,223624,0,1,3
63756,2,1,223625,223625,223626,0,1,1
63757,4,3,223629,223629,223632,0,3,3
63758,2,1,223631,223632,223633,1,2,0
63759,6,2,223637,223637,223639,0,2,4
63760,4,1,223641,223641,223642,0,1,2
63761,2,1,223643,223643,223644,0,1,1
63762,3,2,223646,223646,223648,0,2,2
63763,3,3,223649,223649,223652,0,3,1
63764,4,2,223653,223653,223655,0,2,1
63765,4,1,223657,223657,223658,0,1,2
63766,1,1,223658,223658,223659,0,1,0
63767,4,2,223662,223662,223664,0,2,3
63768,6,1,223668,223668,223669,0,1,4
63769,1,2,223669,223669,223671,0,2,0
63770,4,1,223673,223673,223674,0,1,2
63771,2,2,223675,223675,223677,0,2,1
63772,3,1,223678,223678,223679,0,1,1
63773,3,3,223681,223681,223684,0,3,2
63774,5,3,223686,223686,223689,0,3,2
63775,6,1,223692,223692,223693,0,1,3
63776,5,3,223697,223697,223700,0,3,4
63777,1,2,223698,223700,223702,2,4,0
63778,5,2,223703,223703,223705,0,2,1
63779,3,3,223706,223706,223709,0,3,1
63780,3,1,223709,223709,223710,0,1,0
63781,5,1,223714,223714,223715,0,1,4
63782,3,2,223717,223717,223719,0,2,2
63783,2,1,223719,223719,223720,0,1,0
63784,4,2,223723,223723,223725,0,2,3
63785,3,3,223726,223726,223729,0,3,1
63786,5,1,223731,223731,223732,0,1,2
63787,4,3,223735,223735,223738,0,3,3
63788,3,2,223738,223738,223740,0,2,0
63789,3,3,223741,223741,223744,0,3,1
63790,3,2,223744,223744,223746,0,2,0
63791,3,1,223747,223747,223748,0,1,1
63792,6,2,223753,223753,223755,0,2,5
63793,4,2,223757,223757,223759,0,2,2
63794,6,3,223763,223763,223766,0,3,4
63795,2,1,223765,223766,223767,1,2,0
63796,5,3,223770,223770,223773,0,3,3
63797,1,3,223771,223773,223776,2,5,0
63798,5,2,223776,223776,223778,0,2,0
63799,4,3,223780,223780,223783,0,3,2
63800,4,3,223784,223784,223787,0,3,1
63801,6,1,223790,223790,223791,0,1,3
63802,6,1,223796,223796,223797,0,1,5
63803,3,1,223799,223799,223800,0,1,2
63804,3,1,223802,223802,223803,0,1,2
63805,2,1,223804,223804,223805,0,1,1
63806,1,2,223805,223805,223807,0,2,0
63807,6,3,223811,223811,223814,0,3,4
63808,3,1,223814,223814,223815,0,1,0
63809,1,3,223815,223815,223818,0,3,0
63810,6,3,223821,223821,223824,0,3,3
63811,2,1,223823,223824,223825,1,2,0
63812,2,1,223825,223825,223826,0,1,0
63813,1,3,223826,223826,223829,0,3,0
63814,1,1,223827,223829,223830,2,3,0
63815,4,1,223831,223831,223832,0,1,1
63816,3,3,223834,223834,223837,0,3,2
63817,3,2,223837,223837,223839,0,2,0
63818,4,3,223841,223841,223844,0,3,2
63819,4,2,223845,223845,223847,0,2,1
63820,2,1,223847,223847,223848,0,1,0
63821,1,1,223848,223848,223849,0,1,0
63822,3,3,223851,223851,223854,0,3,2
63823,6,2,223857,223857,223859,0,2,3
63824,1,2,223858,223859,223861,1,3,0
63825,5,3,223863,223863,223866,0,3,2
63826,5,2,223868,223868,223870,0,2,2
63827,4,3,223872,223872,223875,0,3,2
63828,5,3,223877,223877,223880,0,3,2
63829,3,2,223880,223880,223882,0,2,0
63830,2,2,223882,223882,223884,0,2,0
63831,5,3,223887,223887,223890,0,3,3
63832,2,3,223889,223890,223893,1,4,0
63833,2,3,223891,223893,223896,2,5,0
63834,1,2,223892,223896,223898,4,6,0
63835,1,3,223893,223898,223901,5,8,0
63836,2,1,223895,223901,223902,6,7,0
63837,1,3,223896,223902,223905,6,9,0
63838,2,2,223898,223905,223907,7,9,0
63839,2,3,223900,223907,223910,7,10,0
63840,5,3,223905,223910,223913,5,8,0
63841,6,2,223911,223913,223915,2,4,0
63842,1,1,223912,223915,223916,3,4,0
63843,1,2,223913,223916,223918,3,5,0
63844,4,3,223917,223918,223921,1,4,0
63845,4,1,223921,223921,223922,0,1,0
63846,4,2,223925,223925,223927,0,2,3
63847,3,2,223928,223928,223930,0,2,1
63848,1,2,223929,223930,223932,1,3,0
63849,3,1,223932,223932,223933,0,1,0
63850,2,3,223934,223934,223937,0,3,1
63851,5,1,223939,223939,223940,0,1,2
63852,4,1,223943,223943,223944,0,1,3
63853,6,2,223949,223949,223951,0,2,5
63854,3,2,223952,223952,223954,0,2,1
63855,1,3,223953,223954,223957,1,4,0
63856,2,2,223955,223957,223959,2,4,0
63857,1,3,223956,223959,223962,3,6,0
63858,1,2,223957,223962,223964,5,7,0
63859,4,2,223961,223964,223966,3,5,0
63860,4,1,223965,223966,223967,1,2,0
63861,2,1,223967,223967,223968,0,1,0
63862,2,3,223969,223969,223972,0,3,1
63863,1,3,223970,223972,223975,2,5,0
63864,2,1,223972,223975,223976,3,4,0
63865,1,1,223973,223976,223977,3,4,0
63866,4,3,223977,223977,223980,0,3,0
63867,4,3,223981,223981,223984,0,3,1
63868,3,1,223984,223984,223985,0,1,0
63869,6,3,223990,223990,223993,0,3,5
63870,2,1,223992,223993,223994,1,2,0
63871,4,2,223996,223996,223998,0,2,2
63872,1,1,223997,223998,223999,1,2,0
63873,6,3,224003,224003,224006,0,3,4
63874,1,2,224004,224006,224008,2,4,0
63875,2,2,224006,224008,224010,2,4,0
63876,6,3,224012,224012,224015,0,3,2
63877,4,3,224016,224016,224019,0,3,1
63878,3,1,224019,224019,224020,0,1,0
63879,2,1,224021,224021,224022,0,1,1
63880,1,3,224022,224022,224025,0,3,0
63881,5,1,224027,224027,224028,0,1,2
63882,3,1,224030,224030,224031,0,1,2
63883,2,1,224032,224032,224033,0,1,1
63884,5,1,224037,224037,224038,0,1,4
63885,2,2,224039,224039,224041,0,2,1
63886,5,2,224044,224044,224046,0,2,3
63887,1,2,224045,224046,224048,1,3,0
63888,2,2,224047,224048,224050,1,3,0
63889,2,3,224049,224050,224053,1,4,0
63890,5,3,224054,224054,224057,0,3,1
63891,5,3,224059,224059,224062,0,3,2
63892,6,2,224065,224065,224067,0,2,3
63893,1,2,224066,224067,224069,1,3,0
63894,6,3,224072,224072,224075,0,3,3
63895,3,3,224075,224075,224078,0,3,0
63896,1,2,224076,224078,224080,2,4,0
63897,3,3,224079,224080,224083,1,4,0
63898,3,2,224082,224083,224085,1,3,0
63899,2,2,224084,224085,224087,1,3,0
63900,2,3,224086,224087,224090,1,4,0
63901,5,3,224091,224091,224094,0,3,1
63902,6,3,224097,224097,224100,0,3,3
63903,1,1,224098,224100,224101,2,3,0
63904,6,3,224104,224104,224107,0,3,3
63905,4,1,224108,224108,224109,0,1,1
63906,3,1,224111,224111,224112,0,1,2
63907,1,3,224112,224112,224115,0,3,0
63908,3,2,224115,224115,224117,0,2,0
63909,4,2,224119,224119,224121,0,2,2
63910,5,3,224124,224124,224127,0,3,3
63911,6,1,224130,224130,224131,0,1,3
63912,3,3,224133,224133,224136,0,3,2
63913,1,3,224134,224136,224139,2,5,0
63914,4,3,224138,224139,224142,1,4,0
63915,6,1,224144,224144,224145,0,1,2
63916,4,2,224148,224148,224150,0,2,3
63917,1,1,224149,224150,224151,1,2,0
63918,2,3,224151,224151,224154,0,3,0
63919,3,1,224154,224154,224155,0,1,0
63920,4,2,224158,224158,224160,0,2,3
63921,5,3,224163,224163,224166,0,3,3
63922,1,1,224164,224166,224167,2,3,0
63923,2,1,224166,224167,224168,1,2,0
63924,1,3,224167,224168,224171,1,4,0
63925,6,2,224173,224173,224175,0,2,2
63926,4,2,224177,224177,224179,0,2,2
63927,2,1,224179,224179,224180,0,1,0
63928,4,1,224183,224183,224184,0,1,3
63929,5,2,224188,224188,224190,0,2,4
63930,4,1,224192,224192,224193,0,1,2
63931,6,1,224198,224198,224199,0,1,5
63932,6,2,224204,224204,224206,0,2,5
63933,6,1,224210,224210,224211,0,1,4
63934,4,2,224214,224214,224216,0,2,3
63935,4,2,224218,224218,224220,0,2,2
63936,4,2,224222,224222,224224,0,2,2
63937,3,1,224225,224225,224226,0,1,1
63938,1,2,224226,224226,224228,0,2,0
63939,6,1,224232,224232,224233,0,1,4
63940,2,3,224234,224234,224237,0,3,1
63941,2,2,224236,224237,224239,1,3,0
63942,1,3,224237,224239,224242,2,5,0
63943,2,2,224239,224242,224244,3,5,0
63944,2,2,224241,224244,224246,3,5,0
63945,4,2,224245,224246,224248,1,3,0
63946,1,2,224246,224248,224250,2,4,0
63947,2,2,224248,224250,224252,2,4,0
63948,4,3,224252,224252,224255,0,3,0
63949,4,2,224256,224256,224258,0,2,1
63950,6,3,224262,224262,224265,0,3,4
63951,6,2,224268,224268,224270,0,2,3
63952,4,1,224272,224272,224273,0,1,2
63953,2,2,224274,224274,224276,0,2,1
63954,6,2,224280,224280,224282,0,2,4
63955,3,1,224283,224283,224284,0,1,1
63956,5,3,224288,224288,224291,0,3,4
63957,3,2,224291,224291,224293,0,2,0
63958,4,2,224295,224295,224297,0,2,2
63959,4,1,224299,224299,224300,0,1,2
63960,4,3,224303,224303,224306,0,3,3
63961,3,2,224306,224306,224308,0,2,0
63962,4,2,224310,224310,224312,0,2,2
63963,6,2,224316,224316,224318,0,2,4
63964,5,2,224321,224321,224323,0,2,3
63965,1,1,224322,224323,224324,1,2,0
63966,5,2,224327,224327,224329,0,2,3
63967,1,3,224328,224329,224332,1,4,0
63968,4,3,224332,224332,224335,0,3,0
63969,4,1,224336,224336,224337,0,1,1
63970,6,1,224342,224342,224343,0,1,5
63971,6,1,224348,224348,224349,0,1,5
63972,4,2,224352,224352,224354,0,2,3
63973,2,3,224354,224354,224357,0,3,0
63974,3,1,224357,224357,224358,0,1,0
63975,3,2,224360,224360,224362,0,2,2
63976,4,2,224364,224364,224366,0,2,2
63977,3,1,224367,224367,224368,0,1,1
63978,4,1,224371,224371,224372,0,1,3
63979,4,3,224375,224375,224378,0,3,3
63980,5,1,224380,224380,224381,0,1,2
63981,2,3,224382,224382,224385,0,3,1
63982,3,1,224385,224385,224386,0,1,0
63983,6,2,224391,224391,224393,0,2,5
63984,5,3,224396,224396,224399,0,3,3
63985,5,3,224401,224401,224404,0,3,2
63986,6,3,224407,224407,224410,0,3,3
63987,1,2,224408,224410,224412,2,4,0
63988,4,1,224412,224412,224413,0,1,0
63989,2,1,224414,224414,224415,0,1,1
63990,4,2,224418,224418,224420,0,2,3
63991,5,3,224423,224423,224426,0,3,3
63992,1,1,224424,224426,224427,2,3,0
63993,3,1,224427,224427,224428,0,1,0
63994,6,1,224433,224433,224434,0,1,5
63995,2,1,224435,224435,224436,0,1,1
63996,6,1,224441,224441,224442,0,1,5
63997,4,3,224445,224445,224448,0,3,3
63998,4,1,224449,224449,224450,0,1,1
63999,6,3,224455,224455,224458,0,3,5
64000,3,3,224458,224458,224461,0,3,0
64001,2,2,224460,224461,224463,1,3,0
64002,6,2,224466,224466,224468,0,2,3
64003,6,2,224472,224472,224474,0,2,4
64004,1,2,224473,224474,224476,1,3,0
64005,5,1,224478,224478,224479,0,1,2
64006,3,3,224481,224481,224484,0,3,2
64007,6,2,224487,224487,224489,0,2,3
64008,6,2,224493,224493,224495,0,2,4
64009,1,3,224494,224495,224498,1,4,0
64010,6,3,224500,224500,224503,0,3,2
64011,6,1,224506,224506,224507,0,1,3
64012,5,3,224511,224511,224514,0,3,4
64013,2,3,224513,224514,224517,1,4,0
64014,4,3,224517,224517,224520,0,3,0
64015,1,1,224518,224520,224521,2,3,0
64016,6,1,224524,224524,224525,0,1,3
64017,6,1,224530,224530,224531,0,1,5
64018,4,1,224534,224534,224535,0,1,3
64019,1,1,224535,224535,224536,0,1,0
64020,4,1,224539,224539,224540,0,1,3
64021,1,3,224540,224540,224543,0,3,0
64022,6,1,224546,224546,224547,0,1,3
64023,6,1,224552,224552,224553,0,1,5
64024,4,1,224556,224556,224557,0,1,3
64025,2,2,224558,224558,224560,0,2,1
64026,5,1,224563,224563,224564,0,1,3
64027,5,2,224568,224568,224570,0,2,4
64028,4,1,224572,224572,224573,0,1,2
64029,1,2,224573,224573,224575,0,2,0
64030,3,2,224576,224576,224578,0,2,1
64031,4,3,224580,224580,224583,0,3,2
64032,2,1,224582,224583,224584,1,2,0
64033,3,2,224585,224585,224587,0,2,1
64034,4,3,224589,224589,224592,0,3,2
64035,5,1,224594,224594,224595,0,1,2
64036,1,2,224595,224595,224597,0,2,0
64037,5,1,224600,224600,224601,0,1,3
64038,2,3,224602,224602,224605,0,3,1
64039,1,1,224603,224605,224606,2,3,0
64040,3,1,224606,224606,224607,0,1,0
64041,2,3,224608,224608,224611,0,3,1
64042,1,2,224609,224611,224613,2,4,0
64043,4,2,224613,224613,224615,0,2,0
64044,6,2,224619,224619,224621,0,2,4
64045,5,3,224624,224624,224627,0,3,3
64046,3,3,224627,224627,224630,0,3,0
64047,4,1,224631,224631,224632,0,1,1
64048,3,1,224634,224634,224635,0,1,2
64049,2,1,224636,224636,224637,0,1,1
64050,6,2,224642,224642,224644,0,2,5
64051,5,2,224647,224647,224649,0,2,3
64052,4,1,224651,224651,224652,0,1,2
64053,1,2,224652,224652,224654,0,2,0
64054,5,1,224657,224657,224658,0,1,3
64055,4,1,224661,224661,224662,0,1,3
64056,6,3,224667,224667,224670,0,3,5
64057,3,2,224670,224670,224672,0,2,0
64058,4,3,224674,224674,224677,0,3,2
64059,2,1,224676,224677,224678,1,2,0
64060,5,3,224681,224681,224684,0,3,3
64061,2,2,224683,224684,224686,1,3,0
64062,5,2,224688,224688,224690,0,2,2
64063,1,1,224689,224690,224691,1,2,0
64064,5,1,224694,224694,224695,0,1,3
64065,4,3,224698,224698,224701,0,3,3
64066,3,1,224701,224701,224702,0,1,0
64067,6,2,224707,224707,224709,0,2,5
64068,1,1,224708,224709,224710,1,2,0
64069,2,2,224710,224710,224712,0,2,0
64070,6,2,224716,224716,224718,0,2,4
64071,2,3,224718,224718,224721,0,3,0
64072,5,1,224723,224723,224724,0,1,2
64073,3,3,224726,224726,224729,0,3,2
64074,1,3,224727,224729,224732,2,5,0
64075,4,1,224731,224732,224733,1,2,0
64076,1,1,224732,224733,224734,1,2,0
64077,1,2,224733,224734,224736,1,3,0
64078,5,2,224738,224738,224740,0,2,2
64079,1,3,224739,224740,224743,1,4,0
64080,4,2,224743,224743,224745,0,2,0
64081,2,1,224745,224745,224746,0,1,0
64082,4,2,224749,224749,224751,0,2,3
64083,6,1,224755,224755,224756,0,1,4
64084,4,3,224759,224759,224762,0,3,3
64085,6,3,224765,224765,224768,0,3,3
64086,4,3,224769,224769,224772,0,3,1
64087,2,3,224771,224772,224775,1,4,0
64088,6,2,224777,224777,224779,0,2,2
64089,4,2,224781,224781,224783,0,2,2
64090,6,2,224787,224787,224789,0,2,4
64091,6,2,224793,224793,224795,0,2,4
64092,3,2,224796,224796,224798,0,2,1
64093,1,1,224797,224798,224799,1,2,0
64094,5,2,224802,224802,224804,0,2,3
64095,4,3,224806,224806,224809,0,3,2
64096,3,1,224809,224809,224810,0,1,0
64097,6,2,224815,224815,224817,0,2,5
64098,6,1,224821,224821,224822,0,1,4
64099,5,2,224826,224826,224828,0,2,4
64100,5,2,224831,224831,224833,0,2,3
64101,1,1,224832,224833,224834,1,2,0
64102,6,2,224838,224838,224840,0,2,4
64103,5,2,224843,224843,224845,0,2,3
64104,1,1,224844,224845,224846,1,2,0
64105,2,2,224846,224846,224848,0,2,0
64106,2,3,224848,224848,224851,0,3,0
64107,2,1,224850,224851,224852,1,2,0
64108,6,1,224856,224856,224857,0,1,4
64109,1,2,224857,224857,224859,0,2,0
64110,2,1,224859,224859,224860,0,1,0
64111,2,3,224861,224861,224864,0,3,1
64112,1,1,224862,224864,224865,2,3,0
64113,5,2,224867,224867,224869,0,2,2
64114,4,2,224871,224871,224873,0,2,2
64115,3,1,224874,224874,224875,0,1,1
64116,2,2,224876,224876,224878,0,2,1
64117,6,3,224882,224882,224885,0,3,4
64118,3,2,224885,224885,224887,0,2,0
64119,5,1,224890,224890,224891,0,1,3
64120,6,3,224896,224896,224899,0,3,5
64121,3,1,224899,224899,224900,0,1,0
64122,5,2,224904,224904,224906,0,2,4
64123,4,3,224908,224908,224911,0,3,2
64124,1,3,224909,224911,224914,2,5,0
64125,1,1,224910,224914,224915,4,5,0
64126,5,3,224915,224915,224918,0,3,0
64127,3,2,224918,224918,224920,0,2,0
64128,4,1,224922,224922,224923,0,1,2
64129,5,1,224927,224927,224928,0,1,4
64130,3,2,224930,224930,224932,0,2,2
64131,6,3,224936,224936,224939,0,3,4
64132,2,2,224938,224939,224941,1,3,0
64133,2,3,224940,224941,224944,1,4,0
64134,1,2,224941,224944,224946,3,5,0
64135,5,3,224946,224946,224949,0,3,0
64136,6,3,224952,224952,224955,0,3,3
64137,4,2,224956,224956,224958,0,2,1
64138,5,2,224961,224961,224963,0,2,3
64139,2,1,224963,224963,224964,0,1,0
64140,2,1,224965,224965,224966,0,1,1
64141,6,3,224971,224971,224974,0,3,5
64142,5,1,224976,224976,224977,0,1,2
64143,3,1,224979,224979,224980,0,1,2
64144,1,2,224980,224980,224982,0,2,0
64145,6,1,224986,224986,224987,0,1,4
64146,3,2,224989,224989,224991,0,2,2
64147,3,2,224992,224992,224994,0,2,1
64148,2,2,224994,224994,224996,0,2,0
64149,5,2,224999,224999,225001,0,2,3
64150,4,3,225003,225003,225006,0,3,2
64151,4,1,225007,225007,225008,0,1,1
64152,4,1,225011,225011,225012,0,1,3
64153,2,1,225013,225013,225014,0,1,1
64154,2,3,225015,225015,225018,0,3,1
64155,3,3,225018,225018,225021,0,3,0
64156,4,2,225022,225022,225024,0,2,1
64157,2,1,225024,225024,225025,0,1,0
64158,6,1,225030,225030,225031,0,1,5
64159,2,3,225032,225032,225035,0,3,1
64160,4,2,225036,225036,225038,0,2,1
64161,4,3,225040,225040,225043,0,3,2
64162,1,3,225041,225043,225046,2,5,0
64163,3,2,225044,225046,225048,2,4,0
64164,5,2,225049,225049,225051,0,2,1
64165,3,3,225052,225052,225055,0,3,1
64166,3,3,225055,225055,225058,0,3,0
64167,6,2,225061,225061,225063,0,2,3
64168,4,3,225065,225065,225068,0,3,2
64169,3,1,225068,225068,225069,0,1,0
64170,5,2,225073,225073,225075,0,2,4
64171,2,3,225075,225075,225078,0,3,0
64172,2,3,225077,225078,225081,1,4,0
64173,2,2,225079,225081,225083,2,4,0
64174,5,2,225084,225084,225086,0,2,1
64175,1,1,225085,225086,225087,1,2,0
64176,1,1,225086,225087,225088,1,2,0
64177,6,2,225092,225092,225094,0,2,4
64178,3,2,225095,225095,225097,0,2,1
64179,4,2,225099,225099,225101,0,2,2
64180,6,1,225105,225105,225106,0,1,4
64181,6,1,225111,225111,225112,0,1,5
64182,6,2,225117,225117,225119,0,2,5
64183,6,1,225123,225123,225124,0,1,4
64184,1,1,225124,225124,225125,0,1,0
64185,1,2,225125,225125,225127,0,2,0
64186,6,1,225131,225131,225132,0,1,4
64187,6,2,225137,225137,225139,0,2,5
64188,2,1,225139,225139,225140,0,1,0
64189,1,2,225140,225140,225142,0,2,0
64190,4,2,225144,225144,225146,0,2,2
64191,5,1,225149,225149,225150,0,1,3
64192,1,3,225150,225150,225153,0,3,0
64193,1,2,225151,225153,225155,2,4,0
64194,2,2,225153,225155,225157,2,4,0
64195,3,1,225156,225157,225158,1,2,0
64196,2,3,225158,225158,225161,0,3,0
64197,4,3,225162,225162,225165,0,3,1
64198,2,1,225164,225165,225166,1,2,0
64199,1,1,225165,225166,225167,1,2,0
64200,1,2,225166,225167,225169,1,3,0
64201,3,3,225169,225169,225172,0,3,0
64202,4,1,225173,225173,225174,0,1,1
64203,2,3,225175,225175,225178,0,3,1
64204,5,2,225180,225180,225182,0,2,2
64205,1,1,225181,225182,225183,1,2,0
64206,5,1,225186,225186,225187,0,1,3
64207,6,3,225192,225192,225195,0,3,5
64208,1,3,225193,225195,225198,2,5,0
64209,6,1,225199,225199,225200,0,1,1
64210,4,1,225203,225203,225204,0,1,3
64211,5,2,225208,225208,225210,0,2,4
64212,5,3,225213,225213,225216,0,3,3
64213,3,3,225216,225216,225219,0,3,0
64214,1,2,225217,225219,225221,2,4,0
64215,4,2,225221,225221,225223,0,2,0
64216,4,1,225225,225225,225226,0,1,2
64217,4,2,225229,225229,225231,0,2,3
64218,1,3,225230,225231,225234,1,4,0
64219,2,2,225232,225234,225236,2,4,0
64220,5,3,225237,225237,225240,0,3,1
64221,1,1,225238,225240,225241,2,3,0
64222,4,2,225242,225242,225244,0,2,1
64223,6,2,225248,225248,225250,0,2,4
64224,3,2,225251,225251,225253,0,2,1
64225,1,1,225252,225253,225254,1,2,0
64226,1,3,225253,225254,225257,1,4,0
64227,5,1,225258,225258,225259,0,1,1
64228,5,2,225263,225263,225265,0,2,4
64229,3,3,225266,225266,225269,0,3,1
64230,5,3,225271,225271,225274,0,3,2
64231,3,3,225274,225274,225277,0,3,0
64232,2,3,225276,225277,225280,1,4,0
64233,4,3,225280,225280,225283,0,3,0
64234,2,2,225282,225283,225285,1,3,0
64235,1,2,225283,225285,225287,2,4,0
64236,1,1,225284,225287,225288,3,4,0
64237,5,1,225289,225289,225290,0,1,1
64238,6,1,225295,225295,225296,0,1,5
64239,4,2,225299,225299,225301,0,2,3
64240,1,2,225300,225301,225303,1,3,0
64241,2,3,225302,225303,225306,1,4,0
64242,1,1,225303,225306,225307,3,4,0
64243,2,1,225305,225307,225308,2,3,0
64244,2,1,225307,225308,225309,1,2,0
64245,6,3,225313,225313,225316,0,3,4
64246,3,1,225316,225316,225317,0,1,0
64247,3,1,225319,225319,225320,0,1,2
64248,4,2,225323,225323,225325,0,2,3
64249,4,2,225327,225327,225329,0,2,2
64250,1,3,225328,225329,225332,1,4,0
64251,1,3,225329,225332,225335,3,6,0
64252,1,1,225330,225335,225336,5,6,0
64253,1,1,225331,225336,225337,5,6,0
64254,6,3,225337,225337,225340,0,3,0
64255,5,1,225342,225342,225343,0,1,2
64256,3,3,225345,225345,225348,0,3,2
64257,2,3,225347,225348,225351,1,4,0
64258,4,2,225351,225351,225353,0,2,0
64259,4,2,225355,225355,225357,0,2,2
64260,1,3,225356,225357,225360,1,4,0
64261,3,1,225359,225360,225361,1,2,0
64262,4,2,225363,225363,225365,0,2,2
64263,1,2,225364,225365,225367,1,3,0
64264,4,3,225368,225368,225371,0,3,1
64265,1,1,225369,225371,225372,2,3,0
64266,6,3,225375,225375,225378,0,3,3
64267,3,1,225378,225378,225379,0,1,0
64268,2,1,225380,225380,225381,0,1,1
64269,4,3,225384,225384,225387,0,3,3
64270,5,2,225389,225389,225391,0,2,2
64271,4,1,225393,225393,225394,0,1,2
64272,6,1,225399,225399,225400,0,1,5
64273,1,2,225400,225400,225402,0,2,0
64274,6,3,225406,225406,225409,0,3,4
64275,2,1,225408,225409,225410,1,2,0
64276,3,1,225411,225411,225412,0,1,1
64277,1,3,225412,225412,225415,0,3,0
64278,6,1,225418,225418,225419,0,1,3
64279,5,2,225423,225423,225425,0,2,4
64280,4,1,225427,225427,225428,0,1,2
64281,4,1,225431,225431,225432,0,1,3
64282,2,3,225433,225433,225436,0,3,1
64283,5,1,225438,225438,225439,0,1,2
64284,1,2,225439,225439,225441,0,2,0
64285,6,2,225445,225445,225447,0,2,4
64286,3,3,225448,225448,225451,0,3,1
64287,2,3,225450,225451,225454,1,4,0
64288,4,1,225454,225454,225455,0,1,0
64289,1,2,225455,225455,225457,0,2,0
64290,5,2,225460,225460,225462,0,2,3
64291,2,1,225462,225462,225463,0,1,0
64292,2,1,225464,225464,225465,0,1,1
64293,1,3,225465,225465,225468,0,3,0
64294,1,1,225466,225468,225469,2,3,0
64295,6,2,225472,225472,225474,0,2,3
64296,6,3,225478,225478,225481,0,3,4
64297,2,1,225480,225481,225482,1,2,0
64298,4,2,225484,225484,225486,0,2,2
64299,3,3,225487,225487,225490,0,3,1
64300,2,3,225489,225490,225493,1,4,0
64301,3,1,225492,225493,225494,1,2,0
64302,2,2,225494,225494,225496,0,2,0
64303,1,2,225495,225496,225498,1,3,0
64304,2,1,225497,225498,225499,1,2,0
64305,3,3,225500,225500,225503,0,3,1
64306,1,3,225501,225503,225506,2,5,0
64307,5,2,225506,225506,225508,0,2,0
64308,6,2,225512,225512,225514,0,2,4
64309,5,3,225517,225517,225520,0,3,3
64310,4,1,225521,225521,225522,0,1,1
64311,2,2,225523,225523,225525,0,2,1
64312,4,3,225527,225527,225530,0,3,2
64313,6,3,225533,225533,225536,0,3,3
64314,5,1,225538,225538,225539,0,1,2
64315,6,1,225544,225544,225545,0,1,5
64316,6,2,225550,225550,225552,0,2,5
64317,3,3,225553,225553,225556,0,3,1
64318,5,1,225558,225558,225559,0,1,2
64319,5,2,225563,225563,225565,0,2,4
64320,3,1,225566,225566,225567,0,1,1
64321,5,3,225571,225571,225574,0,3,4
64322,1,2,225572,225574,225576,2,4,0
64323,6,2,225578,225578,225580,0,2,2
64324,4,1,225582,225582,225583,0,1,2
64325,4,1,225586,225586,225587,0,1,3
64326,2,2,225588,225588,225590,0,2,1
64327,1,3,225589,225590,225593,1,4,0
64328,1,1,225590,225593,225594,3,4,0
64329,4,1,225594,225594,225595,0,1,0
64330,3,1,225597,225597,225598,0,1,2
64331,3,1,225600,225600,225601,0,1,2
64332,6,1,225606,225606,225607,0,1,5
64333,6,3,225612,225612,225615,0,3,5
64334,5,2,225617,225617,225619,0,2,2
64335,6,1,225623,225623,225624,0,1,4
64336,2,2,225625,225625,225627,0,2,1
64337,6,2,225631,225631,225633,0,2,4
64338,2,3,225633,225633,225636,0,3,0
64339,6,1,225639,225639,225640,0,1,3
64340,3,1,225642,225642,225643,0,1,2
64341,3,2,225645,225645,225647,0,2,2
64342,6,1,225651,225651,225652,0,1,4
64343,6,1,225657,225657,225658,0,1,5
64344,4,2,225661,225661,225663,0,2,3
64345,1,1,225662,225663,225664,1,2,0
64346,4,3,225666,225666,225669,0,3,2
64347,6,1,225672,225672,225673,0,1,3
64348,3,3,225675,225675,225678,0,3,2
64349,3,1,225678,225678,225679,0,1,0
64350,3,3,225681,225681,225684,0,3,2
64351,3,1,225684,225684,225685,0,1,0
64352,3,1,225687,225687,225688,0,1,2
64353,5,3,225692,225692,225695,0,3,4
64354,3,2,225695,225695,225697,0,2,0
64355,3,2,225698,225698,225700,0,2,1
64356,3,1,225701,225701,225702,0,1,1
64357,3,3,225704,225704,225707,0,3,2
64358,1,1,225705,225707,225708,2,3,0
64359,2,2,225707,225708,225710,1,3,0
64360,1,3,225708,225710,225713,2,5,0
64361,1,3,225709,225713,225716,4,7,0
64362,1,3,225710,225716,225719,6,9,0
64363,2,1,225712,225719,225720,7,8,0
64364,3,3,225715,225720,225723,5,8,0
64365,6,3,225721,225723,225726,2,5,0
64366,5,2,225726,225726,225728,0,2,0
64367,3,2,225729,225729,225731,0,2,1
64368,5,2,225734,225734,225736,0,2,3
64369,5,3,225739,225739,225742,0,3,3
64370,2,2,225741,225742,225744,1,3,0
64371,3,3,225744,225744,225747,0,3,0
64372,3,2,225747,225747,225749,0,2,0
64373,3,3,225750,225750,225753,0,3,1
64374,4,1,225754,225754,225755,0,1,1
64375,3,3,225757,225757,225760,0,3,2
64376,6,2,225763,225763,225765,0,2,3
64377,6,1,225769,225769,225770,0,1,4
64378,5,2,225774,225774,225776,0,2,4
64379,5,2,225779,225779,225781,0,2,3
64380,1,3,225780,225781,225784,1,4,0
64381,6,2,225786,225786,225788,0,2,2
64382,4,2,225790,225790,225792,0,2,2
64383,1,2,225791,225792,225794,1,3,0
64384,4,2,225795,225795,225797,0,2,1
64385,4,2,225799,225799,225801,0,2,2
64386,6,1,225805,225805,225806,0,1,4
64387,1,2,225806,225806,225808,0,2,0
64388,2,1,225808,225808,225809,0,1,0
64389,2,3,225810,225810,225813,0,3,1
64390,6,2,225816,225816,225818,0,2,3
64391,3,3,225819,225819,225822,0,3,1
64392,3,3,225822,225822,225825,0,3,0
64393,3,2,225825,225825,225827,0,2,0
64394,1,2,225826,225827,225829,1,3,0
64395,1,1,225827,225829,225830,2,3,0
64396,2,3,225829,225830,225833,1,4,0
64397,5,3,225834,225834,225837,0,3,1
64398,4,1,225838,225838,225839,0,1,1
64399,3,1,225841,225841,225842,0,1,2
64400,2,3,225843,225843,225846,0,3,1
64401,4,3,225847,225847,225850,0,3,1
64402,3,2,225850,225850,225852,0,2,0
64403,3,1,225853,225853,225854,0,1,1
64404,2,1,225855,225855,225856,0,1,1
64405,2,1,225857,225857,225858,0,1,1
64406,3,2,225860,225860,225862,0,2,2
64407,3,1,225863,225863,225864,0,1,1
64408,3,3,225866,225866,225869,0,3,2
64409,5,2,225871,225871,225873,0,2,2
64410,2,1,225873,225873,225874,0,1,0
64411,2,3,225875,225875,225878,0,3,1
64412,3,2,225878,225878,225880,0,2,0
64413,3,3,225881,225881,225884,0,3,1
64414,3,1,225884,225884,225885,0,1,0
64415,2,1,225886,225886,225887,0,1,1
64416,5,3,225891,225891,225894,0,3,4
64417,5,2,225896,225896,225898,0,2,2
64418,5,1,225901,225901,225902,0,1,3
64419,1,1,225902,225902,225903,0,1,0
64420,2,3,225904,225904,225907,0,3,1
64421,4,1,225908,225908,225909,0,1,1
64422,1,1,225909,225909,225910,0,1,0
64423,3,3,225912,225912,225915,0,3,2
64424,1,1,225913,225915,225916,2,3,0
64425,5,1,225918,225918,225919,0,1,2
64426,2,1,225920,225920,225921,0,1,1
64427,2,2,225922,225922,225924,0,2,1
64428,6,2,225928,225928,225930,0,2,4
64429,5,2,225933,225933,225935,0,2,3
64430,3,2,225936,225936,225938,0,2,1
64431,5,2,225941,225941,225943,0,2,3
64432,1,3,225942,225943,225946,1,4,0
64433,4,2,225946,225946,225948,0,2,0
64434,2,1,225948,225948,225949,0,1,0
64435,6,1,225954,225954,225955,0,1,5
64436,3,2,225957,225957,225959,0,2,2
64437,6,1,225963,225963,225964,0,1,4
64438,4,1,225967,225967,225968,0,1,3
64439,5,3,225972,225972,225975,0,3,4
64440,2,1,225974,225975,225976,1,2,0
64441,6,2,225980,225980,225982,0,2,4
64442,4,3,225984,225984,225987,0,3,2
64443,6,2,225990,225990,225992,0,2,3
64444,2,1,225992,225992,225993,0,1,0
64445,4,1,225996,225996,225997,0,1,3
64446,3,2,225999,225999,226001,0,2,2
64447,5,2,226004,226004,226006,0,2,3
64448,6,2,226010,226010,226012,0,2,4
64449,5,1,226015,226015,226016,0,1,3
64450,2,1,226017,226017,226018,0,1,1
64451,2,1,226019,226019,226020,0,1,1
64452,1,1,226020,226020,226021,0,1,0
64453,3,3,226023,226023,226026,0,3,2
64454,1,3,226024,226026,226029,2,5,0
64455,2,3,226026,226029,226032,3,6,0
64456,6,1,226032,226032,226033,0,1,0
64457,6,3,226038,226038,226041,0,3,5
64458,2,2,226040,226041,226043,1,3,0
64459,3,3,226043,226043,226046,0,3,0
64460,2,2,226045,226046,226048,1,3,0
64461,3,1,226048,226048,226049,0,1,0
64462,2,2,226050,226050,226052,0,2,1
64463,5,2,226055,226055,226057,0,2,3
64464,2,2,226057,226057,226059,0,2,0
64465,3,1,226060,226060,226061,0,1,1
64466,4,1,226064,226064,226065,0,1,3
64467,6,1,226070,226070,226071,0,1,5
64468,2,2,226072,226072,226074,0,2,1
64469,3,2,226075,226075,226077,0,2,1
64470,1,3,226076,226077,226080,1,4,0
64471,4,2,226080,226080,226082,0,2,0
64472,4,1,226084,226084,226085,0,1,2
64473,6,1,226090,226090,226091,0,1,5
64474,4,3,226094,226094,226097,0,3,3
64475,4,3,226098,226098,226101,0,3,1
64476,5,1,226103,226103,226104,0,1,2
64477,6,3,226109,226109,226112,0,3,5
64478,3,2,226112,226112,226114,0,2,0
64479,5,2,226117,226117,226119,0,2,3
64480,2,2,226119,226119,226121,0,2,0
64481,2,1,226121,226121,226122,0,1,0
64482,5,3,226126,226126,226129,0,3,4
64483,1,3,226127,226129,226132,2,5,0
64484,6,3,226133,226133,226136,0,3,1
64485,6,2,226139,226139,226141,0,2,3
64486,3,1,226142,226142,226143,0,1,1
64487,3,2,226145,226145,226147,0,2,2
64488,4,1,226149,226149,226150,0,1,2
64489,1,1,226150,226150,226151,0,1,0
64490,1,1,226151,226151,226152,0,1,0
64491,3,1,226154,226154,226155,0,1,2
64492,1,3,226155,226155,226158,0,3,0
64493,2,3,226157,226158,226161,1,4,0
64494,4,2,226161,226161,226163,0,2,0
64495,4,1,226165,226165,226166,0,1,2
64496,1,2,226166,226166,226168,0,2,0
64497,5,1,226171,226171,226172,0,1,3
64498,4,2,226175,226175,226177,0,2,3
64499,3,1,226178,226178,226179,0,1,1
64500,3,2,226181,226181,226183,0,2,2
64501,1,2,226182,226183,226185,1,3,0
64502,5,3,226187,226187,226190,0,3,2
64503,1,2,226188,226190,226192,2,4,0
64504,5,1,226193,226193,226194,0,1,1
64505,1,2,226194,226194,226196,0,2,0
64506,1,2,226195,226196,226198,1,3,0
64507,2,2,226197,226198,226200,1,3,0
64508,5,2,226202,226202,226204,0,2,2
64509,2,3,226204,226204,226207,0,3,0
64510,5,1,226209,226209,226210,0,1,2
64511,3,2,226212,226212,226214,0,2,2
64512,5,2,226217,226217,226219,0,2,3
64513,3,3,226220,226220,226223,0,3,1
64514,4,1,226224,226224,226225,0,1,1
64515,3,2,226227,226227,226229,0,2,2
64516,4,2,226231,226231,226233,0,2,2
64517,4,3,226235,226235,226238,0,3,2
64518,2,3,226237,226238,226241,1,4,0
64519,1,3,226238,226241,226244,3,6,0
64520,4,1,226242,226244,226245,2,3,0
64521,1,3,226243,226245,226248,2,5,0
64522,5,1,226248,226248,226249,0,1,0
64523,5,2,226253,226253,226255,0,2,4
64524,6,2,226259,226259,226261,0,2,4
64525,2,2,226261,226261,226263,0,2,0
64526,2,1,226263,226263,226264,0,1,0
64527,4,3,226267,226267,226270,0,3,3
64528,5,3,226272,226272,226275,0,3,2
64529,6,2,226278,226278,226280,0,2,3
64530,1,3,226279,226280,226283,1,4,0
64531,5,2,226284,226284,226286,0,2,1
64532,2,1,226286,226286,226287,0,1,0
64533,5,2,226291,226291,226293,0,2,4
64534,5,2,226296,226296,226298,0,2,3
64535,6,1,226302,226302,226303,0,1,4
64536,2,2,226304,226304,226306,0,2,1
64537,4,2,226308,226308,226310,0,2,2
64538,1,1,226309,226310,226311,1,2,0
64539,6,1,226315,226315,226316,0,1,4
64540,4,2,226319,226319,226321,0,2,3
64541,5,2,226324,226324,226326,0,2,3
64542,6,1,226330,226330,226331,0,1,4
64543,5,2,226335,226335,226337,0,2,4
64544,2,3,226337,226337,226340,0,3,0
64545,2,1,226339,226340,226341,1,2,0
64546,1,1,226340,226341,226342,1,2,0
64547,3,3,226343,226343,226346,0,3,1
64548,2,2,226345,226346,226348,1,3,0
64549,2,1,226347,226348,226349,1,2,0
64550,3,3,226350,226350,226353,0,3,1
64551,6,2,226356,226356,226358,0,2,3
64552,6,3,226362,226362,226365,0,3,4
64553,2,1,226364,226365,226366,1,2,0
64554,1,1,226365,226366,226367,1,2,0
64555,2,3,226367,226367,226370,0,3,0
64556,3,1,226370,226370,226371,0,1,0
64557,6,3,226376,226376,226379,0,3,5
64558,5,1,226381,226381,226382,0,1,2
64559,6,2,226387,226387,226389,0,2,5
64560,5,2,226392,226392,226394,0,2,3
64561,6,2,226398,226398,226400,0,2,4
64562,2,2,226400,226400,226402,0,2,0
64563,3,1,226403,226403,226404,0,1,1
64564,2,2,226405,226405,226407,0,2,1
64565,6,1,226411,226411,226412,0,1,4
64566,4,1,226415,226415,226416,0,1,3
64567,6,3,226421,226421,226424,0,3,5
64568,5,3,226426,226426,226429,0,3,2
64569,1,1,226427,226429,226430,2,3,0
64570,1,1,226428,226430,226431,2,3,0
64571,4,2,226432,226432,226434,0,2,1
64572,5,3,226437,226437,226440,0,3,3
64573,2,2,226439,226440,226442,1,3,0
64574,2,1,226441,226442,226443,1,2,0
64575,4,3,226445,226445,226448,0,3,2
64576,2,3,226447,226448,226451,1,4,0
64577,1,2,226448,226451,226453,3,5,0
64578,5,1,226453,226453,226454,0,1,0
64579,1,2,226454,226454,226456,0,2,0
64580,2,2,226456,226456,226458,0,2,0
64581,5,1,226461,226461,226462,0,1,3
64582,6,3,226467,226467,226470,0,3,5
64583,2,1,226469,226470,226471,1,2,0
64584,1,3,226470,226471,226474,1,4,0
64585,1,2,226471,226474,226476,3,5,0
64586,6,1,226477,226477,226478,0,1,1
64587,6,2,226483,226483,226485,0,2,5
64588,3,2,226486,226486,226488,0,2,1
64589,2,1,226488,226488,226489,0,1,0
64590,6,2,226494,226494,226496,0,2,5
64591,2,1,226496,226496,226497,0,1,0
64592,6,1,226502,226502,226503,0,1,5
64593,2,1,226504,226504,226505,0,1,1
64594,1,2,226505,226505,226507,0,2,0
64595,4,3,226509,226509,226512,0,3,2
64596,5,3,226514,226514,226517,0,3,2
64597,2,1,226516,226517,226518,1,2,0
64598,5,2,226521,226521,226523,0,2,3
64599,2,2,226523,226523,226525,0,2,0
64600,4,2,226527,226527,226529,0,2,2
64601,4,3,226531,226531,226534,0,3,2
64602,5,2,226536,226536,226538,0,2,2
64603,4,3,226540,226540,226543,0,3,2
64604,5,1,226545,226545,226546,0,1,2
64605,3,3,226548,226548,226551,0,3,2
64606,1,3,226549,226551,226554,2,5,0
64607,4,3,226553,226554,226557,1,4,0
64608,4,2,226557,226557,226559,0,2,0
64609,4,2,226561,226561,226563,0,2,2
64610,4,2,226565,226565,226567,0,2,2
64611,6,3,226571,226571,226574,0,3,4
64612,1,3,226572,226574,226577,2,5,0
64613,4,3,226576,226577,226580,1,4,0
64614,3,2,226579,226580,226582,1,3,0
64615,4,1,226583,226583,226584,0,1,1
64616,3,2,226586,226586,226588,0,2,2
64617,3,2,226589,226589,226591,0,2,1
64618,5,3,226594,226594,226597,0,3,3
64619,1,3,226595,226597,226600,2,5,0
64620,1,1,226596,226600,226601,4,5,0
64621,6,1,226602,226602,226603,0,1,1
64622,1,2,226603,226603,226605,0,2,0
64623,4,3,226607,226607,226610,0,3,2
64624,2,1,226609,226610,226611,1,2,0
64625,3,3,226612,226612,226615,0,3,1
64626,3,2,226615,226615,226617,0,2,0
64627,6,3,226621,226621,226624,0,3,4
64628,4,3,226625,226625,226628,0,3,1
64629,1,3,226626,226628,226631,2,5,0
64630,6,2,226632,226632,226634,0,2,1
64631,4,1,226636,226636,226637,0,1,2
64632,1,1,226637,226637,226638,0,1,0
64633,2,3,226639,226639,226642,0,3,1
64634,5,3,226644,226644,226647,0,3,2
64635,4,2,226648,226648,226650,0,2,1
64636,1,3,226649,226650,226653,1,4,0
64637,3,2,226652,226653,226655,1,3,0
64638,5,1,226657,226657,226658,0,1,2
64639,3,1,226660,226660,226661,0,1,2
64640,3,1,226663,226663,226664,0,1,2
64641,1,3,226664,226664,226667,0,3,0
64642,6,1,226670,226670,226671,0,1,3
64643,1,3,226671,226671,226674,0,3,0
64644,1,1,226672,226674,226675,2,3,0
64645,3,1,226675,226675,226676,0,1,0
64646,6,3,226681,226681,226684,0,3,5
64647,2,1,226683,226684,226685,1,2,0
64648,4,3,226687,226687,226690,0,3,2
64649,6,1,226693,226693,226694,0,1,3
64650,1,1,226694,226694,226695,0,1,0
64651,4,2,226698,226698,226700,0,2,3
64652,3,1,226701,226701,226702,0,1,1
64653,4,3,226705,226705,226708,0,3,3
64654,1,2,226706,226708,226710,2,4,0
64655,5,3,226711,226711,226714,0,3,1
64656,1,1,226712,226714,226715,2,3,0
64657,6,1,226718,226718,226719,0,1,3
64658,4,2,226722,226722,226724,0,2,3
64659,2,1,226724,226724,226725,0,1,0
64660,5,2,226729,226729,226731,0,2,4
64661,5,2,226734,226734,226736,0,2,3
64662,3,2,226737,226737,226739,0,2,1
64663,1,2,226738,226739,226741,1,3,0
64664,3,2,226741,226741,226743,0,2,0
64665,4,2,226745,226745,226747,0,2,2
64666,3,2,226748,226748,226750,0,2,1
64667,6,2,226754,226754,226756,0,2,4
64668,3,3,226757,226757,226760,0,3,1
64669,4,2,226761,226761,226763,0,2,1
64670,3,1,226764,226764,226765,0,1,1
64671,3,3,226767,226767,226770,0,3,2
64672,1,1,226768,226770,226771,2,3,0
64673,3,2,226771,226771,226773,0,2,0
64674,3,1,226774,226774,226775,0,1,1
64675,6,3,226780,226780,226783,0,3,5
64676,6,2,226786,226786,226788,0,2,3
64677,6,3,226792,226792,226795,0,3,4
64678,3,2,226795,226795,226797,0,2,0
64679,2,1,226797,226797,226798,0,1,0
64680,5,3,226802,226802,226805,0,3,4
64681,4,1,226806,226806,226807,0,1,1
64682,1,1,226807,226807,226808,0,1,0
64683,1,2,226808,226808,226810,0,2,0
64684,2,3,226810,226810,226813,0,3,0
64685,6,3,226816,226816,226819,0,3,3
64686,5,3,226821,226821,226824,0,3,2
64687,2,2,226823,226824,226826,1,3,0
64688,1,1,226824,226826,226827,2,3,0
64689,5,2,226829,226829,226831,0,2,2
64690,4,2,226833,226833,226835,0,2,2
64691,6,2,226839,226839,226841,0,2,4
64692,1,1,226840,226841,226842,1,2,0
64693,1,1,226841,226842,226843,1,2,0
64694,6,1,226847,226847,226848,0,1,4
64695,2,1,226849,226849,226850,0,1,1
64696,2,1,226851,226851,226852,0,1,1
64697,6,1,226857,226857,226858,0,1,5
64698,4,1,226861,226861,226862,0,1,3
64699,6,3,226867,226867,226870,0,3,5
64700,5,2,226872,226872,226874,0,2,2
64701,2,3,226874,226874,226877,0,3,0
64702,1,1,226875,226877,226878,2,3,0
64703,6,1,226881,226881,226882,0,1,3
64704,4,2,226885,226885,226887,0,2,3
64705,1,1,226886,226887,226888,1,2,0
64706,2,2,226888,226888,226890,0,2,0
64707,4,2,226892,226892,226894,0,2,2
64708,1,1,226893,226894,226895,1,2,0
64709,5,1,226898,226898,226899,0,1,3
64710,6,3,226904,226904,226907,0,3,5
64711,3,2,226907,226907,226909,0,2,0
64712,5,3,226912,226912,226915,0,3,3
64713,2,3,226914,226915,226918,1,4,0
64714,2,1,226916,226918,226919,2,3,0
64715,4,1,226920,226920,226921,0,1,1
64716,2,2,226922,226922,226924,0,2,1
64717,2,2,226924,226924,226926,0,2,0
64718,6,2,226930,226930,226932,0,2,4
64719,2,3,226932,226932,226935,0,3,0
64720,6,1,226938,226938,226939,0,1,3
64721,5,3,226943,226943,226946,0,3,4
64722,1,3,226944,226946,226949,2,5,0
64723,4,3,226948,226949,226952,1,4,0
64724,2,3,226950,226952,226955,2,5,0
64725,3,2,226953,226955,226957,2,4,0
64726,2,3,226955,226957,226960,2,5,0
64727,6,3,226961,226961,226964,0,3,1
64728,4,1,226965,226965,226966,0,1,1
64729,6,1,226971,226971,226972,0,1,5
64730,4,3,226975,226975,226978,0,3,3
64731,3,3,226978,226978,226981,0,3,0
64732,1,3,226979,226981,226984,2,5,0
64733,2,1,226981,226984,226985,3,4,0
64734,2,1,226983,226985,226986,2,3,0
64735,3,2,226986,226986,226988,0,2,0
64736,2,3,226988,226988,226991,0,3,0
64737,3,2,226991,226991,226993,0,2,0
64738,2,3,226993,226993,226996,0,3,0
64739,5,1,226998,226998,226999,0,1,2
64740,6,2,227004,227004,227006,0,2,5
64741,1,2,227005,227006,227008,1,3,0
64742,4,2,227009,227009,227011,0,2,1
64743,4,2,227013,227013,227015,0,2,2
64744,1,1,227014,227015,227016,1,2,0
64745,4,3,227018,227018,227021,0,3,2
64746,1,1,227019,227021,227022,2,3,0
64747,1,3,227020,227022,227025,2,5,0
64748,6,1,227026,227026,227027,0,1,1
64749,2,2,227028,227028,227030,0,2,1
64750,2,1,227030,227030,227031,0,1,0
64751,4,1,227034,227034,227035,0,1,3
64752,5,1,227039,227039,227040,0,1,4
64753,6,1,227045,227045,227046,0,1,5
64754,5,2,227050,227050,227052,0,2,4
64755,4,1,227054,227054,227055,0,1,2
64756,6,2,227060,227060,227062,0,2,5
64757,1,3,227061,227062,227065,1,4,0
64758,1,1,227062,227065,227066,3,4,0
64759,1,1,227063,227066,227067,3,4,0
64760,1,2,227064,227067,227069,3,5,0
64761,2,2,227066,227069,227071,3,5,0
64762,3,1,227069,227071,227072,2,3,0
64763,2,1,227071,227072,227073,1,2,0
64764,4,1,227075,227075,227076,0,1,2
64765,5,1,227080,227080,227081,0,1,4
64766,5,3,227085,227085,227088,0,3,4
64767,2,1,227087,227088,227089,1,2,0
64768,2,1,227089,227089,227090,0,1,0
64769,5,1,227094,227094,227095,0,1,4
64770,2,1,227096,227096,227097,0,1,1
64771,3,1,227099,227099,227100,0,1,2
64772,3,3,227102,227102,227105,0,3,2
64773,6,2,227108,227108,227110,0,2,3
64774,5,3,227113,227113,227116,0,3,3
64775,3,2,227116,227116,227118,0,2,0
64776,1,3,227117,227118,227121,1,4,0
64777,3,2,227120,227121,227123,1,3,0
64778,6,1,227126,227126,227127,0,1,3
64779,5,3,227131,227131,227134,0,3,4
64780,5,2,227136,227136,227138,0,2,2
64781,6,1,227142,227142,227143,0,1,4
64782,1,2,227143,227143,227145,0,2,0
64783,1,3,227144,227145,227148,1,4,0
64784,6,3,227150,227150,227153,0,3,2
64785,3,1,227153,227153,227154,0,1,0
64786,4,2,227157,227157,227159,0,2,3
64787,4,2,227161,227161,227163,0,2,2
64788,2,2,227163,227163,227165,0,2,0
64789,6,2,227169,227169,227171,0,2,4
64790,1,1,227170,227171,227172,1,2,0
64791,3,1,227173,227173,227174,0,1,1
64792,1,2,227174,227174,227176,0,2,0
64793,3,2,227177,227177,227179,0,2,1
64794,4,1,227181,227181,227182,0,1,2
64795,6,2,227187,227187,227189,0,2,5
64796,5,3,227192,227192,227195,0,3,3
64797,2,2,227194,227195,227197,1,3,0
64798,6,1,227200,227200,227201,0,1,3
64799,2,2,227202,227202,227204,0,2,1
64800,1,1,227203,227204,227205,1,2,0
64801,2,3,227205,227205,227208,0,3,0
64802,6,3,227211,227211,227214,0,3,3
64803,6,2,227217,227217,227219,0,2,3
64804,3,1,227220,227220,227221,0,1,1
64805,4,1,227224,227224,227225,0,1,3
64806,3,1,227227,227227,227228,0,1,2
64807,1,1,227228,227228,227229,0,1,0
64808,2,1,227230,227230,227231,0,1,1
64809,2,2,227232,227232,227234,0,2,1
64810,1,3,227233,227234,227237,1,4,0
64811,3,2,227236,227237,227239,1,3,0
64812,6,1,227242,227242,227243,0,1,3
64813,5,3,227247,227247,227250,0,3,4
64814,2,2,227249,227250,227252,1,3,0
64815,2,1,227251,227252,227253,1,2,0
64816,6,1,227257,227257,227258,0,1,4
64817,2,2,227259,227259,227261,0,2,1
64818,2,3,227261,227261,227264,0,3,0
64819,2,2,227263,227264,227266,1,3,0
64820,2,2,227265,227266,227268,1,3,0
64821,4,3,227269,227269,227272,0,3,1
64822,4,3,227273,227273,227276,0,3,1
64823,4,3,227277,227277,227280,0,3,1
64824,4,3,227281,227281,227284,0,3,1
64825,6,1,227287,227287,227288,0,1,3
64826,1,2,227288,227288,227290,0,2,0
64827,1,2,227289,227290,227292,1,3,0
64828,3,2,227292,227292,227294,0,2,0
64829,4,3,227296,227296,227299,0,3,2
64830,2,3,227298,227299,227302,1,4,0
64831,3,3,227301,227302,227305,1,4,0
64832,1,3,227302,227305,227308,3,6,0
64833,3,3,227305,227308,227311,3,6,0
64834,6,1,227311,227311,227312,0,1,0
64835,5,1,227316,227316,227317,0,1,4
64836,6,3,227322,227322,227325,0,3,5
64837,5,2,227327,227327,227329,0,2,2
64838,4,3,227331,227331,227334,0,3,2
64839,3,3,227334,227334,227337,0,3,0
64840,6,1,227340,227340,227341,0,1,3
64841,2,3,227342,227342,227345,0,3,1
64842,1,1,227343,227345,227346,2,3,0
64843,6,2,227349,227349,227351,0,2,3
64844,2,1,227351,227351,227352,0,1,0
64845,4,3,227355,227355,227358,0,3,3
64846,5,2,227360,227360,227362,0,2,2
64847,2,2,227362,227362,227364,0,2,0
64848,1,3,227363,227364,227367,1,4,0
64849,1,3,227364,227367,227370,3,6,0
64850,2,3,227366,227370,227373,4,7,0
64851,4,1,227370,227373,227374,3,4,0
64852,4,3,227374,227374,227377,0,3,0
64853,1,1,227375,227377,227378,2,3,0
64854,5,2,227380,227380,227382,0,2,2
64855,1,3,227381,227382,227385,1,4,0
64856,4,3,227385,227385,227388,0,3,0
64857,3,3,227388,227388,227391,0,3,0
64858,1,2,227389,227391,227393,2,4,0
64859,6,1,227395,227395,227396,0,1,2
64860,1,1,227396,227396,227397,0,1,0
64861,5,2,227401,227401,227403,0,2,4
64862,3,3,227404,227404,227407,0,3,1
64863,3,3,227407,227407,227410,0,3,0
64864,5,3,227412,227412,227415,0,3,2
64865,6,3,227418,227418,227421,0,3,3
64866,1,2,227419,227421,227423,2,4,0
64867,3,3,227422,227423,227426,1,4,0
64868,4,3,227426,227426,227429,0,3,0
64869,4,3,227430,227430,227433,0,3,1
64870,6,3,227436,227436,227439,0,3,3
64871,6,1,227442,227442,227443,0,1,3
64872,1,2,227443,227443,227445,0,2,0
64873,4,2,227447,227447,227449,0,2,2
64874,2,2,227449,227449,227451,0,2,0
64875,2,2,227451,227451,227453,0,2,0
64876,6,2,227457,227457,227459,0,2,4
64877,2,1,227459,227459,227460,0,1,0
64878,1,2,227460,227460,227462,0,2,0
64879,6,3,227466,227466,227469,0,3,4
64880,4,3,227470,227470,227473,0,3,1
64881,6,2,227476,227476,227478,0,2,3
64882,2,1,227478,227478,227479,0,1,0
64883,2,1,227480,227480,227481,0,1,1
64884,4,1,227484,227484,227485,0,1,3
64885,6,2,227490,227490,227492,0,2,5
64886,5,2,227495,227495,227497,0,2,3
64887,5,2,227500,227500,227502,0,2,3
64888,6,1,227506,227506,227507,0,1,4
64889,2,2,227508,227508,227510,0,2,1
64890,5,3,227513,227513,227516,0,3,3
64891,2,2,227515,227516,227518,1,3,0
64892,4,2,227519,227519,227521,0,2,1
64893,2,3,227521,227521,227524,0,3,0
64894,2,3,227523,227524,227527,1,4,0
64895,2,3,227525,227527,227530,2,5,0
64896,2,3,227527,227530,227533,3,6,0
64897,5,3,227532,227533,227536,1,4,0
64898,6,2,227538,227538,227540,0,2,2
64899,2,2,227540,227540,227542,0,2,0
64900,6,2,227546,227546,227548,0,2,4
64901,1,2,227547,227548,227550,1,3,0
64902,4,1,227551,227551,227552,0,1,1
64903,3,3,227554,227554,227557,0,3,2
64904,4,1,227558,227558,227559,0,1,1
64905,2,2,227560,227560,227562,0,2,1
64906,6,2,227566,227566,227568,0,2,4
64907,1,3,227567,227568,227571,1,4,0
64908,4,3,227571,227571,227574,0,3,0
64909,3,2,227574,227574,227576,0,2,0
64910,2,2,227576,227576,227578,0,2,0
64911,1,3,227577,227578,227581,1,4,0
64912,4,3,227581,227581,227584,0,3,0
64913,2,2,227583,227584,227586,1,3,0
64914,4,1,227587,227587,227588,0,1,1
64915,6,1,227593,227593,227594,0,1,5
64916,3,1,227596,227596,227597,0,1,2
64917,4,2,227600,227600,227602,0,2,3
64918,4,1,227604,227604,227605,0,1,2
64919,6,3,227610,227610,227613,0,3,5
64920,5,1,227615,227615,227616,0,1,2
64921,1,1,227616,227616,227617,0,1,0
64922,4,1,227620,227620,227621,0,1,3
64923,2,1,227622,227622,227623,0,1,1
64924,1,1,227623,227623,227624,0,1,0
64925,1,3,227624,227624,227627,0,3,0
64926,2,1,227626,227627,227628,1,2,0
64927,2,2,227628,227628,227630,0,2,0
64928,4,3,227632,227632,227635,0,3,2
64929,2,1,227634,227635,227636,1,2,0
64930,5,2,227639,227639,227641,0,2,3
64931,2,2,227641,227641,227643,0,2,0
64932,3,2,227644,227644,227646,0,2,1
64933,4,3,227648,227648,227651,0,3,2
64934,6,1,227654,227654,227655,0,1,3
64935,2,3,227656,227656,227659,0,3,1
64936,6,2,227662,227662,227664,0,2,3
64937,6,1,227668,227668,227669,0,1,4
64938,2,3,227670,227670,227673,0,3,1
64939,6,1,227676,227676,227677,0,1,3
64940,3,1,227679,227679,227680,0,1,2
64941,6,3,227685,227685,227688,0,3,5
64942,2,3,227687,227688,227691,1,4,0
64943,2,1,227689,227691,227692,2,3,0
64944,1,3,227690,227692,227695,2,5,0
64945,3,3,227693,227695,227698,2,5,0
64946,2,2,227695,227698,227700,3,5,0
64947,4,2,227699,227700,227702,1,3,0
64948,6,2,227705,227705,227707,0,2,3
64949,1,2,227706,227707,227709,1,3,0
64950,5,1,227711,227711,227712,0,1,2
64951,3,2,227714,227714,227716,0,2,2
64952,2,3,227716,227716,227719,0,3,0
64953,2,3,227718,227719,227722,1,4,0
64954,5,2,227723,227723,227725,0,2,1
64955,5,1,227728,227728,227729,0,1,3
64956,5,1,227733,227733,227734,0,1,4
64957,1,1,227734,227734,227735,0,1,0
64958,5,1,227739,227739,227740,0,1,4
64959,3,3,227742,227742,227745,0,3,2
64960,4,1,227746,227746,227747,0,1,1
64961,2,2,227748,227748,227750,0,2,1
64962,6,2,227754,227754,227756,0,2,4
64963,4,3,227758,227758,227761,0,3,2
64964,5,2,227763,227763,227765,0,2,2
64965,5,1,227768,227768,227769,0,1,3
64966,6,1,227774,227774,227775,0,1,5
64967,2,3,227776,227776,227779,0,3,1
64968,5,3,227781,227781,227784,0,3,2
64969,2,1,227783,227784,227785,1,2,0
64970,4,1,227787,227787,227788,0,1,2
64971,6,2,227793,227793,227795,0,2,5
64972,4,3,227797,227797,227800,0,3,2
64973,4,1,227801,227801,227802,0,1,1
64974,5,2,227806,227806,227808,0,2,4
64975,4,1,227810,227810,227811,0,1,2
64976,2,2,227812,227812,227814,0,2,1
64977,5,3,227817,227817,227820,0,3,3
64978,5,2,227822,227822,227824,0,2,2
64979,6,2,227828,227828,227830,0,2,4
64980,2,1,227830,227830,227831,0,1,0
64981,2,3,227832,227832,227835,0,3,1
64982,1,1,227833,227835,227836,2,3,0
64983,6,3,227839,227839,227842,0,3,3
64984,5,3,227844,227844,227847,0,3,2
64985,3,2,227847,227847,227849,0,2,0
64986,5,3,227852,227852,227855,0,3,3
64987,4,3,227856,227856,227859,0,3,1
64988,3,1,227859,227859,227860,0,1,0
64989,1,2,227860,227860,227862,0,2,0
64990,5,1,227865,227865,227866,0,1,3
64991,5,3,227870,227870,227873,0,3,4
64992,6,2,227876,227876,227878,0,2,3
64993,6,1,227882,227882,227883,0,1,4
64994,1,1,227883,227883,227884,0,1,0
64995,1,2,227884,227884,227886,0,2,0
64996,4,1,227888,227888,227889,0,1,2
64997,6,1,227894,227894,227895,0,1,5
64998,4,2,227898,227898,227900,0,2,3
64999,6,3,227904,227904,227907,0,3,4
65000,6,3,227910,227910,227913,0,3,3
65001,1,2,227911,227913,227915,2,4,0
65002,5,1,227916,227916,227917,0,1,1
65003,5,3,227921,227921,227924,0,3,4
65004,3,3,227924,227924,227927,0,3,0
65005,3,3,227927,227927,227930,0,3,0
65006,5,2,227932,227932,227934,0,2,2
65007,4,1,227936,227936,227937,0,1,2
65008,5,1,227941,227941,227942,0,1,4
65009,1,1,227942,227942,227943,0,1,0
65010,4,3,227946,227946,227949,0,3,3
65011,5,2,227951,227951,227953,0,2,2
65012,1,1,227952,227953,227954,1,2,0
65013,1,2,227953,227954,227956,1,3,0
65014,4,3,227957,227957,227960,0,3,1
65015,5,3,227962,227962,227965,0,3,2
65016,4,2,227966,227966,227968,0,2,1
65017,6,1,227972,227972,227973,0,1,4
65018,3,2,227975,227975,227977,0,2,2
65019,4,1,227979,227979,227980,0,1,2
65020,2,1,227981,227981,227982,0,1,1
65021,1,2,227982,227982,227984,0,2,0
65022,4,1,227986,227986,227987,0,1,2
65023,6,2,227992,227992,227994,0,2,5
65024,5,1,227997,227997,227998,0,1,3
65025,2,1,227999,227999,228000,0,1,1
65026,3,2,228002,228002,228004,0,2,2
65027,3,3,228005,228005,228008,0,3,1
65028,4,2,228009,228009,228011,0,2,1
65029,4,3,228013,228013,228016,0,3,2
65030,6,1,228019,228019,228020,0,1,3
65031,2,3,228021,228021,228024,0,3,1
65032,3,2,228024,228024,228026,0,2,0
65033,3,1,228027,228027,228028,0,1,1
65034,4,2,228031,228031,228033,0,2,3
65035,6,1,228037,228037,228038,0,1,4
65036,2,3,228039,228039,228042,0,3,1
65037,6,2,228045,228045,228047,0,2,3
65038,4,2,228049,228049,228051,0,2,2
65039,4,2,228053,228053,228055,0,2,2
65040,4,1,228057,228057,228058,0,1,2
65041,1,1,228058,228058,228059,0,1,0
65042,6,3,228064,228064,228067,0,3,5
65043,5,3,228069,228069,228072,0,3,2
65044,1,1,228070,228072,228073,2,3,0
65045,2,1,228072,228073,228074,1,2,0
65046,1,3,228073,228074,228077,1,4,0
65047,4,2,228077,228077,228079,0,2,0
65048,1,3,228078,228079,228082,1,4,0
65049,3,2,228081,228082,228084,1,3,0
65050,1,2,228082,228084,228086,2,4,0
65051,1,3,228083,228086,228089,3,6,0
65052,3,1,228086,228089,228090,3,4,0
65053,2,3,228088,228090,228093,2,5,0
65054,3,2,228091,228093,228095,2,4,0
65055,6,1,228097,228097,228098,0,1,2
65056,6,2,228103,228103,228105,0,2,5
65057,2,2,228105,228105,228107,0,2,0
65058,3,1,228108,228108,228109,0,1,1
65059,3,3,228111,228111,228114,0,3,2
65060,5,2,228116,228116,228118,0,2,2
65061,4,1,228120,228120,228121,0,1,2
65062,4,3,228124,228124,228127,0,3,3
65063,5,1,228129,228129,228130,0,1,2
65064,4,1,228133,228133,228134,0,1,3
65065,3,3,228136,228136,228139,0,3,2
65066,3,3,228139,228139,228142,0,3,0
65067,3,1,228142,228142,228143,0,1,0
65068,3,3,228145,228145,228148,0,3,2
65069,2,2,228147,228148,228150,1,3,0
65070,2,3,228149,228150,228153,1,4,0
65071,3,3,228152,228153,228156,1,4,0
65072,4,2,228156,228156,228158,0,2,0
65073,3,3,228159,228159,228162,0,3,1
65074,3,2,228162,228162,228164,0,2,0
65075,1,3,228163,228164,228167,1,4,0
65076,5,2,228168,228168,228170,0,2,1
65077,3,2,228171,228171,228173,0,2,1
65078,4,1,228175,228175,228176,0,1,2
65079,1,2,228176,228176,228178,0,2,0
65080,1,2,228177,228178,228180,1,3,0
65081,4,1,228181,228181,228182,0,1,1
65082,1,2,228182,228182,228184,0,2,0
65083,6,3,228188,228188,228191,0,3,4
65084,6,1,228194,228194,228195,0,1,3
65085,3,3,228197,228197,228200,0,3,2
65086,4,1,228201,228201,228202,0,1,1
65087,5,1,228206,228206,228207,0,1,4
65088,2,3,228208,228208,228211,0,3,1
65089,6,2,228214,228214,228216,0,2,3
65090,2,2,228216,228216,228218,0,2,0
65091,4,3,228220,228220,228223,0,3,2
65092,1,2,228221,228223,228225,2,4,0
65093,5,1,228226,228226,228227,0,1,1
65094,4,2,228230,228230,228232,0,2,3
65095,4,3,228234,228234,228237,0,3,2
65096,3,1,228237,228237,228238,0,1,0
65097,5,3,228242,228242,228245,0,3,4
65098,5,3,228247,228247,228250,0,3,2
65099,2,1,228249,228250,228251,1,2,0
65100,1,3,228250,228251,228254,1,4,0
65101,4,3,228254,228254,228257,0,3,0
65102,3,2,228257,228257,228259,0,2,0
65103,1,3,228258,228259,228262,1,4,0
65104,4,1,228262,228262,228263,0,1,0
65105,2,1,228264,228264,228265,0,1,1
65106,4,2,228268,228268,228270,0,2,3
65107,5,2,228273,228273,228275,0,2,3
65108,6,3,228279,228279,228282,0,3,4
65109,3,3,228282,228282,228285,0,3,0
65110,5,2,228287,228287,228289,0,2,2
65111,6,2,228293,228293,228295,0,2,4
65112,5,3,228298,228298,228301,0,3,3
65113,2,1,228300,228301,228302,1,2,0
65114,3,2,228303,228303,228305,0,2,1
65115,3,3,228306,228306,228309,0,3,1
65116,4,3,228310,228310,228313,0,3,1
65117,5,1,228315,228315,228316,0,1,2
65118,4,3,228319,228319,228322,0,3,3
65119,2,1,228321,228322,228323,1,2,0
65120,3,1,228324,228324,228325,0,1,1
65121,5,2,228329,228329,228331,0,2,4
65122,1,3,228330,228331,228334,1,4,0
65123,6,1,228336,228336,228337,0,1,2
65124,6,2,228342,228342,228344,0,2,5
65125,5,1,228347,228347,228348,0,1,3
65126,4,2,228351,228351,228353,0,2,3
65127,6,1,228357,228357,228358,0,1,4
65128,2,1,228359,228359,228360,0,1,1
65129,1,2,228360,228360,228362,0,2,0
65130,5,3,228365,228365,228368,0,3,3
65131,3,2,228368,228368,228370,0,2,0
65132,3,1,228371,228371,228372,0,1,1
65133,3,2,228374,228374,228376,0,2,2
65134,6,2,228380,228380,228382,0,2,4
65135,6,1,228386,228386,228387,0,1,4
65136,4,1,228390,228390,228391,0,1,3
65137,6,2,228396,228396,228398,0,2,5
65138,1,2,228397,228398,228400,1,3,0
65139,6,2,228403,228403,228405,0,2,3
65140,6,3,228409,228409,228412,0,3,4
65141,2,2,228411,228412,228414,1,3,0
65142,6,1,228417,228417,228418,0,1,3
65143,5,2,228422,228422,228424,0,2,4
65144,3,1,228425,228425,228426,0,1,1
65145,5,2,228430,228430,228432,0,2,4
65146,5,2,228435,228435,228437,0,2,3
65147,4,2,228439,228439,228441,0,2,2
65148,3,1,228442,228442,228443,0,1,1
65149,6,2,228448,228448,228450,0,2,5
65150,2,3,228450,228450,228453,0,3,0
65151,1,1,228451,228453,228454,2,3,0
65152,3,2,228454,228454,228456,0,2,0
65153,2,3,228456,228456,228459,0,3,0
65154,2,1,228458,228459,228460,1,2,0
65155,5,3,228463,228463,228466,0,3,3
65156,4,2,228467,228467,228469,0,2,1
65157,1,3,228468,228469,228472,1,4,0
65158,4,2,228472,228472,228474,0,2,0
65159,2,2,228474,228474,228476,0,2,0
65160,5,1,228479,228479,228480,0,1,3
65161,2,3,228481,228481,228484,0,3,1
65162,1,1,228482,228484,228485,2,3,0
65163,4,2,228486,228486,228488,0,2,1
65164,4,2,228490,228490,228492,0,2,2
65165,6,2,228496,228496,228498,0,2,4
65166,2,2,228498,228498,228500,0,2,0
65167,4,2,228502,228502,228504,0,2,2
65168,6,3,228508,228508,228511,0,3,4
65169,6,1,228514,228514,228515,0,1,3
65170,1,3,228515,228515,228518,0,3,0
65171,6,2,228521,228521,228523,0,2,3
65172,1,2,228522,228523,228525,1,3,0
65173,1,1,228523,228525,228526,2,3,0
65174,4,3,228527,228527,228530,0,3,1
65175,4,1,228531,228531,228532,0,1,1
65176,4,1,228535,228535,228536,0,1,3
65177,4,3,228539,228539,228542,0,3,3
65178,6,3,228545,228545,228548,0,3,3
65179,5,1,228550,228550,228551,0,1,2
65180,4,2,228554,228554,228556,0,2,3
65181,2,3,228556,228556,228559,0,3,0
65182,1,3,228557,228559,228562,2,5,0
65183,4,1,228561,228562,228563,1,2,0
65184,6,1,228567,228567,228568,0,1,4
65185,6,3,228573,228573,228576,0,3,5
65186,5,2,228578,228578,228580,0,2,2
65187,6,2,228584,228584,228586,0,2,4
65188,2,1,228586,228586,228587,0,1,0
65189,2,1,228588,228588,228589,0,1,1
65190,2,2,228590,228590,228592,0,2,1
65191,1,1,228591,228592,228593,1,2,0
65192,2,1,228593,228593,228594,0,1,0
65193,2,2,228595,228595,228597,0,2,1
65194,3,2,228598,228598,228600,0,2,1
65195,5,3,228603,228603,228606,0,3,3
65196,2,3,228605,228606,228609,1,4,0
65197,2,3,228607,228609,228612,2,5,0
65198,6,3,228613,228613,228616,0,3,1
65199,3,1,228616,228616,228617,0,1,0
65200,1,1,228617,228617,228618,0,1,0
65201,2,3,228619,228619,228622,0,3,1
65202,1,1,228620,228622,228623,2,3,0
65203,6,1,228626,228626,228627,0,1,3
65204,2,1,228628,228628,228629,0,1,1
65205,2,3,228630,228630,228633,0,3,1
65206,6,3,228636,228636,228639,0,3,3
65207,2,3,228638,228639,228642,1,4,0
65208,6,3,228644,228644,228647,0,3,2
65209,4,2,228648,228648,228650,0,2,1
65210,2,2,228650,228650,228652,0,2,0
65211,6,3,228656,228656,228659,0,3,4
65212,3,2,228659,228659,228661,0,2,0
65213,1,2,228660,228661,228663,1,3,0
65214,1,1,228661,228663,228664,2,3,0
65215,5,1,228666,228666,228667,0,1,2
65216,1,1,228667,228667,228668,0,1,0
65217,1,1,228668,228668,228669,0,1,0
65218,2,1,228670,228670,228671,0,1,1
65219,6,1,228676,228676,228677,0,1,5
65220,5,3,228681,228681,228684,0,3,4
65221,3,2,228684,228684,228686,0,2,0
65222,5,2,228689,228689,228691,0,2,3
65223,1,1,228690,228691,228692,1,2,0
65224,1,3,228691,228692,228695,1,4,0
65225,6,3,228697,228697,228700,0,3,2
65226,3,2,228700,228700,228702,0,2,0
65227,6,3,228706,228706,228709,0,3,4
65228,2,3,228708,228709,228712,1,4,0
65229,2,3,228710,228712,228715,2,5,0
65230,6,1,228716,228716,228717,0,1,1
65231,3,2,228719,228719,228721,0,2,2
65232,5,1,228724,228724,228725,0,1,3
65233,5,1,228729,228729,228730,0,1,4
65234,4,2,228733,228733,228735,0,2,3
65235,3,2,228736,228736,228738,0,2,1
65236,1,3,228737,228738,228741,1,4,0
65237,3,1,228740,228741,228742,1,2,0
65238,2,3,228742,228742,228745,0,3,0
65239,4,3,228746,228746,228749,0,3,1
65240,3,3,228749,228749,228752,0,3,0
65241,2,2,228751,228752,228754,1,3,0
65242,3,3,228754,228754,228757,0,3,0
65243,1,2,228755,228757,228759,2,4,0
65244,2,3,228757,228759,228762,2,5,0
65245,2,2,228759,228762,228764,3,5,0
65246,4,3,228763,228764,228767,1,4,0
65247,2,3,228765,228767,228770,2,5,0
65248,6,3,228771,228771,228774,0,3,1
65249,2,1,228773,228774,228775,1,2,0
65250,6,3,228779,228779,228782,0,3,4
65251,5,1,228784,228784,228785,0,1,2
65252,3,2,228787,228787,228789,0,2,2
65253,6,3,228793,228793,228796,0,3,4
65254,5,3,228798,228798,228801,0,3,2
65255,2,2,228800,228801,228803,1,3,0
65256,3,2,228803,228803,228805,0,2,0
65257,4,2,228807,228807,228809,0,2,2
65258,4,2,228811,228811,228813,0,2,2
65259,2,3,228813,228813,228816,0,3,0
65260,4,2,228817,228817,228819,0,2,1
65261,3,3,228820,228820,228823,0,3,1
65262,5,3,228825,228825,228828,0,3,2
65263,1,1,228826,228828,228829,2,3,0
65264,6,1,228832,228832,228833,0,1,3
65265,5,2,228837,228837,228839,0,2,4
65266,5,1,228842,228842,228843,0,1,3
65267,2,3,228844,228844,228847,0,3,1
65268,4,1,228848,228848,228849,0,1,1
65269,4,3,228852,228852,228855,0,3,3
65270,4,1,228856,228856,228857,0,1,1
65271,4,3,228860,228860,228863,0,3,3
65272,3,1,228863,228863,228864,0,1,0
65273,5,2,228868,228868,228870,0,2,4
65274,1,3,228869,228870,228873,1,4,0
65275,6,3,228875,228875,228878,0,3,2
65276,6,2,228881,228881,228883,0,2,3
65277,2,2,228883,228883,228885,0,2,0
65278,1,3,228884,228885,228888,1,4,0
65279,2,2,228886,228888,228890,2,4,0
65280,2,1,228888,228890,228891,2,3,0
65281,5,3,228893,228893,228896,0,3,2
65282,3,2,228896,228896,228898,0,2,0
65283,1,1,228897,228898,228899,1,2,0
65284,4,2,228901,228901,228903,0,2,2
65285,5,1,228906,228906,228907,0,1,3
65286,2,1,228908,228908,228909,0,1,1
65287,6,3,228914,228914,228917,0,3,5
65288,1,1,228915,228917,228918,2,3,0
65289,5,2,228920,228920,228922,0,2,2
65290,3,3,228923,228923,228926,0,3,1
65291,3,2,228926,228926,228928,0,2,0
65292,2,1,228928,228928,228929,0,1,0
65293,2,3,228930,228930,228933,0,3,1
65294,1,1,228931,228933,228934,2,3,0
65295,6,1,228937,228937,228938,0,1,3
65296,1,3,228938,228938,228941,0,3,0
65297,5,2,228943,228943,228945,0,2,2
65298,6,3,228949,228949,228952,0,3,4
65299,1,1,228950,228952,228953,2,3,0
65300,1,2,228951,228953,228955,2,4,0
65301,6,2,228957,228957,228959,0,2,2
65302,5,3,228962,228962,228965,0,3,3
65303,5,2,228967,228967,228969,0,2,2
65304,5,3,228972,228972,228975,0,3,3
65305,2,2,228974,228975,228977,1,3,0
65306,3,3,228977,228977,228980,0,3,0
65307,2,1,228979,228980,228981,1,2,0
65308,6,3,228985,228985,228988,0,3,4
65309,5,2,228990,228990,228992,0,2,2
65310,2,2,228992,228992,228994,0,2,0
65311,3,1,228995,228995,228996,0,1,1
65312,2,1,228997,228997,228998,0,1,1
65313,6,1,229003,229003,229004,0,1,5
65314,5,2,229008,229008,229010,0,2,4
65315,5,2,229013,229013,229015,0,2,3
65316,3,2,229016,229016,229018,0,2,1
65317,1,3,229017,229018,229021,1,4,0
65318,2,3,229019,229021,229024,2,5,0
65319,3,1,229022,229024,229025,2,3,0
65320,6,1,229028,229028,229029,0,1,3
65321,2,1,229030,229030,229031,0,1,1
65322,2,2,229032,229032,229034,0,2,1
65323,6,2,229038,229038,229040,0,2,4
65324,5,1,229043,229043,229044,0,1,3
65325,5,1,229048,229048,229049,0,1,4
65326,4,1,229052,229052,229053,0,1,3
65327,3,1,229055,229055,229056,0,1,2
65328,4,3,229059,229059,229062,0,3,3
65329,5,1,229064,229064,229065,0,1,2
65330,5,3,229069,229069,229072,0,3,4
65331,5,3,229074,229074,229077,0,3,2
65332,1,2,229075,229077,229079,2,4,0
65333,3,2,229078,229079,229081,1,3,0
65334,2,1,229080,229081,229082,1,2,0
65335,2,2,229082,229082,229084,0,2,0
65336,5,1,229087,229087,229088,0,1,3
65337,3,2,229090,229090,229092,0,2,2
65338,1,2,229091,229092,229094,1,3,0
65339,2,1,229093,229094,229095,1,2,0
65340,1,3,229094,229095,229098,1,4,0
65341,1,1,229095,229098,229099,3,4,0
65342,2,2,229097,229099,229101,2,4,0
65343,2,2,229099,229101,229103,2,4,0
65344,5,2,229104,229104,229106,0,2,1
65345,5,3,229109,229109,229112,0,3,3
65346,1,3,229110,229112,229115,2,5,0
65347,1,3,229111,229115,229118,4,7,0
65348,4,1,229115,229118,229119,3,4,0
65349,3,2,229118,229119,229121,1,3,0
65350,6,1,229124,229124,229125,0,1,3
65351,5,3,229129,229129,229132,0,3,4
65352,4,1,229133,229133,229134,0,1,1
65353,2,3,229135,229135,229138,0,3,1
65354,3,2,229138,229138,229140,0,2,0
65355,3,3,229141,229141,229144,0,3,1
65356,4,1,229145,229145,229146,0,1,1
65357,3,3,229148,229148,229151,0,3,2
65358,4,3,229152,229152,229155,0,3,1
65359,4,3,229156,229156,229159,0,3,1
65360,1,2,229157,229159,229161,2,4,0
65361,6,3,229163,229163,229166,0,3,2
65362,4,2,229167,229167,229169,0,2,1
65363,5,3,229172,229172,229175,0,3,3
65364,1,1,229173,229175,229176,2,3,0
65365,4,3,229177,229177,229180,0,3,1
65366,6,1,229183,229183,229184,0,1,3
65367,2,1,229185,229185,229186,0,1,1
65368,4,1,229189,229189,229190,0,1,3
65369,5,2,229194,229194,229196,0,2,4
65370,5,3,229199,229199,229202,0,3,3
65371,3,1,229202,229202,229203,0,1,0
65372,6,1,229208,229208,229209,0,1,5
65373,5,3,229213,229213,229216,0,3,4
65374,6,1,229219,229219,229220,0,1,3
65375,6,3,229225,229225,229228,0,3,5
65376,5,1,229230,229230,229231,0,1,2
65377,2,1,229232,229232,229233,0,1,1
65378,4,1,229236,229236,229237,0,1,3
65379,1,1,229237,229237,229238,0,1,0
65380,6,1,229243,229243,229244,0,1,5
65381,4,3,229247,229247,229250,0,3,3
65382,4,2,229251,229251,229253,0,2,1
65383,4,3,229255,229255,229258,0,3,2
65384,6,3,229261,229261,229264,0,3,3
65385,1,1,229262,229264,229265,2,3,0
65386,1,2,229263,229265,229267,2,4,0
65387,2,3,229265,229267,229270,2,5,0
65388,3,2,229268,229270,229272,2,4,0
65389,2,3,229270,229272,229275,2,5,0
65390,3,2,229273,229275,229277,2,4,0
65391,6,2,229279,229279,229281,0,2,2
65392,6,3,229285,229285,229288,0,3,4
65393,6,1,229291,229291,229292,0,1,3
65394,6,3,229297,229297,229300,0,3,5
65395,5,1,229302,229302,229303,0,1,2
65396,3,1,229305,229305,229306,0,1,2
65397,4,3,229309,229309,229312,0,3,3
65398,2,2,229311,229312,229314,1,3,0
65399,4,1,229315,229315,229316,0,1,1
65400,3,2,229318,229318,229320,0,2,2
65401,2,1,229320,229320,229321,0,1,0
65402,2,2,229322,229322,229324,0,2,1
65403,3,2,229325,229325,229327,0,2,1
65404,2,2,229327,229327,229329,0,2,0
65405,5,3,229332,229332,229335,0,3,3
65406,4,1,229336,229336,229337,0,1,1
65407,2,2,229338,229338,229340,0,2,1
65408,3,2,229341,229341,229343,0,2,1
65409,2,1,229343,229343,229344,0,1,0
65410,6,2,229349,229349,229351,0,2,5
65411,4,1,229353,229353,229354,0,1,2
65412,3,2,229356,229356,229358,0,2,2
65413,2,2,229358,229358,229360,0,2,0
65414,1,3,229359,229360,229363,1,4,0
65415,6,2,229365,229365,229367,0,2,2
65416,1,1,229366,229367,229368,1,2,0
65417,5,3,229371,229371,229374,0,3,3
65418,2,2,229373,229374,229376,1,3,0
65419,5,2,229378,229378,229380,0,2,2
65420,1,1,229379,229380,229381,1,2,0
65421,4,2,229383,229383,229385,0,2,2
65422,5,2,229388,229388,229390,0,2,3
65423,4,2,229392,229392,229394,0,2,2
65424,5,3,229397,229397,229400,0,3,3
65425,6,1,229403,229403,229404,0,1,3
65426,5,2,229408,229408,229410,0,2,4
65427,3,2,229411,229411,229413,0,2,1
65428,6,3,229417,229417,229420,0,3,4
65429,1,1,229418,229420,229421,2,3,0
65430,1,1,229419,229421,229422,2,3,0
65431,3,1,229422,229422,229423,0,1,0
65432,1,1,229423,229423,229424,0,1,0
65433,2,3,229425,229425,229428,0,3,1
65434,1,1,229426,229428,229429,2,3,0
65435,4,1,229430,229430,229431,0,1,1
65436,3,1,229433,229433,229434,0,1,2
65437,6,3,229439,229439,229442,0,3,5
65438,5,1,229444,229444,229445,0,1,2
65439,4,2,229448,229448,229450,0,2,3
65440,6,3,229454,229454,229457,0,3,4
65441,6,3,229460,229460,229463,0,3,3
65442,1,3,229461,229463,229466,2,5,0
65443,3,2,229464,229466,229468,2,4,0
65444,2,3,229466,229468,229471,2,5,0
65445,3,1,229469,229471,229472,2,3,0
65446,2,3,229471,229472,229475,1,4,0
65447,3,1,229474,229475,229476,1,2,0
65448,2,1,229476,229476,229477,0,1,0
65449,4,2,229480,229480,229482,0,2,3
65450,3,3,229483,229483,229486,0,3,1
65451,1,1,229484,229486,229487,2,3,0
65452,6,2,229490,229490,229492,0,2,3
65453,2,2,229492,229492,229494,0,2,0
65454,5,2,229497,229497,229499,0,2,3
65455,3,2,229500,229500,229502,0,2,1
65456,3,1,229503,229503,229504,0,1,1
65457,6,2,229509,229509,229511,0,2,5
65458,2,1,229511,229511,229512,0,1,0
65459,3,1,229514,229514,229515,0,1,2
65460,1,2,229515,229515,229517,0,2,0
65461,4,1,229519,229519,229520,0,1,2
65462,6,1,229525,229525,229526,0,1,5
65463,3,2,229528,229528,229530,0,2,2
65464,5,3,229533,229533,229536,0,3,3
65465,4,1,229537,229537,229538,0,1,1
65466,3,1,229540,229540,229541,0,1,2
65467,2,2,229542,229542,229544,0,2,1
65468,5,3,229547,229547,229550,0,3,3
65469,3,2,229550,229550,229552,0,2,0
65470,4,1,229554,229554,229555,0,1,2
65471,2,2,229556,229556,229558,0,2,1
65472,5,1,229561,229561,229562,0,1,3
65473,2,3,229563,229563,229566,0,3,1
65474,4,2,229567,229567,229569,0,2,1
65475,3,3,229570,229570,229573,0,3,1
65476,6,1,229576,229576,229577,0,1,3
65477,1,1,229577,229577,229578,0,1,0
65478,3,2,229580,229580,229582,0,2,2
65479,5,1,229585,229585,229586,0,1,3
65480,4,3,229589,229589,229592,0,3,3
65481,6,3,229595,229595,229598,0,3,3
65482,4,3,229599,229599,229602,0,3,1
65483,4,1,229603,229603,229604,0,1,1
65484,3,2,229606,229606,229608,0,2,2
65485,6,2,229612,229612,229614,0,2,4
65486,1,1,229613,229614,229615,1,2,0
65487,5,2,229618,229618,229620,0,2,3
65488,6,2,229624,229624,229626,0,2,4
65489,2,2,229626,229626,229628,0,2,0
65490,5,1,229631,229631,229632,0,1,3
65491,4,1,229635,229635,229636,0,1,3
65492,4,1,229639,229639,229640,0,1,3
65493,4,1,229643,229643,229644,0,1,3
65494,3,2,229646,229646,229648,0,2,2
65495,1,3,229647,229648,229651,1,4,0
65496,1,1,229648,229651,229652,3,4,0
65497,2,2,229650,229652,229654,2,4,0
65498,6,3,229656,229656,229659,0,3,2
65499,4,2,229660,229660,229662,0,2,1
65500,4,3,229664,229664,229667,0,3,2
65501,4,2,229668,229668,229670,0,2,1
65502,2,3,229670,229670,229673,0,3,0
65503,1,2,229671,229673,229675,2,4,0
65504,6,1,229677,229677,229678,0,1,2
65505,1,1,229678,229678,229679,0,1,0
65506,5,2,229683,229683,229685,0,2,4
65507,3,3,229686,229686,229689,0,3,1
65508,3,1,229689,229689,229690,0,1,0
65509,1,2,229690,229690,229692,0,2,0
65510,2,3,229692,229692,229695,0,3,0
65511,1,3,229693,229695,229698,2,5,0
65512,4,3,229697,229698,229701,1,4,0
65513,5,3,229702,229702,229705,0,3,1
65514,5,2,229707,229707,229709,0,2,2
65515,3,1,229710,229710,229711,0,1,1
65516,4,1,229714,229714,229715,0,1,3
65517,5,3,229719,229719,229722,0,3,4
65518,2,1,229721,229722,229723,1,2,0
65519,1,2,229722,229723,229725,1,3,0
65520,5,1,229727,229727,229728,0,1,2
65521,4,2,229731,229731,229733,0,2,3
65522,4,3,229735,229735,229738,0,3,2
65523,2,3,229737,229738,229741,1,4,0
65524,3,3,229740,229741,229744,1,4,0
65525,4,3,229744,229744,229747,0,3,0
65526,1,1,229745,229747,229748,2,3,0
65527,3,1,229748,229748,229749,0,1,0
65528,3,2,229751,229751,229753,0,2,2
65529,1,3,229752,229753,229756,1,4,0
65530,3,2,229755,229756,229758,1,3,0
65531,3,3,229758,229758,229761,0,3,0
65532,5,1,229763,229763,229764,0,1,2
65533,4,3,229767,229767,229770,0,3,3
65534,1,3,229768,229770,229773,2,5,0
65535,3,2,229771,229773,229775,2,4,0
65536,1,3,229772,229775,229778,3,6,0
65537,4,3,229776,229778,229781,2,5,0
65538,1,1,229777,229781,229782,4,5,0
65539,3,1,229780,229782,229783,2,3,0
65540,3,3,229783,229783,229786,0,3,0
65541,2,1,229785,229786,229787,1,2,0
65542,5,2,229790,229790,229792,0,2,3
65543,6,3,229796,229796,229799,0,3,4
65544,1,2,229797,229799,229801,2,4,0
65545,4,2,229801,229801,229803,0,2,0
65546,2,1,229803,229803,229804,0,1,0
65547,4,3,229807,229807,229810,0,3,3
65548,4,3,229811,229811,229814,0,3,1
65549,4,1,229815,229815,229816,0,1,1
65550,6,2,229821,229821,229823,0,2,5
65551,2,1,229823,229823,229824,0,1,0
65552,4,3,229827,229827,229830,0,3,3
65553,3,2,229830,229830,229832,0,2,0
65554,6,2,229836,229836,229838,0,2,4
65555,6,3,229842,229842,229845,0,3,4
65556,2,2,229844,229845,229847,1,3,0
65557,1,2,229845,229847,229849,2,4,0
65558,4,2,229849,229849,229851,0,2,0
65559,6,1,229855,229855,229856,0,1,4
65560,6,2,229861,229861,229863,0,2,5
65561,4,1,229865,229865,229866,0,1,2
65562,2,2,229867,229867,229869,0,2,1
65563,2,2,229869,229869,229871,0,2,0
65564,3,2,229872,229872,229874,0,2,1
65565,3,3,229875,229875,229878,0,3,1
65566,6,1,229881,229881,229882,0,1,3
65567,6,1,229887,229887,229888,0,1,5
65568,5,1,229892,229892,229893,0,1,4
65569,1,2,229893,229893,229895,0,2,0
65570,5,2,229898,229898,229900,0,2,3
65571,3,3,229901,229901,229904,0,3,1
65572,5,3,229906,229906,229909,0,3,2
65573,6,2,229912,229912,229914,0,2,3
65574,6,1,229918,229918,229919,0,1,4
65575,2,2,229920,229920,229922,0,2,1
65576,5,3,229925,229925,229928,0,3,3
65577,1,3,229926,229928,229931,2,5,0
65578,4,2,229930,229931,229933,1,3,0
65579,5,1,229935,229935,229936,0,1,2
65580,6,1,229941,229941,229942,0,1,5
65581,5,2,229946,229946,229948,0,2,4
65582,5,1,229951,229951,229952,0,1,3
65583,5,3,229956,229956,229959,0,3,4
65584,1,3,229957,229959,229962,2,5,0
65585,3,3,229960,229962,229965,2,5,0
65586,1,3,229961,229965,229968,4,7,0
65587,6,3,229967,229968,229971,1,4,0
65588,6,1,229973,229973,229974,0,1,2
65589,6,3,229979,229979,229982,0,3,5
65590,4,2,229983,229983,229985,0,2,1
65591,4,2,229987,229987,229989,0,2,2
65592,1,3,229988,229989,229992,1,4,0
65593,3,1,229991,229992,229993,1,2,0
65594,4,1,229995,229995,229996,0,1,2
65595,4,2,229999,229999,230001,0,2,3
65596,5,1,230004,230004,230005,0,1,3
65597,3,2,230007,230007,230009,0,2,2
65598,6,3,230013,230013,230016,0,3,4
65599,6,3,230019,230019,230022,0,3,3
65600,3,1,230022,230022,230023,0,1,0
65601,1,2,230023,230023,230025,0,2,0
65602,5,1,230028,230028,230029,0,1,3
65603,3,1,230031,230031,230032,0,1,2
65604,3,1,230034,230034,230035,0,1,2
65605,3,2,230037,230037,230039,0,2,2
65606,3,3,230040,230040,230043,0,3,1
65607,2,2,230042,230043,230045,1,3,0
65608,6,2,230048,230048,230050,0,2,3
65609,4,2,230052,230052,230054,0,2,2
65610,4,1,230056,230056,230057,0,1,2
65611,1,1,230057,230057,230058,0,1,0
65612,4,3,230061,230061,230064,0,3,3
65613,3,2,230064,230064,230066,0,2,0
65614,5,3,230069,230069,230072,0,3,3
65615,1,1,230070,230072,230073,2,3,0
65616,1,2,230071,230073,230075,2,4,0
65617,1,2,230072,230075,230077,3,5,0
65618,5,3,230077,230077,230080,0,3,0
65619,1,1,230078,230080,230081,2,3,0
65620,3,1,230081,230081,230082,0,1,0
65621,5,2,230086,230086,230088,0,2,4
65622,3,3,230089,230089,230092,0,3,1
65623,3,3,230092,230092,230095,0,3,0
65624,2,1,230094,230095,230096,1,2,0
65625,6,3,230100,230100,230103,0,3,4
65626,4,2,230104,230104,230106,0,2,1
65627,5,2,230109,230109,230111,0,2,3
65628,2,1,230111,230111,230112,0,1,0
65629,4,3,230115,230115,230118,0,3,3
65630,5,2,230120,230120,230122,0,2,2
65631,4,3,230124,230124,230127,0,3,2
65632,5,3,230129,230129,230132,0,3,2
65633,5,2,230134,230134,230136,0,2,2
65634,6,1,230140,230140,230141,0,1,4
65635,6,1,230146,230146,230147,0,1,5
65636,1,3,230147,230147,230150,0,3,0
65637,1,3,230148,230150,230153,2,5,0
65638,1,1,230149,230153,230154,4,5,0
65639,4,2,230153,230154,230156,1,3,0
65640,3,2,230156,230156,230158,0,2,0
65641,6,2,230162,230162,230164,0,2,4
65642,2,2,230164,230164,230166,0,2,0
65643,1,2,230165,230166,230168,1,3,0
65644,3,1,230168,230168,230169,0,1,0
65645,6,2,230174,230174,230176,0,2,5
65646,4,3,230178,230178,230181,0,3,2
65647,5,2,230183,230183,230185,0,2,2
65648,3,1,230186,230186,230187,0,1,1
65649,6,1,230192,230192,230193,0,1,5
65650,5,2,230197,230197,230199,0,2,4
65651,1,2,230198,230199,230201,1,3,0
65652,3,3,230201,230201,230204,0,3,0
65653,5,1,230206,230206,230207,0,1,2
65654,6,2,230212,230212,230214,0,2,5
65655,6,3,230218,230218,230221,0,3,4
65656,5,2,230223,230223,230225,0,2,2
65657,6,1,230229,230229,230230,0,1,4
65658,2,1,230231,230231,230232,0,1,1
65659,2,3,230233,230233,230236,0,3,1
65660,1,3,230234,230236,230239,2,5,0
65661,4,1,230238,230239,230240,1,2,0
65662,6,2,230244,230244,230246,0,2,4
65663,4,3,230248,230248,230251,0,3,2
65664,1,2,230249,230251,230253,2,4,0
65665,6,1,230255,230255,230256,0,1,2
65666,4,3,230259,230259,230262,0,3,3
65667,4,1,230263,230263,230264,0,1,1
65668,3,1,230266,230266,230267,0,1,2
65669,5,3,230271,230271,230274,0,3,4
65670,1,1,230272,230274,230275,2,3,0
65671,2,1,230274,230275,230276,1,2,0
65672,3,2,230277,230277,230279,0,2,1
65673,5,2,230282,230282,230284,0,2,3
65674,2,1,230284,230284,230285,0,1,0
65675,6,3,230290,230290,230293,0,3,5
65676,3,2,230293,230293,230295,0,2,0
65677,6,2,230299,230299,230301,0,2,4
65678,5,3,230304,230304,230307,0,3,3
65679,3,2,230307,230307,230309,0,2,0
65680,5,2,230312,230312,230314,0,2,3
65681,4,1,230316,230316,230317,0,1,2
65682,2,3,230318,230318,230321,0,3,1
65683,2,3,230320,230321,230324,1,4,0
65684,3,3,230323,230324,230327,1,4,0
65685,3,2,230326,230327,230329,1,3,0
65686,6,1,230332,230332,230333,0,1,3
65687,2,2,230334,230334,230336,0,2,1
65688,5,2,230339,230339,230341,0,2,3
65689,2,3,230341,230341,230344,0,3,0
65690,5,1,230346,230346,230347,0,1,2
65691,6,1,230352,230352,230353,0,1,5
65692,1,2,230353,230353,230355,0,2,0
65693,1,2,230354,230355,230357,1,3,0
65694,2,3,230356,230357,230360,1,4,0
65695,3,1,230359,230360,230361,1,2,0
65696,2,3,230361,230361,230364,0,3,0
65697,3,1,230364,230364,230365,0,1,0
65698,5,1,230369,230369,230370,0,1,4
65699,3,2,230372,230372,230374,0,2,2
65700,1,3,230373,230374,230377,1,4,0
65701,4,2,230377,230377,230379,0,2,0
65702,3,2,230380,230380,230382,0,2,1
65703,2,3,230382,230382,230385,0,3,0
65704,5,2,230387,230387,230389,0,2,2
65705,6,2,230393,230393,230395,0,2,4
65706,5,2,230398,230398,230400,0,2,3
65707,4,3,230402,230402,230405,0,3,2
65708,2,1,230404,230405,230406,1,2,0
65709,1,2,230405,230406,230408,1,3,0
65710,6,1,230411,230411,230412,0,1,3
65711,4,3,230415,230415,230418,0,3,3
65712,1,2,230416,230418,230420,2,4,0
65713,5,2,230421,230421,230423,0,2,1
65714,4,2,230425,230425,230427,0,2,2
65715,2,3,230427,230427,230430,0,3,0
65716,4,1,230431,230431,230432,0,1,1
65717,1,2,230432,230432,230434,0,2,0
65718,6,1,230438,230438,230439,0,1,4
65719,4,3,230442,230442,230445,0,3,3
65720,4,2,230446,230446,230448,0,2,1
65721,2,1,230448,230448,230449,0,1,0
65722,6,2,230454,230454,230456,0,2,5
65723,4,1,230458,230458,230459,0,1,2
65724,4,3,230462,230462,230465,0,3,3
65725,3,1,230465,230465,230466,0,1,0
65726,4,3,230469,230469,230472,0,3,3
65727,4,3,230473,230473,230476,0,3,1
65728,6,2,230479,230479,230481,0,2,3
65729,1,1,230480,230481,230482,1,2,0
65730,3,3,230483,230483,230486,0,3,1
65731,3,2,230486,230486,230488,0,2,0
65732,2,1,230488,230488,230489,0,1,0
65733,5,1,230493,230493,230494,0,1,4
65734,5,3,230498,230498,230501,0,3,4
65735,2,2,230500,230501,230503,1,3,0
65736,1,2,230501,230503,230505,2,4,0
65737,2,3,230503,230505,230508,2,5,0
65738,2,2,230505,230508,230510,3,5,0
65739,6,1,230511,230511,230512,0,1,1
65740,2,3,230513,230513,230516,0,3,1
65741,4,1,230517,230517,230518,0,1,1
65742,5,3,230522,230522,230525,0,3,4
65743,4,2,230526,230526,230528,0,2,1
65744,2,2,230528,230528,230530,0,2,0
65745,5,3,230533,230533,230536,0,3,3
65746,5,3,230538,230538,230541,0,3,2
65747,1,2,230539,230541,230543,2,4,0
65748,3,3,230542,230543,230546,1,4,0
65749,2,3,230544,230546,230549,2,5,0
65750,5,2,230549,230549,230551,0,2,0
65751,1,1,230550,230551,230552,1,2,0
65752,2,2,230552,230552,230554,0,2,0
65753,4,2,230556,230556,230558,0,2,2
65754,5,3,230561,230561,230564,0,3,3
65755,5,3,230566,230566,230569,0,3,2
65756,4,3,230570,230570,230573,0,3,1
65757,5,2,230575,230575,230577,0,2,2
65758,6,1,230581,230581,230582,0,1,4
65759,4,1,230585,230585,230586,0,1,3
65760,2,3,230587,230587,230590,0,3,1
65761,1,1,230588,230590,230591,2,3,0
65762,6,1,230594,230594,230595,0,1,3
65763,6,2,230600,230600,230602,0,2,5
65764,1,2,230601,230602,230604,1,3,0
65765,4,1,230605,230605,230606,0,1,1
65766,5,2,230610,230610,230612,0,2,4
65767,2,2,230612,230612,230614,0,2,0
65768,2,1,230614,230614,230615,0,1,0
65769,1,2,230615,230615,230617,0,2,0
65770,3,2,230618,230618,230620,0,2,1
65771,3,3,230621,230621,230624,0,3,1
65772,6,2,230627,230627,230629,0,2,3
65773,3,2,230630,230630,230632,0,2,1
65774,6,1,230636,230636,230637,0,1,4
65775,2,1,230638,230638,230639,0,1,1
65776,3,3,230641,230641,230644,0,3,2
65777,4,1,230645,230645,230646,0,1,1
65778,1,3,230646,230646,230649,0,3,0
65779,3,3,230649,230649,230652,0,3,0
65780,3,2,230652,230652,230654,0,2,0
65781,3,2,230655,230655,230657,0,2,1
65782,3,3,230658,230658,230661,0,3,1
65783,6,3,230664,230664,230667,0,3,3
65784,3,1,230667,230667,230668,0,1,0
65785,2,3,230669,230669,230672,0,3,1
65786,1,1,230670,230672,230673,2,3,0
65787,3,3,230673,230673,230676,0,3,0
65788,6,2,230679,230679,230681,0,2,3
65789,5,1,230684,230684,230685,0,1,3
65790,1,2,230685,230685,230687,0,2,0
65791,5,2,230690,230690,230692,0,2,3
65792,3,1,230693,230693,230694,0,1,1
65793,3,3,230696,230696,230699,0,3,2
65794,5,2,230701,230701,230703,0,2,2
65795,2,1,230703,230703,230704,0,1,0
65796,2,2,230705,230705,230707,0,2,1
65797,1,3,230706,230707,230710,1,4,0
65798,3,3,230709,230710,230713,1,4,0
65799,6,3,230715,230715,230718,0,3,2
65800,1,3,230716,230718,230721,2,5,0
65801,2,2,230718,230721,230723,3,5,0
65802,3,3,230721,230723,230726,2,5,0
65803,6,1,230727,230727,230728,0,1,1
65804,6,3,230733,230733,230736,0,3,5
65805,6,1,230739,230739,230740,0,1,3
65806,5,1,230744,230744,230745,0,1,4
65807,1,2,230745,230745,230747,0,2,0
65808,3,1,230748,230748,230749,0,1,1
65809,1,1,230749,230749,230750,0,1,0
65810,4,2,230753,230753,230755,0,2,3
65811,6,2,230759,230759,230761,0,2,4
65812,6,2,230765,230765,230767,0,2,4
65813,6,3,230771,230771,230774,0,3,4
65814,3,1,230774,230774,230775,0,1,0
65815,1,3,230775,230775,230778,0,3,0
65816,2,1,230777,230778,230779,1,2,0
65817,6,1,230783,230783,230784,0,1,4
65818,1,3,230784,230784,230787,0,3,0
65819,4,3,230788,230788,230791,0,3,1
65820,3,1,230791,230791,230792,0,1,0
65821,3,1,230794,230794,230795,0,1,2
65822,4,2,230798,230798,230800,0,2,3
65823,3,3,230801,230801,230804,0,3,1
65824,5,1,230806,230806,230807,0,1,2
65825,5,2,230811,230811,230813,0,2,4
65826,2,3,230813,230813,230816,0,3,0
65827,1,1,230814,230816,230817,2,3,0
65828,2,3,230816,230817,230820,1,4,0
65829,4,3,230820,230820,230823,0,3,0
65830,3,2,230823,230823,230825,0,2,0
65831,4,3,230827,230827,230830,0,3,2
65832,1,3,230828,230830,230833,2,5,0
65833,3,2,230831,230833,230835,2,4,0
65834,2,3,230833,230835,230838,2,5,0
65835,1,3,230834,230838,230841,4,7,0
65836,3,3,230837,230841,230844,4,7,0
65837,2,1,230839,230844,230845,5,6,0
65838,2,3,230841,230845,230848,4,7,0
65839,2,2,230843,230848,230850,5,7,0
65840,5,3,230848,230850,230853,2,5,0
65841,5,2,230853,230853,230855,0,2,0
65842,4,2,230857,230857,230859,0,2,2
65843,6,2,230863,230863,230865,0,2,4
65844,6,2,230869,230869,230871,0,2,4
65845,3,2,230872,230872,230874,0,2,1
65846,6,3,230878,230878,230881,0,3,4
65847,1,3,230879,230881,230884,2,5,0
65848,4,3,230883,230884,230887,1,4,0
65849,3,2,230886,230887,230889,1,3,0
65850,6,1,230892,230892,230893,0,1,3
65851,5,3,230897,230897,230900,0,3,4
65852,6,1,230903,230903,230904,0,1,3
65853,5,2,230908,230908,230910,0,2,4
65854,5,1,230913,230913,230914,0,1,3
65855,2,3,230915,230915,230918,0,3,1
65856,5,2,230920,230920,230922,0,2,2
65857,5,2,230925,230925,230927,0,2,3
65858,5,1,230930,230930,230931,0,1,3
65859,5,1,230935,230935,230936,0,1,4
65860,1,1,230936,230936,230937,0,1,0
65861,4,2,230940,230940,230942,0,2,3
65862,2,1,230942,230942,230943,0,1,0
65863,5,1,230947,230947,230948,0,1,4
65864,1,2,230948,230948,230950,0,2,0
65865,3,1,230951,230951,230952,0,1,1
65866,6,2,230957,230957,230959,0,2,5
65867,4,2,230961,230961,230963,0,2,2
65868,6,1,230967,230967,230968,0,1,4
65869,6,3,230973,230973,230976,0,3,5
65870,2,1,230975,230976,230977,1,2,0
65871,1,3,230976,230977,230980,1,4,0
65872,1,1,230977,230980,230981,3,4,0
65873,1,2,230978,230981,230983,3,5,0
65874,3,1,230981,230983,230984,2,3,0
65875,5,2,230986,230986,230988,0,2,2
65876,4,3,230990,230990,230993,0,3,2
65877,3,1,230993,230993,230994,0,1,0
65878,4,2,230997,230997,230999,0,2,3
65879,1,2,230998,230999,231001,1,3,0
65880,2,1,231000,231001,231002,1,2,0
65881,4,3,231004,231004,231007,0,3,2
65882,3,3,231007,231007,231010,0,3,0
65883,4,1,231011,231011,231012,0,1,1
65884,5,1,231016,231016,231017,0,1,4
65885,1,1,231017,231017,231018,0,1,0
65886,4,3,231021,231021,231024,0,3,3
65887,2,2,231023,231024,231026,1,3,0
65888,1,3,231024,231026,231029,2,5,0
65889,3,3,231027,231029,231032,2,5,0
65890,1,1,231028,231032,231033,4,5,0
65891,6,1,231034,231034,231035,0,1,1
65892,4,2,231038,231038,231040,0,2,3
65893,3,3,231041,231041,231044,0,3,1
65894,4,2,231045,231045,231047,0,2,1
65895,6,1,231051,231051,231052,0,1,4
65896,6,1,231057,231057,231058,0,1,5
65897,6,2,231063,231063,231065,0,2,5
65898,4,2,231067,231067,231069,0,2,2
65899,2,3,231069,231069,231072,0,3,0
65900,2,1,231071,231072,231073,1,2,0
65901,6,1,231077,231077,231078,0,1,4
65902,5,1,231082,231082,231083,0,1,4
65903,1,3,231083,231083,231086,0,3,0
65904,3,3,231086,231086,231089,0,3,0
65905,3,1,231089,231089,231090,0,1,0
65906,1,1,231090,231090,231091,0,1,0
65907,2,3,231092,231092,231095,0,3,1
65908,4,3,231096,231096,231099,0,3,1
65909,4,2,231100,231100,231102,0,2,1
65910,6,3,231106,231106,231109,0,3,4
65911,2,2,231108,231109,231111,1,3,0
65912,3,3,231111,231111,231114,0,3,0
65913,5,1,231116,231116,231117,0,1,2
65914,4,2,231120,231120,231122,0,2,3
65915,6,2,231126,231126,231128,0,2,4
65916,1,1,231127,231128,231129,1,2,0
65917,5,3,231132,231132,231135,0,3,3
65918,6,1,231138,231138,231139,0,1,3
65919,3,1,231141,231141,231142,0,1,2
65920,3,2,231144,231144,231146,0,2,2
65921,4,2,231148,231148,231150,0,2,2
65922,3,1,231151,231151,231152,0,1,1
65923,3,3,231154,231154,231157,0,3,2
65924,2,2,231156,231157,231159,1,3,0
65925,6,3,231162,231162,231165,0,3,3
65926,1,3,231163,231165,231168,2,5,0
65927,5,2,231168,231168,231170,0,2,0
65928,4,1,231172,231172,231173,0,1,2
65929,4,2,231176,231176,231178,0,2,3
65930,2,1,231178,231178,231179,0,1,0
65931,6,1,231184,231184,231185,0,1,5
65932,5,2,231189,231189,231191,0,2,4
65933,3,3,231192,231192,231195,0,3,1
65934,2,1,231194,231195,231196,1,2,0
65935,1,2,231195,231196,231198,1,3,0
65936,3,3,231198,231198,231201,0,3,0
65937,2,3,231200,231201,231204,1,4,0
65938,4,1,231204,231204,231205,0,1,0
65939,2,1,231206,231206,231207,0,1,1
65940,5,3,231211,231211,231214,0,3,4
65941,2,2,231213,231214,231216,1,3,0
65942,4,3,231217,231217,231220,0,3,1
65943,1,1,231218,231220,231221,2,3,0
65944,4,3,231222,231222,231225,0,3,1
65945,4,2,231226,231226,231228,0,2,1
65946,1,2,231227,231228,231230,1,3,0
65947,1,1,231228,231230,231231,2,3,0
65948,3,3,231231,231231,231234,0,3,0
65949,6,1,231237,231237,231238,0,1,3
65950,1,2,231238,231238,231240,0,2,0
65951,2,1,231240,231240,231241,0,1,0
65952,4,1,231244,231244,231245,0,1,3
65953,1,2,231245,231245,231247,0,2,0
65954,6,3,231251,231251,231254,0,3,4
65955,6,2,231257,231257,231259,0,2,3
65956,1,1,231258,231259,231260,1,2,0
65957,2,3,231260,231260,231263,0,3,0
65958,2,1,231262,231263,231264,1,2,0
65959,6,1,231268,231268,231269,0,1,4
65960,1,1,231269,231269,231270,0,1,0
65961,2,2,231271,231271,231273,0,2,1
65962,4,2,231275,231275,231277,0,2,2
65963,5,1,231280,231280,231281,0,1,3
65964,5,2,231285,231285,231287,0,2,4
65965,1,2,231286,231287,231289,1,3,0
65966,1,1,231287,231289,231290,2,3,0
65967,6,1,231293,231293,231294,0,1,3
65968,2,2,231295,231295,231297,0,2,1
65969,3,1,231298,231298,231299,0,1,1
65970,4,1,231302,231302,231303,0,1,3
65971,2,3,231304,231304,231307,0,3,1
65972,2,3,231306,231307,231310,1,4,0
65973,2,3,231308,231310,231313,2,5,0
65974,4,1,231312,231313,231314,1,2,0
65975,5,2,231317,231317,231319,0,2,3
65976,6,2,231323,231323,231325,0,2,4
65977,3,2,231326,231326,231328,0,2,1
65978,4,1,231330,231330,231331,0,1,2
65979,2,2,231332,231332,231334,0,2,1
65980,6,2,231338,231338,231340,0,2,4
65981,4,1,231342,231342,231343,0,1,2
65982,1,1,231343,231343,231344,0,1,0
65983,6,2,231349,231349,231351,0,2,5
65984,5,2,231354,231354,231356,0,2,3
65985,3,1,231357,231357,231358,0,1,1
65986,3,1,231360,231360,231361,0,1,2
65987,1,1,231361,231361,231362,0,1,0
65988,1,1,231362,231362,231363,0,1,0
65989,6,2,231368,231368,231370,0,2,5
65990,3,3,231371,231371,231374,0,3,1
65991,1,1,231372,231374,231375,2,3,0
65992,1,2,231373,231375,231377,2,4,0
65993,1,1,231374,231377,231378,3,4,0
65994,5,3,231379,231379,231382,0,3,1
65995,2,3,231381,231382,231385,1,4,0
65996,5,1,231386,231386,231387,0,1,1
65997,1,1,231387,231387,231388,0,1,0
65998,5,2,231392,231392,231394,0,2,4
65999,5,3,231397,231397,231400,0,3,3
66000,2,2,231399,231400,231402,1,3,0
66001,3,3,231402,231402,231405,0,3,0
66002,1,1,231403,231405,231406,2,3,0
66003,3,3,231406,231406,231409,0,3,0
66004,5,3,231411,231411,231414,0,3,2
66005,4,3,231415,231415,231418,0,3,1
66006,6,3,231421,231421,231424,0,3,3
66007,2,1,231423,231424,231425,1,2,0
66008,2,2,231425,231425,231427,0,2,0
66009,5,1,231430,231430,231431,0,1,3
66010,5,1,231435,231435,231436,0,1,4
66011,5,3,231440,231440,231443,0,3,4
66012,2,2,231442,231443,231445,1,3,0
66013,3,1,231445,231445,231446,0,1,0
66014,1,2,231446,231446,231448,0,2,0
66015,3,1,231449,231449,231450,0,1,1
66016,2,2,231451,231451,231453,0,2,1
66017,5,2,231456,231456,231458,0,2,3
66018,4,3,231460,231460,231463,0,3,2
66019,3,3,231463,231463,231466,0,3,0
66020,2,3,231465,231466,231469,1,4,0
66021,5,2,231470,231470,231472,0,2,1
66022,4,2,231474,231474,231476,0,2,2
66023,3,1,231477,231477,231478,0,1,1
66024,2,2,231479,231479,231481,0,2,1
66025,2,2,231481,231481,231483,0,2,0
66026,1,3,231482,231483,231486,1,4,0
66027,5,3,231487,231487,231490,0,3,1
66028,5,2,231492,231492,231494,0,2,2
66029,2,3,231494,231494,231497,0,3,0
66030,6,2,231500,231500,231502,0,2,3
66031,3,3,231503,231503,231506,0,3,1
66032,4,1,231507,231507,231508,0,1,1
66033,4,1,231511,231511,231512,0,1,3
66034,3,3,231514,231514,231517,0,3,2
66035,2,3,231516,231517,231520,1,4,0
66036,2,1,231518,231520,231521,2,3,0
66037,5,2,231523,231523,231525,0,2,2
66038,5,2,231528,231528,231530,0,2,3
66039,5,1,231533,231533,231534,0,1,3
66040,3,2,231536,231536,231538,0,2,2
66041,6,3,231542,231542,231545,0,3,4
66042,6,1,231548,231548,231549,0,1,3
66043,1,3,231549,231549,231552,0,3,0
66044,6,3,231555,231555,231558,0,3,3
66045,3,3,231558,231558,231561,0,3,0
66046,5,2,231563,231563,231565,0,2,2
66047,3,3,231566,231566,231569,0,3,1
66048,6,3,231572,231572,231575,0,3,3
66049,1,3,231573,231575,231578,2,5,0
66050,1,2,231574,231578,231580,4,6,0
66051,5,3,231579,231580,231583,1,4,0
66052,1,2,231580,231583,231585,3,5,0
66053,5,2,231585,231585,231587,0,2,0
66054,5,3,231590,231590,231593,0,3,3
66055,2,3,231592,231593,231596,1,4,0
66056,2,3,231594,231596,231599,2,5,0
66057,1,3,231595,231599,231602,4,7,0
66058,3,2,231598,231602,231604,4,6,0
66059,1,3,231599,231604,231607,5,8,0
66060,6,2,231605,231607,231609,2,4,0
66061,5,1,231610,231610,231611,0,1,1
66062,2,2,231612,231612,231614,0,2,1
66063,6,1,231618,231618,231619,0,1,4
66064,4,1,231622,231622,231623,0,1,3
66065,3,1,231625,231625,231626,0,1,2
66066,2,1,231627,231627,231628,0,1,1
66067,1,3,231628,231628,231631,0,3,0
66068,1,3,231629,231631,231634,2,5,0
66069,1,3,231630,231634,231637,4,7,0
66070,1,3,231631,231637,231640,6,9,0
66071,4,3,231635,231640,231643,5,8,0
66072,2,1,231637,231643,231644,6,7,0
66073,1,2,231638,231644,231646,6,8,0
66074,4,3,231642,231646,231649,4,7,0
66075,5,2,231647,231649,231651,2,4,0
66076,1,1,231648,231651,231652,3,4,0
66077,5,2,231653,231653,231655,0,2,1
66078,3,2,231656,231656,231658,0,2,1
66079,3,3,231659,231659,231662,0,3,1
66080,3,3,231662,231662,231665,0,3,0
66081,4,3,231666,231666,231669,0,3,1
66082,6,3,231672,231672,231675,0,3,3
66083,6,2,231678,231678,231680,0,2,3
66084,2,1,231680,231680,231681,0,1,0
66085,2,3,231682,231682,231685,0,3,1
66086,4,1,231686,231686,231687,0,1,1
66087,2,1,231688,231688,231689,0,1,1
66088,6,2,231694,231694,231696,0,2,5
66089,6,3,231700,231700,231703,0,3,4
66090,2,2,231702,231703,231705,1,3,0
66091,5,2,231707,231707,231709,0,2,2
66092,5,1,231712,231712,231713,0,1,3
66093,6,3,231718,231718,231721,0,3,5
66094,3,3,231721,231721,231724,0,3,0
66095,4,2,231725,231725,231727,0,2,1
66096,2,1,231727,231727,231728,0,1,0
66097,4,1,231731,231731,231732,0,1,3
66098,4,2,231735,231735,231737,0,2,3
66099,3,3,231738,231738,231741,0,3,1
66100,4,3,231742,231742,231745,0,3,1
66101,4,1,231746,231746,231747,0,1,1
66102,1,1,231747,231747,231748,0,1,0
66103,6,1,231753,231753,231754,0,1,5
66104,5,3,231758,231758,231761,0,3,4
66105,6,2,231764,231764,231766,0,2,3
66106,4,2,231768,231768,231770,0,2,2
66107,2,2,231770,231770,231772,0,2,0
66108,1,2,231771,231772,231774,1,3,0
66109,2,2,231773,231774,231776,1,3,0
66110,4,2,231777,231777,231779,0,2,1
66111,1,2,231778,231779,231781,1,3,0
66112,4,1,231782,231782,231783,0,1,1
66113,6,3,231788,231788,231791,0,3,5
66114,2,3,231790,231791,231794,1,4,0
66115,1,1,231791,231794,231795,3,4,0
66116,6,2,231797,231797,231799,0,2,2
66117,4,3,231801,231801,231804,0,3,2
66118,6,1,231807,231807,231808,0,1,3
66119,6,3,231813,231813,231816,0,3,5
66120,6,3,231819,231819,231822,0,3,3
66121,3,2,231822,231822,231824,0,2,0
66122,5,2,231827,231827,231829,0,2,3
66123,1,3,231828,231829,231832,1,4,0
66124,2,2,231830,231832,231834,2,4,0
66125,3,1,231833,231834,231835,1,2,0
66126,4,3,231837,231837,231840,0,3,2
66127,2,2,231839,231840,231842,1,3,0
66128,6,1,231845,231845,231846,0,1,3
66129,3,1,231848,231848,231849,0,1,2
66130,4,1,231852,231852,231853,0,1,3
66131,3,3,231855,231855,231858,0,3,2
66132,5,2,231860,231860,231862,0,2,2
66133,6,1,231866,231866,231867,0,1,4
66134,3,3,231869,231869,231872,0,3,2
66135,4,2,231873,231873,231875,0,2,1
66136,1,2,231874,231875,231877,1,3,0
66137,3,1,231877,231877,231878,0,1,0
66138,1,3,231878,231878,231881,0,3,0
66139,6,2,231884,231884,231886,0,2,3
66140,2,3,231886,231886,231889,0,3,0
66141,4,3,231890,231890,231893,0,3,1
66142,3,3,231893,231893,231896,0,3,0
66143,2,1,231895,231896,231897,1,2,0
66144,5,2,231900,231900,231902,0,2,3
66145,4,3,231904,231904,231907,0,3,2
66146,5,1,231909,231909,231910,0,1,2
66147,1,2,231910,231910,231912,0,2,0
66148,1,1,231911,231912,231913,1,2,0
66149,4,2,231915,231915,231917,0,2,2
66150,2,3,231917,231917,231920,0,3,0
66151,6,3,231923,231923,231926,0,3,3
66152,3,3,231926,231926,231929,0,3,0
66153,4,2,231930,231930,231932,0,2,1
66154,4,1,231934,231934,231935,0,1,2
66155,5,2,231939,231939,231941,0,2,4
66156,4,1,231943,231943,231944,0,1,2
66157,2,1,231945,231945,231946,0,1,1
66158,1,1,231946,231946,231947,0,1,0
66159,4,2,231950,231950,231952,0,2,3
66160,6,3,231956,231956,231959,0,3,4
66161,1,2,231957,231959,231961,2,4,0
66162,5,3,231962,231962,231965,0,3,1
66163,2,1,231964,231965,231966,1,2,0
66164,3,1,231967,231967,231968,0,1,1
66165,4,3,231971,231971,231974,0,3,3
66166,3,3,231974,231974,231977,0,3,0
66167,2,2,231976,231977,231979,1,3,0
66168,2,1,231978,231979,231980,1,2,0
66169,5,1,231983,231983,231984,0,1,3
66170,5,2,231988,231988,231990,0,2,4
66171,3,2,231991,231991,231993,0,2,1
66172,3,2,231994,231994,231996,0,2,1
66173,6,3,232000,232000,232003,0,3,4
66174,6,2,232006,232006,232008,0,2,3
66175,6,2,232012,232012,232014,0,2,4
66176,4,1,232016,232016,232017,0,1,2
66177,3,3,232019,232019,232022,0,3,2
66178,3,3,232022,232022,232025,0,3,0
66179,4,1,232026,232026,232027,0,1,1
66180,4,3,232030,232030,232033,0,3,3
66181,6,3,232036,232036,232039,0,3,3
66182,5,3,232041,232041,232044,0,3,2
66183,5,3,232046,232046,232049,0,3,2
66184,1,3,232047,232049,232052,2,5,0
66185,4,1,232051,232052,232053,1,2,0
66186,1,2,232052,232053,232055,1,3,0
66187,6,1,232058,232058,232059,0,1,3
66188,3,2,232061,232061,232063,0,2,2
66189,4,3,232065,232065,232068,0,3,2
66190,4,1,232069,232069,232070,0,1,1
66191,1,1,232070,232070,232071,0,1,0
66192,6,1,232076,232076,232077,0,1,5
66193,1,3,232077,232077,232080,0,3,0
66194,2,1,232079,232080,232081,1,2,0
66195,1,2,232080,232081,232083,1,3,0
66196,4,1,232084,232084,232085,0,1,1
66197,3,2,232087,232087,232089,0,2,2
66198,4,2,232091,232091,232093,0,2,2
66199,6,2,232097,232097,232099,0,2,4
66200,6,2,232103,232103,232105,0,2,4
66201,6,1,232109,232109,232110,0,1,4
66202,1,2,232110,232110,232112,0,2,0
66203,3,3,232113,232113,232116,0,3,1
66204,6,3,232119,232119,232122,0,3,3
66205,6,1,232125,232125,232126,0,1,3
66206,1,3,232126,232126,232129,0,3,0
66207,1,3,232127,232129,232132,2,5,0
66208,1,3,232128,232132,232135,4,7,0
66209,2,2,232130,232135,232137,5,7,0
66210,2,2,232132,232137,232139,5,7,0
66211,3,2,232135,232139,232141,4,6,0
66212,4,3,232139,232141,232144,2,5,0
66213,5,2,232144,232144,232146,0,2,0
66214,6,2,232150,232150,232152,0,2,4
66215,3,2,232153,232153,232155,0,2,1
66216,3,3,232156,232156,232159,0,3,1
66217,5,3,232161,232161,232164,0,3,2
66218,6,2,232167,232167,232169,0,2,3
66219,1,2,232168,232169,232171,1,3,0
66220,5,2,232173,232173,232175,0,2,2
66221,3,2,232176,232176,232178,0,2,1
66222,2,2,232178,232178,232180,0,2,0
66223,2,2,232180,232180,232182,0,2,0
66224,5,2,232185,232185,232187,0,2,3
66225,4,2,232189,232189,232191,0,2,2
66226,1,2,232190,232191,232193,1,3,0
66227,6,3,232196,232196,232199,0,3,3
66228,2,3,232198,232199,232202,1,4,0
66229,6,3,232204,232204,232207,0,3,2
66230,6,1,232210,232210,232211,0,1,3
66231,6,2,232216,232216,232218,0,2,5
66232,4,2,232220,232220,232222,0,2,2
66233,3,2,232223,232223,232225,0,2,1
66234,1,1,232224,232225,232226,1,2,0
66235,4,2,232228,232228,232230,0,2,2
66236,6,2,232234,232234,232236,0,2,4
66237,3,1,232237,232237,232238,0,1,1
66238,6,1,232243,232243,232244,0,1,5
66239,3,2,232246,232246,232248,0,2,2
66240,5,1,232251,232251,232252,0,1,3
66241,3,3,232254,232254,232257,0,3,2
66242,2,3,232256,232257,232260,1,4,0
66243,4,3,232260,232260,232263,0,3,0
66244,1,2,232261,232263,232265,2,4,0
66245,1,3,232262,232265,232268,3,6,0
66246,3,2,232265,232268,232270,3,5,0
66247,5,1,232270,232270,232271,0,1,0
66248,4,2,232274,232274,232276,0,2,3
66249,6,2,232280,232280,232282,0,2,4
66250,5,2,232285,232285,232287,0,2,3
66251,5,2,232290,232290,232292,0,2,3
66252,4,3,232294,232294,232297,0,3,2
66253,6,2,232300,232300,232302,0,2,3
66254,5,1,232305,232305,232306,0,1,3
66255,4,3,232309,232309,232312,0,3,3
66256,4,3,232313,232313,232316,0,3,1
66257,2,2,232315,232316,232318,1,3,0
66258,3,1,232318,232318,232319,0,1,0
66259,4,2,232322,232322,232324,0,2,3
66260,6,1,232328,232328,232329,0,1,4
66261,2,3,232330,232330,232333,0,3,1
66262,6,2,232336,232336,232338,0,2,3
66263,2,3,232338,232338,232341,0,3,0
66264,1,2,232339,232341,232343,2,4,0
66265,2,2,232341,232343,232345,2,4,0
66266,6,1,232347,232347,232348,0,1,2
66267,5,1,232352,232352,232353,0,1,4
66268,1,3,232353,232353,232356,0,3,0
66269,6,3,232359,232359,232362,0,3,3
66270,3,1,232362,232362,232363,0,1,0
66271,4,1,232366,232366,232367,0,1,3
66272,1,2,232367,232367,232369,0,2,0
66273,5,1,232372,232372,232373,0,1,3
66274,4,1,232376,232376,232377,0,1,3
66275,3,3,232379,232379,232382,0,3,2
66276,2,3,232381,232382,232385,1,4,0
66277,3,1,232384,232385,232386,1,2,0
66278,3,3,232387,232387,232390,0,3,1
66279,4,1,232391,232391,232392,0,1,1
66280,2,3,232393,232393,232396,0,3,1
66281,3,1,232396,232396,232397,0,1,0
66282,3,3,232399,232399,232402,0,3,2
66283,3,1,232402,232402,232403,0,1,0
66284,1,2,232403,232403,232405,0,2,0
66285,4,3,232407,232407,232410,0,3,2
66286,6,1,232413,232413,232414,0,1,3
66287,4,2,232417,232417,232419,0,2,3
66288,3,3,232420,232420,232423,0,3,1
66289,3,2,232423,232423,232425,0,2,0
66290,1,1,232424,232425,232426,1,2,0
66291,4,1,232428,232428,232429,0,1,2
66292,3,1,232431,232431,232432,0,1,2
66293,6,2,232437,232437,232439,0,2,5
66294,5,1,232442,232442,232443,0,1,3
66295,2,3,232444,232444,232447,0,3,1
66296,1,3,232445,232447,232450,2,5,0
66297,1,3,232446,232450,232453,4,7,0
66298,6,1,232452,232453,232454,1,2,0
66299,4,1,232456,232456,232457,0,1,2
66300,2,2,232458,232458,232460,0,2,1
66301,6,2,232464,232464,232466,0,2,4
66302,3,2,232467,232467,232469,0,2,1
66303,5,1,232472,232472,232473,0,1,3
66304,3,2,232475,232475,232477,0,2,2
66305,6,2,232481,232481,232483,0,2,4
66306,1,1,232482,232483,232484,1,2,0
66307,2,1,232484,232484,232485,0,1,0
66308,2,2,232486,232486,232488,0,2,1
66309,3,2,232489,232489,232491,0,2,1
66310,1,3,232490,232491,232494,1,4,0
66311,6,3,232496,232496,232499,0,3,2
66312,1,3,232497,232499,232502,2,5,0
66313,2,3,232499,232502,232505,3,6,0
66314,2,1,232501,232505,232506,4,5,0
66315,3,1,232504,232506,232507,2,3,0
66316,6,3,232510,232510,232513,0,3,3
66317,1,2,232511,232513,232515,2,4,0
66318,1,3,232512,232515,232518,3,6,0
66319,6,3,232518,232518,232521,0,3,0
66320,5,3,232523,232523,232526,0,3,2
66321,2,1,232525,232526,232527,1,2,0
66322,4,1,232529,232529,232530,0,1,2
66323,1,3,232530,232530,232533,0,3,0
66324,1,1,232531,232533,232534,2,3,0
66325,4,2,232535,232535,232537,0,2,1
66326,4,1,232539,232539,232540,0,1,2
66327,4,3,232543,232543,232546,0,3,3
66328,1,1,232544,232546,232547,2,3,0
66329,3,2,232547,232547,232549,0,2,0
66330,1,2,232548,232549,232551,1,3,0
66331,4,3,232552,232552,232555,0,3,1
66332,1,2,232553,232555,232557,2,4,0
66333,5,3,232558,232558,232561,0,3,1
66334,5,2,232563,232563,232565,0,2,2
66335,1,3,232564,232565,232568,1,4,0
66336,6,1,232570,232570,232571,0,1,2
66337,4,2,232574,232574,232576,0,2,3
66338,3,3,232577,232577,232580,0,3,1
66339,6,2,232583,232583,232585,0,2,3
66340,4,1,232587,232587,232588,0,1,2
66341,3,2,232590,232590,232592,0,2,2
66342,4,3,232594,232594,232597,0,3,2
66343,5,2,232599,232599,232601,0,2,2
66344,1,3,232600,232601,232604,1,4,0
66345,3,2,232603,232604,232606,1,3,0
66346,1,1,232604,232606,232607,2,3,0
66347,2,1,232606,232607,232608,1,2,0
66348,6,2,232612,232612,232614,0,2,4
66349,3,2,232615,232615,232617,0,2,1
66350,4,3,232619,232619,232622,0,3,2
66351,6,1,232625,232625,232626,0,1,3
66352,6,1,232631,232631,232632,0,1,5
66353,1,1,232632,232632,232633,0,1,0
66354,3,2,232635,232635,232637,0,2,2
66355,3,1,232638,232638,232639,0,1,1
66356,5,3,232643,232643,232646,0,3,4
66357,1,3,232644,232646,232649,2,5,0
66358,3,1,232647,232649,232650,2,3,0
66359,3,3,232650,232650,232653,0,3,0
66360,4,2,232654,232654,232656,0,2,1
66361,5,3,232659,232659,232662,0,3,3
66362,2,3,232661,232662,232665,1,4,0
66363,3,2,232664,232665,232667,1,3,0
66364,5,3,232669,232669,232672,0,3,2
66365,2,2,232671,232672,232674,1,3,0
66366,5,3,232676,232676,232679,0,3,2
66367,2,2,232678,232679,232681,1,3,0
66368,3,1,232681,232681,232682,0,1,0
66369,1,2,232682,232682,232684,0,2,0
66370,6,3,232688,232688,232691,0,3,4
66371,4,2,232692,232692,232694,0,2,1
66372,1,1,232693,232694,232695,1,2,0
66373,4,2,232697,232697,232699,0,2,2
66374,5,3,232702,232702,232705,0,3,3
66375,2,1,232704,232705,232706,1,2,0
66376,5,2,232709,232709,232711,0,2,3
66377,4,3,232713,232713,232716,0,3,2
66378,2,3,232715,232716,232719,1,4,0
66379,3,1,232718,232719,232720,1,2,0
66380,3,1,232721,232721,232722,0,1,1
66381,5,2,232726,232726,232728,0,2,4
66382,5,3,232731,232731,232734,0,3,3
66383,2,2,232733,232734,232736,1,3,0
66384,4,2,232737,232737,232739,0,2,1
66385,5,3,232742,232742,232745,0,3,3
66386,3,3,232745,232745,232748,0,3,0
66387,1,3,232746,232748,232751,2,5,0
66388,4,1,232750,232751,232752,1,2,0
66389,1,3,232751,232752,232755,1,4,0
66390,4,3,232755,232755,232758,0,3,0
66391,2,1,232757,232758,232759,1,2,0
66392,5,2,232762,232762,232764,0,2,3
66393,2,2,232764,232764,232766,0,2,0
66394,3,3,232767,232767,232770,0,3,1
66395,4,2,232771,232771,232773,0,2,1
66396,3,3,232774,232774,232777,0,3,1
66397,6,3,232780,232780,232783,0,3,3
66398,1,2,232781,232783,232785,2,4,0
66399,3,3,232784,232785,232788,1,4,0
66400,1,3,232785,232788,232791,3,6,0
66401,4,1,232789,232791,232792,2,3,0
66402,1,2,232790,232792,232794,2,4,0
66403,4,3,232794,232794,232797,0,3,0
66404,6,2,232800,232800,232802,0,2,3
66405,6,3,232806,232806,232809,0,3,4
66406,6,1,232812,232812,232813,0,1,3
66407,4,1,232816,232816,232817,0,1,3
66408,1,3,232817,232817,232820,0,3,0
66409,3,1,232820,232820,232821,0,1,0
66410,5,1,232825,232825,232826,0,1,4
66411,3,3,232828,232828,232831,0,3,2
66412,6,3,232834,232834,232837,0,3,3
66413,6,3,232840,232840,232843,0,3,3
66414,5,1,232845,232845,232846,0,1,2
66415,1,1,232846,232846,232847,0,1,0
66416,3,3,232849,232849,232852,0,3,2
66417,5,1,232854,232854,232855,0,1,2
66418,5,1,232859,232859,232860,0,1,4
66419,1,2,232860,232860,232862,0,2,0
66420,3,1,232863,232863,232864,0,1,1
66421,6,2,232869,232869,232871,0,2,5
66422,1,3,232870,232871,232874,1,4,0
66423,4,3,232874,232874,232877,0,3,0
66424,6,1,232880,232880,232881,0,1,3
66425,1,2,232881,232881,232883,0,2,0
66426,5,1,232886,232886,232887,0,1,3
66427,5,3,232891,232891,232894,0,3,4
66428,1,3,232892,232894,232897,2,5,0
66429,3,2,232895,232897,232899,2,4,0
66430,4,3,232899,232899,232902,0,3,0
66431,5,2,232904,232904,232906,0,2,2
66432,3,1,232907,232907,232908,0,1,1
66433,4,1,232911,232911,232912,0,1,3
66434,5,2,232916,232916,232918,0,2,4
66435,6,2,232922,232922,232924,0,2,4
66436,1,1,232923,232924,232925,1,2,0
66437,6,2,232929,232929,232931,0,2,4
66438,5,3,232934,232934,232937,0,3,3
66439,1,1,232935,232937,232938,2,3,0
66440,3,3,232938,232938,232941,0,3,0
66441,3,1,232941,232941,232942,0,1,0
66442,3,1,232944,232944,232945,0,1,2
66443,1,2,232945,232945,232947,0,2,0
66444,1,1,232946,232947,232948,1,2,0
66445,2,1,232948,232948,232949,0,1,0
66446,3,3,232951,232951,232954,0,3,2
66447,4,1,232955,232955,232956,0,1,1
66448,4,1,232959,232959,232960,0,1,3
66449,4,1,232963,232963,232964,0,1,3
66450,6,2,232969,232969,232971,0,2,5
66451,3,1,232972,232972,232973,0,1,1
66452,6,3,232978,232978,232981,0,3,5
66453,2,2,232980,232981,232983,1,3,0
66454,5,3,232985,232985,232988,0,3,2
66455,5,1,232990,232990,232991,0,1,2
66456,6,2,232996,232996,232998,0,2,5
66457,4,3,233000,233000,233003,0,3,2
66458,4,2,233004,233004,233006,0,2,1
66459,6,2,233010,233010,233012,0,2,4
66460,2,1,233012,233012,233013,0,1,0
66461,5,2,233017,233017,233019,0,2,4
66462,6,2,233023,233023,233025,0,2,4
66463,5,1,233028,233028,233029,0,1,3
66464,5,1,233033,233033,233034,0,1,4
66465,4,2,233037,233037,233039,0,2,3
66466,2,1,233039,233039,233040,0,1,0
66467,2,2,233041,233041,233043,0,2,1
66468,6,1,233047,233047,233048,0,1,4
66469,6,1,233053,233053,233054,0,1,5
66470,4,1,233057,233057,233058,0,1,3
66471,3,3,233060,233060,233063,0,3,2
66472,1,3,233061,233063,233066,2,5,0
66473,5,1,233066,233066,233067,0,1,0
66474,4,1,233070,233070,233071,0,1,3
66475,1,2,233071,233071,233073,0,2,0
66476,3,3,233074,233074,233077,0,3,1
66477,6,1,233080,233080,233081,0,1,3
66478,4,3,233084,233084,233087,0,3,3
66479,4,1,233088,233088,233089,0,1,1
66480,4,2,233092,233092,233094,0,2,3
66481,3,1,233095,233095,233096,0,1,1
66482,2,3,233097,233097,233100,0,3,1
66483,3,3,233100,233100,233103,0,3,0
66484,3,2,233103,233103,233105,0,2,0
66485,1,2,233104,233105,233107,1,3,0
66486,5,2,233109,233109,233111,0,2,2
66487,2,3,233111,233111,233114,0,3,0
66488,5,3,233116,233116,233119,0,3,2
66489,3,3,233119,233119,233122,0,3,0
66490,5,3,233124,233124,233127,0,3,2
66491,5,2,233129,233129,233131,0,2,2
66492,4,3,233133,233133,233136,0,3,2
66493,5,3,233138,233138,233141,0,3,2
66494,6,1,233144,233144,233145,0,1,3
66495,1,3,233145,233145,233148,0,3,0
66496,4,1,233149,233149,233150,0,1,1
66497,2,3,233151,233151,233154,0,3,1
66498,3,2,233154,233154,233156,0,2,0
66499,5,2,233159,233159,233161,0,2,3
66500,3,3,233162,233162,233165,0,3,1
66501,6,3,233168,233168,233171,0,3,3
66502,5,1,233173,233173,233174,0,1,2
66503,3,2,233176,233176,233178,0,2,2
66504,6,1,233182,233182,233183,0,1,4
66505,5,1,233187,233187,233188,0,1,4
66506,4,3,233191,233191,233194,0,3,3
66507,6,1,233197,233197,233198,0,1,3
66508,4,3,233201,233201,233204,0,3,3
66509,4,2,233205,233205,233207,0,2,1
66510,5,3,233210,233210,233213,0,3,3
66511,6,1,233216,233216,233217,0,1,3
66512,5,3,233221,233221,233224,0,3,4
66513,2,2,233223,233224,233226,1,3,0
66514,4,2,233227,233227,233229,0,2,1
66515,6,3,233233,233233,233236,0,3,4
66516,5,1,233238,233238,233239,0,1,2
66517,5,2,233243,233243,233245,0,2,4
66518,1,1,233244,233245,233246,1,2,0
66519,3,3,233247,233247,233250,0,3,1
66520,4,3,233251,233251,233254,0,3,1
66521,2,3,233253,233254,233257,1,4,0
66522,1,3,233254,233257,233260,3,6,0
66523,4,2,233258,233260,233262,2,4,0
66524,2,1,233260,233262,233263,2,3,0
66525,1,1,233261,233263,233264,2,3,0
66526,3,1,233264,233264,233265,0,1,0
66527,6,3,233270,233270,233273,0,3,5
66528,5,3,233275,233275,233278,0,3,2
66529,6,2,233281,233281,233283,0,2,3
66530,1,1,233282,233283,233284,1,2,0
66531,5,2,233287,233287,233289,0,2,3
66532,2,3,233289,233289,233292,0,3,0
66533,3,1,233292,233292,233293,0,1,0
66534,1,3,233293,233293,233296,0,3,0
66535,1,3,233294,233296,233299,2,5,0
66536,6,3,233300,233300,233303,0,3,1
66537,5,1,233305,233305,233306,0,1,2
66538,6,3,233311,233311,233314,0,3,5
66539,2,1,233313,233314,233315,1,2,0
66540,5,2,233318,233318,233320,0,2,3
66541,5,3,233323,233323,233326,0,3,3
66542,6,1,233329,233329,233330,0,1,3
66543,2,3,233331,233331,233334,0,3,1
66544,1,3,233332,233334,233337,2,5,0
66545,5,2,233337,233337,233339,0,2,0
66546,6,2,233343,233343,233345,0,2,4
66547,5,2,233348,233348,233350,0,2,3
66548,6,1,233354,233354,233355,0,1,4
66549,6,2,233360,233360,233362,0,2,5
66550,4,3,233364,233364,233367,0,3,2
66551,6,2,233370,233370,233372,0,2,3
66552,4,3,233374,233374,233377,0,3,2
66553,3,3,233377,233377,233380,0,3,0
66554,4,3,233381,233381,233384,0,3,1
66555,3,3,233384,233384,233387,0,3,0
66556,1,1,233385,233387,233388,2,3,0
66557,1,3,233386,233388,233391,2,5,0
66558,4,3,233390,233391,233394,1,4,0
66559,1,1,233391,233394,233395,3,4,0
66560,6,1,233397,233397,233398,0,1,2
66561,1,1,233398,233398,233399,0,1,0
66562,3,1,233401,233401,233402,0,1,2
66563,1,2,233402,233402,233404,0,2,0
66564,3,3,233405,233405,233408,0,3,1
66565,2,1,233407,233408,233409,1,2,0
66566,2,2,233409,233409,233411,0,2,0
66567,1,2,233410,233411,233413,1,3,0
66568,3,2,233413,233413,233415,0,2,0
66569,5,1,233418,233418,233419,0,1,3
66570,2,3,233420,233420,233423,0,3,1
66571,1,1,233421,233423,233424,2,3,0
66572,5,3,233426,233426,233429,0,3,2
66573,1,3,233427,233429,233432,2,5,0
66574,4,2,233431,233432,233434,1,3,0
66575,3,3,233434,233434,233437,0,3,0
66576,4,1,233438,233438,233439,0,1,1
66577,6,3,233444,233444,233447,0,3,5
66578,4,3,233448,233448,233451,0,3,1
66579,4,1,233452,233452,233453,0,1,1
66580,5,3,233457,233457,233460,0,3,4
66581,3,3,233460,233460,233463,0,3,0
66582,6,2,233466,233466,233468,0,2,3
66583,1,1,233467,233468,233469,1,2,0
66584,4,3,233471,233471,233474,0,3,2
66585,1,1,233472,233474,233475,2,3,0
66586,4,2,233476,233476,233478,0,2,1
66587,6,3,233482,233482,233485,0,3,4
66588,1,3,233483,233485,233488,2,5,0
66589,5,3,233488,233488,233491,0,3,0
66590,6,1,233494,233494,233495,0,1,3
66591,4,2,233498,233498,233500,0,2,3
66592,5,3,233503,233503,233506,0,3,3
66593,4,3,233507,233507,233510,0,3,1
66594,2,1,233509,233510,233511,1,2,0
66595,1,2,233510,233511,233513,1,3,0
66596,2,1,233512,233513,233514,1,2,0
66597,6,3,233518,233518,233521,0,3,4
66598,2,1,233520,233521,233522,1,2,0
66599,5,3,233525,233525,233528,0,3,3
66600,1,2,233526,233528,233530,2,4,0
66601,2,3,233528,233530,233533,2,5,0
66602,1,1,233529,233533,233534,4,5,0
66603,4,2,233533,233534,233536,1,3,0
66604,1,3,233534,233536,233539,2,5,0
66605,1,2,233535,233539,233541,4,6,0
66606,1,1,233536,233541,233542,5,6,0
66607,6,3,233542,233542,233545,0,3,0
66608,5,1,233547,233547,233548,0,1,2
66609,3,3,233550,233550,233553,0,3,2
66610,4,3,233554,233554,233557,0,3,1
66611,3,3,233557,233557,233560,0,3,0
66612,4,1,233561,233561,233562,0,1,1
66613,4,1,233565,233565,233566,0,1,3
66614,6,2,233571,233571,233573,0,2,5
66615,5,2,233576,233576,233578,0,2,3
66616,2,3,233578,233578,233581,0,3,0
66617,5,1,233583,233583,233584,0,1,2
66618,5,2,233588,233588,233590,0,2,4
66619,2,1,233590,233590,233591,0,1,0
66620,6,1,233596,233596,233597,0,1,5
66621,5,2,233601,233601,233603,0,2,4
66622,3,2,233604,233604,233606,0,2,1
66623,6,3,233610,233610,233613,0,3,4
66624,4,2,233614,233614,233616,0,2,1
66625,6,2,233620,233620,233622,0,2,4
66626,4,1,233624,233624,233625,0,1,2
66627,5,2,233629,233629,233631,0,2,4
66628,3,3,233632,233632,233635,0,3,1
66629,5,3,233637,233637,233640,0,3,2
66630,1,3,233638,233640,233643,2,5,0
66631,5,1,233643,233643,233644,0,1,0
66632,2,3,233645,233645,233648,0,3,1
66633,4,3,233649,233649,233652,0,3,1
66634,1,2,233650,233652,233654,2,4,0
66635,4,2,233654,233654,233656,0,2,0
66636,3,2,233657,233657,233659,0,2,1
66637,6,1,233663,233663,233664,0,1,4
66638,5,2,233668,233668,233670,0,2,4
66639,2,3,233670,233670,233673,0,3,0
66640,3,1,233673,233673,233674,0,1,0
66641,3,2,233676,233676,233678,0,2,2
66642,4,3,233680,233680,233683,0,3,2
66643,1,2,233681,233683,233685,2,4,0
66644,5,1,233686,233686,233687,0,1,1
66645,6,3,233692,233692,233695,0,3,5
66646,6,1,233698,233698,233699,0,1,3
66647,1,1,233699,233699,233700,0,1,0
66648,4,2,233703,233703,233705,0,2,3
66649,5,3,233708,233708,233711,0,3,3
66650,1,2,233709,233711,233713,2,4,0
66651,3,2,233712,233713,233715,1,3,0
66652,5,1,233717,233717,233718,0,1,2
66653,5,1,233722,233722,233723,0,1,4
66654,2,1,233724,233724,233725,0,1,1
66655,1,1,233725,233725,233726,0,1,0
66656,2,3,233727,233727,233730,0,3,1
66657,4,2,233731,233731,233733,0,2,1
66658,3,3,233734,233734,233737,0,3,1
66659,6,1,233740,233740,233741,0,1,3
66660,1,2,233741,233741,233743,0,2,0
66661,3,1,233744,233744,233745,0,1,1
66662,3,3,233747,233747,233750,0,3,2
66663,5,2,233752,233752,233754,0,2,2
66664,3,1,233755,233755,233756,0,1,1
66665,4,1,233759,233759,233760,0,1,3
66666,3,2,233762,233762,233764,0,2,2
66667,4,2,233766,233766,233768,0,2,2
66668,5,2,233771,233771,233773,0,2,3
66669,1,2,233772,233773,233775,1,3,0
66670,1,1,233773,233775,233776,2,3,0
66671,6,2,233779,233779,233781,0,2,3
66672,3,2,233782,233782,233784,0,2,1
66673,4,1,233786,233786,233787,0,1,2
66674,2,2,233788,233788,233790,0,2,1
66675,3,1,233791,233791,233792,0,1,1
66676,4,2,233795,233795,233797,0,2,3
66677,5,3,233800,233800,233803,0,3,3
66678,3,1,233803,233803,233804,0,1,0
66679,2,2,233805,233805,233807,0,2,1
66680,3,1,233808,233808,233809,0,1,1
66681,4,2,233812,233812,233814,0,2,3
66682,5,3,233817,233817,233820,0,3,3
66683,2,1,233819,233820,233821,1,2,0
66684,4,1,233823,233823,233824,0,1,2
66685,1,2,233824,233824,233826,0,2,0
66686,4,3,233828,233828,233831,0,3,2
66687,4,3,233832,233832,233835,0,3,1
66688,5,2,233837,233837,233839,0,2,2
66689,3,1,233840,233840,233841,0,1,1
66690,6,1,233846,233846,233847,0,1,5
66691,6,2,233852,233852,233854,0,2,5
66692,3,3,233855,233855,233858,0,3,1
66693,1,2,233856,233858,233860,2,4,0
66694,3,1,233859,233860,233861,1,2,0
66695,4,3,233863,233863,233866,0,3,2
66696,6,3,233869,233869,233872,0,3,3
66697,1,2,233870,233872,233874,2,4,0
66698,4,1,233874,233874,233875,0,1,0
66699,5,3,233879,233879,233882,0,3,4
66700,6,2,233885,233885,233887,0,2,3
66701,5,1,233890,233890,233891,0,1,3
66702,1,3,233891,233891,233894,0,3,0
66703,4,2,233895,233895,233897,0,2,1
66704,5,1,233900,233900,233901,0,1,3
66705,1,2,233901,233901,233903,0,2,0
66706,1,1,233902,233903,233904,1,2,0
66707,5,1,233907,233907,233908,0,1,3
66708,1,3,233908,233908,233911,0,3,0
66709,1,3,233909,233911,233914,2,5,0
66710,6,2,233915,233915,233917,0,2,1
66711,1,3,233916,233917,233920,1,4,0
66712,5,2,233921,233921,233923,0,2,1
66713,3,3,233924,233924,233927,0,3,1
66714,6,1,233930,233930,233931,0,1,3
66715,1,3,233931,233931,233934,0,3,0
66716,2,3,233933,233934,233937,1,4,0
66717,6,3,233939,233939,233942,0,3,2
66718,3,2,233942,233942,233944,0,2,0
66719,6,1,233948,233948,233949,0,1,4
66720,5,2,233953,233953,233955,0,2,4
66721,1,2,233954,233955,233957,1,3,0
66722,6,1,233960,233960,233961,0,1,3
66723,2,3,233962,233962,233965,0,3,1
66724,3,1,233965,233965,233966,0,1,0
66725,4,3,233969,233969,233972,0,3,3
66726,6,2,233975,233975,233977,0,2,3
66727,3,1,233978,233978,233979,0,1,1
66728,4,2,233982,233982,233984,0,2,3
66729,5,2,233987,233987,233989,0,2,3
66730,5,2,233992,233992,233994,0,2,3
66731,4,2,233996,233996,233998,0,2,2
66732,2,2,233998,233998,234000,0,2,0
66733,4,1,234002,234002,234003,0,1,2
66734,3,3,234005,234005,234008,0,3,2
66735,6,1,234011,234011,234012,0,1,3
66736,6,3,234017,234017,234020,0,3,5
66737,1,3,234018,234020,234023,2,5,0
66738,3,3,234021,234023,234026,2,5,0
66739,3,1,234024,234026,234027,2,3,0
66740,5,1,234029,234029,234030,0,1,2
66741,6,2,234035,234035,234037,0,2,5
66742,1,1,234036,234037,234038,1,2,0
66743,3,2,234039,234039,234041,0,2,1
66744,4,1,234043,234043,234044,0,1,2
66745,4,1,234047,234047,234048,0,1,3
66746,5,2,234052,234052,234054,0,2,4
66747,4,1,234056,234056,234057,0,1,2
66748,4,2,234060,234060,234062,0,2,3
66749,2,3,234062,234062,234065,0,3,0
66750,3,1,234065,234065,234066,0,1,0
66751,6,1,234071,234071,234072,0,1,5
66752,3,3,234074,234074,234077,0,3,2
66753,5,1,234079,234079,234080,0,1,2
66754,6,1,234085,234085,234086,0,1,5
66755,3,3,234088,234088,234091,0,3,2
66756,1,3,234089,234091,234094,2,5,0
66757,4,3,234093,234094,234097,1,4,0
66758,2,2,234095,234097,234099,2,4,0
66759,5,1,234100,234100,234101,0,1,1
66760,4,2,234104,234104,234106,0,2,3
66761,2,1,234106,234106,234107,0,1,0
66762,6,2,234112,234112,234114,0,2,5
66763,1,3,234113,234114,234117,1,4,0
66764,4,3,234117,234117,234120,0,3,0
66765,2,3,234119,234120,234123,1,4,0
66766,6,3,234125,234125,234128,0,3,2
66767,2,3,234127,234128,234131,1,4,0
66768,2,1,234129,234131,234132,2,3,0
66769,1,1,234130,234132,234133,2,3,0
66770,3,1,234133,234133,234134,0,1,0
66771,4,3,234137,234137,234140,0,3,3
66772,1,2,234138,234140,234142,2,4,0
66773,4,1,234142,234142,234143,0,1,0
66774,2,1,234144,234144,234145,0,1,1
66775,1,1,234145,234145,234146,0,1,0
66776,1,1,234146,234146,234147,0,1,0
66777,3,1,234149,234149,234150,0,1,2
66778,6,2,234155,234155,234157,0,2,5
66779,6,3,234161,234161,234164,0,3,4
66780,6,2,234167,234167,234169,0,2,3
66781,5,3,234172,234172,234175,0,3,3
66782,6,2,234178,234178,234180,0,2,3
66783,1,1,234179,234180,234181,1,2,0
66784,1,1,234180,234181,234182,1,2,0
66785,4,2,234184,234184,234186,0,2,2
66786,6,2,234190,234190,234192,0,2,4
66787,3,3,234193,234193,234196,0,3,1
66788,5,3,234198,234198,234201,0,3,2
66789,6,2,234204,234204,234206,0,2,3
66790,3,1,234207,234207,234208,0,1,1
66791,4,3,234211,234211,234214,0,3,3
66792,5,2,234216,234216,234218,0,2,2
66793,1,1,234217,234218,234219,1,2,0
66794,1,1,234218,234219,234220,1,2,0
66795,5,3,234223,234223,234226,0,3,3
66796,3,3,234226,234226,234229,0,3,0
66797,1,3,234227,234229,234232,2,5,0
66798,1,3,234228,234232,234235,4,7,0
66799,6,2,234234,234235,234237,1,3,0
66800,2,2,234236,234237,234239,1,3,0
66801,2,3,234238,234239,234242,1,4,0
66802,1,3,234239,234242,234245,3,6,0
66803,4,1,234243,234245,234246,2,3,0
66804,6,1,234249,234249,234250,0,1,3
66805,3,3,234252,234252,234255,0,3,2
66806,1,3,234253,234255,234258,2,5,0
66807,2,2,234255,234258,234260,3,5,0
66808,1,2,234256,234260,234262,4,6,0
66809,6,3,234262,234262,234265,0,3,0
66810,1,1,234263,234265,234266,2,3,0
66811,2,2,234265,234266,234268,1,3,0
66812,5,2,234270,234270,234272,0,2,2
66813,1,2,234271,234272,234274,1,3,0
66814,4,2,234275,234275,234277,0,2,1
66815,1,3,234276,234277,234280,1,4,0
66816,5,1,234281,234281,234282,0,1,1
66817,3,3,234284,234284,234287,0,3,2
66818,2,2,234286,234287,234289,1,3,0
66819,4,2,234290,234290,234292,0,2,1
66820,6,2,234296,234296,234298,0,2,4
66821,1,2,234297,234298,234300,1,3,0
66822,3,3,234300,234300,234303,0,3,0
66823,5,3,234305,234305,234308,0,3,2
66824,6,1,234311,234311,234312,0,1,3
66825,2,2,234313,234313,234315,0,2,1
66826,2,2,234315,234315,234317,0,2,0
66827,6,2,234321,234321,234323,0,2,4
66828,1,1,234322,234323,234324,1,2,0
66829,2,1,234324,234324,234325,0,1,0
66830,3,3,234327,234327,234330,0,3,2
66831,6,1,234333,234333,234334,0,1,3
66832,2,2,234335,234335,234337,0,2,1
66833,6,3,234341,234341,234344,0,3,4
66834,5,2,234346,234346,234348,0,2,2
66835,4,1,234350,234350,234351,0,1,2
66836,3,2,234353,234353,234355,0,2,2
66837,1,1,234354,234355,234356,1,2,0
66838,6,1,234360,234360,234361,0,1,4
66839,3,1,234363,234363,234364,0,1,2
66840,4,1,234367,234367,234368,0,1,3
66841,2,3,234369,234369,234372,0,3,1
66842,6,2,234375,234375,234377,0,2,3
66843,1,2,234376,234377,234379,1,3,0
66844,5,1,234381,234381,234382,0,1,2
66845,5,1,234386,234386,234387,0,1,4
66846,1,2,234387,234387,234389,0,2,0
66847,5,1,234392,234392,234393,0,1,3
66848,6,1,234398,234398,234399,0,1,5
66849,6,1,234404,234404,234405,0,1,5
66850,2,1,234406,234406,234407,0,1,1
66851,6,1,234412,234412,234413,0,1,5
66852,5,1,234417,234417,234418,0,1,4
66853,1,1,234418,234418,234419,0,1,0
66854,3,3,234421,234421,234424,0,3,2
66855,5,3,234426,234426,234429,0,3,2
66856,2,3,234428,234429,234432,1,4,0
66857,1,2,234429,234432,234434,3,5,0
66858,4,3,234433,234434,234437,1,4,0
66859,4,2,234437,234437,234439,0,2,0
66860,3,3,234440,234440,234443,0,3,1
66861,4,3,234444,234444,234447,0,3,1
66862,1,1,234445,234447,234448,2,3,0
66863,3,1,234448,234448,234449,0,1,0
66864,4,2,234452,234452,234454,0,2,3
66865,2,1,234454,234454,234455,0,1,0
66866,1,2,234455,234455,234457,0,2,0
66867,5,2,234460,234460,234462,0,2,3
66868,3,2,234463,234463,234465,0,2,1
66869,4,3,234467,234467,234470,0,3,2
66870,2,3,234469,234470,234473,1,4,0
66871,4,2,234473,234473,234475,0,2,0
66872,6,1,234479,234479,234480,0,1,4
66873,6,3,234485,234485,234488,0,3,5
66874,3,2,234488,234488,234490,0,2,0
66875,6,2,234494,234494,234496,0,2,4
66876,3,1,234497,234497,234498,0,1,1
66877,4,3,234501,234501,234504,0,3,3
66878,2,1,234503,234504,234505,1,2,0
66879,5,3,234508,234508,234511,0,3,3
66880,5,1,234513,234513,234514,0,1,2
66881,4,3,234517,234517,234520,0,3,3
66882,1,2,234518,234520,234522,2,4,0
66883,2,2,234520,234522,234524,2,4,0
66884,5,2,234525,234525,234527,0,2,1
66885,6,1,234531,234531,234532,0,1,4
66886,6,2,234537,234537,234539,0,2,5
66887,3,3,234540,234540,234543,0,3,1
66888,4,3,234544,234544,234547,0,3,1
66889,4,3,234548,234548,234551,0,3,1
66890,6,1,234554,234554,234555,0,1,3
66891,1,1,234555,234555,234556,0,1,0
66892,1,1,234556,234556,234557,0,1,0
66893,3,3,234559,234559,234562,0,3,2
66894,1,2,234560,234562,234564,2,4,0
66895,4,1,234564,234564,234565,0,1,0
66896,1,1,234565,234565,234566,0,1,0
66897,4,1,234569,234569,234570,0,1,3
66898,5,3,234574,234574,234577,0,3,4
66899,2,3,234576,234577,234580,1,4,0
66900,4,3,234580,234580,234583,0,3,0
66901,1,2,234581,234583,234585,2,4,0
66902,2,1,234583,234585,234586,2,3,0
66903,4,3,234587,234587,234590,0,3,1
66904,5,3,234592,234592,234595,0,3,2
66905,3,2,234595,234595,234597,0,2,0
66906,4,3,234599,234599,234602,0,3,2
66907,1,2,234600,234602,234604,2,4,0
66908,1,3,234601,234604,234607,3,6,0
66909,2,1,234603,234607,234608,4,5,0
66910,6,3,234609,234609,234612,0,3,1
66911,5,1,234614,234614,234615,0,1,2
66912,6,3,234620,234620,234623,0,3,5
66913,5,2,234625,234625,234627,0,2,2
66914,6,2,234631,234631,234633,0,2,4
66915,6,3,234637,234637,234640,0,3,4
66916,2,3,234639,234640,234643,1,4,0
66917,1,2,234640,234643,234645,3,5,0
66918,2,2,234642,234645,234647,3,5,0
66919,6,1,234648,234648,234649,0,1,1
66920,4,1,234652,234652,234653,0,1,3
66921,6,3,234658,234658,234661,0,3,5
66922,4,2,234662,234662,234664,0,2,1
66923,1,2,234663,234664,234666,1,3,0
66924,5,3,234668,234668,234671,0,3,2
66925,4,1,234672,234672,234673,0,1,1
66926,1,3,234673,234673,234676,0,3,0
66927,2,2,234675,234676,234678,1,3,0
66928,6,1,234681,234681,234682,0,1,3
66929,4,2,234685,234685,234687,0,2,3
66930,2,1,234687,234687,234688,0,1,0
66931,2,3,234689,234689,234692,0,3,1
66932,2,3,234691,234692,234695,1,4,0
66933,2,3,234693,234695,234698,2,5,0
66934,2,2,234695,234698,234700,3,5,0
66935,6,3,234701,234701,234704,0,3,1
66936,2,2,234703,234704,234706,1,3,0
66937,4,1,234707,234707,234708,0,1,1
66938,1,2,234708,234708,234710,0,2,0
66939,6,2,234714,234714,234716,0,2,4
66940,3,3,234717,234717,234720,0,3,1
66941,4,3,234721,234721,234724,0,3,1
66942,6,1,234727,234727,234728,0,1,3
66943,6,3,234733,234733,234736,0,3,5
66944,4,1,234737,234737,234738,0,1,1
66945,1,2,234738,234738,234740,0,2,0
66946,5,1,234743,234743,234744,0,1,3
66947,1,3,234744,234744,234747,0,3,0
66948,1,3,234745,234747,234750,2,5,0
66949,4,1,234749,234750,234751,1,2,0
66950,4,3,234753,234753,234756,0,3,2
66951,1,2,234754,234756,234758,2,4,0
66952,4,1,234758,234758,234759,0,1,0
66953,5,1,234763,234763,234764,0,1,4
66954,5,2,234768,234768,234770,0,2,4
66955,2,3,234770,234770,234773,0,3,0
66956,3,2,234773,234773,234775,0,2,0
66957,2,1,234775,234775,234776,0,1,0
66958,5,2,234780,234780,234782,0,2,4
66959,5,2,234785,234785,234787,0,2,3
66960,6,2,234791,234791,234793,0,2,4
66961,4,3,234795,234795,234798,0,3,2
66962,4,3,234799,234799,234802,0,3,1
66963,4,3,234803,234803,234806,0,3,1
66964,4,3,234807,234807,234810,0,3,1
66965,5,2,234812,234812,234814,0,2,2
66966,1,3,234813,234814,234817,1,4,0
66967,6,3,234819,234819,234822,0,3,2
66968,6,2,234825,234825,234827,0,2,3
66969,4,2,234829,234829,234831,0,2,2
66970,5,1,234834,234834,234835,0,1,3
66971,3,3,234837,234837,234840,0,3,2
66972,3,3,234840,234840,234843,0,3,0
66973,5,1,234845,234845,234846,0,1,2
66974,2,3,234847,234847,234850,0,3,1
66975,6,3,234853,234853,234856,0,3,3
66976,6,1,234859,234859,234860,0,1,3
66977,1,2,234860,234860,234862,0,2,0
66978,5,2,234865,234865,234867,0,2,3
66979,4,3,234869,234869,234872,0,3,2
66980,1,1,234870,234872,234873,2,3,0
66981,3,2,234873,234873,234875,0,2,0
66982,3,1,234876,234876,234877,0,1,1
66983,3,2,234879,234879,234881,0,2,2
66984,5,2,234884,234884,234886,0,2,3
66985,1,2,234885,234886,234888,1,3,0
66986,4,3,234889,234889,234892,0,3,1
66987,6,1,234895,234895,234896,0,1,3
66988,5,3,234900,234900,234903,0,3,4
66989,1,1,234901,234903,234904,2,3,0
66990,2,1,234903,234904,234905,1,2,0
66991,6,2,234909,234909,234911,0,2,4
66992,1,3,234910,234911,234914,1,4,0
66993,1,3,234911,234914,234917,3,6,0
66994,4,3,234915,234917,234920,2,5,0
66995,2,1,234917,234920,234921,3,4,0
66996,4,2,234921,234921,234923,0,2,0
66997,4,2,234925,234925,234927,0,2,2
66998,1,1,234926,234927,234928,1,2,0
66999,3,1,234929,234929,234930,0,1,1
67000,1,1,234930,234930,234931,0,1,0
67001,4,3,234934,234934,234937,0,3,3
67002,5,2,234939,234939,234941,0,2,2
67003,5,3,234944,234944,234947,0,3,3
67004,2,1,234946,234947,234948,1,2,0
67005,2,1,234948,234948,234949,0,1,0
67006,5,1,234953,234953,234954,0,1,4
67007,6,1,234959,234959,234960,0,1,5
67008,2,3,234961,234961,234964,0,3,1
67009,5,1,234966,234966,234967,0,1,2
67010,5,1,234971,234971,234972,0,1,4
67011,6,1,234977,234977,234978,0,1,5
67012,2,2,234979,234979,234981,0,2,1
67013,4,2,234983,234983,234985,0,2,2
67014,1,3,234984,234985,234988,1,4,0
67015,6,3,234990,234990,234993,0,3,2
67016,3,1,234993,234993,234994,0,1,0
67017,5,1,234998,234998,234999,0,1,4
67018,1,2,234999,234999,235001,0,2,0
67019,6,1,235005,235005,235006,0,1,4
67020,6,1,235011,235011,235012,0,1,5
67021,5,2,235016,235016,235018,0,2,4
67022,4,2,235020,235020,235022,0,2,2
67023,4,1,235024,235024,235025,0,1,2
67024,3,1,235027,235027,235028,0,1,2
67025,3,2,235030,235030,235032,0,2,2
67026,2,1,235032,235032,235033,0,1,0
67027,4,3,235036,235036,235039,0,3,3
67028,6,3,235042,235042,235045,0,3,3
67029,3,2,235045,235045,235047,0,2,0
67030,4,1,235049,235049,235050,0,1,2
67031,1,3,235050,235050,235053,0,3,0
67032,4,3,235054,235054,235057,0,3,1
67033,1,2,235055,235057,235059,2,4,0
67034,3,1,235058,235059,235060,1,2,0
67035,5,3,235063,235063,235066,0,3,3
67036,1,3,235064,235066,235069,2,5,0
67037,6,2,235070,235070,235072,0,2,1
67038,4,1,235074,235074,235075,0,1,2
67039,5,1,235079,235079,235080,0,1,4
67040,5,1,235084,235084,235085,0,1,4
67041,5,1,235089,235089,235090,0,1,4
67042,6,3,235095,235095,235098,0,3,5
67043,4,2,235099,235099,235101,0,2,1
67044,5,3,235104,235104,235107,0,3,3
67045,1,1,235105,235107,235108,2,3,0
67046,4,3,235109,235109,235112,0,3,1
67047,1,3,235110,235112,235115,2,5,0
67048,1,3,235111,235115,235118,4,7,0
67049,2,2,235113,235118,235120,5,7,0
67050,1,3,235114,235120,235123,6,9,0
67051,4,2,235118,235123,235125,5,7,0
67052,4,3,235122,235125,235128,3,6,0
67053,5,3,235127,235128,235131,1,4,0
67054,5,1,235132,235132,235133,0,1,1
67055,1,2,235133,235133,235135,0,2,0
67056,3,3,235136,235136,235139,0,3,1
67057,4,2,235140,235140,235142,0,2,1
67058,3,1,235143,235143,235144,0,1,1
67059,5,1,235148,235148,235149,0,1,4
67060,2,2,235150,235150,235152,0,2,1
67061,1,1,235151,235152,235153,1,2,0
67062,5,3,235156,235156,235159,0,3,3
67063,4,2,235160,235160,235162,0,2,1
67064,5,3,235165,235165,235168,0,3,3
67065,3,3,235168,235168,235171,0,3,0
67066,5,2,235173,235173,235175,0,2,2
67067,2,1,235175,235175,235176,0,1,0
67068,3,1,235178,235178,235179,0,1,2
67069,6,3,235184,235184,235187,0,3,5
67070,5,1,235189,235189,235190,0,1,2
67071,3,1,235192,235192,235193,0,1,2
67072,5,1,235197,235197,235198,0,1,4
67073,3,1,235200,235200,235201,0,1,2
67074,1,3,235201,235201,235204,0,3,0
67075,2,3,235203,235204,235207,1,4,0
67076,5,3,235208,235208,235211,0,3,1
67077,4,2,235212,235212,235214,0,2,1
67078,2,3,235214,235214,235217,0,3,0
67079,2,3,235216,235217,235220,1,4,0
67080,4,1,235220,235220,235221,0,1,0
67081,5,3,235225,235225,235228,0,3,4
67082,3,2,235228,235228,235230,0,2,0
67083,5,1,235233,235233,235234,0,1,3
67084,3,2,235236,235236,235238,0,2,2
67085,5,3,235241,235241,235244,0,3,3
67086,5,3,235246,235246,235249,0,3,2
67087,6,2,235252,235252,235254,0,2,3
67088,6,2,235258,235258,235260,0,2,4
67089,4,3,235262,235262,235265,0,3,2
67090,6,3,235268,235268,235271,0,3,3
67091,3,3,235271,235271,235274,0,3,0
67092,4,3,235275,235275,235278,0,3,1
67093,3,1,235278,235278,235279,0,1,0
67094,2,2,235280,235280,235282,0,2,1
67095,2,3,235282,235282,235285,0,3,0
67096,5,2,235287,235287,235289,0,2,2
67097,4,1,235291,235291,235292,0,1,2
67098,6,1,235297,235297,235298,0,1,5
67099,2,2,235299,235299,235301,0,2,1
67100,1,3,235300,235301,235304,1,4,0
67101,1,1,235301,235304,235305,3,4,0
67102,3,2,235304,235305,235307,1,3,0
67103,1,2,235305,235307,235309,2,4,0
67104,5,2,235310,235310,235312,0,2,1
67105,4,3,235314,235314,235317,0,3,2
67106,1,1,235315,235317,235318,2,3,0
67107,5,1,235320,235320,235321,0,1,2
67108,2,2,235322,235322,235324,0,2,1
67109,5,2,235327,235327,235329,0,2,3
67110,4,3,235331,235331,235334,0,3,2
67111,2,3,235333,235334,235337,1,4,0
67112,6,1,235339,235339,235340,0,1,2
67113,6,3,235345,235345,235348,0,3,5
67114,2,1,235347,235348,235349,1,2,0
67115,4,2,235351,235351,235353,0,2,2
67116,2,2,235353,235353,235355,0,2,0
67117,2,2,235355,235355,235357,0,2,0
67118,3,1,235358,235358,235359,0,1,1
67119,6,3,235364,235364,235367,0,3,5
67120,1,3,235365,235367,235370,2,5,0
67121,6,2,235371,235371,235373,0,2,1
67122,3,3,235374,235374,235377,0,3,1
67123,2,1,235376,235377,235378,1,2,0
67124,6,1,235382,235382,235383,0,1,4
67125,1,1,235383,235383,235384,0,1,0
67126,2,3,235385,235385,235388,0,3,1
67127,6,1,235391,235391,235392,0,1,3
67128,1,3,235392,235392,235395,0,3,0
67129,5,1,235397,235397,235398,0,1,2
67130,6,2,235403,235403,235405,0,2,5
67131,2,1,235405,235405,235406,0,1,0
67132,4,3,235409,235409,235412,0,3,3
67133,2,3,235411,235412,235415,1,4,0
67134,6,2,235417,235417,235419,0,2,2
67135,6,2,235423,235423,235425,0,2,4
67136,3,1,235426,235426,235427,0,1,1
67137,4,1,235430,235430,235431,0,1,3
67138,2,3,235432,235432,235435,0,3,1
67139,6,1,235438,235438,235439,0,1,3
67140,5,2,235443,235443,235445,0,2,4
67141,4,1,235447,235447,235448,0,1,2
67142,1,3,235448,235448,235451,0,3,0
67143,4,1,235452,235452,235453,0,1,1
67144,2,2,235454,235454,235456,0,2,1
67145,1,1,235455,235456,235457,1,2,0
67146,5,3,235460,235460,235463,0,3,3
67147,4,3,235464,235464,235467,0,3,1
67148,1,3,235465,235467,235470,2,5,0
67149,6,1,235471,235471,235472,0,1,1
67150,5,2,235476,235476,235478,0,2,4
67151,4,3,235480,235480,235483,0,3,2
67152,1,3,235481,235483,235486,2,5,0
67153,4,2,235485,235486,235488,1,3,0
67154,2,3,235487,235488,235491,1,4,0
67155,4,3,235491,235491,235494,0,3,0
67156,5,1,235496,235496,235497,0,1,2
67157,4,3,235500,235500,235503,0,3,3
67158,5,3,235505,235505,235508,0,3,2
67159,6,2,235511,235511,235513,0,2,3
67160,3,2,235514,235514,235516,0,2,1
67161,5,1,235519,235519,235520,0,1,3
67162,1,2,235520,235520,235522,0,2,0
67163,1,2,235521,235522,235524,1,3,0
67164,1,2,235522,235524,235526,2,4,0
67165,3,1,235525,235526,235527,1,2,0
67166,4,3,235529,235529,235532,0,3,2
67167,3,1,235532,235532,235533,0,1,0
67168,2,1,235534,235534,235535,0,1,1
67169,4,3,235538,235538,235541,0,3,3
67170,5,3,235543,235543,235546,0,3,2
67171,3,1,235546,235546,235547,0,1,0
67172,5,3,235551,235551,235554,0,3,4
67173,3,3,235554,235554,235557,0,3,0
67174,5,1,235559,235559,235560,0,1,2
67175,2,3,235561,235561,235564,0,3,1
67176,6,3,235567,235567,235570,0,3,3
67177,4,1,235571,235571,235572,0,1,1
67178,6,3,235577,235577,235580,0,3,5
67179,2,1,235579,235580,235581,1,2,0
67180,5,2,235584,235584,235586,0,2,3
67181,4,2,235588,235588,235590,0,2,2
67182,1,2,235589,235590,235592,1,3,0
67183,3,1,235592,235592,235593,0,1,0
67184,5,1,235597,235597,235598,0,1,4
67185,1,2,235598,235598,235600,0,2,0
67186,1,3,235599,235600,235603,1,4,0
67187,3,3,235602,235603,235606,1,4,0
67188,6,1,235608,235608,235609,0,1,2
67189,6,3,235614,235614,235617,0,3,5
67190,4,3,235618,235618,235621,0,3,1
67191,5,3,235623,235623,235626,0,3,2
67192,6,3,235629,235629,235632,0,3,3
67193,5,1,235634,235634,235635,0,1,2
67194,4,2,235638,235638,235640,0,2,3
67195,3,2,235641,235641,235643,0,2,1
67196,1,2,235642,235643,235645,1,3,0
67197,3,1,235645,235645,235646,0,1,0
67198,5,1,235650,235650,235651,0,1,4
67199,4,1,235654,235654,235655,0,1,3
67200,6,3,235660,235660,235663,0,3,5
67201,2,3,235662,235663,235666,1,4,0
67202,2,2,235664,235666,235668,2,4,0
67203,5,1,235669,235669,235670,0,1,1
67204,5,2,235674,235674,235676,0,2,4
67205,2,3,235676,235676,235679,0,3,0
67206,6,2,235682,235682,235684,0,2,3
67207,5,1,235687,235687,235688,0,1,3
67208,1,1,235688,235688,235689,0,1,0
67209,3,1,235691,235691,235692,0,1,2
67210,6,3,235697,235697,235700,0,3,5
67211,2,3,235699,235700,235703,1,4,0
67212,1,3,235700,235703,235706,3,6,0
67213,3,3,235703,235706,235709,3,6,0
67214,1,2,235704,235709,235711,5,7,0
67215,5,3,235709,235711,235714,2,5,0
67216,6,1,235715,235715,235716,0,1,1
67217,5,2,235720,235720,235722,0,2,4
67218,1,1,235721,235722,235723,1,2,0
67219,1,1,235722,235723,235724,1,2,0
67220,5,1,235727,235727,235728,0,1,3
67221,6,1,235733,235733,235734,0,1,5
67222,3,1,235736,235736,235737,0,1,2
67223,6,1,235742,235742,235743,0,1,5
67224,3,3,235745,235745,235748,0,3,2
67225,1,1,235746,235748,235749,2,3,0
67226,4,2,235750,235750,235752,0,2,1
67227,3,3,235753,235753,235756,0,3,1
67228,3,2,235756,235756,235758,0,2,0
67229,2,1,235758,235758,235759,0,1,0
67230,4,3,235762,235762,235765,0,3,3
67231,2,3,235764,235765,235768,1,4,0
67232,2,3,235766,235768,235771,2,5,0
67233,6,2,235772,235772,235774,0,2,1
67234,4,1,235776,235776,235777,0,1,2
67235,3,1,235779,235779,235780,0,1,2
67236,6,2,235785,235785,235787,0,2,5
67237,5,2,235790,235790,235792,0,2,3
67238,4,3,235794,235794,235797,0,3,2
67239,2,2,235796,235797,235799,1,3,0
67240,4,1,235800,235800,235801,0,1,1
67241,5,1,235805,235805,235806,0,1,4
67242,6,1,235811,235811,235812,0,1,5
67243,3,3,235814,235814,235817,0,3,2
67244,4,1,235818,235818,235819,0,1,1
67245,3,1,235821,235821,235822,0,1,2
67246,6,3,235827,235827,235830,0,3,5
67247,6,1,235833,235833,235834,0,1,3
67248,2,3,235835,235835,235838,0,3,1
67249,6,3,235841,235841,235844,0,3,3
67250,1,1,235842,235844,235845,2,3,0
67251,6,3,235848,235848,235851,0,3,3
67252,1,2,235849,235851,235853,2,4,0
67253,4,3,235853,235853,235856,0,3,0
67254,4,2,235857,235857,235859,0,2,1
67255,4,2,235861,235861,235863,0,2,2
67256,1,2,235862,235863,235865,1,3,0
67257,3,1,235865,235865,235866,0,1,0
67258,2,2,235867,235867,235869,0,2,1
67259,3,1,235870,235870,235871,0,1,1
67260,1,2,235871,235871,235873,0,2,0
67261,5,2,235876,235876,235878,0,2,3
67262,1,3,235877,235878,235881,1,4,0
67263,1,1,235878,235881,235882,3,4,0
67264,2,2,235880,235882,235884,2,4,0
67265,3,2,235883,235884,235886,1,3,0
67266,6,3,235889,235889,235892,0,3,3
67267,3,2,235892,235892,235894,0,2,0
67268,5,1,235897,235897,235898,0,1,3
67269,6,3,235903,235903,235906,0,3,5
67270,2,1,235905,235906,235907,1,2,0
67271,5,1,235910,235910,235911,0,1,3
67272,1,2,235911,235911,235913,0,2,0
67273,3,2,235914,235914,235916,0,2,1
67274,5,1,235919,235919,235920,0,1,3
67275,2,1,235921,235921,235922,0,1,1
67276,1,2,235922,235922,235924,0,2,0
67277,3,2,235925,235925,235927,0,2,1
67278,4,3,235929,235929,235932,0,3,2
67279,6,1,235935,235935,235936,0,1,3
67280,5,1,235940,235940,235941,0,1,4
67281,1,2,235941,235941,235943,0,2,0
67282,4,3,235945,235945,235948,0,3,2
67283,5,1,235950,235950,235951,0,1,2
67284,6,3,235956,235956,235959,0,3,5
67285,5,3,235961,235961,235964,0,3,2
67286,5,3,235966,235966,235969,0,3,2
67287,3,3,235969,235969,235972,0,3,0
67288,6,2,235975,235975,235977,0,2,3
67289,6,2,235981,235981,235983,0,2,4
67290,3,1,235984,235984,235985,0,1,1
67291,1,2,235985,235985,235987,0,2,0
67292,2,3,235987,235987,235990,0,3,0
67293,3,1,235990,235990,235991,0,1,0
67294,5,1,235995,235995,235996,0,1,4
67295,4,3,235999,235999,236002,0,3,3
67296,3,1,236002,236002,236003,0,1,0
67297,2,2,236004,236004,236006,0,2,1
67298,3,2,236007,236007,236009,0,2,1
67299,6,1,236013,236013,236014,0,1,4
67300,6,3,236019,236019,236022,0,3,5
67301,3,1,236022,236022,236023,0,1,0
67302,1,3,236023,236023,236026,0,3,0
67303,5,2,236028,236028,236030,0,2,2
67304,2,1,236030,236030,236031,0,1,0
67305,2,2,236032,236032,236034,0,2,1
67306,6,2,236038,236038,236040,0,2,4
67307,2,3,236040,236040,236043,0,3,0
67308,4,1,236044,236044,236045,0,1,1
67309,2,2,236046,236046,236048,0,2,1
67310,5,2,236051,236051,236053,0,2,3
67311,1,2,236052,236053,236055,1,3,0
67312,2,2,236054,236055,236057,1,3,0
67313,6,3,236060,236060,236063,0,3,3
67314,3,3,236063,236063,236066,0,3,0
67315,6,2,236069,236069,236071,0,2,3
67316,6,1,236075,236075,236076,0,1,4
67317,4,3,236079,236079,236082,0,3,3
67318,1,2,236080,236082,236084,2,4,0
67319,4,2,236084,236084,236086,0,2,0
67320,4,1,236088,236088,236089,0,1,2
67321,2,2,236090,236090,236092,0,2,1
67322,1,1,236091,236092,236093,1,2,0
67323,6,3,236097,236097,236100,0,3,4
67324,1,1,236098,236100,236101,2,3,0
67325,4,2,236102,236102,236104,0,2,1
67326,3,2,236105,236105,236107,0,2,1
67327,1,2,236106,236107,236109,1,3,0
67328,5,3,236111,236111,236114,0,3,2
67329,4,2,236115,236115,236117,0,2,1
67330,1,3,236116,236117,236120,1,4,0
67331,5,1,236121,236121,236122,0,1,1
67332,3,3,236124,236124,236127,0,3,2
67333,3,1,236127,236127,236128,0,1,0
67334,1,2,236128,236128,236130,0,2,0
67335,1,1,236129,236130,236131,1,2,0
67336,1,2,236130,236131,236133,1,3,0
67337,6,2,236136,236136,236138,0,2,3
67338,2,2,236138,236138,236140,0,2,0
67339,3,3,236141,236141,236144,0,3,1
67340,5,1,236146,236146,236147,0,1,2
67341,3,3,236149,236149,236152,0,3,2
67342,3,3,236152,236152,236155,0,3,0
67343,3,3,236155,236155,236158,0,3,0
67344,2,3,236157,236158,236161,1,4,0
67345,3,1,236160,236161,236162,1,2,0
67346,2,3,236162,236162,236165,0,3,0
67347,1,2,236163,236165,236167,2,4,0
67348,4,2,236167,236167,236169,0,2,0
67349,2,2,236169,236169,236171,0,2,0
67350,3,3,236172,236172,236175,0,3,1
67351,1,3,236173,236175,236178,2,5,0
67352,1,3,236174,236178,236181,4,7,0
67353,4,3,236178,236181,236184,3,6,0
67354,6,2,236184,236184,236186,0,2,0
67355,5,3,236189,236189,236192,0,3,3
67356,3,3,236192,236192,236195,0,3,0
67357,1,2,236193,236195,236197,2,4,0
67358,4,1,236197,236197,236198,0,1,0
67359,4,3,236201,236201,236204,0,3,3
67360,5,3,236206,236206,236209,0,3,2
67361,2,1,236208,236209,236210,1,2,0
67362,4,3,236212,236212,236215,0,3,2
67363,2,3,236214,236215,236218,1,4,0
67364,5,2,236219,236219,236221,0,2,1
67365,6,1,236225,236225,236226,0,1,4
67366,5,2,236230,236230,236232,0,2,4
67367,3,1,236233,236233,236234,0,1,1
67368,5,2,236238,236238,236240,0,2,4
67369,3,1,236241,236241,236242,0,1,1
67370,1,3,236242,236242,236245,0,3,0
67371,3,3,236245,236245,236248,0,3,0
67372,4,2,236249,236249,236251,0,2,1
67373,2,1,236251,236251,236252,0,1,0
67374,2,2,236253,236253,236255,0,2,1
67375,6,3,236259,236259,236262,0,3,4
67376,2,2,236261,236262,236264,1,3,0
67377,3,3,236264,236264,236267,0,3,0
67378,5,2,236269,236269,236271,0,2,2
67379,3,2,236272,236272,236274,0,2,1
67380,5,3,236277,236277,236280,0,3,3
67381,6,1,236283,236283,236284,0,1,3
67382,2,2,236285,236285,236287,0,2,1
67383,5,1,236290,236290,236291,0,1,3
67384,5,2,236295,236295,236297,0,2,4
67385,4,1,236299,236299,236300,0,1,2
67386,2,1,236301,236301,236302,0,1,1
67387,4,1,236305,236305,236306,0,1,3
67388,3,1,236308,236308,236309,0,1,2
67389,1,2,236309,236309,236311,0,2,0
67390,1,1,236310,236311,236312,1,2,0
67391,6,3,236316,236316,236319,0,3,4
67392,1,1,236317,236319,236320,2,3,0
67393,2,1,236319,236320,236321,1,2,0
67394,2,2,236321,236321,236323,0,2,0
67395,6,2,236327,236327,236329,0,2,4
67396,1,3,236328,236329,236332,1,4,0
67397,6,2,236334,236334,236336,0,2,2
67398,3,2,236337,236337,236339,0,2,1
67399,3,1,236340,236340,236341,0,1,1
67400,4,3,236344,236344,236347,0,3,3
67401,1,2,236345,236347,236349,2,4,0
67402,2,3,236347,236349,236352,2,5,0
67403,3,3,236350,236352,236355,2,5,0
67404,2,3,236352,236355,236358,3,6,0
67405,5,2,236357,236358,236360,1,3,0
67406,2,3,236359,236360,236363,1,4,0
67407,4,3,236363,236363,236366,0,3,0
67408,6,1,236369,236369,236370,0,1,3
67409,3,2,236372,236372,236374,0,2,2
67410,4,2,236376,236376,236378,0,2,2
67411,6,2,236382,236382,236384,0,2,4
67412,6,3,236388,236388,236391,0,3,4
67413,2,3,236390,236391,236394,1,4,0
67414,2,3,236392,236394,236397,2,5,0
67415,5,2,236397,236397,236399,0,2,0
67416,5,3,236402,236402,236405,0,3,3
67417,5,3,236407,236407,236410,0,3,2
67418,6,1,236413,236413,236414,0,1,3
67419,6,1,236419,236419,236420,0,1,5
67420,2,1,236421,236421,236422,0,1,1
67421,5,3,236426,236426,236429,0,3,4
67422,1,3,236427,236429,236432,2,5,0
67423,6,3,236433,236433,236436,0,3,1
67424,2,3,236435,236436,236439,1,4,0
67425,3,2,236438,236439,236441,1,3,0
67426,6,2,236444,236444,236446,0,2,3
67427,4,2,236448,236448,236450,0,2,2
67428,1,2,236449,236450,236452,1,3,0
67429,2,2,236451,236452,236454,1,3,0
67430,2,1,236453,236454,236455,1,2,0
67431,2,1,236455,236455,236456,0,1,0
67432,5,2,236460,236460,236462,0,2,4
67433,4,1,236464,236464,236465,0,1,2
67434,4,3,236468,236468,236471,0,3,3
67435,5,3,236473,236473,236476,0,3,2
67436,2,2,236475,236476,236478,1,3,0
67437,4,3,236479,236479,236482,0,3,1
67438,2,1,236481,236482,236483,1,2,0
67439,5,3,236486,236486,236489,0,3,3
67440,1,2,236487,236489,236491,2,4,0
67441,3,1,236490,236491,236492,1,2,0
67442,4,2,236494,236494,236496,0,2,2
67443,4,2,236498,236498,236500,0,2,2
67444,3,1,236501,236501,236502,0,1,1
67445,6,1,236507,236507,236508,0,1,5
67446,4,2,236511,236511,236513,0,2,3
67447,2,1,236513,236513,236514,0,1,0
67448,1,2,236514,236514,236516,0,2,0
67449,2,1,236516,236516,236517,0,1,0
67450,1,3,236517,236517,236520,0,3,0
67451,4,3,236521,236521,236524,0,3,1
67452,4,3,236525,236525,236528,0,3,1
67453,4,3,236529,236529,236532,0,3,1
67454,1,3,236530,236532,236535,2,5,0
67455,6,1,236536,236536,236537,0,1,1
67456,3,2,236539,236539,236541,0,2,2
67457,5,3,236544,236544,236547,0,3,3
67458,2,1,236546,236547,236548,1,2,0
67459,1,1,236547,236548,236549,1,2,0
67460,6,3,236553,236553,236556,0,3,4
67461,5,2,236558,236558,236560,0,2,2
67462,3,1,236561,236561,236562,0,1,1
67463,6,3,236567,236567,236570,0,3,5
67464,6,2,236573,236573,236575,0,2,3
67465,2,2,236575,236575,236577,0,2,0
67466,4,3,236579,236579,236582,0,3,2
67467,4,1,236583,236583,236584,0,1,1
67468,6,3,236589,236589,236592,0,3,5
67469,4,1,236593,236593,236594,0,1,1
67470,2,1,236595,236595,236596,0,1,1
67471,1,2,236596,236596,236598,0,2,0
67472,6,3,236602,236602,236605,0,3,4
67473,2,1,236604,236605,236606,1,2,0
67474,2,3,236606,236606,236609,0,3,0
67475,6,2,236612,236612,236614,0,2,3
67476,5,3,236617,236617,236620,0,3,3
67477,2,1,236619,236620,236621,1,2,0
67478,2,3,236621,236621,236624,0,3,0
67479,6,3,236627,236627,236630,0,3,3
67480,3,3,236630,236630,236633,0,3,0
67481,1,1,236631,236633,236634,2,3,0
67482,2,2,236633,236634,236636,1,3,0
67483,2,3,236635,236636,236639,1,4,0
67484,3,1,236638,236639,236640,1,2,0
67485,4,1,236642,236642,236643,0,1,2
67486,4,2,236646,236646,236648,0,2,3
67487,3,2,236649,236649,236651,0,2,1
67488,4,3,236653,236653,236656,0,3,2
67489,1,3,236654,236656,236659,2,5,0
67490,4,3,236658,236659,236662,1,4,0
67491,1,2,236659,236662,236664,3,5,0
67492,1,1,236660,236664,236665,4,5,0
67493,4,3,236664,236665,236668,1,4,0
67494,4,1,236668,236668,236669,0,1,0
67495,3,3,236671,236671,236674,0,3,2
67496,2,2,236673,236674,236676,1,3,0
67497,2,1,236675,236676,236677,1,2,0
67498,1,2,236676,236677,236679,1,3,0
67499,6,1,236682,236682,236683,0,1,3
67500,5,2,236687,236687,236689,0,2,4
67501,3,3,236690,236690,236693,0,3,1
67502,5,1,236695,236695,236696,0,1,2
67503,3,2,236698,236698,236700,0,2,2
67504,4,2,236702,236702,236704,0,2,2
67505,3,1,236705,236705,236706,0,1,1
67506,1,1,236706,236706,236707,0,1,0
67507,1,3,236707,236707,236710,0,3,0
67508,4,2,236711,236711,236713,0,2,1
67509,4,1,236715,236715,236716,0,1,2
67510,3,1,236718,236718,236719,0,1,2
67511,2,1,236720,236720,236721,0,1,1
67512,4,1,236724,236724,236725,0,1,3
67513,1,2,236725,236725,236727,0,2,0
67514,6,2,236731,236731,236733,0,2,4
67515,2,2,236733,236733,236735,0,2,0
67516,2,2,236735,236735,236737,0,2,0
67517,5,2,236740,236740,236742,0,2,3
67518,1,1,236741,236742,236743,1,2,0
67519,6,2,236747,236747,236749,0,2,4
67520,4,2,236751,236751,236753,0,2,2
67521,1,3,236752,236753,236756,1,4,0
67522,6,3,236758,236758,236761,0,3,2
67523,2,1,236760,236761,236762,1,2,0
67524,3,2,236763,236763,236765,0,2,1
67525,5,1,236768,236768,236769,0,1,3
67526,4,2,236772,236772,236774,0,2,3
67527,1,1,236773,236774,236775,1,2,0
67528,5,3,236778,236778,236781,0,3,3
67529,6,1,236784,236784,236785,0,1,3
67530,3,1,236787,236787,236788,0,1,2
67531,2,3,236789,236789,236792,0,3,1
67532,6,2,236795,236795,236797,0,2,3
67533,2,1,236797,236797,236798,0,1,0
67534,2,2,236799,236799,236801,0,2,1
67535,3,1,236802,236802,236803,0,1,1
67536,1,3,236803,236803,236806,0,3,0
67537,5,2,236808,236808,236810,0,2,2
67538,5,3,236813,236813,236816,0,3,3
67539,1,3,236814,236816,236819,2,5,0
67540,6,2,236820,236820,236822,0,2,1
67541,6,1,236826,236826,236827,0,1,4
67542,5,1,236831,236831,236832,0,1,4
67543,6,1,236837,236837,236838,0,1,5
67544,4,1,236841,236841,236842,0,1,3
67545,6,1,236847,236847,236848,0,1,5
67546,4,2,236851,236851,236853,0,2,3
67547,1,2,236852,236853,236855,1,3,0
67548,5,3,236857,236857,236860,0,3,2
67549,5,2,236862,236862,236864,0,2,2
67550,2,3,236864,236864,236867,0,3,0
67551,4,1,236868,236868,236869,0,1,1
67552,4,1,236872,236872,236873,0,1,3
67553,5,1,236877,236877,236878,0,1,4
67554,4,3,236881,236881,236884,0,3,3
67555,2,2,236883,236884,236886,1,3,0
67556,5,3,236888,236888,236891,0,3,2
67557,4,3,236892,236892,236895,0,3,1
67558,5,3,236897,236897,236900,0,3,2
67559,4,3,236901,236901,236904,0,3,1
67560,3,2,236904,236904,236906,0,2,0
67561,2,1,236906,236906,236907,0,1,0
67562,5,2,236911,236911,236913,0,2,4
67563,6,1,236917,236917,236918,0,1,4
67564,4,3,236921,236921,236924,0,3,3
67565,2,3,236923,236924,236927,1,4,0
67566,6,3,236929,236929,236932,0,3,2
67567,2,2,236931,236932,236934,1,3,0
67568,5,2,236936,236936,236938,0,2,2
67569,2,1,236938,236938,236939,0,1,0
67570,6,1,236944,236944,236945,0,1,5
67571,2,3,236946,236946,236949,0,3,1
67572,2,2,236948,236949,236951,1,3,0
67573,1,1,236949,236951,236952,2,3,0
67574,4,3,236953,236953,236956,0,3,1
67575,1,3,236954,236956,236959,2,5,0
67576,4,1,236958,236959,236960,1,2,0
67577,3,1,236961,236961,236962,0,1,1
67578,2,2,236963,236963,236965,0,2,1
67579,4,3,236967,236967,236970,0,3,2
67580,6,1,236973,236973,236974,0,1,3
67581,3,3,236976,236976,236979,0,3,2
67582,4,1,236980,236980,236981,0,1,1
67583,4,2,236984,236984,236986,0,2,3
67584,1,3,236985,236986,236989,1,4,0
67585,2,2,236987,236989,236991,2,4,0
67586,4,3,236991,236991,236994,0,3,0
67587,6,1,236997,236997,236998,0,1,3
67588,5,2,237002,237002,237004,0,2,4
67589,4,1,237006,237006,237007,0,1,2
67590,1,2,237007,237007,237009,0,2,0
67591,3,1,237010,237010,237011,0,1,1
67592,4,2,237014,237014,237016,0,2,3
67593,5,2,237019,237019,237021,0,2,3
67594,6,1,237025,237025,237026,0,1,4
67595,6,3,237031,237031,237034,0,3,5
67596,4,3,237035,237035,237038,0,3,1
67597,4,2,237039,237039,237041,0,2,1
67598,3,2,237042,237042,237044,0,2,1
67599,3,1,237045,237045,237046,0,1,1
67600,4,2,237049,237049,237051,0,2,3
67601,6,1,237055,237055,237056,0,1,4
67602,3,1,237058,237058,237059,0,1,2
67603,4,3,237062,237062,237065,0,3,3
67604,4,3,237066,237066,237069,0,3,1
67605,6,1,237072,237072,237073,0,1,3
67606,2,2,237074,237074,237076,0,2,1
67607,2,1,237076,237076,237077,0,1,0
67608,3,2,237079,237079,237081,0,2,2
67609,2,3,237081,237081,237084,0,3,0
67610,6,3,237087,237087,237090,0,3,3
67611,3,3,237090,237090,237093,0,3,0
67612,3,3,237093,237093,237096,0,3,0
67613,1,2,237094,237096,237098,2,4,0
67614,6,3,237100,237100,237103,0,3,2
67615,6,3,237106,237106,237109,0,3,3
67616,1,2,237107,237109,237111,2,4,0
67617,4,1,237111,237111,237112,0,1,0
67618,1,2,237112,237112,237114,0,2,0
67619,5,3,237117,237117,237120,0,3,3
67620,5,1,237122,237122,237123,0,1,2
67621,5,3,237127,237127,237130,0,3,4
67622,1,1,237128,237130,237131,2,3,0
67623,6,1,237134,237134,237135,0,1,3
67624,3,2,237137,237137,237139,0,2,2
67625,2,3,237139,237139,237142,0,3,0
67626,1,1,237140,237142,237143,2,3,0
67627,1,2,237141,237143,237145,2,4,0
67628,1,2,237142,237145,237147,3,5,0
67629,2,2,237144,237147,237149,3,5,0
67630,3,3,237147,237149,237152,2,5,0
67631,3,3,237150,237152,237155,2,5,0
67632,4,3,237154,237155,237158,1,4,0
67633,6,1,237160,237160,237161,0,1,2
67634,4,3,237164,237164,237167,0,3,3
67635,1,2,237165,237167,237169,2,4,0
67636,3,1,237168,237169,237170,1,2,0
67637,6,3,237174,237174,237177,0,3,4
67638,1,1,237175,237177,237178,2,3,0
67639,4,2,237179,237179,237181,0,2,1
67640,2,3,237181,237181,237184,0,3,0
67641,6,1,237187,237187,237188,0,1,3
67642,1,3,237188,237188,237191,0,3,0
67643,1,2,237189,237191,237193,2,4,0
67644,3,2,237192,237193,237195,1,3,0
67645,2,1,237194,237195,237196,1,2,0
67646,1,1,237195,237196,237197,1,2,0
67647,3,2,237198,237198,237200,0,2,1
67648,3,1,237201,237201,237202,0,1,1
67649,4,1,237205,237205,237206,0,1,3
67650,3,1,237208,237208,237209,0,1,2
67651,3,3,237211,237211,237214,0,3,2
67652,1,3,237212,237214,237217,2,5,0
67653,2,3,237214,237217,237220,3,6,0
67654,6,2,237220,237220,237222,0,2,0
67655,2,3,237222,237222,237225,0,3,0
67656,4,3,237226,237226,237229,0,3,1
67657,1,3,237227,237229,237232,2,5,0
67658,1,1,237228,237232,237233,4,5,0
67659,6,3,237234,237234,237237,0,3,1
67660,4,1,237238,237238,237239,0,1,1
67661,4,1,237242,237242,237243,0,1,3
67662,5,3,237247,237247,237250,0,3,4
67663,1,2,237248,237250,237252,2,4,0
67664,4,2,237252,237252,237254,0,2,0
67665,4,3,237256,237256,237259,0,3,2
67666,5,2,237261,237261,237263,0,2,2
67667,5,3,237266,237266,237269,0,3,3
67668,3,1,237269,237269,237270,0,1,0
67669,2,3,237271,237271,237274,0,3,1
67670,1,3,237272,237274,237277,2,5,0
67671,3,3,237275,237277,237280,2,5,0
67672,1,1,237276,237280,237281,4,5,0
67673,2,1,237278,237281,237282,3,4,0
67674,3,1,237281,237282,237283,1,2,0
67675,3,1,237284,237284,237285,0,1,1
67676,1,1,237285,237285,237286,0,1,0
67677,5,2,237290,237290,237292,0,2,4
67678,1,1,237291,237292,237293,1,2,0
67679,4,3,237295,237295,237298,0,3,2
67680,5,3,237300,237300,237303,0,3,2
67681,6,2,237306,237306,237308,0,2,3
67682,3,2,237309,237309,237311,0,2,1
67683,6,1,237315,237315,237316,0,1,4
67684,1,3,237316,237316,237319,0,3,0
67685,2,2,237318,237319,237321,1,3,0
67686,4,1,237322,237322,237323,0,1,1
67687,6,1,237328,237328,237329,0,1,5
67688,3,2,237331,237331,237333,0,2,2
67689,4,3,237335,237335,237338,0,3,2
67690,4,2,237339,237339,237341,0,2,1
67691,5,3,237344,237344,237347,0,3,3
67692,6,1,237350,237350,237351,0,1,3
67693,5,3,237355,237355,237358,0,3,4
67694,5,3,237360,237360,237363,0,3,2
67695,4,1,237364,237364,237365,0,1,1
67696,6,2,237370,237370,237372,0,2,5
67697,2,3,237372,237372,237375,0,3,0
67698,2,3,237374,237375,237378,1,4,0
67699,6,1,237380,237380,237381,0,1,2
67700,2,1,237382,237382,237383,0,1,1
67701,2,1,237384,237384,237385,0,1,1
67702,1,3,237385,237385,237388,0,3,0
67703,4,2,237389,237389,237391,0,2,1
67704,2,1,237391,237391,237392,0,1,0
67705,4,1,237395,237395,237396,0,1,3
67706,4,3,237399,237399,237402,0,3,3
67707,2,2,237401,237402,237404,1,3,0
67708,2,1,237403,237404,237405,1,2,0
67709,3,1,237406,237406,237407,0,1,1
67710,3,3,237409,237409,237412,0,3,2
67711,5,2,237414,237414,237416,0,2,2
67712,6,3,237420,237420,237423,0,3,4
67713,6,3,237426,237426,237429,0,3,3
67714,5,3,237431,237431,237434,0,3,2
67715,3,2,237434,237434,237436,0,2,0
67716,6,3,237440,237440,237443,0,3,4
67717,1,1,237441,237443,237444,2,3,0
67718,5,1,237446,237446,237447,0,1,2
67719,3,2,237449,237449,237451,0,2,2
67720,4,3,237453,237453,237456,0,3,2
67721,1,3,237454,237456,237459,2,5,0
67722,1,3,237455,237459,237462,4,7,0
67723,2,3,237457,237462,237465,5,8,0
67724,2,2,237459,237465,237467,6,8,0
67725,3,2,237462,237467,237469,5,7,0
67726,5,1,237467,237469,237470,2,3,0
67727,6,1,237473,237473,237474,0,1,3
67728,2,1,237475,237475,237476,0,1,1
67729,3,2,237478,237478,237480,0,2,2
67730,2,2,237480,237480,237482,0,2,0
67731,5,1,237485,237485,237486,0,1,3
67732,3,2,237488,237488,237490,0,2,2
67733,3,2,237491,237491,237493,0,2,1
67734,5,2,237496,237496,237498,0,2,3
67735,5,3,237501,237501,237504,0,3,3
67736,3,2,237504,237504,237506,0,2,0
67737,3,3,237507,237507,237510,0,3,1
67738,5,3,237512,237512,237515,0,3,2
67739,2,3,237514,237515,237518,1,4,0
67740,1,1,237515,237518,237519,3,4,0
67741,2,2,237517,237519,237521,2,4,0
67742,2,1,237519,237521,237522,2,3,0
67743,6,3,237525,237525,237528,0,3,3
67744,4,2,237529,237529,237531,0,2,1
67745,5,1,237534,237534,237535,0,1,3
67746,5,3,237539,237539,237542,0,3,4
67747,1,3,237540,237542,237545,2,5,0
67748,6,3,237546,237546,237549,0,3,1
67749,6,2,237552,237552,237554,0,2,3
67750,4,1,237556,237556,237557,0,1,2
67751,6,2,237562,237562,237564,0,2,5
67752,4,2,237566,237566,237568,0,2,2
67753,3,2,237569,237569,237571,0,2,1
67754,5,2,237574,237574,237576,0,2,3
67755,3,1,237577,237577,237578,0,1,1
67756,2,3,237579,237579,237582,0,3,1
67757,1,3,237580,237582,237585,2,5,0
67758,3,3,237583,237585,237588,2,5,0
67759,4,3,237587,237588,237591,1,4,0
67760,5,3,237592,237592,237595,0,3,1
67761,4,2,237596,237596,237598,0,2,1
67762,1,2,237597,237598,237600,1,3,0
67763,3,1,237600,237600,237601,0,1,0
67764,1,3,237601,237601,237604,0,3,0
67765,4,2,237605,237605,237607,0,2,1
67766,5,1,237610,237610,237611,0,1,3
67767,5,2,237615,237615,237617,0,2,4
67768,1,3,237616,237617,237620,1,4,0
67769,5,1,237621,237621,237622,0,1,1
67770,6,2,237627,237627,237629,0,2,5
67771,2,2,237629,237629,237631,0,2,0
67772,5,1,237634,237634,237635,0,1,3
67773,4,3,237638,237638,237641,0,3,3
67774,3,1,237641,237641,237642,0,1,0
67775,6,1,237647,237647,237648,0,1,5
67776,2,3,237649,237649,237652,0,3,1
67777,2,3,237651,237652,237655,1,4,0
67778,6,3,237657,237657,237660,0,3,2
67779,1,1,237658,237660,237661,2,3,0
67780,1,2,237659,237661,237663,2,4,0
67781,1,3,237660,237663,237666,3,6,0
67782,6,1,237666,237666,237667,0,1,0
67783,5,3,237671,237671,237674,0,3,4
67784,1,1,237672,237674,237675,2,3,0
67785,6,1,237678,237678,237679,0,1,3
67786,6,2,237684,237684,237686,0,2,5
67787,2,2,237686,237686,237688,0,2,0
67788,5,1,237691,237691,237692,0,1,3
67789,2,1,237693,237693,237694,0,1,1
67790,4,3,237697,237697,237700,0,3,3
67791,3,1,237700,237700,237701,0,1,0
67792,3,1,237703,237703,237704,0,1,2
67793,4,3,237707,237707,237710,0,3,3
67794,1,2,237708,237710,237712,2,4,0
67795,6,2,237714,237714,237716,0,2,2
67796,3,3,237717,237717,237720,0,3,1
67797,4,2,237721,237721,237723,0,2,1
67798,2,2,237723,237723,237725,0,2,0
67799,2,3,237725,237725,237728,0,3,0
67800,4,3,237729,237729,237732,0,3,1
67801,4,1,237733,237733,237734,0,1,1
67802,2,2,237735,237735,237737,0,2,1
67803,2,2,237737,237737,237739,0,2,0
67804,4,2,237741,237741,237743,0,2,2
67805,6,2,237747,237747,237749,0,2,4
67806,6,3,237753,237753,237756,0,3,4
67807,4,3,237757,237757,237760,0,3,1
67808,5,2,237762,237762,237764,0,2,2
67809,3,1,237765,237765,237766,0,1,1
67810,6,2,237771,237771,237773,0,2,5
67811,2,3,237773,237773,237776,0,3,0
67812,4,2,237777,237777,237779,0,2,1
67813,4,3,237781,237781,237784,0,3,2
67814,1,1,237782,237784,237785,2,3,0
67815,2,2,237784,237785,237787,1,3,0
67816,5,3,237789,237789,237792,0,3,2
67817,4,1,237793,237793,237794,0,1,1
67818,5,2,237798,237798,237800,0,2,4
67819,2,1,237800,237800,237801,0,1,0
67820,1,2,237801,237801,237803,0,2,0
67821,6,2,237807,237807,237809,0,2,4
67822,4,1,237811,237811,237812,0,1,2
67823,2,2,237813,237813,237815,0,2,1
67824,3,1,237816,237816,237817,0,1,1
67825,1,2,237817,237817,237819,0,2,0
67826,6,2,237823,237823,237825,0,2,4
67827,3,3,237826,237826,237829,0,3,1
67828,4,3,237830,237830,237833,0,3,1
67829,4,3,237834,237834,237837,0,3,1
67830,3,2,237837,237837,237839,0,2,0
67831,6,3,237843,237843,237846,0,3,4
67832,2,3,237845,237846,237849,1,4,0
67833,4,3,237849,237849,237852,0,3,0
67834,6,3,237855,237855,237858,0,3,3
67835,5,3,237860,237860,237863,0,3,2
67836,6,2,237866,237866,237868,0,2,3
67837,1,2,237867,237868,237870,1,3,0
67838,4,2,237871,237871,237873,0,2,1
67839,2,2,237873,237873,237875,0,2,0
67840,4,1,237877,237877,237878,0,1,2
67841,6,1,237883,237883,237884,0,1,5
67842,2,1,237885,237885,237886,0,1,1
67843,2,1,237887,237887,237888,0,1,1
67844,3,1,237890,237890,237891,0,1,2
67845,4,1,237894,237894,237895,0,1,3
67846,4,3,237898,237898,237901,0,3,3
67847,3,2,237901,237901,237903,0,2,0
67848,4,3,237905,237905,237908,0,3,2
67849,4,1,237909,237909,237910,0,1,1
67850,6,1,237915,237915,237916,0,1,5
67851,2,2,237917,237917,237919,0,2,1
67852,6,1,237923,237923,237924,0,1,4
67853,2,3,237925,237925,237928,0,3,1
67854,2,3,237927,237928,237931,1,4,0
67855,3,3,237930,237931,237934,1,4,0
67856,6,1,237936,237936,237937,0,1,2
67857,1,1,237937,237937,237938,0,1,0
67858,5,1,237942,237942,237943,0,1,4
67859,3,2,237945,237945,237947,0,2,2
67860,5,3,237950,237950,237953,0,3,3
67861,2,2,237952,237953,237955,1,3,0
67862,5,3,237957,237957,237960,0,3,2
67863,6,3,237963,237963,237966,0,3,3
67864,6,1,237969,237969,237970,0,1,3
67865,2,1,237971,237971,237972,0,1,1
67866,1,2,237972,237972,237974,0,2,0
67867,4,3,237976,237976,237979,0,3,2
67868,2,2,237978,237979,237981,1,3,0
67869,6,1,237984,237984,237985,0,1,3
67870,6,3,237990,237990,237993,0,3,5
67871,5,2,237995,237995,237997,0,2,2
67872,1,2,237996,237997,237999,1,3,0
67873,6,2,238002,238002,238004,0,2,3
67874,4,1,238006,238006,238007,0,1,2
67875,3,1,238009,238009,238010,0,1,2
67876,1,3,238010,238010,238013,0,3,0
67877,6,2,238016,238016,238018,0,2,3
67878,5,3,238021,238021,238024,0,3,3
67879,6,2,238027,238027,238029,0,2,3
67880,5,3,238032,238032,238035,0,3,3
67881,5,2,238037,238037,238039,0,2,2
67882,4,3,238041,238041,238044,0,3,2
67883,4,2,238045,238045,238047,0,2,1
67884,1,2,238046,238047,238049,1,3,0
67885,1,2,238047,238049,238051,2,4,0
67886,4,1,238051,238051,238052,0,1,0
67887,6,1,238057,238057,238058,0,1,5
67888,4,2,238061,238061,238063,0,2,3
67889,6,2,238067,238067,238069,0,2,4
67890,4,1,238071,238071,238072,0,1,2
67891,2,1,238073,238073,238074,0,1,1
67892,2,2,238075,238075,238077,0,2,1
67893,4,1,238079,238079,238080,0,1,2
67894,5,1,238084,238084,238085,0,1,4
67895,3,1,238087,238087,238088,0,1,2
67896,2,3,238089,238089,238092,0,3,1
67897,1,3,238090,238092,238095,2,5,0
67898,1,2,238091,238095,238097,4,6,0
67899,5,3,238096,238097,238100,1,4,0
67900,4,1,238100,238100,238101,0,1,0
67901,2,2,238102,238102,238104,0,2,1
67902,4,3,238106,238106,238109,0,3,2
67903,5,3,238111,238111,238114,0,3,2
67904,3,1,238114,238114,238115,0,1,0
67905,3,1,238117,238117,238118,0,1,2
67906,6,1,238123,238123,238124,0,1,5
67907,1,3,238124,238124,238127,0,3,0
67908,5,2,238129,238129,238131,0,2,2
67909,2,1,238131,238131,238132,0,1,0
67910,4,2,238135,238135,238137,0,2,3
67911,6,2,238141,238141,238143,0,2,4
67912,6,3,238147,238147,238150,0,3,4
67913,5,2,238152,238152,238154,0,2,2
67914,5,1,238157,238157,238158,0,1,3
67915,3,3,238160,238160,238163,0,3,2
67916,2,2,238162,238163,238165,1,3,0
67917,1,3,238163,238165,238168,2,5,0
67918,4,3,238167,238168,238171,1,4,0
67919,2,2,238169,238171,238173,2,4,0
67920,2,2,238171,238173,238175,2,4,0
67921,5,3,238176,238176,238179,0,3,1
67922,5,2,238181,238181,238183,0,2,2
67923,2,1,238183,238183,238184,0,1,0
67924,2,3,238185,238185,238188,0,3,1
67925,6,2,238191,238191,238193,0,2,3
67926,3,2,238194,238194,238196,0,2,1
67927,4,3,238198,238198,238201,0,3,2
67928,1,2,238199,238201,238203,2,4,0
67929,6,2,238205,238205,238207,0,2,2
67930,6,1,238211,238211,238212,0,1,4
67931,5,1,238216,238216,238217,0,1,4
67932,2,2,238218,238218,238220,0,2,1
67933,5,1,238223,238223,238224,0,1,3
67934,3,3,238226,238226,238229,0,3,2
67935,3,2,238229,238229,238231,0,2,0
67936,4,3,238233,238233,238236,0,3,2
67937,5,3,238238,238238,238241,0,3,2
67938,3,3,238241,238241,238244,0,3,0
67939,1,2,238242,238244,238246,2,4,0
67940,6,2,238248,238248,238250,0,2,2
67941,4,3,238252,238252,238255,0,3,2
67942,4,1,238256,238256,238257,0,1,1
67943,5,2,238261,238261,238263,0,2,4
67944,2,3,238263,238263,238266,0,3,0
67945,2,3,238265,238266,238269,1,4,0
67946,6,1,238271,238271,238272,0,1,2
67947,6,3,238277,238277,238280,0,3,5
67948,5,1,238282,238282,238283,0,1,2
67949,4,2,238286,238286,238288,0,2,3
67950,6,3,238292,238292,238295,0,3,4
67951,5,3,238297,238297,238300,0,3,2
67952,2,3,238299,238300,238303,1,4,0
67953,2,1,238301,238303,238304,2,3,0
67954,2,1,238303,238304,238305,1,2,0
67955,2,1,238305,238305,238306,0,1,0
67956,3,2,238308,238308,238310,0,2,2
67957,2,1,238310,238310,238311,0,1,0
67958,2,3,238312,238312,238315,0,3,1
67959,1,1,238313,238315,238316,2,3,0
67960,4,3,238317,238317,238320,0,3,1
67961,5,3,238322,238322,238325,0,3,2
67962,3,2,238325,238325,238327,0,2,0
67963,2,2,238327,238327,238329,0,2,0
67964,1,3,238328,238329,238332,1,4,0
67965,2,2,238330,238332,238334,2,4,0
67966,6,1,238336,238336,238337,0,1,2
67967,1,3,238337,238337,238340,0,3,0
67968,6,3,238343,238343,238346,0,3,3
67969,1,3,238344,238346,238349,2,5,0
67970,4,3,238348,238349,238352,1,4,0
67971,3,1,238351,238352,238353,1,2,0
67972,4,3,238355,238355,238358,0,3,2
67973,4,1,238359,238359,238360,0,1,1
67974,5,3,238364,238364,238367,0,3,4
67975,5,3,238369,238369,238372,0,3,2
67976,1,3,238370,238372,238375,2,5,0
67977,5,3,238375,238375,238378,0,3,0
67978,5,3,238380,238380,238383,0,3,2
67979,4,2,238384,238384,238386,0,2,1
67980,1,1,238385,238386,238387,1,2,0
67981,4,2,238389,238389,238391,0,2,2
67982,6,3,238395,238395,238398,0,3,4
67983,1,2,238396,238398,238400,2,4,0
67984,3,3,238399,238400,238403,1,4,0
67985,2,1,238401,238403,238404,2,3,0
67986,3,3,238404,238404,238407,0,3,0
67987,3,1,238407,238407,238408,0,1,0
67988,6,1,238413,238413,238414,0,1,5
67989,6,1,238419,238419,238420,0,1,5
67990,2,1,238421,238421,238422,0,1,1
67991,3,3,238424,238424,238427,0,3,2
67992,5,2,238429,238429,238431,0,2,2
67993,3,2,238432,238432,238434,0,2,1
67994,6,2,238438,238438,238440,0,2,4
67995,1,1,238439,238440,238441,1,2,0
67996,2,1,238441,238441,238442,0,1,0
67997,1,1,238442,238442,238443,0,1,0
67998,2,2,238444,238444,238446,0,2,1
67999,5,1,238449,238449,238450,0,1,3
68000,3,3,238452,238452,238455,0,3,2
68001,2,3,238454,238455,238458,1,4,0
68002,1,3,238455,238458,238461,3,6,0
68003,2,1,238457,238461,238462,4,5,0
68004,3,2,238460,238462,238464,2,4,0
68005,3,1,238463,238464,238465,1,2,0
68006,6,1,238469,238469,238470,0,1,4
68007,2,3,238471,238471,238474,0,3,1
68008,6,1,238477,238477,238478,0,1,3
68009,5,1,238482,238482,238483,0,1,4
68010,3,1,238485,238485,238486,0,1,2
68011,3,3,238488,238488,238491,0,3,2
68012,6,2,238494,238494,238496,0,2,3
68013,3,1,238497,238497,238498,0,1,1
68014,1,3,238498,238498,238501,0,3,0
68015,2,3,238500,238501,238504,1,4,0
68016,3,3,238503,238504,238507,1,4,0
68017,2,3,238505,238507,238510,2,5,0
68018,6,2,238511,238511,238513,0,2,1
68019,5,2,238516,238516,238518,0,2,3
68020,6,1,238522,238522,238523,0,1,4
68021,1,1,238523,238523,238524,0,1,0
68022,2,1,238525,238525,238526,0,1,1
68023,5,1,238530,238530,238531,0,1,4
68024,2,3,238532,238532,238535,0,3,1
68025,5,3,238537,238537,238540,0,3,2
68026,4,3,238541,238541,238544,0,3,1
68027,3,3,238544,238544,238547,0,3,0
68028,5,1,238549,238549,238550,0,1,2
68029,2,1,238551,238551,238552,0,1,1
68030,3,3,238554,238554,238557,0,3,2
68031,3,3,238557,238557,238560,0,3,0
68032,5,2,238562,238562,238564,0,2,2
68033,4,3,238566,238566,238569,0,3,2
68034,3,2,238569,238569,238571,0,2,0
68035,4,2,238573,238573,238575,0,2,2
68036,1,3,238574,238575,238578,1,4,0
68037,6,2,238580,238580,238582,0,2,2
68038,3,3,238583,238583,238586,0,3,1
68039,3,3,238586,238586,238589,0,3,0
68040,1,3,238587,238589,238592,2,5,0
68041,4,3,238591,238592,238595,1,4,0
68042,6,3,238597,238597,238600,0,3,2
68043,6,3,238603,238603,238606,0,3,3
68044,3,1,238606,238606,238607,0,1,0
68045,1,2,238607,238607,238609,0,2,0
68046,4,1,238611,238611,238612,0,1,2
68047,2,2,238613,238613,238615,0,2,1
68048,4,3,238617,238617,238620,0,3,2
68049,1,1,238618,238620,238621,2,3,0
68050,5,3,238623,238623,238626,0,3,2
68051,3,2,238626,238626,238628,0,2,0
68052,4,2,238630,238630,238632,0,2,2
68053,5,1,238635,238635,238636,0,1,3
68054,2,2,238637,238637,238639,0,2,1
68055,3,3,238640,238640,238643,0,3,1
68056,5,2,238645,238645,238647,0,2,2
68057,6,1,238651,238651,238652,0,1,4
68058,6,3,238657,238657,238660,0,3,5
68059,1,1,238658,238660,238661,2,3,0
68060,6,2,238664,238664,238666,0,2,3
68061,4,2,238668,238668,238670,0,2,2
68062,5,1,238673,238673,238674,0,1,3
68063,6,2,238679,238679,238681,0,2,5
68064,2,2,238681,238681,238683,0,2,0
68065,3,2,238684,238684,238686,0,2,1
68066,5,3,238689,238689,238692,0,3,3
68067,5,1,238694,238694,238695,0,1,2
68068,1,2,238695,238695,238697,0,2,0
68069,3,1,238698,238698,238699,0,1,1
68070,4,2,238702,238702,238704,0,2,3
68071,4,1,238706,238706,238707,0,1,2
68072,2,1,238708,238708,238709,0,1,1
68073,4,2,238712,238712,238714,0,2,3
68074,6,1,238718,238718,238719,0,1,4
68075,4,2,238722,238722,238724,0,2,3
68076,1,1,238723,238724,238725,1,2,0
68077,3,1,238726,238726,238727,0,1,1
68078,5,2,238731,238731,238733,0,2,4
68079,3,3,238734,238734,238737,0,3,1
68080,1,3,238735,238737,238740,2,5,0
68081,3,2,238738,238740,238742,2,4,0
68082,3,1,238741,238742,238743,1,2,0
68083,5,3,238746,238746,238749,0,3,3
68084,5,3,238751,238751,238754,0,3,2
68085,5,1,238756,238756,238757,0,1,2
68086,6,1,238762,238762,238763,0,1,5
68087,1,1,238763,238763,238764,0,1,0
68088,2,2,238765,238765,238767,0,2,1
68089,5,3,238770,238770,238773,0,3,3
68090,3,3,238773,238773,238776,0,3,0
68091,1,1,238774,238776,238777,2,3,0
68092,6,2,238780,238780,238782,0,2,3
68093,2,1,238782,238782,238783,0,1,0
68094,1,1,238783,238783,238784,0,1,0
68095,5,2,238788,238788,238790,0,2,4
68096,2,2,238790,238790,238792,0,2,0
68097,1,3,238791,238792,238795,1,4,0
68098,4,1,238795,238795,238796,0,1,0
68099,1,3,238796,238796,238799,0,3,0
68100,6,2,238802,238802,238804,0,2,3
68101,3,1,238805,238805,238806,0,1,1
68102,2,1,238807,238807,238808,0,1,1
68103,6,1,238813,238813,238814,0,1,5
68104,4,1,238817,238817,238818,0,1,3
68105,6,3,238823,238823,238826,0,3,5
68106,4,2,238827,238827,238829,0,2,1
68107,4,1,238831,238831,238832,0,1,2
68108,4,2,238835,238835,238837,0,2,3
68109,2,3,238837,238837,238840,0,3,0
68110,4,2,238841,238841,238843,0,2,1
68111,5,3,238846,238846,238849,0,3,3
68112,6,3,238852,238852,238855,0,3,3
68113,2,1,238854,238855,238856,1,2,0
68114,5,3,238859,238859,238862,0,3,3
68115,4,2,238863,238863,238865,0,2,1
68116,6,1,238869,238869,238870,0,1,4
68117,4,3,238873,238873,238876,0,3,3
68118,2,2,238875,238876,238878,1,3,0
68119,5,3,238880,238880,238883,0,3,2
68120,3,2,238883,238883,238885,0,2,0
68121,1,3,238884,238885,238888,1,4,0
68122,1,2,238885,238888,238890,3,5,0
68123,5,3,238890,238890,238893,0,3,0
68124,5,3,238895,238895,238898,0,3,2
68125,2,3,238897,238898,238901,1,4,0
68126,3,2,238900,238901,238903,1,3,0
68127,3,2,238903,238903,238905,0,2,0
68128,3,3,238906,238906,238909,0,3,1
68129,5,1,238911,238911,238912,0,1,2
68130,3,2,238914,238914,238916,0,2,2
68131,5,3,238919,238919,238922,0,3,3
68132,1,3,238920,238922,238925,2,5,0
68133,1,3,238921,238925,238928,4,7,0
68134,3,3,238924,238928,238931,4,7,0
68135,6,2,238930,238931,238933,1,3,0
68136,2,1,238932,238933,238934,1,2,0
68137,1,3,238933,238934,238937,1,4,0
68138,3,1,238936,238937,238938,1,2,0
68139,3,3,238939,238939,238942,0,3,1
68140,4,1,238943,238943,238944,0,1,1
68141,6,1,238949,238949,238950,0,1,5
68142,1,2,238950,238950,238952,0,2,0
68143,4,1,238954,238954,238955,0,1,2
68144,4,3,238958,238958,238961,0,3,3
68145,1,3,238959,238961,238964,2,5,0
68146,2,3,238961,238964,238967,3,6,0
68147,1,1,238962,238967,238968,5,6,0
68148,3,2,238965,238968,238970,3,5,0
68149,2,1,238967,238970,238971,3,4,0
68150,5,1,238972,238972,238973,0,1,1
68151,2,1,238974,238974,238975,0,1,1
68152,1,1,238975,238975,238976,0,1,0
68153,4,1,238979,238979,238980,0,1,3
68154,6,1,238985,238985,238986,0,1,5
68155,3,1,238988,238988,238989,0,1,2
68156,4,3,238992,238992,238995,0,3,3
68157,1,3,238993,238995,238998,2,5,0
68158,1,2,238994,238998,239000,4,6,0
68159,3,3,238997,239000,239003,3,6,0
68160,6,3,239003,239003,239006,0,3,0
68161,1,3,239004,239006,239009,2,5,0
68162,1,2,239005,239009,239011,4,6,0
68163,4,2,239009,239011,239013,2,4,0
68164,3,3,239012,239013,239016,1,4,0
68165,6,2,239018,239018,239020,0,2,2
68166,6,3,239024,239024,239027,0,3,4
68167,2,3,239026,239027,239030,1,4,0
68168,4,3,239030,239030,239033,0,3,0
68169,4,1,239034,239034,239035,0,1,1
68170,5,3,239039,239039,239042,0,3,4
68171,2,2,239041,239042,239044,1,3,0
68172,2,1,239043,239044,239045,1,2,0
68173,1,2,239044,239045,239047,1,3,0
68174,5,3,239049,239049,239052,0,3,2
68175,5,1,239054,239054,239055,0,1,2
68176,5,3,239059,239059,239062,0,3,4
68177,5,1,239064,239064,239065,0,1,2
68178,3,2,239067,239067,239069,0,2,2
68179,6,3,239073,239073,239076,0,3,4
68180,6,3,239079,239079,239082,0,3,3
68181,5,3,239084,239084,239087,0,3,2
68182,2,2,239086,239087,239089,1,3,0
68183,1,2,239087,239089,239091,2,4,0
68184,1,3,239088,239091,239094,3,6,0
68185,2,3,239090,239094,239097,4,7,0
68186,6,1,239096,239097,239098,1,2,0
68187,5,1,239101,239101,239102,0,1,3
68188,6,3,239107,239107,239110,0,3,5
68189,5,1,239112,239112,239113,0,1,2
68190,4,2,239116,239116,239118,0,2,3
68191,3,1,239119,239119,239120,0,1,1
68192,1,1,239120,239120,239121,0,1,0
68193,2,2,239122,239122,239124,0,2,1
68194,1,1,239123,239124,239125,1,2,0
68195,1,3,239124,239125,239128,1,4,0
68196,4,2,239128,239128,239130,0,2,0
68197,6,2,239134,239134,239136,0,2,4
68198,4,1,239138,239138,239139,0,1,2
68199,3,3,239141,239141,239144,0,3,2
68200,5,2,239146,239146,239148,0,2,2
68201,2,3,239148,239148,239151,0,3,0
68202,4,3,239152,239152,239155,0,3,1
68203,1,3,239153,239155,239158,2,5,0
68204,2,2,239155,239158,239160,3,5,0
68205,4,2,239159,239160,239162,1,3,0
68206,4,3,239163,239163,239166,0,3,1
68207,5,1,239168,239168,239169,0,1,2
68208,5,1,239173,239173,239174,0,1,4
68209,3,3,239176,239176,239179,0,3,2
68210,1,3,239177,239179,239182,2,5,0
68211,3,3,239180,239182,239185,2,5,0
68212,1,3,239181,239185,239188,4,7,0
68213,3,1,239184,239188,239189,4,5,0
68214,3,2,239187,239189,239191,2,4,0
68215,1,1,239188,239191,239192,3,4,0
68216,1,1,239189,239192,239193,3,4,0
68217,4,3,239193,239193,239196,0,3,0
68218,2,1,239195,239196,239197,1,2,0
68219,3,1,239198,239198,239199,0,1,1
68220,5,2,239203,239203,239205,0,2,4
68221,4,2,239207,239207,239209,0,2,2
68222,6,2,239213,239213,239215,0,2,4
68223,2,1,239215,239215,239216,0,1,0
68224,2,2,239217,239217,239219,0,2,1
68225,6,1,239223,239223,239224,0,1,4
68226,6,2,239229,239229,239231,0,2,5
68227,2,3,239231,239231,239234,0,3,0
68228,3,1,239234,239234,239235,0,1,0
68229,1,1,239235,239235,239236,0,1,0
68230,3,1,239238,239238,239239,0,1,2
68231,3,1,239241,239241,239242,0,1,2
68232,1,1,239242,239242,239243,0,1,0
68233,1,1,239243,239243,239244,0,1,0
68234,6,1,239249,239249,239250,0,1,5
68235,5,2,239254,239254,239256,0,2,4
68236,1,3,239255,239256,239259,1,4,0
68237,1,3,239256,239259,239262,3,6,0
68238,1,1,239257,239262,239263,5,6,0
68239,4,1,239261,239263,239264,2,3,0
68240,6,3,239267,239267,239270,0,3,3
68241,1,3,239268,239270,239273,2,5,0
68242,6,3,239274,239274,239277,0,3,1
68243,1,2,239275,239277,239279,2,4,0
68244,4,1,239279,239279,239280,0,1,0
68245,5,3,239284,239284,239287,0,3,4
68246,3,3,239287,239287,239290,0,3,0
68247,1,1,239288,239290,239291,2,3,0
68248,2,1,239290,239291,239292,1,2,0
68249,5,2,239295,239295,239297,0,2,3
68250,2,2,239297,239297,239299,0,2,0
68251,6,1,239303,239303,239304,0,1,4
68252,5,2,239308,239308,239310,0,2,4
68253,1,2,239309,239310,239312,1,3,0
68254,5,3,239314,239314,239317,0,3,2
68255,6,1,239320,239320,239321,0,1,3
68256,3,1,239323,239323,239324,0,1,2
68257,3,2,239326,239326,239328,0,2,2
68258,3,1,239329,239329,239330,0,1,1
68259,4,1,239333,239333,239334,0,1,3
68260,1,2,239334,239334,239336,0,2,0
68261,2,1,239336,239336,239337,0,1,0
68262,4,2,239340,239340,239342,0,2,3
68263,1,2,239341,239342,239344,1,3,0
68264,4,2,239345,239345,239347,0,2,1
68265,3,3,239348,239348,239351,0,3,1
68266,6,2,239354,239354,239356,0,2,3
68267,6,2,239360,239360,239362,0,2,4
68268,6,3,239366,239366,239369,0,3,4
68269,3,2,239369,239369,239371,0,2,0
68270,6,3,239375,239375,239378,0,3,4
68271,3,2,239378,239378,239380,0,2,0
68272,3,2,239381,239381,239383,0,2,1
68273,6,2,239387,239387,239389,0,2,4
68274,6,2,239393,239393,239395,0,2,4
68275,3,1,239396,239396,239397,0,1,1
68276,1,3,239397,239397,239400,0,3,0
68277,2,1,239399,239400,239401,1,2,0
68278,1,1,239400,239401,239402,1,2,0
68279,4,2,239404,239404,239406,0,2,2
68280,2,3,239406,239406,239409,0,3,0
68281,4,3,239410,239410,239413,0,3,1
68282,6,3,239416,239416,239419,0,3,3
68283,5,1,239421,239421,239422,0,1,2
68284,6,1,239427,239427,239428,0,1,5
68285,6,1,239433,239433,239434,0,1,5
68286,1,1,239434,239434,239435,0,1,0
68287,4,3,239438,239438,239441,0,3,3
68288,4,3,239442,239442,239445,0,3,1
68289,3,1,239445,239445,239446,0,1,0
68290,4,3,239449,239449,239452,0,3,3
68291,5,2,239454,239454,239456,0,2,2
68292,5,3,239459,239459,239462,0,3,3
68293,4,2,239463,239463,239465,0,2,1
68294,2,1,239465,239465,239466,0,1,0
68295,5,2,239470,239470,239472,0,2,4
68296,4,3,239474,239474,239477,0,3,2
68297,5,1,239479,239479,239480,0,1,2
68298,6,3,239485,239485,239488,0,3,5
68299,6,3,239491,239491,239494,0,3,3
68300,4,1,239495,239495,239496,0,1,1
68301,6,1,239501,239501,239502,0,1,5
68302,1,3,239502,239502,239505,0,3,0
68303,1,2,239503,239505,239507,2,4,0
68304,3,2,239506,239507,239509,1,3,0
68305,6,2,239512,239512,239514,0,2,3
68306,6,1,239518,239518,239519,0,1,4
68307,5,1,239523,239523,239524,0,1,4
68308,5,3,239528,239528,239531,0,3,4
68309,6,1,239534,239534,239535,0,1,3
68310,3,2,239537,239537,239539,0,2,2
68311,6,3,239543,239543,239546,0,3,4
68312,1,2,239544,239546,239548,2,4,0
68313,5,3,239549,239549,239552,0,3,1
68314,1,1,239550,239552,239553,2,3,0
68315,6,1,239556,239556,239557,0,1,3
68316,5,3,239561,239561,239564,0,3,4
68317,3,1,239564,239564,239565,0,1,0
68318,1,1,239565,239565,239566,0,1,0
68319,5,2,239570,239570,239572,0,2,4
68320,2,1,239572,239572,239573,0,1,0
68321,1,1,239573,239573,239574,0,1,0
68322,5,2,239578,239578,239580,0,2,4
68323,2,1,239580,239580,239581,0,1,0
68324,5,3,239585,239585,239588,0,3,4
68325,1,3,239586,239588,239591,2,5,0
68326,1,2,239587,239591,239593,4,6,0
68327,5,3,239592,239593,239596,1,4,0
68328,6,1,239598,239598,239599,0,1,2
68329,2,3,239600,239600,239603,0,3,1
68330,1,1,239601,239603,239604,2,3,0
68331,4,1,239605,239605,239606,0,1,1
68332,2,2,239607,239607,239609,0,2,1
68333,1,1,239608,239609,239610,1,2,0
68334,1,3,239609,239610,239613,1,4,0
68335,6,3,239615,239615,239618,0,3,2
68336,4,1,239619,239619,239620,0,1,1
68337,6,1,239625,239625,239626,0,1,5
68338,4,3,239629,239629,239632,0,3,3
68339,2,1,239631,239632,239633,1,2,0
68340,5,2,239636,239636,239638,0,2,3
68341,2,2,239638,239638,239640,0,2,0
68342,1,2,239639,239640,239642,1,3,0
68343,2,1,239641,239642,239643,1,2,0
68344,3,2,239644,239644,239646,0,2,1
68345,1,2,239645,239646,239648,1,3,0
68346,4,1,239649,239649,239650,0,1,1
68347,4,2,239653,239653,239655,0,2,3
68348,5,2,239658,239658,239660,0,2,3
68349,3,2,239661,239661,239663,0,2,1
68350,5,3,239666,239666,239669,0,3,3
68351,2,3,239668,239669,239672,1,4,0
68352,5,1,239673,239673,239674,0,1,1
68353,6,1,239679,239679,239680,0,1,5
68354,3,3,239682,239682,239685,0,3,2
68355,5,3,239687,239687,239690,0,3,2
68356,4,3,239691,239691,239694,0,3,1
68357,4,2,239695,239695,239697,0,2,1
68358,4,1,239699,239699,239700,0,1,2
68359,2,3,239701,239701,239704,0,3,1
68360,1,1,239702,239704,239705,2,3,0
68361,2,1,239704,239705,239706,1,2,0
68362,4,1,239708,239708,239709,0,1,2
68363,2,1,239710,239710,239711,0,1,1
68364,4,2,239714,239714,239716,0,2,3
68365,1,2,239715,239716,239718,1,3,0
68366,6,1,239721,239721,239722,0,1,3
68367,2,2,239723,239723,239725,0,2,1
68368,4,3,239727,239727,239730,0,3,2
68369,3,2,239730,239730,239732,0,2,0
68370,2,3,239732,239732,239735,0,3,0
68371,3,2,239735,239735,239737,0,2,0
68372,2,2,239737,239737,239739,0,2,0
68373,3,2,239740,239740,239742,0,2,1
68374,2,1,239742,239742,239743,0,1,0
68375,4,2,239746,239746,239748,0,2,3
68376,2,3,239748,239748,239751,0,3,0
68377,4,2,239752,239752,239754,0,2,1
68378,1,3,239753,239754,239757,1,4,0
68379,4,3,239757,239757,239760,0,3,0
68380,6,2,239763,239763,239765,0,2,3
68381,1,1,239764,239765,239766,1,2,0
68382,5,2,239769,239769,239771,0,2,3
68383,1,3,239770,239771,239774,1,4,0
68384,2,3,239772,239774,239777,2,5,0
68385,6,3,239778,239778,239781,0,3,1
68386,2,1,239780,239781,239782,1,2,0
68387,3,2,239783,239783,239785,0,2,1
68388,6,3,239789,239789,239792,0,3,4
68389,2,2,239791,239792,239794,1,3,0
68390,4,2,239795,239795,239797,0,2,1
68391,1,1,239796,239797,239798,1,2,0
68392,6,2,239802,239802,239804,0,2,4
68393,2,1,239804,239804,239805,0,1,0
68394,4,1,239808,239808,239809,0,1,3
68395,5,3,239813,239813,239816,0,3,4
68396,3,3,239816,239816,239819,0,3,0
68397,2,2,239818,239819,239821,1,3,0
68398,5,1,239823,239823,239824,0,1,2
68399,2,2,239825,239825,239827,0,2,1
68400,4,3,239829,239829,239832,0,3,2
68401,5,1,239834,239834,239835,0,1,2
68402,2,1,239836,239836,239837,0,1,1
68403,4,3,239840,239840,239843,0,3,3
68404,6,2,239846,239846,239848,0,2,3
68405,4,2,239850,239850,239852,0,2,2
68406,3,3,239853,239853,239856,0,3,1
68407,4,2,239857,239857,239859,0,2,1
68408,6,2,239863,239863,239865,0,2,4
68409,4,3,239867,239867,239870,0,3,2
68410,6,3,239873,239873,239876,0,3,3
68411,5,2,239878,239878,239880,0,2,2
68412,1,1,239879,239880,239881,1,2,0
68413,2,1,239881,239881,239882,0,1,0
68414,3,3,239884,239884,239887,0,3,2
68415,6,1,239890,239890,239891,0,1,3
68416,2,2,239892,239892,239894,0,2,1
68417,5,2,239897,239897,239899,0,2,3
68418,4,2,239901,239901,239903,0,2,2
68419,4,2,239905,239905,239907,0,2,2
68420,1,2,239906,239907,239909,1,3,0
68421,2,1,239908,239909,239910,1,2,0
68422,2,3,239910,239910,239913,0,3,0
68423,5,3,239915,239915,239918,0,3,2
68424,4,2,239919,239919,239921,0,2,1
68425,6,3,239925,239925,239928,0,3,4
68426,4,2,239929,239929,239931,0,2,1
68427,6,3,239935,239935,239938,0,3,4
68428,2,2,239937,239938,239940,1,3,0
68429,2,3,239939,239940,239943,1,4,0
68430,5,2,239944,239944,239946,0,2,1
68431,1,3,239945,239946,239949,1,4,0
68432,5,2,239950,239950,239952,0,2,1
68433,6,3,239956,239956,239959,0,3,4
68434,2,2,239958,239959,239961,1,3,0
68435,6,3,239964,239964,239967,0,3,3
68436,6,2,239970,239970,239972,0,2,3
68437,3,2,239973,239973,239975,0,2,1
68438,4,1,239977,239977,239978,0,1,2
68439,5,2,239982,239982,239984,0,2,4
68440,1,2,239983,239984,239986,1,3,0
68441,4,1,239987,239987,239988,0,1,1
68442,4,2,239991,239991,239993,0,2,3
68443,5,2,239996,239996,239998,0,2,3
68444,4,1,240000,240000,240001,0,1,2
68445,2,1,240002,240002,240003,0,1,1
68446,4,1,240006,240006,240007,0,1,3
68447,4,3,240010,240010,240013,0,3,3
68448,2,1,240012,240013,240014,1,2,0
68449,6,3,240018,240018,240021,0,3,4
68450,6,1,240024,240024,240025,0,1,3
68451,6,1,240030,240030,240031,0,1,5
68452,6,3,240036,240036,240039,0,3,5
68453,6,3,240042,240042,240045,0,3,3
68454,4,2,240046,240046,240048,0,2,1
68455,2,2,240048,240048,240050,0,2,0
68456,2,2,240050,240050,240052,0,2,0
68457,3,1,240053,240053,240054,0,1,1
68458,3,1,240056,240056,240057,0,1,2
68459,3,2,240059,240059,240061,0,2,2
68460,2,3,240061,240061,240064,0,3,0
68461,1,2,240062,240064,240066,2,4,0
68462,4,3,240066,240066,240069,0,3,0
68463,4,1,240070,240070,240071,0,1,1
68464,3,1,240073,240073,240074,0,1,2
68465,1,2,240074,240074,240076,0,2,0
68466,4,2,240078,240078,240080,0,2,2
68467,4,2,240082,240082,240084,0,2,2
68468,2,2,240084,240084,240086,0,2,0
68469,1,2,240085,240086,240088,1,3,0
68470,5,1,240090,240090,240091,0,1,2
68471,2,1,240092,240092,240093,0,1,1
68472,6,3,240098,240098,240101,0,3,5
68473,6,1,240104,240104,240105,0,1,3
68474,3,3,240107,240107,240110,0,3,2
68475,1,1,240108,240110,240111,2,3,0
68476,6,1,240114,240114,240115,0,1,3
68477,6,3,240120,240120,240123,0,3,5
68478,6,3,240126,240126,240129,0,3,3
68479,5,2,240131,240131,240133,0,2,2
68480,1,3,240132,240133,240136,1,4,0
68481,2,1,240134,240136,240137,2,3,0
68482,6,3,240140,240140,240143,0,3,3
68483,1,2,240141,240143,240145,2,4,0
68484,6,1,240147,240147,240148,0,1,2
68485,1,3,240148,240148,240151,0,3,0
68486,5,1,240153,240153,240154,0,1,2
68487,2,2,240155,240155,240157,0,2,1
68488,5,2,240160,240160,240162,0,2,3
68489,4,3,240164,240164,240167,0,3,2
68490,1,1,240165,240167,240168,2,3,0
68491,5,2,240170,240170,240172,0,2,2
68492,2,1,240172,240172,240173,0,1,0
68493,6,2,240178,240178,240180,0,2,5
68494,5,3,240183,240183,240186,0,3,3
68495,2,3,240185,240186,240189,1,4,0
68496,2,3,240187,240189,240192,2,5,0
68497,1,3,240188,240192,240195,4,7,0
68498,5,3,240193,240195,240198,2,5,0
68499,1,1,240194,240198,240199,4,5,0
68500,5,2,240199,240199,240201,0,2,0
68501,4,1,240203,240203,240204,0,1,2
68502,6,1,240209,240209,240210,0,1,5
68503,5,2,240214,240214,240216,0,2,4
68504,5,3,240219,240219,240222,0,3,3
68505,2,2,240221,240222,240224,1,3,0
68506,2,2,240223,240224,240226,1,3,0
68507,4,1,240227,240227,240228,0,1,1
68508,6,2,240233,240233,240235,0,2,5
68509,5,2,240238,240238,240240,0,2,3
68510,4,2,240242,240242,240244,0,2,2
68511,3,2,240245,240245,240247,0,2,1
68512,5,1,240250,240250,240251,0,1,3
68513,5,2,240255,240255,240257,0,2,4
68514,6,1,240261,240261,240262,0,1,4
68515,5,3,240266,240266,240269,0,3,4
68516,6,1,240272,240272,240273,0,1,3
68517,5,1,240277,240277,240278,0,1,4
68518,1,2,240278,240278,240280,0,2,0
68519,6,1,240284,240284,240285,0,1,4
68520,6,3,240290,240290,240293,0,3,5
68521,2,1,240292,240293,240294,1,2,0
68522,4,2,240296,240296,240298,0,2,2
68523,3,2,240299,240299,240301,0,2,1
68524,6,3,240305,240305,240308,0,3,4
68525,2,1,240307,240308,240309,1,2,0
68526,4,2,240311,240311,240313,0,2,2
68527,5,1,240316,240316,240317,0,1,3
68528,1,1,240317,240317,240318,0,1,0
68529,4,1,240321,240321,240322,0,1,3
68530,5,3,240326,240326,240329,0,3,4
68531,1,3,240327,240329,240332,2,5,0
68532,5,1,240332,240332,240333,0,1,0
68533,6,2,240338,240338,240340,0,2,5
68534,6,3,240344,240344,240347,0,3,4
68535,2,3,240346,240347,240350,1,4,0
68536,1,1,240347,240350,240351,3,4,0
68537,1,2,240348,240351,240353,3,5,0
68538,3,3,240351,240353,240356,2,5,0
68539,6,3,240357,240357,240360,0,3,1
68540,5,2,240362,240362,240364,0,2,2
68541,3,1,240365,240365,240366,0,1,1
68542,6,3,240371,240371,240374,0,3,5
68543,6,3,240377,240377,240380,0,3,3
68544,1,2,240378,240380,240382,2,4,0
68545,4,1,240382,240382,240383,0,1,0
68546,3,2,240385,240385,240387,0,2,2
68547,5,3,240390,240390,240393,0,3,3
68548,3,3,240393,240393,240396,0,3,0
68549,1,3,240394,240396,240399,2,5,0
68550,2,1,240396,240399,240400,3,4,0
68551,4,2,240400,240400,240402,0,2,0
68552,1,2,240401,240402,240404,1,3,0
68553,6,3,240407,240407,240410,0,3,3
68554,1,2,240408,240410,240412,2,4,0
68555,4,1,240412,240412,240413,0,1,0
68556,3,3,240415,240415,240418,0,3,2
68557,2,1,240417,240418,240419,1,2,0
68558,4,1,240421,240421,240422,0,1,2
68559,2,3,240423,240423,240426,0,3,1
68560,6,3,240429,240429,240432,0,3,3
68561,4,1,240433,240433,240434,0,1,1
68562,1,1,240434,240434,240435,0,1,0
68563,5,3,240439,240439,240442,0,3,4
68564,5,2,240444,240444,240446,0,2,2
68565,2,2,240446,240446,240448,0,2,0
68566,1,3,240447,240448,240451,1,4,0
68567,2,2,240449,240451,240453,2,4,0
68568,2,2,240451,240453,240455,2,4,0
68569,1,1,240452,240455,240456,3,4,0
68570,5,2,240457,240457,240459,0,2,1
68571,4,2,240461,240461,240463,0,2,2
68572,5,2,240466,240466,240468,0,2,3
68573,6,3,240472,240472,240475,0,3,4
68574,2,2,240474,240475,240477,1,3,0
68575,6,1,240480,240480,240481,0,1,3
68576,5,1,240485,240485,240486,0,1,4
68577,2,3,240487,240487,240490,0,3,1
68578,6,2,240493,240493,240495,0,2,3
68579,3,2,240496,240496,240498,0,2,1
68580,2,1,240498,240498,240499,0,1,0
68581,4,2,240502,240502,240504,0,2,3
68582,3,3,240505,240505,240508,0,3,1
68583,1,3,240506,240508,240511,2,5,0
68584,2,2,240508,240511,240513,3,5,0
68585,5,3,240513,240513,240516,0,3,0
68586,1,1,240514,240516,240517,2,3,0
68587,5,1,240519,240519,240520,0,1,2
68588,6,1,240525,240525,240526,0,1,5
68589,3,2,240528,240528,240530,0,2,2
68590,6,3,240534,240534,240537,0,3,4
68591,5,2,240539,240539,240541,0,2,2
68592,1,3,240540,240541,240544,1,4,0
68593,2,2,240542,240544,240546,2,4,0
68594,1,3,240543,240546,240549,3,6,0
68595,3,1,240546,240549,240550,3,4,0
68596,1,2,240547,240550,240552,3,5,0
68597,3,2,240550,240552,240554,2,4,0
68598,1,2,240551,240554,240556,3,5,0
68599,3,1,240554,240556,240557,2,3,0
68600,1,2,240555,240557,240559,2,4,0
68601,4,1,240559,240559,240560,0,1,0
68602,3,2,240562,240562,240564,0,2,2
68603,6,2,240568,240568,240570,0,2,4
68604,5,1,240573,240573,240574,0,1,3
68605,1,2,240574,240574,240576,0,2,0
68606,5,2,240579,240579,240581,0,2,3
68607,3,3,240582,240582,240585,0,3,1
68608,1,2,240583,240585,240587,2,4,0
68609,3,3,240586,240587,240590,1,4,0
68610,5,3,240591,240591,240594,0,3,1
68611,3,2,240594,240594,240596,0,2,0
68612,3,2,240597,240597,240599,0,2,1
68613,2,1,240599,240599,240600,0,1,0
68614,4,2,240603,240603,240605,0,2,3
68615,4,1,240607,240607,240608,0,1,2
68616,4,3,240611,240611,240614,0,3,3
68617,4,3,240615,240615,240618,0,3,1
68618,6,1,240621,240621,240622,0,1,3
68619,1,3,240622,240622,240625,0,3,0
68620,2,2,240624,240625,240627,1,3,0
68621,3,3,240627,240627,240630,0,3,0
68622,6,2,240633,240633,240635,0,2,3
68623,5,2,240638,240638,240640,0,2,3
68624,1,3,240639,240640,240643,1,4,0
68625,6,3,240645,240645,240648,0,3,2
68626,3,3,240648,240648,240651,0,3,0
68627,1,2,240649,240651,240653,2,4,0
68628,2,3,240651,240653,240656,2,5,0
68629,5,2,240656,240656,240658,0,2,0
68630,3,2,240659,240659,240661,0,2,1
68631,1,1,240660,240661,240662,1,2,0
68632,2,2,240662,240662,240664,0,2,0
68633,2,2,240664,240664,240666,0,2,0
68634,1,2,240665,240666,240668,1,3,0
68635,6,3,240671,240671,240674,0,3,3
68636,4,3,240675,240675,240678,0,3,1
68637,5,2,240680,240680,240682,0,2,2
68638,2,3,240682,240682,240685,0,3,0
68639,4,2,240686,240686,240688,0,2,1
68640,1,3,240687,240688,240691,1,4,0
68641,5,3,240692,240692,240695,0,3,1
68642,5,1,240697,240697,240698,0,1,2
68643,3,3,240700,240700,240703,0,3,2
68644,3,2,240703,240703,240705,0,2,0
68645,1,3,240704,240705,240708,1,4,0
68646,1,2,240705,240708,240710,3,5,0
68647,3,1,240708,240710,240711,2,3,0
68648,4,3,240712,240712,240715,0,3,1
68649,6,2,240718,240718,240720,0,2,3
68650,4,3,240722,240722,240725,0,3,2
68651,4,1,240726,240726,240727,0,1,1
68652,1,3,240727,240727,240730,0,3,0
68653,4,1,240731,240731,240732,0,1,1
68654,5,3,240736,240736,240739,0,3,4
68655,4,1,240740,240740,240741,0,1,1
68656,1,3,240741,240741,240744,0,3,0
68657,4,3,240745,240745,240748,0,3,1
68658,4,1,240749,240749,240750,0,1,1
68659,3,3,240752,240752,240755,0,3,2
68660,5,3,240757,240757,240760,0,3,2
68661,3,1,240760,240760,240761,0,1,0
68662,4,2,240764,240764,240766,0,2,3
68663,6,3,240770,240770,240773,0,3,4
68664,4,3,240774,240774,240777,0,3,1
68665,3,1,240777,240777,240778,0,1,0
68666,3,2,240780,240780,240782,0,2,2
68667,5,3,240785,240785,240788,0,3,3
68668,6,2,240791,240791,240793,0,2,3
68669,3,2,240794,240794,240796,0,2,1
68670,3,2,240797,240797,240799,0,2,1
68671,2,3,240799,240799,240802,0,3,0
68672,2,2,240801,240802,240804,1,3,0
68673,5,1,240806,240806,240807,0,1,2
68674,3,3,240809,240809,240812,0,3,2
68675,2,1,240811,240812,240813,1,2,0
68676,3,2,240814,240814,240816,0,2,1
68677,2,1,240816,240816,240817,0,1,0
68678,3,1,240819,240819,240820,0,1,2
68679,6,2,240825,240825,240827,0,2,5
68680,5,1,240830,240830,240831,0,1,3
68681,2,3,240832,240832,240835,0,3,1
68682,6,3,240838,240838,240841,0,3,3
68683,5,3,240843,240843,240846,0,3,2
68684,1,2,240844,240846,240848,2,4,0
68685,4,3,240848,240848,240851,0,3,0
68686,1,2,240849,240851,240853,2,4,0
68687,3,3,240852,240853,240856,1,4,0
68688,6,3,240858,240858,240861,0,3,2
68689,3,1,240861,240861,240862,0,1,0
68690,3,2,240864,240864,240866,0,2,2
68691,6,3,240870,240870,240873,0,3,4
68692,6,3,240876,240876,240879,0,3,3
68693,3,1,240879,240879,240880,0,1,0
68694,6,1,240885,240885,240886,0,1,5
68695,5,2,240890,240890,240892,0,2,4
68696,4,1,240894,240894,240895,0,1,2
68697,5,3,240899,240899,240902,0,3,4
68698,6,1,240905,240905,240906,0,1,3
68699,4,2,240909,240909,240911,0,2,3
68700,1,2,240910,240911,240913,1,3,0
68701,6,3,240916,240916,240919,0,3,3
68702,5,3,240921,240921,240924,0,3,2
68703,1,3,240922,240924,240927,2,5,0
68704,3,1,240925,240927,240928,2,3,0
68705,3,1,240928,240928,240929,0,1,0
68706,6,3,240934,240934,240937,0,3,5
68707,1,1,240935,240937,240938,2,3,0
68708,2,2,240937,240938,240940,1,3,0
68709,4,3,240941,240941,240944,0,3,1
68710,1,2,240942,240944,240946,2,4,0
68711,6,2,240948,240948,240950,0,2,2
68712,1,1,240949,240950,240951,1,2,0
68713,2,1,240951,240951,240952,0,1,0
68714,2,3,240953,240953,240956,0,3,1
68715,4,3,240957,240957,240960,0,3,1
68716,3,1,240960,240960,240961,0,1,0
68717,2,2,240962,240962,240964,0,2,1
68718,2,2,240964,240964,240966,0,2,0
68719,1,3,240965,240966,240969,1,4,0
68720,5,1,240970,240970,240971,0,1,1
68721,6,1,240976,240976,240977,0,1,5
68722,4,2,240980,240980,240982,0,2,3
68723,4,1,240984,240984,240985,0,1,2
68724,3,3,240987,240987,240990,0,3,2
68725,2,3,240989,240990,240993,1,4,0
68726,2,1,240991,240993,240994,2,3,0
68727,6,3,240997,240997,241000,0,3,3
68728,2,2,240999,241000,241002,1,3,0
68729,5,2,241004,241004,241006,0,2,2
68730,3,3,241007,241007,241010,0,3,1
68731,1,1,241008,241010,241011,2,3,0
68732,1,1,241009,241011,241012,2,3,0
68733,6,1,241015,241015,241016,0,1,3
68734,4,2,241019,241019,241021,0,2,3
68735,1,1,241020,241021,241022,1,2,0
68736,5,3,241025,241025,241028,0,3,3
68737,1,2,241026,241028,241030,2,4,0
68738,5,3,241031,241031,241034,0,3,1
68739,2,1,241033,241034,241035,1,2,0
68740,2,2,241035,241035,241037,0,2,0
68741,2,1,241037,241037,241038,0,1,0
68742,6,1,241043,241043,241044,0,1,5
68743,2,1,241045,241045,241046,0,1,1
68744,6,2,241051,241051,241053,0,2,5
68745,6,3,241057,241057,241060,0,3,4
68746,6,1,241063,241063,241064,0,1,3
68747,1,3,241064,241064,241067,0,3,0
68748,3,2,241067,241067,241069,0,2,0
68749,4,3,241071,241071,241074,0,3,2
68750,5,3,241076,241076,241079,0,3,2
68751,1,1,241077,241079,241080,2,3,0
68752,4,1,241081,241081,241082,0,1,1
68753,2,3,241083,241083,241086,0,3,1
68754,1,2,241084,241086,241088,2,4,0
68755,5,3,241089,241089,241092,0,3,1
68756,2,3,241091,241092,241095,1,4,0
68757,3,2,241094,241095,241097,1,3,0
68758,5,3,241099,241099,241102,0,3,2
68759,4,2,241103,241103,241105,0,2,1
68760,5,2,241108,241108,241110,0,2,3
68761,4,2,241112,241112,241114,0,2,2
68762,2,3,241114,241114,241117,0,3,0
68763,2,2,241116,241117,241119,1,3,0
68764,5,3,241121,241121,241124,0,3,2
68765,5,2,241126,241126,241128,0,2,2
68766,5,1,241131,241131,241132,0,1,3
68767,3,2,241134,241134,241136,0,2,2
68768,3,1,241137,241137,241138,0,1,1
68769,6,3,241143,241143,241146,0,3,5
68770,5,2,241148,241148,241150,0,2,2
68771,3,2,241151,241151,241153,0,2,1
68772,2,1,241153,241153,241154,0,1,0
68773,3,3,241156,241156,241159,0,3,2
68774,5,3,241161,241161,241164,0,3,2
68775,1,1,241162,241164,241165,2,3,0
68776,5,3,241167,241167,241170,0,3,2
68777,4,3,241171,241171,241174,0,3,1
68778,5,2,241176,241176,241178,0,2,2
68779,6,3,241182,241182,241185,0,3,4
68780,2,2,241184,241185,241187,1,3,0
68781,1,3,241185,241187,241190,2,5,0
68782,5,1,241190,241190,241191,0,1,0
68783,1,1,241191,241191,241192,0,1,0
68784,5,1,241196,241196,241197,0,1,4
68785,3,3,241199,241199,241202,0,3,2
68786,5,1,241204,241204,241205,0,1,2
68787,1,3,241205,241205,241208,0,3,0
68788,2,1,241207,241208,241209,1,2,0
68789,1,3,241208,241209,241212,1,4,0
68790,3,3,241211,241212,241215,1,4,0
68791,5,3,241216,241216,241219,0,3,1
68792,2,3,241218,241219,241222,1,4,0
68793,4,2,241222,241222,241224,0,2,0
68794,4,2,241226,241226,241228,0,2,2
68795,1,3,241227,241228,241231,1,4,0
68796,5,2,241232,241232,241234,0,2,1
68797,2,3,241234,241234,241237,0,3,0
68798,5,2,241239,241239,241241,0,2,2
68799,3,1,241242,241242,241243,0,1,1
68800,6,2,241248,241248,241250,0,2,5
68801,5,3,241253,241253,241256,0,3,3
68802,4,3,241257,241257,241260,0,3,1
68803,1,1,241258,241260,241261,2,3,0
68804,3,3,241261,241261,241264,0,3,0
68805,1,2,241262,241264,241266,2,4,0
68806,3,1,241265,241266,241267,1,2,0
68807,2,1,241267,241267,241268,0,1,0
68808,4,3,241271,241271,241274,0,3,3
68809,1,2,241272,241274,241276,2,4,0
68810,3,3,241275,241276,241279,1,4,0
68811,6,3,241281,241281,241284,0,3,2
68812,6,1,241287,241287,241288,0,1,3
68813,1,3,241288,241288,241291,0,3,0
68814,5,2,241293,241293,241295,0,2,2
68815,2,2,241295,241295,241297,0,2,0
68816,2,1,241297,241297,241298,0,1,0
68817,6,2,241303,241303,241305,0,2,5
68818,3,3,241306,241306,241309,0,3,1
68819,5,2,241311,241311,241313,0,2,2
68820,5,1,241316,241316,241317,0,1,3
68821,4,1,241320,241320,241321,0,1,3
68822,1,1,241321,241321,241322,0,1,0
68823,6,2,241327,241327,241329,0,2,5
68824,3,3,241330,241330,241333,0,3,1
68825,3,1,241333,241333,241334,0,1,0
68826,3,3,241336,241336,241339,0,3,2
68827,5,2,241341,241341,241343,0,2,2
68828,4,1,241345,241345,241346,0,1,2
68829,4,1,241349,241349,241350,0,1,3
68830,4,1,241353,241353,241354,0,1,3
68831,4,1,241357,241357,241358,0,1,3
68832,2,3,241359,241359,241362,0,3,1
68833,5,1,241364,241364,241365,0,1,2
68834,3,3,241367,241367,241370,0,3,2
68835,1,3,241368,241370,241373,2,5,0
68836,2,3,241370,241373,241376,3,6,0
68837,4,3,241374,241376,241379,2,5,0
68838,1,3,241375,241379,241382,4,7,0
68839,3,1,241378,241382,241383,4,5,0
68840,6,1,241384,241384,241385,0,1,1
68841,6,2,241390,241390,241392,0,2,5
68842,1,2,241391,241392,241394,1,3,0
68843,3,2,241394,241394,241396,0,2,0
68844,5,2,241399,241399,241401,0,2,3
68845,6,3,241405,241405,241408,0,3,4
68846,1,3,241406,241408,241411,2,5,0
68847,2,1,241408,241411,241412,3,4,0
68848,3,3,241411,241412,241415,1,4,0
68849,6,3,241417,241417,241420,0,3,2
68850,5,3,241422,241422,241425,0,3,2
68851,6,2,241428,241428,241430,0,2,3
68852,1,2,241429,241430,241432,1,3,0
68853,6,2,241435,241435,241437,0,2,3
68854,2,3,241437,241437,241440,0,3,0
68855,3,3,241440,241440,241443,0,3,0
68856,5,2,241445,241445,241447,0,2,2
68857,5,1,241450,241450,241451,0,1,3
68858,2,3,241452,241452,241455,0,3,1
68859,4,3,241456,241456,241459,0,3,1
68860,6,1,241462,241462,241463,0,1,3
68861,6,2,241468,241468,241470,0,2,5
68862,3,3,241471,241471,241474,0,3,1
68863,1,2,241472,241474,241476,2,4,0
68864,5,3,241477,241477,241480,0,3,1
68865,2,1,241479,241480,241481,1,2,0
68866,3,1,241482,241482,241483,0,1,1
68867,1,1,241483,241483,241484,0,1,0
68868,6,2,241489,241489,241491,0,2,5
68869,4,1,241493,241493,241494,0,1,2
68870,2,3,241495,241495,241498,0,3,1
68871,4,3,241499,241499,241502,0,3,1
68872,3,2,241502,241502,241504,0,2,0
68873,1,2,241503,241504,241506,1,3,0
68874,4,3,241507,241507,241510,0,3,1
68875,1,2,241508,241510,241512,2,4,0
68876,1,2,241509,241512,241514,3,5,0
68877,2,1,241511,241514,241515,3,4,0
68878,5,2,241516,241516,241518,0,2,1
68879,1,3,241517,241518,241521,1,4,0
68880,6,1,241523,241523,241524,0,1,2
68881,3,2,241526,241526,241528,0,2,2
68882,6,3,241532,241532,241535,0,3,4
68883,5,1,241537,241537,241538,0,1,2
68884,5,1,241542,241542,241543,0,1,4
68885,2,3,241544,241544,241547,0,3,1
68886,2,3,241546,241547,241550,1,4,0
68887,6,3,241552,241552,241555,0,3,2
68888,6,2,241558,241558,241560,0,2,3
68889,2,3,241560,241560,241563,0,3,0
68890,3,1,241563,241563,241564,0,1,0
68891,1,1,241564,241564,241565,0,1,0
68892,6,1,241570,241570,241571,0,1,5
68893,6,3,241576,241576,241579,0,3,5
68894,3,2,241579,241579,241581,0,2,0
68895,6,1,241585,241585,241586,0,1,4
68896,6,3,241591,241591,241594,0,3,5
68897,2,3,241593,241594,241597,1,4,0
68898,5,3,241598,241598,241601,0,3,1
68899,6,3,241604,241604,241607,0,3,3
68900,2,2,241606,241607,241609,1,3,0
68901,3,1,241609,241609,241610,0,1,0
68902,6,2,241615,241615,241617,0,2,5
68903,5,1,241620,241620,241621,0,1,3
68904,3,3,241623,241623,241626,0,3,2
68905,6,2,241629,241629,241631,0,2,3
68906,6,3,241635,241635,241638,0,3,4
68907,2,3,241637,241638,241641,1,4,0
68908,1,3,241638,241641,241644,3,6,0
68909,4,2,241642,241644,241646,2,4,0
68910,2,2,241644,241646,241648,2,4,0
68911,4,2,241648,241648,241650,0,2,0
68912,5,3,241653,241653,241656,0,3,3
68913,5,1,241658,241658,241659,0,1,2
68914,4,3,241662,241662,241665,0,3,3
68915,3,1,241665,241665,241666,0,1,0
68916,1,1,241666,241666,241667,0,1,0
68917,3,3,241669,241669,241672,0,3,2
68918,4,3,241673,241673,241676,0,3,1
68919,3,3,241676,241676,241679,0,3,0
68920,3,3,241679,241679,241682,0,3,0
68921,6,2,241685,241685,241687,0,2,3
68922,5,3,241690,241690,241693,0,3,3
68923,5,1,241695,241695,241696,0,1,2
68924,4,3,241699,241699,241702,0,3,3
68925,1,2,241700,241702,241704,2,4,0
68926,4,1,241704,241704,241705,0,1,0
68927,1,3,241705,241705,241708,0,3,0
68928,4,1,241709,241709,241710,0,1,1
68929,4,3,241713,241713,241716,0,3,3
68930,5,2,241718,241718,241720,0,2,2
68931,1,2,241719,241720,241722,1,3,0
68932,4,3,241723,241723,241726,0,3,1
68933,2,2,241725,241726,241728,1,3,0
68934,2,2,241727,241728,241730,1,3,0
68935,2,1,241729,241730,241731,1,2,0
68936,1,2,241730,241731,241733,1,3,0
68937,6,2,241736,241736,241738,0,2,3
68938,2,3,241738,241738,241741,0,3,0
68939,6,3,241744,241744,241747,0,3,3
68940,1,3,241745,241747,241750,2,5,0
68941,6,1,241751,241751,241752,0,1,1
68942,6,2,241757,241757,241759,0,2,5
68943,5,3,241762,241762,241765,0,3,3
68944,6,3,241768,241768,241771,0,3,3
68945,4,1,241772,241772,241773,0,1,1
68946,4,3,241776,241776,241779,0,3,3
68947,3,2,241779,241779,241781,0,2,0
68948,6,2,241785,241785,241787,0,2,4
68949,6,1,241791,241791,241792,0,1,4
68950,5,2,241796,241796,241798,0,2,4
68951,4,2,241800,241800,241802,0,2,2
68952,6,1,241806,241806,241807,0,1,4
68953,3,2,241809,241809,241811,0,2,2
68954,4,3,241813,241813,241816,0,3,2
68955,6,3,241819,241819,241822,0,3,3
68956,4,3,241823,241823,241826,0,3,1
68957,1,3,241824,241826,241829,2,5,0
68958,3,1,241827,241829,241830,2,3,0
68959,1,2,241828,241830,241832,2,4,0
68960,4,1,241832,241832,241833,0,1,0
68961,1,3,241833,241833,241836,0,3,0
68962,3,1,241836,241836,241837,0,1,0
68963,3,2,241839,241839,241841,0,2,2
68964,4,1,241843,241843,241844,0,1,2
68965,5,1,241848,241848,241849,0,1,4
68966,4,3,241852,241852,241855,0,3,3
68967,2,3,241854,241855,241858,1,4,0
68968,4,3,241858,241858,241861,0,3,0
68969,1,1,241859,241861,241862,2,3,0
68970,4,3,241863,241863,241866,0,3,1
68971,6,3,241869,241869,241872,0,3,3
68972,3,1,241872,241872,241873,0,1,0
68973,4,3,241876,241876,241879,0,3,3
68974,2,1,241878,241879,241880,1,2,0
68975,6,2,241884,241884,241886,0,2,4
68976,2,1,241886,241886,241887,0,1,0
68977,2,2,241888,241888,241890,0,2,1
68978,4,3,241892,241892,241895,0,3,2
68979,6,3,241898,241898,241901,0,3,3
68980,6,2,241904,241904,241906,0,2,3
68981,3,1,241907,241907,241908,0,1,1
68982,6,3,241913,241913,241916,0,3,5
68983,3,2,241916,241916,241918,0,2,0
68984,6,2,241922,241922,241924,0,2,4
68985,2,1,241924,241924,241925,0,1,0
68986,3,3,241927,241927,241930,0,3,2
68987,5,2,241932,241932,241934,0,2,2
68988,4,3,241936,241936,241939,0,3,2
68989,5,2,241941,241941,241943,0,2,2
68990,4,3,241945,241945,241948,0,3,2
68991,3,1,241948,241948,241949,0,1,0
68992,6,1,241954,241954,241955,0,1,5
68993,1,3,241955,241955,241958,0,3,0
68994,1,2,241956,241958,241960,2,4,0
68995,2,3,241958,241960,241963,2,5,0
68996,4,1,241962,241963,241964,1,2,0
68997,4,3,241966,241966,241969,0,3,2
68998,1,3,241967,241969,241972,2,5,0
68999,5,1,241972,241972,241973,0,1,0
69000,1,3,241973,241973,241976,0,3,0
69001,4,3,241977,241977,241980,0,3,1
69002,4,3,241981,241981,241984,0,3,1
69003,5,1,241986,241986,241987,0,1,2
69004,2,3,241988,241988,241991,0,3,1
69005,1,3,241989,241991,241994,2,5,0
69006,1,3,241990,241994,241997,4,7,0
69007,4,2,241994,241997,241999,3,5,0
69008,1,2,241995,241999,242001,4,6,0
69009,1,1,241996,242001,242002,5,6,0
69010,3,1,241999,242002,242003,3,4,0
69011,2,1,242001,242003,242004,2,3,0
69012,2,3,242003,242004,242007,1,4,0
69013,6,2,242009,242009,242011,0,2,2
69014,5,3,242014,242014,242017,0,3,3
69015,5,2,242019,242019,242021,0,2,2
69016,5,2,242024,242024,242026,0,2,3
69017,5,3,242029,242029,242032,0,3,3
69018,3,3,242032,242032,242035,0,3,0
69019,1,2,242033,242035,242037,2,4,0
69020,3,2,242036,242037,242039,1,3,0
69021,6,1,242042,242042,242043,0,1,3
69022,5,1,242047,242047,242048,0,1,4
69023,3,2,242050,242050,242052,0,2,2
69024,4,3,242054,242054,242057,0,3,2
69025,5,2,242059,242059,242061,0,2,2
69026,6,1,242065,242065,242066,0,1,4
69027,1,1,242066,242066,242067,0,1,0
69028,1,3,242067,242067,242070,0,3,0
69029,2,3,242069,242070,242073,1,4,0
69030,6,1,242075,242075,242076,0,1,2
69031,3,3,242078,242078,242081,0,3,2
69032,4,2,242082,242082,242084,0,2,1
69033,4,3,242086,242086,242089,0,3,2
69034,2,3,242088,242089,242092,1,4,0
69035,3,2,242091,242092,242094,1,3,0
69036,3,3,242094,242094,242097,0,3,0
69037,1,3,242095,242097,242100,2,5,0
69038,6,2,242101,242101,242103,0,2,1
69039,2,2,242103,242103,242105,0,2,0
69040,3,2,242106,242106,242108,0,2,1
69041,3,1,242109,242109,242110,0,1,1
69042,6,1,242115,242115,242116,0,1,5
69043,6,2,242121,242121,242123,0,2,5
69044,1,1,242122,242123,242124,1,2,0
69045,6,3,242128,242128,242131,0,3,4
69046,2,1,242130,242131,242132,1,2,0
69047,5,1,242135,242135,242136,0,1,3
69048,3,3,242138,242138,242141,0,3,2
69049,3,2,242141,242141,242143,0,2,0
69050,3,2,242144,242144,242146,0,2,1
69051,4,2,242148,242148,242150,0,2,2
69052,5,2,242153,242153,242155,0,2,3
69053,4,2,242157,242157,242159,0,2,2
69054,1,2,242158,242159,242161,1,3,0
69055,4,1,242162,242162,242163,0,1,1
69056,2,2,242164,242164,242166,0,2,1
69057,3,1,242167,242167,242168,0,1,1
69058,6,2,242173,242173,242175,0,2,5
69059,3,2,242176,242176,242178,0,2,1
69060,6,1,242182,242182,242183,0,1,4
69061,6,2,242188,242188,242190,0,2,5
69062,4,3,242192,242192,242195,0,3,2
69063,4,3,242196,242196,242199,0,3,1
69064,4,1,242200,242200,242201,0,1,1
69065,2,1,242202,242202,242203,0,1,1
69066,6,1,242208,242208,242209,0,1,5
69067,1,1,242209,242209,242210,0,1,0
69068,1,2,242210,242210,242212,0,2,0
69069,3,2,242213,242213,242215,0,2,1
69070,4,3,242217,242217,242220,0,3,2
69071,5,1,242222,242222,242223,0,1,2
69072,4,3,242226,242226,242229,0,3,3
69073,3,1,242229,242229,242230,0,1,0
69074,2,3,242231,242231,242234,0,3,1
69075,6,1,242237,242237,242238,0,1,3
69076,4,3,242241,242241,242244,0,3,3
69077,5,3,242246,242246,242249,0,3,2
69078,5,2,242251,242251,242253,0,2,2
69079,4,3,242255,242255,242258,0,3,2
69080,6,3,242261,242261,242264,0,3,3
69081,3,3,242264,242264,242267,0,3,0
69082,5,2,242269,242269,242271,0,2,2
69083,3,1,242272,242272,242273,0,1,1
69084,3,2,242275,242275,242277,0,2,2
69085,1,2,242276,242277,242279,1,3,0
69086,3,3,242279,242279,242282,0,3,0
69087,2,2,242281,242282,242284,1,3,0
69088,2,1,242283,242284,242285,1,2,0
69089,1,1,242284,242285,242286,1,2,0
69090,2,3,242286,242286,242289,0,3,0
69091,5,2,242291,242291,242293,0,2,2
69092,5,2,242296,242296,242298,0,2,3
69093,1,1,242297,242298,242299,1,2,0
69094,6,1,242303,242303,242304,0,1,4
69095,1,3,242304,242304,242307,0,3,0
69096,3,2,242307,242307,242309,0,2,0
69097,1,2,242308,242309,242311,1,3,0
69098,1,3,242309,242311,242314,2,5,0
69099,3,2,242312,242314,242316,2,4,0
69100,3,3,242315,242316,242319,1,4,0
69101,1,2,242316,242319,242321,3,5,0
69102,4,1,242320,242321,242322,1,2,0
69103,5,3,242325,242325,242328,0,3,3
69104,4,2,242329,242329,242331,0,2,1
69105,5,3,242334,242334,242337,0,3,3
69106,5,3,242339,242339,242342,0,3,2
69107,6,2,242345,242345,242347,0,2,3
69108,3,1,242348,242348,242349,0,1,1
69109,4,2,242352,242352,242354,0,2,3
69110,4,3,242356,242356,242359,0,3,2
69111,2,1,242358,242359,242360,1,2,0
69112,1,1,242359,242360,242361,1,2,0
69113,4,2,242363,242363,242365,0,2,2
69114,5,2,242368,242368,242370,0,2,3
69115,2,3,242370,242370,242373,0,3,0
69116,1,3,242371,242373,242376,2,5,0
69117,1,2,242372,242376,242378,4,6,0
69118,4,2,242376,242378,242380,2,4,0
69119,1,2,242377,242380,242382,3,5,0
69120,5,1,242382,242382,242383,0,1,0
69121,2,1,242384,242384,242385,0,1,1
69122,3,2,242387,242387,242389,0,2,2
69123,2,3,242389,242389,242392,0,3,0
69124,1,3,242390,242392,242395,2,5,0
69125,3,1,242393,242395,242396,2,3,0
69126,5,3,242398,242398,242401,0,3,2
69127,6,1,242404,242404,242405,0,1,3
69128,1,2,242405,242405,242407,0,2,0
69129,1,3,242406,242407,242410,1,4,0
69130,4,3,242410,242410,242413,0,3,0
69131,5,3,242415,242415,242418,0,3,2
69132,4,1,242419,242419,242420,0,1,1
69133,5,1,242424,242424,242425,0,1,4
69134,3,3,242427,242427,242430,0,3,2
69135,4,3,242431,242431,242434,0,3,1
69136,6,2,242437,242437,242439,0,2,3
69137,6,1,242443,242443,242444,0,1,4
69138,5,1,242448,242448,242449,0,1,4
69139,4,2,242452,242452,242454,0,2,3
69140,5,2,242457,242457,242459,0,2,3
69141,2,2,242459,242459,242461,0,2,0
69142,4,3,242463,242463,242466,0,3,2
69143,2,3,242465,242466,242469,1,4,0
69144,1,2,242466,242469,242471,3,5,0
69145,4,2,242470,242471,242473,1,3,0
69146,4,2,242474,242474,242476,0,2,1
69147,1,1,242475,242476,242477,1,2,0
69148,1,3,242476,242477,242480,1,4,0
69149,5,3,242481,242481,242484,0,3,1
69150,3,1,242484,242484,242485,0,1,0
69151,1,3,242485,242485,242488,0,3,0
69152,2,3,242487,242488,242491,1,4,0
69153,5,3,242492,242492,242495,0,3,1
69154,4,1,242496,242496,242497,0,1,1
69155,1,2,242497,242497,242499,0,2,0
69156,3,3,242500,242500,242503,0,3,1
69157,4,2,242504,242504,242506,0,2,1
69158,1,1,242505,242506,242507,1,2,0
69159,4,3,242509,242509,242512,0,3,2
69160,6,2,242515,242515,242517,0,2,3
69161,1,3,242516,242517,242520,1,4,0
69162,4,3,242520,242520,242523,0,3,0
69163,6,3,242526,242526,242529,0,3,3
69164,1,1,242527,242529,242530,2,3,0
69165,6,3,242533,242533,242536,0,3,3
69166,6,3,242539,242539,242542,0,3,3
69167,6,3,242545,242545,242548,0,3,3
69168,3,1,242548,242548,242549,0,1,0
69169,2,2,242550,242550,242552,0,2,1
69170,1,2,242551,242552,242554,1,3,0
69171,4,3,242555,242555,242558,0,3,1
69172,5,3,242560,242560,242563,0,3,2
69173,2,3,242562,242563,242566,1,4,0
69174,4,2,242566,242566,242568,0,2,0
69175,5,1,242571,242571,242572,0,1,3
69176,3,2,242574,242574,242576,0,2,2
69177,4,2,242578,242578,242580,0,2,2
69178,3,3,242581,242581,242584,0,3,1
69179,2,1,242583,242584,242585,1,2,0
69180,4,3,242587,242587,242590,0,3,2
69181,1,3,242588,242590,242593,2,5,0
69182,2,3,242590,242593,242596,3,6,0
69183,6,1,242596,242596,242597,0,1,0
69184,3,3,242599,242599,242602,0,3,2
69185,4,1,242603,242603,242604,0,1,1
69186,3,3,242606,242606,242609,0,3,2
69187,1,1,242607,242609,242610,2,3,0
69188,6,2,242613,242613,242615,0,2,3
69189,6,1,242619,242619,242620,0,1,4
69190,3,1,242622,242622,242623,0,1,2
69191,5,3,242627,242627,242630,0,3,4
69192,1,2,242628,242630,242632,2,4,0
69193,2,1,242630,242632,242633,2,3,0
69194,6,1,242636,242636,242637,0,1,3
69195,2,1,242638,242638,242639,0,1,1
69196,3,2,242641,242641,242643,0,2,2
69197,5,3,242646,242646,242649,0,3,3
69198,4,2,242650,242650,242652,0,2,1
69199,2,2,242652,242652,242654,0,2,0
69200,2,3,242654,242654,242657,0,3,0
69201,3,3,242657,242657,242660,0,3,0
69202,3,2,242660,242660,242662,0,2,0
69203,1,1,242661,242662,242663,1,2,0
69204,5,3,242666,242666,242669,0,3,3
69205,5,1,242671,242671,242672,0,1,2
69206,4,1,242675,242675,242676,0,1,3
69207,3,2,242678,242678,242680,0,2,2
69208,4,2,242682,242682,242684,0,2,2
69209,5,3,242687,242687,242690,0,3,3
69210,1,1,242688,242690,242691,2,3,0
69211,1,2,242689,242691,242693,2,4,0
69212,4,1,242693,242693,242694,0,1,0
69213,1,3,242694,242694,242697,0,3,0
69214,2,2,242696,242697,242699,1,3,0
69215,1,2,242697,242699,242701,2,4,0
69216,3,3,242700,242701,242704,1,4,0
69217,2,2,242702,242704,242706,2,4,0
69218,3,1,242705,242706,242707,1,2,0
69219,2,2,242707,242707,242709,0,2,0
69220,4,3,242711,242711,242714,0,3,2
69221,5,2,242716,242716,242718,0,2,2
69222,6,1,242722,242722,242723,0,1,4
69223,6,3,242728,242728,242731,0,3,5
69224,1,2,242729,242731,242733,2,4,0
69225,4,2,242733,242733,242735,0,2,0
69226,6,3,242739,242739,242742,0,3,4
69227,6,2,242745,242745,242747,0,2,3
69228,1,3,242746,242747,242750,1,4,0
69229,4,1,242750,242750,242751,0,1,0
69230,6,2,242756,242756,242758,0,2,5
69231,2,2,242758,242758,242760,0,2,0
69232,2,3,242760,242760,242763,0,3,0
69233,4,1,242764,242764,242765,0,1,1
69234,5,1,242769,242769,242770,0,1,4
69235,4,2,242773,242773,242775,0,2,3
69236,6,1,242779,242779,242780,0,1,4
69237,2,2,242781,242781,242783,0,2,1
69238,6,2,242787,242787,242789,0,2,4
69239,3,1,242790,242790,242791,0,1,1
69240,1,1,242791,242791,242792,0,1,0
69241,4,1,242795,242795,242796,0,1,3
69242,3,2,242798,242798,242800,0,2,2
69243,2,1,242800,242800,242801,0,1,0
69244,2,1,242802,242802,242803,0,1,1
69245,3,2,242805,242805,242807,0,2,2
69246,3,2,242808,242808,242810,0,2,1
69247,1,1,242809,242810,242811,1,2,0
69248,2,3,242811,242811,242814,0,3,0
69249,2,2,242813,242814,242816,1,3,0
69250,3,2,242816,242816,242818,0,2,0
69251,1,3,242817,242818,242821,1,4,0
69252,2,2,242819,242821,242823,2,4,0
69253,5,1,242824,242824,242825,0,1,1
69254,3,1,242827,242827,242828,0,1,2
69255,3,2,242830,242830,242832,0,2,2
69256,5,3,242835,242835,242838,0,3,3
69257,5,3,242840,242840,242843,0,3,2
69258,4,2,242844,242844,242846,0,2,1
69259,2,2,242846,242846,242848,0,2,0
69260,2,2,242848,242848,242850,0,2,0
69261,2,2,242850,242850,242852,0,2,0
69262,5,1,242855,242855,242856,0,1,3
69263,2,2,242857,242857,242859,0,2,1
69264,6,1,242863,242863,242864,0,1,4
69265,6,2,242869,242869,242871,0,2,5
69266,4,3,242873,242873,242876,0,3,2
69267,6,2,242879,242879,242881,0,2,3
69268,6,1,242885,242885,242886,0,1,4
69269,2,1,242887,242887,242888,0,1,1
69270,3,2,242890,242890,242892,0,2,2
69271,3,3,242893,242893,242896,0,3,1
69272,5,1,242898,242898,242899,0,1,2
69273,1,3,242899,242899,242902,0,3,0
69274,4,3,242903,242903,242906,0,3,1
69275,3,3,242906,242906,242909,0,3,0
69276,3,2,242909,242909,242911,0,2,0
69277,2,1,242911,242911,242912,0,1,0
69278,2,1,242913,242913,242914,0,1,1
69279,4,2,242917,242917,242919,0,2,3
69280,2,3,242919,242919,242922,0,3,0
69281,1,2,242920,242922,242924,2,4,0
69282,2,1,242922,242924,242925,2,3,0
69283,5,3,242927,242927,242930,0,3,2
69284,1,2,242928,242930,242932,2,4,0
69285,5,3,242933,242933,242936,0,3,1
69286,2,3,242935,242936,242939,1,4,0
69287,3,3,242938,242939,242942,1,4,0
69288,1,2,242939,242942,242944,3,5,0
69289,2,1,242941,242944,242945,3,4,0
69290,6,2,242947,242947,242949,0,2,2
69291,4,1,242951,242951,242952,0,1,2
69292,1,3,242952,242952,242955,0,3,0
69293,1,3,242953,242955,242958,2,5,0
69294,4,1,242957,242958,242959,1,2,0
69295,3,3,242960,242960,242963,0,3,1
69296,5,1,242965,242965,242966,0,1,2
69297,3,1,242968,242968,242969,0,1,2
69298,5,1,242973,242973,242974,0,1,4
69299,6,3,242979,242979,242982,0,3,5
69300,5,3,242984,242984,242987,0,3,2
69301,2,1,242986,242987,242988,1,2,0
69302,2,2,242988,242988,242990,0,2,0
69303,2,1,242990,242990,242991,0,1,0
69304,5,1,242995,242995,242996,0,1,4
69305,1,1,242996,242996,242997,0,1,0
69306,5,3,243001,243001,243004,0,3,4
69307,2,1,243003,243004,243005,1,2,0
69308,5,1,243008,243008,243009,0,1,3
69309,6,1,243014,243014,243015,0,1,5
69310,4,3,243018,243018,243021,0,3,3
69311,6,1,243024,243024,243025,0,1,3
69312,1,2,243025,243025,243027,0,2,0
69313,1,2,243026,243027,243029,1,3,0
69314,2,1,243028,243029,243030,1,2,0
69315,2,2,243030,243030,243032,0,2,0
69316,4,3,243034,243034,243037,0,3,2
69317,2,1,243036,243037,243038,1,2,0
69318,2,1,243038,243038,243039,0,1,0
69319,5,3,243043,243043,243046,0,3,4
69320,5,2,243048,243048,243050,0,2,2
69321,5,1,243053,243053,243054,0,1,3
69322,6,1,243059,243059,243060,0,1,5
69323,1,1,243060,243060,243061,0,1,0
69324,5,1,243065,243065,243066,0,1,4
69325,1,1,243066,243066,243067,0,1,0
69326,4,3,243070,243070,243073,0,3,3
69327,2,1,243072,243073,243074,1,2,0
69328,6,3,243078,243078,243081,0,3,4
69329,3,2,243081,243081,243083,0,2,0
69330,2,2,243083,243083,243085,0,2,0
69331,2,3,243085,243085,243088,0,3,0
69332,1,2,243086,243088,243090,2,4,0
69333,1,3,243087,243090,243093,3,6,0
69334,2,2,243089,243093,243095,4,6,0
69335,2,2,243091,243095,243097,4,6,0
69336,1,3,243092,243097,243100,5,8,0
69337,6,2,243098,243100,243102,2,4,0
69338,6,3,243104,243104,243107,0,3,2
69339,1,3,243105,243107,243110,2,5,0
69340,5,1,243110,243110,243111,0,1,0
69341,6,2,243116,243116,243118,0,2,5
69342,3,3,243119,243119,243122,0,3,1
69343,4,3,243123,243123,243126,0,3,1
69344,1,1,243124,243126,243127,2,3,0
69345,4,3,243128,243128,243131,0,3,1
69346,1,3,243129,243131,243134,2,5,0
69347,1,2,243130,243134,243136,4,6,0
69348,3,2,243133,243136,243138,3,5,0
69349,2,1,243135,243138,243139,3,4,0
69350,4,1,243139,243139,243140,0,1,0
69351,4,3,243143,243143,243146,0,3,3
69352,3,3,243146,243146,243149,0,3,0
69353,5,3,243151,243151,243154,0,3,2
69354,6,1,243157,243157,243158,0,1,3
69355,4,1,243161,243161,243162,0,1,3
69356,5,2,243166,243166,243168,0,2,4
69357,1,3,243167,243168,243171,1,4,0
69358,2,3,243169,243171,243174,2,5,0
69359,1,2,243170,243174,243176,4,6,0
69360,2,2,243172,243176,243178,4,6,0
69361,4,2,243176,243178,243180,2,4,0
69362,2,3,243178,243180,243183,2,5,0
69363,4,1,243182,243183,243184,1,2,0
69364,4,2,243186,243186,243188,0,2,2
69365,5,3,243191,243191,243194,0,3,3
69366,1,3,243192,243194,243197,2,5,0
69367,6,2,243198,243198,243200,0,2,1
69368,1,2,243199,243200,243202,1,3,0
69369,2,2,243201,243202,243204,1,3,0
69370,1,2,243202,243204,243206,2,4,0
69371,2,2,243204,243206,243208,2,4,0
69372,2,2,243206,243208,243210,2,4,0
69373,1,2,243207,243210,243212,3,5,0
69374,4,1,243211,243212,243213,1,2,0
69375,1,3,243212,243213,243216,1,4,0
69376,3,2,243215,243216,243218,1,3,0
69377,4,3,243219,243219,243222,0,3,1
69378,1,1,243220,243222,243223,2,3,0
69379,1,3,243221,243223,243226,2,5,0
69380,1,3,243222,243226,243229,4,7,0
69381,3,1,243225,243229,243230,4,5,0
69382,4,1,243229,243230,243231,1,2,0
69383,1,1,243230,243231,243232,1,2,0
69384,3,1,243233,243233,243234,0,1,1
69385,3,1,243236,243236,243237,0,1,2
69386,1,1,243237,243237,243238,0,1,0
69387,5,2,243242,243242,243244,0,2,4
69388,3,1,243245,243245,243246,0,1,1
69389,5,3,243250,243250,243253,0,3,4
69390,1,2,243251,243253,243255,2,4,0
69391,5,3,243256,243256,243259,0,3,1
69392,4,1,243260,243260,243261,0,1,1
69393,6,1,243266,243266,243267,0,1,5
69394,6,2,243272,243272,243274,0,2,5
69395,1,2,243273,243274,243276,1,3,0
69396,4,2,243277,243277,243279,0,2,1
69397,3,1,243280,243280,243281,0,1,1
69398,3,2,243283,243283,243285,0,2,2
69399,4,2,243287,243287,243289,0,2,2
69400,2,1,243289,243289,243290,0,1,0
69401,5,1,243294,243294,243295,0,1,4
69402,2,3,243296,243296,243299,0,3,1
69403,4,1,243300,243300,243301,0,1,1
69404,1,1,243301,243301,243302,0,1,0
69405,1,2,243302,243302,243304,0,2,0
69406,2,1,243304,243304,243305,0,1,0
69407,5,1,243309,243309,243310,0,1,4
69408,4,3,243313,243313,243316,0,3,3
69409,6,3,243319,243319,243322,0,3,3
69410,3,3,243322,243322,243325,0,3,0
69411,4,1,243326,243326,243327,0,1,1
69412,1,3,243327,243327,243330,0,3,0
69413,3,2,243330,243330,243332,0,2,0
69414,5,2,243335,243335,243337,0,2,3
69415,6,2,243341,243341,243343,0,2,4
69416,2,1,243343,243343,243344,0,1,0
69417,3,2,243346,243346,243348,0,2,2
69418,1,3,243347,243348,243351,1,4,0
69419,1,2,243348,243351,243353,3,5,0
69420,2,1,243350,243353,243354,3,4,0
69421,4,2,243354,243354,243356,0,2,0
69422,4,2,243358,243358,243360,0,2,2
69423,2,2,243360,243360,243362,0,2,0
69424,1,1,243361,243362,243363,1,2,0
69425,2,1,243363,243363,243364,0,1,0
69426,4,2,243367,243367,243369,0,2,3
69427,1,1,243368,243369,243370,1,2,0
69428,6,3,243374,243374,243377,0,3,4
69429,2,3,243376,243377,243380,1,4,0
69430,1,3,243377,243380,243383,3,6,0
69431,5,2,243382,243383,243385,1,3,0
69432,6,3,243388,243388,243391,0,3,3
69433,4,3,243392,243392,243395,0,3,1
69434,4,3,243396,243396,243399,0,3,1
69435,5,2,243401,243401,243403,0,2,2
69436,6,2,243407,243407,243409,0,2,4
69437,3,2,243410,243410,243412,0,2,1
69438,5,1,243415,243415,243416,0,1,3
69439,5,2,243420,243420,243422,0,2,4
69440,5,1,243425,243425,243426,0,1,3
69441,2,2,243427,243427,243429,0,2,1
69442,3,3,243430,243430,243433,0,3,1
69443,4,1,243434,243434,243435,0,1,1
69444,5,1,243439,243439,243440,0,1,4
69445,4,1,243443,243443,243444,0,1,3
69446,4,3,243447,243447,243450,0,3,3
69447,5,1,243452,243452,243453,0,1,2
69448,5,2,243457,243457,243459,0,2,4
69449,5,3,243462,243462,243465,0,3,3
69450,4,2,243466,243466,243468,0,2,1
69451,1,1,243467,243468,243469,1,2,0
69452,4,3,243471,243471,243474,0,3,2
69453,6,3,243477,243477,243480,0,3,3
69454,5,2,243482,243482,243484,0,2,2
69455,2,1,243484,243484,243485,0,1,0
69456,6,2,243490,243490,243492,0,2,5
69457,1,3,243491,243492,243495,1,4,0
69458,4,3,243495,243495,243498,0,3,0
69459,4,2,243499,243499,243501,0,2,1
69460,4,3,243503,243503,243506,0,3,2
69461,5,2,243508,243508,243510,0,2,2
69462,6,2,243514,243514,243516,0,2,4
69463,2,3,243516,243516,243519,0,3,0
69464,6,2,243522,243522,243524,0,2,3
69465,6,1,243528,243528,243529,0,1,4
69466,2,1,243530,243530,243531,0,1,1
69467,1,2,243531,243531,243533,0,2,0
69468,1,2,243532,243533,243535,1,3,0
69469,1,1,243533,243535,243536,2,3,0
69470,1,1,243534,243536,243537,2,3,0
69471,5,3,243539,243539,243542,0,3,2
69472,3,3,243542,243542,243545,0,3,0
69473,2,3,243544,243545,243548,1,4,0
69474,6,1,243550,243550,243551,0,1,2
69475,6,2,243556,243556,243558,0,2,5
69476,3,3,243559,243559,243562,0,3,1
69477,3,1,243562,243562,243563,0,1,0
69478,6,3,243568,243568,243571,0,3,5
69479,5,2,243573,243573,243575,0,2,2
69480,5,2,243578,243578,243580,0,2,3
69481,2,3,243580,243580,243583,0,3,0
69482,5,2,243585,243585,243587,0,2,2
69483,4,2,243589,243589,243591,0,2,2
69484,6,1,243595,243595,243596,0,1,4
69485,5,3,243600,243600,243603,0,3,4
69486,3,2,243603,243603,243605,0,2,0
69487,2,1,243605,243605,243606,0,1,0
69488,2,3,243607,243607,243610,0,3,1
69489,4,1,243611,243611,243612,0,1,1
69490,6,2,243617,243617,243619,0,2,5
69491,4,1,243621,243621,243622,0,1,2
69492,1,1,243622,243622,243623,0,1,0
69493,1,1,243623,243623,243624,0,1,0
69494,6,1,243629,243629,243630,0,1,5
69495,2,2,243631,243631,243633,0,2,1
69496,5,1,243636,243636,243637,0,1,3
69497,6,2,243642,243642,243644,0,2,5
69498,4,2,243646,243646,243648,0,2,2
69499,3,1,243649,243649,243650,0,1,1
69500,3,3,243652,243652,243655,0,3,2
69501,6,2,243658,243658,243660,0,2,3
69502,1,1,243659,243660,243661,1,2,0
69503,3,3,243662,243662,243665,0,3,1
69504,5,3,243667,243667,243670,0,3,2
69505,3,2,243670,243670,243672,0,2,0
69506,5,2,243675,243675,243677,0,2,3
69507,4,3,243679,243679,243682,0,3,2
69508,2,3,243681,243682,243685,1,4,0
69509,5,3,243686,243686,243689,0,3,1
69510,5,2,243691,243691,243693,0,2,2
69511,1,2,243692,243693,243695,1,3,0
69512,5,3,243697,243697,243700,0,3,2
69513,6,3,243703,243703,243706,0,3,3
69514,5,1,243708,243708,243709,0,1,2
69515,6,2,243714,243714,243716,0,2,5
69516,2,2,243716,243716,243718,0,2,0
69517,3,3,243719,243719,243722,0,3,1
69518,1,2,243720,243722,243724,2,4,0
69519,3,1,243723,243724,243725,1,2,0
69520,1,1,243724,243725,243726,1,2,0
69521,4,3,243728,243728,243731,0,3,2
69522,4,1,243732,243732,243733,0,1,1
69523,6,2,243738,243738,243740,0,2,5
69524,6,1,243744,243744,243745,0,1,4
69525,5,3,243749,243749,243752,0,3,4
69526,3,2,243752,243752,243754,0,2,0
69527,4,1,243756,243756,243757,0,1,2
69528,6,3,243762,243762,243765,0,3,5
69529,1,2,243763,243765,243767,2,4,0
69530,6,1,243769,243769,243770,0,1,2
69531,3,3,243772,243772,243775,0,3,2
69532,4,1,243776,243776,243777,0,1,1
69533,4,3,243780,243780,243783,0,3,3
69534,5,2,243785,243785,243787,0,2,2
69535,3,3,243788,243788,243791,0,3,1
69536,4,3,243792,243792,243795,0,3,1
69537,2,2,243794,243795,243797,1,3,0
69538,3,3,243797,243797,243800,0,3,0
69539,5,3,243802,243802,243805,0,3,2
69540,4,3,243806,243806,243809,0,3,1
69541,2,3,243808,243809,243812,1,4,0
69542,3,3,243811,243812,243815,1,4,0
69543,1,2,243812,243815,243817,3,5,0
69544,1,2,243813,243817,243819,4,6,0
69545,5,2,243818,243819,243821,1,3,0
69546,5,2,243823,243823,243825,0,2,2
69547,5,1,243828,243828,243829,0,1,3
69548,6,1,243834,243834,243835,0,1,5
69549,1,2,243835,243835,243837,0,2,0
69550,3,1,243838,243838,243839,0,1,1
69551,6,1,243844,243844,243845,0,1,5
69552,4,2,243848,243848,243850,0,2,3
69553,6,2,243854,243854,243856,0,2,4
69554,4,1,243858,243858,243859,0,1,2
69555,2,2,243860,243860,243862,0,2,1
69556,2,2,243862,243862,243864,0,2,0
69557,5,1,243867,243867,243868,0,1,3
69558,2,3,243869,243869,243872,0,3,1
69559,1,3,243870,243872,243875,2,5,0
69560,1,1,243871,243875,243876,4,5,0
69561,6,3,243877,243877,243880,0,3,1
69562,5,3,243882,243882,243885,0,3,2
69563,4,3,243886,243886,243889,0,3,1
69564,6,2,243892,243892,243894,0,2,3
69565,4,1,243896,243896,243897,0,1,2
69566,4,3,243900,243900,243903,0,3,3
69567,6,3,243906,243906,243909,0,3,3
69568,1,3,243907,243909,243912,2,5,0
69569,4,2,243911,243912,243914,1,3,0
69570,5,1,243916,243916,243917,0,1,2
69571,6,1,243922,243922,243923,0,1,5
69572,2,3,243924,243924,243927,0,3,1
69573,3,3,243927,243927,243930,0,3,0
69574,3,3,243930,243930,243933,0,3,0
69575,6,1,243936,243936,243937,0,1,3
69576,4,3,243940,243940,243943,0,3,3
69577,1,3,243941,243943,243946,2,5,0
69578,3,2,243944,243946,243948,2,4,0
69579,6,3,243950,243950,243953,0,3,2
69580,4,1,243954,243954,243955,0,1,1
69581,6,3,243960,243960,243963,0,3,5
69582,4,1,243964,243964,243965,0,1,1
69583,1,1,243965,243965,243966,0,1,0
69584,2,2,243967,243967,243969,0,2,1
69585,1,1,243968,243969,243970,1,2,0
69586,5,1,243973,243973,243974,0,1,3
69587,4,2,243977,243977,243979,0,2,3
69588,6,2,243983,243983,243985,0,2,4
69589,4,2,243987,243987,243989,0,2,2
69590,3,1,243990,243990,243991,0,1,1
69591,3,2,243993,243993,243995,0,2,2
69592,4,3,243997,243997,244000,0,3,2
69593,3,1,244000,244000,244001,0,1,0
69594,5,1,244005,244005,244006,0,1,4
69595,5,1,244010,244010,244011,0,1,4
69596,3,3,244013,244013,244016,0,3,2
69597,5,1,244018,244018,244019,0,1,2
69598,3,2,244021,244021,244023,0,2,2
69599,2,2,244023,244023,244025,0,2,0
69600,4,3,244027,244027,244030,0,3,2
69601,3,2,244030,244030,244032,0,2,0
69602,5,2,244035,244035,244037,0,2,3
69603,4,3,244039,244039,244042,0,3,2
69604,5,2,244044,244044,244046,0,2,2
69605,1,3,244045,244046,244049,1,4,0
69606,5,2,244050,244050,244052,0,2,1
69607,4,2,244054,244054,244056,0,2,2
69608,5,2,244059,244059,244061,0,2,3
69609,6,1,244065,244065,244066,0,1,4
69610,1,2,244066,244066,244068,0,2,0
69611,5,3,244071,244071,244074,0,3,3
69612,4,1,244075,244075,244076,0,1,1
69613,1,3,244076,244076,244079,0,3,0
69614,5,3,244081,244081,244084,0,3,2
69615,2,3,244083,244084,244087,1,4,0
69616,6,2,244089,244089,244091,0,2,2
69617,5,1,244094,244094,244095,0,1,3
69618,6,1,244100,244100,244101,0,1,5
69619,3,3,244103,244103,244106,0,3,2
69620,4,2,244107,244107,244109,0,2,1
69621,2,3,244109,244109,244112,0,3,0
69622,4,3,244113,244113,244116,0,3,1
69623,6,3,244119,244119,244122,0,3,3
69624,1,3,244120,244122,244125,2,5,0
69625,4,3,244124,244125,244128,1,4,0
69626,6,1,244130,244130,244131,0,1,2
69627,4,3,244134,244134,244137,0,3,3
69628,6,1,244140,244140,244141,0,1,3
69629,5,2,244145,244145,244147,0,2,4
69630,5,1,244150,244150,244151,0,1,3
69631,5,1,244155,244155,244156,0,1,4
69632,6,2,244161,244161,244163,0,2,5
69633,1,1,244162,244163,244164,1,2,0
69634,4,1,244166,244166,244167,0,1,2
69635,2,3,244168,244168,244171,0,3,1
69636,2,1,244170,244171,244172,1,2,0
69637,3,2,244173,244173,244175,0,2,1
69638,1,1,244174,244175,244176,1,2,0
69639,2,2,244176,244176,244178,0,2,0
69640,1,3,244177,244178,244181,1,4,0
69641,3,3,244180,244181,244184,1,4,0
69642,3,3,244183,244184,244187,1,4,0
69643,4,1,244187,244187,244188,0,1,0
69644,2,3,244189,244189,244192,0,3,1
69645,1,3,244190,244192,244195,2,5,0
69646,3,3,244193,244195,244198,2,5,0
69647,2,2,244195,244198,244200,3,5,0
69648,5,2,244200,244200,244202,0,2,0
69649,6,2,244206,244206,244208,0,2,4
69650,1,1,244207,244208,244209,1,2,0
69651,1,1,244208,244209,244210,1,2,0
69652,2,3,244210,244210,244213,0,3,0
69653,4,3,244214,244214,244217,0,3,1
69654,1,1,244215,244217,244218,2,3,0
69655,3,3,244218,244218,244221,0,3,0
69656,5,1,244223,244223,244224,0,1,2
69657,4,2,244227,244227,244229,0,2,3
69658,2,3,244229,244229,244232,0,3,0
69659,4,2,244233,244233,244235,0,2,1
69660,6,2,244239,244239,244241,0,2,4
69661,3,2,244242,244242,244244,0,2,1
69662,2,2,244244,244244,244246,0,2,0
69663,2,1,244246,244246,244247,0,1,0
69664,3,3,244249,244249,244252,0,3,2
69665,4,1,244253,244253,244254,0,1,1
69666,1,3,244254,244254,244257,0,3,0
69667,4,1,244258,244258,244259,0,1,1
69668,2,2,244260,244260,244262,0,2,1
69669,5,2,244265,244265,244267,0,2,3
69670,3,1,244268,244268,244269,0,1,1
69671,5,1,244273,244273,244274,0,1,4
69672,3,1,244276,244276,244277,0,1,2
69673,2,1,244278,244278,244279,0,1,1
69674,5,2,244283,244283,244285,0,2,4
69675,3,3,244286,244286,244289,0,3,1
69676,4,3,244290,244290,244293,0,3,1
69677,4,3,244294,244294,244297,0,3,1
69678,2,3,244296,244297,244300,1,4,0
69679,4,1,244300,244300,244301,0,1,0
69680,4,3,244304,244304,244307,0,3,3
69681,5,3,244309,244309,244312,0,3,2
69682,5,2,244314,244314,244316,0,2,2
69683,2,1,244316,244316,244317,0,1,0
69684,3,3,244319,244319,244322,0,3,2
69685,4,1,244323,244323,244324,0,1,1
69686,6,1,244329,244329,244330,0,1,5
69687,5,1,244334,244334,244335,0,1,4
69688,6,2,244340,244340,244342,0,2,5
69689,5,3,244345,244345,244348,0,3,3
69690,5,2,244350,244350,244352,0,2,2
69691,4,1,244354,244354,244355,0,1,2
69692,2,3,244356,244356,244359,0,3,1
69693,6,2,244362,244362,244364,0,2,3
69694,1,1,244363,244364,244365,1,2,0
69695,3,1,244366,244366,244367,0,1,1
69696,6,1,244372,244372,244373,0,1,5
69697,3,3,244375,244375,244378,0,3,2
69698,3,1,244378,244378,244379,0,1,0
69699,1,1,244379,244379,244380,0,1,0
69700,3,1,244382,244382,244383,0,1,2
69701,4,2,244386,244386,244388,0,2,3
69702,3,2,244389,244389,244391,0,2,1
69703,5,3,244394,244394,244397,0,3,3
69704,5,1,244399,244399,244400,0,1,2
69705,4,3,244403,244403,244406,0,3,3
69706,5,3,244408,244408,244411,0,3,2
69707,1,3,244409,244411,244414,2,5,0
69708,4,1,244413,244414,244415,1,2,0
69709,4,2,244417,244417,244419,0,2,2
69710,5,3,244422,244422,244425,0,3,3
69711,2,1,244424,244425,244426,1,2,0
69712,6,3,244430,244430,244433,0,3,4
69713,3,3,244433,244433,244436,0,3,0
69714,1,2,244434,244436,244438,2,4,0
69715,6,2,244440,244440,244442,0,2,2
69716,1,3,244441,244442,244445,1,4,0
69717,1,2,244442,244445,244447,3,5,0
69718,4,2,244446,244447,244449,1,3,0
69719,3,3,244449,244449,244452,0,3,0
69720,3,2,244452,244452,244454,0,2,0
69721,5,3,244457,244457,244460,0,3,3
69722,4,3,244461,244461,244464,0,3,1
69723,6,1,244467,244467,244468,0,1,3
69724,3,1,244470,244470,244471,0,1,2
69725,2,1,244472,244472,244473,0,1,1
69726,6,1,244478,244478,244479,0,1,5
69727,6,3,244484,244484,244487,0,3,5
69728,6,2,244490,244490,244492,0,2,3
69729,2,1,244492,244492,244493,0,1,0
69730,6,1,244498,244498,244499,0,1,5
69731,1,1,244499,244499,244500,0,1,0
69732,5,2,244504,244504,244506,0,2,4
69733,1,2,244505,244506,244508,1,3,0
69734,4,2,244509,244509,244511,0,2,1
69735,2,2,244511,244511,244513,0,2,0
69736,1,3,244512,244513,244516,1,4,0
69737,3,3,244515,244516,244519,1,4,0
69738,3,1,244518,244519,244520,1,2,0
69739,6,3,244524,244524,244527,0,3,4
69740,6,1,244530,244530,244531,0,1,3
69741,4,3,244534,244534,244537,0,3,3
69742,3,2,244537,244537,244539,0,2,0
69743,5,1,244542,244542,244543,0,1,3
69744,3,3,244545,244545,244548,0,3,2
69745,6,1,244551,244551,244552,0,1,3
69746,2,2,244553,244553,244555,0,2,1
69747,6,2,244559,244559,244561,0,2,4
69748,2,2,244561,244561,244563,0,2,0
69749,2,3,244563,244563,244566,0,3,0
69750,5,2,244568,244568,244570,0,2,2
69751,1,3,244569,244570,244573,1,4,0
69752,2,2,244571,244573,244575,2,4,0
69753,1,3,244572,244575,244578,3,6,0
69754,6,2,244578,244578,244580,0,2,0
69755,6,1,244584,244584,244585,0,1,4
69756,4,1,244588,244588,244589,0,1,3
69757,3,3,244591,244591,244594,0,3,2
69758,6,3,244597,244597,244600,0,3,3
69759,4,2,244601,244601,244603,0,2,1
69760,3,2,244604,244604,244606,0,2,1
69761,2,2,244606,244606,244608,0,2,0
69762,4,3,244610,244610,244613,0,3,2
69763,6,2,244616,244616,244618,0,2,3
69764,4,3,244620,244620,244623,0,3,2
69765,4,1,244624,244624,244625,0,1,1
69766,5,1,244629,244629,244630,0,1,4
69767,4,2,244633,244633,244635,0,2,3
69768,6,1,244639,244639,244640,0,1,4
69769,3,1,244642,244642,244643,0,1,2
69770,2,3,244644,244644,244647,0,3,1
69771,6,2,244650,244650,244652,0,2,3
69772,5,1,244655,244655,244656,0,1,3
69773,5,1,244660,244660,244661,0,1,4
69774,5,1,244665,244665,244666,0,1,4
69775,3,1,244668,244668,244669,0,1,2
69776,2,3,244670,244670,244673,0,3,1
69777,5,3,244675,244675,244678,0,3,2
69778,6,1,244681,244681,244682,0,1,3
69779,1,3,244682,244682,244685,0,3,0
69780,3,1,244685,244685,244686,0,1,0
69781,6,3,244691,244691,244694,0,3,5
69782,4,3,244695,244695,244698,0,3,1
69783,1,2,244696,244698,244700,2,4,0
69784,3,2,244699,244700,244702,1,3,0
69785,6,3,244705,244705,244708,0,3,3
69786,2,1,244707,244708,244709,1,2,0
69787,6,3,244713,244713,244716,0,3,4
69788,2,2,244715,244716,244718,1,3,0
69789,4,2,244719,244719,244721,0,2,1
69790,4,2,244723,244723,244725,0,2,2
69791,2,1,244725,244725,244726,0,1,0
69792,3,1,244728,244728,244729,0,1,2
69793,5,3,244733,244733,244736,0,3,4
69794,2,3,244735,244736,244739,1,4,0
69795,6,3,244741,244741,244744,0,3,2
69796,3,1,244744,244744,244745,0,1,0
69797,5,3,244749,244749,244752,0,3,4
69798,6,3,244755,244755,244758,0,3,3
69799,3,3,244758,244758,244761,0,3,0
69800,5,3,244763,244763,244766,0,3,2
69801,4,1,244767,244767,244768,0,1,1
69802,3,1,244770,244770,244771,0,1,2
69803,5,2,244775,244775,244777,0,2,4
69804,5,3,244780,244780,244783,0,3,3
69805,5,2,244785,244785,244787,0,2,2
69806,2,2,244787,244787,244789,0,2,0
69807,6,3,244793,244793,244796,0,3,4
69808,1,1,244794,244796,244797,2,3,0
69809,1,1,244795,244797,244798,2,3,0
69810,5,3,244800,244800,244803,0,3,2
69811,3,2,244803,244803,244805,0,2,0
69812,4,3,244807,244807,244810,0,3,2
69813,4,1,244811,244811,244812,0,1,1
69814,1,3,244812,244812,244815,0,3,0
69815,1,1,244813,244815,244816,2,3,0
69816,4,3,244817,244817,244820,0,3,1
69817,4,3,244821,244821,244824,0,3,1
69818,6,1,244827,244827,244828,0,1,3
69819,4,1,244831,244831,244832,0,1,3
69820,3,1,244834,244834,244835,0,1,2
69821,3,3,244837,244837,244840,0,3,2
69822,1,3,244838,244840,244843,2,5,0
69823,5,3,244843,244843,244846,0,3,0
69824,3,3,244846,244846,244849,0,3,0
69825,6,1,244852,244852,244853,0,1,3
69826,5,3,244857,244857,244860,0,3,4
69827,2,3,244859,244860,244863,1,4,0
69828,2,2,244861,244863,244865,2,4,0
69829,2,1,244863,244865,244866,2,3,0
69830,6,3,244869,244869,244872,0,3,3
69831,4,3,244873,244873,244876,0,3,1
69832,1,3,244874,244876,244879,2,5,0
69833,3,1,244877,244879,244880,2,3,0
69834,3,3,244880,244880,244883,0,3,0
69835,5,1,244885,244885,244886,0,1,2
69836,3,2,244888,244888,244890,0,2,2
69837,6,3,244894,244894,244897,0,3,4
69838,2,3,244896,244897,244900,1,4,0
69839,4,1,244900,244900,244901,0,1,0
69840,6,3,244906,244906,244909,0,3,5
69841,6,1,244912,244912,244913,0,1,3
69842,4,2,244916,244916,244918,0,2,3
69843,6,3,244922,244922,244925,0,3,4
69844,1,3,244923,244925,244928,2,5,0
69845,5,2,244928,244928,244930,0,2,0
69846,4,3,244932,244932,244935,0,3,2
69847,3,1,244935,244935,244936,0,1,0
69848,1,1,244936,244936,244937,0,1,0
69849,2,2,244938,244938,244940,0,2,1
69850,1,3,244939,244940,244943,1,4,0
69851,5,3,244944,244944,244947,0,3,1
69852,2,2,244946,244947,244949,1,3,0
69853,5,2,244951,244951,244953,0,2,2
69854,5,3,244956,244956,244959,0,3,3
69855,5,3,244961,244961,244964,0,3,2
69856,1,1,244962,244964,244965,2,3,0
69857,1,3,244963,244965,244968,2,5,0
69858,3,1,244966,244968,244969,2,3,0
69859,3,2,244969,244969,244971,0,2,0
69860,3,3,244972,244972,244975,0,3,1
69861,2,2,244974,244975,244977,1,3,0
69862,5,3,244979,244979,244982,0,3,2
69863,6,2,244985,244985,244987,0,2,3
69864,2,1,244987,244987,244988,0,1,0
69865,2,3,244989,244989,244992,0,3,1
69866,2,1,244991,244992,244993,1,2,0
69867,1,1,244992,244993,244994,1,2,0
69868,3,1,244995,244995,244996,0,1,1
69869,2,1,244997,244997,244998,0,1,1
69870,5,2,245002,245002,245004,0,2,4
69871,6,3,245008,245008,245011,0,3,4
69872,5,3,245013,245013,245016,0,3,2
69873,5,2,245018,245018,245020,0,2,2
69874,3,1,245021,245021,245022,0,1,1
69875,3,3,245024,245024,245027,0,3,2
69876,5,1,245029,245029,245030,0,1,2
69877,1,3,245030,245030,245033,0,3,0
69878,4,2,245034,245034,245036,0,2,1
69879,3,3,245037,245037,245040,0,3,1
69880,4,3,245041,245041,245044,0,3,1
69881,1,2,245042,245044,245046,2,4,0
69882,4,2,245046,245046,245048,0,2,0
69883,2,1,245048,245048,245049,0,1,0
69884,4,2,245052,245052,245054,0,2,3
69885,4,1,245056,245056,245057,0,1,2
69886,2,3,245058,245058,245061,0,3,1
69887,2,2,245060,245061,245063,1,3,0
69888,1,3,245061,245063,245066,2,5,0
69889,3,3,245064,245066,245069,2,5,0
69890,3,2,245067,245069,245071,2,4,0
69891,4,2,245071,245071,245073,0,2,0
69892,3,2,245074,245074,245076,0,2,1
69893,3,2,245077,245077,245079,0,2,1
69894,5,3,245082,245082,245085,0,3,3
69895,4,3,245086,245086,245089,0,3,1
69896,2,3,245088,245089,245092,1,4,0
69897,4,3,245092,245092,245095,0,3,0
69898,4,2,245096,245096,245098,0,2,1
69899,1,3,245097,245098,245101,1,4,0
69900,4,2,245101,245101,245103,0,2,0
69901,2,3,245103,245103,245106,0,3,0
69902,2,1,245105,245106,245107,1,2,0
69903,3,3,245108,245108,245111,0,3,1
69904,1,2,245109,245111,245113,2,4,0
69905,1,3,245110,245113,245116,3,6,0
69906,6,3,245116,245116,245119,0,3,0
69907,6,3,245122,245122,245125,0,3,3
69908,3,3,245125,245125,245128,0,3,0
69909,3,2,245128,245128,245130,0,2,0
69910,4,2,245132,245132,245134,0,2,2
69911,3,1,245135,245135,245136,0,1,1
69912,4,2,245139,245139,245141,0,2,3
69913,4,2,245143,245143,245145,0,2,2
69914,2,3,245145,245145,245148,0,3,0
69915,1,1,245146,245148,245149,2,3,0
69916,5,3,245151,245151,245154,0,3,2
69917,6,2,245157,245157,245159,0,2,3
69918,5,1,245162,245162,245163,0,1,3
69919,5,2,245167,245167,245169,0,2,4
69920,3,1,245170,245170,245171,0,1,1
69921,5,1,245175,245175,245176,0,1,4
69922,5,2,245180,245180,245182,0,2,4
69923,4,3,245184,245184,245187,0,3,2
69924,6,2,245190,245190,245192,0,2,3
69925,5,1,245195,245195,245196,0,1,3
69926,4,2,245199,245199,245201,0,2,3
69927,2,1,245201,245201,245202,0,1,0
69928,1,1,245202,245202,245203,0,1,0
69929,5,2,245207,245207,245209,0,2,4
69930,6,3,245213,245213,245216,0,3,4
69931,2,2,245215,245216,245218,1,3,0
69932,6,3,245221,245221,245224,0,3,3
69933,2,1,245223,245224,245225,1,2,0
69934,6,2,245229,245229,245231,0,2,4
69935,6,2,245235,245235,245237,0,2,4
69936,4,2,245239,245239,245241,0,2,2
69937,1,1,245240,245241,245242,1,2,0
69938,1,3,245241,245242,245245,1,4,0
69939,3,1,245244,245245,245246,1,2,0
69940,5,1,245249,245249,245250,0,1,3
69941,4,2,245253,245253,245255,0,2,3
69942,6,3,245259,245259,245262,0,3,4
69943,3,1,245262,245262,245263,0,1,0
69944,1,1,245263,245263,245264,0,1,0
69945,5,2,245268,245268,245270,0,2,4
69946,3,2,245271,245271,245273,0,2,1
69947,5,3,245276,245276,245279,0,3,3
69948,4,2,245280,245280,245282,0,2,1
69949,6,2,245286,245286,245288,0,2,4
69950,6,1,245292,245292,245293,0,1,4
69951,3,3,245295,245295,245298,0,3,2
69952,2,3,245297,245298,245301,1,4,0
69953,4,1,245301,245301,245302,0,1,0
69954,2,1,245303,245303,245304,0,1,1
69955,5,1,245308,245308,245309,0,1,4
69956,4,2,245312,245312,245314,0,2,3
69957,5,2,245317,245317,245319,0,2,3
69958,5,1,245322,245322,245323,0,1,3
69959,5,3,245327,245327,245330,0,3,4
69960,4,2,245331,245331,245333,0,2,1
69961,3,1,245334,245334,245335,0,1,1
69962,4,3,245338,245338,245341,0,3,3
69963,2,2,245340,245341,245343,1,3,0
69964,2,3,245342,245343,245346,1,4,0
69965,1,1,245343,245346,245347,3,4,0
69966,5,1,245348,245348,245349,0,1,1
69967,5,3,245353,245353,245356,0,3,4
69968,4,1,245357,245357,245358,0,1,1
69969,1,1,245358,245358,245359,0,1,0
69970,2,1,245360,245360,245361,0,1,1
69971,6,1,245366,245366,245367,0,1,5
69972,4,3,245370,245370,245373,0,3,3
69973,5,2,245375,245375,245377,0,2,2
69974,3,2,245378,245378,245380,0,2,1
69975,1,2,245379,245380,245382,1,3,0
69976,1,2,245380,245382,245384,2,4,0
69977,2,3,245382,245384,245387,2,5,0
69978,5,1,245387,245387,245388,0,1,0
69979,4,2,245391,245391,245393,0,2,3
69980,3,3,245394,245394,245397,0,3,1
69981,2,1,245396,245397,245398,1,2,0
69982,4,3,245400,245400,245403,0,3,2
69983,3,2,245403,245403,245405,0,2,0
69984,5,3,245408,245408,245411,0,3,3
69985,4,3,245412,245412,245415,0,3,1
69986,1,3,245413,245415,245418,2,5,0
69987,3,2,245416,245418,245420,2,4,0
69988,5,2,245421,245421,245423,0,2,1
69989,4,3,245425,245425,245428,0,3,2
69990,5,3,245430,245430,245433,0,3,2
69991,6,3,245436,245436,245439,0,3,3
69992,6,3,245442,245442,245445,0,3,3
69993,5,3,245447,245447,245450,0,3,2
69994,4,3,245451,245451,245454,0,3,1
69995,3,1,245454,245454,245455,0,1,0
69996,4,3,245458,245458,245461,0,3,3
69997,5,1,245463,245463,245464,0,1,2
69998,6,2,245469,245469,245471,0,2,5
69999,3,3,245472,245472,245475,0,3,1
70000,6,2,245478,245478,245480,0,2,3
70001,6,3,245484,245484,245487,0,3,4
70002,3,1,245487,245487,245488,0,1,0
70003,2,1,245489,245489,245490,0,1,1
70004,3,1,245492,245492,245493,0,1,2
70005,5,3,245497,245497,245500,0,3,4
70006,3,3,245500,245500,245503,0,3,0
70007,4,2,245504,245504,245506,0,2,1
70008,1,2,245505,245506,245508,1,3,0
70009,2,2,245507,245508,245510,1,3,0
70010,5,2,245512,245512,245514,0,2,2
70011,4,2,245516,245516,245518,0,2,2
70012,2,3,245518,245518,245521,0,3,0
70013,3,2,245521,245521,245523,0,2,0
70014,1,2,245522,245523,245525,1,3,0
70015,6,1,245528,245528,245529,0,1,3
70016,4,2,245532,245532,245534,0,2,3
70017,4,1,245536,245536,245537,0,1,2
70018,1,1,245537,245537,245538,0,1,0
70019,5,1,245542,245542,245543,0,1,4
70020,6,1,245548,245548,245549,0,1,5
70021,6,1,245554,245554,245555,0,1,5
70022,2,2,245556,245556,245558,0,2,1
70023,2,1,245558,245558,245559,0,1,0
70024,1,2,245559,245559,245561,0,2,0
70025,5,3,245564,245564,245567,0,3,3
70026,5,2,245569,245569,245571,0,2,2
70027,5,1,245574,245574,245575,0,1,3
70028,6,3,245580,245580,245583,0,3,5
70029,6,3,245586,245586,245589,0,3,3
70030,6,3,245592,245592,245595,0,3,3
70031,3,2,245595,245595,245597,0,2,0
70032,3,3,245598,245598,245601,0,3,1
70033,3,2,245601,245601,245603,0,2,0
70034,3,1,245604,245604,245605,0,1,1
70035,3,3,245607,245607,245610,0,3,2
70036,2,2,245609,245610,245612,1,3,0
70037,6,1,245615,245615,245616,0,1,3
70038,1,3,245616,245616,245619,0,3,0
70039,5,3,245621,245621,245624,0,3,2
70040,4,1,245625,245625,245626,0,1,1
70041,5,2,245630,245630,245632,0,2,4
70042,1,1,245631,245632,245633,1,2,0
70043,4,3,245635,245635,245638,0,3,2
70044,2,2,245637,245638,245640,1,3,0
70045,6,3,245643,245643,245646,0,3,3
70046,4,1,245647,245647,245648,0,1,1
70047,3,2,245650,245650,245652,0,2,2
70048,5,2,245655,245655,245657,0,2,3
70049,5,1,245660,245660,245661,0,1,3
70050,5,2,245665,245665,245667,0,2,4
70051,5,3,245670,245670,245673,0,3,3
70052,6,1,245676,245676,245677,0,1,3
70053,1,2,245677,245677,245679,0,2,0
70054,6,1,245683,245683,245684,0,1,4
70055,4,1,245687,245687,245688,0,1,3
70056,1,3,245688,245688,245691,0,3,0
70057,2,3,245690,245691,245694,1,4,0
70058,1,2,245691,245694,245696,3,5,0
70059,5,2,245696,245696,245698,0,2,0
70060,4,2,245700,245700,245702,0,2,2
70061,5,3,245705,245705,245708,0,3,3
70062,4,2,245709,245709,245711,0,2,1
70063,1,1,245710,245711,245712,1,2,0
70064,2,2,245712,245712,245714,0,2,0
70065,4,3,245716,245716,245719,0,3,2
70066,1,2,245717,245719,245721,2,4,0
70067,2,2,245719,245721,245723,2,4,0
70068,2,3,245721,245723,245726,2,5,0
70069,4,3,245725,245726,245729,1,4,0
70070,5,1,245730,245730,245731,0,1,1
70071,3,1,245733,245733,245734,0,1,2
70072,2,2,245735,245735,245737,0,2,1
70073,6,3,245741,245741,245744,0,3,4
70074,1,1,245742,245744,245745,2,3,0
70075,5,3,245747,245747,245750,0,3,2
70076,2,3,245749,245750,245753,1,4,0
70077,5,3,245754,245754,245757,0,3,1
70078,4,2,245758,245758,245760,0,2,1
70079,5,1,245763,245763,245764,0,1,3
70080,3,3,245766,245766,245769,0,3,2
70081,1,1,245767,245769,245770,2,3,0
70082,1,1,245768,245770,245771,2,3,0
70083,3,1,245771,245771,245772,0,1,0
70084,6,2,245777,245777,245779,0,2,5
70085,6,1,245783,245783,245784,0,1,4
70086,6,1,245789,245789,245790,0,1,5
70087,2,2,245791,245791,245793,0,2,1
70088,3,1,245794,245794,245795,0,1,1
70089,2,3,245796,245796,245799,0,3,1
70090,4,3,245800,245800,245803,0,3,1
70091,4,3,245804,245804,245807,0,3,1
70092,6,2,245810,245810,245812,0,2,3
70093,1,1,245811,245812,245813,1,2,0
70094,3,3,245814,245814,245817,0,3,1
70095,6,3,245820,245820,245823,0,3,3
70096,5,1,245825,245825,245826,0,1,2
70097,6,2,245831,245831,245833,0,2,5
70098,1,3,245832,245833,245836,1,4,0
70099,6,2,245838,245838,245840,0,2,2
70100,2,3,245840,245840,245843,0,3,0
70101,5,1,245845,245845,245846,0,1,2
70102,3,2,245848,245848,245850,0,2,2
70103,4,1,245852,245852,245853,0,1,2
70104,1,1,245853,245853,245854,0,1,0
70105,3,2,245856,245856,245858,0,2,2
70106,4,1,245860,245860,245861,0,1,2
70107,2,3,245862,245862,245865,0,3,1
70108,4,2,245866,245866,245868,0,2,1
70109,6,1,245872,245872,245873,0,1,4
70110,2,2,245874,245874,245876,0,2,1
70111,2,1,245876,245876,245877,0,1,0
70112,1,2,245877,245877,245879,0,2,0
70113,3,1,245880,245880,245881,0,1,1
70114,1,2,245881,245881,245883,0,2,0
70115,2,3,245883,245883,245886,0,3,0
70116,4,2,245887,245887,245889,0,2,1
70117,3,3,245890,245890,245893,0,3,1
70118,4,3,245894,245894,245897,0,3,1
70119,5,3,245899,245899,245902,0,3,2
70120,1,2,245900,245902,245904,2,4,0
70121,1,1,245901,245904,245905,3,4,0
70122,5,3,245906,245906,245909,0,3,1
70123,6,3,245912,245912,245915,0,3,3
70124,5,1,245917,245917,245918,0,1,2
70125,6,2,245923,245923,245925,0,2,5
70126,3,3,245926,245926,245929,0,3,1
70127,3,3,245929,245929,245932,0,3,0
70128,4,2,245933,245933,245935,0,2,1
70129,1,2,245934,245935,245937,1,3,0
70130,3,1,245937,245937,245938,0,1,0
70131,4,2,245941,245941,245943,0,2,3
70132,4,2,245945,245945,245947,0,2,2
70133,6,3,245951,245951,245954,0,3,4
70134,2,2,245953,245954,245956,1,3,0
70135,1,1,245954,245956,245957,2,3,0
70136,1,2,245955,245957,245959,2,4,0
70137,5,1,245960,245960,245961,0,1,1
70138,5,1,245965,245965,245966,0,1,4
70139,2,1,245967,245967,245968,0,1,1
70140,6,3,245973,245973,245976,0,3,5
70141,2,1,245975,245976,245977,1,2,0
70142,5,1,245980,245980,245981,0,1,3
70143,3,2,245983,245983,245985,0,2,2
70144,3,3,245986,245986,245989,0,3,1
70145,3,3,245989,245989,245992,0,3,0
70146,3,3,245992,245992,245995,0,3,0
70147,5,2,245997,245997,245999,0,2,2
70148,1,1,245998,245999,246000,1,2,0
70149,1,1,245999,246000,246001,1,2,0
70150,4,3,246003,246003,246006,0,3,2
70151,2,3,246005,246006,246009,1,4,0
70152,5,1,246010,246010,246011,0,1,1
70153,3,1,246013,246013,246014,0,1,2
70154,3,1,246016,246016,246017,0,1,2
70155,6,2,246022,246022,246024,0,2,5
70156,1,2,246023,246024,246026,1,3,0
70157,4,3,246027,246027,246030,0,3,1
70158,3,2,246030,246030,246032,0,2,0
70159,2,2,246032,246032,246034,0,2,0
70160,4,2,246036,246036,246038,0,2,2
70161,1,1,246037,246038,246039,1,2,0
70162,2,1,246039,246039,246040,0,1,0
70163,4,3,246043,246043,246046,0,3,3
70164,1,1,246044,246046,246047,2,3,0
70165,3,2,246047,246047,246049,0,2,0
70166,2,3,246049,246049,246052,0,3,0
70167,4,3,246053,246053,246056,0,3,1
70168,6,2,246059,246059,246061,0,2,3
70169,1,2,246060,246061,246063,1,3,0
70170,2,1,246062,246063,246064,1,2,0
70171,6,2,246068,246068,246070,0,2,4
70172,5,1,246073,246073,246074,0,1,3
70173,6,1,246079,246079,246080,0,1,5
70174,5,3,246084,246084,246087,0,3,4
70175,6,2,246090,246090,246092,0,2,3
70176,2,2,246092,246092,246094,0,2,0
70177,5,1,246097,246097,246098,0,1,3
70178,5,2,246102,246102,246104,0,2,4
70179,4,3,246106,246106,246109,0,3,2
70180,6,3,246112,246112,246115,0,3,3
70181,6,1,246118,246118,246119,0,1,3
70182,4,3,246122,246122,246125,0,3,3
70183,1,2,246123,246125,246127,2,4,0
70184,1,3,246124,246127,246130,3,6,0
70185,4,1,246128,246130,246131,2,3,0
70186,3,1,246131,246131,246132,0,1,0
70187,2,1,246133,246133,246134,0,1,1
70188,6,2,246139,246139,246141,0,2,5
70189,1,3,246140,246141,246144,1,4,0
70190,4,1,246144,246144,246145,0,1,0
70191,3,3,246147,246147,246150,0,3,2
70192,5,1,246152,246152,246153,0,1,2
70193,3,2,246155,246155,246157,0,2,2
70194,5,3,246160,246160,246163,0,3,3
70195,6,2,246166,246166,246168,0,2,3
70196,3,1,246169,246169,246170,0,1,1
70197,6,3,246175,246175,246178,0,3,5
70198,2,2,246177,246178,246180,1,3,0
70199,2,2,246179,246180,246182,1,3,0
70200,4,3,246183,246183,246186,0,3,1
70201,4,1,246187,246187,246188,0,1,1
70202,1,3,246188,246188,246191,0,3,0
70203,1,3,246189,246191,246194,2,5,0
70204,5,3,246194,246194,246197,0,3,0
70205,3,3,246197,246197,246200,0,3,0
70206,3,1,246200,246200,246201,0,1,0
70207,3,1,246203,246203,246204,0,1,2
70208,4,3,246207,246207,246210,0,3,3
70209,4,3,246211,246211,246214,0,3,1
70210,5,1,246216,246216,246217,0,1,2
70211,4,1,246220,246220,246221,0,1,3
70212,6,2,246226,246226,246228,0,2,5
70213,6,1,246232,246232,246233,0,1,4
70214,5,3,246237,246237,246240,0,3,4
70215,3,1,246240,246240,246241,0,1,0
70216,4,3,246244,246244,246247,0,3,3
70217,6,3,246250,246250,246253,0,3,3
70218,4,2,246254,246254,246256,0,2,1
70219,6,1,246260,246260,246261,0,1,4
70220,2,1,246262,246262,246263,0,1,1
70221,5,2,246267,246267,246269,0,2,4
70222,4,3,246271,246271,246274,0,3,2
70223,1,3,246272,246274,246277,2,5,0
70224,5,2,246277,246277,246279,0,2,0
70225,1,3,246278,246279,246282,1,4,0
70226,4,2,246282,246282,246284,0,2,0
70227,2,2,246284,246284,246286,0,2,0
70228,4,3,246288,246288,246291,0,3,2
70229,1,2,246289,246291,246293,2,4,0
70230,5,1,246294,246294,246295,0,1,1
70231,2,3,246296,246296,246299,0,3,1
70232,5,2,246301,246301,246303,0,2,2
70233,6,1,246307,246307,246308,0,1,4
70234,4,1,246311,246311,246312,0,1,3
70235,2,1,246313,246313,246314,0,1,1
70236,1,3,246314,246314,246317,0,3,0
70237,2,1,246316,246317,246318,1,2,0
70238,1,3,246317,246318,246321,1,4,0
70239,3,3,246320,246321,246324,1,4,0
70240,3,2,246323,246324,246326,1,3,0
70241,5,3,246328,246328,246331,0,3,2
70242,2,3,246330,246331,246334,1,4,0
70243,3,3,246333,246334,246337,1,4,0
70244,4,2,246337,246337,246339,0,2,0
70245,5,1,246342,246342,246343,0,1,3
70246,5,2,246347,246347,246349,0,2,4
70247,1,1,246348,246349,246350,1,2,0
70248,6,1,246354,246354,246355,0,1,4
70249,1,2,246355,246355,246357,0,2,0
70250,1,3,246356,246357,246360,1,4,0
70251,4,3,246360,246360,246363,0,3,0
70252,1,1,246361,246363,246364,2,3,0
70253,3,1,246364,246364,246365,0,1,0
70254,1,1,246365,246365,246366,0,1,0
70255,4,3,246369,246369,246372,0,3,3
70256,1,2,246370,246372,246374,2,4,0
70257,2,2,246372,246374,246376,2,4,0
70258,6,2,246378,246378,246380,0,2,2
70259,4,2,246382,246382,246384,0,2,2
70260,4,2,246386,246386,246388,0,2,2
70261,2,2,246388,246388,246390,0,2,0
70262,2,3,246390,246390,246393,0,3,0
70263,4,3,246394,246394,246397,0,3,1
70264,3,1,246397,246397,246398,0,1,0
70265,1,1,246398,246398,246399,0,1,0
70266,2,2,246400,246400,246402,0,2,1
70267,5,2,246405,246405,246407,0,2,3
70268,4,3,246409,246409,246412,0,3,2
70269,1,3,246410,246412,246415,2,5,0
70270,6,3,246416,246416,246419,0,3,1
70271,1,2,246417,246419,246421,2,4,0
70272,4,1,246421,246421,246422,0,1,0
70273,2,1,246423,246423,246424,0,1,1
70274,2,3,246425,246425,246428,0,3,1
70275,3,1,246428,246428,246429,0,1,0
70276,6,1,246434,246434,246435,0,1,5
70277,5,2,246439,246439,246441,0,2,4
70278,6,1,246445,246445,246446,0,1,4
70279,1,2,246446,246446,246448,0,2,0
70280,3,1,246449,246449,246450,0,1,1
70281,4,3,246453,246453,246456,0,3,3
70282,5,2,246458,246458,246460,0,2,2
70283,3,2,246461,246461,246463,0,2,1
70284,5,1,246466,246466,246467,0,1,3
70285,6,3,246472,246472,246475,0,3,5
70286,3,3,246475,246475,246478,0,3,0
70287,5,1,246480,246480,246481,0,1,2
70288,2,3,246482,246482,246485,0,3,1
70289,4,1,246486,246486,246487,0,1,1
70290,6,3,246492,246492,246495,0,3,5
70291,3,2,246495,246495,246497,0,2,0
70292,5,2,246500,246500,246502,0,2,3
70293,4,2,246504,246504,246506,0,2,2
70294,3,2,246507,246507,246509,0,2,1
70295,1,3,246508,246509,246512,1,4,0
70296,1,3,246509,246512,246515,3,6,0
70297,5,1,246514,246515,246516,1,2,0
70298,1,1,246515,246516,246517,1,2,0
70299,3,2,246518,246518,246520,0,2,1
70300,1,2,246519,246520,246522,1,3,0
70301,1,1,246520,246522,246523,2,3,0
70302,6,1,246526,246526,246527,0,1,3
70303,3,2,246529,246529,246531,0,2,2
70304,5,2,246534,246534,246536,0,2,3
70305,4,3,246538,246538,246541,0,3,2
70306,1,3,246539,246541,246544,2,5,0
70307,6,1,246545,246545,246546,0,1,1
70308,5,1,246550,246550,246551,0,1,4
70309,5,3,246555,246555,246558,0,3,4
70310,4,1,246559,246559,246560,0,1,1
70311,2,1,246561,246561,246562,0,1,1
70312,4,3,246565,246565,246568,0,3,3
70313,3,3,246568,246568,246571,0,3,0
70314,1,1,246569,246571,246572,2,3,0
70315,2,1,246571,246572,246573,1,2,0
70316,3,3,246574,246574,246577,0,3,1
70317,5,1,246579,246579,246580,0,1,2
70318,6,1,246585,246585,246586,0,1,5
70319,2,1,246587,246587,246588,0,1,1
70320,1,2,246588,246588,246590,0,2,0
70321,1,1,246589,246590,246591,1,2,0
70322,2,1,246591,246591,246592,0,1,0
70323,5,3,246596,246596,246599,0,3,4
70324,6,2,246602,246602,246604,0,2,3
70325,3,2,246605,246605,246607,0,2,1
70326,5,2,246610,246610,246612,0,2,3
70327,5,3,246615,246615,246618,0,3,3
70328,4,2,246619,246619,246621,0,2,1
70329,2,3,246621,246621,246624,0,3,0
70330,5,3,246626,246626,246629,0,3,2
70331,4,3,246630,246630,246633,0,3,1
70332,4,2,246634,246634,246636,0,2,1
70333,5,3,246639,246639,246642,0,3,3
70334,3,3,246642,246642,246645,0,3,0
70335,5,1,246647,246647,246648,0,1,2
70336,1,3,246648,246648,246651,0,3,0
70337,4,3,246652,246652,246655,0,3,1
70338,3,3,246655,246655,246658,0,3,0
70339,6,2,246661,246661,246663,0,2,3
70340,5,3,246666,246666,246669,0,3,3
70341,1,2,246667,246669,246671,2,4,0
70342,1,2,246668,246671,246673,3,5,0
70343,5,3,246673,246673,246676,0,3,0
70344,6,2,246679,246679,246681,0,2,3
70345,1,3,246680,246681,246684,1,4,0
70346,4,1,246684,246684,246685,0,1,0
70347,5,2,246689,246689,246691,0,2,4
70348,2,1,246691,246691,246692,0,1,0
70349,3,2,246694,246694,246696,0,2,2
70350,3,1,246697,246697,246698,0,1,1
70351,2,1,246699,246699,246700,0,1,1
70352,5,2,246704,246704,246706,0,2,4
70353,3,2,246707,246707,246709,0,2,1
70354,4,1,246711,246711,246712,0,1,2
70355,2,2,246713,246713,246715,0,2,1
70356,6,3,246719,246719,246722,0,3,4
70357,5,2,246724,246724,246726,0,2,2
70358,6,3,246730,246730,246733,0,3,4
70359,1,1,246731,246733,246734,2,3,0
70360,5,1,246736,246736,246737,0,1,2
70361,5,1,246741,246741,246742,0,1,4
70362,6,3,246747,246747,246750,0,3,5
70363,6,1,246753,246753,246754,0,1,3
70364,2,2,246755,246755,246757,0,2,1
70365,4,3,246759,246759,246762,0,3,2
70366,5,2,246764,246764,246766,0,2,2
70367,6,2,246770,246770,246772,0,2,4
70368,5,2,246775,246775,246777,0,2,3
70369,5,3,246780,246780,246783,0,3,3
70370,1,1,246781,246783,246784,2,3,0
70371,3,2,246784,246784,246786,0,2,0
70372,2,1,246786,246786,246787,0,1,0
70373,3,3,246789,246789,246792,0,3,2
70374,2,3,246791,246792,246795,1,4,0
70375,6,3,246797,246797,246800,0,3,2
70376,5,1,246802,246802,246803,0,1,2
70377,6,1,246808,246808,246809,0,1,5
70378,4,1,246812,246812,246813,0,1,3
70379,1,3,246813,246813,246816,0,3,0
70380,5,2,246818,246818,246820,0,2,2
70381,4,3,246822,246822,246825,0,3,2
70382,6,2,246828,246828,246830,0,2,3
70383,6,1,246834,246834,246835,0,1,4
70384,5,1,246839,246839,246840,0,1,4
70385,5,1,246844,246844,246845,0,1,4
70386,3,2,246847,246847,246849,0,2,2
70387,2,1,246849,246849,246850,0,1,0
70388,1,2,246850,246850,246852,0,2,0
70389,6,3,246856,246856,246859,0,3,4
70390,4,3,246860,246860,246863,0,3,1
70391,5,3,246865,246865,246868,0,3,2
70392,3,2,246868,246868,246870,0,2,0
70393,5,1,246873,246873,246874,0,1,3
70394,2,3,246875,246875,246878,0,3,1
70395,5,2,246880,246880,246882,0,2,2
70396,4,2,246884,246884,246886,0,2,2
70397,1,3,246885,246886,246889,1,4,0
70398,1,2,246886,246889,246891,3,5,0
70399,3,2,246889,246891,246893,2,4,0
70400,6,2,246895,246895,246897,0,2,2
70401,6,1,246901,246901,246902,0,1,4
70402,2,2,246903,246903,246905,0,2,1
70403,5,2,246908,246908,246910,0,2,3
70404,3,3,246911,246911,246914,0,3,1
70405,2,1,246913,246914,246915,1,2,0
70406,5,3,246918,246918,246921,0,3,3
70407,6,3,246924,246924,246927,0,3,3
70408,1,2,246925,246927,246929,2,4,0
70409,6,1,246931,246931,246932,0,1,2
70410,4,3,246935,246935,246938,0,3,3
70411,4,1,246939,246939,246940,0,1,1
70412,2,1,246941,246941,246942,0,1,1
70413,3,3,246944,246944,246947,0,3,2
70414,2,1,246946,246947,246948,1,2,0
70415,3,1,246949,246949,246950,0,1,1
70416,2,2,246951,246951,246953,0,2,1
70417,1,3,246952,246953,246956,1,4,0
70418,5,3,246957,246957,246960,0,3,1
70419,4,1,246961,246961,246962,0,1,1
70420,4,2,246965,246965,246967,0,2,3
70421,6,2,246971,246971,246973,0,2,4
70422,4,1,246975,246975,246976,0,1,2
70423,5,3,246980,246980,246983,0,3,4
70424,2,3,246982,246983,246986,1,4,0
70425,4,2,246986,246986,246988,0,2,0
70426,5,3,246991,246991,246994,0,3,3
70427,2,1,246993,246994,246995,1,2,0
70428,6,3,246999,246999,247002,0,3,4
70429,6,3,247005,247005,247008,0,3,3
70430,4,2,247009,247009,247011,0,2,1
70431,4,1,247013,247013,247014,0,1,2
70432,6,2,247019,247019,247021,0,2,5
70433,4,1,247023,247023,247024,0,1,2
70434,4,1,247027,247027,247028,0,1,3
70435,2,3,247029,247029,247032,0,3,1
70436,5,2,247034,247034,247036,0,2,2
70437,6,1,247040,247040,247041,0,1,4
70438,6,2,247046,247046,247048,0,2,5
70439,3,2,247049,247049,247051,0,2,1
70440,6,2,247055,247055,247057,0,2,4
70441,2,1,247057,247057,247058,0,1,0
70442,2,3,247059,247059,247062,0,3,1
70443,2,2,247061,247062,247064,1,3,0
70444,1,2,247062,247064,247066,2,4,0
70445,6,1,247068,247068,247069,0,1,2
70446,4,3,247072,247072,247075,0,3,3
70447,1,3,247073,247075,247078,2,5,0
70448,1,1,247074,247078,247079,4,5,0
70449,2,2,247076,247079,247081,3,5,0
70450,1,3,247077,247081,247084,4,7,0
70451,5,2,247082,247084,247086,2,4,0
70452,2,1,247084,247086,247087,2,3,0
70453,3,2,247087,247087,247089,0,2,0
70454,5,2,247092,247092,247094,0,2,3
70455,1,3,247093,247094,247097,1,4,0
70456,1,3,247094,247097,247100,3,6,0
70457,5,3,247099,247100,247103,1,4,0
70458,5,3,247104,247104,247107,0,3,1
70459,1,2,247105,247107,247109,2,4,0
70460,5,3,247110,247110,247113,0,3,1
70461,2,1,247112,247113,247114,1,2,0
70462,3,3,247115,247115,247118,0,3,1
70463,2,1,247117,247118,247119,1,2,0
70464,3,2,247120,247120,247122,0,2,1
70465,6,3,247126,247126,247129,0,3,4
70466,1,2,247127,247129,247131,2,4,0
70467,4,3,247131,247131,247134,0,3,0
70468,3,1,247134,247134,247135,0,1,0
70469,3,2,247137,247137,247139,0,2,2
70470,6,3,247143,247143,247146,0,3,4
70471,2,1,247145,247146,247147,1,2,0
70472,6,3,247151,247151,247154,0,3,4
70473,3,2,247154,247154,247156,0,2,0
70474,2,2,247156,247156,247158,0,2,0
70475,5,3,247161,247161,247164,0,3,3
70476,4,2,247165,247165,247167,0,2,1
70477,5,2,247170,247170,247172,0,2,3
70478,2,1,247172,247172,247173,0,1,0
70479,1,3,247173,247173,247176,0,3,0
70480,5,3,247178,247178,247181,0,3,2
70481,2,2,247180,247181,247183,1,3,0
70482,4,1,247184,247184,247185,0,1,1
70483,4,1,247188,247188,247189,0,1,3
70484,3,2,247191,247191,247193,0,2,2
70485,1,1,247192,247193,247194,1,2,0
70486,2,1,247194,247194,247195,0,1,0
70487,5,2,247199,247199,247201,0,2,4
70488,5,3,247204,247204,247207,0,3,3
70489,3,3,247207,247207,247210,0,3,0
70490,6,2,247213,247213,247215,0,2,3
70491,1,2,247214,247215,247217,1,3,0
70492,2,3,247216,247217,247220,1,4,0
70493,3,3,247219,247220,247223,1,4,0
70494,1,3,247220,247223,247226,3,6,0
70495,5,1,247225,247226,247227,1,2,0
70496,4,2,247229,247229,247231,0,2,2
70497,1,1,247230,247231,247232,1,2,0
70498,6,2,247236,247236,247238,0,2,4
70499,3,3,247239,247239,247242,0,3,1
70500,2,2,247241,247242,247244,1,3,0
70501,6,1,247247,247247,247248,0,1,3
70502,1,2,247248,247248,247250,0,2,0
70503,3,2,247251,247251,247253,0,2,1
70504,4,3,247255,247255,247258,0,3,2
70505,5,3,247260,247260,247263,0,3,2
70506,5,3,247265,247265,247268,0,3,2
70507,5,3,247270,247270,247273,0,3,2
70508,3,2,247273,247273,247275,0,2,0
70509,5,3,247278,247278,247281,0,3,3
70510,2,2,247280,247281,247283,1,3,0
70511,4,2,247284,247284,247286,0,2,1
70512,4,2,247288,247288,247290,0,2,2
70513,1,1,247289,247290,247291,1,2,0
70514,2,3,247291,247291,247294,0,3,0
70515,1,1,247292,247294,247295,2,3,0
70516,1,2,247293,247295,247297,2,4,0
70517,3,3,247296,247297,247300,1,4,0
70518,4,3,247300,247300,247303,0,3,0
70519,1,1,247301,247303,247304,2,3,0
70520,2,1,247303,247304,247305,1,2,0
70521,2,2,247305,247305,247307,0,2,0
70522,4,1,247309,247309,247310,0,1,2
70523,5,1,247314,247314,247315,0,1,4
70524,1,2,247315,247315,247317,0,2,0
70525,1,3,247316,247317,247320,1,4,0
70526,1,1,247317,247320,247321,3,4,0
70527,4,1,247321,247321,247322,0,1,0
70528,2,1,247323,247323,247324,0,1,1
70529,1,2,247324,247324,247326,0,2,0
70530,5,1,247329,247329,247330,0,1,3
70531,5,2,247334,247334,247336,0,2,4
70532,2,2,247336,247336,247338,0,2,0
70533,4,1,247340,247340,247341,0,1,2
70534,6,2,247346,247346,247348,0,2,5
70535,5,2,247351,247351,247353,0,2,3
70536,3,1,247354,247354,247355,0,1,1
70537,5,1,247359,247359,247360,0,1,4
70538,2,3,247361,247361,247364,0,3,1
70539,1,1,247362,247364,247365,2,3,0
70540,6,1,247368,247368,247369,0,1,3
70541,5,1,247373,247373,247374,0,1,4
70542,5,3,247378,247378,247381,0,3,4
70543,1,2,247379,247381,247383,2,4,0
70544,2,2,247381,247383,247385,2,4,0
70545,4,1,247385,247385,247386,0,1,0
70546,6,2,247391,247391,247393,0,2,5
70547,4,3,247395,247395,247398,0,3,2
70548,3,3,247398,247398,247401,0,3,0
70549,2,3,247400,247401,247404,1,4,0
70550,1,2,247401,247404,247406,3,5,0
70551,1,2,247402,247406,247408,4,6,0
70552,3,3,247405,247408,247411,3,6,0
70553,2,1,247407,247411,247412,4,5,0
70554,4,1,247411,247412,247413,1,2,0
70555,4,3,247415,247415,247418,0,3,2
70556,2,3,247417,247418,247421,1,4,0
70557,1,1,247418,247421,247422,3,4,0
70558,2,3,247420,247422,247425,2,5,0
70559,4,1,247424,247425,247426,1,2,0
70560,2,2,247426,247426,247428,0,2,0
70561,3,2,247429,247429,247431,0,2,1
70562,3,2,247432,247432,247434,0,2,1
70563,6,2,247438,247438,247440,0,2,4
70564,3,3,247441,247441,247444,0,3,1
70565,3,2,247444,247444,247446,0,2,0
70566,5,1,247449,247449,247450,0,1,3
70567,3,3,247452,247452,247455,0,3,2
70568,1,3,247453,247455,247458,2,5,0
70569,1,3,247454,247458,247461,4,7,0
70570,5,1,247459,247461,247462,2,3,0
70571,6,3,247465,247465,247468,0,3,3
70572,1,1,247466,247468,247469,2,3,0
70573,5,2,247471,247471,247473,0,2,2
70574,1,2,247472,247473,247475,1,3,0
70575,3,2,247475,247475,247477,0,2,0
70576,1,2,247476,247477,247479,1,3,0
70577,4,2,247480,247480,247482,0,2,1
70578,6,2,247486,247486,247488,0,2,4
70579,4,3,247490,247490,247493,0,3,2
70580,2,2,247492,247493,247495,1,3,0
70581,1,2,247493,247495,247497,2,4,0
70582,1,3,247494,247497,247500,3,6,0
70583,5,3,247499,247500,247503,1,4,0
70584,2,3,247501,247503,247506,2,5,0
70585,6,1,247507,247507,247508,0,1,1
70586,3,3,247510,247510,247513,0,3,2
70587,6,1,247516,247516,247517,0,1,3
70588,5,2,247521,247521,247523,0,2,4
70589,4,1,247525,247525,247526,0,1,2
70590,2,2,247527,247527,247529,0,2,1
70591,1,2,247528,247529,247531,1,3,0
70592,6,2,247534,247534,247536,0,2,3
70593,3,1,247537,247537,247538,0,1,1
70594,2,2,247539,247539,247541,0,2,1
70595,4,3,247543,247543,247546,0,3,2
70596,3,1,247546,247546,247547,0,1,0
70597,6,3,247552,247552,247555,0,3,5
70598,2,2,247554,247555,247557,1,3,0
70599,3,3,247557,247557,247560,0,3,0
70600,2,1,247559,247560,247561,1,2,0
70601,5,1,247564,247564,247565,0,1,3
70602,5,3,247569,247569,247572,0,3,4
70603,2,3,247571,247572,247575,1,4,0
70604,2,1,247573,247575,247576,2,3,0
70605,2,1,247575,247576,247577,1,2,0
70606,5,1,247580,247580,247581,0,1,3
70607,3,1,247583,247583,247584,0,1,2
70608,3,3,247586,247586,247589,0,3,2
70609,1,3,247587,247589,247592,2,5,0
70610,4,2,247591,247592,247594,1,3,0
70611,4,1,247595,247595,247596,0,1,1
70612,4,2,247599,247599,247601,0,2,3
70613,5,3,247604,247604,247607,0,3,3
70614,3,1,247607,247607,247608,0,1,0
70615,5,2,247612,247612,247614,0,2,4
70616,6,3,247618,247618,247621,0,3,4
70617,3,2,247621,247621,247623,0,2,0
70618,6,3,247627,247627,247630,0,3,4
70619,3,2,247630,247630,247632,0,2,0
70620,2,3,247632,247632,247635,0,3,0
70621,6,2,247638,247638,247640,0,2,3
70622,5,3,247643,247643,247646,0,3,3
70623,1,3,247644,247646,247649,2,5,0
70624,6,2,247650,247650,247652,0,2,1
70625,1,2,247651,247652,247654,1,3,0
70626,3,2,247654,247654,247656,0,2,0
70627,3,3,247657,247657,247660,0,3,1
70628,6,2,247663,247663,247665,0,2,3
70629,4,1,247667,247667,247668,0,1,2
70630,6,1,247673,247673,247674,0,1,5
70631,2,2,247675,247675,247677,0,2,1
70632,3,3,247678,247678,247681,0,3,1
70633,2,2,247680,247681,247683,1,3,0
70634,5,2,247685,247685,247687,0,2,2
70635,2,3,247687,247687,247690,0,3,0
70636,2,2,247689,247690,247692,1,3,0
70637,2,3,247691,247692,247695,1,4,0
70638,6,1,247697,247697,247698,0,1,2
70639,2,2,247699,247699,247701,0,2,1
70640,2,1,247701,247701,247702,0,1,0
70641,3,3,247704,247704,247707,0,3,2
70642,1,2,247705,247707,247709,2,4,0
70643,4,3,247709,247709,247712,0,3,0
70644,6,3,247715,247715,247718,0,3,3
70645,3,3,247718,247718,247721,0,3,0
70646,1,2,247719,247721,247723,2,4,0
70647,5,2,247724,247724,247726,0,2,1
70648,5,2,247729,247729,247731,0,2,3
70649,5,2,247734,247734,247736,0,2,3
70650,6,1,247740,247740,247741,0,1,4
70651,3,3,247743,247743,247746,0,3,2
70652,6,2,247749,247749,247751,0,2,3
70653,2,3,247751,247751,247754,0,3,0
70654,5,1,247756,247756,247757,0,1,2
70655,6,2,247762,247762,247764,0,2,5
70656,6,2,247768,247768,247770,0,2,4
70657,1,2,247769,247770,247772,1,3,0
70658,1,2,247770,247772,247774,2,4,0
70659,5,1,247775,247775,247776,0,1,1
70660,3,2,247778,247778,247780,0,2,2
70661,4,1,247782,247782,247783,0,1,2
70662,4,1,247786,247786,247787,0,1,3
70663,1,3,247787,247787,247790,0,3,0
70664,5,2,247792,247792,247794,0,2,2
70665,5,3,247797,247797,247800,0,3,3
70666,6,2,247803,247803,247805,0,2,3
70667,2,1,247805,247805,247806,0,1,0
70668,4,1,247809,247809,247810,0,1,3
70669,3,1,247812,247812,247813,0,1,2
70670,4,2,247816,247816,247818,0,2,3
70671,4,3,247820,247820,247823,0,3,2
70672,2,3,247822,247823,247826,1,4,0
70673,6,1,247828,247828,247829,0,1,2
70674,4,1,247832,247832,247833,0,1,3
70675,5,1,247837,247837,247838,0,1,4
70676,4,2,247841,247841,247843,0,2,3
70677,1,3,247842,247843,247846,1,4,0
70678,5,2,247847,247847,247849,0,2,1
70679,2,1,247849,247849,247850,0,1,0
70680,5,3,247854,247854,247857,0,3,4
70681,1,1,247855,247857,247858,2,3,0
70682,5,2,247860,247860,247862,0,2,2
70683,5,3,247865,247865,247868,0,3,3
70684,3,2,247868,247868,247870,0,2,0
70685,5,1,247873,247873,247874,0,1,3
70686,5,1,247878,247878,247879,0,1,4
70687,1,2,247879,247879,247881,0,2,0
70688,2,3,247881,247881,247884,0,3,0
70689,1,2,247882,247884,247886,2,4,0
70690,6,3,247888,247888,247891,0,3,2
70691,3,1,247891,247891,247892,0,1,0
70692,6,3,247897,247897,247900,0,3,5
70693,1,3,247898,247900,247903,2,5,0
70694,1,1,247899,247903,247904,4,5,0
70695,3,2,247902,247904,247906,2,4,0
70696,5,1,247907,247907,247908,0,1,1
70697,4,1,247911,247911,247912,0,1,3
70698,4,3,247915,247915,247918,0,3,3
70699,6,2,247921,247921,247923,0,2,3
70700,5,3,247926,247926,247929,0,3,3
70701,2,3,247928,247929,247932,1,4,0
70702,4,1,247932,247932,247933,0,1,0
70703,3,3,247935,247935,247938,0,3,2
70704,4,1,247939,247939,247940,0,1,1
70705,5,1,247944,247944,247945,0,1,4
70706,4,3,247948,247948,247951,0,3,3
70707,1,2,247949,247951,247953,2,4,0
70708,6,3,247955,247955,247958,0,3,2
70709,4,3,247959,247959,247962,0,3,1
70710,2,2,247961,247962,247964,1,3,0
70711,3,3,247964,247964,247967,0,3,0
70712,2,2,247966,247967,247969,1,3,0
70713,3,3,247969,247969,247972,0,3,0
70714,6,3,247975,247975,247978,0,3,3
70715,1,1,247976,247978,247979,2,3,0
70716,1,1,247977,247979,247980,2,3,0
70717,1,3,247978,247980,247983,2,5,0
70718,2,2,247980,247983,247985,3,5,0
70719,3,1,247983,247985,247986,2,3,0
70720,5,3,247988,247988,247991,0,3,2
70721,6,1,247994,247994,247995,0,1,3
70722,4,2,247998,247998,248000,0,2,3
70723,3,1,248001,248001,248002,0,1,1
70724,2,3,248003,248003,248006,0,3,1
70725,5,2,248008,248008,248010,0,2,2
70726,4,2,248012,248012,248014,0,2,2
70727,5,2,248017,248017,248019,0,2,3
70728,2,3,248019,248019,248022,0,3,0
70729,2,1,248021,248022,248023,1,2,0
70730,3,1,248024,248024,248025,0,1,1
70731,3,1,248027,248027,248028,0,1,2
70732,4,2,248031,248031,248033,0,2,3
70733,6,1,248037,248037,248038,0,1,4
70734,2,2,248039,248039,248041,0,2,1
70735,6,3,248045,248045,248048,0,3,4
70736,4,3,248049,248049,248052,0,3,1
70737,1,2,248050,248052,248054,2,4,0
70738,5,2,248055,248055,248057,0,2,1
70739,4,1,248059,248059,248060,0,1,2
70740,1,2,248060,248060,248062,0,2,0
70741,3,1,248063,248063,248064,0,1,1
70742,3,1,248066,248066,248067,0,1,2
70743,2,2,248068,248068,248070,0,2,1
70744,1,3,248069,248070,248073,1,4,0
70745,3,1,248072,248073,248074,1,2,0
70746,5,1,248077,248077,248078,0,1,3
70747,3,2,248080,248080,248082,0,2,2
70748,4,2,248084,248084,248086,0,2,2
70749,2,3,248086,248086,248089,0,3,0
70750,5,2,248091,248091,248093,0,2,2
70751,6,1,248097,248097,248098,0,1,4
70752,1,2,248098,248098,248100,0,2,0
70753,3,3,248101,248101,248104,0,3,1
70754,5,2,248106,248106,248108,0,2,2
70755,6,1,248112,248112,248113,0,1,4
70756,2,1,248114,248114,248115,0,1,1
70757,2,1,248116,248116,248117,0,1,1
70758,1,3,248117,248117,248120,0,3,0
70759,3,1,248120,248120,248121,0,1,0
70760,3,1,248123,248123,248124,0,1,2
70761,1,1,248124,248124,248125,0,1,0
70762,3,2,248127,248127,248129,0,2,2
70763,3,2,248130,248130,248132,0,2,1
70764,6,2,248136,248136,248138,0,2,4
70765,1,2,248137,248138,248140,1,3,0
70766,1,1,248138,248140,248141,2,3,0
70767,5,3,248143,248143,248146,0,3,2
70768,6,1,248149,248149,248150,0,1,3
70769,3,2,248152,248152,248154,0,2,2
70770,4,2,248156,248156,248158,0,2,2
70771,5,3,248161,248161,248164,0,3,3
70772,5,2,248166,248166,248168,0,2,2
70773,5,3,248171,248171,248174,0,3,3
70774,5,1,248176,248176,248177,0,1,2
70775,2,3,248178,248178,248181,0,3,1
70776,2,1,248180,248181,248182,1,2,0
70777,4,2,248184,248184,248186,0,2,2
70778,5,2,248189,248189,248191,0,2,3
70779,3,2,248192,248192,248194,0,2,1
70780,5,2,248197,248197,248199,0,2,3
70781,2,1,248199,248199,248200,0,1,0
70782,1,3,248200,248200,248203,0,3,0
70783,2,1,248202,248203,248204,1,2,0
70784,3,3,248205,248205,248208,0,3,1
70785,5,3,248210,248210,248213,0,3,2
70786,6,3,248216,248216,248219,0,3,3
70787,2,2,248218,248219,248221,1,3,0
70788,2,2,248220,248221,248223,1,3,0
70789,5,3,248225,248225,248228,0,3,2
70790,6,3,248231,248231,248234,0,3,3
70791,3,3,248234,248234,248237,0,3,0
70792,2,3,248236,248237,248240,1,4,0
70793,5,2,248241,248241,248243,0,2,1
70794,5,3,248246,248246,248249,0,3,3
70795,3,2,248249,248249,248251,0,2,0
70796,4,3,248253,248253,248256,0,3,2
70797,5,2,248258,248258,248260,0,2,2
70798,2,1,248260,248260,248261,0,1,0
70799,4,3,248264,248264,248267,0,3,3
70800,5,3,248269,248269,248272,0,3,2
70801,2,3,248271,248272,248275,1,4,0
70802,1,2,248272,248275,248277,3,5,0
70803,5,3,248277,248277,248280,0,3,0
70804,4,3,248281,248281,248284,0,3,1
70805,6,3,248287,248287,248290,0,3,3
70806,2,2,248289,248290,248292,1,3,0
70807,5,2,248294,248294,248296,0,2,2
70808,4,3,248298,248298,248301,0,3,2
70809,1,3,248299,248301,248304,2,5,0
70810,3,3,248302,248304,248307,2,5,0
70811,2,2,248304,248307,248309,3,5,0
70812,4,3,248308,248309,248312,1,4,0
70813,5,2,248313,248313,248315,0,2,1
70814,3,3,248316,248316,248319,0,3,1
70815,1,2,248317,248319,248321,2,4,0
70816,3,1,248320,248321,248322,1,2,0
70817,6,1,248326,248326,248327,0,1,4
70818,2,1,248328,248328,248329,0,1,1
70819,6,3,248334,248334,248337,0,3,5
70820,2,3,248336,248337,248340,1,4,0
70821,6,1,248342,248342,248343,0,1,2
70822,6,1,248348,248348,248349,0,1,5
70823,3,3,248351,248351,248354,0,3,2
70824,1,3,248352,248354,248357,2,5,0
70825,1,1,248353,248357,248358,4,5,0
70826,6,3,248359,248359,248362,0,3,1
70827,6,1,248365,248365,248366,0,1,3
70828,2,1,248367,248367,248368,0,1,1
70829,5,1,248372,248372,248373,0,1,4
70830,2,1,248374,248374,248375,0,1,1
70831,6,3,248380,248380,248383,0,3,5
70832,3,2,248383,248383,248385,0,2,0
70833,3,1,248386,248386,248387,0,1,1
70834,2,1,248388,248388,248389,0,1,1
70835,2,1,248390,248390,248391,0,1,1
70836,3,3,248393,248393,248396,0,3,2
70837,4,1,248397,248397,248398,0,1,1
70838,1,1,248398,248398,248399,0,1,0
70839,6,2,248404,248404,248406,0,2,5
70840,2,3,248406,248406,248409,0,3,0
70841,6,3,248412,248412,248415,0,3,3
70842,5,1,248417,248417,248418,0,1,2
70843,1,3,248418,248418,248421,0,3,0
70844,2,2,248420,248421,248423,1,3,0
70845,5,3,248425,248425,248428,0,3,2
70846,2,3,248427,248428,248431,1,4,0
70847,3,3,248430,248431,248434,1,4,0
70848,4,3,248434,248434,248437,0,3,0
70849,1,1,248435,248437,248438,2,3,0
70850,2,2,248437,248438,248440,1,3,0
70851,1,2,248438,248440,248442,2,4,0
70852,5,2,248443,248443,248445,0,2,1
70853,1,1,248444,248445,248446,1,2,0
70854,1,3,248445,248446,248449,1,4,0
70855,2,3,248447,248449,248452,2,5,0
70856,6,3,248453,248453,248456,0,3,1
70857,3,3,248456,248456,248459,0,3,0
70858,4,2,248460,248460,248462,0,2,1
70859,5,1,248465,248465,248466,0,1,3
70860,3,1,248468,248468,248469,0,1,2
70861,4,2,248472,248472,248474,0,2,3
70862,2,2,248474,248474,248476,0,2,0
70863,4,3,248478,248478,248481,0,3,2
70864,2,2,248480,248481,248483,1,3,0
70865,2,3,248482,248483,248486,1,4,0
70866,6,1,248488,248488,248489,0,1,2
70867,2,3,248490,248490,248493,0,3,1
70868,3,2,248493,248493,248495,0,2,0
70869,5,3,248498,248498,248501,0,3,3
70870,2,1,248500,248501,248502,1,2,0
70871,5,2,248505,248505,248507,0,2,3
70872,2,1,248507,248507,248508,0,1,0
70873,2,1,248509,248509,248510,0,1,1
70874,5,2,248514,248514,248516,0,2,4
70875,5,2,248519,248519,248521,0,2,3
70876,3,1,248522,248522,248523,0,1,1
70877,5,3,248527,248527,248530,0,3,4
70878,2,3,248529,248530,248533,1,4,0
70879,3,2,248532,248533,248535,1,3,0
70880,4,1,248536,248536,248537,0,1,1
70881,1,3,248537,248537,248540,0,3,0
70882,3,2,248540,248540,248542,0,2,0
70883,2,1,248542,248542,248543,0,1,0
70884,2,3,248544,248544,248547,0,3,1
70885,5,1,248549,248549,248550,0,1,2
70886,6,1,248555,248555,248556,0,1,5
70887,6,3,248561,248561,248564,0,3,5
70888,2,3,248563,248564,248567,1,4,0
70889,6,3,248569,248569,248572,0,3,2
70890,3,1,248572,248572,248573,0,1,0
70891,5,3,248577,248577,248580,0,3,4
70892,3,2,248580,248580,248582,0,2,0
70893,3,3,248583,248583,248586,0,3,1
70894,1,3,248584,248586,248589,2,5,0
70895,3,2,248587,248589,248591,2,4,0
70896,5,2,248592,248592,248594,0,2,1
70897,2,1,248594,248594,248595,0,1,0
70898,3,3,248597,248597,248600,0,3,2
70899,1,1,248598,248600,248601,2,3,0
70900,3,3,248601,248601,248604,0,3,0
70901,1,2,248602,248604,248606,2,4,0
70902,4,1,248606,248606,248607,0,1,0
70903,1,1,248607,248607,248608,0,1,0
70904,2,3,248609,248609,248612,0,3,1
70905,6,3,248615,248615,248618,0,3,3
70906,6,3,248621,248621,248624,0,3,3
70907,4,1,248625,248625,248626,0,1,1
70908,3,1,248628,248628,248629,0,1,2
70909,5,1,248633,248633,248634,0,1,4
70910,2,2,248635,248635,248637,0,2,1
70911,1,3,248636,248637,248640,1,4,0
70912,1,3,248637,248640,248643,3,6,0
70913,4,1,248641,248643,248644,2,3,0
70914,3,3,248644,248644,248647,0,3,0
70915,4,1,248648,248648,248649,0,1,1
70916,5,3,248653,248653,248656,0,3,4
70917,6,3,248659,248659,248662,0,3,3
70918,3,2,248662,248662,248664,0,2,0
70919,6,1,248668,248668,248669,0,1,4
70920,1,3,248669,248669,248672,0,3,0
70921,1,3,248670,248672,248675,2,5,0
70922,1,2,248671,248675,248677,4,6,0
70923,2,1,248673,248677,248678,4,5,0
70924,6,1,248679,248679,248680,0,1,1
70925,5,3,248684,248684,248687,0,3,4
70926,6,3,248690,248690,248693,0,3,3
70927,5,1,248695,248695,248696,0,1,2
70928,5,1,248700,248700,248701,0,1,4
70929,5,3,248705,248705,248708,0,3,4
70930,2,2,248707,248708,248710,1,3,0
70931,5,1,248712,248712,248713,0,1,2
70932,4,3,248716,248716,248719,0,3,3
70933,3,3,248719,248719,248722,0,3,0
70934,3,1,248722,248722,248723,0,1,0
70935,6,2,248728,248728,248730,0,2,5
70936,2,2,248730,248730,248732,0,2,0
70937,6,2,248736,248736,248738,0,2,4
70938,6,2,248742,248742,248744,0,2,4
70939,5,3,248747,248747,248750,0,3,3
70940,5,3,248752,248752,248755,0,3,2
70941,5,1,248757,248757,248758,0,1,2
70942,4,1,248761,248761,248762,0,1,3
70943,5,3,248766,248766,248769,0,3,4
70944,3,1,248769,248769,248770,0,1,0
70945,1,1,248770,248770,248771,0,1,0
70946,2,1,248772,248772,248773,0,1,1
70947,2,3,248774,248774,248777,0,3,1
70948,6,1,248780,248780,248781,0,1,3
70949,5,1,248785,248785,248786,0,1,4
70950,3,1,248788,248788,248789,0,1,2
70951,5,1,248793,248793,248794,0,1,4
70952,1,3,248794,248794,248797,0,3,0
70953,6,2,248800,248800,248802,0,2,3
70954,5,1,248805,248805,248806,0,1,3
70955,6,3,248811,248811,248814,0,3,5
70956,1,1,248812,248814,248815,2,3,0
70957,3,1,248815,248815,248816,0,1,0
70958,4,3,248819,248819,248822,0,3,3
70959,1,3,248820,248822,248825,2,5,0
70960,3,3,248823,248825,248828,2,5,0
70961,3,2,248826,248828,248830,2,4,0
70962,6,3,248832,248832,248835,0,3,2
70963,4,1,248836,248836,248837,0,1,1
70964,3,2,248839,248839,248841,0,2,2
70965,5,2,248844,248844,248846,0,2,3
70966,5,1,248849,248849,248850,0,1,3
70967,3,3,248852,248852,248855,0,3,2
70968,2,1,248854,248855,248856,1,2,0
70969,5,1,248859,248859,248860,0,1,3
70970,6,3,248865,248865,248868,0,3,5
70971,2,1,248867,248868,248869,1,2,0
70972,6,2,248873,248873,248875,0,2,4
70973,4,2,248877,248877,248879,0,2,2
70974,2,3,248879,248879,248882,0,3,0
70975,4,2,248883,248883,248885,0,2,1
70976,6,2,248889,248889,248891,0,2,4
70977,3,2,248892,248892,248894,0,2,1
70978,2,1,248894,248894,248895,0,1,0
70979,2,1,248896,248896,248897,0,1,1
70980,1,2,248897,248897,248899,0,2,0
70981,5,3,248902,248902,248905,0,3,3
70982,1,1,248903,248905,248906,2,3,0
70983,5,3,248908,248908,248911,0,3,2
70984,2,3,248910,248911,248914,1,4,0
70985,2,1,248912,248914,248915,2,3,0
70986,3,1,248915,248915,248916,0,1,0
70987,1,2,248916,248916,248918,0,2,0
70988,3,3,248919,248919,248922,0,3,1
70989,5,3,248924,248924,248927,0,3,2
70990,5,1,248929,248929,248930,0,1,2
70991,4,3,248933,248933,248936,0,3,3
70992,5,3,248938,248938,248941,0,3,2
70993,6,2,248944,248944,248946,0,2,3
70994,5,2,248949,248949,248951,0,2,3
70995,1,2,248950,248951,248953,1,3,0
70996,1,3,248951,248953,248956,2,5,0
70997,5,1,248956,248956,248957,0,1,0
70998,1,2,248957,248957,248959,0,2,0
70999,6,3,248963,248963,248966,0,3,4
71000,4,3,248967,248967,248970,0,3,1
71001,2,3,248969,248970,248973,1,4,0
71002,5,2,248974,248974,248976,0,2,1
71003,2,3,248976,248976,248979,0,3,0
71004,4,3,248980,248980,248983,0,3,1
71005,4,1,248984,248984,248985,0,1,1
71006,2,3,248986,248986,248989,0,3,1
71007,1,3,248987,248989,248992,2,5,0
71008,4,2,248991,248992,248994,1,3,0
71009,3,3,248994,248994,248997,0,3,0
71010,1,2,248995,248997,248999,2,4,0
71011,2,3,248997,248999,249002,2,5,0
71012,4,2,249001,249002,249004,1,3,0
71013,4,3,249005,249005,249008,0,3,1
71014,2,3,249007,249008,249011,1,4,0
71015,4,1,249011,249011,249012,0,1,0
71016,6,3,249017,249017,249020,0,3,5
71017,2,1,249019,249020,249021,1,2,0
71018,2,2,249021,249021,249023,0,2,0
71019,1,2,249022,249023,249025,1,3,0
71020,6,3,249028,249028,249031,0,3,3
71021,1,3,249029,249031,249034,2,5,0
71022,5,2,249034,249034,249036,0,2,0
71023,4,1,249038,249038,249039,0,1,2
71024,6,1,249044,249044,249045,0,1,5
71025,6,1,249050,249050,249051,0,1,5
71026,3,2,249053,249053,249055,0,2,2
71027,1,2,249054,249055,249057,1,3,0
71028,4,3,249058,249058,249061,0,3,1
71029,3,1,249061,249061,249062,0,1,0
71030,4,3,249065,249065,249068,0,3,3
71031,3,1,249068,249068,249069,0,1,0
71032,3,2,249071,249071,249073,0,2,2
71033,5,3,249076,249076,249079,0,3,3
71034,6,1,249082,249082,249083,0,1,3
71035,2,3,249084,249084,249087,0,3,1
71036,4,3,249088,249088,249091,0,3,1
71037,6,1,249094,249094,249095,0,1,3
71038,3,3,249097,249097,249100,0,3,2
71039,1,1,249098,249100,249101,2,3,0
71040,3,3,249101,249101,249104,0,3,0
71041,6,2,249107,249107,249109,0,2,3
71042,1,2,249108,249109,249111,1,3,0
71043,4,2,249112,249112,249114,0,2,1
71044,3,3,249115,249115,249118,0,3,1
71045,2,1,249117,249118,249119,1,2,0
71046,4,2,249121,249121,249123,0,2,2
71047,3,2,249124,249124,249126,0,2,1
71048,5,2,249129,249129,249131,0,2,3
71049,1,3,249130,249131,249134,1,4,0
71050,2,1,249132,249134,249135,2,3,0
71051,4,3,249136,249136,249139,0,3,1
71052,3,3,249139,249139,249142,0,3,0
71053,1,1,249140,249142,249143,2,3,0
71054,5,1,249145,249145,249146,0,1,2
71055,4,1,249149,249149,249150,0,1,3
71056,5,3,249154,249154,249157,0,3,4
71057,3,2,249157,249157,249159,0,2,0
71058,6,3,249163,249163,249166,0,3,4
71059,1,1,249164,249166,249167,2,3,0
71060,1,3,249165,249167,249170,2,5,0
71061,1,2,249166,249170,249172,4,6,0
71062,4,3,249170,249172,249175,2,5,0
71063,1,2,249171,249175,249177,4,6,0
71064,6,1,249177,249177,249178,0,1,0
71065,2,3,249179,249179,249182,0,3,1
71066,1,2,249180,249182,249184,2,4,0
71067,5,3,249185,249185,249188,0,3,1
71068,2,2,249187,249188,249190,1,3,0
71069,6,2,249193,249193,249195,0,2,3
71070,3,3,249196,249196,249199,0,3,1
71071,5,1,249201,249201,249202,0,1,2
71072,3,2,249204,249204,249206,0,2,2
71073,5,2,249209,249209,249211,0,2,3
71074,3,3,249212,249212,249215,0,3,1
71075,4,3,249216,249216,249219,0,3,1
71076,6,2,249222,249222,249224,0,2,3
71077,2,1,249224,249224,249225,0,1,0
71078,5,3,249229,249229,249232,0,3,4
71079,3,3,249232,249232,249235,0,3,0
71080,5,3,249237,249237,249240,0,3,2
71081,5,2,249242,249242,249244,0,2,2
71082,3,3,249245,249245,249248,0,3,1
71083,2,2,249247,249248,249250,1,3,0
71084,1,1,249248,249250,249251,2,3,0
71085,4,2,249252,249252,249254,0,2,1
71086,5,3,249257,249257,249260,0,3,3
71087,5,1,249262,249262,249263,0,1,2
71088,1,3,249263,249263,249266,0,3,0
71089,6,1,249269,249269,249270,0,1,3
71090,4,1,249273,249273,249274,0,1,3
71091,2,2,249275,249275,249277,0,2,1
71092,2,2,249277,249277,249279,0,2,0
71093,5,1,249282,249282,249283,0,1,3
71094,1,3,249283,249283,249286,0,3,0
71095,6,2,249289,249289,249291,0,2,3
71096,2,2,249291,249291,249293,0,2,0
71097,6,3,249297,249297,249300,0,3,4
71098,1,1,249298,249300,249301,2,3,0
71099,6,3,249304,249304,249307,0,3,3
71100,4,1,249308,249308,249309,0,1,1
71101,1,3,249309,249309,249312,0,3,0
71102,4,1,249313,249313,249314,0,1,1
71103,1,3,249314,249314,249317,0,3,0
71104,3,2,249317,249317,249319,0,2,0
71105,6,3,249323,249323,249326,0,3,4
71106,2,3,249325,249326,249329,1,4,0
71107,2,2,249327,249329,249331,2,4,0
71108,1,2,249328,249331,249333,3,5,0
71109,6,3,249334,249334,249337,0,3,1
71110,6,2,249340,249340,249342,0,2,3
71111,6,1,249346,249346,249347,0,1,4
71112,6,1,249352,249352,249353,0,1,5
71113,1,2,249353,249353,249355,0,2,0
71114,3,3,249356,249356,249359,0,3,1
71115,3,3,249359,249359,249362,0,3,0
71116,2,1,249361,249362,249363,1,2,0
71117,6,2,249367,249367,249369,0,2,4
71118,3,3,249370,249370,249373,0,3,1
71119,4,2,249374,249374,249376,0,2,1
71120,5,3,249379,249379,249382,0,3,3
71121,2,3,249381,249382,249385,1,4,0
71122,3,2,249384,249385,249387,1,3,0
71123,1,1,249385,249387,249388,2,3,0
71124,5,2,249390,249390,249392,0,2,2
71125,4,3,249394,249394,249397,0,3,2
71126,2,3,249396,249397,249400,1,4,0
71127,6,2,249402,249402,249404,0,2,2
71128,6,1,249408,249408,249409,0,1,4
71129,3,2,249411,249411,249413,0,2,2
71130,2,2,249413,249413,249415,0,2,0
71131,3,1,249416,249416,249417,0,1,1
71132,5,1,249421,249421,249422,0,1,4
71133,4,2,249425,249425,249427,0,2,3
71134,3,1,249428,249428,249429,0,1,1
71135,4,1,249432,249432,249433,0,1,3
71136,3,1,249435,249435,249436,0,1,2
71137,6,1,249441,249441,249442,0,1,5
71138,4,3,249445,249445,249448,0,3,3
71139,4,2,249449,249449,249451,0,2,1
71140,4,1,249453,249453,249454,0,1,2
71141,1,3,249454,249454,249457,0,3,0
71142,1,3,249455,249457,249460,2,5,0
71143,6,1,249461,249461,249462,0,1,1
71144,1,1,249462,249462,249463,0,1,0
71145,3,2,249465,249465,249467,0,2,2
71146,4,3,249469,249469,249472,0,3,2
71147,1,2,249470,249472,249474,2,4,0
71148,5,3,249475,249475,249478,0,3,1
71149,3,1,249478,249478,249479,0,1,0
71150,4,1,249482,249482,249483,0,1,3
71151,1,3,249483,249483,249486,0,3,0
71152,1,1,249484,249486,249487,2,3,0
71153,3,1,249487,249487,249488,0,1,0
71154,3,2,249490,249490,249492,0,2,2
71155,2,3,249492,249492,249495,0,3,0
71156,6,2,249498,249498,249500,0,2,3
71157,1,2,249499,249500,249502,1,3,0
71158,2,2,249501,249502,249504,1,3,0
71159,3,3,249504,249504,249507,0,3,0
71160,4,1,249508,249508,249509,0,1,1
71161,5,1,249513,249513,249514,0,1,4
71162,1,2,249514,249514,249516,0,2,0
71163,4,1,249518,249518,249519,0,1,2
71164,3,1,249521,249521,249522,0,1,2
71165,5,3,249526,249526,249529,0,3,4
71166,2,1,249528,249529,249530,1,2,0
71167,6,2,249534,249534,249536,0,2,4
71168,5,3,249539,249539,249542,0,3,3
71169,6,1,249545,249545,249546,0,1,3
71170,1,1,249546,249546,249547,0,1,0
71171,5,1,249551,249551,249552,0,1,4
71172,5,1,249556,249556,249557,0,1,4
71173,4,1,249560,249560,249561,0,1,3
71174,6,3,249566,249566,249569,0,3,5
71175,5,1,249571,249571,249572,0,1,2
71176,4,2,249575,249575,249577,0,2,3
71177,4,2,249579,249579,249581,0,2,2
71178,4,2,249583,249583,249585,0,2,2
71179,2,3,249585,249585,249588,0,3,0
71180,1,1,249586,249588,249589,2,3,0
71181,2,1,249588,249589,249590,1,2,0
71182,1,3,249589,249590,249593,1,4,0
71183,1,2,249590,249593,249595,3,5,0
71184,6,3,249596,249596,249599,0,3,1
71185,2,2,249598,249599,249601,1,3,0
71186,5,3,249603,249603,249606,0,3,2
71187,2,1,249605,249606,249607,1,2,0
71188,2,1,249607,249607,249608,0,1,0
71189,4,3,249611,249611,249614,0,3,3
71190,1,1,249612,249614,249615,2,3,0
71191,5,2,249617,249617,249619,0,2,2
71192,6,3,249623,249623,249626,0,3,4
71193,5,2,249628,249628,249630,0,2,2
71194,1,1,249629,249630,249631,1,2,0
71195,6,2,249635,249635,249637,0,2,4
71196,2,2,249637,249637,249639,0,2,0
71197,2,3,249639,249639,249642,0,3,0
71198,1,2,249640,249642,249644,2,4,0
71199,3,1,249643,249644,249645,1,2,0
71200,4,2,249647,249647,249649,0,2,2
71201,6,2,249653,249653,249655,0,2,4
71202,1,3,249654,249655,249658,1,4,0
71203,5,3,249659,249659,249662,0,3,1
71204,1,1,249660,249662,249663,2,3,0
71205,6,3,249666,249666,249669,0,3,3
71206,1,2,249667,249669,249671,2,4,0
71207,3,3,249670,249671,249674,1,4,0
71208,2,3,249672,249674,249677,2,5,0
71209,2,2,249674,249677,249679,3,5,0
71210,3,2,249677,249679,249681,2,4,0
71211,6,3,249683,249683,249686,0,3,2
71212,2,3,249685,249686,249689,1,4,0
71213,6,2,249691,249691,249693,0,2,2
71214,4,2,249695,249695,249697,0,2,2
71215,2,1,249697,249697,249698,0,1,0
71216,4,2,249701,249701,249703,0,2,3
71217,6,2,249707,249707,249709,0,2,4
71218,5,3,249712,249712,249715,0,3,3
71219,3,1,249715,249715,249716,0,1,0
71220,6,1,249721,249721,249722,0,1,5
71221,2,1,249723,249723,249724,0,1,1
71222,3,2,249726,249726,249728,0,2,2
71223,6,2,249732,249732,249734,0,2,4
71224,4,3,249736,249736,249739,0,3,2
71225,1,2,249737,249739,249741,2,4,0
71226,3,2,249740,249741,249743,1,3,0
71227,4,2,249744,249744,249746,0,2,1
71228,5,3,249749,249749,249752,0,3,3
71229,4,3,249753,249753,249756,0,3,1
71230,4,3,249757,249757,249760,0,3,1
71231,4,2,249761,249761,249763,0,2,1
71232,4,2,249765,249765,249767,0,2,2
71233,3,1,249768,249768,249769,0,1,1
71234,3,3,249771,249771,249774,0,3,2
71235,2,3,249773,249774,249777,1,4,0
71236,6,1,249779,249779,249780,0,1,2
71237,6,2,249785,249785,249787,0,2,5
71238,6,2,249791,249791,249793,0,2,4
71239,5,3,249796,249796,249799,0,3,3
71240,4,2,249800,249800,249802,0,2,1
71241,2,1,249802,249802,249803,0,1,0
71242,6,2,249808,249808,249810,0,2,5
71243,2,1,249810,249810,249811,0,1,0
71244,5,3,249815,249815,249818,0,3,4
71245,2,1,249817,249818,249819,1,2,0
71246,5,3,249822,249822,249825,0,3,3
71247,2,3,249824,249825,249828,1,4,0
71248,2,3,249826,249828,249831,2,5,0
71249,4,1,249830,249831,249832,1,2,0
71250,1,1,249831,249832,249833,1,2,0
71251,4,3,249835,249835,249838,0,3,2
71252,1,2,249836,249838,249840,2,4,0
71253,6,2,249842,249842,249844,0,2,2
71254,5,3,249847,249847,249850,0,3,3
71255,5,3,249852,249852,249855,0,3,2
71256,5,3,249857,249857,249860,0,3,2
71257,4,3,249861,249861,249864,0,3,1
71258,3,3,249864,249864,249867,0,3,0
71259,1,2,249865,249867,249869,2,4,0
71260,4,1,249869,249869,249870,0,1,0
71261,1,1,249870,249870,249871,0,1,0
71262,4,3,249874,249874,249877,0,3,3
71263,5,2,249879,249879,249881,0,2,2
71264,2,3,249881,249881,249884,0,3,0
71265,4,2,249885,249885,249887,0,2,1
71266,1,1,249886,249887,249888,1,2,0
71267,5,1,249891,249891,249892,0,1,3
71268,5,2,249896,249896,249898,0,2,4
71269,5,3,249901,249901,249904,0,3,3
71270,5,1,249906,249906,249907,0,1,2
71271,2,2,249908,249908,249910,0,2,1
71272,1,3,249909,249910,249913,1,4,0
71273,5,2,249914,249914,249916,0,2,1
71274,2,1,249916,249916,249917,0,1,0
71275,5,1,249921,249921,249922,0,1,4
71276,6,1,249927,249927,249928,0,1,5
71277,1,3,249928,249928,249931,0,3,0
71278,6,1,249934,249934,249935,0,1,3
71279,2,2,249936,249936,249938,0,2,1
71280,2,1,249938,249938,249939,0,1,0
71281,6,1,249944,249944,249945,0,1,5
71282,1,1,249945,249945,249946,0,1,0
71283,6,2,249951,249951,249953,0,2,5
71284,2,1,249953,249953,249954,0,1,0
71285,5,2,249958,249958,249960,0,2,4
71286,1,3,249959,249960,249963,1,4,0
71287,5,2,249964,249964,249966,0,2,1
71288,5,3,249969,249969,249972,0,3,3
71289,4,3,249973,249973,249976,0,3,1
71290,5,3,249978,249978,249981,0,3,2
71291,5,2,249983,249983,249985,0,2,2
71292,4,1,249987,249987,249988,0,1,2
71293,2,2,249989,249989,249991,0,2,1
71294,1,1,249990,249991,249992,1,2,0
71295,3,1,249993,249993,249994,0,1,1
71296,6,3,249999,249999,250002,0,3,5
71297,6,2,250005,250005,250007,0,2,3
71298,2,3,250007,250007,250010,0,3,0
71299,4,3,250011,250011,250014,0,3,1
71300,1,2,250012,250014,250016,2,4,0
71301,3,3,250015,250016,250019,1,4,0
71302,2,1,250017,250019,250020,2,3,0
71303,4,2,250021,250021,250023,0,2,1
71304,2,1,250023,250023,250024,0,1,0
71305,6,2,250029,250029,250031,0,2,5
71306,2,2,250031,250031,250033,0,2,0
71307,2,2,250033,250033,250035,0,2,0
71308,3,3,250036,250036,250039,0,3,1
71309,1,1,250037,250039,250040,2,3,0
71310,5,3,250042,250042,250045,0,3,2
71311,1,1,250043,250045,250046,2,3,0
71312,5,3,250048,250048,250051,0,3,2
71313,4,1,250052,250052,250053,0,1,1
71314,5,3,250057,250057,250060,0,3,4
71315,1,1,250058,250060,250061,2,3,0
71316,6,1,250064,250064,250065,0,1,3
71317,1,2,250065,250065,250067,0,2,0
71318,5,3,250070,250070,250073,0,3,3
71319,1,1,250071,250073,250074,2,3,0
71320,3,2,250074,250074,250076,0,2,0
71321,6,3,250080,250080,250083,0,3,4
71322,5,2,250085,250085,250087,0,2,2
71323,2,1,250087,250087,250088,0,1,0
71324,2,2,250089,250089,250091,0,2,1
71325,4,2,250093,250093,250095,0,2,2
71326,4,3,250097,250097,250100,0,3,2
71327,6,3,250103,250103,250106,0,3,3
71328,6,1,250109,250109,250110,0,1,3
71329,4,2,250113,250113,250115,0,2,3
71330,3,1,250116,250116,250117,0,1,1
71331,3,1,250119,250119,250120,0,1,2
71332,1,3,250120,250120,250123,0,3,0
71333,4,2,250124,250124,250126,0,2,1
71334,1,3,250125,250126,250129,1,4,0
71335,2,1,250127,250129,250130,2,3,0
71336,6,2,250133,250133,250135,0,2,3
71337,6,1,250139,250139,250140,0,1,4
71338,3,1,250142,250142,250143,0,1,2
71339,3,3,250145,250145,250148,0,3,2
71340,3,3,250148,250148,250151,0,3,0
71341,1,1,250149,250151,250152,2,3,0
71342,1,2,250150,250152,250154,2,4,0
71343,6,3,250156,250156,250159,0,3,2
71344,2,3,250158,250159,250162,1,4,0
71345,1,1,250159,250162,250163,3,4,0
71346,3,2,250162,250163,250165,1,3,0
71347,3,3,250165,250165,250168,0,3,0
71348,4,1,250169,250169,250170,0,1,1
71349,2,3,250171,250171,250174,0,3,1
71350,5,1,250176,250176,250177,0,1,2
71351,2,2,250178,250178,250180,0,2,1
71352,5,2,250183,250183,250185,0,2,3
71353,3,1,250186,250186,250187,0,1,1
71354,1,3,250187,250187,250190,0,3,0
71355,5,2,250192,250192,250194,0,2,2
71356,2,2,250194,250194,250196,0,2,0
71357,5,2,250199,250199,250201,0,2,3
71358,6,1,250205,250205,250206,0,1,4
71359,1,3,250206,250206,250209,0,3,0
71360,6,1,250212,250212,250213,0,1,3
71361,4,3,250216,250216,250219,0,3,3
71362,4,2,250220,250220,250222,0,2,1
71363,5,1,250225,250225,250226,0,1,3
71364,6,3,250231,250231,250234,0,3,5
71365,4,3,250235,250235,250238,0,3,1
71366,4,2,250239,250239,250241,0,2,1
71367,2,3,250241,250241,250244,0,3,0
71368,3,3,250244,250244,250247,0,3,0
71369,5,1,250249,250249,250250,0,1,2
71370,5,1,250254,250254,250255,0,1,4
71371,2,2,250256,250256,250258,0,2,1
71372,1,2,250257,250258,250260,1,3,0
71373,3,1,250260,250260,250261,0,1,0
71374,4,2,250264,250264,250266,0,2,3
71375,1,2,250265,250266,250268,1,3,0
71376,6,1,250271,250271,250272,0,1,3
71377,5,3,250276,250276,250279,0,3,4
71378,4,3,250280,250280,250283,0,3,1
71379,4,3,250284,250284,250287,0,3,1
71380,6,2,250290,250290,250292,0,2,3
71381,4,1,250294,250294,250295,0,1,2
71382,3,1,250297,250297,250298,0,1,2
71383,2,2,250299,250299,250301,0,2,1
71384,2,3,250301,250301,250304,0,3,0
71385,4,2,250305,250305,250307,0,2,1
71386,2,3,250307,250307,250310,0,3,0
71387,3,1,250310,250310,250311,0,1,0
71388,3,2,250313,250313,250315,0,2,2
71389,5,2,250318,250318,250320,0,2,3
71390,2,3,250320,250320,250323,0,3,0
71391,3,3,250323,250323,250326,0,3,0
71392,6,2,250329,250329,250331,0,2,3
71393,2,2,250331,250331,250333,0,2,0
71394,2,2,250333,250333,250335,0,2,0
71395,6,1,250339,250339,250340,0,1,4
71396,2,2,250341,250341,250343,0,2,1
71397,5,1,250346,250346,250347,0,1,3
71398,1,3,250347,250347,250350,0,3,0
71399,1,1,250348,250350,250351,2,3,0
71400,2,1,250350,250351,250352,1,2,0
71401,3,3,250353,250353,250356,0,3,1
71402,5,1,250358,250358,250359,0,1,2
71403,4,2,250362,250362,250364,0,2,3
71404,3,3,250365,250365,250368,0,3,1
71405,5,3,250370,250370,250373,0,3,2
71406,3,3,250373,250373,250376,0,3,0
71407,2,3,250375,250376,250379,1,4,0
71408,1,2,250376,250379,250381,3,5,0
71409,6,1,250382,250382,250383,0,1,1
71410,6,1,250388,250388,250389,0,1,5
71411,2,2,250390,250390,250392,0,2,1
71412,4,2,250394,250394,250396,0,2,2
71413,1,2,250395,250396,250398,1,3,0
71414,2,2,250397,250398,250400,1,3,0
71415,2,1,250399,250400,250401,1,2,0
71416,6,3,250405,250405,250408,0,3,4
71417,3,3,250408,250408,250411,0,3,0
71418,5,2,250413,250413,250415,0,2,2
71419,2,2,250415,250415,250417,0,2,0
71420,6,2,250421,250421,250423,0,2,4
71421,1,3,250422,250423,250426,1,4,0
71422,3,3,250425,250426,250429,1,4,0
71423,4,1,250429,250429,250430,0,1,0
71424,2,1,250431,250431,250432,0,1,1
71425,4,3,250435,250435,250438,0,3,3
71426,2,2,250437,250438,250440,1,3,0
71427,3,1,250440,250440,250441,0,1,0
71428,2,1,250442,250442,250443,0,1,1
71429,5,1,250447,250447,250448,0,1,4
71430,6,1,250453,250453,250454,0,1,5
71431,3,3,250456,250456,250459,0,3,2
71432,3,2,250459,250459,250461,0,2,0
71433,4,3,250463,250463,250466,0,3,2
71434,5,3,250468,250468,250471,0,3,2
71435,3,2,250471,250471,250473,0,2,0
71436,4,3,250475,250475,250478,0,3,2
71437,6,2,250481,250481,250483,0,2,3
71438,1,1,250482,250483,250484,1,2,0
71439,5,2,250487,250487,250489,0,2,3
71440,2,3,250489,250489,250492,0,3,0
71441,6,3,250495,250495,250498,0,3,3
71442,5,2,250500,250500,250502,0,2,2
71443,5,1,250505,250505,250506,0,1,3
71444,3,1,250508,250508,250509,0,1,2
71445,3,3,250511,250511,250514,0,3,2
71446,3,1,250514,250514,250515,0,1,0
71447,2,2,250516,250516,250518,0,2,1
71448,4,1,250520,250520,250521,0,1,2
71449,5,3,250525,250525,250528,0,3,4
71450,2,1,250527,250528,250529,1,2,0
71451,1,1,250528,250529,250530,1,2,0
71452,2,3,250530,250530,250533,0,3,0
71453,2,2,250532,250533,250535,1,3,0
71454,5,1,250537,250537,250538,0,1,2
71455,5,3,250542,250542,250545,0,3,4
71456,1,2,250543,250545,250547,2,4,0
71457,6,2,250549,250549,250551,0,2,2
71458,5,2,250554,250554,250556,0,2,3
71459,6,2,250560,250560,250562,0,2,4
71460,3,1,250563,250563,250564,0,1,1
71461,2,3,250565,250565,250568,0,3,1
71462,3,1,250568,250568,250569,0,1,0
71463,1,1,250569,250569,250570,0,1,0
71464,6,1,250575,250575,250576,0,1,5
71465,3,3,250578,250578,250581,0,3,2
71466,3,2,250581,250581,250583,0,2,0
71467,5,2,250586,250586,250588,0,2,3
71468,4,1,250590,250590,250591,0,1,2
71469,3,1,250593,250593,250594,0,1,2
71470,4,3,250597,250597,250600,0,3,3
71471,4,3,250601,250601,250604,0,3,1
71472,4,1,250605,250605,250606,0,1,1
71473,4,1,250609,250609,250610,0,1,3
71474,6,3,250615,250615,250618,0,3,5
71475,4,3,250619,250619,250622,0,3,1
71476,6,2,250625,250625,250627,0,2,3
71477,6,3,250631,250631,250634,0,3,4
71478,6,1,250637,250637,250638,0,1,3
71479,1,3,250638,250638,250641,0,3,0
71480,2,2,250640,250641,250643,1,3,0
71481,1,2,250641,250643,250645,2,4,0
71482,6,3,250647,250647,250650,0,3,2
71483,3,1,250650,250650,250651,0,1,0
71484,4,1,250654,250654,250655,0,1,3
71485,5,3,250659,250659,250662,0,3,4
71486,4,1,250663,250663,250664,0,1,1
71487,5,1,250668,250668,250669,0,1,4
71488,1,3,250669,250669,250672,0,3,0
71489,6,2,250675,250675,250677,0,2,3
71490,5,2,250680,250680,250682,0,2,3
71491,2,1,250682,250682,250683,0,1,0
71492,6,2,250688,250688,250690,0,2,5
71493,3,2,250691,250691,250693,0,2,1
71494,3,3,250694,250694,250697,0,3,1
71495,2,3,250696,250697,250700,1,4,0
71496,4,2,250700,250700,250702,0,2,0
71497,5,1,250705,250705,250706,0,1,3
71498,1,1,250706,250706,250707,0,1,0
71499,3,2,250709,250709,250711,0,2,2
71500,3,1,250712,250712,250713,0,1,1
71501,6,1,250718,250718,250719,0,1,5
71502,1,3,250719,250719,250722,0,3,0
71503,6,3,250725,250725,250728,0,3,3
71504,4,3,250729,250729,250732,0,3,1
71505,5,1,250734,250734,250735,0,1,2
71506,4,3,250738,250738,250741,0,3,3
71507,1,3,250739,250741,250744,2,5,0
71508,3,1,250742,250744,250745,2,3,0
71509,4,1,250746,250746,250747,0,1,1
71510,5,2,250751,250751,250753,0,2,4
71511,3,3,250754,250754,250757,0,3,1
71512,4,3,250758,250758,250761,0,3,1
71513,1,1,250759,250761,250762,2,3,0
71514,4,3,250763,250763,250766,0,3,1
71515,4,3,250767,250767,250770,0,3,1
71516,1,3,250768,250770,250773,2,5,0
71517,2,2,250770,250773,250775,3,5,0
71518,1,1,250771,250775,250776,4,5,0
71519,4,2,250775,250776,250778,1,3,0
71520,3,2,250778,250778,250780,0,2,0
71521,2,2,250780,250780,250782,0,2,0
71522,2,2,250782,250782,250784,0,2,0
71523,6,1,250788,250788,250789,0,1,4
71524,3,3,250791,250791,250794,0,3,2
71525,6,2,250797,250797,250799,0,2,3
71526,3,1,250800,250800,250801,0,1,1
71527,3,3,250803,250803,250806,0,3,2
71528,1,2,250804,250806,250808,2,4,0
71529,6,1,250810,250810,250811,0,1,2
71530,5,2,250815,250815,250817,0,2,4
71531,5,1,250820,250820,250821,0,1,3
71532,6,2,250826,250826,250828,0,2,5
71533,5,3,250831,250831,250834,0,3,3
71534,2,3,250833,250834,250837,1,4,0
71535,6,2,250839,250839,250841,0,2,2
71536,6,1,250845,250845,250846,0,1,4
71537,1,3,250846,250846,250849,0,3,0
71538,3,2,250849,250849,250851,0,2,0
71539,6,2,250855,250855,250857,0,2,4
71540,5,2,250860,250860,250862,0,2,3
71541,1,1,250861,250862,250863,1,2,0
71542,3,3,250864,250864,250867,0,3,1
71543,2,1,250866,250867,250868,1,2,0
71544,5,2,250871,250871,250873,0,2,3
71545,6,3,250877,250877,250880,0,3,4
71546,4,2,250881,250881,250883,0,2,1
71547,2,1,250883,250883,250884,0,1,0
71548,4,3,250887,250887,250890,0,3,3
71549,5,3,250892,250892,250895,0,3,2
71550,4,1,250896,250896,250897,0,1,1
71551,4,3,250900,250900,250903,0,3,3
71552,1,3,250901,250903,250906,2,5,0
71553,4,1,250905,250906,250907,1,2,0
71554,3,1,250908,250908,250909,0,1,1
71555,3,3,250911,250911,250914,0,3,2
71556,3,3,250914,250914,250917,0,3,0
71557,6,2,250920,250920,250922,0,2,3
71558,2,3,250922,250922,250925,0,3,0
71559,3,2,250925,250925,250927,0,2,0
71560,1,1,250926,250927,250928,1,2,0
71561,2,3,250928,250928,250931,0,3,0
71562,4,2,250932,250932,250934,0,2,1
71563,6,3,250938,250938,250941,0,3,4
71564,5,2,250943,250943,250945,0,2,2
71565,2,3,250945,250945,250948,0,3,0
71566,5,1,250950,250950,250951,0,1,2
71567,1,1,250951,250951,250952,0,1,0
71568,6,3,250957,250957,250960,0,3,5
71569,2,1,250959,250960,250961,1,2,0
71570,5,1,250964,250964,250965,0,1,3
71571,5,3,250969,250969,250972,0,3,4
71572,6,3,250975,250975,250978,0,3,3
71573,6,1,250981,250981,250982,0,1,3
71574,1,2,250982,250982,250984,0,2,0
71575,1,3,250983,250984,250987,1,4,0
71576,1,1,250984,250987,250988,3,4,0
71577,3,2,250987,250988,250990,1,3,0
71578,4,3,250991,250991,250994,0,3,1
71579,1,3,250992,250994,250997,2,5,0
71580,1,2,250993,250997,250999,4,6,0
71581,1,2,250994,250999,251001,5,7,0
71582,6,1,251000,251001,251002,1,2,0
71583,1,3,251001,251002,251005,1,4,0
71584,1,3,251002,251005,251008,3,6,0
71585,4,1,251006,251008,251009,2,3,0
71586,2,2,251008,251009,251011,1,3,0
71587,3,3,251011,251011,251014,0,3,0
71588,2,2,251013,251014,251016,1,3,0
71589,4,3,251017,251017,251020,0,3,1
71590,4,2,251021,251021,251023,0,2,1
71591,1,3,251022,251023,251026,1,4,0
71592,4,2,251026,251026,251028,0,2,0
71593,1,2,251027,251028,251030,1,3,0
71594,2,3,251029,251030,251033,1,4,0
71595,6,3,251035,251035,251038,0,3,2
71596,1,1,251036,251038,251039,2,3,0
71597,4,1,251040,251040,251041,0,1,1
71598,6,1,251046,251046,251047,0,1,5
71599,2,2,251048,251048,251050,0,2,1
71600,5,2,251053,251053,251055,0,2,3
71601,3,3,251056,251056,251059,0,3,1
71602,3,3,251059,251059,251062,0,3,0
71603,6,3,251065,251065,251068,0,3,3
71604,5,1,251070,251070,251071,0,1,2
71605,4,2,251074,251074,251076,0,2,3
71606,6,2,251080,251080,251082,0,2,4
71607,2,1,251082,251082,251083,0,1,0
71608,1,2,251083,251083,251085,0,2,0
71609,2,2,251085,251085,251087,0,2,0
71610,3,3,251088,251088,251091,0,3,1
71611,4,3,251092,251092,251095,0,3,1
71612,5,3,251097,251097,251100,0,3,2
71613,2,1,251099,251100,251101,1,2,0
71614,4,1,251103,251103,251104,0,1,2
71615,3,3,251106,251106,251109,0,3,2
71616,1,3,251107,251109,251112,2,5,0
71617,5,3,251112,251112,251115,0,3,0
71618,5,3,251117,251117,251120,0,3,2
71619,5,3,251122,251122,251125,0,3,2
71620,2,2,251124,251125,251127,1,3,0
71621,1,2,251125,251127,251129,2,4,0
71622,3,3,251128,251129,251132,1,4,0
71623,1,3,251129,251132,251135,3,6,0
71624,3,2,251132,251135,251137,3,5,0
71625,3,1,251135,251137,251138,2,3,0
71626,5,1,251140,251140,251141,0,1,2
71627,3,2,251143,251143,251145,0,2,2
71628,3,2,251146,251146,251148,0,2,1
71629,5,2,251151,251151,251153,0,2,3
71630,5,1,251156,251156,251157,0,1,3
71631,6,2,251162,251162,251164,0,2,5
71632,6,2,251168,251168,251170,0,2,4
71633,6,3,251174,251174,251177,0,3,4
71634,3,3,251177,251177,251180,0,3,0
71635,4,2,251181,251181,251183,0,2,1
71636,5,1,251186,251186,251187,0,1,3
71637,1,2,251187,251187,251189,0,2,0
71638,4,3,251191,251191,251194,0,3,2
71639,4,3,251195,251195,251198,0,3,1
71640,2,3,251197,251198,251201,1,4,0
71641,1,1,251198,251201,251202,3,4,0
71642,4,3,251202,251202,251205,0,3,0
71643,1,1,251203,251205,251206,2,3,0
71644,1,3,251204,251206,251209,2,5,0
71645,6,1,251210,251210,251211,0,1,1
71646,2,3,251212,251212,251215,0,3,1
71647,4,1,251216,251216,251217,0,1,1
71648,3,3,251219,251219,251222,0,3,2
71649,5,3,251224,251224,251227,0,3,2
71650,2,3,251226,251227,251230,1,4,0
71651,2,2,251228,251230,251232,2,4,0
71652,1,3,251229,251232,251235,3,6,0
71653,5,2,251234,251235,251237,1,3,0
71654,1,3,251235,251237,251240,2,5,0
71655,2,2,251237,251240,251242,3,5,0
71656,4,3,251241,251242,251245,1,4,0
71657,4,2,251245,251245,251247,0,2,0
71658,6,2,251251,251251,251253,0,2,4
71659,2,3,251253,251253,251256,0,3,0
71660,2,1,251255,251256,251257,1,2,0
71661,6,2,251261,251261,251263,0,2,4
71662,4,1,251265,251265,251266,0,1,2
71663,3,3,251268,251268,251271,0,3,2
71664,2,2,251270,251271,251273,1,3,0
71665,4,1,251274,251274,251275,0,1,1
71666,6,2,251280,251280,251282,0,2,5
71667,4,2,251284,251284,251286,0,2,2
71668,5,3,251289,251289,251292,0,3,3
71669,4,2,251293,251293,251295,0,2,1
71670,1,1,251294,251295,251296,1,2,0
71671,4,3,251298,251298,251301,0,3,2
71672,2,1,251300,251301,251302,1,2,0
71673,2,1,251302,251302,251303,0,1,0
71674,6,2,251308,251308,251310,0,2,5
71675,4,1,251312,251312,251313,0,1,2
71676,1,3,251313,251313,251316,0,3,0
71677,5,2,251318,251318,251320,0,2,2
71678,3,2,251321,251321,251323,0,2,1
71679,5,1,251326,251326,251327,0,1,3
71680,5,2,251331,251331,251333,0,2,4
71681,5,1,251336,251336,251337,0,1,3
71682,6,2,251342,251342,251344,0,2,5
71683,5,2,251347,251347,251349,0,2,3
71684,5,3,251352,251352,251355,0,3,3
71685,1,1,251353,251355,251356,2,3,0
71686,2,3,251355,251356,251359,1,4,0
71687,1,1,251356,251359,251360,3,4,0
71688,5,1,251361,251361,251362,0,1,1
71689,1,1,251362,251362,251363,0,1,0
71690,6,3,251368,251368,251371,0,3,5
71691,1,3,251369,251371,251374,2,5,0
71692,6,2,251375,251375,251377,0,2,1
71693,6,3,251381,251381,251384,0,3,4
71694,1,3,251382,251384,251387,2,5,0
71695,3,2,251385,251387,251389,2,4,0
71696,1,1,251386,251389,251390,3,4,0
71697,4,1,251390,251390,251391,0,1,0
71698,6,2,251396,251396,251398,0,2,5
71699,6,1,251402,251402,251403,0,1,4
71700,3,2,251405,251405,251407,0,2,2
71701,2,1,251407,251407,251408,0,1,0
71702,2,1,251409,251409,251410,0,1,1
71703,3,1,251412,251412,251413,0,1,2
71704,3,3,251415,251415,251418,0,3,2
71705,2,3,251417,251418,251421,1,4,0
71706,3,2,251420,251421,251423,1,3,0
71707,6,2,251426,251426,251428,0,2,3
71708,1,1,251427,251428,251429,1,2,0
71709,1,3,251428,251429,251432,1,4,0
71710,4,2,251432,251432,251434,0,2,0
71711,6,3,251438,251438,251441,0,3,4
71712,4,3,251442,251442,251445,0,3,1
71713,1,3,251443,251445,251448,2,5,0
71714,6,1,251449,251449,251450,0,1,1
71715,2,2,251451,251451,251453,0,2,1
71716,4,3,251455,251455,251458,0,3,2
71717,3,2,251458,251458,251460,0,2,0
71718,1,2,251459,251460,251462,1,3,0
71719,5,1,251464,251464,251465,0,1,2
71720,1,3,251465,251465,251468,0,3,0
71721,1,3,251466,251468,251471,2,5,0
71722,5,3,251471,251471,251474,0,3,0
71723,3,3,251474,251474,251477,0,3,0
71724,1,2,251475,251477,251479,2,4,0
71725,1,2,251476,251479,251481,3,5,0
71726,3,3,251479,251481,251484,2,5,0
71727,2,1,251481,251484,251485,3,4,0
71728,2,1,251483,251485,251486,2,3,0
71729,6,3,251489,251489,251492,0,3,3
71730,3,2,251492,251492,251494,0,2,0
71731,3,1,251495,251495,251496,0,1,1
71732,4,2,251499,251499,251501,0,2,3
71733,4,2,251503,251503,251505,0,2,2
71734,1,2,251504,251505,251507,1,3,0
71735,3,2,251507,251507,251509,0,2,0
71736,3,3,251510,251510,251513,0,3,1
71737,4,3,251514,251514,251517,0,3,1
71738,1,2,251515,251517,251519,2,4,0
71739,6,2,251521,251521,251523,0,2,2
71740,3,2,251524,251524,251526,0,2,1
71741,1,3,251525,251526,251529,1,4,0
71742,5,2,251530,251530,251532,0,2,1
71743,1,1,251531,251532,251533,1,2,0
71744,1,3,251532,251533,251536,1,4,0
71745,2,1,251534,251536,251537,2,3,0
71746,6,2,251540,251540,251542,0,2,3
71747,1,2,251541,251542,251544,1,3,0
71748,2,3,251543,251544,251547,1,4,0
71749,4,3,251547,251547,251550,0,3,0
71750,1,2,251548,251550,251552,2,4,0
71751,6,2,251554,251554,251556,0,2,2
71752,3,1,251557,251557,251558,0,1,1
71753,3,3,251560,251560,251563,0,3,2
71754,5,2,251565,251565,251567,0,2,2
71755,5,2,251570,251570,251572,0,2,3
71756,3,2,251573,251573,251575,0,2,1
71757,3,1,251576,251576,251577,0,1,1
71758,3,1,251579,251579,251580,0,1,2
71759,4,3,251583,251583,251586,0,3,3
71760,1,3,251584,251586,251589,2,5,0
71761,1,3,251585,251589,251592,4,7,0
71762,5,3,251590,251592,251595,2,5,0
71763,6,1,251596,251596,251597,0,1,1
71764,4,3,251600,251600,251603,0,3,3
71765,5,1,251605,251605,251606,0,1,2
71766,4,2,251609,251609,251611,0,2,3
71767,4,1,251613,251613,251614,0,1,2
71768,2,2,251615,251615,251617,0,2,1
71769,5,3,251620,251620,251623,0,3,3
71770,3,1,251623,251623,251624,0,1,0
71771,2,3,251625,251625,251628,0,3,1
71772,3,1,251628,251628,251629,0,1,0
71773,5,3,251633,251633,251636,0,3,4
71774,2,1,251635,251636,251637,1,2,0
71775,3,3,251638,251638,251641,0,3,1
71776,1,2,251639,251641,251643,2,4,0
71777,4,3,251643,251643,251646,0,3,0
71778,1,3,251644,251646,251649,2,5,0
71779,3,3,251647,251649,251652,2,5,0
71780,4,1,251651,251652,251653,1,2,0
71781,2,2,251653,251653,251655,0,2,0
71782,2,3,251655,251655,251658,0,3,0
71783,1,3,251656,251658,251661,2,5,0
71784,6,1,251662,251662,251663,0,1,1
71785,1,2,251663,251663,251665,0,2,0
71786,3,3,251666,251666,251669,0,3,1
71787,4,1,251670,251670,251671,0,1,1
71788,6,3,251676,251676,251679,0,3,5
71789,3,3,251679,251679,251682,0,3,0
71790,2,3,251681,251682,251685,1,4,0
71791,4,3,251685,251685,251688,0,3,0
71792,6,1,251691,251691,251692,0,1,3
71793,4,1,251695,251695,251696,0,1,3
71794,4,2,251699,251699,251701,0,2,3
71795,4,2,251703,251703,251705,0,2,2
71796,6,3,251709,251709,251712,0,3,4
71797,2,1,251711,251712,251713,1,2,0
71798,5,2,251716,251716,251718,0,2,3
71799,2,3,251718,251718,251721,0,3,0
71800,2,3,251720,251721,251724,1,4,0
71801,4,3,251724,251724,251727,0,3,0
71802,6,2,251730,251730,251732,0,2,3
71803,3,2,251733,251733,251735,0,2,1
71804,5,2,251738,251738,251740,0,2,3
71805,2,1,251740,251740,251741,0,1,0
71806,1,2,251741,251741,251743,0,2,0
71807,2,2,251743,251743,251745,0,2,0
71808,6,3,251749,251749,251752,0,3,4
71809,4,1,251753,251753,251754,0,1,1
71810,6,3,251759,251759,251762,0,3,5
71811,3,3,251762,251762,251765,0,3,0
71812,4,3,251766,251766,251769,0,3,1
71813,1,3,251767,251769,251772,2,5,0
71814,3,3,251770,251772,251775,2,5,0
71815,6,2,251776,251776,251778,0,2,1
71816,3,3,251779,251779,251782,0,3,1
71817,3,1,251782,251782,251783,0,1,0
71818,3,2,251785,251785,251787,0,2,2
71819,2,2,251787,251787,251789,0,2,0
71820,6,3,251793,251793,251796,0,3,4
71821,2,1,251795,251796,251797,1,2,0
71822,2,1,251797,251797,251798,0,1,0
71823,6,2,251803,251803,251805,0,2,5
71824,4,2,251807,251807,251809,0,2,2
71825,4,1,251811,251811,251812,0,1,2
71826,6,2,251817,251817,251819,0,2,5
71827,1,1,251818,251819,251820,1,2,0
71828,3,2,251821,251821,251823,0,2,1
71829,5,2,251826,251826,251828,0,2,3
71830,6,3,251832,251832,251835,0,3,4
71831,1,3,251833,251835,251838,2,5,0
71832,1,1,251834,251838,251839,4,5,0
71833,1,3,251835,251839,251842,4,7,0
71834,3,3,251838,251842,251845,4,7,0
71835,2,3,251840,251845,251848,5,8,0
71836,3,1,251843,251848,251849,5,6,0
71837,5,2,251848,251849,251851,1,3,0
71838,1,2,251849,251851,251853,2,4,0
71839,5,1,251854,251854,251855,0,1,1
71840,3,2,251857,251857,251859,0,2,2
71841,1,2,251858,251859,251861,1,3,0
71842,1,1,251859,251861,251862,2,3,0
71843,3,3,251862,251862,251865,0,3,0
71844,3,3,251865,251865,251868,0,3,0
71845,4,3,251869,251869,251872,0,3,1
71846,2,3,251871,251872,251875,1,4,0
71847,3,1,251874,251875,251876,1,2,0
71848,6,3,251880,251880,251883,0,3,4
71849,2,3,251882,251883,251886,1,4,0
71850,2,2,251884,251886,251888,2,4,0
71851,4,3,251888,251888,251891,0,3,0
71852,3,3,251891,251891,251894,0,3,0
71853,4,2,251895,251895,251897,0,2,1
71854,2,3,251897,251897,251900,0,3,0
71855,2,3,251899,251900,251903,1,4,0
71856,4,1,251903,251903,251904,0,1,0
71857,4,3,251907,251907,251910,0,3,3
71858,2,1,251909,251910,251911,1,2,0
71859,4,1,251913,251913,251914,0,1,2
71860,2,2,251915,251915,251917,0,2,1
71861,5,3,251920,251920,251923,0,3,3
71862,2,1,251922,251923,251924,1,2,0
71863,4,3,251926,251926,251929,0,3,2
71864,6,2,251932,251932,251934,0,2,3
71865,6,3,251938,251938,251941,0,3,4
71866,6,3,251944,251944,251947,0,3,3
71867,6,1,251950,251950,251951,0,1,3
71868,4,2,251954,251954,251956,0,2,3
71869,3,1,251957,251957,251958,0,1,1
71870,1,1,251958,251958,251959,0,1,0
71871,3,3,251961,251961,251964,0,3,2
71872,1,2,251962,251964,251966,2,4,0
71873,5,1,251967,251967,251968,0,1,1
71874,3,3,251970,251970,251973,0,3,2
71875,1,2,251971,251973,251975,2,4,0
71876,3,3,251974,251975,251978,1,4,0
71877,4,3,251978,251978,251981,0,3,0
71878,4,1,251982,251982,251983,0,1,1
71879,4,2,251986,251986,251988,0,2,3
71880,1,3,251987,251988,251991,1,4,0
71881,6,2,251993,251993,251995,0,2,2
71882,4,2,251997,251997,251999,0,2,2
71883,6,1,252003,252003,252004,0,1,4
71884,5,2,252008,252008,252010,0,2,4
71885,1,1,252009,252010,252011,1,2,0
71886,1,1,252010,252011,252012,1,2,0
71887,2,2,252012,252012,252014,0,2,0
71888,2,2,252014,252014,252016,0,2,0
71889,1,2,252015,252016,252018,1,3,0
71890,5,1,252020,252020,252021,0,1,2
71891,2,1,252022,252022,252023,0,1,1
71892,2,1,252024,252024,252025,0,1,1
71893,1,3,252025,252025,252028,0,3,0
71894,2,1,252027,252028,252029,1,2,0
71895,4,3,252031,252031,252034,0,3,2
71896,5,2,252036,252036,252038,0,2,2
71897,1,1,252037,252038,252039,1,2,0
71898,5,2,252042,252042,252044,0,2,3
71899,6,3,252048,252048,252051,0,3,4
71900,4,3,252052,252052,252055,0,3,1
71901,6,3,252058,252058,252061,0,3,3
71902,2,1,252060,252061,252062,1,2,0
71903,1,3,252061,252062,252065,1,4,0
71904,1,2,252062,252065,252067,3,5,0
71905,2,3,252064,252067,252070,3,6,0
71906,4,2,252068,252070,252072,2,4,0
71907,2,2,252070,252072,252074,2,4,0
71908,2,3,252072,252074,252077,2,5,0
71909,5,3,252077,252077,252080,0,3,0
71910,1,1,252078,252080,252081,2,3,0
71911,4,2,252082,252082,252084,0,2,1
71912,3,3,252085,252085,252088,0,3,1
71913,1,1,252086,252088,252089,2,3,0
71914,3,2,252089,252089,252091,0,2,0
71915,3,3,252092,252092,252095,0,3,1
71916,1,1,252093,252095,252096,2,3,0
71917,5,1,252098,252098,252099,0,1,2
71918,5,2,252103,252103,252105,0,2,4
71919,1,3,252104,252105,252108,1,4,0
71920,5,3,252109,252109,252112,0,3,1
71921,5,1,252114,252114,252115,0,1,2
71922,6,2,252120,252120,252122,0,2,5
71923,2,1,252122,252122,252123,0,1,0
71924,4,1,252126,252126,252127,0,1,3
71925,5,3,252131,252131,252134,0,3,4
71926,6,1,252137,252137,252138,0,1,3
71927,6,3,252143,252143,252146,0,3,5
71928,5,3,252148,252148,252151,0,3,2
71929,6,1,252154,252154,252155,0,1,3
71930,5,1,252159,252159,252160,0,1,4
71931,5,2,252164,252164,252166,0,2,4
71932,1,2,252165,252166,252168,1,3,0
71933,6,1,252171,252171,252172,0,1,3
71934,6,1,252177,252177,252178,0,1,5
71935,1,3,252178,252178,252181,0,3,0
71936,4,3,252182,252182,252185,0,3,1
71937,1,2,252183,252185,252187,2,4,0
71938,6,1,252189,252189,252190,0,1,2
71939,5,2,252194,252194,252196,0,2,4
71940,3,2,252197,252197,252199,0,2,1
71941,6,1,252203,252203,252204,0,1,4
71942,6,1,252209,252209,252210,0,1,5
71943,3,2,252212,252212,252214,0,2,2
71944,4,3,252216,252216,252219,0,3,2
71945,3,3,252219,252219,252222,0,3,0
71946,4,2,252223,252223,252225,0,2,1
71947,5,2,252228,252228,252230,0,2,3
71948,3,3,252231,252231,252234,0,3,1
71949,1,3,252232,252234,252237,2,5,0
71950,4,1,252236,252237,252238,1,2,0
71951,4,2,252240,252240,252242,0,2,2
71952,1,1,252241,252242,252243,1,2,0
71953,5,2,252246,252246,252248,0,2,3
71954,3,3,252249,252249,252252,0,3,1
71955,4,1,252253,252253,252254,0,1,1
71956,1,3,252254,252254,252257,0,3,0
71957,2,2,252256,252257,252259,1,3,0
71958,4,1,252260,252260,252261,0,1,1
71959,4,3,252264,252264,252267,0,3,3
71960,2,1,252266,252267,252268,1,2,0
71961,4,2,252270,252270,252272,0,2,2
71962,4,1,252274,252274,252275,0,1,2
71963,3,1,252277,252277,252278,0,1,2
71964,3,1,252280,252280,252281,0,1,2
71965,1,2,252281,252281,252283,0,2,0
71966,4,1,252285,252285,252286,0,1,2
71967,2,2,252287,252287,252289,0,2,1
71968,1,3,252288,252289,252292,1,4,0
71969,6,1,252294,252294,252295,0,1,2
71970,2,1,252296,252296,252297,0,1,1
71971,5,1,252301,252301,252302,0,1,4
71972,3,3,252304,252304,252307,0,3,2
71973,5,2,252309,252309,252311,0,2,2
71974,4,3,252313,252313,252316,0,3,2
71975,2,3,252315,252316,252319,1,4,0
71976,5,3,252320,252320,252323,0,3,1
71977,5,2,252325,252325,252327,0,2,2
71978,3,3,252328,252328,252331,0,3,1
71979,1,1,252329,252331,252332,2,3,0
71980,2,3,252331,252332,252335,1,4,0
71981,2,1,252333,252335,252336,2,3,0
71982,4,1,252337,252337,252338,0,1,1
71983,4,1,252341,252341,252342,0,1,3
71984,3,2,252344,252344,252346,0,2,2
71985,4,1,252348,252348,252349,0,1,2
71986,1,3,252349,252349,252352,0,3,0
71987,3,3,252352,252352,252355,0,3,0
71988,1,3,252353,252355,252358,2,5,0
71989,4,3,252357,252358,252361,1,4,0
71990,6,3,252363,252363,252366,0,3,2
71991,1,3,252364,252366,252369,2,5,0
71992,5,3,252369,252369,252372,0,3,0
71993,5,1,252374,252374,252375,0,1,2
71994,3,2,252377,252377,252379,0,2,2
71995,5,2,252382,252382,252384,0,2,3
71996,2,3,252384,252384,252387,0,3,0
71997,4,1,252388,252388,252389,0,1,1
71998,6,3,252394,252394,252397,0,3,5
71999,2,3,252396,252397,252400,1,4,0
72000,1,1,252397,252400,252401,3,4,0
72001,1,1,252398,252401,252402,3,4,0
72002,4,3,252402,252402,252405,0,3,0
72003,2,1,252404,252405,252406,1,2,0
72004,6,1,252410,252410,252411,0,1,4
72005,4,3,252414,252414,252417,0,3,3
72006,5,3,252419,252419,252422,0,3,2
72007,6,3,252425,252425,252428,0,3,3
72008,1,2,252426,252428,252430,2,4,0
72009,1,2,252427,252430,252432,3,5,0
72010,6,3,252433,252433,252436,0,3,1
72011,6,3,252439,252439,252442,0,3,3
72012,6,3,252445,252445,252448,0,3,3
72013,4,1,252449,252449,252450,0,1,1
72014,6,1,252455,252455,252456,0,1,5
72015,4,2,252459,252459,252461,0,2,3
72016,4,1,252463,252463,252464,0,1,2
72017,6,2,252469,252469,252471,0,2,5
72018,5,3,252474,252474,252477,0,3,3
72019,5,1,252479,252479,252480,0,1,2
72020,6,1,252485,252485,252486,0,1,5
72021,2,1,252487,252487,252488,0,1,1
72022,6,2,252493,252493,252495,0,2,5
72023,5,2,252498,252498,252500,0,2,3
72024,3,3,252501,252501,252504,0,3,1
72025,1,3,252502,252504,252507,2,5,0
72026,2,3,252504,252507,252510,3,6,0
72027,4,1,252508,252510,252511,2,3,0
72028,4,1,252512,252512,252513,0,1,1
72029,3,2,252515,252515,252517,0,2,2
72030,3,1,252518,252518,252519,0,1,1
72031,6,3,252524,252524,252527,0,3,5
72032,3,3,252527,252527,252530,0,3,0
72033,4,1,252531,252531,252532,0,1,1
72034,1,1,252532,252532,252533,0,1,0
72035,3,1,252535,252535,252536,0,1,2
72036,2,3,252537,252537,252540,0,3,1
72037,4,2,252541,252541,252543,0,2,1
72038,1,3,252542,252543,252546,1,4,0
72039,1,3,252543,252546,252549,3,6,0
72040,5,1,252548,252549,252550,1,2,0
72041,3,3,252551,252551,252554,0,3,1
72042,3,1,252554,252554,252555,0,1,0
72043,2,1,252556,252556,252557,0,1,1
72044,6,3,252562,252562,252565,0,3,5
72045,6,1,252568,252568,252569,0,1,3
72046,1,1,252569,252569,252570,0,1,0
72047,1,3,252570,252570,252573,0,3,0
72048,6,2,252576,252576,252578,0,2,3
72049,1,2,252577,252578,252580,1,3,0
72050,6,3,252583,252583,252586,0,3,3
72051,4,2,252587,252587,252589,0,2,1
72052,6,3,252593,252593,252596,0,3,4
72053,3,3,252596,252596,252599,0,3,0
72054,2,1,252598,252599,252600,1,2,0
72055,4,3,252602,252602,252605,0,3,2
72056,3,1,252605,252605,252606,0,1,0
72057,6,1,252611,252611,252612,0,1,5
72058,1,1,252612,252612,252613,0,1,0
72059,5,3,252617,252617,252620,0,3,4
72060,1,3,252618,252620,252623,2,5,0
72061,1,2,252619,252623,252625,4,6,0
72062,1,1,252620,252625,252626,5,6,0
72063,2,2,252622,252626,252628,4,6,0
72064,3,2,252625,252628,252630,3,5,0
72065,4,2,252629,252630,252632,1,3,0
72066,5,1,252634,252634,252635,0,1,2
72067,5,1,252639,252639,252640,0,1,4
72068,5,2,252644,252644,252646,0,2,4
72069,4,2,252648,252648,252650,0,2,2
72070,3,3,252651,252651,252654,0,3,1
72071,6,3,252657,252657,252660,0,3,3
72072,4,3,252661,252661,252664,0,3,1
72073,4,2,252665,252665,252667,0,2,1
72074,5,3,252670,252670,252673,0,3,3
72075,5,1,252675,252675,252676,0,1,2
72076,3,1,252678,252678,252679,0,1,2
72077,4,3,252682,252682,252685,0,3,3
72078,5,2,252687,252687,252689,0,2,2
72079,5,2,252692,252692,252694,0,2,3
72080,4,1,252696,252696,252697,0,1,2
72081,4,2,252700,252700,252702,0,2,3
72082,5,2,252705,252705,252707,0,2,3
72083,1,1,252706,252707,252708,1,2,0
72084,4,2,252710,252710,252712,0,2,2
72085,6,2,252716,252716,252718,0,2,4
72086,5,1,252721,252721,252722,0,1,3
72087,5,1,252726,252726,252727,0,1,4
72088,5,3,252731,252731,252734,0,3,4
72089,4,3,252735,252735,252738,0,3,1
72090,3,3,252738,252738,252741,0,3,0
72091,4,2,252742,252742,252744,0,2,1
72092,3,3,252745,252745,252748,0,3,1
72093,2,1,252747,252748,252749,1,2,0
72094,4,1,252751,252751,252752,0,1,2
72095,6,3,252757,252757,252760,0,3,5
72096,6,2,252763,252763,252765,0,2,3
72097,2,2,252765,252765,252767,0,2,0
72098,4,3,252769,252769,252772,0,3,2
72099,3,2,252772,252772,252774,0,2,0
72100,3,3,252775,252775,252778,0,3,1
72101,2,1,252777,252778,252779,1,2,0
72102,4,1,252781,252781,252782,0,1,2
72103,5,2,252786,252786,252788,0,2,4
72104,5,3,252791,252791,252794,0,3,3
72105,5,3,252796,252796,252799,0,3,2
72106,5,2,252801,252801,252803,0,2,2
72107,4,1,252805,252805,252806,0,1,2
72108,6,3,252811,252811,252814,0,3,5
72109,4,1,252815,252815,252816,0,1,1
72110,2,1,252817,252817,252818,0,1,1
72111,3,1,252820,252820,252821,0,1,2
72112,6,1,252826,252826,252827,0,1,5
72113,2,2,252828,252828,252830,0,2,1
72114,1,1,252829,252830,252831,1,2,0
72115,2,3,252831,252831,252834,0,3,0
72116,2,2,252833,252834,252836,1,3,0
72117,2,1,252835,252836,252837,1,2,0
72118,4,2,252839,252839,252841,0,2,2
72119,5,1,252844,252844,252845,0,1,3
72120,1,1,252845,252845,252846,0,1,0
72121,6,3,252851,252851,252854,0,3,5
72122,2,1,252853,252854,252855,1,2,0
72123,5,3,252858,252858,252861,0,3,3
72124,4,3,252862,252862,252865,0,3,1
72125,3,1,252865,252865,252866,0,1,0
72126,1,1,252866,252866,252867,0,1,0
72127,3,3,252869,252869,252872,0,3,2
72128,2,3,252871,252872,252875,1,4,0
72129,6,1,252877,252877,252878,0,1,2
72130,1,2,252878,252878,252880,0,2,0
72131,4,2,252882,252882,252884,0,2,2
72132,4,1,252886,252886,252887,0,1,2
72133,5,3,252891,252891,252894,0,3,4
72134,2,1,252893,252894,252895,1,2,0
72135,2,2,252895,252895,252897,0,2,0
72136,2,3,252897,252897,252900,0,3,0
72137,6,2,252903,252903,252905,0,2,3
72138,4,2,252907,252907,252909,0,2,2
72139,4,3,252911,252911,252914,0,3,2
72140,5,3,252916,252916,252919,0,3,2
72141,2,2,252918,252919,252921,1,3,0
72142,6,1,252924,252924,252925,0,1,3
72143,1,1,252925,252925,252926,0,1,0
72144,6,1,252931,252931,252932,0,1,5
72145,3,1,252934,252934,252935,0,1,2
72146,3,2,252937,252937,252939,0,2,2
72147,1,1,252938,252939,252940,1,2,0
72148,3,1,252941,252941,252942,0,1,1
72149,4,3,252945,252945,252948,0,3,3
72150,5,2,252950,252950,252952,0,2,2
72151,2,2,252952,252952,252954,0,2,0
72152,4,3,252956,252956,252959,0,3,2
72153,6,1,252962,252962,252963,0,1,3
72154,5,2,252967,252967,252969,0,2,4
72155,5,1,252972,252972,252973,0,1,3
72156,5,3,252977,252977,252980,0,3,4
72157,5,1,252982,252982,252983,0,1,2
72158,6,2,252988,252988,252990,0,2,5
72159,1,3,252989,252990,252993,1,4,0
72160,6,3,252995,252995,252998,0,3,2
72161,3,3,252998,252998,253001,0,3,0
72162,2,2,253000,253001,253003,1,3,0
72163,4,1,253004,253004,253005,0,1,1
72164,4,3,253008,253008,253011,0,3,3
72165,3,2,253011,253011,253013,0,2,0
72166,6,3,253017,253017,253020,0,3,4
72167,6,1,253023,253023,253024,0,1,3
72168,6,3,253029,253029,253032,0,3,5
72169,2,3,253031,253032,253035,1,4,0
72170,3,3,253034,253035,253038,1,4,0
72171,4,1,253038,253038,253039,0,1,0
72172,1,1,253039,253039,253040,0,1,0
72173,5,2,253044,253044,253046,0,2,4
72174,1,1,253045,253046,253047,1,2,0
72175,4,3,253049,253049,253052,0,3,2
72176,6,1,253055,253055,253056,0,1,3
72177,4,1,253059,253059,253060,0,1,3
72178,1,3,253060,253060,253063,0,3,0
72179,3,2,253063,253063,253065,0,2,0
72180,2,3,253065,253065,253068,0,3,0
72181,2,1,253067,253068,253069,1,2,0
72182,2,3,253069,253069,253072,0,3,0
72183,1,2,253070,253072,253074,2,4,0
72184,3,2,253073,253074,253076,1,3,0
72185,6,2,253079,253079,253081,0,2,3
72186,5,3,253084,253084,253087,0,3,3
72187,5,1,253089,253089,253090,0,1,2
72188,3,1,253092,253092,253093,0,1,2
72189,1,2,253093,253093,253095,0,2,0
72190,6,1,253099,253099,253100,0,1,4
72191,4,2,253103,253103,253105,0,2,3
72192,2,1,253105,253105,253106,0,1,0
72193,6,1,253111,253111,253112,0,1,5
72194,1,3,253112,253112,253115,0,3,0
72195,4,1,253116,253116,253117,0,1,1
72196,6,3,253122,253122,253125,0,3,5
72197,6,1,253128,253128,253129,0,1,3
72198,6,3,253134,253134,253137,0,3,5
72199,1,2,253135,253137,253139,2,4,0
72200,6,3,253141,253141,253144,0,3,2
72201,3,2,253144,253144,253146,0,2,0
72202,2,2,253146,253146,253148,0,2,0
72203,1,3,253147,253148,253151,1,4,0
72204,3,3,253150,253151,253154,1,4,0
72205,4,3,253154,253154,253157,0,3,0
72206,4,3,253158,253158,253161,0,3,1
72207,6,2,253164,253164,253166,0,2,3
72208,1,1,253165,253166,253167,1,2,0
72209,1,2,253166,253167,253169,1,3,0
72210,1,2,253167,253169,253171,2,4,0
72211,1,2,253168,253171,253173,3,5,0
72212,3,1,253171,253173,253174,2,3,0
72213,1,1,253172,253174,253175,2,3,0
72214,4,3,253176,253176,253179,0,3,1
72215,4,2,253180,253180,253182,0,2,1
72216,4,2,253184,253184,253186,0,2,2
72217,1,2,253185,253186,253188,1,3,0
72218,3,3,253188,253188,253191,0,3,0
72219,6,1,253194,253194,253195,0,1,3
72220,3,2,253197,253197,253199,0,2,2
72221,1,3,253198,253199,253202,1,4,0
72222,2,3,253200,253202,253205,2,5,0
72223,4,3,253204,253205,253208,1,4,0
72224,2,3,253206,253208,253211,2,5,0
72225,1,1,253207,253211,253212,4,5,0
72226,2,3,253209,253212,253215,3,6,0
72227,4,1,253213,253215,253216,2,3,0
72228,5,2,253218,253218,253220,0,2,2
72229,5,2,253223,253223,253225,0,2,3
72230,3,2,253226,253226,253228,0,2,1
72231,3,3,253229,253229,253232,0,3,1
72232,1,2,253230,253232,253234,2,4,0
72233,1,2,253231,253234,253236,3,5,0
72234,5,1,253236,253236,253237,0,1,0
72235,1,2,253237,253237,253239,0,2,0
72236,3,2,253240,253240,253242,0,2,1
72237,4,1,253244,253244,253245,0,1,2
72238,3,1,253247,253247,253248,0,1,2
72239,5,1,253252,253252,253253,0,1,4
72240,1,3,253253,253253,253256,0,3,0
72241,3,3,253256,253256,253259,0,3,0
72242,2,3,253258,253259,253262,1,4,0
72243,4,2,253262,253262,253264,0,2,0
72244,6,2,253268,253268,253270,0,2,4
72245,6,3,253274,253274,253277,0,3,4
72246,3,2,253277,253277,253279,0,2,0
72247,2,1,253279,253279,253280,0,1,0
72248,1,1,253280,253280,253281,0,1,0
72249,1,2,253281,253281,253283,0,2,0
72250,1,3,253282,253283,253286,1,4,0
72251,2,1,253284,253286,253287,2,3,0
72252,3,2,253287,253287,253289,0,2,0
72253,5,2,253292,253292,253294,0,2,3
72254,6,3,253298,253298,253301,0,3,4
72255,3,3,253301,253301,253304,0,3,0
72256,2,2,253303,253304,253306,1,3,0
72257,5,1,253308,253308,253309,0,1,2
72258,6,2,253314,253314,253316,0,2,5
72259,3,2,253317,253317,253319,0,2,1
72260,1,3,253318,253319,253322,1,4,0
72261,5,3,253323,253323,253326,0,3,1
72262,6,3,253329,253329,253332,0,3,3
72263,6,1,253335,253335,253336,0,1,3
72264,5,2,253340,253340,253342,0,2,4
72265,2,3,253342,253342,253345,0,3,0
72266,4,1,253346,253346,253347,0,1,1
72267,1,2,253347,253347,253349,0,2,0
72268,5,3,253352,253352,253355,0,3,3
72269,1,3,253353,253355,253358,2,5,0
72270,6,3,253359,253359,253362,0,3,1
72271,6,3,253365,253365,253368,0,3,3
72272,1,3,253366,253368,253371,2,5,0
72273,1,2,253367,253371,253373,4,6,0
72274,2,2,253369,253373,253375,4,6,0
72275,1,3,253370,253375,253378,5,8,0
72276,5,3,253375,253378,253381,3,6,0
72277,3,1,253378,253381,253382,3,4,0
72278,5,2,253383,253383,253385,0,2,1
72279,6,2,253389,253389,253391,0,2,4
72280,5,2,253394,253394,253396,0,2,3
72281,4,3,253398,253398,253401,0,3,2
72282,2,3,253400,253401,253404,1,4,0
72283,5,1,253405,253405,253406,0,1,1
72284,5,3,253410,253410,253413,0,3,4
72285,1,3,253411,253413,253416,2,5,0
72286,5,1,253416,253416,253417,0,1,0
72287,1,2,253417,253417,253419,0,2,0
72288,5,2,253422,253422,253424,0,2,3
72289,3,3,253425,253425,253428,0,3,1
72290,1,3,253426,253428,253431,2,5,0
72291,3,2,253429,253431,253433,2,4,0
72292,1,1,253430,253433,253434,3,4,0
72293,6,3,253436,253436,253439,0,3,2
72294,5,3,253441,253441,253444,0,3,2
72295,3,3,253444,253444,253447,0,3,0
72296,5,3,253449,253449,253452,0,3,2
72297,6,1,253455,253455,253456,0,1,3
72298,2,1,253457,253457,253458,0,1,1
72299,5,2,253462,253462,253464,0,2,4
72300,5,2,253467,253467,253469,0,2,3
72301,5,2,253472,253472,253474,0,2,3
72302,6,1,253478,253478,253479,0,1,4
72303,3,3,253481,253481,253484,0,3,2
72304,4,2,253485,253485,253487,0,2,1
72305,2,1,253487,253487,253488,0,1,0
72306,2,3,253489,253489,253492,0,3,1
72307,3,2,253492,253492,253494,0,2,0
72308,2,3,253494,253494,253497,0,3,0
72309,5,1,253499,253499,253500,0,1,2
72310,6,2,253505,253505,253507,0,2,5
72311,2,3,253507,253507,253510,0,3,0
72312,2,2,253509,253510,253512,1,3,0
72313,5,3,253514,253514,253517,0,3,2
72314,2,3,253516,253517,253520,1,4,0
72315,2,3,253518,253520,253523,2,5,0
72316,5,2,253523,253523,253525,0,2,0
72317,1,1,253524,253525,253526,1,2,0
72318,3,3,253527,253527,253530,0,3,1
72319,5,1,253532,253532,253533,0,1,2
72320,4,3,253536,253536,253539,0,3,3
72321,1,2,253537,253539,253541,2,4,0
72322,4,3,253541,253541,253544,0,3,0
72323,6,3,253547,253547,253550,0,3,3
72324,4,2,253551,253551,253553,0,2,1
72325,5,3,253556,253556,253559,0,3,3
72326,6,2,253562,253562,253564,0,2,3
72327,2,3,253564,253564,253567,0,3,0
72328,6,3,253570,253570,253573,0,3,3
72329,6,3,253576,253576,253579,0,3,3
72330,2,3,253578,253579,253582,1,4,0
72331,6,3,253584,253584,253587,0,3,2
72332,4,3,253588,253588,253591,0,3,1
72333,5,3,253593,253593,253596,0,3,2
72334,2,2,253595,253596,253598,1,3,0
72335,2,3,253597,253598,253601,1,4,0
72336,6,1,253603,253603,253604,0,1,2
72337,5,2,253608,253608,253610,0,2,4
72338,6,2,253614,253614,253616,0,2,4
72339,6,3,253620,253620,253623,0,3,4
72340,4,1,253624,253624,253625,0,1,1
72341,1,2,253625,253625,253627,0,2,0
72342,5,1,253630,253630,253631,0,1,3
72343,2,3,253632,253632,253635,0,3,1
72344,2,1,253634,253635,253636,1,2,0
72345,6,1,253640,253640,253641,0,1,4
72346,2,3,253642,253642,253645,0,3,1
72347,1,1,253643,253645,253646,2,3,0
72348,6,3,253649,253649,253652,0,3,3
72349,1,1,253650,253652,253653,2,3,0
72350,6,1,253656,253656,253657,0,1,3
72351,6,2,253662,253662,253664,0,2,5
72352,5,3,253667,253667,253670,0,3,3
72353,4,2,253671,253671,253673,0,2,1
72354,3,3,253674,253674,253677,0,3,1
72355,3,1,253677,253677,253678,0,1,0
72356,2,2,253679,253679,253681,0,2,1
72357,5,3,253684,253684,253687,0,3,3
72358,1,2,253685,253687,253689,2,4,0
72359,5,1,253690,253690,253691,0,1,1
72360,1,3,253691,253691,253694,0,3,0
72361,1,2,253692,253694,253696,2,4,0
72362,6,1,253698,253698,253699,0,1,2
72363,2,2,253700,253700,253702,0,2,1
72364,1,2,253701,253702,253704,1,3,0
72365,3,1,253704,253704,253705,0,1,0
72366,5,3,253709,253709,253712,0,3,4
72367,2,2,253711,253712,253714,1,3,0
72368,3,2,253714,253714,253716,0,2,0
72369,4,3,253718,253718,253721,0,3,2
72370,5,3,253723,253723,253726,0,3,2
72371,2,1,253725,253726,253727,1,2,0
72372,4,2,253729,253729,253731,0,2,2
72373,1,3,253730,253731,253734,1,4,0
72374,5,1,253735,253735,253736,0,1,1
72375,6,2,253741,253741,253743,0,2,5
72376,1,1,253742,253743,253744,1,2,0
72377,2,2,253744,253744,253746,0,2,0
72378,5,3,253749,253749,253752,0,3,3
72379,2,2,253751,253752,253754,1,3,0
72380,1,3,253752,253754,253757,2,5,0
72381,6,3,253758,253758,253761,0,3,1
72382,1,1,253759,253761,253762,2,3,0
72383,5,3,253764,253764,253767,0,3,2
72384,5,2,253769,253769,253771,0,2,2
72385,2,3,253771,253771,253774,0,3,0
72386,4,1,253775,253775,253776,0,1,1
72387,2,1,253777,253777,253778,0,1,1
72388,1,1,253778,253778,253779,0,1,0
72389,3,3,253781,253781,253784,0,3,2
72390,2,3,253783,253784,253787,1,4,0
72391,1,1,253784,253787,253788,3,4,0
72392,2,2,253786,253788,253790,2,4,0
72393,6,3,253792,253792,253795,0,3,2
72394,5,2,253797,253797,253799,0,2,2
72395,6,1,253803,253803,253804,0,1,4
72396,6,3,253809,253809,253812,0,3,5
72397,2,3,253811,253812,253815,1,4,0
72398,4,2,253815,253815,253817,0,2,0
72399,4,1,253819,253819,253820,0,1,2
72400,2,2,253821,253821,253823,0,2,1
72401,4,3,253825,253825,253828,0,3,2
72402,3,1,253828,253828,253829,0,1,0
72403,6,1,253834,253834,253835,0,1,5
72404,2,3,253836,253836,253839,0,3,1
72405,2,3,253838,253839,253842,1,4,0
72406,4,2,253842,253842,253844,0,2,0
72407,3,3,253845,253845,253848,0,3,1
72408,3,2,253848,253848,253850,0,2,0
72409,6,2,253854,253854,253856,0,2,4
72410,2,2,253856,253856,253858,0,2,0
72411,4,3,253860,253860,253863,0,3,2
72412,1,2,253861,253863,253865,2,4,0
72413,6,3,253867,253867,253870,0,3,2
72414,4,2,253871,253871,253873,0,2,1
72415,3,3,253874,253874,253877,0,3,1
72416,2,2,253876,253877,253879,1,3,0
72417,6,1,253882,253882,253883,0,1,3
72418,3,1,253885,253885,253886,0,1,2
72419,5,3,253890,253890,253893,0,3,4
72420,3,2,253893,253893,253895,0,2,0
72421,1,2,253894,253895,253897,1,3,0
72422,6,3,253900,253900,253903,0,3,3
72423,6,2,253906,253906,253908,0,2,3
72424,3,2,253909,253909,253911,0,2,1
72425,6,1,253915,253915,253916,0,1,4
72426,1,2,253916,253916,253918,0,2,0
72427,1,3,253917,253918,253921,1,4,0
72428,5,2,253922,253922,253924,0,2,1
72429,4,3,253926,253926,253929,0,3,2
72430,3,3,253929,253929,253932,0,3,0
72431,3,3,253932,253932,253935,0,3,0
72432,5,2,253937,253937,253939,0,2,2
72433,3,2,253940,253940,253942,0,2,1
72434,1,3,253941,253942,253945,1,4,0
72435,3,1,253944,253945,253946,1,2,0
72436,3,2,253947,253947,253949,0,2,1
72437,3,1,253950,253950,253951,0,1,1
72438,1,3,253951,253951,253954,0,3,0
72439,2,2,253953,253954,253956,1,3,0
72440,3,1,253956,253956,253957,0,1,0
72441,1,2,253957,253957,253959,0,2,0
72442,6,3,253963,253963,253966,0,3,4
72443,6,2,253969,253969,253971,0,2,3
72444,2,1,253971,253971,253972,0,1,0
72445,6,1,253977,253977,253978,0,1,5
72446,1,3,253978,253978,253981,0,3,0
72447,3,2,253981,253981,253983,0,2,0
72448,2,3,253983,253983,253986,0,3,0
72449,3,2,253986,253986,253988,0,2,0
72450,5,2,253991,253991,253993,0,2,3
72451,4,1,253995,253995,253996,0,1,2
72452,3,1,253998,253998,253999,0,1,2
72453,2,1,254000,254000,254001,0,1,1
72454,6,1,254006,254006,254007,0,1,5
72455,4,2,254010,254010,254012,0,2,3
72456,5,3,254015,254015,254018,0,3,3
72457,4,1,254019,254019,254020,0,1,1
72458,5,2,254024,254024,254026,0,2,4
72459,3,1,254027,254027,254028,0,1,1
72460,4,1,254031,254031,254032,0,1,3
72461,3,2,254034,254034,254036,0,2,2
72462,4,2,254038,254038,254040,0,2,2
72463,3,1,254041,254041,254042,0,1,1
72464,2,1,254043,254043,254044,0,1,1
72465,5,2,254048,254048,254050,0,2,4
72466,1,1,254049,254050,254051,1,2,0
72467,2,3,254051,254051,254054,0,3,0
72468,2,1,254053,254054,254055,1,2,0
72469,4,3,254057,254057,254060,0,3,2
72470,3,1,254060,254060,254061,0,1,0
72471,2,2,254062,254062,254064,0,2,1
72472,5,3,254067,254067,254070,0,3,3
72473,2,1,254069,254070,254071,1,2,0
72474,2,3,254071,254071,254074,0,3,0
72475,2,3,254073,254074,254077,1,4,0
72476,5,1,254078,254078,254079,0,1,1
72477,4,1,254082,254082,254083,0,1,3
72478,6,1,254088,254088,254089,0,1,5
72479,6,3,254094,254094,254097,0,3,5
72480,3,1,254097,254097,254098,0,1,0
72481,1,2,254098,254098,254100,0,2,0
72482,4,2,254102,254102,254104,0,2,2
72483,1,3,254103,254104,254107,1,4,0
72484,2,3,254105,254107,254110,2,5,0
72485,5,1,254110,254110,254111,0,1,0
72486,2,2,254112,254112,254114,0,2,1
72487,6,2,254118,254118,254120,0,2,4
72488,5,3,254123,254123,254126,0,3,3
72489,1,1,254124,254126,254127,2,3,0
72490,1,1,254125,254127,254128,2,3,0
72491,2,1,254127,254128,254129,1,2,0
72492,4,3,254131,254131,254134,0,3,2
72493,1,3,254132,254134,254137,2,5,0
72494,3,2,254135,254137,254139,2,4,0
72495,4,3,254139,254139,254142,0,3,0
72496,5,1,254144,254144,254145,0,1,2
72497,6,3,254150,254150,254153,0,3,5
72498,5,1,254155,254155,254156,0,1,2
72499,6,3,254161,254161,254164,0,3,5
72500,6,2,254167,254167,254169,0,2,3
72501,4,3,254171,254171,254174,0,3,2
72502,3,2,254174,254174,254176,0,2,0
72503,6,1,254180,254180,254181,0,1,4
72504,4,2,254184,254184,254186,0,2,3
72505,1,3,254185,254186,254189,1,4,0
72506,3,2,254188,254189,254191,1,3,0
72507,6,3,254194,254194,254197,0,3,3
72508,2,1,254196,254197,254198,1,2,0
72509,4,1,254200,254200,254201,0,1,2
72510,5,2,254205,254205,254207,0,2,4
72511,4,2,254209,254209,254211,0,2,2
72512,1,2,254210,254211,254213,1,3,0
72513,5,3,254215,254215,254218,0,3,2
72514,1,2,254216,254218,254220,2,4,0
72515,5,3,254221,254221,254224,0,3,1
72516,5,3,254226,254226,254229,0,3,2
72517,2,2,254228,254229,254231,1,3,0
72518,2,2,254230,254231,254233,1,3,0
72519,4,3,254234,254234,254237,0,3,1
72520,4,2,254238,254238,254240,0,2,1
72521,3,3,254241,254241,254244,0,3,1
72522,4,3,254245,254245,254248,0,3,1
72523,2,1,254247,254248,254249,1,2,0
72524,1,2,254248,254249,254251,1,3,0
72525,3,2,254251,254251,254253,0,2,0
72526,2,2,254253,254253,254255,0,2,0
72527,5,3,254258,254258,254261,0,3,3
72528,1,3,254259,254261,254264,2,5,0
72529,6,1,254265,254265,254266,0,1,1
72530,4,1,254269,254269,254270,0,1,3
72531,2,2,254271,254271,254273,0,2,1
72532,1,3,254272,254273,254276,1,4,0
72533,1,1,254273,254276,254277,3,4,0
72534,1,1,254274,254277,254278,3,4,0
72535,1,1,254275,254278,254279,3,4,0
72536,2,3,254277,254279,254282,2,5,0
72537,1,3,254278,254282,254285,4,7,0
72538,1,1,254279,254285,254286,6,7,0
72539,3,1,254282,254286,254287,4,5,0
72540,4,2,254286,254287,254289,1,3,0
72541,2,1,254288,254289,254290,1,2,0
72542,2,1,254290,254290,254291,0,1,0
72543,6,2,254296,254296,254298,0,2,5
72544,4,1,254300,254300,254301,0,1,2
72545,5,1,254305,254305,254306,0,1,4
72546,5,1,254310,254310,254311,0,1,4
72547,1,1,254311,254311,254312,0,1,0
72548,4,1,254315,254315,254316,0,1,3
72549,2,3,254317,254317,254320,0,3,1
72550,1,2,254318,254320,254322,2,4,0
72551,4,3,254322,254322,254325,0,3,0
72552,2,2,254324,254325,254327,1,3,0
72553,1,2,254325,254327,254329,2,4,0
72554,2,1,254327,254329,254330,2,3,0
72555,4,3,254331,254331,254334,0,3,1
72556,3,3,254334,254334,254337,0,3,0
72557,1,1,254335,254337,254338,2,3,0
72558,1,3,254336,254338,254341,2,5,0
72559,3,2,254339,254341,254343,2,4,0
72560,1,3,254340,254343,254346,3,6,0
72561,1,1,254341,254346,254347,5,6,0
72562,4,2,254345,254347,254349,2,4,0
72563,6,3,254351,254351,254354,0,3,2
72564,2,2,254353,254354,254356,1,3,0
72565,4,2,254357,254357,254359,0,2,1
72566,6,2,254363,254363,254365,0,2,4
72567,5,3,254368,254368,254371,0,3,3
72568,4,2,254372,254372,254374,0,2,1
72569,5,2,254377,254377,254379,0,2,3
72570,2,2,254379,254379,254381,0,2,0
72571,5,2,254384,254384,254386,0,2,3
72572,1,1,254385,254386,254387,1,2,0
72573,2,1,254387,254387,254388,0,1,0
72574,1,3,254388,254388,254391,0,3,0
72575,4,3,254392,254392,254395,0,3,1
72576,5,2,254397,254397,254399,0,2,2
72577,3,3,254400,254400,254403,0,3,1
72578,6,3,254406,254406,254409,0,3,3
72579,4,1,254410,254410,254411,0,1,1
72580,6,2,254416,254416,254418,0,2,5
72581,4,2,254420,254420,254422,0,2,2
72582,3,1,254423,254423,254424,0,1,1
72583,6,2,254429,254429,254431,0,2,5
72584,1,3,254430,254431,254434,1,4,0
72585,6,2,254436,254436,254438,0,2,2
72586,2,2,254438,254438,254440,0,2,0
72587,6,1,254444,254444,254445,0,1,4
72588,2,3,254446,254446,254449,0,3,1
72589,2,1,254448,254449,254450,1,2,0
72590,1,2,254449,254450,254452,1,3,0
72591,5,3,254454,254454,254457,0,3,2
72592,5,1,254459,254459,254460,0,1,2
72593,4,2,254463,254463,254465,0,2,3
72594,4,3,254467,254467,254470,0,3,2
72595,5,2,254472,254472,254474,0,2,2
72596,6,3,254478,254478,254481,0,3,4
72597,5,1,254483,254483,254484,0,1,2
72598,2,3,254485,254485,254488,0,3,1
72599,6,1,254491,254491,254492,0,1,3
72600,2,3,254493,254493,254496,0,3,1
72601,5,1,254498,254498,254499,0,1,2
72602,1,3,254499,254499,254502,0,3,0
72603,6,3,254505,254505,254508,0,3,3
72604,2,1,254507,254508,254509,1,2,0
72605,6,3,254513,254513,254516,0,3,4
72606,6,2,254519,254519,254521,0,2,3
72607,6,3,254525,254525,254528,0,3,4
72608,6,3,254531,254531,254534,0,3,3
72609,2,2,254533,254534,254536,1,3,0
72610,1,3,254534,254536,254539,2,5,0
72611,4,3,254538,254539,254542,1,4,0
72612,5,2,254543,254543,254545,0,2,1
72613,4,2,254547,254547,254549,0,2,2
72614,4,2,254551,254551,254553,0,2,2
72615,3,3,254554,254554,254557,0,3,1
72616,6,3,254560,254560,254563,0,3,3
72617,5,2,254565,254565,254567,0,2,2
72618,5,2,254570,254570,254572,0,2,3
72619,4,1,254574,254574,254575,0,1,2
72620,3,1,254577,254577,254578,0,1,2
72621,3,2,254580,254580,254582,0,2,2
72622,3,1,254583,254583,254584,0,1,1
72623,2,1,254585,254585,254586,0,1,1
72624,3,1,254588,254588,254589,0,1,2
72625,6,3,254594,254594,254597,0,3,5
72626,4,2,254598,254598,254600,0,2,1
72627,2,2,254600,254600,254602,0,2,0
72628,5,1,254605,254605,254606,0,1,3
72629,3,3,254608,254608,254611,0,3,2
72630,5,2,254613,254613,254615,0,2,2
72631,4,3,254617,254617,254620,0,3,2
72632,1,3,254618,254620,254623,2,5,0
72633,3,2,254621,254623,254625,2,4,0
72634,5,1,254626,254626,254627,0,1,1
72635,5,2,254631,254631,254633,0,2,4
72636,4,1,254635,254635,254636,0,1,2
72637,1,3,254636,254636,254639,0,3,0
72638,4,1,254640,254640,254641,0,1,1
72639,2,1,254642,254642,254643,0,1,1
72640,4,1,254646,254646,254647,0,1,3
72641,2,3,254648,254648,254651,0,3,1
72642,3,1,254651,254651,254652,0,1,0
72643,4,3,254655,254655,254658,0,3,3
72644,6,3,254661,254661,254664,0,3,3
72645,6,2,254667,254667,254669,0,2,3
72646,5,2,254672,254672,254674,0,2,3
72647,4,2,254676,254676,254678,0,2,2
72648,4,2,254680,254680,254682,0,2,2
72649,4,2,254684,254684,254686,0,2,2
72650,5,1,254689,254689,254690,0,1,3
72651,2,1,254691,254691,254692,0,1,1
72652,4,2,254695,254695,254697,0,2,3
72653,1,3,254696,254697,254700,1,4,0
72654,2,1,254698,254700,254701,2,3,0
72655,3,3,254701,254701,254704,0,3,0
72656,6,2,254707,254707,254709,0,2,3
72657,6,2,254713,254713,254715,0,2,4
72658,3,1,254716,254716,254717,0,1,1
72659,3,3,254719,254719,254722,0,3,2
72660,1,1,254720,254722,254723,2,3,0
72661,1,3,254721,254723,254726,2,5,0
72662,1,3,254722,254726,254729,4,7,0
72663,6,3,254728,254729,254732,1,4,0
72664,6,2,254734,254734,254736,0,2,2
72665,2,1,254736,254736,254737,0,1,0
72666,1,2,254737,254737,254739,0,2,0
72667,6,3,254743,254743,254746,0,3,4
72668,5,2,254748,254748,254750,0,2,2
72669,6,3,254754,254754,254757,0,3,4
72670,3,3,254757,254757,254760,0,3,0
72671,5,3,254762,254762,254765,0,3,2
72672,4,3,254766,254766,254769,0,3,1
72673,6,1,254772,254772,254773,0,1,3
72674,1,2,254773,254773,254775,0,2,0
72675,5,2,254778,254778,254780,0,2,3
72676,6,3,254784,254784,254787,0,3,4
72677,5,2,254789,254789,254791,0,2,2
72678,6,2,254795,254795,254797,0,2,4
72679,1,3,254796,254797,254800,1,4,0
72680,6,1,254802,254802,254803,0,1,2
72681,1,2,254803,254803,254805,0,2,0
72682,6,1,254809,254809,254810,0,1,4
72683,3,1,254812,254812,254813,0,1,2
72684,6,1,254818,254818,254819,0,1,5
72685,5,1,254823,254823,254824,0,1,4
72686,2,2,254825,254825,254827,0,2,1
72687,3,2,254828,254828,254830,0,2,1
72688,5,2,254833,254833,254835,0,2,3
72689,5,3,254838,254838,254841,0,3,3
72690,3,3,254841,254841,254844,0,3,0
72691,4,2,254845,254845,254847,0,2,1
72692,5,3,254850,254850,254853,0,3,3
72693,4,3,254854,254854,254857,0,3,1
72694,3,1,254857,254857,254858,0,1,0
72695,6,2,254863,254863,254865,0,2,5
72696,5,3,254868,254868,254871,0,3,3
72697,1,2,254869,254871,254873,2,4,0
72698,3,2,254872,254873,254875,1,3,0
72699,3,3,254875,254875,254878,0,3,0
72700,5,2,254880,254880,254882,0,2,2
72701,5,2,254885,254885,254887,0,2,3
72702,5,2,254890,254890,254892,0,2,3
72703,4,2,254894,254894,254896,0,2,2
72704,2,2,254896,254896,254898,0,2,0
72705,5,3,254901,254901,254904,0,3,3
72706,4,2,254905,254905,254907,0,2,1
72707,3,3,254908,254908,254911,0,3,1
72708,2,3,254910,254911,254914,1,4,0
72709,5,2,254915,254915,254917,0,2,1
72710,1,3,254916,254917,254920,1,4,0
72711,4,2,254920,254920,254922,0,2,0
72712,2,3,254922,254922,254925,0,3,0
72713,5,3,254927,254927,254930,0,3,2
72714,1,2,254928,254930,254932,2,4,0
72715,1,2,254929,254932,254934,3,5,0
72716,1,1,254930,254934,254935,4,5,0
72717,2,3,254932,254935,254938,3,6,0
72718,6,1,254938,254938,254939,0,1,0
72719,1,3,254939,254939,254942,0,3,0
72720,3,3,254942,254942,254945,0,3,0
72721,2,1,254944,254945,254946,1,2,0
72722,5,3,254949,254949,254952,0,3,3
72723,2,1,254951,254952,254953,1,2,0
72724,5,1,254956,254956,254957,0,1,3
72725,6,3,254962,254962,254965,0,3,5
72726,5,3,254967,254967,254970,0,3,2
72727,3,2,254970,254970,254972,0,2,0
72728,3,3,254973,254973,254976,0,3,1
72729,2,3,254975,254976,254979,1,4,0
72730,5,2,254980,254980,254982,0,2,1
72731,1,3,254981,254982,254985,1,4,0
72732,5,2,254986,254986,254988,0,2,1
72733,3,2,254989,254989,254991,0,2,1
72734,1,3,254990,254991,254994,1,4,0
72735,6,1,254996,254996,254997,0,1,2
72736,4,3,255000,255000,255003,0,3,3
72737,1,3,255001,255003,255006,2,5,0
72738,6,3,255007,255007,255010,0,3,1
72739,4,3,255011,255011,255014,0,3,1
72740,1,1,255012,255014,255015,2,3,0
72741,4,1,255016,255016,255017,0,1,1
72742,1,1,255017,255017,255018,0,1,0
72743,2,3,255019,255019,255022,0,3,1
72744,3,1,255022,255022,255023,0,1,0
72745,4,1,255026,255026,255027,0,1,3
72746,2,1,255028,255028,255029,0,1,1
72747,1,2,255029,255029,255031,0,2,0
72748,3,3,255032,255032,255035,0,3,1
72749,5,2,255037,255037,255039,0,2,2
72750,5,3,255042,255042,255045,0,3,3
72751,3,2,255045,255045,255047,0,2,0
72752,5,3,255050,255050,255053,0,3,3
72753,5,3,255055,255055,255058,0,3,2
72754,1,2,255056,255058,255060,2,4,0
72755,4,3,255060,255060,255063,0,3,0
72756,2,1,255062,255063,255064,1,2,0
72757,3,1,255065,255065,255066,0,1,1
72758,2,1,255067,255067,255068,0,1,1
72759,5,2,255072,255072,255074,0,2,4
72760,4,1,255076,255076,255077,0,1,2
72761,5,2,255081,255081,255083,0,2,4
72762,4,3,255085,255085,255088,0,3,2
72763,2,2,255087,255088,255090,1,3,0
72764,4,2,255091,255091,255093,0,2,1
72765,1,2,255092,255093,255095,1,3,0
72766,4,2,255096,255096,255098,0,2,1
72767,3,1,255099,255099,255100,0,1,1
72768,5,2,255104,255104,255106,0,2,4
72769,3,2,255107,255107,255109,0,2,1
72770,2,1,255109,255109,255110,0,1,0
72771,3,1,255112,255112,255113,0,1,2
72772,4,1,255116,255116,255117,0,1,3
72773,2,3,255118,255118,255121,0,3,1
72774,5,3,255123,255123,255126,0,3,2
72775,2,1,255125,255126,255127,1,2,0
72776,1,1,255126,255127,255128,1,2,0
72777,1,2,255127,255128,255130,1,3,0
72778,3,1,255130,255130,255131,0,1,0
72779,2,3,255132,255132,255135,0,3,1
72780,1,2,255133,255135,255137,2,4,0
72781,1,2,255134,255137,255139,3,5,0
72782,6,2,255140,255140,255142,0,2,1
72783,5,1,255145,255145,255146,0,1,3
72784,6,1,255151,255151,255152,0,1,5
72785,2,1,255153,255153,255154,0,1,1
72786,1,3,255154,255154,255157,0,3,0
72787,2,3,255156,255157,255160,1,4,0
72788,4,1,255160,255160,255161,0,1,0
72789,2,3,255162,255162,255165,0,3,1
72790,4,2,255166,255166,255168,0,2,1
72791,2,3,255168,255168,255171,0,3,0
72792,4,1,255172,255172,255173,0,1,1
72793,4,1,255176,255176,255177,0,1,3
72794,6,1,255182,255182,255183,0,1,5
72795,3,1,255185,255185,255186,0,1,2
72796,4,3,255189,255189,255192,0,3,3
72797,6,2,255195,255195,255197,0,2,3
72798,5,3,255200,255200,255203,0,3,3
72799,1,3,255201,255203,255206,2,5,0
72800,5,1,255206,255206,255207,0,1,0
72801,3,1,255209,255209,255210,0,1,2
72802,4,1,255213,255213,255214,0,1,3
72803,1,2,255214,255214,255216,0,2,0
72804,4,1,255218,255218,255219,0,1,2
72805,2,3,255220,255220,255223,0,3,1
72806,1,3,255221,255223,255226,2,5,0
72807,2,2,255223,255226,255228,3,5,0
72808,5,2,255228,255228,255230,0,2,0
72809,3,3,255231,255231,255234,0,3,1
72810,2,3,255233,255234,255237,1,4,0
72811,6,3,255239,255239,255242,0,3,2
72812,6,3,255245,255245,255248,0,3,3
72813,4,2,255249,255249,255251,0,2,1
72814,3,2,255252,255252,255254,0,2,1
72815,3,3,255255,255255,255258,0,3,1
72816,4,3,255259,255259,255262,0,3,1
72817,2,2,255261,255262,255264,1,3,0
72818,2,3,255263,255264,255267,1,4,0
72819,3,2,255266,255267,255269,1,3,0
72820,1,3,255267,255269,255272,2,5,0
72821,5,1,255272,255272,255273,0,1,0
72822,3,2,255275,255275,255277,0,2,2
72823,6,1,255281,255281,255282,0,1,4
72824,3,3,255284,255284,255287,0,3,2
72825,5,2,255289,255289,255291,0,2,2
72826,6,2,255295,255295,255297,0,2,4
72827,4,3,255299,255299,255302,0,3,2
72828,1,1,255300,255302,255303,2,3,0
72829,4,2,255304,255304,255306,0,2,1
72830,6,3,255310,255310,255313,0,3,4
72831,4,3,255314,255314,255317,0,3,1
72832,3,1,255317,255317,255318,0,1,0
72833,2,2,255319,255319,255321,0,2,1
72834,5,1,255324,255324,255325,0,1,3
72835,2,2,255326,255326,255328,0,2,1
72836,3,3,255329,255329,255332,0,3,1
72837,5,3,255334,255334,255337,0,3,2
72838,3,3,255337,255337,255340,0,3,0
72839,4,1,255341,255341,255342,0,1,1
72840,2,3,255343,255343,255346,0,3,1
72841,2,3,255345,255346,255349,1,4,0
72842,3,2,255348,255349,255351,1,3,0
72843,4,1,255352,255352,255353,0,1,1
72844,3,2,255355,255355,255357,0,2,2
72845,3,3,255358,255358,255361,0,3,1
72846,3,2,255361,255361,255363,0,2,0
72847,1,2,255362,255363,255365,1,3,0
72848,6,3,255368,255368,255371,0,3,3
72849,6,2,255374,255374,255376,0,2,3
72850,2,1,255376,255376,255377,0,1,0
72851,4,2,255380,255380,255382,0,2,3
72852,2,2,255382,255382,255384,0,2,0
72853,5,2,255387,255387,255389,0,2,3
72854,6,1,255393,255393,255394,0,1,4
72855,5,2,255398,255398,255400,0,2,4
72856,4,2,255402,255402,255404,0,2,2
72857,3,2,255405,255405,255407,0,2,1
72858,3,1,255408,255408,255409,0,1,1
72859,5,2,255413,255413,255415,0,2,4
72860,2,1,255415,255415,255416,0,1,0
72861,2,1,255417,255417,255418,0,1,1
72862,1,3,255418,255418,255421,0,3,0
72863,2,2,255420,255421,255423,1,3,0
72864,4,3,255424,255424,255427,0,3,1
72865,2,3,255426,255427,255430,1,4,0
72866,6,1,255432,255432,255433,0,1,2
72867,5,1,255437,255437,255438,0,1,4
72868,5,1,255442,255442,255443,0,1,4
72869,2,3,255444,255444,255447,0,3,1
72870,6,1,255450,255450,255451,0,1,3
72871,3,2,255453,255453,255455,0,2,2
72872,5,1,255458,255458,255459,0,1,3
72873,4,1,255462,255462,255463,0,1,3
72874,4,1,255466,255466,255467,0,1,3
72875,1,1,255467,255467,255468,0,1,0
72876,5,1,255472,255472,255473,0,1,4
72877,1,3,255473,255473,255476,0,3,0
72878,5,2,255478,255478,255480,0,2,2
72879,2,2,255480,255480,255482,0,2,0
72880,2,3,255482,255482,255485,0,3,0
72881,6,3,255488,255488,255491,0,3,3
72882,1,3,255489,255491,255494,2,5,0
72883,3,3,255492,255494,255497,2,5,0
72884,1,3,255493,255497,255500,4,7,0
72885,2,2,255495,255500,255502,5,7,0
72886,6,1,255501,255502,255503,1,2,0
72887,5,2,255506,255506,255508,0,2,3
72888,6,1,255512,255512,255513,0,1,4
72889,4,2,255516,255516,255518,0,2,3
72890,3,2,255519,255519,255521,0,2,1
72891,6,3,255525,255525,255528,0,3,4
72892,1,3,255526,255528,255531,2,5,0
72893,3,3,255529,255531,255534,2,5,0
72894,6,1,255535,255535,255536,0,1,1
72895,5,2,255540,255540,255542,0,2,4
72896,1,1,255541,255542,255543,1,2,0
72897,2,2,255543,255543,255545,0,2,0
72898,5,3,255548,255548,255551,0,3,3
72899,4,1,255552,255552,255553,0,1,1
72900,2,1,255554,255554,255555,0,1,1
72901,3,2,255557,255557,255559,0,2,2
72902,5,2,255562,255562,255564,0,2,3
72903,3,1,255565,255565,255566,0,1,1
72904,2,2,255567,255567,255569,0,2,1
72905,4,2,255571,255571,255573,0,2,2
72906,2,2,255573,255573,255575,0,2,0
72907,6,1,255579,255579,255580,0,1,4
72908,3,1,255582,255582,255583,0,1,2
72909,4,3,255586,255586,255589,0,3,3
72910,2,3,255588,255589,255592,1,4,0
72911,3,2,255591,255592,255594,1,3,0
72912,3,2,255594,255594,255596,0,2,0
72913,4,2,255598,255598,255600,0,2,2
72914,3,1,255601,255601,255602,0,1,1
72915,1,3,255602,255602,255605,0,3,0
72916,6,2,255608,255608,255610,0,2,3
72917,3,3,255611,255611,255614,0,3,1
72918,1,1,255612,255614,255615,2,3,0
72919,3,3,255615,255615,255618,0,3,0
72920,4,2,255619,255619,255621,0,2,1
72921,2,3,255621,255621,255624,0,3,0
72922,2,1,255623,255624,255625,1,2,0
72923,3,2,255626,255626,255628,0,2,1
72924,1,2,255627,255628,255630,1,3,0
72925,5,3,255632,255632,255635,0,3,2
72926,6,2,255638,255638,255640,0,2,3
72927,4,2,255642,255642,255644,0,2,2
72928,3,2,255645,255645,255647,0,2,1
72929,1,2,255646,255647,255649,1,3,0
72930,1,1,255647,255649,255650,2,3,0
72931,4,1,255651,255651,255652,0,1,1
72932,6,1,255657,255657,255658,0,1,5
72933,5,3,255662,255662,255665,0,3,4
72934,1,3,255663,255665,255668,2,5,0
72935,3,1,255666,255668,255669,2,3,0
72936,6,3,255672,255672,255675,0,3,3
72937,4,1,255676,255676,255677,0,1,1
72938,1,3,255677,255677,255680,0,3,0
72939,5,3,255682,255682,255685,0,3,2
72940,5,2,255687,255687,255689,0,2,2
72941,4,2,255691,255691,255693,0,2,2
72942,1,3,255692,255693,255696,1,4,0
72943,3,3,255695,255696,255699,1,4,0
72944,2,1,255697,255699,255700,2,3,0
72945,1,3,255698,255700,255703,2,5,0
72946,5,1,255703,255703,255704,0,1,0
72947,3,1,255706,255706,255707,0,1,2
72948,1,3,255707,255707,255710,0,3,0
72949,5,3,255712,255712,255715,0,3,2
72950,5,1,255717,255717,255718,0,1,2
72951,2,2,255719,255719,255721,0,2,1
72952,6,2,255725,255725,255727,0,2,4
72953,5,3,255730,255730,255733,0,3,3
72954,1,2,255731,255733,255735,2,4,0
72955,4,1,255735,255735,255736,0,1,0
72956,4,1,255739,255739,255740,0,1,3
72957,1,2,255740,255740,255742,0,2,0
72958,1,3,255741,255742,255745,1,4,0
72959,4,2,255745,255745,255747,0,2,0
72960,1,1,255746,255747,255748,1,2,0
72961,3,1,255749,255749,255750,0,1,1
72962,5,3,255754,255754,255757,0,3,4
72963,6,2,255760,255760,255762,0,2,3
72964,3,1,255763,255763,255764,0,1,1
72965,3,1,255766,255766,255767,0,1,2
72966,2,3,255768,255768,255771,0,3,1
72967,3,1,255771,255771,255772,0,1,0
72968,2,2,255773,255773,255775,0,2,1
72969,1,1,255774,255775,255776,1,2,0
72970,6,2,255780,255780,255782,0,2,4
72971,5,2,255785,255785,255787,0,2,3
72972,2,3,255787,255787,255790,0,3,0
72973,4,1,255791,255791,255792,0,1,1
72974,6,3,255797,255797,255800,0,3,5
72975,5,2,255802,255802,255804,0,2,2
72976,6,2,255808,255808,255810,0,2,4
72977,6,3,255814,255814,255817,0,3,4
72978,3,1,255817,255817,255818,0,1,0
72979,4,3,255821,255821,255824,0,3,3
72980,6,1,255827,255827,255828,0,1,3
72981,1,2,255828,255828,255830,0,2,0
72982,3,3,255831,255831,255834,0,3,1
72983,1,1,255832,255834,255835,2,3,0
72984,2,2,255834,255835,255837,1,3,0
72985,1,1,255835,255837,255838,2,3,0
72986,4,3,255839,255839,255842,0,3,1
72987,4,2,255843,255843,255845,0,2,1
72988,1,3,255844,255845,255848,1,4,0
72989,6,1,255850,255850,255851,0,1,2
72990,3,3,255853,255853,255856,0,3,2
72991,6,1,255859,255859,255860,0,1,3
72992,5,1,255864,255864,255865,0,1,4
72993,1,2,255865,255865,255867,0,2,0
72994,1,1,255866,255867,255868,1,2,0
72995,5,3,255871,255871,255874,0,3,3
72996,6,2,255877,255877,255879,0,2,3
72997,5,3,255882,255882,255885,0,3,3
72998,6,1,255888,255888,255889,0,1,3
72999,4,1,255892,255892,255893,0,1,3
73000,1,3,255893,255893,255896,0,3,0
73001,1,1,255894,255896,255897,2,3,0
73002,1,3,255895,255897,255900,2,5,0
73003,6,1,255901,255901,255902,0,1,1
73004,5,3,255906,255906,255909,0,3,4
73005,6,2,255912,255912,255914,0,2,3
73006,6,1,255918,255918,255919,0,1,4
73007,1,1,255919,255919,255920,0,1,0
73008,1,3,255920,255920,255923,0,3,0
73009,3,2,255923,255923,255925,0,2,0
73010,3,1,255926,255926,255927,0,1,1
73011,5,1,255931,255931,255932,0,1,4
73012,2,3,255933,255933,255936,0,3,1
73013,2,3,255935,255936,255939,1,4,0
73014,3,1,255938,255939,255940,1,2,0
73015,6,1,255944,255944,255945,0,1,4
73016,1,1,255945,255945,255946,0,1,0
73017,5,3,255950,255950,255953,0,3,4
73018,4,2,255954,255954,255956,0,2,1
73019,6,3,255960,255960,255963,0,3,4
73020,6,1,255966,255966,255967,0,1,3
73021,1,2,255967,255967,255969,0,2,0
73022,4,1,255971,255971,255972,0,1,2
73023,6,3,255977,255977,255980,0,3,5
73024,2,2,255979,255980,255982,1,3,0
73025,2,3,255981,255982,255985,1,4,0
73026,3,3,255984,255985,255988,1,4,0
73027,1,2,255985,255988,255990,3,5,0
73028,6,3,255991,255991,255994,0,3,1
73029,3,1,255994,255994,255995,0,1,0
73030,3,1,255997,255997,255998,0,1,2
73031,6,1,256003,256003,256004,0,1,5
73032,4,1,256007,256007,256008,0,1,3
73033,5,1,256012,256012,256013,0,1,4
73034,6,2,256018,256018,256020,0,2,5
73035,1,1,256019,256020,256021,1,2,0
73036,2,1,256021,256021,256022,0,1,0
73037,5,3,256026,256026,256029,0,3,4
73038,1,1,256027,256029,256030,2,3,0
73039,4,3,256031,256031,256034,0,3,1
73040,6,1,256037,256037,256038,0,1,3
73041,6,3,256043,256043,256046,0,3,5
73042,1,2,256044,256046,256048,2,4,0
73043,4,2,256048,256048,256050,0,2,0
73044,3,2,256051,256051,256053,0,2,1
73045,5,2,256056,256056,256058,0,2,3
73046,1,3,256057,256058,256061,1,4,0
73047,1,2,256058,256061,256063,3,5,0
73048,2,1,256060,256063,256064,3,4,0
73049,2,1,256062,256064,256065,2,3,0
73050,4,1,256066,256066,256067,0,1,1
73051,4,1,256070,256070,256071,0,1,3
73052,3,1,256073,256073,256074,0,1,2
73053,2,3,256075,256075,256078,0,3,1
73054,1,3,256076,256078,256081,2,5,0
73055,4,2,256080,256081,256083,1,3,0
73056,6,2,256086,256086,256088,0,2,3
73057,2,2,256088,256088,256090,0,2,0
73058,3,1,256091,256091,256092,0,1,1
73059,1,3,256092,256092,256095,0,3,0
73060,6,1,256098,256098,256099,0,1,3
73061,5,2,256103,256103,256105,0,2,4
73062,1,1,256104,256105,256106,1,2,0
73063,2,1,256106,256106,256107,0,1,0
73064,2,1,256108,256108,256109,0,1,1
73065,6,2,256114,256114,256116,0,2,5
73066,3,1,256117,256117,256118,0,1,1
73067,3,1,256120,256120,256121,0,1,2
73068,5,2,256125,256125,256127,0,2,4
73069,2,1,256127,256127,256128,0,1,0
73070,3,2,256130,256130,256132,0,2,2
73071,2,1,256132,256132,256133,0,1,0
73072,6,2,256138,256138,256140,0,2,5
73073,4,3,256142,256142,256145,0,3,2
73074,5,2,256147,256147,256149,0,2,2
73075,3,1,256150,256150,256151,0,1,1
73076,1,1,256151,256151,256152,0,1,0
73077,1,3,256152,256152,256155,0,3,0
73078,5,2,256157,256157,256159,0,2,2
73079,6,1,256163,256163,256164,0,1,4
73080,5,2,256168,256168,256170,0,2,4
73081,5,2,256173,256173,256175,0,2,3
73082,6,3,256179,256179,256182,0,3,4
73083,5,1,256184,256184,256185,0,1,2
73084,6,3,256190,256190,256193,0,3,5
73085,4,2,256194,256194,256196,0,2,1
73086,4,3,256198,256198,256201,0,3,2
73087,1,3,256199,256201,256204,2,5,0
73088,2,2,256201,256204,256206,3,5,0
73089,2,2,256203,256206,256208,3,5,0
73090,4,3,256207,256208,256211,1,4,0
73091,2,2,256209,256211,256213,2,4,0
73092,3,2,256212,256213,256215,1,3,0
73093,3,3,256215,256215,256218,0,3,0
73094,6,3,256221,256221,256224,0,3,3
73095,6,1,256227,256227,256228,0,1,3
73096,4,1,256231,256231,256232,0,1,3
73097,3,1,256234,256234,256235,0,1,2
73098,3,1,256237,256237,256238,0,1,2
73099,6,3,256243,256243,256246,0,3,5
73100,2,1,256245,256246,256247,1,2,0
73101,1,2,256246,256247,256249,1,3,0
73102,3,2,256249,256249,256251,0,2,0
73103,6,3,256255,256255,256258,0,3,4
73104,2,2,256257,256258,256260,1,3,0
73105,1,1,256258,256260,256261,2,3,0
73106,5,2,256263,256263,256265,0,2,2
73107,4,3,256267,256267,256270,0,3,2
73108,3,1,256270,256270,256271,0,1,0
73109,4,2,256274,256274,256276,0,2,3
73110,4,2,256278,256278,256280,0,2,2
73111,6,2,256284,256284,256286,0,2,4
73112,6,1,256290,256290,256291,0,1,4
73113,2,2,256292,256292,256294,0,2,1
73114,2,3,256294,256294,256297,0,3,0
73115,2,3,256296,256297,256300,1,4,0
73116,2,3,256298,256300,256303,2,5,0
73117,1,3,256299,256303,256306,4,7,0
73118,3,3,256302,256306,256309,4,7,0
73119,3,2,256305,256309,256311,4,6,0
73120,2,3,256307,256311,256314,4,7,0
73121,1,3,256308,256314,256317,6,9,0
73122,6,3,256314,256317,256320,3,6,0
73123,5,1,256319,256320,256321,1,2,0
73124,4,3,256323,256323,256326,0,3,2
73125,4,3,256327,256327,256330,0,3,1
73126,6,1,256333,256333,256334,0,1,3
73127,3,3,256336,256336,256339,0,3,2
73128,3,3,256339,256339,256342,0,3,0
73129,1,1,256340,256342,256343,2,3,0
73130,2,1,256342,256343,256344,1,2,0
73131,1,3,256343,256344,256347,1,4,0
73132,5,1,256348,256348,256349,0,1,1
73133,1,2,256349,256349,256351,0,2,0
73134,1,1,256350,256351,256352,1,2,0
73135,2,1,256352,256352,256353,0,1,0
73136,1,3,256353,256353,256356,0,3,0
73137,5,1,256358,256358,256359,0,1,2
73138,5,2,256363,256363,256365,0,2,4
73139,4,2,256367,256367,256369,0,2,2
73140,6,1,256373,256373,256374,0,1,4
73141,6,2,256379,256379,256381,0,2,5
73142,1,2,256380,256381,256383,1,3,0
73143,2,1,256382,256383,256384,1,2,0
73144,6,3,256388,256388,256391,0,3,4
73145,5,2,256393,256393,256395,0,2,2
73146,2,3,256395,256395,256398,0,3,0
73147,3,2,256398,256398,256400,0,2,0
73148,6,3,256404,256404,256407,0,3,4
73149,2,3,256406,256407,256410,1,4,0
73150,6,3,256412,256412,256415,0,3,2
73151,2,1,256414,256415,256416,1,2,0
73152,4,1,256418,256418,256419,0,1,2
73153,1,2,256419,256419,256421,0,2,0
73154,4,2,256423,256423,256425,0,2,2
73155,2,2,256425,256425,256427,0,2,0
73156,4,2,256429,256429,256431,0,2,2
73157,2,1,256431,256431,256432,0,1,0
73158,3,2,256434,256434,256436,0,2,2
73159,1,3,256435,256436,256439,1,4,0
73160,1,3,256436,256439,256442,3,6,0
73161,4,3,256440,256442,256445,2,5,0
73162,4,1,256444,256445,256446,1,2,0
73163,5,3,256449,256449,256452,0,3,3
73164,1,1,256450,256452,256453,2,3,0
73165,1,3,256451,256453,256456,2,5,0
73166,6,3,256457,256457,256460,0,3,1
73167,1,1,256458,256460,256461,2,3,0
73168,3,1,256461,256461,256462,0,1,0
73169,2,3,256463,256463,256466,0,3,1
73170,5,1,256468,256468,256469,0,1,2
73171,2,2,256470,256470,256472,0,2,1
73172,1,2,256471,256472,256474,1,3,0
73173,6,2,256477,256477,256479,0,2,3
73174,4,1,256481,256481,256482,0,1,2
73175,1,1,256482,256482,256483,0,1,0
73176,1,2,256483,256483,256485,0,2,0
73177,1,1,256484,256485,256486,1,2,0
73178,6,2,256490,256490,256492,0,2,4
73179,4,1,256494,256494,256495,0,1,2
73180,1,3,256495,256495,256498,0,3,0
73181,6,3,256501,256501,256504,0,3,3
73182,1,1,256502,256504,256505,2,3,0
73183,1,3,256503,256505,256508,2,5,0
73184,5,2,256508,256508,256510,0,2,0
73185,5,3,256513,256513,256516,0,3,3
73186,5,1,256518,256518,256519,0,1,2
73187,6,2,256524,256524,256526,0,2,5
73188,5,3,256529,256529,256532,0,3,3
73189,5,2,256534,256534,256536,0,2,2
73190,3,1,256537,256537,256538,0,1,1
73191,3,1,256540,256540,256541,0,1,2
73192,4,1,256544,256544,256545,0,1,3
73193,4,1,256548,256548,256549,0,1,3
73194,3,1,256551,256551,256552,0,1,2
73195,4,3,256555,256555,256558,0,3,3
73196,6,2,256561,256561,256563,0,2,3
73197,2,3,256563,256563,256566,0,3,0
73198,2,1,256565,256566,256567,1,2,0
73199,5,1,256570,256570,256571,0,1,3
73200,6,1,256576,256576,256577,0,1,5
73201,1,1,256577,256577,256578,0,1,0
73202,1,3,256578,256578,256581,0,3,0
73203,6,3,256584,256584,256587,0,3,3
73204,4,1,256588,256588,256589,0,1,1
73205,2,3,256590,256590,256593,0,3,1
73206,4,3,256594,256594,256597,0,3,1
73207,1,3,256595,256597,256600,2,5,0
73208,6,1,256601,256601,256602,0,1,1
73209,5,1,256606,256606,256607,0,1,4
73210,3,1,256609,256609,256610,0,1,2
73211,5,3,256614,256614,256617,0,3,4
73212,3,1,256617,256617,256618,0,1,0
73213,5,3,256622,256622,256625,0,3,4
73214,5,1,256627,256627,256628,0,1,2
73215,5,2,256632,256632,256634,0,2,4
73216,4,3,256636,256636,256639,0,3,2
73217,6,2,256642,256642,256644,0,2,3
73218,4,2,256646,256646,256648,0,2,2
73219,5,1,256651,256651,256652,0,1,3
73220,3,2,256654,256654,256656,0,2,2
73221,3,2,256657,256657,256659,0,2,1
73222,6,1,256663,256663,256664,0,1,4
73223,3,1,256666,256666,256667,0,1,2
73224,1,3,256667,256667,256670,0,3,0
73225,4,2,256671,256671,256673,0,2,1
73226,3,1,256674,256674,256675,0,1,1
73227,1,2,256675,256675,256677,0,2,0
73228,1,2,256676,256677,256679,1,3,0
73229,5,2,256681,256681,256683,0,2,2
73230,2,3,256683,256683,256686,0,3,0
73231,4,1,256687,256687,256688,0,1,1
73232,4,1,256691,256691,256692,0,1,3
73233,6,2,256697,256697,256699,0,2,5
73234,2,3,256699,256699,256702,0,3,0
73235,2,3,256701,256702,256705,1,4,0
73236,1,3,256702,256705,256708,3,6,0
73237,4,2,256706,256708,256710,2,4,0
73238,3,1,256709,256710,256711,1,2,0
73239,3,1,256712,256712,256713,0,1,1
73240,3,2,256715,256715,256717,0,2,2
73241,4,3,256719,256719,256722,0,3,2
73242,5,1,256724,256724,256725,0,1,2
73243,5,3,256729,256729,256732,0,3,4
73244,1,3,256730,256732,256735,2,5,0
73245,3,3,256733,256735,256738,2,5,0
73246,3,1,256736,256738,256739,2,3,0
73247,1,2,256737,256739,256741,2,4,0
73248,2,1,256739,256741,256742,2,3,0
73249,1,2,256740,256742,256744,2,4,0
73250,4,3,256744,256744,256747,0,3,0
73251,1,3,256745,256747,256750,2,5,0
73252,5,1,256750,256750,256751,0,1,0
73253,5,1,256755,256755,256756,0,1,4
73254,3,2,256758,256758,256760,0,2,2
73255,3,3,256761,256761,256764,0,3,1
73256,1,3,256762,256764,256767,2,5,0
73257,6,1,256768,256768,256769,0,1,1
73258,6,3,256774,256774,256777,0,3,5
73259,3,1,256777,256777,256778,0,1,0
73260,4,1,256781,256781,256782,0,1,3
73261,5,2,256786,256786,256788,0,2,4
73262,1,3,256787,256788,256791,1,4,0
73263,6,3,256793,256793,256796,0,3,2
73264,5,2,256798,256798,256800,0,2,2
73265,3,2,256801,256801,256803,0,2,1
73266,5,1,256806,256806,256807,0,1,3
73267,6,2,256812,256812,256814,0,2,5
73268,6,1,256818,256818,256819,0,1,4
73269,4,1,256822,256822,256823,0,1,3
73270,1,2,256823,256823,256825,0,2,0
73271,5,1,256828,256828,256829,0,1,3
73272,6,2,256834,256834,256836,0,2,5
73273,3,1,256837,256837,256838,0,1,1
73274,6,3,256843,256843,256846,0,3,5
73275,5,2,256848,256848,256850,0,2,2
73276,3,3,256851,256851,256854,0,3,1
73277,1,1,256852,256854,256855,2,3,0
73278,1,2,256853,256855,256857,2,4,0
73279,2,1,256855,256857,256858,2,3,0
73280,1,1,256856,256858,256859,2,3,0
73281,1,1,256857,256859,256860,2,3,0
73282,5,3,256862,256862,256865,0,3,2
73283,3,3,256865,256865,256868,0,3,0
73284,2,1,256867,256868,256869,1,2,0
73285,5,1,256872,256872,256873,0,1,3
73286,2,1,256874,256874,256875,0,1,1
73287,4,1,256878,256878,256879,0,1,3
73288,6,3,256884,256884,256887,0,3,5
73289,5,1,256889,256889,256890,0,1,2
73290,5,2,256894,256894,256896,0,2,4
73291,5,1,256899,256899,256900,0,1,3
73292,2,2,256901,256901,256903,0,2,1
73293,3,2,256904,256904,256906,0,2,1
73294,6,1,256910,256910,256911,0,1,4
73295,2,3,256912,256912,256915,0,3,1
73296,6,1,256918,256918,256919,0,1,3
73297,5,2,256923,256923,256925,0,2,4
73298,2,3,256925,256925,256928,0,3,0
73299,6,1,256931,256931,256932,0,1,3
73300,5,2,256936,256936,256938,0,2,4
73301,4,1,256940,256940,256941,0,1,2
73302,1,2,256941,256941,256943,0,2,0
73303,3,2,256944,256944,256946,0,2,1
73304,5,3,256949,256949,256952,0,3,3
73305,6,1,256955,256955,256956,0,1,3
73306,3,3,256958,256958,256961,0,3,2
73307,4,3,256962,256962,256965,0,3,1
73308,2,3,256964,256965,256968,1,4,0
73309,4,3,256968,256968,256971,0,3,0
73310,5,2,256973,256973,256975,0,2,2
73311,1,2,256974,256975,256977,1,3,0
73312,5,3,256979,256979,256982,0,3,2
73313,2,2,256981,256982,256984,1,3,0
73314,6,1,256987,256987,256988,0,1,3
73315,2,1,256989,256989,256990,0,1,1
73316,3,1,256992,256992,256993,0,1,2
73317,1,1,256993,256993,256994,0,1,0
73318,3,2,256996,256996,256998,0,2,2
73319,6,3,257002,257002,257005,0,3,4
73320,1,2,257003,257005,257007,2,4,0
73321,2,1,257005,257007,257008,2,3,0
73322,5,1,257010,257010,257011,0,1,2
73323,1,2,257011,257011,257013,0,2,0
73324,4,3,257015,257015,257018,0,3,2
73325,4,3,257019,257019,257022,0,3,1
73326,5,1,257024,257024,257025,0,1,2
73327,2,2,257026,257026,257028,0,2,1
73328,6,1,257032,257032,257033,0,1,4
73329,2,3,257034,257034,257037,0,3,1
73330,6,1,257040,257040,257041,0,1,3
73331,5,2,257045,257045,257047,0,2,4
73332,4,1,257049,257049,257050,0,1,2
73333,3,2,257052,257052,257054,0,2,2
73334,4,2,257056,257056,257058,0,2,2
73335,3,3,257059,257059,257062,0,3,1
73336,4,2,257063,257063,257065,0,2,1
73337,6,1,257069,257069,257070,0,1,4
73338,2,2,257071,257071,257073,0,2,1
73339,5,2,257076,257076,257078,0,2,3
73340,6,2,257082,257082,257084,0,2,4
73341,2,1,257084,257084,257085,0,1,0
73342,3,3,257087,257087,257090,0,3,2
73343,2,3,257089,257090,257093,1,4,0
73344,4,1,257093,257093,257094,0,1,0
73345,1,2,257094,257094,257096,0,2,0
73346,1,1,257095,257096,257097,1,2,0
73347,1,3,257096,257097,257100,1,4,0
73348,3,3,257099,257100,257103,1,4,0
73349,1,3,257100,257103,257106,3,6,0
73350,4,3,257104,257106,257109,2,5,0
73351,2,3,257106,257109,257112,3,6,0
73352,3,2,257109,257112,257114,3,5,0
73353,4,3,257113,257114,257117,1,4,0
73354,6,3,257119,257119,257122,0,3,2
73355,2,1,257121,257122,257123,1,2,0
73356,2,3,257123,257123,257126,0,3,0
73357,4,1,257127,257127,257128,0,1,1
73358,2,3,257129,257129,257132,0,3,1
73359,6,2,257135,257135,257137,0,2,3
73360,4,1,257139,257139,257140,0,1,2
73361,1,1,257140,257140,257141,0,1,0
73362,1,2,257141,257141,257143,0,2,0
73363,6,2,257147,257147,257149,0,2,4
73364,1,3,257148,257149,257152,1,4,0
73365,5,2,257153,257153,257155,0,2,1
73366,3,3,257156,257156,257159,0,3,1
73367,6,1,257162,257162,257163,0,1,3
73368,3,3,257165,257165,257168,0,3,2
73369,4,3,257169,257169,257172,0,3,1
73370,1,3,257170,257172,257175,2,5,0
73371,1,1,257171,257175,257176,4,5,0
73372,3,1,257174,257176,257177,2,3,0
73373,2,1,257176,257177,257178,1,2,0
73374,5,1,257181,257181,257182,0,1,3
73375,4,3,257185,257185,257188,0,3,3
73376,1,2,257186,257188,257190,2,4,0
73377,3,1,257189,257190,257191,1,2,0
73378,1,1,257190,257191,257192,1,2,0
73379,6,1,257196,257196,257197,0,1,4
73380,2,1,257198,257198,257199,0,1,1
73381,6,3,257204,257204,257207,0,3,5
73382,4,3,257208,257208,257211,0,3,1
73383,4,3,257212,257212,257215,0,3,1
73384,6,2,257218,257218,257220,0,2,3
73385,1,2,257219,257220,257222,1,3,0
73386,5,3,257224,257224,257227,0,3,2
73387,2,2,257226,257227,257229,1,3,0
73388,1,3,257227,257229,257232,2,5,0
73389,5,2,257232,257232,257234,0,2,0
73390,1,3,257233,257234,257237,1,4,0
73391,6,3,257239,257239,257242,0,3,2
73392,1,2,257240,257242,257244,2,4,0
73393,3,3,257243,257244,257247,1,4,0
73394,5,2,257248,257248,257250,0,2,1
73395,5,1,257253,257253,257254,0,1,3
73396,6,2,257259,257259,257261,0,2,5
73397,3,3,257262,257262,257265,0,3,1
73398,1,3,257263,257265,257268,2,5,0
73399,2,1,257265,257268,257269,3,4,0
73400,3,1,257268,257269,257270,1,2,0
73401,1,3,257269,257270,257273,1,4,0
73402,3,1,257272,257273,257274,1,2,0
73403,6,2,257278,257278,257280,0,2,4
73404,4,1,257282,257282,257283,0,1,2
73405,6,2,257288,257288,257290,0,2,5
73406,5,2,257293,257293,257295,0,2,3
73407,2,2,257295,257295,257297,0,2,0
73408,5,2,257300,257300,257302,0,2,3
73409,3,2,257303,257303,257305,0,2,1
73410,5,3,257308,257308,257311,0,3,3
73411,1,3,257309,257311,257314,2,5,0
73412,5,2,257314,257314,257316,0,2,0
73413,6,3,257320,257320,257323,0,3,4
73414,5,1,257325,257325,257326,0,1,2
73415,5,2,257330,257330,257332,0,2,4
73416,1,2,257331,257332,257334,1,3,0
73417,5,2,257336,257336,257338,0,2,2
73418,1,3,257337,257338,257341,1,4,0
73419,1,1,257338,257341,257342,3,4,0
73420,5,2,257343,257343,257345,0,2,1
73421,5,2,257348,257348,257350,0,2,3
73422,1,3,257349,257350,257353,1,4,0
73423,4,2,257353,257353,257355,0,2,0
73424,1,1,257354,257355,257356,1,2,0
73425,5,3,257359,257359,257362,0,3,3
73426,5,3,257364,257364,257367,0,3,2
73427,3,3,257367,257367,257370,0,3,0
73428,1,3,257368,257370,257373,2,5,0
73429,5,2,257373,257373,257375,0,2,0
73430,1,1,257374,257375,257376,1,2,0
73431,1,1,257375,257376,257377,1,2,0
73432,4,3,257379,257379,257382,0,3,2
73433,3,1,257382,257382,257383,0,1,0
73434,6,2,257388,257388,257390,0,2,5
73435,1,2,257389,257390,257392,1,3,0
73436,3,1,257392,257392,257393,0,1,0
73437,4,2,257396,257396,257398,0,2,3
73438,6,2,257402,257402,257404,0,2,4
73439,3,3,257405,257405,257408,0,3,1
73440,3,1,257408,257408,257409,0,1,0
73441,3,3,257411,257411,257414,0,3,2
73442,3,1,257414,257414,257415,0,1,0
73443,6,2,257420,257420,257422,0,2,5
73444,1,2,257421,257422,257424,1,3,0
73445,3,2,257424,257424,257426,0,2,0
73446,2,2,257426,257426,257428,0,2,0
73447,6,3,257432,257432,257435,0,3,4
73448,4,2,257436,257436,257438,0,2,1
73449,5,1,257441,257441,257442,0,1,3
73450,5,2,257446,257446,257448,0,2,4
73451,6,3,257452,257452,257455,0,3,4
73452,2,2,257454,257455,257457,1,3,0
73453,4,2,257458,257458,257460,0,2,1
73454,2,1,257460,257460,257461,0,1,0
73455,3,3,257463,257463,257466,0,3,2
73456,4,2,257467,257467,257469,0,2,1
73457,3,1,257470,257470,257471,0,1,1
73458,1,3,257471,257471,257474,0,3,0
73459,4,3,257475,257475,257478,0,3,1
73460,3,2,257478,257478,257480,0,2,0
73461,5,1,257483,257483,257484,0,1,3
73462,3,1,257486,257486,257487,0,1,2
73463,5,3,257491,257491,257494,0,3,4
73464,5,1,257496,257496,257497,0,1,2
73465,3,1,257499,257499,257500,0,1,2
73466,3,3,257502,257502,257505,0,3,2
73467,2,3,257504,257505,257508,1,4,0
73468,4,2,257508,257508,257510,0,2,0
73469,2,2,257510,257510,257512,0,2,0
73470,1,2,257511,257512,257514,1,3,0
73471,3,3,257514,257514,257517,0,3,0
73472,4,3,257518,257518,257521,0,3,1
73473,5,1,257523,257523,257524,0,1,2
73474,2,3,257525,257525,257528,0,3,1
73475,3,2,257528,257528,257530,0,2,0
73476,4,1,257532,257532,257533,0,1,2
73477,3,3,257535,257535,257538,0,3,2
73478,2,3,257537,257538,257541,1,4,0
73479,2,2,257539,257541,257543,2,4,0
73480,6,1,257545,257545,257546,0,1,2
73481,4,2,257549,257549,257551,0,2,3
73482,4,2,257553,257553,257555,0,2,2
73483,4,2,257557,257557,257559,0,2,2
73484,6,2,257563,257563,257565,0,2,4
73485,6,3,257569,257569,257572,0,3,4
73486,6,2,257575,257575,257577,0,2,3
73487,2,3,257577,257577,257580,0,3,0
73488,5,3,257582,257582,257585,0,3,2
73489,2,3,257584,257585,257588,1,4,0
73490,5,1,257589,257589,257590,0,1,1
73491,2,1,257591,257591,257592,0,1,1
73492,2,3,257593,257593,257596,0,3,1
73493,6,2,257599,257599,257601,0,2,3
73494,3,2,257602,257602,257604,0,2,1
73495,2,3,257604,257604,257607,0,3,0
73496,4,3,257608,257608,257611,0,3,1
73497,4,3,257612,257612,257615,0,3,1
73498,1,2,257613,257615,257617,2,4,0
73499,1,3,257614,257617,257620,3,6,0
73500,1,1,257615,257620,257621,5,6,0
73501,6,2,257621,257621,257623,0,2,0
73502,4,2,257625,257625,257627,0,2,2
73503,3,2,257628,257628,257630,0,2,1
73504,2,2,257630,257630,257632,0,2,0
73505,5,1,257635,257635,257636,0,1,3
73506,4,3,257639,257639,257642,0,3,3
73507,1,1,257640,257642,257643,2,3,0
73508,6,3,257646,257646,257649,0,3,3
73509,1,1,257647,257649,257650,2,3,0
73510,1,1,257648,257650,257651,2,3,0
73511,2,3,257650,257651,257654,1,4,0
73512,4,2,257654,257654,257656,0,2,0
73513,1,1,257655,257656,257657,1,2,0
73514,2,1,257657,257657,257658,0,1,0
73515,6,2,257663,257663,257665,0,2,5
73516,3,2,257666,257666,257668,0,2,1
73517,3,3,257669,257669,257672,0,3,1
73518,4,1,257673,257673,257674,0,1,1
73519,1,2,257674,257674,257676,0,2,0
73520,1,2,257675,257676,257678,1,3,0
73521,6,2,257681,257681,257683,0,2,3
73522,3,3,257684,257684,257687,0,3,1
73523,6,2,257690,257690,257692,0,2,3
73524,4,3,257694,257694,257697,0,3,2
73525,2,2,257696,257697,257699,1,3,0
73526,2,3,257698,257699,257702,1,4,0
73527,3,1,257701,257702,257703,1,2,0
73528,4,3,257705,257705,257708,0,3,2
73529,4,1,257709,257709,257710,0,1,1
73530,6,2,257715,257715,257717,0,2,5
73531,5,2,257720,257720,257722,0,2,3
73532,5,3,257725,257725,257728,0,3,3
73533,4,1,257729,257729,257730,0,1,1
73534,3,3,257732,257732,257735,0,3,2
73535,6,3,257738,257738,257741,0,3,3
73536,6,3,257744,257744,257747,0,3,3
73537,5,1,257749,257749,257750,0,1,2
73538,1,2,257750,257750,257752,0,2,0
73539,5,2,257755,257755,257757,0,2,3
73540,5,1,257760,257760,257761,0,1,3
73541,5,1,257765,257765,257766,0,1,4
73542,1,2,257766,257766,257768,0,2,0
73543,4,1,257770,257770,257771,0,1,2
73544,4,1,257774,257774,257775,0,1,3
73545,5,2,257779,257779,257781,0,2,4
73546,2,1,257781,257781,257782,0,1,0
73547,3,3,257784,257784,257787,0,3,2
73548,4,2,257788,257788,257790,0,2,1
73549,3,2,257791,257791,257793,0,2,1
73550,6,3,257797,257797,257800,0,3,4
73551,4,2,257801,257801,257803,0,2,1
73552,5,1,257806,257806,257807,0,1,3
73553,2,3,257808,257808,257811,0,3,1
73554,5,2,257813,257813,257815,0,2,2
73555,3,3,257816,257816,257819,0,3,1
73556,2,3,257818,257819,257822,1,4,0
73557,2,3,257820,257822,257825,2,5,0
73558,5,3,257825,257825,257828,0,3,0
73559,6,2,257831,257831,257833,0,2,3
73560,6,3,257837,257837,257840,0,3,4
73561,4,3,257841,257841,257844,0,3,1
73562,1,1,257842,257844,257845,2,3,0
73563,1,3,257843,257845,257848,2,5,0
73564,1,2,257844,257848,257850,4,6,0
73565,2,3,257846,257850,257853,4,7,0
73566,5,1,257851,257853,257854,2,3,0
73567,2,3,257853,257854,257857,1,4,0
73568,6,3,257859,257859,257862,0,3,2
73569,4,1,257863,257863,257864,0,1,1
73570,6,1,257869,257869,257870,0,1,5
73571,5,3,257874,257874,257877,0,3,4
73572,6,2,257880,257880,257882,0,2,3
73573,5,1,257885,257885,257886,0,1,3
73574,5,2,257890,257890,257892,0,2,4
73575,3,2,257893,257893,257895,0,2,1
73576,4,2,257897,257897,257899,0,2,2
73577,6,3,257903,257903,257906,0,3,4
73578,1,2,257904,257906,257908,2,4,0
73579,4,1,257908,257908,257909,0,1,0
73580,5,3,257913,257913,257916,0,3,4
73581,5,1,257918,257918,257919,0,1,2
73582,5,3,257923,257923,257926,0,3,4
73583,1,2,257924,257926,257928,2,4,0
73584,2,1,257926,257928,257929,2,3,0
73585,2,2,257928,257929,257931,1,3,0
73586,1,1,257929,257931,257932,2,3,0
73587,5,1,257934,257934,257935,0,1,2
73588,2,1,257936,257936,257937,0,1,1
73589,3,1,257939,257939,257940,0,1,2
73590,4,1,257943,257943,257944,0,1,3
73591,5,3,257948,257948,257951,0,3,4
73592,3,1,257951,257951,257952,0,1,0
73593,3,1,257954,257954,257955,0,1,2
73594,4,1,257958,257958,257959,0,1,3
73595,1,2,257959,257959,257961,0,2,0
73596,4,1,257963,257963,257964,0,1,2
73597,2,3,257965,257965,257968,0,3,1
73598,5,1,257970,257970,257971,0,1,2
73599,4,3,257974,257974,257977,0,3,3
73600,4,1,257978,257978,257979,0,1,1
73601,3,1,257981,257981,257982,0,1,2
73602,5,3,257986,257986,257989,0,3,4
73603,3,3,257989,257989,257992,0,3,0
73604,1,2,257990,257992,257994,2,4,0
73605,5,1,257995,257995,257996,0,1,1
73606,6,3,258001,258001,258004,0,3,5
73607,6,1,258007,258007,258008,0,1,3
73608,4,1,258011,258011,258012,0,1,3
73609,4,3,258015,258015,258018,0,3,3
73610,2,1,258017,258018,258019,1,2,0
73611,2,2,258019,258019,258021,0,2,0
73612,1,3,258020,258021,258024,1,4,0
73613,5,2,258025,258025,258027,0,2,1
73614,4,1,258029,258029,258030,0,1,2
73615,1,1,258030,258030,258031,0,1,0
73616,6,2,258036,258036,258038,0,2,5
73617,3,3,258039,258039,258042,0,3,1
73618,3,2,258042,258042,258044,0,2,0
73619,6,1,258048,258048,258049,0,1,4
73620,4,2,258052,258052,258054,0,2,3
73621,6,3,258058,258058,258061,0,3,4
73622,2,3,258060,258061,258064,1,4,0
73623,3,2,258063,258064,258066,1,3,0
73624,3,2,258066,258066,258068,0,2,0
73625,3,3,258069,258069,258072,0,3,1
73626,2,1,258071,258072,258073,1,2,0
73627,3,1,258074,258074,258075,0,1,1
73628,6,2,258080,258080,258082,0,2,5
73629,3,2,258083,258083,258085,0,2,1
73630,1,3,258084,258085,258088,1,4,0
73631,3,2,258087,258088,258090,1,3,0
73632,2,1,258089,258090,258091,1,2,0
73633,1,1,258090,258091,258092,1,2,0
73634,6,1,258096,258096,258097,0,1,4
73635,1,2,258097,258097,258099,0,2,0
73636,1,3,258098,258099,258102,1,4,0
73637,5,3,258103,258103,258106,0,3,1
73638,5,1,258108,258108,258109,0,1,2
73639,1,2,258109,258109,258111,0,2,0
73640,2,1,258111,258111,258112,0,1,0
73641,3,1,258114,258114,258115,0,1,2
73642,2,1,258116,258116,258117,0,1,1
73643,5,2,258121,258121,258123,0,2,4
73644,3,2,258124,258124,258126,0,2,1
73645,2,1,258126,258126,258127,0,1,0
73646,1,2,258127,258127,258129,0,2,0
73647,1,1,258128,258129,258130,1,2,0
73648,3,2,258131,258131,258133,0,2,1
73649,5,2,258136,258136,258138,0,2,3
73650,5,3,258141,258141,258144,0,3,3
73651,1,1,258142,258144,258145,2,3,0
73652,3,1,258145,258145,258146,0,1,0
73653,5,1,258150,258150,258151,0,1,4
73654,2,3,258152,258152,258155,0,3,1
73655,1,2,258153,258155,258157,2,4,0
73656,5,1,258158,258158,258159,0,1,1
73657,2,3,258160,258160,258163,0,3,1
73658,2,1,258162,258163,258164,1,2,0
73659,3,2,258165,258165,258167,0,2,1
73660,2,3,258167,258167,258170,0,3,0
73661,5,2,258172,258172,258174,0,2,2
73662,2,2,258174,258174,258176,0,2,0
73663,3,3,258177,258177,258180,0,3,1
73664,4,2,258181,258181,258183,0,2,1
73665,6,3,258187,258187,258190,0,3,4
73666,3,2,258190,258190,258192,0,2,0
73667,4,3,258194,258194,258197,0,3,2
73668,6,1,258200,258200,258201,0,1,3
73669,6,1,258206,258206,258207,0,1,5
73670,4,1,258210,258210,258211,0,1,3
73671,1,1,258211,258211,258212,0,1,0
73672,3,1,258214,258214,258215,0,1,2
73673,1,3,258215,258215,258218,0,3,0
73674,3,2,258218,258218,258220,0,2,0
73675,6,2,258224,258224,258226,0,2,4
73676,5,1,258229,258229,258230,0,1,3
73677,1,3,258230,258230,258233,0,3,0
73678,3,2,258233,258233,258235,0,2,0
73679,6,1,258239,258239,258240,0,1,4
73680,3,3,258242,258242,258245,0,3,2
73681,4,3,258246,258246,258249,0,3,1
73682,3,2,258249,258249,258251,0,2,0
73683,3,3,258252,258252,258255,0,3,1
73684,4,1,258256,258256,258257,0,1,1
73685,1,1,258257,258257,258258,0,1,0
73686,1,3,258258,258258,258261,0,3,0
73687,2,1,258260,258261,258262,1,2,0
73688,3,2,258263,258263,258265,0,2,1
73689,4,2,258267,258267,258269,0,2,2
73690,3,1,258270,258270,258271,0,1,1
73691,3,2,258273,258273,258275,0,2,2
73692,2,2,258275,258275,258277,0,2,0
73693,1,1,258276,258277,258278,1,2,0
73694,4,2,258280,258280,258282,0,2,2
73695,1,2,258281,258282,258284,1,3,0
73696,1,1,258282,258284,258285,2,3,0
73697,1,1,258283,258285,258286,2,3,0
73698,6,2,258289,258289,258291,0,2,3
73699,5,3,258294,258294,258297,0,3,3
73700,1,2,258295,258297,258299,2,4,0
73701,4,1,258299,258299,258300,0,1,0
73702,1,1,258300,258300,258301,0,1,0
73703,6,3,258306,258306,258309,0,3,5
73704,5,1,258311,258311,258312,0,1,2
73705,6,2,258317,258317,258319,0,2,5
73706,3,3,258320,258320,258323,0,3,1
73707,2,2,258322,258323,258325,1,3,0
73708,2,3,258324,258325,258328,1,4,0
73709,5,1,258329,258329,258330,0,1,1
73710,2,1,258331,258331,258332,0,1,1
73711,3,1,258334,258334,258335,0,1,2
73712,3,2,258337,258337,258339,0,2,2
73713,5,2,258342,258342,258344,0,2,3
73714,2,1,258344,258344,258345,0,1,0
73715,1,3,258345,258345,258348,0,3,0
73716,3,3,258348,258348,258351,0,3,0
73717,4,3,258352,258352,258355,0,3,1
73718,5,3,258357,258357,258360,0,3,2
73719,5,3,258362,258362,258365,0,3,2
73720,1,3,258363,258365,258368,2,5,0
73721,5,1,258368,258368,258369,0,1,0
73722,1,2,258369,258369,258371,0,2,0
73723,4,2,258373,258373,258375,0,2,2
73724,1,1,258374,258375,258376,1,2,0
73725,1,1,258375,258376,258377,1,2,0
73726,3,3,258378,258378,258381,0,3,1
73727,4,3,258382,258382,258385,0,3,1
73728,5,2,258387,258387,258389,0,2,2
73729,3,1,258390,258390,258391,0,1,1
73730,5,3,258395,258395,258398,0,3,4
73731,1,3,258396,258398,258401,2,5,0
73732,4,1,258400,258401,258402,1,2,0
73733,4,1,258404,258404,258405,0,1,2
73734,6,2,258410,258410,258412,0,2,5
73735,4,2,258414,258414,258416,0,2,2
73736,6,2,258420,258420,258422,0,2,4
73737,5,2,258425,258425,258427,0,2,3
73738,2,2,258427,258427,258429,0,2,0
73739,2,3,258429,258429,258432,0,3,0
73740,3,3,258432,258432,258435,0,3,0
73741,4,2,258436,258436,258438,0,2,1
73742,6,1,258442,258442,258443,0,1,4
73743,6,1,258448,258448,258449,0,1,5
73744,4,2,258452,258452,258454,0,2,3
73745,2,3,258454,258454,258457,0,3,0
73746,3,3,258457,258457,258460,0,3,0
73747,3,3,258460,258460,258463,0,3,0
73748,4,3,258464,258464,258467,0,3,1
73749,3,2,258467,258467,258469,0,2,0
73750,4,2,258471,258471,258473,0,2,2
73751,2,1,258473,258473,258474,0,1,0
73752,1,2,258474,258474,258476,0,2,0
73753,6,3,258480,258480,258483,0,3,4
73754,3,1,258483,258483,258484,0,1,0
73755,6,3,258489,258489,258492,0,3,5
73756,1,3,258490,258492,258495,2,5,0
73757,5,2,258495,258495,258497,0,2,0
73758,1,3,258496,258497,258500,1,4,0
73759,6,3,258502,258502,258505,0,3,2
73760,1,2,258503,258505,258507,2,4,0
73761,2,1,258505,258507,258508,2,3,0
73762,3,1,258508,258508,258509,0,1,0
73763,3,1,258511,258511,258512,0,1,2
73764,6,3,258517,258517,258520,0,3,5
73765,2,2,258519,258520,258522,1,3,0
73766,6,3,258525,258525,258528,0,3,3
73767,2,1,258527,258528,258529,1,2,0
73768,2,2,258529,258529,258531,0,2,0
73769,6,3,258535,258535,258538,0,3,4
73770,4,2,258539,258539,258541,0,2,1
73771,2,1,258541,258541,258542,0,1,0
73772,3,3,258544,258544,258547,0,3,2
73773,4,3,258548,258548,258551,0,3,1
73774,5,2,258553,258553,258555,0,2,2
73775,6,3,258559,258559,258562,0,3,4
73776,3,2,258562,258562,258564,0,2,0
73777,3,1,258565,258565,258566,0,1,1
73778,3,2,258568,258568,258570,0,2,2
73779,4,3,258572,258572,258575,0,3,2
73780,1,1,258573,258575,258576,2,3,0
73781,1,3,258574,258576,258579,2,5,0
73782,5,1,258579,258579,258580,0,1,0
73783,1,2,258580,258580,258582,0,2,0
73784,4,3,258584,258584,258587,0,3,2
73785,6,1,258590,258590,258591,0,1,3
73786,5,3,258595,258595,258598,0,3,4
73787,6,2,258601,258601,258603,0,2,3
73788,2,3,258603,258603,258606,0,3,0
73789,5,1,258608,258608,258609,0,1,2
73790,1,2,258609,258609,258611,0,2,0
73791,1,2,258610,258611,258613,1,3,0
73792,1,3,258611,258613,258616,2,5,0
73793,4,3,258615,258616,258619,1,4,0
73794,4,2,258619,258619,258621,0,2,0
73795,3,2,258622,258622,258624,0,2,1
73796,2,1,258624,258624,258625,0,1,0
73797,1,3,258625,258625,258628,0,3,0
73798,6,2,258631,258631,258633,0,2,3
73799,3,3,258634,258634,258637,0,3,1
73800,1,3,258635,258637,258640,2,5,0
73801,3,2,258638,258640,258642,2,4,0
73802,3,1,258641,258642,258643,1,2,0
73803,5,1,258646,258646,258647,0,1,3
73804,4,3,258650,258650,258653,0,3,3
73805,3,1,258653,258653,258654,0,1,0
73806,2,1,258655,258655,258656,0,1,1
73807,5,2,258660,258660,258662,0,2,4
73808,5,1,258665,258665,258666,0,1,3
73809,6,1,258671,258671,258672,0,1,5
73810,6,2,258677,258677,258679,0,2,5
73811,2,1,258679,258679,258680,0,1,0
73812,4,3,258683,258683,258686,0,3,3
73813,2,3,258685,258686,258689,1,4,0
73814,3,1,258688,258689,258690,1,2,0
73815,3,2,258691,258691,258693,0,2,1
73816,3,3,258694,258694,258697,0,3,1
73817,2,3,258696,258697,258700,1,4,0
73818,6,2,258702,258702,258704,0,2,2
73819,3,1,258705,258705,258706,0,1,1
73820,2,2,258707,258707,258709,0,2,1
73821,6,1,258713,258713,258714,0,1,4
73822,4,2,258717,258717,258719,0,2,3
73823,5,2,258722,258722,258724,0,2,3
73824,4,2,258726,258726,258728,0,2,2
73825,4,3,258730,258730,258733,0,3,2
73826,1,1,258731,258733,258734,2,3,0
73827,4,2,258735,258735,258737,0,2,1
73828,6,1,258741,258741,258742,0,1,4
73829,2,2,258743,258743,258745,0,2,1
73830,1,2,258744,258745,258747,1,3,0
73831,3,2,258747,258747,258749,0,2,0
73832,6,3,258753,258753,258756,0,3,4
73833,1,2,258754,258756,258758,2,4,0
73834,1,1,258755,258758,258759,3,4,0
73835,6,3,258761,258761,258764,0,3,2
73836,5,1,258766,258766,258767,0,1,2
73837,5,2,258771,258771,258773,0,2,4
73838,2,1,258773,258773,258774,0,1,0
73839,4,3,258777,258777,258780,0,3,3
73840,5,2,258782,258782,258784,0,2,2
73841,4,1,258786,258786,258787,0,1,2
73842,2,1,258788,258788,258789,0,1,1
73843,3,2,258791,258791,258793,0,2,2
73844,5,1,258796,258796,258797,0,1,3
73845,6,1,258802,258802,258803,0,1,5
73846,1,3,258803,258803,258806,0,3,0
73847,2,2,258805,258806,258808,1,3,0
73848,3,2,258808,258808,258810,0,2,0
73849,2,1,258810,258810,258811,0,1,0
73850,6,1,258816,258816,258817,0,1,5
73851,5,3,258821,258821,258824,0,3,4
73852,5,2,258826,258826,258828,0,2,2
73853,6,1,258832,258832,258833,0,1,4
73854,1,3,258833,258833,258836,0,3,0
73855,5,1,258838,258838,258839,0,1,2
73856,4,2,258842,258842,258844,0,2,3
73857,2,2,258844,258844,258846,0,2,0
73858,5,3,258849,258849,258852,0,3,3
73859,4,2,258853,258853,258855,0,2,1
73860,4,1,258857,258857,258858,0,1,2
73861,6,2,258863,258863,258865,0,2,5
73862,3,1,258866,258866,258867,0,1,1
73863,2,2,258868,258868,258870,0,2,1
73864,3,2,258871,258871,258873,0,2,1
73865,5,3,258876,258876,258879,0,3,3
73866,3,1,258879,258879,258880,0,1,0
73867,1,1,258880,258880,258881,0,1,0
73868,5,1,258885,258885,258886,0,1,4
73869,6,2,258891,258891,258893,0,2,5
73870,1,1,258892,258893,258894,1,2,0
73871,3,3,258895,258895,258898,0,3,1
73872,4,1,258899,258899,258900,0,1,1
73873,6,3,258905,258905,258908,0,3,5
73874,3,3,258908,258908,258911,0,3,0
73875,4,2,258912,258912,258914,0,2,1
73876,2,2,258914,258914,258916,0,2,0
73877,5,1,258919,258919,258920,0,1,3
73878,1,2,258920,258920,258922,0,2,0
73879,4,3,258924,258924,258927,0,3,2
73880,2,2,258926,258927,258929,1,3,0
73881,5,2,258931,258931,258933,0,2,2
73882,2,2,258933,258933,258935,0,2,0
73883,6,1,258939,258939,258940,0,1,4
73884,5,2,258944,258944,258946,0,2,4
73885,5,3,258949,258949,258952,0,3,3
73886,4,1,258953,258953,258954,0,1,1
73887,6,2,258959,258959,258961,0,2,5
73888,1,2,258960,258961,258963,1,3,0
73889,5,2,258965,258965,258967,0,2,2
73890,1,2,258966,258967,258969,1,3,0
73891,3,1,258969,258969,258970,0,1,0
73892,5,2,258974,258974,258976,0,2,4
73893,1,1,258975,258976,258977,1,2,0
73894,4,1,258979,258979,258980,0,1,2
73895,1,3,258980,258980,258983,0,3,0
73896,3,1,258983,258983,258984,0,1,0
73897,5,1,258988,258988,258989,0,1,4
73898,1,1,258989,258989,258990,0,1,0
73899,1,1,258990,258990,258991,0,1,0
73900,6,1,258996,258996,258997,0,1,5
73901,6,3,259002,259002,259005,0,3,5
73902,2,2,259004,259005,259007,1,3,0
73903,3,3,259007,259007,259010,0,3,0
73904,2,3,259009,259010,259013,1,4,0
73905,4,2,259013,259013,259015,0,2,0
73906,3,3,259016,259016,259019,0,3,1
73907,6,3,259022,259022,259025,0,3,3
73908,1,3,259023,259025,259028,2,5,0
73909,1,3,259024,259028,259031,4,7,0
73910,2,3,259026,259031,259034,5,8,0
73911,2,2,259028,259034,259036,6,8,0
73912,5,2,259033,259036,259038,3,5,0
73913,6,3,259039,259039,259042,0,3,1
73914,5,3,259044,259044,259047,0,3,2
73915,4,3,259048,259048,259051,0,3,1
73916,4,3,259052,259052,259055,0,3,1
73917,2,1,259054,259055,259056,1,2,0
73918,5,2,259059,259059,259061,0,2,3
73919,3,2,259062,259062,259064,0,2,1
73920,4,2,259066,259066,259068,0,2,2
73921,1,1,259067,259068,259069,1,2,0
73922,2,1,259069,259069,259070,0,1,0
73923,1,2,259070,259070,259072,0,2,0
73924,3,2,259073,259073,259075,0,2,1
73925,1,1,259074,259075,259076,1,2,0
73926,5,3,259079,259079,259082,0,3,3
73927,2,3,259081,259082,259085,1,4,0
73928,2,2,259083,259085,259087,2,4,0
73929,5,3,259088,259088,259091,0,3,1
73930,4,2,259092,259092,259094,0,2,1
73931,1,3,259093,259094,259097,1,4,0
73932,4,2,259097,259097,259099,0,2,0
73933,2,2,259099,259099,259101,0,2,0
73934,3,2,259102,259102,259104,0,2,1
73935,6,3,259108,259108,259111,0,3,4
73936,5,3,259113,259113,259116,0,3,2
73937,6,1,259119,259119,259120,0,1,3
73938,4,3,259123,259123,259126,0,3,3
73939,5,1,259128,259128,259129,0,1,2
73940,1,1,259129,259129,259130,0,1,0
73941,1,1,259130,259130,259131,0,1,0
73942,5,1,259135,259135,259136,0,1,4
73943,4,3,259139,259139,259142,0,3,3
73944,2,1,259141,259142,259143,1,2,0
73945,4,3,259145,259145,259148,0,3,2
73946,6,3,259151,259151,259154,0,3,3
73947,2,1,259153,259154,259155,1,2,0
73948,1,1,259154,259155,259156,1,2,0
73949,4,2,259158,259158,259160,0,2,2
73950,6,3,259164,259164,259167,0,3,4
73951,2,3,259166,259167,259170,1,4,0
73952,4,1,259170,259170,259171,0,1,0
73953,4,1,259174,259174,259175,0,1,3
73954,2,1,259176,259176,259177,0,1,1
73955,5,1,259181,259181,259182,0,1,4
73956,3,3,259184,259184,259187,0,3,2
73957,5,3,259189,259189,259192,0,3,2
73958,1,1,259190,259192,259193,2,3,0
73959,3,1,259193,259193,259194,0,1,0
73960,6,2,259199,259199,259201,0,2,5
73961,4,1,259203,259203,259204,0,1,2
73962,6,2,259209,259209,259211,0,2,5
73963,4,2,259213,259213,259215,0,2,2
73964,3,3,259216,259216,259219,0,3,1
73965,6,3,259222,259222,259225,0,3,3
73966,2,3,259224,259225,259228,1,4,0
73967,3,2,259227,259228,259230,1,3,0
73968,1,1,259228,259230,259231,2,3,0
73969,5,2,259233,259233,259235,0,2,2
73970,1,1,259234,259235,259236,1,2,0
73971,4,3,259238,259238,259241,0,3,2
73972,1,1,259239,259241,259242,2,3,0
73973,3,2,259242,259242,259244,0,2,0
73974,2,2,259244,259244,259246,0,2,0
73975,2,3,259246,259246,259249,0,3,0
73976,2,1,259248,259249,259250,1,2,0
73977,1,2,259249,259250,259252,1,3,0
73978,3,2,259252,259252,259254,0,2,0
73979,5,2,259257,259257,259259,0,2,3
73980,5,3,259262,259262,259265,0,3,3
73981,6,1,259268,259268,259269,0,1,3
73982,5,1,259273,259273,259274,0,1,4
73983,6,2,259279,259279,259281,0,2,5
73984,5,3,259284,259284,259287,0,3,3
73985,4,1,259288,259288,259289,0,1,1
73986,5,3,259293,259293,259296,0,3,4
73987,1,2,259294,259296,259298,2,4,0
73988,6,1,259300,259300,259301,0,1,2
73989,4,3,259304,259304,259307,0,3,3
73990,6,1,259310,259310,259311,0,1,3
73991,5,1,259315,259315,259316,0,1,4
73992,4,2,259319,259319,259321,0,2,3
73993,4,1,259323,259323,259324,0,1,2
73994,1,3,259324,259324,259327,0,3,0
73995,6,3,259330,259330,259333,0,3,3
73996,2,2,259332,259333,259335,1,3,0
73997,5,3,259337,259337,259340,0,3,2
73998,6,3,259343,259343,259346,0,3,3
73999,3,1,259346,259346,259347,0,1,0
74000,1,1,259347,259347,259348,0,1,0
74001,1,2,259348,259348,259350,0,2,0
74002,4,2,259352,259352,259354,0,2,2
74003,4,3,259356,259356,259359,0,3,2
74004,1,1,259357,259359,259360,2,3,0
74005,4,3,259361,259361,259364,0,3,1
74006,3,1,259364,259364,259365,0,1,0
74007,6,1,259370,259370,259371,0,1,5
74008,6,2,259376,259376,259378,0,2,5
74009,2,1,259378,259378,259379,0,1,0
74010,3,2,259381,259381,259383,0,2,2
74011,3,3,259384,259384,259387,0,3,1
74012,5,1,259389,259389,259390,0,1,2
74013,5,1,259394,259394,259395,0,1,4
74014,2,3,259396,259396,259399,0,3,1
74015,1,3,259397,259399,259402,2,5,0
74016,6,2,259403,259403,259405,0,2,1
74017,2,3,259405,259405,259408,0,3,0
74018,2,3,259407,259408,259411,1,4,0
74019,3,1,259410,259411,259412,1,2,0
74020,5,1,259415,259415,259416,0,1,3
74021,6,3,259421,259421,259424,0,3,5
74022,2,2,259423,259424,259426,1,3,0
74023,4,2,259427,259427,259429,0,2,1
74024,1,1,259428,259429,259430,1,2,0
74025,3,3,259431,259431,259434,0,3,1
74026,1,3,259432,259434,259437,2,5,0
74027,1,2,259433,259437,259439,4,6,0
74028,6,3,259439,259439,259442,0,3,0
74029,3,1,259442,259442,259443,0,1,0
74030,4,2,259446,259446,259448,0,2,3
74031,5,2,259451,259451,259453,0,2,3
74032,6,2,259457,259457,259459,0,2,4
74033,1,3,259458,259459,259462,1,4,0
74034,5,1,259463,259463,259464,0,1,1
74035,5,2,259468,259468,259470,0,2,4
74036,3,2,259471,259471,259473,0,2,1
74037,4,3,259475,259475,259478,0,3,2
74038,3,3,259478,259478,259481,0,3,0
74039,6,3,259484,259484,259487,0,3,3
74040,6,1,259490,259490,259491,0,1,3
74041,1,2,259491,259491,259493,0,2,0
74042,2,2,259493,259493,259495,0,2,0
74043,1,3,259494,259495,259498,1,4,0
74044,1,1,259495,259498,259499,3,4,0
74045,1,1,259496,259499,259500,3,4,0
74046,6,3,259502,259502,259505,0,3,2
74047,2,3,259504,259505,259508,1,4,0
74048,3,3,259507,259508,259511,1,4,0
74049,4,3,259511,259511,259514,0,3,0
74050,6,1,259517,259517,259518,0,1,3
74051,6,1,259523,259523,259524,0,1,5
74052,2,2,259525,259525,259527,0,2,1
74053,4,3,259529,259529,259532,0,3,2
74054,4,3,259533,259533,259536,0,3,1
74055,5,1,259538,259538,259539,0,1,2
74056,2,3,259540,259540,259543,0,3,1
74057,5,3,259545,259545,259548,0,3,2
74058,6,3,259551,259551,259554,0,3,3
74059,4,1,259555,259555,259556,0,1,1
74060,5,1,259560,259560,259561,0,1,4
74061,5,3,259565,259565,259568,0,3,4
74062,3,2,259568,259568,259570,0,2,0
74063,1,2,259569,259570,259572,1,3,0
74064,3,2,259572,259572,259574,0,2,0
74065,1,2,259573,259574,259576,1,3,0
74066,3,3,259576,259576,259579,0,3,0
74067,2,3,259578,259579,259582,1,4,0
74068,3,3,259581,259582,259585,1,4,0
74069,2,2,259583,259585,259587,2,4,0
74070,4,3,259587,259587,259590,0,3,0
74071,3,3,259590,259590,259593,0,3,0
74072,5,1,259595,259595,259596,0,1,2
74073,1,1,259596,259596,259597,0,1,0
74074,1,3,259597,259597,259600,0,3,0
74075,2,2,259599,259600,259602,1,3,0
74076,3,2,259602,259602,259604,0,2,0
74077,6,3,259608,259608,259611,0,3,4
74078,2,2,259610,259611,259613,1,3,0
74079,1,3,259611,259613,259616,2,5,0
74080,1,1,259612,259616,259617,4,5,0
74081,1,1,259613,259617,259618,4,5,0
74082,1,1,259614,259618,259619,4,5,0
74083,6,3,259620,259620,259623,0,3,1
74084,1,3,259621,259623,259626,2,5,0
74085,6,3,259627,259627,259630,0,3,1
74086,4,3,259631,259631,259634,0,3,1
74087,2,3,259633,259634,259637,1,4,0
74088,2,2,259635,259637,259639,2,4,0
74089,4,1,259639,259639,259640,0,1,0
74090,4,1,259643,259643,259644,0,1,3
74091,2,1,259645,259645,259646,0,1,1
74092,1,1,259646,259646,259647,0,1,0
74093,2,1,259648,259648,259649,0,1,1
74094,4,2,259652,259652,259654,0,2,3
74095,4,1,259656,259656,259657,0,1,2
74096,1,3,259657,259657,259660,0,3,0
74097,4,2,259661,259661,259663,0,2,1
74098,4,3,259665,259665,259668,0,3,2
74099,5,3,259670,259670,259673,0,3,2
74100,1,2,259671,259673,259675,2,4,0
74101,5,1,259676,259676,259677,0,1,1
74102,1,2,259677,259677,259679,0,2,0
74103,5,1,259682,259682,259683,0,1,3
74104,6,1,259688,259688,259689,0,1,5
74105,4,1,259692,259692,259693,0,1,3
74106,2,1,259694,259694,259695,0,1,1
74107,3,2,259697,259697,259699,0,2,2
74108,4,2,259701,259701,259703,0,2,2
74109,3,2,259704,259704,259706,0,2,1
74110,6,1,259710,259710,259711,0,1,4
74111,1,3,259711,259711,259714,0,3,0
74112,3,1,259714,259714,259715,0,1,0
74113,1,2,259715,259715,259717,0,2,0
74114,3,2,259718,259718,259720,0,2,1
74115,6,2,259724,259724,259726,0,2,4
74116,3,1,259727,259727,259728,0,1,1
74117,3,3,259730,259730,259733,0,3,2
74118,3,1,259733,259733,259734,0,1,0
74119,3,3,259736,259736,259739,0,3,2
74120,2,1,259738,259739,259740,1,2,0
74121,1,2,259739,259740,259742,1,3,0
74122,6,3,259745,259745,259748,0,3,3
74123,3,2,259748,259748,259750,0,2,0
74124,4,3,259752,259752,259755,0,3,2
74125,6,2,259758,259758,259760,0,2,3
74126,6,2,259764,259764,259766,0,2,4
74127,3,3,259767,259767,259770,0,3,1
74128,3,2,259770,259770,259772,0,2,0
74129,6,2,259776,259776,259778,0,2,4
74130,6,3,259782,259782,259785,0,3,4
74131,2,2,259784,259785,259787,1,3,0
74132,2,2,259786,259787,259789,1,3,0
74133,6,2,259792,259792,259794,0,2,3
74134,3,1,259795,259795,259796,0,1,1
74135,1,1,259796,259796,259797,0,1,0
74136,5,2,259801,259801,259803,0,2,4
74137,5,1,259806,259806,259807,0,1,3
74138,1,3,259807,259807,259810,0,3,0
74139,3,1,259810,259810,259811,0,1,0
74140,6,1,259816,259816,259817,0,1,5
74141,1,3,259817,259817,259820,0,3,0
74142,1,3,259818,259820,259823,2,5,0
74143,2,1,259820,259823,259824,3,4,0
74144,5,2,259825,259825,259827,0,2,1
74145,1,3,259826,259827,259830,1,4,0
74146,5,3,259831,259831,259834,0,3,1
74147,5,1,259836,259836,259837,0,1,2
74148,5,2,259841,259841,259843,0,2,4
74149,6,1,259847,259847,259848,0,1,4
74150,1,3,259848,259848,259851,0,3,0
74151,4,3,259852,259852,259855,0,3,1
74152,6,3,259858,259858,259861,0,3,3
74153,3,3,259861,259861,259864,0,3,0
74154,1,1,259862,259864,259865,2,3,0
74155,4,3,259866,259866,259869,0,3,1
74156,4,3,259870,259870,259873,0,3,1
74157,5,2,259875,259875,259877,0,2,2
74158,5,3,259880,259880,259883,0,3,3
74159,2,3,259882,259883,259886,1,4,0
74160,3,3,259885,259886,259889,1,4,0
74161,5,1,259890,259890,259891,0,1,1
74162,1,1,259891,259891,259892,0,1,0
74163,6,2,259897,259897,259899,0,2,5
74164,5,2,259902,259902,259904,0,2,3
74165,3,2,259905,259905,259907,0,2,1
74166,5,3,259910,259910,259913,0,3,3
74167,2,3,259912,259913,259916,1,4,0
74168,4,3,259916,259916,259919,0,3,0
74169,5,1,259921,259921,259922,0,1,2
74170,5,3,259926,259926,259929,0,3,4
74171,1,3,259927,259929,259932,2,5,0
74172,1,1,259928,259932,259933,4,5,0
74173,3,2,259931,259933,259935,2,4,0
74174,6,3,259937,259937,259940,0,3,2
74175,6,2,259943,259943,259945,0,2,3
74176,2,3,259945,259945,259948,0,3,0
74177,6,1,259951,259951,259952,0,1,3
74178,3,3,259954,259954,259957,0,3,2
74179,2,2,259956,259957,259959,1,3,0
74180,1,1,259957,259959,259960,2,3,0
74181,3,1,259960,259960,259961,0,1,0
74182,3,1,259963,259963,259964,0,1,2
74183,3,1,259966,259966,259967,0,1,2
74184,5,2,259971,259971,259973,0,2,4
74185,5,2,259976,259976,259978,0,2,3
74186,2,2,259978,259978,259980,0,2,0
74187,5,2,259983,259983,259985,0,2,3
74188,5,2,259988,259988,259990,0,2,3
74189,6,1,259994,259994,259995,0,1,4
74190,4,2,259998,259998,260000,0,2,3
74191,4,2,260002,260002,260004,0,2,2
74192,5,1,260007,260007,260008,0,1,3
74193,4,3,260011,260011,260014,0,3,3
74194,3,2,260014,260014,260016,0,2,0
74195,2,3,260016,260016,260019,0,3,0
74196,1,2,260017,260019,260021,2,4,0
74197,4,3,260021,260021,260024,0,3,0
74198,4,1,260025,260025,260026,0,1,1
74199,4,1,260029,260029,260030,0,1,3
74200,6,2,260035,260035,260037,0,2,5
74201,2,3,260037,260037,260040,0,3,0
74202,5,1,260042,260042,260043,0,1,2
74203,2,2,260044,260044,260046,0,2,1
74204,1,3,260045,260046,260049,1,4,0
74205,6,1,260051,260051,260052,0,1,2
74206,4,2,260055,260055,260057,0,2,3
74207,5,1,260060,260060,260061,0,1,3
74208,2,3,260062,260062,260065,0,3,1
74209,6,1,260068,260068,260069,0,1,3
74210,4,1,260072,260072,260073,0,1,3
74211,4,3,260076,260076,260079,0,3,3
74212,5,1,260081,260081,260082,0,1,2
74213,2,2,260083,260083,260085,0,2,1
74214,3,3,260086,260086,260089,0,3,1
74215,5,3,260091,260091,260094,0,3,2
74216,4,1,260095,260095,260096,0,1,1
74217,2,1,260097,260097,260098,0,1,1
74218,3,2,260100,260100,260102,0,2,2
74219,2,1,260102,260102,260103,0,1,0
74220,6,3,260108,260108,260111,0,3,5
74221,6,3,260114,260114,260117,0,3,3
74222,3,1,260117,260117,260118,0,1,0
74223,6,2,260123,260123,260125,0,2,5
74224,5,1,260128,260128,260129,0,1,3
74225,2,3,260130,260130,260133,0,3,1
74226,6,2,260136,260136,260138,0,2,3
74227,4,1,260140,260140,260141,0,1,2
74228,1,3,260141,260141,260144,0,3,0
74229,1,3,260142,260144,260147,2,5,0
74230,5,3,260147,260147,260150,0,3,0
74231,5,2,260152,260152,260154,0,2,2
74232,4,3,260156,260156,260159,0,3,2
74233,6,1,260162,260162,260163,0,1,3
74234,4,3,260166,260166,260169,0,3,3
74235,4,1,260170,260170,260171,0,1,1
74236,3,1,260173,260173,260174,0,1,2
74237,4,3,260177,260177,260180,0,3,3
74238,1,3,260178,260180,260183,2,5,0
74239,6,2,260184,260184,260186,0,2,1
74240,2,2,260186,260186,260188,0,2,0
74241,5,3,260191,260191,260194,0,3,3
74242,3,1,260194,260194,260195,0,1,0
74243,2,1,260196,260196,260197,0,1,1
74244,6,1,260202,260202,260203,0,1,5
74245,1,3,260203,260203,260206,0,3,0
74246,3,3,260206,260206,260209,0,3,0
74247,6,1,260212,260212,260213,0,1,3
74248,3,3,260215,260215,260218,0,3,2
74249,3,1,260218,260218,260219,0,1,0
74250,3,3,260221,260221,260224,0,3,2
74251,3,2,260224,260224,260226,0,2,0
74252,3,2,260227,260227,260229,0,2,1
74253,2,2,260229,260229,260231,0,2,0
74254,6,1,260235,260235,260236,0,1,4
74255,6,3,260241,260241,260244,0,3,5
74256,6,2,260247,260247,260249,0,2,3
74257,5,2,260252,260252,260254,0,2,3
74258,2,3,260254,260254,260257,0,3,0
74259,1,3,260255,260257,260260,2,5,0
74260,4,3,260259,260260,260263,1,4,0
74261,4,1,260263,260263,260264,0,1,0
74262,2,3,260265,260265,260268,0,3,1
74263,4,2,260269,260269,260271,0,2,1
74264,6,1,260275,260275,260276,0,1,4
74265,2,1,260277,260277,260278,0,1,1
74266,4,1,260281,260281,260282,0,1,3
74267,6,1,260287,260287,260288,0,1,5
74268,1,3,260288,260288,260291,0,3,0
74269,2,3,260290,260291,260294,1,4,0
74270,5,1,260295,260295,260296,0,1,1
74271,5,1,260300,260300,260301,0,1,4
74272,1,1,260301,260301,260302,0,1,0
74273,4,1,260305,260305,260306,0,1,3
74274,3,2,260308,260308,260310,0,2,2
74275,2,3,260310,260310,260313,0,3,0
74276,3,3,260313,260313,260316,0,3,0
74277,2,1,260315,260316,260317,1,2,0
74278,3,1,260318,260318,260319,0,1,1
74279,4,2,260322,260322,260324,0,2,3
74280,5,3,260327,260327,260330,0,3,3
74281,2,3,260329,260330,260333,1,4,0
74282,4,2,260333,260333,260335,0,2,0
74283,5,1,260338,260338,260339,0,1,3
74284,6,2,260344,260344,260346,0,2,5
74285,5,2,260349,260349,260351,0,2,3
74286,2,3,260351,260351,260354,0,3,0
74287,2,3,260353,260354,260357,1,4,0
74288,6,3,260359,260359,260362,0,3,2
74289,5,3,260364,260364,260367,0,3,2
74290,1,2,260365,260367,260369,2,4,0
74291,4,2,260369,260369,260371,0,2,0
74292,1,2,260370,260371,260373,1,3,0
74293,2,3,260372,260373,260376,1,4,0
74294,1,1,260373,260376,260377,3,4,0
74295,1,3,260374,260377,260380,3,6,0
74296,1,2,260375,260380,260382,5,7,0
74297,4,1,260379,260382,260383,3,4,0
74298,5,3,260384,260384,260387,0,3,1
74299,5,2,260389,260389,260391,0,2,2
74300,4,1,260393,260393,260394,0,1,2
74301,4,1,260397,260397,260398,0,1,3
74302,1,2,260398,260398,260400,0,2,0
74303,4,2,260402,260402,260404,0,2,2
74304,4,1,260406,260406,260407,0,1,2
74305,2,2,260408,260408,260410,0,2,1
74306,2,3,260410,260410,260413,0,3,0
74307,1,3,260411,260413,260416,2,5,0
74308,6,1,260417,260417,260418,0,1,1
74309,4,1,260421,260421,260422,0,1,3
74310,1,2,260422,260422,260424,0,2,0
74311,2,2,260424,260424,260426,0,2,0
74312,3,3,260427,260427,260430,0,3,1
74313,5,1,260432,260432,260433,0,1,2
74314,5,1,260437,260437,260438,0,1,4
74315,2,3,260439,260439,260442,0,3,1
74316,5,2,260444,260444,260446,0,2,2
74317,3,2,260447,260447,260449,0,2,1
74318,1,1,260448,260449,260450,1,2,0
74319,4,2,260452,260452,260454,0,2,2
74320,4,2,260456,260456,260458,0,2,2
74321,6,2,260462,260462,260464,0,2,4
74322,6,3,260468,260468,260471,0,3,4
74323,4,3,260472,260472,260475,0,3,1
74324,2,2,260474,260475,260477,1,3,0
74325,2,1,260476,260477,260478,1,2,0
74326,4,3,260480,260480,260483,0,3,2
74327,1,2,260481,260483,260485,2,4,0
74328,3,1,260484,260485,260486,1,2,0
74329,5,3,260489,260489,260492,0,3,3
74330,3,1,260492,260492,260493,0,1,0
74331,5,1,260497,260497,260498,0,1,4
74332,1,3,260498,260498,260501,0,3,0
74333,3,2,260501,260501,260503,0,2,0
74334,1,2,260502,260503,260505,1,3,0
74335,4,3,260506,260506,260509,0,3,1
74336,5,2,260511,260511,260513,0,2,2
74337,6,3,260517,260517,260520,0,3,4
74338,4,3,260521,260521,260524,0,3,1
74339,6,1,260527,260527,260528,0,1,3
74340,1,3,260528,260528,260531,0,3,0
74341,4,3,260532,260532,260535,0,3,1
74342,4,1,260536,260536,260537,0,1,1
74343,1,1,260537,260537,260538,0,1,0
74344,2,2,260539,260539,260541,0,2,1
74345,2,1,260541,260541,260542,0,1,0
74346,1,3,260542,260542,260545,0,3,0
74347,4,3,260546,260546,260549,0,3,1
74348,4,3,260550,260550,260553,0,3,1
74349,4,2,260554,260554,260556,0,2,1
74350,6,1,260560,260560,260561,0,1,4
74351,5,1,260565,260565,260566,0,1,4
74352,6,3,260571,260571,260574,0,3,5
74353,3,3,260574,260574,260577,0,3,0
74354,6,2,260580,260580,260582,0,2,3
74355,4,1,260584,260584,260585,0,1,2
74356,6,2,260590,260590,260592,0,2,5
74357,4,2,260594,260594,260596,0,2,2
74358,4,1,260598,260598,260599,0,1,2
74359,6,2,260604,260604,260606,0,2,5
74360,6,1,260610,260610,260611,0,1,4
74361,2,3,260612,260612,260615,0,3,1
74362,4,1,260616,260616,260617,0,1,1
74363,4,2,260620,260620,260622,0,2,3
74364,6,1,260626,260626,260627,0,1,4
74365,6,1,260632,260632,260633,0,1,5
74366,1,2,260633,260633,260635,0,2,0
74367,6,3,260639,260639,260642,0,3,4
74368,2,2,260641,260642,260644,1,3,0
74369,2,3,260643,260644,260647,1,4,0
74370,2,2,260645,260647,260649,2,4,0
74371,4,1,260649,260649,260650,0,1,0
74372,1,2,260650,260650,260652,0,2,0
74373,1,2,260651,260652,260654,1,3,0
74374,2,3,260653,260654,260657,1,4,0
74375,6,2,260659,260659,260661,0,2,2
74376,3,2,260662,260662,260664,0,2,1
74377,3,2,260665,260665,260667,0,2,1
74378,5,2,260670,260670,260672,0,2,3
74379,4,2,260674,260674,260676,0,2,2
74380,1,1,260675,260676,260677,1,2,0
74381,5,3,260680,260680,260683,0,3,3
74382,4,1,260684,260684,260685,0,1,1
74383,5,2,260689,260689,260691,0,2,4
74384,2,2,260691,260691,260693,0,2,0
74385,4,3,260695,260695,260698,0,3,2
74386,2,2,260697,260698,260700,1,3,0
74387,1,1,260698,260700,260701,2,3,0
74388,3,1,260701,260701,260702,0,1,0
74389,2,2,260703,260703,260705,0,2,1
74390,6,1,260709,260709,260710,0,1,4
74391,5,3,260714,260714,260717,0,3,4
74392,6,2,260720,260720,260722,0,2,3
74393,5,2,260725,260725,260727,0,2,3
74394,6,1,260731,260731,260732,0,1,4
74395,6,2,260737,260737,260739,0,2,5
74396,6,3,260743,260743,260746,0,3,4
74397,3,1,260746,260746,260747,0,1,0
74398,5,2,260751,260751,260753,0,2,4
74399,3,1,260754,260754,260755,0,1,1
74400,2,3,260756,260756,260759,0,3,1
74401,3,2,260759,260759,260761,0,2,0
74402,5,3,260764,260764,260767,0,3,3
74403,4,1,260768,260768,260769,0,1,1
74404,3,2,260771,260771,260773,0,2,2
74405,2,1,260773,260773,260774,0,1,0
74406,5,3,260778,260778,260781,0,3,4
74407,6,2,260784,260784,260786,0,2,3
74408,3,2,260787,260787,260789,0,2,1
74409,5,1,260792,260792,260793,0,1,3
74410,2,3,260794,260794,260797,0,3,1
74411,2,3,260796,260797,260800,1,4,0
74412,5,2,260801,260801,260803,0,2,1
74413,4,3,260805,260805,260808,0,3,2
74414,4,2,260809,260809,260811,0,2,1
74415,2,2,260811,260811,260813,0,2,0
74416,1,1,260812,260813,260814,1,2,0
74417,2,3,260814,260814,260817,0,3,0
74418,6,1,260820,260820,260821,0,1,3
74419,3,3,260823,260823,260826,0,3,2
74420,3,2,260826,260826,260828,0,2,0
74421,1,3,260827,260828,260831,1,4,0
74422,1,3,260828,260831,260834,3,6,0
74423,1,3,260829,260834,260837,5,8,0
74424,1,3,260830,260837,260840,7,10,0
74425,4,3,260834,260840,260843,6,9,0
74426,1,2,260835,260843,260845,8,10,0
74427,2,1,260837,260845,260846,8,9,0
74428,4,2,260841,260846,260848,5,7,0
74429,6,2,260847,260848,260850,1,3,0
74430,2,1,260849,260850,260851,1,2,0
74431,1,3,260850,260851,260854,1,4,0
74432,6,1,260856,260856,260857,0,1,2
74433,2,1,260858,260858,260859,0,1,1
74434,1,2,260859,260859,260861,0,2,0
74435,3,1,260862,260862,260863,0,1,1
74436,1,3,260863,260863,260866,0,3,0
74437,3,3,260866,260866,260869,0,3,0
74438,2,2,260868,260869,260871,1,3,0
74439,1,2,260869,260871,260873,2,4,0
74440,5,2,260874,260874,260876,0,2,1
74441,2,3,260876,260876,260879,0,3,0
74442,4,2,260880,260880,260882,0,2,1
74443,5,2,260885,260885,260887,0,2,3
74444,1,3,260886,260887,260890,1,4,0
74445,2,3,260888,260890,260893,2,5,0
74446,5,1,260893,260893,260894,0,1,0
74447,5,1,260898,260898,260899,0,1,4
74448,4,1,260902,260902,260903,0,1,3
74449,2,1,260904,260904,260905,0,1,1
74450,5,1,260909,260909,260910,0,1,4
74451,5,3,260914,260914,260917,0,3,4
74452,4,1,260918,260918,260919,0,1,1
74453,2,1,260920,260920,260921,0,1,1
74454,4,2,260924,260924,260926,0,2,3
74455,1,2,260925,260926,260928,1,3,0
74456,3,2,260928,260928,260930,0,2,0
74457,1,3,260929,260930,260933,1,4,0
74458,2,2,260931,260933,260935,2,4,0
74459,2,3,260933,260935,260938,2,5,0
74460,5,3,260938,260938,260941,0,3,0
74461,3,3,260941,260941,260944,0,3,0
74462,6,1,260947,260947,260948,0,1,3
74463,3,3,260950,260950,260953,0,3,2
74464,5,1,260955,260955,260956,0,1,2
74465,6,2,260961,260961,260963,0,2,5
74466,2,2,260963,260963,260965,0,2,0
74467,4,3,260967,260967,260970,0,3,2
74468,3,1,260970,260970,260971,0,1,0
74469,2,3,260972,260972,260975,0,3,1
74470,4,1,260976,260976,260977,0,1,1
74471,6,1,260982,260982,260983,0,1,5
74472,1,3,260983,260983,260986,0,3,0
74473,1,3,260984,260986,260989,2,5,0
74474,5,2,260989,260989,260991,0,2,0
74475,3,2,260992,260992,260994,0,2,1
74476,4,3,260996,260996,260999,0,3,2
74477,6,3,261002,261002,261005,0,3,3
74478,1,2,261003,261005,261007,2,4,0
74479,6,1,261009,261009,261010,0,1,2
74480,6,1,261015,261015,261016,0,1,5
74481,5,2,261020,261020,261022,0,2,4
74482,1,3,261021,261022,261025,1,4,0
74483,3,2,261024,261025,261027,1,3,0
74484,6,2,261030,261030,261032,0,2,3
74485,5,2,261035,261035,261037,0,2,3
74486,6,1,261041,261041,261042,0,1,4
74487,2,2,261043,261043,261045,0,2,1
74488,5,3,261048,261048,261051,0,3,3
74489,4,1,261052,261052,261053,0,1,1
74490,4,2,261056,261056,261058,0,2,3
74491,1,1,261057,261058,261059,1,2,0
74492,4,3,261061,261061,261064,0,3,2
74493,5,3,261066,261066,261069,0,3,2
74494,6,2,261072,261072,261074,0,2,3
74495,1,3,261073,261074,261077,1,4,0
74496,6,3,261079,261079,261082,0,3,2
74497,2,1,261081,261082,261083,1,2,0
74498,6,2,261087,261087,261089,0,2,4
74499,1,3,261088,261089,261092,1,4,0
74500,5,3,261093,261093,261096,0,3,1
74501,5,2,261098,261098,261100,0,2,2
74502,5,2,261103,261103,261105,0,2,3
74503,4,2,261107,261107,261109,0,2,2
74504,5,3,261112,261112,261115,0,3,3
74505,5,1,261117,261117,261118,0,1,2
74506,1,1,261118,261118,261119,0,1,0
74507,4,3,261122,261122,261125,0,3,3
74508,5,2,261127,261127,261129,0,2,2
74509,2,3,261129,261129,261132,0,3,0
74510,5,1,261134,261134,261135,0,1,2
74511,1,3,261135,261135,261138,0,3,0
74512,2,1,261137,261138,261139,1,2,0
74513,5,2,261142,261142,261144,0,2,3
74514,2,2,261144,261144,261146,0,2,0
74515,1,1,261145,261146,261147,1,2,0
74516,1,2,261146,261147,261149,1,3,0
74517,6,2,261152,261152,261154,0,2,3
74518,1,2,261153,261154,261156,1,3,0
74519,2,3,261155,261156,261159,1,4,0
74520,5,1,261160,261160,261161,0,1,1
74521,1,3,261161,261161,261164,0,3,0
74522,1,1,261162,261164,261165,2,3,0
74523,1,1,261163,261165,261166,2,3,0
74524,6,1,261169,261169,261170,0,1,3
74525,2,3,261171,261171,261174,0,3,1
74526,3,1,261174,261174,261175,0,1,0
74527,4,3,261178,261178,261181,0,3,3
74528,6,2,261184,261184,261186,0,2,3
74529,4,1,261188,261188,261189,0,1,2
74530,1,3,261189,261189,261192,0,3,0
74531,4,3,261193,261193,261196,0,3,1
74532,4,3,261197,261197,261200,0,3,1
74533,5,1,261202,261202,261203,0,1,2
74534,4,2,261206,261206,261208,0,2,3
74535,1,3,261207,261208,261211,1,4,0
74536,3,3,261210,261211,261214,1,4,0
74537,1,2,261211,261214,261216,3,5,0
74538,3,2,261214,261216,261218,2,4,0
74539,5,1,261219,261219,261220,0,1,1
74540,1,2,261220,261220,261222,0,2,0
74541,5,3,261225,261225,261228,0,3,3
74542,2,1,261227,261228,261229,1,2,0
74543,1,3,261228,261229,261232,1,4,0
74544,6,1,261234,261234,261235,0,1,2
74545,6,2,261240,261240,261242,0,2,5
74546,1,2,261241,261242,261244,1,3,0
74547,4,2,261245,261245,261247,0,2,1
74548,2,3,261247,261247,261250,0,3,0
74549,5,3,261252,261252,261255,0,3,2
74550,3,2,261255,261255,261257,0,2,0
74551,3,1,261258,261258,261259,0,1,1
74552,5,1,261263,261263,261264,0,1,4
74553,1,2,261264,261264,261266,0,2,0
74554,4,3,261268,261268,261271,0,3,2
74555,3,1,261271,261271,261272,0,1,0
74556,6,3,261277,261277,261280,0,3,5
74557,4,3,261281,261281,261284,0,3,1
74558,4,2,261285,261285,261287,0,2,1
74559,4,3,261289,261289,261292,0,3,2
74560,5,1,261294,261294,261295,0,1,2
74561,5,3,261299,261299,261302,0,3,4
74562,3,2,261302,261302,261304,0,2,0
74563,3,3,261305,261305,261308,0,3,1
74564,1,1,261306,261308,261309,2,3,0
74565,3,1,261309,261309,261310,0,1,0
74566,6,1,261315,261315,261316,0,1,5
74567,2,1,261317,261317,261318,0,1,1
74568,2,3,261319,261319,261322,0,3,1
74569,1,2,261320,261322,261324,2,4,0
74570,6,2,261326,261326,261328,0,2,2
74571,1,3,261327,261328,261331,1,4,0
74572,5,3,261332,261332,261335,0,3,1
74573,6,2,261338,261338,261340,0,2,3
74574,5,2,261343,261343,261345,0,2,3
74575,5,1,261348,261348,261349,0,1,3
74576,3,3,261351,261351,261354,0,3,2
74577,1,1,261352,261354,261355,2,3,0
74578,6,3,261358,261358,261361,0,3,3
74579,5,1,261363,261363,261364,0,1,2
74580,5,2,261368,261368,261370,0,2,4
74581,3,2,261371,261371,261373,0,2,1
74582,4,3,261375,261375,261378,0,3,2
74583,1,3,261376,261378,261381,2,5,0
74584,6,1,261382,261382,261383,0,1,1
74585,5,3,261387,261387,261390,0,3,4
74586,6,3,261393,261393,261396,0,3,3
74587,4,3,261397,261397,261400,0,3,1
74588,4,3,261401,261401,261404,0,3,1
74589,1,2,261402,261404,261406,2,4,0
74590,2,1,261404,261406,261407,2,3,0
74591,5,3,261409,261409,261412,0,3,2
74592,6,2,261415,261415,261417,0,2,3
74593,3,1,261418,261418,261419,0,1,1
74594,1,2,261419,261419,261421,0,2,0
74595,1,2,261420,261421,261423,1,3,0
74596,6,1,261426,261426,261427,0,1,3
74597,4,2,261430,261430,261432,0,2,3
74598,6,3,261436,261436,261439,0,3,4
74599,2,2,261438,261439,261441,1,3,0
74600,2,2,261440,261441,261443,1,3,0
74601,4,3,261444,261444,261447,0,3,1
74602,4,2,261448,261448,261450,0,2,1
74603,5,1,261453,261453,261454,0,1,3
74604,4,3,261457,261457,261460,0,3,3
74605,2,1,261459,261460,261461,1,2,0
74606,5,3,261464,261464,261467,0,3,3
74607,6,3,261470,261470,261473,0,3,3
74608,1,1,261471,261473,261474,2,3,0
74609,5,3,261476,261476,261479,0,3,2
74610,5,1,261481,261481,261482,0,1,2
74611,6,2,261487,261487,261489,0,2,5
74612,2,3,261489,261489,261492,0,3,0
74613,4,2,261493,261493,261495,0,2,1
74614,5,3,261498,261498,261501,0,3,3
74615,4,2,261502,261502,261504,0,2,1
74616,1,1,261503,261504,261505,1,2,0
74617,5,2,261508,261508,261510,0,2,3
74618,6,3,261514,261514,261517,0,3,4
74619,5,1,261519,261519,261520,0,1,2
74620,4,2,261523,261523,261525,0,2,3
74621,1,1,261524,261525,261526,1,2,0
74622,2,3,261526,261526,261529,0,3,0
74623,4,2,261530,261530,261532,0,2,1
74624,3,3,261533,261533,261536,0,3,1
74625,6,2,261539,261539,261541,0,2,3
74626,5,3,261544,261544,261547,0,3,3
74627,3,2,261547,261547,261549,0,2,0
74628,5,3,261552,261552,261555,0,3,3
74629,2,2,261554,261555,261557,1,3,0
74630,1,1,261555,261557,261558,2,3,0
74631,6,2,261561,261561,261563,0,2,3
74632,5,3,261566,261566,261569,0,3,3
74633,1,2,261567,261569,261571,2,4,0
74634,6,1,261573,261573,261574,0,1,2
74635,4,2,261577,261577,261579,0,2,3
74636,6,1,261583,261583,261584,0,1,4
74637,4,2,261587,261587,261589,0,2,3
74638,5,1,261592,261592,261593,0,1,3
74639,5,1,261597,261597,261598,0,1,4
74640,1,2,261598,261598,261600,0,2,0
74641,1,1,261599,261600,261601,1,2,0
74642,1,1,261600,261601,261602,1,2,0
74643,4,3,261604,261604,261607,0,3,2
74644,6,2,261610,261610,261612,0,2,3
74645,5,2,261615,261615,261617,0,2,3
74646,4,2,261619,261619,261621,0,2,2
74647,2,1,261621,261621,261622,0,1,0
74648,4,1,261625,261625,261626,0,1,3
74649,6,2,261631,261631,261633,0,2,5
74650,2,1,261633,261633,261634,0,1,0
74651,5,3,261638,261638,261641,0,3,4
74652,5,1,261643,261643,261644,0,1,2
74653,1,3,261644,261644,261647,0,3,0
74654,6,2,261650,261650,261652,0,2,3
74655,6,1,261656,261656,261657,0,1,4
74656,1,3,261657,261657,261660,0,3,0
74657,4,2,261661,261661,261663,0,2,1
74658,1,2,261662,261663,261665,1,3,0
74659,6,1,261668,261668,261669,0,1,3
74660,4,3,261672,261672,261675,0,3,3
74661,5,2,261677,261677,261679,0,2,2
74662,5,3,261682,261682,261685,0,3,3
74663,1,3,261683,261685,261688,2,5,0
74664,2,2,261685,261688,261690,3,5,0
74665,2,2,261687,261690,261692,3,5,0
74666,5,1,261692,261692,261693,0,1,0
74667,3,1,261695,261695,261696,0,1,2
74668,3,3,261698,261698,261701,0,3,2
74669,3,3,261701,261701,261704,0,3,0
74670,2,1,261703,261704,261705,1,2,0
74671,2,2,261705,261705,261707,0,2,0
74672,3,1,261708,261708,261709,0,1,1
74673,5,2,261713,261713,261715,0,2,4
74674,4,1,261717,261717,261718,0,1,2
74675,5,2,261722,261722,261724,0,2,4
74676,3,1,261725,261725,261726,0,1,1
74677,2,3,261727,261727,261730,0,3,1
74678,3,1,261730,261730,261731,0,1,0
74679,6,1,261736,261736,261737,0,1,5
74680,3,1,261739,261739,261740,0,1,2
74681,2,1,261741,261741,261742,0,1,1
74682,1,2,261742,261742,261744,0,2,0
74683,5,3,261747,261747,261750,0,3,3
74684,3,1,261750,261750,261751,0,1,0
74685,2,1,261752,261752,261753,0,1,1
74686,3,3,261755,261755,261758,0,3,2
74687,2,1,261757,261758,261759,1,2,0
74688,3,3,261760,261760,261763,0,3,1
74689,2,3,261762,261763,261766,1,4,0
74690,4,2,261766,261766,261768,0,2,0
74691,2,2,261768,261768,261770,0,2,0
74692,4,3,261772,261772,261775,0,3,2
74693,6,3,261778,261778,261781,0,3,3
74694,5,1,261783,261783,261784,0,1,2
74695,1,2,261784,261784,261786,0,2,0
74696,1,1,261785,261786,261787,1,2,0
74697,1,1,261786,261787,261788,1,2,0
74698,4,1,261790,261790,261791,0,1,2
74699,2,3,261792,261792,261795,0,3,1
74700,1,1,261793,261795,261796,2,3,0
74701,2,1,261795,261796,261797,1,2,0
74702,4,2,261799,261799,261801,0,2,2
74703,5,3,261804,261804,261807,0,3,3
74704,1,1,261805,261807,261808,2,3,0
74705,6,3,261811,261811,261814,0,3,3
74706,4,2,261815,261815,261817,0,2,1
74707,6,1,261821,261821,261822,0,1,4
74708,6,1,261827,261827,261828,0,1,5
74709,2,2,261829,261829,261831,0,2,1
74710,2,2,261831,261831,261833,0,2,0
74711,2,3,261833,261833,261836,0,3,0
74712,3,3,261836,261836,261839,0,3,0
74713,3,1,261839,261839,261840,0,1,0
74714,3,1,261842,261842,261843,0,1,2
74715,2,3,261844,261844,261847,0,3,1
74716,4,3,261848,261848,261851,0,3,1
74717,3,1,261851,261851,261852,0,1,0
74718,2,3,261853,261853,261856,0,3,1
74719,4,2,261857,261857,261859,0,2,1
74720,6,3,261863,261863,261866,0,3,4
74721,3,3,261866,261866,261869,0,3,0
74722,5,3,261871,261871,261874,0,3,2
74723,6,2,261877,261877,261879,0,2,3
74724,6,1,261883,261883,261884,0,1,4
74725,3,2,261886,261886,261888,0,2,2
74726,2,2,261888,261888,261890,0,2,0
74727,6,1,261894,261894,261895,0,1,4
74728,5,3,261899,261899,261902,0,3,4
74729,2,3,261901,261902,261905,1,4,0
74730,2,1,261903,261905,261906,2,3,0
74731,6,2,261909,261909,261911,0,2,3
74732,6,3,261915,261915,261918,0,3,4
74733,2,2,261917,261918,261920,1,3,0
74734,2,1,261919,261920,261921,1,2,0
74735,5,2,261924,261924,261926,0,2,3
74736,2,1,261926,261926,261927,0,1,0
74737,5,1,261931,261931,261932,0,1,4
74738,6,2,261937,261937,261939,0,2,5
74739,4,2,261941,261941,261943,0,2,2
74740,5,3,261946,261946,261949,0,3,3
74741,4,3,261950,261950,261953,0,3,1
74742,6,1,261956,261956,261957,0,1,3
74743,2,3,261958,261958,261961,0,3,1
74744,3,1,261961,261961,261962,0,1,0
74745,5,3,261966,261966,261969,0,3,4
74746,2,1,261968,261969,261970,1,2,0
74747,1,2,261969,261970,261972,1,3,0
74748,5,2,261974,261974,261976,0,2,2
74749,3,2,261977,261977,261979,0,2,1
74750,5,3,261982,261982,261985,0,3,3
74751,5,1,261987,261987,261988,0,1,2
74752,6,1,261993,261993,261994,0,1,5
74753,4,1,261997,261997,261998,0,1,3
74754,2,3,261999,261999,262002,0,3,1
74755,5,2,262004,262004,262006,0,2,2
74756,4,1,262008,262008,262009,0,1,2
74757,3,1,262011,262011,262012,0,1,2
74758,5,3,262016,262016,262019,0,3,4
74759,2,1,262018,262019,262020,1,2,0
74760,2,1,262020,262020,262021,0,1,0
74761,3,3,262023,262023,262026,0,3,2
74762,3,2,262026,262026,262028,0,2,0
74763,5,2,262031,262031,262033,0,2,3
74764,1,1,262032,262033,262034,1,2,0
74765,5,3,262037,262037,262040,0,3,3
74766,3,3,262040,262040,262043,0,3,0
74767,3,2,262043,262043,262045,0,2,0
74768,1,3,262044,262045,262048,1,4,0
74769,1,3,262045,262048,262051,3,6,0
74770,5,3,262050,262051,262054,1,4,0
74771,5,2,262055,262055,262057,0,2,1
74772,4,3,262059,262059,262062,0,3,2
74773,1,3,262060,262062,262065,2,5,0
74774,1,3,262061,262065,262068,4,7,0
74775,2,3,262063,262068,262071,5,8,0
74776,6,2,262069,262071,262073,2,4,0
74777,5,2,262074,262074,262076,0,2,1
74778,2,2,262076,262076,262078,0,2,0
74779,6,3,262082,262082,262085,0,3,4
74780,3,1,262085,262085,262086,0,1,0
74781,1,1,262086,262086,262087,0,1,0
74782,6,3,262092,262092,262095,0,3,5
74783,4,3,262096,262096,262099,0,3,1
74784,5,2,262101,262101,262103,0,2,2
74785,5,1,262106,262106,262107,0,1,3
74786,4,3,262110,262110,262113,0,3,3
74787,4,1,262114,262114,262115,0,1,1
74788,3,1,262117,262117,262118,0,1,2
74789,1,2,262118,262118,262120,0,2,0
74790,6,1,262124,262124,262125,0,1,4
74791,5,2,262129,262129,262131,0,2,4
74792,5,1,262134,262134,262135,0,1,3
74793,1,3,262135,262135,262138,0,3,0
74794,5,3,262140,262140,262143,0,3,2
74795,2,2,262142,262143,262145,1,3,0
74796,6,1,262148,262148,262149,0,1,3
74797,6,1,262154,262154,262155,0,1,5
74798,1,2,262155,262155,262157,0,2,0
74799,4,1,262159,262159,262160,0,1,2
74800,6,3,262165,262165,262168,0,3,5
74801,6,1,262171,262171,262172,0,1,3
74802,2,2,262173,262173,262175,0,2,1
74803,3,2,262176,262176,262178,0,2,1
74804,1,2,262177,262178,262180,1,3,0
74805,2,3,262179,262180,262183,1,4,0
74806,5,1,262184,262184,262185,0,1,1
74807,3,1,262187,262187,262188,0,1,2
74808,3,1,262190,262190,262191,0,1,2
74809,1,1,262191,262191,262192,0,1,0
74810,6,1,262197,262197,262198,0,1,5
74811,6,1,262203,262203,262204,0,1,5
74812,5,3,262208,262208,262211,0,3,4
74813,6,1,262214,262214,262215,0,1,3
74814,5,3,262219,262219,262222,0,3,4
74815,3,1,262222,262222,262223,0,1,0
74816,4,2,262226,262226,262228,0,2,3
74817,4,1,262230,262230,262231,0,1,2
74818,1,3,262231,262231,262234,0,3,0
74819,5,3,262236,262236,262239,0,3,2
74820,3,1,262239,262239,262240,0,1,0
74821,5,1,262244,262244,262245,0,1,4
74822,3,3,262247,262247,262250,0,3,2
74823,6,3,262253,262253,262256,0,3,3
74824,4,1,262257,262257,262258,0,1,1
74825,5,3,262262,262262,262265,0,3,4
74826,1,3,262263,262265,262268,2,5,0
74827,1,3,262264,262268,262271,4,7,0
74828,4,2,262268,262271,262273,3,5,0
74829,4,3,262272,262273,262276,1,4,0
74830,3,3,262275,262276,262279,1,4,0
74831,5,1,262280,262280,262281,0,1,1
74832,4,3,262284,262284,262287,0,3,3
74833,4,2,262288,262288,262290,0,2,1
74834,3,1,262291,262291,262292,0,1,1
74835,4,2,262295,262295,262297,0,2,3
74836,4,1,262299,262299,262300,0,1,2
74837,5,2,262304,262304,262306,0,2,4
74838,2,3,262306,262306,262309,0,3,0
74839,1,1,262307,262309,262310,2,3,0
74840,2,1,262309,262310,262311,1,2,0
74841,2,2,262311,262311,262313,0,2,0
74842,2,2,262313,262313,262315,0,2,0
74843,5,3,262318,262318,262321,0,3,3
74844,6,3,262324,262324,262327,0,3,3
74845,1,1,262325,262327,262328,2,3,0
74846,5,1,262330,262330,262331,0,1,2
74847,5,2,262335,262335,262337,0,2,4
74848,4,3,262339,262339,262342,0,3,2
74849,1,2,262340,262342,262344,2,4,0
74850,6,2,262346,262346,262348,0,2,2
74851,4,1,262350,262350,262351,0,1,2
74852,4,3,262354,262354,262357,0,3,3
74853,5,1,262359,262359,262360,0,1,2
74854,2,2,262361,262361,262363,0,2,1
74855,4,1,262365,262365,262366,0,1,2
74856,1,1,262366,262366,262367,0,1,0
74857,3,1,262369,262369,262370,0,1,2
74858,4,3,262373,262373,262376,0,3,3
74859,2,1,262375,262376,262377,1,2,0
74860,4,3,262379,262379,262382,0,3,2
74861,3,2,262382,262382,262384,0,2,0
74862,1,1,262383,262384,262385,1,2,0
74863,4,1,262387,262387,262388,0,1,2
74864,5,1,262392,262392,262393,0,1,4
74865,6,1,262398,262398,262399,0,1,5
74866,5,2,262403,262403,262405,0,2,4
74867,5,1,262408,262408,262409,0,1,3
74868,5,2,262413,262413,262415,0,2,4
74869,3,3,262416,262416,262419,0,3,1
74870,6,3,262422,262422,262425,0,3,3
74871,3,1,262425,262425,262426,0,1,0
74872,3,2,262428,262428,262430,0,2,2
74873,4,3,262432,262432,262435,0,3,2
74874,1,2,262433,262435,262437,2,4,0
74875,2,3,262435,262437,262440,2,5,0
74876,2,2,262437,262440,262442,3,5,0
74877,6,1,262443,262443,262444,0,1,1
74878,5,2,262448,262448,262450,0,2,4
74879,4,1,262452,262452,262453,0,1,2
74880,6,1,262458,262458,262459,0,1,5
74881,4,1,262462,262462,262463,0,1,3
74882,4,2,262466,262466,262468,0,2,3
74883,3,1,262469,262469,262470,0,1,1
74884,4,1,262473,262473,262474,0,1,3
74885,5,1,262478,262478,262479,0,1,4
74886,1,3,262479,262479,262482,0,3,0
74887,6,1,262485,262485,262486,0,1,3
74888,2,2,262487,262487,262489,0,2,1
74889,3,3,262490,262490,262493,0,3,1
74890,3,3,262493,262493,262496,0,3,0
74891,2,3,262495,262496,262499,1,4,0
74892,2,1,262497,262499,262500,2,3,0
74893,4,1,262501,262501,262502,0,1,1
74894,4,2,262505,262505,262507,0,2,3
74895,6,2,262511,262511,262513,0,2,4
74896,6,3,262517,262517,262520,0,3,4
74897,6,2,262523,262523,262525,0,2,3
74898,2,3,262525,262525,262528,0,3,0
74899,2,1,262527,262528,262529,1,2,0
74900,3,3,262530,262530,262533,0,3,1
74901,5,1,262535,262535,262536,0,1,2
74902,3,2,262538,262538,262540,0,2,2
74903,5,1,262543,262543,262544,0,1,3
74904,3,2,262546,262546,262548,0,2,2
74905,2,2,262548,262548,262550,0,2,0
74906,1,3,262549,262550,262553,1,4,0
74907,1,3,262550,262553,262556,3,6,0
74908,2,1,262552,262556,262557,4,5,0
74909,4,1,262556,262557,262558,1,2,0
74910,5,1,262561,262561,262562,0,1,3
74911,4,2,262565,262565,262567,0,2,3
74912,6,1,262571,262571,262572,0,1,4
74913,6,1,262577,262577,262578,0,1,5
74914,6,2,262583,262583,262585,0,2,5
74915,1,3,262584,262585,262588,1,4,0
74916,3,1,262587,262588,262589,1,2,0
74917,3,1,262590,262590,262591,0,1,1
74918,1,2,262591,262591,262593,0,2,0
74919,3,3,262594,262594,262597,0,3,1
74920,1,2,262595,262597,262599,2,4,0
74921,4,1,262599,262599,262600,0,1,0
74922,3,1,262602,262602,262603,0,1,2
74923,5,2,262607,262607,262609,0,2,4
74924,3,2,262610,262610,262612,0,2,1
74925,5,1,262615,262615,262616,0,1,3
74926,4,1,262619,262619,262620,0,1,3
74927,1,1,262620,262620,262621,0,1,0
74928,6,1,262626,262626,262627,0,1,5
74929,6,2,262632,262632,262634,0,2,5
74930,2,2,262634,262634,262636,0,2,0
74931,5,2,262639,262639,262641,0,2,3
74932,1,2,262640,262641,262643,1,3,0
74933,2,2,262642,262643,262645,1,3,0
74934,6,3,262648,262648,262651,0,3,3
74935,6,1,262654,262654,262655,0,1,3
74936,1,1,262655,262655,262656,0,1,0
74937,2,3,262657,262657,262660,0,3,1
74938,6,2,262663,262663,262665,0,2,3
74939,4,1,262667,262667,262668,0,1,2
74940,5,1,262672,262672,262673,0,1,4
74941,3,3,262675,262675,262678,0,3,2
74942,4,3,262679,262679,262682,0,3,1
74943,4,2,262683,262683,262685,0,2,1
74944,2,2,262685,262685,262687,0,2,0
74945,4,1,262689,262689,262690,0,1,2
74946,1,1,262690,262690,262691,0,1,0
74947,2,1,262692,262692,262693,0,1,1
74948,6,3,262698,262698,262701,0,3,5
74949,4,2,262702,262702,262704,0,2,1
74950,1,1,262703,262704,262705,1,2,0
74951,2,3,262705,262705,262708,0,3,0
74952,3,2,262708,262708,262710,0,2,0
74953,5,1,262713,262713,262714,0,1,3
74954,1,1,262714,262714,262715,0,1,0
74955,2,2,262716,262716,262718,0,2,1
74956,1,1,262717,262718,262719,1,2,0
74957,2,2,262719,262719,262721,0,2,0
74958,3,3,262722,262722,262725,0,3,1
74959,3,2,262725,262725,262727,0,2,0
74960,1,3,262726,262727,262730,1,4,0
74961,2,1,262728,262730,262731,2,3,0
74962,3,3,262731,262731,262734,0,3,0
74963,4,2,262735,262735,262737,0,2,1
74964,4,2,262739,262739,262741,0,2,2
74965,3,3,262742,262742,262745,0,3,1
74966,5,3,262747,262747,262750,0,3,2
74967,6,1,262753,262753,262754,0,1,3
74968,6,2,262759,262759,262761,0,2,5
74969,6,2,262765,262765,262767,0,2,4
74970,2,2,262767,262767,262769,0,2,0
74971,1,3,262768,262769,262772,1,4,0
74972,5,3,262773,262773,262776,0,3,1
74973,1,3,262774,262776,262779,2,5,0
74974,3,3,262777,262779,262782,2,5,0
74975,2,1,262779,262782,262783,3,4,0
74976,4,2,262783,262783,262785,0,2,0
74977,4,3,262787,262787,262790,0,3,2
74978,5,1,262792,262792,262793,0,1,2
74979,5,2,262797,262797,262799,0,2,4
74980,1,3,262798,262799,262802,1,4,0
74981,4,2,262802,262802,262804,0,2,0
74982,4,1,262806,262806,262807,0,1,2
74983,3,2,262809,262809,262811,0,2,2
74984,4,3,262813,262813,262816,0,3,2
74985,2,3,262815,262816,262819,1,4,0
74986,2,3,262817,262819,262822,2,5,0
74987,3,3,262820,262822,262825,2,5,0
74988,2,1,262822,262825,262826,3,4,0
74989,1,3,262823,262826,262829,3,6,0
74990,5,2,262828,262829,262831,1,3,0
74991,2,2,262830,262831,262833,1,3,0
74992,1,3,262831,262833,262836,2,5,0
74993,2,2,262833,262836,262838,3,5,0
74994,5,2,262838,262838,262840,0,2,0
74995,3,2,262841,262841,262843,0,2,1
74996,2,1,262843,262843,262844,0,1,0
74997,4,1,262847,262847,262848,0,1,3
74998,6,3,262853,262853,262856,0,3,5
74999,6,2,262859,262859,262861,0,2,3
75000,2,1,262861,262861,262862,0,1,0
75001,5,1,262866,262866,262867,0,1,4
75002,6,3,262872,262872,262875,0,3,5
75003,4,1,262876,262876,262877,0,1,1
75004,1,1,262877,262877,262878,0,1,0
75005,5,1,262882,262882,262883,0,1,4
75006,1,3,262883,262883,262886,0,3,0
75007,2,2,262885,262886,262888,1,3,0
75008,1,1,262886,262888,262889,2,3,0
75009,6,3,262892,262892,262895,0,3,3
75010,2,1,262894,262895,262896,1,2,0
75011,3,1,262897,262897,262898,0,1,1
75012,4,3,262901,262901,262904,0,3,3
75013,4,1,262905,262905,262906,0,1,1
75014,6,3,262911,262911,262914,0,3,5
75015,6,1,262917,262917,262918,0,1,3
75016,6,1,262923,262923,262924,0,1,5
75017,1,1,262924,262924,262925,0,1,0
75018,3,3,262927,262927,262930,0,3,2
75019,3,2,262930,262930,262932,0,2,0
75020,6,1,262936,262936,262937,0,1,4
75021,3,2,262939,262939,262941,0,2,2
75022,4,1,262943,262943,262944,0,1,2
75023,5,3,262948,262948,262951,0,3,4
75024,2,1,262950,262951,262952,1,2,0
75025,4,1,262954,262954,262955,0,1,2
75026,1,2,262955,262955,262957,0,2,0
75027,5,1,262960,262960,262961,0,1,3
75028,5,2,262965,262965,262967,0,2,4
75029,6,1,262971,262971,262972,0,1,4
75030,1,1,262972,262972,262973,0,1,0
75031,6,3,262978,262978,262981,0,3,5
75032,5,3,262983,262983,262986,0,3,2
75033,4,3,262987,262987,262990,0,3,1
75034,6,3,262993,262993,262996,0,3,3
75035,6,3,262999,262999,263002,0,3,3
75036,2,3,263001,263002,263005,1,4,0
75037,1,2,263002,263005,263007,3,5,0
75038,1,1,263003,263007,263008,4,5,0
75039,6,2,263009,263009,263011,0,2,1
75040,5,2,263014,263014,263016,0,2,3
75041,6,2,263020,263020,263022,0,2,4
75042,3,1,263023,263023,263024,0,1,1
75043,5,3,263028,263028,263031,0,3,4
75044,5,3,263033,263033,263036,0,3,2
75045,2,1,263035,263036,263037,1,2,0
75046,2,2,263037,263037,263039,0,2,0
75047,6,3,263043,263043,263046,0,3,4
75048,1,2,263044,263046,263048,2,4,0
75049,4,1,263048,263048,263049,0,1,0
75050,1,2,263049,263049,263051,0,2,0
75051,6,2,263055,263055,263057,0,2,4
75052,5,3,263060,263060,263063,0,3,3
75053,3,3,263063,263063,263066,0,3,0
75054,4,3,263067,263067,263070,0,3,1
75055,4,1,263071,263071,263072,0,1,1
75056,3,3,263074,263074,263077,0,3,2
75057,5,1,263079,263079,263080,0,1,2
75058,4,3,263083,263083,263086,0,3,3
75059,6,1,263089,263089,263090,0,1,3
75060,3,3,263092,263092,263095,0,3,2
75061,5,1,263097,263097,263098,0,1,2
75062,3,3,263100,263100,263103,0,3,2
75063,1,2,263101,263103,263105,2,4,0
75064,6,1,263107,263107,263108,0,1,2
75065,2,2,263109,263109,263111,0,2,1
75066,6,2,263115,263115,263117,0,2,4
75067,2,3,263117,263117,263120,0,3,0
75068,6,3,263123,263123,263126,0,3,3
75069,3,2,263126,263126,263128,0,2,0
75070,1,1,263127,263128,263129,1,2,0
75071,3,3,263130,263130,263133,0,3,1
75072,2,3,263132,263133,263136,1,4,0
75073,6,1,263138,263138,263139,0,1,2
75074,3,3,263141,263141,263144,0,3,2
75075,1,1,263142,263144,263145,2,3,0
75076,4,3,263146,263146,263149,0,3,1
75077,3,3,263149,263149,263152,0,3,0
75078,2,2,263151,263152,263154,1,3,0
75079,4,1,263155,263155,263156,0,1,1
75080,1,3,263156,263156,263159,0,3,0
75081,5,3,263161,263161,263164,0,3,2
75082,2,3,263163,263164,263167,1,4,0
75083,3,2,263166,263167,263169,1,3,0
75084,2,2,263168,263169,263171,1,3,0
75085,2,3,263170,263171,263174,1,4,0
75086,6,3,263176,263176,263179,0,3,2
75087,4,2,263180,263180,263182,0,2,1
75088,4,1,263184,263184,263185,0,1,2
75089,4,1,263188,263188,263189,0,1,3
75090,6,3,263194,263194,263197,0,3,5
75091,2,2,263196,263197,263199,1,3,0
75092,4,3,263200,263200,263203,0,3,1
75093,2,2,263202,263203,263205,1,3,0
75094,5,1,263207,263207,263208,0,1,2
75095,2,2,263209,263209,263211,0,2,1
75096,4,3,263213,263213,263216,0,3,2
75097,3,3,263216,263216,263219,0,3,0
75098,5,1,263221,263221,263222,0,1,2
75099,2,1,263223,263223,263224,0,1,1
75100,2,1,263225,263225,263226,0,1,1
75101,4,1,263229,263229,263230,0,1,3
75102,5,3,263234,263234,263237,0,3,4
75103,2,3,263236,263237,263240,1,4,0
75104,6,1,263242,263242,263243,0,1,2
75105,1,2,263243,263243,263245,0,2,0
75106,6,1,263249,263249,263250,0,1,4
75107,2,2,263251,263251,263253,0,2,1
75108,3,1,263254,263254,263255,0,1,1
75109,5,1,263259,263259,263260,0,1,4
75110,5,1,263264,263264,263265,0,1,4
75111,4,3,263268,263268,263271,0,3,3
75112,1,1,263269,263271,263272,2,3,0
75113,3,1,263272,263272,263273,0,1,0
75114,4,3,263276,263276,263279,0,3,3
75115,5,2,263281,263281,263283,0,2,2
75116,6,1,263287,263287,263288,0,1,4
75117,1,2,263288,263288,263290,0,2,0
75118,3,3,263291,263291,263294,0,3,1
75119,6,2,263297,263297,263299,0,2,3
75120,3,1,263300,263300,263301,0,1,1
75121,3,1,263303,263303,263304,0,1,2
75122,6,1,263309,263309,263310,0,1,5
75123,1,3,263310,263310,263313,0,3,0
75124,6,2,263316,263316,263318,0,2,3
75125,5,3,263321,263321,263324,0,3,3
75126,1,2,263322,263324,263326,2,4,0
75127,4,3,263326,263326,263329,0,3,0
75128,5,3,263331,263331,263334,0,3,2
75129,6,3,263337,263337,263340,0,3,3
75130,3,1,263340,263340,263341,0,1,0
75131,1,3,263341,263341,263344,0,3,0
75132,1,3,263342,263344,263347,2,5,0
75133,3,2,263345,263347,263349,2,4,0
75134,2,3,263347,263349,263352,2,5,0
75135,1,2,263348,263352,263354,4,6,0
75136,1,1,263349,263354,263355,5,6,0
75137,6,3,263355,263355,263358,0,3,0
75138,5,3,263360,263360,263363,0,3,2
75139,4,2,263364,263364,263366,0,2,1
75140,6,1,263370,263370,263371,0,1,4
75141,3,2,263373,263373,263375,0,2,2
75142,1,2,263374,263375,263377,1,3,0
75143,2,2,263376,263377,263379,1,3,0
75144,6,3,263382,263382,263385,0,3,3
75145,4,3,263386,263386,263389,0,3,1
75146,6,2,263392,263392,263394,0,2,3
75147,3,1,263395,263395,263396,0,1,1
75148,1,3,263396,263396,263399,0,3,0
75149,6,2,263402,263402,263404,0,2,3
75150,5,3,263407,263407,263410,0,3,3
75151,3,2,263410,263410,263412,0,2,0
75152,5,2,263415,263415,263417,0,2,3
75153,3,2,263418,263418,263420,0,2,1
75154,3,1,263421,263421,263422,0,1,1
75155,4,3,263425,263425,263428,0,3,3
75156,5,3,263430,263430,263433,0,3,2
75157,3,3,263433,263433,263436,0,3,0
75158,5,3,263438,263438,263441,0,3,2
75159,2,2,263440,263441,263443,1,3,0
75160,4,1,263444,263444,263445,0,1,1
75161,2,2,263446,263446,263448,0,2,1
75162,2,2,263448,263448,263450,0,2,0
75163,4,1,263452,263452,263453,0,1,2
75164,4,3,263456,263456,263459,0,3,3
75165,4,2,263460,263460,263462,0,2,1
75166,4,3,263464,263464,263467,0,3,2
75167,6,1,263470,263470,263471,0,1,3
75168,6,3,263476,263476,263479,0,3,5
75169,1,2,263477,263479,263481,2,4,0
75170,1,1,263478,263481,263482,3,4,0
75171,3,1,263481,263482,263483,1,2,0
75172,4,1,263485,263485,263486,0,1,2
75173,1,3,263486,263486,263489,0,3,0
75174,5,1,263491,263491,263492,0,1,2
75175,4,1,263495,263495,263496,0,1,3
75176,2,1,263497,263497,263498,0,1,1
75177,1,3,263498,263498,263501,0,3,0
75178,1,3,263499,263501,263504,2,5,0
75179,3,2,263502,263504,263506,2,4,0
75180,3,3,263505,263506,263509,1,4,0
75181,4,1,263509,263509,263510,0,1,0
75182,6,1,263515,263515,263516,0,1,5
75183,5,2,263520,263520,263522,0,2,4
75184,6,3,263526,263526,263529,0,3,4
75185,1,2,263527,263529,263531,2,4,0
75186,5,1,263532,263532,263533,0,1,1
75187,6,1,263538,263538,263539,0,1,5
75188,6,1,263544,263544,263545,0,1,5
75189,1,2,263545,263545,263547,0,2,0
75190,2,1,263547,263547,263548,0,1,0
75191,2,3,263549,263549,263552,0,3,1
75192,1,1,263550,263552,263553,2,3,0
75193,1,3,263551,263553,263556,2,5,0
75194,2,2,263553,263556,263558,3,5,0
75195,4,3,263557,263558,263561,1,4,0
75196,5,3,263562,263562,263565,0,3,1
75197,4,3,263566,263566,263569,0,3,1
75198,1,3,263567,263569,263572,2,5,0
75199,5,2,263572,263572,263574,0,2,0
75200,1,3,263573,263574,263577,1,4,0
75201,5,1,263578,263578,263579,0,1,1
75202,6,1,263584,263584,263585,0,1,5
75203,5,3,263589,263589,263592,0,3,4
75204,5,3,263594,263594,263597,0,3,2
75205,5,3,263599,263599,263602,0,3,2
75206,2,1,263601,263602,263603,1,2,0
75207,2,2,263603,263603,263605,0,2,0
75208,5,2,263608,263608,263610,0,2,3
75209,6,3,263614,263614,263617,0,3,4
75210,1,1,263615,263617,263618,2,3,0
75211,4,2,263619,263619,263621,0,2,1
75212,2,1,263621,263621,263622,0,1,0
75213,6,1,263627,263627,263628,0,1,5
75214,2,2,263629,263629,263631,0,2,1
75215,5,1,263634,263634,263635,0,1,3
75216,6,1,263640,263640,263641,0,1,5
75217,6,3,263646,263646,263649,0,3,5
75218,5,1,263651,263651,263652,0,1,2
75219,5,2,263656,263656,263658,0,2,4
75220,1,2,263657,263658,263660,1,3,0
75221,6,3,263663,263663,263666,0,3,3
75222,5,3,263668,263668,263671,0,3,2
75223,6,3,263674,263674,263677,0,3,3
75224,1,1,263675,263677,263678,2,3,0
75225,3,1,263678,263678,263679,0,1,0
75226,3,3,263681,263681,263684,0,3,2
75227,6,3,263687,263687,263690,0,3,3
75228,5,1,263692,263692,263693,0,1,2
75229,4,2,263696,263696,263698,0,2,3
75230,3,1,263699,263699,263700,0,1,1
75231,6,3,263705,263705,263708,0,3,5
75232,3,3,263708,263708,263711,0,3,0
75233,4,2,263712,263712,263714,0,2,1
75234,3,3,263715,263715,263718,0,3,1
75235,5,1,263720,263720,263721,0,1,2
75236,2,3,263722,263722,263725,0,3,1
75237,6,1,263728,263728,263729,0,1,3
75238,5,2,263733,263733,263735,0,2,4
75239,4,3,263737,263737,263740,0,3,2
75240,5,1,263742,263742,263743,0,1,2
75241,5,2,263747,263747,263749,0,2,4
75242,5,3,263752,263752,263755,0,3,3
75243,3,2,263755,263755,263757,0,2,0
75244,2,1,263757,263757,263758,0,1,0
75245,4,3,263761,263761,263764,0,3,3
75246,6,3,263767,263767,263770,0,3,3
75247,4,3,263771,263771,263774,0,3,1
75248,5,2,263776,263776,263778,0,2,2
75249,6,3,263782,263782,263785,0,3,4
75250,5,2,263787,263787,263789,0,2,2
75251,4,3,263791,263791,263794,0,3,2
75252,3,1,263794,263794,263795,0,1,0
75253,5,1,263799,263799,263800,0,1,4
75254,2,3,263801,263801,263804,0,3,1
75255,2,3,263803,263804,263807,1,4,0
75256,1,1,263804,263807,263808,3,4,0
75257,3,1,263807,263808,263809,1,2,0
75258,3,3,263810,263810,263813,0,3,1
75259,6,1,263816,263816,263817,0,1,3
75260,5,1,263821,263821,263822,0,1,4
75261,1,3,263822,263822,263825,0,3,0
75262,2,1,263824,263825,263826,1,2,0
75263,6,3,263830,263830,263833,0,3,4
75264,3,3,263833,263833,263836,0,3,0
75265,2,3,263835,263836,263839,1,4,0
75266,6,3,263841,263841,263844,0,3,2
75267,1,3,263842,263844,263847,2,5,0
75268,6,3,263848,263848,263851,0,3,1
75269,4,1,263852,263852,263853,0,1,1
75270,1,3,263853,263853,263856,0,3,0
75271,5,2,263858,263858,263860,0,2,2
75272,3,3,263861,263861,263864,0,3,1
75273,6,2,263867,263867,263869,0,2,3
75274,2,1,263869,263869,263870,0,1,0
75275,1,2,263870,263870,263872,0,2,0
75276,2,1,263872,263872,263873,0,1,0
75277,5,3,263877,263877,263880,0,3,4
75278,2,1,263879,263880,263881,1,2,0
75279,1,1,263880,263881,263882,1,2,0
75280,3,1,263883,263883,263884,0,1,1
75281,4,3,263887,263887,263890,0,3,3
75282,2,2,263889,263890,263892,1,3,0
75283,5,2,263894,263894,263896,0,2,2
75284,3,3,263897,263897,263900,0,3,1
75285,5,3,263902,263902,263905,0,3,2
75286,1,3,263903,263905,263908,2,5,0
75287,2,2,263905,263908,263910,3,5,0
75288,3,3,263908,263910,263913,2,5,0
75289,4,3,263912,263913,263916,1,4,0
75290,3,2,263915,263916,263918,1,3,0
75291,2,2,263917,263918,263920,1,3,0
75292,3,2,263920,263920,263922,0,2,0
75293,2,2,263922,263922,263924,0,2,0
75294,6,3,263928,263928,263931,0,3,4
75295,3,3,263931,263931,263934,0,3,0
75296,2,3,263933,263934,263937,1,4,0
75297,1,2,263934,263937,263939,3,5,0
75298,2,1,263936,263939,263940,3,4,0
75299,2,1,263938,263940,263941,2,3,0
75300,4,3,263942,263942,263945,0,3,1
75301,2,3,263944,263945,263948,1,4,0
75302,3,3,263947,263948,263951,1,4,0
75303,4,3,263951,263951,263954,0,3,0
75304,3,2,263954,263954,263956,0,2,0
75305,1,3,263955,263956,263959,1,4,0
75306,5,2,263960,263960,263962,0,2,1
75307,3,1,263963,263963,263964,0,1,1
75308,1,3,263964,263964,263967,0,3,0
75309,2,1,263966,263967,263968,1,2,0
75310,2,1,263968,263968,263969,0,1,0
75311,2,3,263970,263970,263973,0,3,1
75312,1,1,263971,263973,263974,2,3,0
75313,1,2,263972,263974,263976,2,4,0
75314,1,1,263973,263976,263977,3,4,0
75315,1,3,263974,263977,263980,3,6,0
75316,3,3,263977,263980,263983,3,6,0
75317,5,1,263982,263983,263984,1,2,0
75318,3,2,263985,263985,263987,0,2,1
75319,5,3,263990,263990,263993,0,3,3
75320,2,2,263992,263993,263995,1,3,0
75321,5,2,263997,263997,263999,0,2,2
75322,1,3,263998,263999,264002,1,4,0
75323,6,2,264004,264004,264006,0,2,2
75324,1,3,264005,264006,264009,1,4,0
75325,6,1,264011,264011,264012,0,1,2
75326,3,2,264014,264014,264016,0,2,2
75327,1,1,264015,264016,264017,1,2,0
75328,3,1,264018,264018,264019,0,1,1
75329,2,3,264020,264020,264023,0,3,1
75330,2,2,264022,264023,264025,1,3,0
75331,1,3,264023,264025,264028,2,5,0
75332,1,3,264024,264028,264031,4,7,0
75333,6,3,264030,264031,264034,1,4,0
75334,1,3,264031,264034,264037,3,6,0
75335,4,1,264035,264037,264038,2,3,0
75336,3,2,264038,264038,264040,0,2,0
75337,3,3,264041,264041,264044,0,3,1
75338,2,2,264043,264044,264046,1,3,0
75339,1,1,264044,264046,264047,2,3,0
75340,1,2,264045,264047,264049,2,4,0
75341,2,1,264047,264049,264050,2,3,0
75342,6,2,264053,264053,264055,0,2,3
75343,3,2,264056,264056,264058,0,2,1
75344,4,2,264060,264060,264062,0,2,2
75345,2,3,264062,264062,264065,0,3,0
75346,6,2,264068,264068,264070,0,2,3
75347,6,2,264074,264074,264076,0,2,4
75348,3,2,264077,264077,264079,0,2,1
75349,6,1,264083,264083,264084,0,1,4
75350,6,1,264089,264089,264090,0,1,5
75351,4,3,264093,264093,264096,0,3,3
75352,2,1,264095,264096,264097,1,2,0
75353,2,3,264097,264097,264100,0,3,0
75354,6,3,264103,264103,264106,0,3,3
75355,1,1,264104,264106,264107,2,3,0
75356,3,1,264107,264107,264108,0,1,0
75357,6,1,264113,264113,264114,0,1,5
75358,4,3,264117,264117,264120,0,3,3
75359,6,1,264123,264123,264124,0,1,3
75360,4,3,264127,264127,264130,0,3,3
75361,4,1,264131,264131,264132,0,1,1
75362,5,2,264136,264136,264138,0,2,4
75363,6,3,264142,264142,264145,0,3,4
75364,2,2,264144,264145,264147,1,3,0
75365,3,2,264147,264147,264149,0,2,0
75366,2,1,264149,264149,264150,0,1,0
75367,6,1,264155,264155,264156,0,1,5
75368,1,3,264156,264156,264159,0,3,0
75369,1,2,264157,264159,264161,2,4,0
75370,6,1,264163,264163,264164,0,1,2
75371,2,2,264165,264165,264167,0,2,1
75372,4,3,264169,264169,264172,0,3,2
75373,3,2,264172,264172,264174,0,2,0
75374,1,3,264173,264174,264177,1,4,0
75375,1,1,264174,264177,264178,3,4,0
75376,5,3,264179,264179,264182,0,3,1
75377,1,3,264180,264182,264185,2,5,0
75378,1,3,264181,264185,264188,4,7,0
75379,1,1,264182,264188,264189,6,7,0
75380,2,1,264184,264189,264190,5,6,0
75381,1,3,264185,264190,264193,5,8,0
75382,5,1,264190,264193,264194,3,4,0
75383,1,2,264191,264194,264196,3,5,0
75384,4,3,264195,264196,264199,1,4,0
75385,1,2,264196,264199,264201,3,5,0
75386,2,3,264198,264201,264204,3,6,0
75387,2,3,264200,264204,264207,4,7,0
75388,4,3,264204,264207,264210,3,6,0
75389,4,2,264208,264210,264212,2,4,0
75390,3,3,264211,264212,264215,1,4,0
75391,4,1,264215,264215,264216,0,1,0
75392,3,1,264218,264218,264219,0,1,2
75393,3,3,264221,264221,264224,0,3,2
75394,5,2,264226,264226,264228,0,2,2
75395,3,1,264229,264229,264230,0,1,1
75396,6,3,264235,264235,264238,0,3,5
75397,6,1,264241,264241,264242,0,1,3
75398,6,1,264247,264247,264248,0,1,5
75399,5,1,264252,264252,264253,0,1,4
75400,5,2,264257,264257,264259,0,2,4
75401,4,3,264261,264261,264264,0,3,2
75402,5,3,264266,264266,264269,0,3,2
75403,2,3,264268,264269,264272,1,4,0
75404,3,1,264271,264272,264273,1,2,0
75405,5,3,264276,264276,264279,0,3,3
75406,1,2,264277,264279,264281,2,4,0
75407,3,1,264280,264281,264282,1,2,0
75408,6,3,264286,264286,264289,0,3,4
75409,6,3,264292,264292,264295,0,3,3
75410,6,1,264298,264298,264299,0,1,3
75411,4,3,264302,264302,264305,0,3,3
75412,6,2,264308,264308,264310,0,2,3
75413,6,2,264314,264314,264316,0,2,4
75414,6,3,264320,264320,264323,0,3,4
75415,3,1,264323,264323,264324,0,1,0
75416,3,2,264326,264326,264328,0,2,2
75417,4,1,264330,264330,264331,0,1,2
75418,6,2,264336,264336,264338,0,2,5
75419,3,1,264339,264339,264340,0,1,1
75420,6,2,264345,264345,264347,0,2,5
75421,6,3,264351,264351,264354,0,3,4
75422,3,3,264354,264354,264357,0,3,0
75423,3,1,264357,264357,264358,0,1,0
75424,5,2,264362,264362,264364,0,2,4
75425,1,2,264363,264364,264366,1,3,0
75426,3,1,264366,264366,264367,0,1,0
75427,1,2,264367,264367,264369,0,2,0
75428,6,3,264373,264373,264376,0,3,4
75429,4,3,264377,264377,264380,0,3,1
75430,3,2,264380,264380,264382,0,2,0
75431,4,2,264384,264384,264386,0,2,2
75432,5,2,264389,264389,264391,0,2,3
75433,5,2,264394,264394,264396,0,2,3
75434,4,3,264398,264398,264401,0,3,2
75435,2,3,264400,264401,264404,1,4,0
75436,3,2,264403,264404,264406,1,3,0
75437,4,1,264407,264407,264408,0,1,1
75438,2,2,264409,264409,264411,0,2,1
75439,1,1,264410,264411,264412,1,2,0
75440,2,2,264412,264412,264414,0,2,0
75441,5,1,264417,264417,264418,0,1,3
75442,2,2,264419,264419,264421,0,2,1
75443,2,1,264421,264421,264422,0,1,0
75444,3,3,264424,264424,264427,0,3,2
75445,5,2,264429,264429,264431,0,2,2
75446,5,3,264434,264434,264437,0,3,3
75447,5,3,264439,264439,264442,0,3,2
75448,5,2,264444,264444,264446,0,2,2
75449,5,3,264449,264449,264452,0,3,3
75450,1,1,264450,264452,264453,2,3,0
75451,2,1,264452,264453,264454,1,2,0
75452,4,3,264456,264456,264459,0,3,2
75453,3,1,264459,264459,264460,0,1,0
75454,2,3,264461,264461,264464,0,3,1
75455,1,1,264462,264464,264465,2,3,0
75456,4,1,264466,264466,264467,0,1,1
75457,2,2,264468,264468,264470,0,2,1
75458,6,2,264474,264474,264476,0,2,4
75459,5,2,264479,264479,264481,0,2,3
75460,1,1,264480,264481,264482,1,2,0
75461,5,3,264485,264485,264488,0,3,3
75462,2,1,264487,264488,264489,1,2,0
75463,4,3,264491,264491,264494,0,3,2
75464,5,3,264496,264496,264499,0,3,2
75465,1,2,264497,264499,264501,2,4,0
75466,5,3,264502,264502,264505,0,3,1
75467,1,3,264503,264505,264508,2,5,0
75468,6,1,264509,264509,264510,0,1,1
75469,6,2,264515,264515,264517,0,2,5
75470,3,2,264518,264518,264520,0,2,1
75471,5,2,264523,264523,264525,0,2,3
75472,6,2,264529,264529,264531,0,2,4
75473,3,3,264532,264532,264535,0,3,1
75474,3,1,264535,264535,264536,0,1,0
75475,1,3,264536,264536,264539,0,3,0
75476,4,3,264540,264540,264543,0,3,1
75477,4,2,264544,264544,264546,0,2,1
75478,6,2,264550,264550,264552,0,2,4
75479,2,1,264552,264552,264553,0,1,0
75480,3,2,264555,264555,264557,0,2,2
75481,2,1,264557,264557,264558,0,1,0
75482,5,2,264562,264562,264564,0,2,4
75483,6,3,264568,264568,264571,0,3,4
75484,3,3,264571,264571,264574,0,3,0
75485,3,3,264574,264574,264577,0,3,0
75486,4,1,264578,264578,264579,0,1,1
75487,4,2,264582,264582,264584,0,2,3
75488,2,1,264584,264584,264585,0,1,0
75489,1,3,264585,264585,264588,0,3,0
75490,4,3,264589,264589,264592,0,3,1
75491,4,3,264593,264593,264596,0,3,1
75492,4,1,264597,264597,264598,0,1,1
75493,1,3,264598,264598,264601,0,3,0
75494,3,3,264601,264601,264604,0,3,0
75495,6,2,264607,264607,264609,0,2,3
75496,2,1,264609,264609,264610,0,1,0
75497,4,1,264613,264613,264614,0,1,3
75498,3,1,264616,264616,264617,0,1,2
75499,5,1,264621,264621,264622,0,1,4
75500,5,2,264626,264626,264628,0,2,4
75501,1,2,264627,264628,264630,1,3,0
75502,2,1,264629,264630,264631,1,2,0
75503,5,2,264634,264634,264636,0,2,3
75504,4,3,264638,264638,264641,0,3,2
75505,3,1,264641,264641,264642,0,1,0
75506,2,3,264643,264643,264646,0,3,1
75507,2,3,264645,264646,264649,1,4,0
75508,4,2,264649,264649,264651,0,2,0
75509,1,3,264650,264651,264654,1,4,0
75510,6,2,264656,264656,264658,0,2,2
75511,2,1,264658,264658,264659,0,1,0
75512,4,3,264662,264662,264665,0,3,3
75513,3,2,264665,264665,264667,0,2,0
75514,2,3,264667,264667,264670,0,3,0
75515,2,2,264669,264670,264672,1,3,0
75516,2,2,264671,264672,264674,1,3,0
75517,4,3,264675,264675,264678,0,3,1
75518,5,3,264680,264680,264683,0,3,2
75519,6,2,264686,264686,264688,0,2,3
75520,3,2,264689,264689,264691,0,2,1
75521,5,2,264694,264694,264696,0,2,3
75522,2,2,264696,264696,264698,0,2,0
75523,2,3,264698,264698,264701,0,3,0
75524,1,2,264699,264701,264703,2,4,0
75525,2,3,264701,264703,264706,2,5,0
75526,2,1,264703,264706,264707,3,4,0
75527,4,2,264707,264707,264709,0,2,0
75528,1,1,264708,264709,264710,1,2,0
75529,1,2,264709,264710,264712,1,3,0
75530,6,1,264715,264715,264716,0,1,3
75531,2,2,264717,264717,264719,0,2,1
75532,4,3,264721,264721,264724,0,3,2
75533,3,2,264724,264724,264726,0,2,0
75534,4,2,264728,264728,264730,0,2,2
75535,6,3,264734,264734,264737,0,3,4
75536,1,3,264735,264737,264740,2,5,0
75537,5,1,264740,264740,264741,0,1,0
75538,1,3,264741,264741,264744,0,3,0
75539,1,1,264742,264744,264745,2,3,0
75540,4,1,264746,264746,264747,0,1,1
75541,4,2,264750,264750,264752,0,2,3
75542,3,3,264753,264753,264756,0,3,1
75543,4,1,264757,264757,264758,0,1,1
75544,5,1,264762,264762,264763,0,1,4
75545,3,3,264765,264765,264768,0,3,2
75546,6,3,264771,264771,264774,0,3,3
75547,1,1,264772,264774,264775,2,3,0
75548,3,2,264775,264775,264777,0,2,0
75549,3,2,264778,264778,264780,0,2,1
75550,3,2,264781,264781,264783,0,2,1
75551,3,3,264784,264784,264787,0,3,1
75552,1,1,264785,264787,264788,2,3,0
75553,5,3,264790,264790,264793,0,3,2
75554,6,1,264796,264796,264797,0,1,3
75555,3,3,264799,264799,264802,0,3,2
75556,5,2,264804,264804,264806,0,2,2
75557,4,3,264808,264808,264811,0,3,2
75558,5,3,264813,264813,264816,0,3,2
75559,2,3,264815,264816,264819,1,4,0
75560,5,1,264820,264820,264821,0,1,1
75561,2,2,264822,264822,264824,0,2,1
75562,5,2,264827,264827,264829,0,2,3
75563,5,2,264832,264832,264834,0,2,3
75564,3,1,264835,264835,264836,0,1,1
75565,5,1,264840,264840,264841,0,1,4
75566,5,1,264845,264845,264846,0,1,4
75567,5,3,264850,264850,264853,0,3,4
75568,3,1,264853,264853,264854,0,1,0
75569,2,2,264855,264855,264857,0,2,1
75570,1,2,264856,264857,264859,1,3,0
75571,6,2,264862,264862,264864,0,2,3
75572,3,1,264865,264865,264866,0,1,1
75573,6,2,264871,264871,264873,0,2,5
75574,2,3,264873,264873,264876,0,3,0
75575,2,2,264875,264876,264878,1,3,0
75576,6,3,264881,264881,264884,0,3,3
75577,4,3,264885,264885,264888,0,3,1
75578,6,1,264891,264891,264892,0,1,3
75579,5,1,264896,264896,264897,0,1,4
75580,3,3,264899,264899,264902,0,3,2
75581,6,3,264905,264905,264908,0,3,3
75582,1,2,264906,264908,264910,2,4,0
75583,3,2,264909,264910,264912,1,3,0
75584,5,1,264914,264914,264915,0,1,2
75585,2,1,264916,264916,264917,0,1,1
75586,4,1,264920,264920,264921,0,1,3
75587,3,1,264923,264923,264924,0,1,2
75588,1,3,264924,264924,264927,0,3,0
75589,1,1,264925,264927,264928,2,3,0
75590,4,2,264929,264929,264931,0,2,1
75591,3,1,264932,264932,264933,0,1,1
75592,1,2,264933,264933,264935,0,2,0
75593,1,1,264934,264935,264936,1,2,0
75594,3,3,264937,264937,264940,0,3,1
75595,3,2,264940,264940,264942,0,2,0
75596,2,2,264942,264942,264944,0,2,0
75597,1,2,264943,264944,264946,1,3,0
75598,2,1,264945,264946,264947,1,2,0
75599,6,3,264951,264951,264954,0,3,4
75600,3,2,264954,264954,264956,0,2,0
75601,1,1,264955,264956,264957,1,2,0
75602,5,3,264960,264960,264963,0,3,3
75603,6,3,264966,264966,264969,0,3,3
75604,1,1,264967,264969,264970,2,3,0
75605,3,1,264970,264970,264971,0,1,0
75606,5,2,264975,264975,264977,0,2,4
75607,4,2,264979,264979,264981,0,2,2
75608,5,2,264984,264984,264986,0,2,3
75609,1,3,264985,264986,264989,1,4,0
75610,4,2,264989,264989,264991,0,2,0
75611,5,3,264994,264994,264997,0,3,3
75612,4,2,264998,264998,265000,0,2,1
75613,2,3,265000,265000,265003,0,3,0
75614,1,2,265001,265003,265005,2,4,0
75615,4,3,265005,265005,265008,0,3,0
75616,1,1,265006,265008,265009,2,3,0
75617,4,1,265010,265010,265011,0,1,1
75618,5,1,265015,265015,265016,0,1,4
75619,3,2,265018,265018,265020,0,2,2
75620,5,3,265023,265023,265026,0,3,3
75621,3,3,265026,265026,265029,0,3,0
75622,1,2,265027,265029,265031,2,4,0
75623,2,2,265029,265031,265033,2,4,0
75624,1,3,265030,265033,265036,3,6,0
75625,1,1,265031,265036,265037,5,6,0
75626,2,3,265033,265037,265040,4,7,0
75627,4,1,265037,265040,265041,3,4,0
75628,3,2,265040,265041,265043,1,3,0
75629,6,1,265046,265046,265047,0,1,3
75630,1,1,265047,265047,265048,0,1,0
75631,2,1,265049,265049,265050,0,1,1
75632,4,1,265053,265053,265054,0,1,3
75633,5,1,265058,265058,265059,0,1,4
75634,6,2,265064,265064,265066,0,2,5
75635,4,1,265068,265068,265069,0,1,2
75636,6,2,265074,265074,265076,0,2,5
75637,6,3,265080,265080,265083,0,3,4
75638,2,2,265082,265083,265085,1,3,0
75639,3,3,265085,265085,265088,0,3,0
75640,3,3,265088,265088,265091,0,3,0
75641,4,2,265092,265092,265094,0,2,1
75642,4,1,265096,265096,265097,0,1,2
75643,1,2,265097,265097,265099,0,2,0
75644,2,1,265099,265099,265100,0,1,0
75645,4,3,265103,265103,265106,0,3,3
75646,4,3,265107,265107,265110,0,3,1
75647,5,2,265112,265112,265114,0,2,2
75648,5,1,265117,265117,265118,0,1,3
75649,4,3,265121,265121,265124,0,3,3
75650,2,2,265123,265124,265126,1,3,0
75651,2,3,265125,265126,265129,1,4,0
75652,5,3,265130,265130,265133,0,3,1
75653,6,1,265136,265136,265137,0,1,3
75654,5,3,265141,265141,265144,0,3,4
75655,4,3,265145,265145,265148,0,3,1
75656,4,2,265149,265149,265151,0,2,1
75657,4,2,265153,265153,265155,0,2,2
75658,5,1,265158,265158,265159,0,1,3
75659,2,3,265160,265160,265163,0,3,1
75660,6,3,265166,265166,265169,0,3,3
75661,4,2,265170,265170,265172,0,2,1
75662,6,2,265176,265176,265178,0,2,4
75663,1,3,265177,265178,265181,1,4,0
75664,2,1,265179,265181,265182,2,3,0
75665,2,2,265181,265182,265184,1,3,0
75666,5,3,265186,265186,265189,0,3,2
75667,1,3,265187,265189,265192,2,5,0
75668,5,3,265192,265192,265195,0,3,0
75669,5,3,265197,265197,265200,0,3,2
75670,2,2,265199,265200,265202,1,3,0
75671,4,1,265203,265203,265204,0,1,1
75672,2,3,265205,265205,265208,0,3,1
75673,4,1,265209,265209,265210,0,1,1
75674,3,2,265212,265212,265214,0,2,2
75675,4,1,265216,265216,265217,0,1,2
75676,3,2,265219,265219,265221,0,2,2
75677,1,2,265220,265221,265223,1,3,0
75678,6,3,265226,265226,265229,0,3,3
75679,3,1,265229,265229,265230,0,1,0
75680,2,2,265231,265231,265233,0,2,1
75681,5,3,265236,265236,265239,0,3,3
75682,5,1,265241,265241,265242,0,1,2
75683,4,3,265245,265245,265248,0,3,3
75684,2,3,265247,265248,265251,1,4,0
75685,1,1,265248,265251,265252,3,4,0
75686,3,3,265251,265252,265255,1,4,0
75687,1,2,265252,265255,265257,3,5,0
75688,2,2,265254,265257,265259,3,5,0
75689,6,3,265260,265260,265263,0,3,1
75690,5,3,265265,265265,265268,0,3,2
75691,1,1,265266,265268,265269,2,3,0
75692,2,1,265268,265269,265270,1,2,0
75693,2,1,265270,265270,265271,0,1,0
75694,2,3,265272,265272,265275,0,3,1
75695,5,1,265277,265277,265278,0,1,2
75696,1,1,265278,265278,265279,0,1,0
75697,4,1,265282,265282,265283,0,1,3
75698,2,3,265284,265284,265287,0,3,1
75699,3,3,265287,265287,265290,0,3,0
75700,4,1,265291,265291,265292,0,1,1
75701,6,2,265297,265297,265299,0,2,5
75702,1,1,265298,265299,265300,1,2,0
75703,1,2,265299,265300,265302,1,3,0
75704,5,3,265304,265304,265307,0,3,2
75705,3,3,265307,265307,265310,0,3,0
75706,5,2,265312,265312,265314,0,2,2
75707,1,2,265313,265314,265316,1,3,0
75708,4,2,265317,265317,265319,0,2,1
75709,1,2,265318,265319,265321,1,3,0
75710,5,3,265323,265323,265326,0,3,2
75711,6,1,265329,265329,265330,0,1,3
75712,2,3,265331,265331,265334,0,3,1
75713,3,1,265334,265334,265335,0,1,0
75714,4,3,265338,265338,265341,0,3,3
75715,5,3,265343,265343,265346,0,3,2
75716,5,1,265348,265348,265349,0,1,2
75717,3,2,265351,265351,265353,0,2,2
75718,3,2,265354,265354,265356,0,2,1
75719,1,2,265355,265356,265358,1,3,0
75720,1,1,265356,265358,265359,2,3,0
75721,1,2,265357,265359,265361,2,4,0
75722,2,3,265359,265361,265364,2,5,0
75723,4,3,265363,265364,265367,1,4,0
75724,6,1,265369,265369,265370,0,1,2
75725,1,2,265370,265370,265372,0,2,0
75726,1,3,265371,265372,265375,1,4,0
75727,3,3,265374,265375,265378,1,4,0
75728,5,3,265379,265379,265382,0,3,1
75729,2,2,265381,265382,265384,1,3,0
75730,1,3,265382,265384,265387,2,5,0
75731,2,2,265384,265387,265389,3,5,0
75732,2,1,265386,265389,265390,3,4,0
75733,2,1,265388,265390,265391,2,3,0
75734,5,1,265393,265393,265394,0,1,2
75735,4,1,265397,265397,265398,0,1,3
75736,4,1,265401,265401,265402,0,1,3
75737,3,2,265404,265404,265406,0,2,2
75738,6,3,265410,265410,265413,0,3,4
75739,3,1,265413,265413,265414,0,1,0
75740,6,2,265419,265419,265421,0,2,5
75741,2,3,265421,265421,265424,0,3,0
75742,1,2,265422,265424,265426,2,4,0
75743,3,2,265425,265426,265428,1,3,0
75744,6,3,265431,265431,265434,0,3,3
75745,4,2,265435,265435,265437,0,2,1
75746,1,1,265436,265437,265438,1,2,0
75747,3,2,265439,265439,265441,0,2,1
75748,5,2,265444,265444,265446,0,2,3
75749,2,1,265446,265446,265447,0,1,0
75750,6,2,265452,265452,265454,0,2,5
75751,2,2,265454,265454,265456,0,2,0
75752,4,3,265458,265458,265461,0,3,2
75753,2,1,265460,265461,265462,1,2,0
75754,4,1,265464,265464,265465,0,1,2
75755,4,2,265468,265468,265470,0,2,3
75756,3,1,265471,265471,265472,0,1,1
75757,6,2,265477,265477,265479,0,2,5
75758,6,3,265483,265483,265486,0,3,4
75759,4,3,265487,265487,265490,0,3,1
75760,5,3,265492,265492,265495,0,3,2
75761,3,1,265495,265495,265496,0,1,0
75762,3,1,265498,265498,265499,0,1,2
75763,4,3,265502,265502,265505,0,3,3
75764,3,1,265505,265505,265506,0,1,0
75765,5,1,265510,265510,265511,0,1,4
75766,4,2,265514,265514,265516,0,2,3
75767,6,3,265520,265520,265523,0,3,4
75768,5,1,265525,265525,265526,0,1,2
75769,4,1,265529,265529,265530,0,1,3
75770,1,3,265530,265530,265533,0,3,0
75771,1,3,265531,265533,265536,2,5,0
75772,1,1,265532,265536,265537,4,5,0
75773,2,1,265534,265537,265538,3,4,0
75774,1,3,265535,265538,265541,3,6,0
75775,4,2,265539,265541,265543,2,4,0
75776,1,1,265540,265543,265544,3,4,0
75777,4,2,265544,265544,265546,0,2,0
75778,6,2,265550,265550,265552,0,2,4
75779,5,3,265555,265555,265558,0,3,3
75780,4,3,265559,265559,265562,0,3,1
75781,6,3,265565,265565,265568,0,3,3
75782,5,1,265570,265570,265571,0,1,2
75783,5,1,265575,265575,265576,0,1,4
75784,4,1,265579,265579,265580,0,1,3
75785,3,1,265582,265582,265583,0,1,2
75786,6,1,265588,265588,265589,0,1,5
75787,2,1,265590,265590,265591,0,1,1
75788,4,2,265594,265594,265596,0,2,3
75789,1,3,265595,265596,265599,1,4,0
75790,2,1,265597,265599,265600,2,3,0
75791,5,3,265602,265602,265605,0,3,2
75792,5,1,265607,265607,265608,0,1,2
75793,2,2,265609,265609,265611,0,2,1
75794,3,2,265612,265612,265614,0,2,1
75795,2,1,265614,265614,265615,0,1,0
75796,3,3,265617,265617,265620,0,3,2
75797,6,3,265623,265623,265626,0,3,3
75798,1,1,265624,265626,265627,2,3,0
75799,1,3,265625,265627,265630,2,5,0
75800,5,3,265630,265630,265633,0,3,0
75801,5,2,265635,265635,265637,0,2,2
75802,3,2,265638,265638,265640,0,2,1
75803,5,1,265643,265643,265644,0,1,3
75804,1,2,265644,265644,265646,0,2,0
75805,1,2,265645,265646,265648,1,3,0
75806,4,3,265649,265649,265652,0,3,1
75807,5,1,265654,265654,265655,0,1,2
75808,5,1,265659,265659,265660,0,1,4
75809,4,3,265663,265663,265666,0,3,3
75810,1,3,265664,265666,265669,2,5,0
75811,4,3,265668,265669,265672,1,4,0
75812,2,1,265670,265672,265673,2,3,0
75813,2,3,265672,265673,265676,1,4,0
75814,2,1,265674,265676,265677,2,3,0
75815,1,3,265675,265677,265680,2,5,0
75816,1,1,265676,265680,265681,4,5,0
75817,4,2,265680,265681,265683,1,3,0
75818,2,2,265682,265683,265685,1,3,0
75819,2,3,265684,265685,265688,1,4,0
75820,4,3,265688,265688,265691,0,3,0
75821,3,2,265691,265691,265693,0,2,0
75822,5,2,265696,265696,265698,0,2,3
75823,2,2,265698,265698,265700,0,2,0
75824,3,3,265701,265701,265704,0,3,1
75825,4,1,265705,265705,265706,0,1,1
75826,2,3,265707,265707,265710,0,3,1
75827,6,1,265713,265713,265714,0,1,3
75828,1,1,265714,265714,265715,0,1,0
75829,1,3,265715,265715,265718,0,3,0
75830,5,1,265720,265720,265721,0,1,2
75831,4,3,265724,265724,265727,0,3,3
75832,2,3,265726,265727,265730,1,4,0
75833,6,1,265732,265732,265733,0,1,2
75834,1,2,265733,265733,265735,0,2,0
75835,4,3,265737,265737,265740,0,3,2
75836,3,1,265740,265740,265741,0,1,0
75837,4,2,265744,265744,265746,0,2,3
75838,5,2,265749,265749,265751,0,2,3
75839,1,2,265750,265751,265753,1,3,0
75840,2,3,265752,265753,265756,1,4,0
75841,5,3,265757,265757,265760,0,3,1
75842,5,2,265762,265762,265764,0,2,2
75843,1,2,265763,265764,265766,1,3,0
75844,3,1,265766,265766,265767,0,1,0
75845,4,1,265770,265770,265771,0,1,3
75846,6,2,265776,265776,265778,0,2,5
75847,6,2,265782,265782,265784,0,2,4
75848,5,3,265787,265787,265790,0,3,3
75849,6,2,265793,265793,265795,0,2,3
75850,3,3,265796,265796,265799,0,3,1
75851,3,2,265799,265799,265801,0,2,0
75852,6,2,265805,265805,265807,0,2,4
75853,3,1,265808,265808,265809,0,1,1
75854,5,3,265813,265813,265816,0,3,4
75855,1,1,265814,265816,265817,2,3,0
75856,2,2,265816,265817,265819,1,3,0
75857,3,2,265819,265819,265821,0,2,0
75858,5,3,265824,265824,265827,0,3,3
75859,1,2,265825,265827,265829,2,4,0
75860,4,3,265829,265829,265832,0,3,0
75861,4,1,265833,265833,265834,0,1,1
75862,4,1,265837,265837,265838,0,1,3
75863,4,1,265841,265841,265842,0,1,3
75864,6,3,265847,265847,265850,0,3,5
75865,3,3,265850,265850,265853,0,3,0
75866,5,1,265855,265855,265856,0,1,2
75867,6,2,265861,265861,265863,0,2,5
75868,5,3,265866,265866,265869,0,3,3
75869,1,2,265867,265869,265871,2,4,0
75870,3,2,265870,265871,265873,1,3,0
75871,6,1,265876,265876,265877,0,1,3
75872,4,3,265880,265880,265883,0,3,3
75873,2,1,265882,265883,265884,1,2,0
75874,2,2,265884,265884,265886,0,2,0
75875,4,1,265888,265888,265889,0,1,2
75876,6,2,265894,265894,265896,0,2,5
75877,2,3,265896,265896,265899,0,3,0
75878,6,3,265902,265902,265905,0,3,3
75879,2,2,265904,265905,265907,1,3,0
75880,6,3,265910,265910,265913,0,3,3
75881,4,2,265914,265914,265916,0,2,1
75882,4,2,265918,265918,265920,0,2,2
75883,3,2,265921,265921,265923,0,2,1
75884,1,3,265922,265923,265926,1,4,0
75885,2,3,265924,265926,265929,2,5,0
75886,5,2,265929,265929,265931,0,2,0
75887,3,3,265932,265932,265935,0,3,1
75888,3,2,265935,265935,265937,0,2,0
75889,6,1,265941,265941,265942,0,1,4
75890,6,2,265947,265947,265949,0,2,5
75891,1,1,265948,265949,265950,1,2,0
75892,1,2,265949,265950,265952,1,3,0
75893,5,1,265954,265954,265955,0,1,2
75894,6,3,265960,265960,265963,0,3,5
75895,6,1,265966,265966,265967,0,1,3
75896,1,3,265967,265967,265970,0,3,0
75897,5,1,265972,265972,265973,0,1,2
75898,5,3,265977,265977,265980,0,3,4
75899,1,1,265978,265980,265981,2,3,0
75900,3,3,265981,265981,265984,0,3,0
75901,4,2,265985,265985,265987,0,2,1
75902,6,2,265991,265991,265993,0,2,4
75903,1,1,265992,265993,265994,1,2,0
75904,6,1,265998,265998,265999,0,1,4
75905,3,3,266001,266001,266004,0,3,2
75906,4,3,266005,266005,266008,0,3,1
75907,6,2,266011,266011,266013,0,2,3
75908,3,1,266014,266014,266015,0,1,1
75909,4,1,266018,266018,266019,0,1,3
75910,1,3,266019,266019,266022,0,3,0
75911,5,1,266024,266024,266025,0,1,2
75912,4,2,266028,266028,266030,0,2,3
75913,4,3,266032,266032,266035,0,3,2
75914,6,1,266038,266038,266039,0,1,3
75915,6,3,266044,266044,266047,0,3,5
75916,4,2,266048,266048,266050,0,2,1
75917,4,3,266052,266052,266055,0,3,2
75918,1,1,266053,266055,266056,2,3,0
75919,5,2,266058,266058,266060,0,2,2
75920,6,1,266064,266064,266065,0,1,4
75921,6,2,266070,266070,266072,0,2,5
75922,6,1,266076,266076,266077,0,1,4
75923,5,2,266081,266081,266083,0,2,4
75924,2,1,266083,266083,266084,0,1,0
75925,4,1,266087,266087,266088,0,1,3
75926,4,2,266091,266091,266093,0,2,3
75927,2,1,266093,266093,266094,0,1,0
75928,2,1,266095,266095,266096,0,1,1
75929,3,3,266098,266098,266101,0,3,2
75930,2,2,266100,266101,266103,1,3,0
75931,5,2,266105,266105,266107,0,2,2
75932,5,1,266110,266110,266111,0,1,3
75933,2,1,266112,266112,266113,0,1,1
75934,2,2,266114,266114,266116,0,2,1
75935,5,1,266119,266119,266120,0,1,3
75936,6,1,266125,266125,266126,0,1,5
75937,4,1,266129,266129,266130,0,1,3
75938,2,3,266131,266131,266134,0,3,1
75939,3,1,266134,266134,266135,0,1,0
75940,3,1,266137,266137,266138,0,1,2
75941,5,2,266142,266142,266144,0,2,4
75942,3,3,266145,266145,266148,0,3,1
75943,4,2,266149,266149,266151,0,2,1
75944,4,3,266153,266153,266156,0,3,2
75945,4,2,266157,266157,266159,0,2,1
75946,6,1,266163,266163,266164,0,1,4
75947,5,1,266168,266168,266169,0,1,4
75948,6,2,266174,266174,266176,0,2,5
75949,6,1,266180,266180,266181,0,1,4
75950,5,1,266185,266185,266186,0,1,4
75951,6,2,266191,266191,266193,0,2,5
75952,5,1,266196,266196,266197,0,1,3
75953,5,2,266201,266201,266203,0,2,4
75954,2,1,266203,266203,266204,0,1,0
75955,3,2,266206,266206,266208,0,2,2
75956,4,3,266210,266210,266213,0,3,2
75957,1,1,266211,266213,266214,2,3,0
75958,4,2,266215,266215,266217,0,2,1
75959,6,1,266221,266221,266222,0,1,4
75960,1,1,266222,266222,266223,0,1,0
75961,2,1,266224,266224,266225,0,1,1
75962,4,1,266228,266228,266229,0,1,3
75963,2,1,266230,266230,266231,0,1,1
75964,4,1,266234,266234,266235,0,1,3
75965,1,1,266235,266235,266236,0,1,0
75966,3,1,266238,266238,266239,0,1,2
75967,1,3,266239,266239,266242,0,3,0
75968,4,2,266243,266243,266245,0,2,1
75969,1,1,266244,266245,266246,1,2,0
75970,5,2,266249,266249,266251,0,2,3
75971,6,3,266255,266255,266258,0,3,4
75972,5,3,266260,266260,266263,0,3,2
75973,6,1,266266,266266,266267,0,1,3
75974,2,3,266268,266268,266271,0,3,1
75975,2,1,266270,266271,266272,1,2,0
75976,4,2,266274,266274,266276,0,2,2
75977,3,1,266277,266277,266278,0,1,1
75978,2,1,266279,266279,266280,0,1,1
75979,1,2,266280,266280,266282,0,2,0
75980,2,3,266282,266282,266285,0,3,0
75981,4,1,266286,266286,266287,0,1,1
75982,4,1,266290,266290,266291,0,1,3
75983,6,1,266296,266296,266297,0,1,5
75984,3,2,266299,266299,266301,0,2,2
75985,6,2,266305,266305,266307,0,2,4
75986,3,1,266308,266308,266309,0,1,1
75987,4,1,266312,266312,266313,0,1,3
75988,3,2,266315,266315,266317,0,2,2
75989,1,2,266316,266317,266319,1,3,0
75990,4,3,266320,266320,266323,0,3,1
75991,3,2,266323,266323,266325,0,2,0
75992,5,2,266328,266328,266330,0,2,3
75993,2,2,266330,266330,266332,0,2,0
75994,3,3,266333,266333,266336,0,3,1
75995,6,3,266339,266339,266342,0,3,3
75996,1,3,266340,266342,266345,2,5,0
75997,4,3,266344,266345,266348,1,4,0
75998,2,2,266346,266348,266350,2,4,0
75999,4,3,266350,266350,266353,0,3,0
76000,4,1,266354,266354,266355,0,1,1
76001,2,3,266356,266356,266359,0,3,1
76002,5,1,266361,266361,266362,0,1,2
76003,5,3,266366,266366,266369,0,3,4
76004,6,3,266372,266372,266375,0,3,3
76005,6,2,266378,266378,266380,0,2,3
76006,6,2,266384,266384,266386,0,2,4
76007,5,3,266389,266389,266392,0,3,3
76008,1,2,266390,266392,266394,2,4,0
76009,2,1,266392,266394,266395,2,3,0
76010,6,2,266398,266398,266400,0,2,3
76011,6,2,266404,266404,266406,0,2,4
76012,6,3,266410,266410,266413,0,3,4
76013,4,3,266414,266414,266417,0,3,1
76014,5,1,266419,266419,266420,0,1,2
76015,1,1,266420,266420,266421,0,1,0
76016,1,3,266421,266421,266424,0,3,0
76017,2,3,266423,266424,266427,1,4,0
76018,4,3,266427,266427,266430,0,3,0
76019,3,3,266430,266430,266433,0,3,0
76020,2,3,266432,266433,266436,1,4,0
76021,4,1,266436,266436,266437,0,1,0
76022,3,2,266439,266439,266441,0,2,2
76023,4,1,266443,266443,266444,0,1,2
76024,2,2,266445,266445,266447,0,2,1
76025,4,3,266449,266449,266452,0,3,2
76026,2,3,266451,266452,266455,1,4,0
76027,1,2,266452,266455,266457,3,5,0
76028,3,1,266455,266457,266458,2,3,0
76029,4,1,266459,266459,266460,0,1,1
76030,1,1,266460,266460,266461,0,1,0
76031,1,2,266461,266461,266463,0,2,0
76032,5,3,266466,266466,266469,0,3,3
76033,6,3,266472,266472,266475,0,3,3
76034,4,2,266476,266476,266478,0,2,1
76035,2,1,266478,266478,266479,0,1,0
76036,6,2,266484,266484,266486,0,2,5
76037,6,3,266490,266490,266493,0,3,4
76038,3,1,266493,266493,266494,0,1,0
76039,3,2,266496,266496,266498,0,2,2
76040,6,1,266502,266502,266503,0,1,4
76041,1,1,266503,266503,266504,0,1,0
76042,4,2,266507,266507,266509,0,2,3
76043,1,1,266508,266509,266510,1,2,0
76044,6,3,266514,266514,266517,0,3,4
76045,3,1,266517,266517,266518,0,1,0
76046,3,1,266520,266520,266521,0,1,2
76047,5,2,266525,266525,266527,0,2,4
76048,1,3,266526,266527,266530,1,4,0
76049,3,2,266529,266530,266532,1,3,0
76050,3,1,266532,266532,266533,0,1,0
76051,6,1,266538,266538,266539,0,1,5
76052,1,3,266539,266539,266542,0,3,0
76053,2,2,266541,266542,266544,1,3,0
76054,6,3,266547,266547,266550,0,3,3
76055,5,3,266552,266552,266555,0,3,2
76056,5,1,266557,266557,266558,0,1,2
76057,6,1,266563,266563,266564,0,1,5
76058,4,1,266567,266567,266568,0,1,3
76059,2,3,266569,266569,266572,0,3,1
76060,5,2,266574,266574,266576,0,2,2
76061,4,2,266578,266578,266580,0,2,2
76062,2,1,266580,266580,266581,0,1,0
76063,5,3,266585,266585,266588,0,3,4
76064,1,3,266586,266588,266591,2,5,0
76065,1,3,266587,266591,266594,4,7,0
76066,2,1,266589,266594,266595,5,6,0
76067,3,3,266592,266595,266598,3,6,0
76068,4,1,266596,266598,266599,2,3,0
76069,1,3,266597,266599,266602,2,5,0
76070,6,3,266603,266603,266606,0,3,1
76071,2,3,266605,266606,266609,1,4,0
76072,3,3,266608,266609,266612,1,4,0
76073,3,2,266611,266612,266614,1,3,0
76074,3,3,266614,266614,266617,0,3,0
76075,4,2,266618,266618,266620,0,2,1
76076,4,3,266622,266622,266625,0,3,2
76077,1,1,266623,266625,266626,2,3,0
76078,3,3,266626,266626,266629,0,3,0
76079,1,2,266627,266629,266631,2,4,0
76080,2,2,266629,266631,266633,2,4,0
76081,2,2,266631,266633,266635,2,4,0
76082,3,3,266634,266635,266638,1,4,0
76083,1,2,266635,266638,266640,3,5,0
76084,6,2,266641,266641,266643,0,2,1
76085,1,3,266642,266643,266646,1,4,0
76086,5,1,266647,266647,266648,0,1,1
76087,6,1,266653,266653,266654,0,1,5
76088,5,2,266658,266658,266660,0,2,4
76089,3,3,266661,266661,266664,0,3,1
76090,3,3,266664,266664,266667,0,3,0
76091,6,3,266670,266670,266673,0,3,3
76092,4,3,266674,266674,266677,0,3,1
76093,3,1,266677,266677,266678,0,1,0
76094,6,1,266683,266683,266684,0,1,5
76095,4,1,266687,266687,266688,0,1,3
76096,3,1,266690,266690,266691,0,1,2
76097,2,1,266692,266692,266693,0,1,1
76098,5,1,266697,266697,266698,0,1,4
76099,4,3,266701,266701,266704,0,3,3
76100,6,3,266707,266707,266710,0,3,3
76101,6,1,266713,266713,266714,0,1,3
76102,3,3,266716,266716,266719,0,3,2
76103,3,3,266719,266719,266722,0,3,0
76104,3,1,266722,266722,266723,0,1,0
76105,3,3,266725,266725,266728,0,3,2
76106,6,1,266731,266731,266732,0,1,3
76107,1,3,266732,266732,266735,0,3,0
76108,4,1,266736,266736,266737,0,1,1
76109,4,2,266740,266740,266742,0,2,3
76110,3,1,266743,266743,266744,0,1,1
76111,1,1,266744,266744,266745,0,1,0
76112,6,3,266750,266750,266753,0,3,5
76113,1,2,266751,266753,266755,2,4,0
76114,2,2,266753,266755,266757,2,4,0
76115,2,2,266755,266757,266759,2,4,0
76116,1,1,266756,266759,266760,3,4,0
76117,1,3,266757,266760,266763,3,6,0
76118,4,2,266761,266763,266765,2,4,0
76119,4,3,266765,266765,266768,0,3,0
76120,2,2,266767,266768,266770,1,3,0
76121,3,2,266770,266770,266772,0,2,0
76122,5,3,266775,266775,266778,0,3,3
76123,4,3,266779,266779,266782,0,3,1
76124,4,3,266783,266783,266786,0,3,1
76125,2,3,266785,266786,266789,1,4,0
76126,6,3,266791,266791,266794,0,3,2
76127,5,1,266796,266796,266797,0,1,2
76128,6,3,266802,266802,266805,0,3,5
76129,6,3,266808,266808,266811,0,3,3
76130,5,2,266813,266813,266815,0,2,2
76131,5,1,266818,266818,266819,0,1,3
76132,1,3,266819,266819,266822,0,3,0
76133,1,3,266820,266822,266825,2,5,0
76134,6,3,266826,266826,266829,0,3,1
76135,3,3,266829,266829,266832,0,3,0
76136,6,2,266835,266835,266837,0,2,3
76137,4,2,266839,266839,266841,0,2,2
76138,1,1,266840,266841,266842,1,2,0
76139,6,2,266846,266846,266848,0,2,4
76140,1,1,266847,266848,266849,1,2,0
76141,1,2,266848,266849,266851,1,3,0
76142,5,2,266853,266853,266855,0,2,2
76143,3,1,266856,266856,266857,0,1,1
76144,4,1,266860,266860,266861,0,1,3
76145,3,1,266863,266863,266864,0,1,2
76146,6,3,266869,266869,266872,0,3,5
76147,4,2,266873,266873,266875,0,2,1
76148,4,1,266877,266877,266878,0,1,2
76149,2,3,266879,266879,266882,0,3,1
76150,4,1,266883,266883,266884,0,1,1
76151,3,1,266886,266886,266887,0,1,2
76152,1,1,266887,266887,266888,0,1,0
76153,3,3,266890,266890,266893,0,3,2
76154,5,3,266895,266895,266898,0,3,2
76155,5,1,266900,266900,266901,0,1,2
76156,3,1,266903,266903,266904,0,1,2
76157,6,2,266909,266909,266911,0,2,5
76158,6,1,266915,266915,266916,0,1,4
76159,6,3,266921,266921,266924,0,3,5
76160,4,1,266925,266925,266926,0,1,1
76161,2,1,266927,266927,266928,0,1,1
76162,2,2,266929,266929,266931,0,2,1
76163,4,1,266933,266933,266934,0,1,2
76164,2,3,266935,266935,266938,0,3,1
76165,1,3,266936,266938,266941,2,5,0
76166,6,1,266942,266942,266943,0,1,1
76167,3,1,266945,266945,266946,0,1,2
76168,5,2,266950,266950,266952,0,2,4
76169,5,1,266955,266955,266956,0,1,3
76170,5,2,266960,266960,266962,0,2,4
76171,2,3,266962,266962,266965,0,3,0
76172,3,2,266965,266965,266967,0,2,0
76173,4,2,266969,266969,266971,0,2,2
76174,4,3,266973,266973,266976,0,3,2
76175,4,1,266977,266977,266978,0,1,1
76176,3,3,266980,266980,266983,0,3,2
76177,2,2,266982,266983,266985,1,3,0
76178,6,3,266988,266988,266991,0,3,3
76179,4,1,266992,266992,266993,0,1,1
76180,4,1,266996,266996,266997,0,1,3
76181,1,1,266997,266997,266998,0,1,0
76182,4,3,267001,267001,267004,0,3,3
76183,4,3,267005,267005,267008,0,3,1
76184,6,2,267011,267011,267013,0,2,3
76185,6,1,267017,267017,267018,0,1,4
76186,2,3,267019,267019,267022,0,3,1
76187,5,2,267024,267024,267026,0,2,2
76188,3,2,267027,267027,267029,0,2,1
76189,2,1,267029,267029,267030,0,1,0
76190,1,3,267030,267030,267033,0,3,0
76191,6,1,267036,267036,267037,0,1,3
76192,3,2,267039,267039,267041,0,2,2
76193,3,3,267042,267042,267045,0,3,1
76194,6,1,267048,267048,267049,0,1,3
76195,2,2,267050,267050,267052,0,2,1
76196,5,2,267055,267055,267057,0,2,3
76197,2,1,267057,267057,267058,0,1,0
76198,3,1,267060,267060,267061,0,1,2
76199,1,1,267061,267061,267062,0,1,0
76200,5,2,267066,267066,267068,0,2,4
76201,6,3,267072,267072,267075,0,3,4
76202,4,3,267076,267076,267079,0,3,1
76203,4,3,267080,267080,267083,0,3,1
76204,5,1,267085,267085,267086,0,1,2
76205,1,3,267086,267086,267089,0,3,0
76206,1,3,267087,267089,267092,2,5,0
76207,2,1,267089,267092,267093,3,4,0
76208,1,3,267090,267093,267096,3,6,0
76209,1,1,267091,267096,267097,5,6,0
76210,6,2,267097,267097,267099,0,2,0
76211,6,3,267103,267103,267106,0,3,4
76212,1,2,267104,267106,267108,2,4,0
76213,1,2,267105,267108,267110,3,5,0
76214,2,1,267107,267110,267111,3,4,0
76215,5,3,267112,267112,267115,0,3,1
76216,6,3,267118,267118,267121,0,3,3
76217,4,2,267122,267122,267124,0,2,1
76218,4,1,267126,267126,267127,0,1,2
76219,4,3,267130,267130,267133,0,3,3
76220,5,3,267135,267135,267138,0,3,2
76221,1,3,267136,267138,267141,2,5,0
76222,3,3,267139,267141,267144,2,5,0
76223,3,3,267142,267144,267147,2,5,0
76224,5,3,267147,267147,267150,0,3,0
76225,2,2,267149,267150,267152,1,3,0
76226,4,2,267153,267153,267155,0,2,1
76227,4,1,267157,267157,267158,0,1,2
76228,6,3,267163,267163,267166,0,3,5
76229,2,3,267165,267166,267169,1,4,0
76230,6,3,267171,267171,267174,0,3,2
76231,1,1,267172,267174,267175,2,3,0
76232,4,2,267176,267176,267178,0,2,1
76233,5,2,267181,267181,267183,0,2,3
76234,3,2,267184,267184,267186,0,2,1
76235,6,3,267190,267190,267193,0,3,4
76236,2,3,267192,267193,267196,1,4,0
76237,6,2,267198,267198,267200,0,2,2
76238,2,3,267200,267200,267203,0,3,0
76239,3,3,267203,267203,267206,0,3,0
76240,4,1,267207,267207,267208,0,1,1
76241,1,2,267208,267208,267210,0,2,0
76242,5,3,267213,267213,267216,0,3,3
76243,3,2,267216,267216,267218,0,2,0
76244,6,3,267222,267222,267225,0,3,4
76245,4,3,267226,267226,267229,0,3,1
76246,5,2,267231,267231,267233,0,2,2
76247,1,1,267232,267233,267234,1,2,0
76248,6,1,267238,267238,267239,0,1,4
76249,6,1,267244,267244,267245,0,1,5
76250,5,2,267249,267249,267251,0,2,4
76251,4,1,267253,267253,267254,0,1,2
76252,3,1,267256,267256,267257,0,1,2
76253,6,2,267262,267262,267264,0,2,5
76254,1,1,267263,267264,267265,1,2,0
76255,2,2,267265,267265,267267,0,2,0
76256,4,2,267269,267269,267271,0,2,2
76257,2,2,267271,267271,267273,0,2,0
76258,6,2,267277,267277,267279,0,2,4
76259,2,1,267279,267279,267280,0,1,0
76260,6,3,267285,267285,267288,0,3,5
76261,1,2,267286,267288,267290,2,4,0
76262,3,1,267289,267290,267291,1,2,0
76263,5,2,267294,267294,267296,0,2,3
76264,2,2,267296,267296,267298,0,2,0
76265,5,1,267301,267301,267302,0,1,3
76266,3,3,267304,267304,267307,0,3,2
76267,2,3,267306,267307,267310,1,4,0
76268,2,2,267308,267310,267312,2,4,0
76269,2,2,267310,267312,267314,2,4,0
76270,4,2,267314,267314,267316,0,2,0
76271,1,3,267315,267316,267319,1,4,0
76272,5,2,267320,267320,267322,0,2,1
76273,4,3,267324,267324,267327,0,3,2
76274,3,3,267327,267327,267330,0,3,0
76275,4,3,267331,267331,267334,0,3,1
76276,1,1,267332,267334,267335,2,3,0
76277,2,3,267334,267335,267338,1,4,0
76278,2,1,267336,267338,267339,2,3,0
76279,2,1,267338,267339,267340,1,2,0
76280,2,2,267340,267340,267342,0,2,0
76281,6,2,267346,267346,267348,0,2,4
76282,6,1,267352,267352,267353,0,1,4
76283,6,1,267358,267358,267359,0,1,5
76284,4,1,267362,267362,267363,0,1,3
76285,3,2,267365,267365,267367,0,2,2
76286,1,3,267366,267367,267370,1,4,0
76287,2,1,267368,267370,267371,2,3,0
76288,2,3,267370,267371,267374,1,4,0
76289,3,2,267373,267374,267376,1,3,0
76290,4,3,267377,267377,267380,0,3,1
76291,1,1,267378,267380,267381,2,3,0
76292,1,3,267379,267381,267384,2,5,0
76293,3,3,267382,267384,267387,2,5,0
76294,6,2,267388,267388,267390,0,2,1
76295,4,2,267392,267392,267394,0,2,2
76296,4,1,267396,267396,267397,0,1,2
76297,1,2,267397,267397,267399,0,2,0
76298,3,3,267400,267400,267403,0,3,1
76299,5,2,267405,267405,267407,0,2,2
76300,5,3,267410,267410,267413,0,3,3
76301,5,3,267415,267415,267418,0,3,2
76302,1,1,267416,267418,267419,2,3,0
76303,5,1,267421,267421,267422,0,1,2
76304,6,3,267427,267427,267430,0,3,5
76305,3,3,267430,267430,267433,0,3,0
76306,4,2,267434,267434,267436,0,2,1
76307,4,1,267438,267438,267439,0,1,2
76308,4,3,267442,267442,267445,0,3,3
76309,2,2,267444,267445,267447,1,3,0
76310,6,1,267450,267450,267451,0,1,3
76311,2,1,267452,267452,267453,0,1,1
76312,3,2,267455,267455,267457,0,2,2
76313,4,1,267459,267459,267460,0,1,2
76314,3,3,267462,267462,267465,0,3,2
76315,6,1,267468,267468,267469,0,1,3
76316,6,1,267474,267474,267475,0,1,5
76317,3,1,267477,267477,267478,0,1,2
76318,2,3,267479,267479,267482,0,3,1
76319,1,1,267480,267482,267483,2,3,0
76320,5,2,267485,267485,267487,0,2,2
76321,5,2,267490,267490,267492,0,2,3
76322,3,1,267493,267493,267494,0,1,1
76323,2,1,267495,267495,267496,0,1,1
76324,1,1,267496,267496,267497,0,1,0
76325,4,1,267500,267500,267501,0,1,3
76326,4,3,267504,267504,267507,0,3,3
76327,6,1,267510,267510,267511,0,1,3
76328,1,2,267511,267511,267513,0,2,0
76329,3,2,267514,267514,267516,0,2,1
76330,5,3,267519,267519,267522,0,3,3
76331,4,3,267523,267523,267526,0,3,1
76332,1,3,267524,267526,267529,2,5,0
76333,1,3,267525,267529,267532,4,7,0
76334,6,3,267531,267532,267535,1,4,0
76335,6,1,267537,267537,267538,0,1,2
76336,4,2,267541,267541,267543,0,2,3
76337,3,3,267544,267544,267547,0,3,1
76338,6,1,267550,267550,267551,0,1,3
76339,6,2,267556,267556,267558,0,2,5
76340,2,2,267558,267558,267560,0,2,0
76341,4,3,267562,267562,267565,0,3,2
76342,6,3,267568,267568,267571,0,3,3
76343,4,3,267572,267572,267575,0,3,1
76344,6,2,267578,267578,267580,0,2,3
76345,2,2,267580,267580,267582,0,2,0
76346,2,1,267582,267582,267583,0,1,0
76347,6,1,267588,267588,267589,0,1,5
76348,2,2,267590,267590,267592,0,2,1
76349,5,2,267595,267595,267597,0,2,3
76350,3,1,267598,267598,267599,0,1,1
76351,5,2,267603,267603,267605,0,2,4
76352,6,2,267609,267609,267611,0,2,4
76353,6,3,267615,267615,267618,0,3,4
76354,4,3,267619,267619,267622,0,3,1
76355,2,2,267621,267622,267624,1,3,0
76356,1,1,267622,267624,267625,2,3,0
76357,5,3,267627,267627,267630,0,3,2
76358,4,3,267631,267631,267634,0,3,1
76359,4,1,267635,267635,267636,0,1,1
76360,1,1,267636,267636,267637,0,1,0
76361,2,3,267638,267638,267641,0,3,1
76362,3,2,267641,267641,267643,0,2,0
76363,2,3,267643,267643,267646,0,3,0
76364,2,2,267645,267646,267648,1,3,0
76365,6,2,267651,267651,267653,0,2,3
76366,6,1,267657,267657,267658,0,1,4
76367,3,3,267660,267660,267663,0,3,2
76368,6,3,267666,267666,267669,0,3,3
76369,3,3,267669,267669,267672,0,3,0
76370,5,1,267674,267674,267675,0,1,2
76371,1,2,267675,267675,267677,0,2,0
76372,5,1,267680,267680,267681,0,1,3
76373,5,1,267685,267685,267686,0,1,4
76374,4,3,267689,267689,267692,0,3,3
76375,1,2,267690,267692,267694,2,4,0
76376,1,3,267691,267694,267697,3,6,0
76377,4,2,267695,267697,267699,2,4,0
76378,1,2,267696,267699,267701,3,5,0
76379,5,3,267701,267701,267704,0,3,0
76380,5,1,267706,267706,267707,0,1,2
76381,5,3,267711,267711,267714,0,3,4
76382,1,1,267712,267714,267715,2,3,0
76383,5,3,267717,267717,267720,0,3,2
76384,4,2,267721,267721,267723,0,2,1
76385,5,1,267726,267726,267727,0,1,3
76386,2,3,267728,267728,267731,0,3,1
76387,3,1,267731,267731,267732,0,1,0
76388,6,3,267737,267737,267740,0,3,5
76389,5,2,267742,267742,267744,0,2,2
76390,5,2,267747,267747,267749,0,2,3
76391,6,3,267753,267753,267756,0,3,4
76392,3,1,267756,267756,267757,0,1,0
76393,2,2,267758,267758,267760,0,2,1
76394,3,3,267761,267761,267764,0,3,1
76395,4,3,267765,267765,267768,0,3,1
76396,3,3,267768,267768,267771,0,3,0
76397,3,1,267771,267771,267772,0,1,0
76398,5,3,267776,267776,267779,0,3,4
76399,3,1,267779,267779,267780,0,1,0
76400,2,3,267781,267781,267784,0,3,1
76401,5,2,267786,267786,267788,0,2,2
76402,3,1,267789,267789,267790,0,1,1
76403,1,1,267790,267790,267791,0,1,0
76404,3,1,267793,267793,267794,0,1,2
76405,3,2,267796,267796,267798,0,2,2
76406,6,3,267802,267802,267805,0,3,4
76407,4,2,267806,267806,267808,0,2,1
76408,3,3,267809,267809,267812,0,3,1
76409,3,1,267812,267812,267813,0,1,0
76410,3,1,267815,267815,267816,0,1,2
76411,4,1,267819,267819,267820,0,1,3
76412,1,1,267820,267820,267821,0,1,0
76413,4,1,267824,267824,267825,0,1,3
76414,1,3,267825,267825,267828,0,3,0
76415,5,3,267830,267830,267833,0,3,2
76416,1,2,267831,267833,267835,2,4,0
76417,4,1,267835,267835,267836,0,1,0
76418,4,2,267839,267839,267841,0,2,3
76419,6,1,267845,267845,267846,0,1,4
76420,1,3,267846,267846,267849,0,3,0
76421,2,3,267848,267849,267852,1,4,0
76422,1,1,267849,267852,267853,3,4,0
76423,1,2,267850,267853,267855,3,5,0
76424,1,1,267851,267855,267856,4,5,0
76425,5,2,267856,267856,267858,0,2,0
76426,5,2,267861,267861,267863,0,2,3
76427,6,2,267867,267867,267869,0,2,4
76428,4,3,267871,267871,267874,0,3,2
76429,5,2,267876,267876,267878,0,2,2
76430,2,2,267878,267878,267880,0,2,0
76431,5,1,267883,267883,267884,0,1,3
76432,2,3,267885,267885,267888,0,3,1
76433,6,2,267891,267891,267893,0,2,3
76434,4,1,267895,267895,267896,0,1,2
76435,3,1,267898,267898,267899,0,1,2
76436,6,1,267904,267904,267905,0,1,5
76437,2,3,267906,267906,267909,0,3,1
76438,6,1,267912,267912,267913,0,1,3
76439,2,3,267914,267914,267917,0,3,1
76440,1,2,267915,267917,267919,2,4,0
76441,5,1,267920,267920,267921,0,1,1
76442,2,1,267922,267922,267923,0,1,1
76443,4,1,267926,267926,267927,0,1,3
76444,3,1,267929,267929,267930,0,1,2
76445,4,1,267933,267933,267934,0,1,3
76446,3,1,267936,267936,267937,0,1,2
76447,1,3,267937,267937,267940,0,3,0
76448,1,2,267938,267940,267942,2,4,0
76449,5,3,267943,267943,267946,0,3,1
76450,4,2,267947,267947,267949,0,2,1
76451,3,2,267950,267950,267952,0,2,1
76452,6,2,267956,267956,267958,0,2,4
76453,1,3,267957,267958,267961,1,4,0
76454,1,1,267958,267961,267962,3,4,0
76455,6,3,267964,267964,267967,0,3,2
76456,2,3,267966,267967,267970,1,4,0
76457,2,3,267968,267970,267973,2,5,0
76458,1,3,267969,267973,267976,4,7,0
76459,6,2,267975,267976,267978,1,3,0
76460,2,2,267977,267978,267980,1,3,0
76461,1,2,267978,267980,267982,2,4,0
76462,1,3,267979,267982,267985,3,6,0
76463,4,1,267983,267985,267986,2,3,0
76464,5,3,267988,267988,267991,0,3,2
76465,2,3,267990,267991,267994,1,4,0
76466,6,3,267996,267996,267999,0,3,2
76467,1,3,267997,267999,268002,2,5,0
76468,2,1,267999,268002,268003,3,4,0
76469,1,3,268000,268003,268006,3,6,0
76470,5,1,268005,268006,268007,1,2,0
76471,6,2,268011,268011,268013,0,2,4
76472,1,1,268012,268013,268014,1,2,0
76473,5,2,268017,268017,268019,0,2,3
76474,3,2,268020,268020,268022,0,2,1
76475,3,3,268023,268023,268026,0,3,1
76476,3,3,268026,268026,268029,0,3,0
76477,6,2,268032,268032,268034,0,2,3
76478,3,3,268035,268035,268038,0,3,1
76479,2,2,268037,268038,268040,1,3,0
76480,4,1,268041,268041,268042,0,1,1
76481,2,1,268043,268043,268044,0,1,1
76482,2,3,268045,268045,268048,0,3,1
76483,2,3,268047,268048,268051,1,4,0
76484,5,2,268052,268052,268054,0,2,1
76485,2,1,268054,268054,268055,0,1,0
76486,6,2,268060,268060,268062,0,2,5
76487,3,3,268063,268063,268066,0,3,1
76488,1,2,268064,268066,268068,2,4,0
76489,2,3,268066,268068,268071,2,5,0
76490,6,2,268072,268072,268074,0,2,1
76491,1,1,268073,268074,268075,1,2,0
76492,4,1,268077,268077,268078,0,1,2
76493,1,3,268078,268078,268081,0,3,0
76494,5,2,268083,268083,268085,0,2,2
76495,1,2,268084,268085,268087,1,3,0
76496,2,1,268086,268087,268088,1,2,0
76497,3,3,268089,268089,268092,0,3,1
76498,5,2,268094,268094,268096,0,2,2
76499,2,1,268096,268096,268097,0,1,0
76500,1,3,268097,268097,268100,0,3,0
76501,1,2,268098,268100,268102,2,4,0
76502,3,2,268101,268102,268104,1,3,0
76503,1,3,268102,268104,268107,2,5,0
76504,1,2,268103,268107,268109,4,6,0
76505,1,3,268104,268109,268112,5,8,0
76506,2,1,268106,268112,268113,6,7,0
76507,4,2,268110,268113,268115,3,5,0
76508,4,2,268114,268115,268117,1,3,0
76509,6,2,268120,268120,268122,0,2,3
76510,4,3,268124,268124,268127,0,3,2
76511,1,3,268125,268127,268130,2,5,0
76512,6,3,268131,268131,268134,0,3,1
76513,4,3,268135,268135,268138,0,3,1
76514,6,1,268141,268141,268142,0,1,3
76515,2,3,268143,268143,268146,0,3,1
76516,5,3,268148,268148,268151,0,3,2
76517,6,1,268154,268154,268155,0,1,3
76518,3,3,268157,268157,268160,0,3,2
76519,4,2,268161,268161,268163,0,2,1
76520,1,3,268162,268163,268166,1,4,0
76521,4,2,268166,268166,268168,0,2,0
76522,5,2,268171,268171,268173,0,2,3
76523,4,2,268175,268175,268177,0,2,2
76524,1,1,268176,268177,268178,1,2,0
76525,3,2,268179,268179,268181,0,2,1
76526,1,3,268180,268181,268184,1,4,0
76527,2,2,268182,268184,268186,2,4,0
76528,1,1,268183,268186,268187,3,4,0
76529,4,1,268187,268187,268188,0,1,0
76530,2,2,268189,268189,268191,0,2,1
76531,2,2,268191,268191,268193,0,2,0
76532,3,2,268194,268194,268196,0,2,1
76533,6,3,268200,268200,268203,0,3,4
76534,3,1,268203,268203,268204,0,1,0
76535,1,3,268204,268204,268207,0,3,0
76536,5,3,268209,268209,268212,0,3,2
76537,3,2,268212,268212,268214,0,2,0
76538,2,2,268214,268214,268216,0,2,0
76539,6,3,268220,268220,268223,0,3,4
76540,6,3,268226,268226,268229,0,3,3
76541,2,3,268228,268229,268232,1,4,0
76542,6,2,268234,268234,268236,0,2,2
76543,2,2,268236,268236,268238,0,2,0
76544,5,1,268241,268241,268242,0,1,3
76545,6,2,268247,268247,268249,0,2,5
76546,3,1,268250,268250,268251,0,1,1
76547,5,1,268255,268255,268256,0,1,4
76548,6,2,268261,268261,268263,0,2,5
76549,2,1,268263,268263,268264,0,1,0
76550,2,2,268265,268265,268267,0,2,1
76551,6,1,268271,268271,268272,0,1,4
76552,1,3,268272,268272,268275,0,3,0
76553,3,2,268275,268275,268277,0,2,0
76554,2,2,268277,268277,268279,0,2,0
76555,1,1,268278,268279,268280,1,2,0
76556,4,2,268282,268282,268284,0,2,2
76557,6,1,268288,268288,268289,0,1,4
76558,2,1,268290,268290,268291,0,1,1
76559,4,1,268294,268294,268295,0,1,3
76560,6,2,268300,268300,268302,0,2,5
76561,6,3,268306,268306,268309,0,3,4
76562,4,3,268310,268310,268313,0,3,1
76563,4,3,268314,268314,268317,0,3,1
76564,5,1,268319,268319,268320,0,1,2
76565,1,3,268320,268320,268323,0,3,0
76566,4,1,268324,268324,268325,0,1,1
76567,1,3,268325,268325,268328,0,3,0
76568,2,2,268327,268328,268330,1,3,0
76569,6,2,268333,268333,268335,0,2,3
76570,6,1,268339,268339,268340,0,1,4
76571,2,2,268341,268341,268343,0,2,1
76572,2,3,268343,268343,268346,0,3,0
76573,1,3,268344,268346,268349,2,5,0
76574,2,2,268346,268349,268351,3,5,0
76575,2,2,268348,268351,268353,3,5,0
76576,5,3,268353,268353,268356,0,3,0
76577,4,1,268357,268357,268358,0,1,1
76578,4,1,268361,268361,268362,0,1,3
76579,4,2,268365,268365,268367,0,2,3
76580,5,1,268370,268370,268371,0,1,3
76581,1,1,268371,268371,268372,0,1,0
76582,4,3,268375,268375,268378,0,3,3
76583,5,2,268380,268380,268382,0,2,2
76584,6,2,268386,268386,268388,0,2,4
76585,5,1,268391,268391,268392,0,1,3
76586,6,1,268397,268397,268398,0,1,5
76587,6,3,268403,268403,268406,0,3,5
76588,3,2,268406,268406,268408,0,2,0
76589,2,3,268408,268408,268411,0,3,0
76590,6,3,268414,268414,268417,0,3,3
76591,4,2,268418,268418,268420,0,2,1
76592,6,1,268424,268424,268425,0,1,4
76593,4,3,268428,268428,268431,0,3,3
76594,5,1,268433,268433,268434,0,1,2
76595,2,1,268435,268435,268436,0,1,1
76596,4,3,268439,268439,268442,0,3,3
76597,4,3,268443,268443,268446,0,3,1
76598,2,1,268445,268446,268447,1,2,0
76599,6,1,268451,268451,268452,0,1,4
76600,2,3,268453,268453,268456,0,3,1
76601,3,1,268456,268456,268457,0,1,0
76602,5,2,268461,268461,268463,0,2,4
76603,2,2,268463,268463,268465,0,2,0
76604,5,1,268468,268468,268469,0,1,3
76605,6,2,268474,268474,268476,0,2,5
76606,5,3,268479,268479,268482,0,3,3
76607,5,2,268484,268484,268486,0,2,2
76608,3,1,268487,268487,268488,0,1,1
76609,5,1,268492,268492,268493,0,1,4
76610,3,2,268495,268495,268497,0,2,2
76611,1,2,268496,268497,268499,1,3,0
76612,2,3,268498,268499,268502,1,4,0
76613,3,2,268501,268502,268504,1,3,0
76614,4,3,268505,268505,268508,0,3,1
76615,1,1,268506,268508,268509,2,3,0
76616,2,1,268508,268509,268510,1,2,0
76617,4,3,268512,268512,268515,0,3,2
76618,1,2,268513,268515,268517,2,4,0
76619,5,3,268518,268518,268521,0,3,1
76620,2,2,268520,268521,268523,1,3,0
76621,2,1,268522,268523,268524,1,2,0
76622,5,3,268527,268527,268530,0,3,3
76623,5,3,268532,268532,268535,0,3,2
76624,2,2,268534,268535,268537,1,3,0
76625,1,2,268535,268537,268539,2,4,0
76626,4,3,268539,268539,268542,0,3,0
76627,5,1,268544,268544,268545,0,1,2
76628,4,2,268548,268548,268550,0,2,3
76629,1,3,268549,268550,268553,1,4,0
76630,2,1,268551,268553,268554,2,3,0
76631,1,1,268552,268554,268555,2,3,0
76632,3,1,268555,268555,268556,0,1,0
76633,5,2,268560,268560,268562,0,2,4
76634,6,2,268566,268566,268568,0,2,4
76635,4,3,268570,268570,268573,0,3,2
76636,2,1,268572,268573,268574,1,2,0
76637,4,2,268576,268576,268578,0,2,2
76638,5,1,268581,268581,268582,0,1,3
76639,5,2,268586,268586,268588,0,2,4
76640,4,1,268590,268590,268591,0,1,2
76641,5,2,268595,268595,268597,0,2,4
76642,1,2,268596,268597,268599,1,3,0
76643,5,1,268601,268601,268602,0,1,2
76644,1,1,268602,268602,268603,0,1,0
76645,1,1,268603,268603,268604,0,1,0
76646,3,2,268606,268606,268608,0,2,2
76647,1,1,268607,268608,268609,1,2,0
76648,6,2,268613,268613,268615,0,2,4
76649,3,3,268616,268616,268619,0,3,1
76650,5,3,268621,268621,268624,0,3,2
76651,1,1,268622,268624,268625,2,3,0
76652,4,3,268626,268626,268629,0,3,1
76653,5,2,268631,268631,268633,0,2,2
76654,4,3,268635,268635,268638,0,3,2
76655,5,2,268640,268640,268642,0,2,2
76656,5,2,268645,268645,268647,0,2,3
76657,3,2,268648,268648,268650,0,2,1
76658,3,3,268651,268651,268654,0,3,1
76659,5,3,268656,268656,268659,0,3,2
76660,6,3,268662,268662,268665,0,3,3
76661,4,3,268666,268666,268669,0,3,1
76662,4,3,268670,268670,268673,0,3,1
76663,4,2,268674,268674,268676,0,2,1
76664,4,3,268678,268678,268681,0,3,2
76665,2,2,268680,268681,268683,1,3,0
76666,6,2,268686,268686,268688,0,2,3
76667,5,3,268691,268691,268694,0,3,3
76668,2,2,268693,268694,268696,1,3,0
76669,4,1,268697,268697,268698,0,1,1
76670,1,1,268698,268698,268699,0,1,0
76671,3,3,268701,268701,268704,0,3,2
76672,3,2,268704,268704,268706,0,2,0
76673,6,3,268710,268710,268713,0,3,4
76674,6,2,268716,268716,268718,0,2,3
76675,5,1,268721,268721,268722,0,1,3
76676,4,3,268725,268725,268728,0,3,3
76677,4,1,268729,268729,268730,0,1,1
76678,3,1,268732,268732,268733,0,1,2
76679,6,1,268738,268738,268739,0,1,5
76680,4,1,268742,268742,268743,0,1,3
76681,4,3,268746,268746,268749,0,3,3
76682,3,3,268749,268749,268752,0,3,0
76683,3,2,268752,268752,268754,0,2,0
76684,6,2,268758,268758,268760,0,2,4
76685,4,1,268762,268762,268763,0,1,2
76686,4,1,268766,268766,268767,0,1,3
76687,3,3,268769,268769,268772,0,3,2
76688,4,1,268773,268773,268774,0,1,1
76689,5,3,268778,268778,268781,0,3,4
76690,2,1,268780,268781,268782,1,2,0
76691,5,3,268785,268785,268788,0,3,3
76692,3,1,268788,268788,268789,0,1,0
76693,2,2,268790,268790,268792,0,2,1
76694,4,2,268794,268794,268796,0,2,2
76695,1,1,268795,268796,268797,1,2,0
76696,6,2,268801,268801,268803,0,2,4
76697,1,3,268802,268803,268806,1,4,0
76698,5,2,268807,268807,268809,0,2,1
76699,4,2,268811,268811,268813,0,2,2
76700,5,3,268816,268816,268819,0,3,3
76701,2,1,268818,268819,268820,1,2,0
76702,4,2,268822,268822,268824,0,2,2
76703,4,1,268826,268826,268827,0,1,2
76704,6,3,268832,268832,268835,0,3,5
76705,2,1,268834,268835,268836,1,2,0
76706,3,1,268837,268837,268838,0,1,1
76707,2,3,268839,268839,268842,0,3,1
76708,3,1,268842,268842,268843,0,1,0
76709,6,3,268848,268848,268851,0,3,5
76710,3,3,268851,268851,268854,0,3,0
76711,2,3,268853,268854,268857,1,4,0
76712,3,3,268856,268857,268860,1,4,0
76713,1,3,268857,268860,268863,3,6,0
76714,5,2,268862,268863,268865,1,3,0
76715,5,1,268867,268867,268868,0,1,2
76716,5,3,268872,268872,268875,0,3,4
76717,6,1,268878,268878,268879,0,1,3
76718,5,2,268883,268883,268885,0,2,4
76719,2,3,268885,268885,268888,0,3,0
76720,2,3,268887,268888,268891,1,4,0
76721,4,2,268891,268891,268893,0,2,0
76722,3,2,268894,268894,268896,0,2,1
76723,6,1,268900,268900,268901,0,1,4
76724,5,2,268905,268905,268907,0,2,4
76725,3,2,268908,268908,268910,0,2,1
76726,1,2,268909,268910,268912,1,3,0
76727,1,3,268910,268912,268915,2,5,0
76728,6,3,268916,268916,268919,0,3,1
76729,4,3,268920,268920,268923,0,3,1
76730,6,3,268926,268926,268929,0,3,3
76731,1,2,268927,268929,268931,2,4,0
76732,4,3,268931,268931,268934,0,3,0
76733,3,3,268934,268934,268937,0,3,0
76734,1,2,268935,268937,268939,2,4,0
76735,3,1,268938,268939,268940,1,2,0
76736,4,3,268942,268942,268945,0,3,2
76737,4,2,268946,268946,268948,0,2,1
76738,3,3,268949,268949,268952,0,3,1
76739,3,1,268952,268952,268953,0,1,0
76740,1,1,268953,268953,268954,0,1,0
76741,3,1,268956,268956,268957,0,1,2
76742,3,2,268959,268959,268961,0,2,2
76743,2,2,268961,268961,268963,0,2,0
76744,6,2,268967,268967,268969,0,2,4
76745,4,2,268971,268971,268973,0,2,2
76746,5,3,268976,268976,268979,0,3,3
76747,2,2,268978,268979,268981,1,3,0
76748,1,2,268979,268981,268983,2,4,0
76749,3,2,268982,268983,268985,1,3,0
76750,5,3,268987,268987,268990,0,3,2
76751,4,3,268991,268991,268994,0,3,1
76752,3,1,268994,268994,268995,0,1,0
76753,5,2,268999,268999,269001,0,2,4
76754,3,2,269002,269002,269004,0,2,1
76755,4,2,269006,269006,269008,0,2,2
76756,4,3,269010,269010,269013,0,3,2
76757,2,1,269012,269013,269014,1,2,0
76758,2,2,269014,269014,269016,0,2,0
76759,2,1,269016,269016,269017,0,1,0
76760,4,3,269020,269020,269023,0,3,3
76761,1,3,269021,269023,269026,2,5,0
76762,6,3,269027,269027,269030,0,3,1
76763,1,3,269028,269030,269033,2,5,0
76764,5,1,269033,269033,269034,0,1,0
76765,6,3,269039,269039,269042,0,3,5
76766,4,2,269043,269043,269045,0,2,1
76767,4,3,269047,269047,269050,0,3,2
76768,4,2,269051,269051,269053,0,2,1
76769,5,3,269056,269056,269059,0,3,3
76770,6,1,269062,269062,269063,0,1,3
76771,2,1,269064,269064,269065,0,1,1
76772,4,2,269068,269068,269070,0,2,3
76773,3,2,269071,269071,269073,0,2,1
76774,5,3,269076,269076,269079,0,3,3
76775,6,1,269082,269082,269083,0,1,3
76776,3,3,269085,269085,269088,0,3,2
76777,4,3,269089,269089,269092,0,3,1
76778,5,2,269094,269094,269096,0,2,2
76779,5,3,269099,269099,269102,0,3,3
76780,5,2,269104,269104,269106,0,2,2
76781,1,3,269105,269106,269109,1,4,0
76782,1,1,269106,269109,269110,3,4,0
76783,6,3,269112,269112,269115,0,3,2
76784,2,3,269114,269115,269118,1,4,0
76785,3,3,269117,269118,269121,1,4,0
76786,1,2,269118,269121,269123,3,5,0
76787,4,2,269122,269123,269125,1,3,0
76788,3,2,269125,269125,269127,0,2,0
76789,5,3,269130,269130,269133,0,3,3
76790,4,1,269134,269134,269135,0,1,1
76791,2,1,269136,269136,269137,0,1,1
76792,5,1,269141,269141,269142,0,1,4
76793,4,1,269145,269145,269146,0,1,3
76794,3,3,269148,269148,269151,0,3,2
76795,6,3,269154,269154,269157,0,3,3
76796,1,3,269155,269157,269160,2,5,0
76797,6,2,269161,269161,269163,0,2,1
76798,3,1,269164,269164,269165,0,1,1
76799,3,1,269167,269167,269168,0,1,2
76800,5,1,269172,269172,269173,0,1,4
76801,2,2,269174,269174,269176,0,2,1
76802,4,3,269178,269178,269181,0,3,2
76803,2,2,269180,269181,269183,1,3,0
76804,6,3,269186,269186,269189,0,3,3
76805,5,2,269191,269191,269193,0,2,2
76806,2,1,269193,269193,269194,0,1,0
76807,1,1,269194,269194,269195,0,1,0
76808,6,2,269200,269200,269202,0,2,5
76809,4,1,269204,269204,269205,0,1,2
76810,5,2,269209,269209,269211,0,2,4
76811,2,3,269211,269211,269214,0,3,0
76812,1,3,269212,269214,269217,2,5,0
76813,5,3,269217,269217,269220,0,3,0
76814,5,1,269222,269222,269223,0,1,2
76815,3,2,269225,269225,269227,0,2,2
76816,1,2,269226,269227,269229,1,3,0
76817,2,3,269228,269229,269232,1,4,0
76818,1,3,269229,269232,269235,3,6,0
76819,6,1,269235,269235,269236,0,1,0
76820,6,1,269241,269241,269242,0,1,5
76821,1,2,269242,269242,269244,0,2,0
76822,3,3,269245,269245,269248,0,3,1
76823,4,2,269249,269249,269251,0,2,1
76824,3,3,269252,269252,269255,0,3,1
76825,5,1,269257,269257,269258,0,1,2
76826,4,3,269261,269261,269264,0,3,3
76827,3,2,269264,269264,269266,0,2,0
76828,5,3,269269,269269,269272,0,3,3
76829,5,1,269274,269274,269275,0,1,2
76830,4,2,269278,269278,269280,0,2,3
76831,5,1,269283,269283,269284,0,1,3
76832,3,1,269286,269286,269287,0,1,2
76833,4,2,269290,269290,269292,0,2,3
76834,1,3,269291,269292,269295,1,4,0
76835,4,1,269295,269295,269296,0,1,0
76836,3,1,269298,269298,269299,0,1,2
76837,4,3,269302,269302,269305,0,3,3
76838,1,2,269303,269305,269307,2,4,0
76839,5,3,269308,269308,269311,0,3,1
76840,1,1,269309,269311,269312,2,3,0
76841,3,3,269312,269312,269315,0,3,0
76842,1,2,269313,269315,269317,2,4,0
76843,3,2,269316,269317,269319,1,3,0
76844,1,3,269317,269319,269322,2,5,0
76845,6,2,269323,269323,269325,0,2,1
76846,2,2,269325,269325,269327,0,2,0
76847,5,3,269330,269330,269333,0,3,3
76848,2,1,269332,269333,269334,1,2,0
76849,2,1,269334,269334,269335,0,1,0
76850,2,3,269336,269336,269339,0,3,1
76851,6,2,269342,269342,269344,0,2,3
76852,1,1,269343,269344,269345,1,2,0
76853,4,1,269347,269347,269348,0,1,2
76854,2,1,269349,269349,269350,0,1,1
76855,1,2,269350,269350,269352,0,2,0
76856,4,2,269354,269354,269356,0,2,2
76857,3,3,269357,269357,269360,0,3,1
76858,6,2,269363,269363,269365,0,2,3
76859,4,2,269367,269367,269369,0,2,2
76860,3,2,269370,269370,269372,0,2,1
76861,1,2,269371,269372,269374,1,3,0
76862,6,2,269377,269377,269379,0,2,3
76863,1,3,269378,269379,269382,1,4,0
76864,4,2,269382,269382,269384,0,2,0
76865,5,1,269387,269387,269388,0,1,3
76866,6,2,269393,269393,269395,0,2,5
76867,1,3,269394,269395,269398,1,4,0
76868,2,1,269396,269398,269399,2,3,0
76869,5,3,269401,269401,269404,0,3,2
76870,2,3,269403,269404,269407,1,4,0
76871,4,1,269407,269407,269408,0,1,0
76872,4,1,269411,269411,269412,0,1,3
76873,5,1,269416,269416,269417,0,1,4
76874,3,1,269419,269419,269420,0,1,2
76875,2,2,269421,269421,269423,0,2,1
76876,5,1,269426,269426,269427,0,1,3
76877,1,2,269427,269427,269429,0,2,0
76878,6,2,269433,269433,269435,0,2,4
76879,5,2,269438,269438,269440,0,2,3
76880,2,3,269440,269440,269443,0,3,0
76881,1,1,269441,269443,269444,2,3,0
76882,5,3,269446,269446,269449,0,3,2
76883,6,3,269452,269452,269455,0,3,3
76884,3,3,269455,269455,269458,0,3,0
76885,4,3,269459,269459,269462,0,3,1
76886,3,2,269462,269462,269464,0,2,0
76887,2,1,269464,269464,269465,0,1,0
76888,2,1,269466,269466,269467,0,1,1
76889,4,2,269470,269470,269472,0,2,3
76890,3,1,269473,269473,269474,0,1,1
76891,3,1,269476,269476,269477,0,1,2
76892,5,3,269481,269481,269484,0,3,4
76893,6,3,269487,269487,269490,0,3,3
76894,5,2,269492,269492,269494,0,2,2
76895,5,2,269497,269497,269499,0,2,3
76896,4,3,269501,269501,269504,0,3,2
76897,3,3,269504,269504,269507,0,3,0
76898,3,3,269507,269507,269510,0,3,0
76899,2,3,269509,269510,269513,1,4,0
76900,3,3,269512,269513,269516,1,4,0
76901,4,2,269516,269516,269518,0,2,0
76902,4,1,269520,269520,269521,0,1,2
76903,1,3,269521,269521,269524,0,3,0
76904,6,1,269527,269527,269528,0,1,3
76905,3,1,269530,269530,269531,0,1,2
76906,5,1,269535,269535,269536,0,1,4
76907,4,3,269539,269539,269542,0,3,3
76908,2,2,269541,269542,269544,1,3,0
76909,2,3,269543,269544,269547,1,4,0
76910,6,2,269549,269549,269551,0,2,2
76911,4,2,269553,269553,269555,0,2,2
76912,5,2,269558,269558,269560,0,2,3
76913,3,1,269561,269561,269562,0,1,1
76914,5,2,269566,269566,269568,0,2,4
76915,1,1,269567,269568,269569,1,2,0
76916,3,2,269570,269570,269572,0,2,1
76917,2,1,269572,269572,269573,0,1,0
76918,2,2,269574,269574,269576,0,2,1
76919,2,2,269576,269576,269578,0,2,0
76920,2,2,269578,269578,269580,0,2,0
76921,5,2,269583,269583,269585,0,2,3
76922,2,3,269585,269585,269588,0,3,0
76923,5,1,269590,269590,269591,0,1,2
76924,2,1,269592,269592,269593,0,1,1
76925,6,2,269598,269598,269600,0,2,5
76926,3,3,269601,269601,269604,0,3,1
76927,4,1,269605,269605,269606,0,1,1
76928,4,1,269609,269609,269610,0,1,3
76929,2,3,269611,269611,269614,0,3,1
76930,2,1,269613,269614,269615,1,2,0
76931,5,3,269618,269618,269621,0,3,3
76932,5,2,269623,269623,269625,0,2,2
76933,2,1,269625,269625,269626,0,1,0
76934,1,3,269626,269626,269629,0,3,0
76935,6,2,269632,269632,269634,0,2,3
76936,6,3,269638,269638,269641,0,3,4
76937,5,2,269643,269643,269645,0,2,2
76938,6,1,269649,269649,269650,0,1,4
76939,2,1,269651,269651,269652,0,1,1
76940,3,3,269654,269654,269657,0,3,2
76941,6,1,269660,269660,269661,0,1,3
76942,4,1,269664,269664,269665,0,1,3
76943,3,2,269667,269667,269669,0,2,2
76944,2,3,269669,269669,269672,0,3,0
76945,6,3,269675,269675,269678,0,3,3
76946,1,2,269676,269678,269680,2,4,0
76947,3,3,269679,269680,269683,1,4,0
76948,5,2,269684,269684,269686,0,2,1
76949,5,3,269689,269689,269692,0,3,3
76950,6,2,269695,269695,269697,0,2,3
76951,5,2,269700,269700,269702,0,2,3
76952,5,1,269705,269705,269706,0,1,3
76953,2,3,269707,269707,269710,0,3,1
76954,6,3,269713,269713,269716,0,3,3
76955,2,2,269715,269716,269718,1,3,0
76956,1,3,269716,269718,269721,2,5,0
76957,5,3,269721,269721,269724,0,3,0
76958,1,1,269722,269724,269725,2,3,0
76959,3,2,269725,269725,269727,0,2,0
76960,5,3,269730,269730,269733,0,3,3
76961,3,2,269733,269733,269735,0,2,0
76962,5,3,269738,269738,269741,0,3,3
76963,2,2,269740,269741,269743,1,3,0
76964,3,3,269743,269743,269746,0,3,0
76965,1,1,269744,269746,269747,2,3,0
76966,6,2,269750,269750,269752,0,2,3
76967,1,3,269751,269752,269755,1,4,0
76968,4,2,269755,269755,269757,0,2,0
76969,4,3,269759,269759,269762,0,3,2
76970,3,3,269762,269762,269765,0,3,0
76971,6,3,269768,269768,269771,0,3,3
76972,2,3,269770,269771,269774,1,4,0
76973,6,2,269776,269776,269778,0,2,2
76974,3,1,269779,269779,269780,0,1,1
76975,6,2,269785,269785,269787,0,2,5
76976,1,2,269786,269787,269789,1,3,0
76977,1,2,269787,269789,269791,2,4,0
76978,4,2,269791,269791,269793,0,2,0
76979,5,1,269796,269796,269797,0,1,3
76980,5,1,269801,269801,269802,0,1,4
76981,6,3,269807,269807,269810,0,3,5
76982,3,1,269810,269810,269811,0,1,0
76983,5,1,269815,269815,269816,0,1,4
76984,5,2,269820,269820,269822,0,2,4
76985,4,1,269824,269824,269825,0,1,2
76986,3,1,269827,269827,269828,0,1,2
76987,1,3,269828,269828,269831,0,3,0
76988,3,1,269831,269831,269832,0,1,0
76989,6,3,269837,269837,269840,0,3,5
76990,5,3,269842,269842,269845,0,3,2
76991,2,1,269844,269845,269846,1,2,0
76992,1,2,269845,269846,269848,1,3,0
76993,1,3,269846,269848,269851,2,5,0
76994,6,1,269852,269852,269853,0,1,1
76995,4,1,269856,269856,269857,0,1,3
76996,3,1,269859,269859,269860,0,1,2
76997,5,1,269864,269864,269865,0,1,4
76998,5,2,269869,269869,269871,0,2,4
76999,1,1,269870,269871,269872,1,2,0
77000,6,3,269876,269876,269879,0,3,4
77001,1,3,269877,269879,269882,2,5,0
77002,2,3,269879,269882,269885,3,6,0
77003,4,3,269883,269885,269888,2,5,0
77004,1,3,269884,269888,269891,4,7,0
77005,3,3,269887,269891,269894,4,7,0
77006,4,1,269891,269894,269895,3,4,0
77007,5,2,269896,269896,269898,0,2,1
77008,5,3,269901,269901,269904,0,3,3
77009,1,2,269902,269904,269906,2,4,0
77010,4,3,269906,269906,269909,0,3,0
77011,4,3,269910,269910,269913,0,3,1
77012,4,3,269914,269914,269917,0,3,1
77013,1,1,269915,269917,269918,2,3,0
77014,3,1,269918,269918,269919,0,1,0
77015,1,1,269919,269919,269920,0,1,0
77016,2,2,269921,269921,269923,0,2,1
77017,6,2,269927,269927,269929,0,2,4
77018,6,1,269933,269933,269934,0,1,4
77019,3,2,269936,269936,269938,0,2,2
77020,2,2,269938,269938,269940,0,2,0
77021,5,1,269943,269943,269944,0,1,3
77022,6,1,269949,269949,269950,0,1,5
77023,6,2,269955,269955,269957,0,2,5
77024,2,3,269957,269957,269960,0,3,0
77025,6,2,269963,269963,269965,0,2,3
77026,3,3,269966,269966,269969,0,3,1
77027,1,1,269967,269969,269970,2,3,0
77028,4,2,269971,269971,269973,0,2,1
77029,6,3,269977,269977,269980,0,3,4
77030,6,1,269983,269983,269984,0,1,3
77031,3,3,269986,269986,269989,0,3,2
77032,6,3,269992,269992,269995,0,3,3
77033,3,2,269995,269995,269997,0,2,0
77034,6,2,270001,270001,270003,0,2,4
77035,4,2,270005,270005,270007,0,2,2
77036,1,3,270006,270007,270010,1,4,0
77037,5,1,270011,270011,270012,0,1,1
77038,4,1,270015,270015,270016,0,1,3
77039,6,1,270021,270021,270022,0,1,5
77040,4,1,270025,270025,270026,0,1,3
77041,6,3,270031,270031,270034,0,3,5
77042,5,2,270036,270036,270038,0,2,2
77043,3,3,270039,270039,270042,0,3,1
77044,5,3,270044,270044,270047,0,3,2
77045,3,1,270047,270047,270048,0,1,0
77046,4,1,270051,270051,270052,0,1,3
77047,5,3,270056,270056,270059,0,3,4
77048,6,1,270062,270062,270063,0,1,3
77049,5,2,270067,270067,270069,0,2,4
77050,6,3,270073,270073,270076,0,3,4
77051,2,2,270075,270076,270078,1,3,0
77052,6,2,270081,270081,270083,0,2,3
77053,5,2,270086,270086,270088,0,2,3
77054,5,1,270091,270091,270092,0,1,3
77055,6,3,270097,270097,270100,0,3,5
77056,5,2,270102,270102,270104,0,2,2
77057,1,3,270103,270104,270107,1,4,0
77058,1,1,270104,270107,270108,3,4,0
77059,6,2,270110,270110,270112,0,2,2
77060,5,2,270115,270115,270117,0,2,3
77061,5,2,270120,270120,270122,0,2,3
77062,6,3,270126,270126,270129,0,3,4
77063,6,2,270132,270132,270134,0,2,3
77064,6,1,270138,270138,270139,0,1,4
77065,4,2,270142,270142,270144,0,2,3
77066,1,3,270143,270144,270147,1,4,0
77067,4,3,270147,270147,270150,0,3,0
77068,5,2,270152,270152,270154,0,2,2
77069,3,1,270155,270155,270156,0,1,1
77070,2,2,270157,270157,270159,0,2,1
77071,1,3,270158,270159,270162,1,4,0
77072,2,1,270160,270162,270163,2,3,0
77073,5,3,270165,270165,270168,0,3,2
77074,1,2,270166,270168,270170,2,4,0
77075,5,1,270171,270171,270172,0,1,1
77076,2,3,270173,270173,270176,0,3,1
77077,3,3,270176,270176,270179,0,3,0
77078,3,3,270179,270179,270182,0,3,0
77079,3,2,270182,270182,270184,0,2,0
77080,4,1,270186,270186,270187,0,1,2
77081,5,1,270191,270191,270192,0,1,4
77082,5,3,270196,270196,270199,0,3,4
77083,4,3,270200,270200,270203,0,3,1
77084,4,2,270204,270204,270206,0,2,1
77085,5,1,270209,270209,270210,0,1,3
77086,2,2,270211,270211,270213,0,2,1
77087,1,2,270212,270213,270215,1,3,0
77088,3,3,270215,270215,270218,0,3,0
77089,5,1,270220,270220,270221,0,1,2
77090,5,1,270225,270225,270226,0,1,4
77091,5,3,270230,270230,270233,0,3,4
77092,3,3,270233,270233,270236,0,3,0
77093,4,1,270237,270237,270238,0,1,1
77094,5,1,270242,270242,270243,0,1,4
77095,5,2,270247,270247,270249,0,2,4
77096,5,1,270252,270252,270253,0,1,3
77097,6,2,270258,270258,270260,0,2,5
77098,1,1,270259,270260,270261,1,2,0
77099,5,3,270264,270264,270267,0,3,3
77100,4,1,270268,270268,270269,0,1,1
77101,5,1,270273,270273,270274,0,1,4
77102,1,1,270274,270274,270275,0,1,0
77103,3,1,270277,270277,270278,0,1,2
77104,4,3,270281,270281,270284,0,3,3
77105,2,1,270283,270284,270285,1,2,0
77106,4,1,270287,270287,270288,0,1,2
77107,1,2,270288,270288,270290,0,2,0
77108,2,3,270290,270290,270293,0,3,0
77109,5,3,270295,270295,270298,0,3,2
77110,5,2,270300,270300,270302,0,2,2
77111,2,1,270302,270302,270303,0,1,0
77112,2,2,270304,270304,270306,0,2,1
77113,1,1,270305,270306,270307,1,2,0
77114,3,3,270308,270308,270311,0,3,1
77115,4,2,270312,270312,270314,0,2,1
77116,4,1,270316,270316,270317,0,1,2
77117,3,1,270319,270319,270320,0,1,2
77118,4,3,270323,270323,270326,0,3,3
77119,1,3,270324,270326,270329,2,5,0
77120,3,2,270327,270329,270331,2,4,0
77121,5,1,270332,270332,270333,0,1,1
77122,4,3,270336,270336,270339,0,3,3
77123,3,2,270339,270339,270341,0,2,0
77124,6,2,270345,270345,270347,0,2,4
77125,6,3,270351,270351,270354,0,3,4
77126,3,3,270354,270354,270357,0,3,0
77127,4,3,270358,270358,270361,0,3,1
77128,6,2,270364,270364,270366,0,2,3
77129,1,1,270365,270366,270367,1,2,0
77130,3,3,270368,270368,270371,0,3,1
77131,4,1,270372,270372,270373,0,1,1
77132,2,1,270374,270374,270375,0,1,1
77133,1,1,270375,270375,270376,0,1,0
77134,6,3,270381,270381,270384,0,3,5
77135,6,3,270387,270387,270390,0,3,3
77136,6,3,270393,270393,270396,0,3,3
77137,6,3,270399,270399,270402,0,3,3
77138,5,2,270404,270404,270406,0,2,2
77139,1,1,270405,270406,270407,1,2,0
77140,2,1,270407,270407,270408,0,1,0
77141,4,2,270411,270411,270413,0,2,3
77142,2,2,270413,270413,270415,0,2,0
77143,3,1,270416,270416,270417,0,1,1
77144,5,2,270421,270421,270423,0,2,4
77145,6,3,270427,270427,270430,0,3,4
77146,4,1,270431,270431,270432,0,1,1
77147,2,2,270433,270433,270435,0,2,1
77148,3,3,270436,270436,270439,0,3,1
77149,1,1,270437,270439,270440,2,3,0
77150,2,1,270439,270440,270441,1,2,0
77151,5,3,270444,270444,270447,0,3,3
77152,2,2,270446,270447,270449,1,3,0
77153,2,2,270448,270449,270451,1,3,0
77154,6,1,270454,270454,270455,0,1,3
77155,4,2,270458,270458,270460,0,2,3
77156,2,3,270460,270460,270463,0,3,0
77157,5,3,270465,270465,270468,0,3,2
77158,4,2,270469,270469,270471,0,2,1
77159,3,3,270472,270472,270475,0,3,1
77160,5,3,270477,270477,270480,0,3,2
77161,5,1,270482,270482,270483,0,1,2
77162,4,2,270486,270486,270488,0,2,3
77163,4,3,270490,270490,270493,0,3,2
77164,3,2,270493,270493,270495,0,2,0
77165,6,3,270499,270499,270502,0,3,4
77166,4,2,270503,270503,270505,0,2,1
77167,3,2,270506,270506,270508,0,2,1
77168,6,3,270512,270512,270515,0,3,4
77169,6,1,270518,270518,270519,0,1,3
77170,6,3,270524,270524,270527,0,3,5
77171,3,2,270527,270527,270529,0,2,0
77172,4,2,270531,270531,270533,0,2,2
77173,3,3,270534,270534,270537,0,3,1
77174,3,2,270537,270537,270539,0,2,0
77175,2,1,270539,270539,270540,0,1,0
77176,1,2,270540,270540,270542,0,2,0
77177,3,2,270543,270543,270545,0,2,1
77178,1,1,270544,270545,270546,1,2,0
77179,4,1,270548,270548,270549,0,1,2
77180,5,2,270553,270553,270555,0,2,4
77181,1,1,270554,270555,270556,1,2,0
77182,4,2,270558,270558,270560,0,2,2
77183,4,2,270562,270562,270564,0,2,2
77184,4,2,270566,270566,270568,0,2,2
77185,1,2,270567,270568,270570,1,3,0
77186,2,3,270569,270570,270573,1,4,0
77187,2,3,270571,270573,270576,2,5,0
77188,1,3,270572,270576,270579,4,7,0
77189,4,3,270576,270579,270582,3,6,0
77190,2,3,270578,270582,270585,4,7,0
77191,4,3,270582,270585,270588,3,6,0
77192,5,2,270587,270588,270590,1,3,0
77193,4,2,270591,270591,270593,0,2,1
77194,3,1,270594,270594,270595,0,1,1
77195,2,1,270596,270596,270597,0,1,1
77196,4,3,270600,270600,270603,0,3,3
77197,4,2,270604,270604,270606,0,2,1
77198,6,3,270610,270610,270613,0,3,4
77199,4,2,270614,270614,270616,0,2,1
77200,6,3,270620,270620,270623,0,3,4
77201,6,3,270626,270626,270629,0,3,3
77202,5,3,270631,270631,270634,0,3,2
77203,1,3,270632,270634,270637,2,5,0
77204,5,1,270637,270637,270638,0,1,0
77205,4,2,270641,270641,270643,0,2,3
77206,4,2,270645,270645,270647,0,2,2
77207,4,1,270649,270649,270650,0,1,2
77208,6,3,270655,270655,270658,0,3,5
77209,1,2,270656,270658,270660,2,4,0
77210,1,2,270657,270660,270662,3,5,0
77211,3,3,270660,270662,270665,2,5,0
77212,1,1,270661,270665,270666,4,5,0
77213,4,1,270665,270666,270667,1,2,0
77214,2,1,270667,270667,270668,0,1,0
77215,4,1,270671,270671,270672,0,1,3
77216,5,3,270676,270676,270679,0,3,4
77217,1,2,270677,270679,270681,2,4,0
77218,6,3,270683,270683,270686,0,3,2
77219,1,3,270684,270686,270689,2,5,0
77220,5,3,270689,270689,270692,0,3,0
77221,3,3,270692,270692,270695,0,3,0
77222,2,1,270694,270695,270696,1,2,0
77223,4,2,270698,270698,270700,0,2,2
77224,2,2,270700,270700,270702,0,2,0
77225,6,1,270706,270706,270707,0,1,4
77226,2,2,270708,270708,270710,0,2,1
77227,4,3,270712,270712,270715,0,3,2
77228,3,1,270715,270715,270716,0,1,0
77229,4,2,270719,270719,270721,0,2,3
77230,3,2,270722,270722,270724,0,2,1
77231,1,3,270723,270724,270727,1,4,0
77232,1,2,270724,270727,270729,3,5,0
77233,5,1,270729,270729,270730,0,1,0
77234,6,1,270735,270735,270736,0,1,5
77235,1,1,270736,270736,270737,0,1,0
77236,2,1,270738,270738,270739,0,1,1
77237,6,3,270744,270744,270747,0,3,5
77238,3,1,270747,270747,270748,0,1,0
77239,6,2,270753,270753,270755,0,2,5
77240,3,3,270756,270756,270759,0,3,1
77241,6,1,270762,270762,270763,0,1,3
77242,5,1,270767,270767,270768,0,1,4
77243,6,3,270773,270773,270776,0,3,5
77244,6,3,270779,270779,270782,0,3,3
77245,2,2,270781,270782,270784,1,3,0
77246,4,3,270785,270785,270788,0,3,1
77247,4,2,270789,270789,270791,0,2,1
77248,3,2,270792,270792,270794,0,2,1
77249,5,3,270797,270797,270800,0,3,3
77250,5,3,270802,270802,270805,0,3,2
77251,2,3,270804,270805,270808,1,4,0
77252,1,3,270805,270808,270811,3,6,0
77253,3,2,270808,270811,270813,3,5,0
77254,1,1,270809,270813,270814,4,5,0
77255,2,1,270811,270814,270815,3,4,0
77256,3,3,270814,270815,270818,1,4,0
77257,2,1,270816,270818,270819,2,3,0
77258,5,2,270821,270821,270823,0,2,2
77259,5,3,270826,270826,270829,0,3,3
77260,3,2,270829,270829,270831,0,2,0
77261,5,2,270834,270834,270836,0,2,3
77262,1,1,270835,270836,270837,1,2,0
77263,3,3,270838,270838,270841,0,3,1
77264,2,1,270840,270841,270842,1,2,0
77265,6,1,270846,270846,270847,0,1,4
77266,6,3,270852,270852,270855,0,3,5
77267,2,3,270854,270855,270858,1,4,0
77268,6,2,270860,270860,270862,0,2,2
77269,6,2,270866,270866,270868,0,2,4
77270,6,2,270872,270872,270874,0,2,4
77271,3,3,270875,270875,270878,0,3,1
77272,4,1,270879,270879,270880,0,1,1
77273,5,3,270884,270884,270887,0,3,4
77274,3,2,270887,270887,270889,0,2,0
77275,6,3,270893,270893,270896,0,3,4
77276,6,2,270899,270899,270901,0,2,3
77277,3,3,270902,270902,270905,0,3,1
77278,4,1,270906,270906,270907,0,1,1
77279,6,2,270912,270912,270914,0,2,5
77280,2,2,270914,270914,270916,0,2,0
77281,5,2,270919,270919,270921,0,2,3
77282,4,2,270923,270923,270925,0,2,2
77283,4,1,270927,270927,270928,0,1,2
77284,4,1,270931,270931,270932,0,1,3
77285,6,2,270937,270937,270939,0,2,5
77286,4,2,270941,270941,270943,0,2,2
77287,2,1,270943,270943,270944,0,1,0
77288,5,1,270948,270948,270949,0,1,4
77289,1,1,270949,270949,270950,0,1,0
77290,3,2,270952,270952,270954,0,2,2
77291,1,3,270953,270954,270957,1,4,0
77292,3,1,270956,270957,270958,1,2,0
77293,2,2,270958,270958,270960,0,2,0
77294,4,3,270962,270962,270965,0,3,2
77295,3,2,270965,270965,270967,0,2,0
77296,1,2,270966,270967,270969,1,3,0
77297,5,3,270971,270971,270974,0,3,2
77298,4,2,270975,270975,270977,0,2,1
77299,2,3,270977,270977,270980,0,3,0
77300,2,3,270979,270980,270983,1,4,0
77301,3,2,270982,270983,270985,1,3,0
77302,5,2,270987,270987,270989,0,2,2
77303,5,3,270992,270992,270995,0,3,3
77304,1,1,270993,270995,270996,2,3,0
77305,1,3,270994,270996,270999,2,5,0
77306,6,1,271000,271000,271001,0,1,1
77307,3,3,271003,271003,271006,0,3,2
77308,4,2,271007,271007,271009,0,2,1
77309,3,1,271010,271010,271011,0,1,1
77310,1,1,271011,271011,271012,0,1,0
77311,2,3,271013,271013,271016,0,3,1
77312,1,3,271014,271016,271019,2,5,0
77313,5,3,271019,271019,271022,0,3,0
77314,4,3,271023,271023,271026,0,3,1
77315,4,3,271027,271027,271030,0,3,1
77316,4,3,271031,271031,271034,0,3,1
77317,5,3,271036,271036,271039,0,3,2
77318,5,1,271041,271041,271042,0,1,2
77319,4,2,271045,271045,271047,0,2,3
77320,5,1,271050,271050,271051,0,1,3
77321,4,3,271054,271054,271057,0,3,3
77322,2,1,271056,271057,271058,1,2,0
77323,6,3,271062,271062,271065,0,3,4
77324,2,1,271064,271065,271066,1,2,0
77325,1,3,271065,271066,271069,1,4,0
77326,5,3,271070,271070,271073,0,3,1
77327,4,2,271074,271074,271076,0,2,1
77328,2,2,271076,271076,271078,0,2,0
77329,4,3,271080,271080,271083,0,3,2
77330,2,1,271082,271083,271084,1,2,0
77331,3,2,271085,271085,271087,0,2,1
77332,3,2,271088,271088,271090,0,2,1
77333,2,1,271090,271090,271091,0,1,0
77334,2,1,271092,271092,271093,0,1,1
77335,4,3,271096,271096,271099,0,3,3
77336,1,3,271097,271099,271102,2,5,0
77337,6,1,271103,271103,271104,0,1,1
77338,1,1,271104,271104,271105,0,1,0
77339,6,1,271110,271110,271111,0,1,5
77340,3,2,271113,271113,271115,0,2,2
77341,3,3,271116,271116,271119,0,3,1
77342,3,3,271119,271119,271122,0,3,0
77343,1,3,271120,271122,271125,2,5,0
77344,6,3,271126,271126,271129,0,3,1
77345,6,1,271132,271132,271133,0,1,3
77346,2,2,271134,271134,271136,0,2,1
77347,2,3,271136,271136,271139,0,3,0
77348,2,1,271138,271139,271140,1,2,0
77349,6,3,271144,271144,271147,0,3,4
77350,4,2,271148,271148,271150,0,2,1
77351,3,2,271151,271151,271153,0,2,1
77352,5,2,271156,271156,271158,0,2,3
77353,2,2,271158,271158,271160,0,2,0
77354,5,3,271163,271163,271166,0,3,3
77355,4,2,271167,271167,271169,0,2,1
77356,4,3,271171,271171,271174,0,3,2
77357,2,1,271173,271174,271175,1,2,0
77358,3,1,271176,271176,271177,0,1,1
77359,2,3,271178,271178,271181,0,3,1
77360,3,2,271181,271181,271183,0,2,0
77361,1,1,271182,271183,271184,1,2,0
77362,4,1,271186,271186,271187,0,1,2
77363,4,1,271190,271190,271191,0,1,3
77364,1,3,271191,271191,271194,0,3,0
77365,6,3,271197,271197,271200,0,3,3
77366,4,1,271201,271201,271202,0,1,1
77367,2,2,271203,271203,271205,0,2,1
77368,2,2,271205,271205,271207,0,2,0
77369,6,3,271211,271211,271214,0,3,4
77370,1,3,271212,271214,271217,2,5,0
77371,1,3,271213,271217,271220,4,7,0
77372,2,2,271215,271220,271222,5,7,0
77373,3,3,271218,271222,271225,4,7,0
77374,6,2,271224,271225,271227,1,3,0
77375,6,1,271230,271230,271231,0,1,3
77376,1,3,271231,271231,271234,0,3,0
77377,2,3,271233,271234,271237,1,4,0
77378,4,1,271237,271237,271238,0,1,0
77379,1,3,271238,271238,271241,0,3,0
77380,2,2,271240,271241,271243,1,3,0
77381,5,3,271245,271245,271248,0,3,2
77382,3,3,271248,271248,271251,0,3,0
77383,6,3,271254,271254,271257,0,3,3
77384,2,1,271256,271257,271258,1,2,0
77385,5,2,271261,271261,271263,0,2,3
77386,1,1,271262,271263,271264,1,2,0
77387,5,2,271267,271267,271269,0,2,3
77388,2,2,271269,271269,271271,0,2,0
77389,6,1,271275,271275,271276,0,1,4
77390,1,2,271276,271276,271278,0,2,0
77391,4,2,271280,271280,271282,0,2,2
77392,3,3,271283,271283,271286,0,3,1
77393,5,2,271288,271288,271290,0,2,2
77394,2,2,271290,271290,271292,0,2,0
77395,3,2,271293,271293,271295,0,2,1
77396,5,2,271298,271298,271300,0,2,3
77397,6,3,271304,271304,271307,0,3,4
77398,5,3,271309,271309,271312,0,3,2
77399,5,2,271314,271314,271316,0,2,2
77400,6,2,271320,271320,271322,0,2,4
77401,2,3,271322,271322,271325,0,3,0
77402,4,2,271326,271326,271328,0,2,1
77403,6,1,271332,271332,271333,0,1,4
77404,4,1,271336,271336,271337,0,1,3
77405,2,2,271338,271338,271340,0,2,1
77406,4,3,271342,271342,271345,0,3,2
77407,2,1,271344,271345,271346,1,2,0
77408,6,2,271350,271350,271352,0,2,4
77409,4,2,271354,271354,271356,0,2,2
77410,6,2,271360,271360,271362,0,2,4
77411,1,2,271361,271362,271364,1,3,0
77412,4,3,271365,271365,271368,0,3,1
77413,3,2,271368,271368,271370,0,2,0
77414,1,1,271369,271370,271371,1,2,0
77415,2,2,271371,271371,271373,0,2,0
77416,1,2,271372,271373,271375,1,3,0
77417,6,2,271378,271378,271380,0,2,3
77418,3,2,271381,271381,271383,0,2,1
77419,3,2,271384,271384,271386,0,2,1
77420,5,2,271389,271389,271391,0,2,3
77421,1,3,271390,271391,271394,1,4,0
77422,6,3,271396,271396,271399,0,3,2
77423,5,1,271401,271401,271402,0,1,2
77424,5,1,271406,271406,271407,0,1,4
77425,2,3,271408,271408,271411,0,3,1
77426,2,2,271410,271411,271413,1,3,0
77427,2,1,271412,271413,271414,1,2,0
77428,4,2,271416,271416,271418,0,2,2
77429,4,2,271420,271420,271422,0,2,2
77430,3,3,271423,271423,271426,0,3,1
77431,4,3,271427,271427,271430,0,3,1
77432,3,3,271430,271430,271433,0,3,0
77433,2,1,271432,271433,271434,1,2,0
77434,4,3,271436,271436,271439,0,3,2
77435,1,2,271437,271439,271441,2,4,0
77436,1,2,271438,271441,271443,3,5,0
77437,4,2,271442,271443,271445,1,3,0
77438,3,2,271445,271445,271447,0,2,0
77439,6,2,271451,271451,271453,0,2,4
77440,3,3,271454,271454,271457,0,3,1
77441,5,1,271459,271459,271460,0,1,2
77442,1,2,271460,271460,271462,0,2,0
77443,6,2,271466,271466,271468,0,2,4
77444,2,3,271468,271468,271471,0,3,0
77445,5,2,271473,271473,271475,0,2,2
77446,3,1,271476,271476,271477,0,1,1
77447,2,2,271478,271478,271480,0,2,1
77448,6,1,271484,271484,271485,0,1,4
77449,3,3,271487,271487,271490,0,3,2
77450,6,1,271493,271493,271494,0,1,3
77451,2,1,271495,271495,271496,0,1,1
77452,5,3,271500,271500,271503,0,3,4
77453,5,3,271505,271505,271508,0,3,2
77454,4,2,271509,271509,271511,0,2,1
77455,5,3,271514,271514,271517,0,3,3
77456,1,3,271515,271517,271520,2,5,0
77457,1,2,271516,271520,271522,4,6,0
77458,5,3,271521,271522,271525,1,4,0
77459,6,2,271527,271527,271529,0,2,2
77460,2,1,271529,271529,271530,0,1,0
77461,2,1,271531,271531,271532,0,1,1
77462,1,3,271532,271532,271535,0,3,0
77463,2,3,271534,271535,271538,1,4,0
77464,5,1,271539,271539,271540,0,1,1
77465,5,3,271544,271544,271547,0,3,4
77466,6,3,271550,271550,271553,0,3,3
77467,1,3,271551,271553,271556,2,5,0
77468,3,1,271554,271556,271557,2,3,0
77469,1,1,271555,271557,271558,2,3,0
77470,5,1,271560,271560,271561,0,1,2
77471,2,3,271562,271562,271565,0,3,1
77472,3,2,271565,271565,271567,0,2,0
77473,2,1,271567,271567,271568,0,1,0
77474,1,2,271568,271568,271570,0,2,0
77475,3,1,271571,271571,271572,0,1,1
77476,5,2,271576,271576,271578,0,2,4
77477,3,2,271579,271579,271581,0,2,1
77478,4,3,271583,271583,271586,0,3,2
77479,1,1,271584,271586,271587,2,3,0
77480,4,2,271588,271588,271590,0,2,1
77481,2,3,271590,271590,271593,0,3,0
77482,5,3,271595,271595,271598,0,3,2
77483,6,2,271601,271601,271603,0,2,3
77484,3,3,271604,271604,271607,0,3,1
77485,4,1,271608,271608,271609,0,1,1
77486,1,3,271609,271609,271612,0,3,0
77487,2,2,271611,271612,271614,1,3,0
77488,6,3,271617,271617,271620,0,3,3
77489,6,2,271623,271623,271625,0,2,3
77490,5,2,271628,271628,271630,0,2,3
77491,6,3,271634,271634,271637,0,3,4
77492,6,3,271640,271640,271643,0,3,3
77493,3,2,271643,271643,271645,0,2,0
77494,6,1,271649,271649,271650,0,1,4
77495,2,1,271651,271651,271652,0,1,1
77496,6,2,271657,271657,271659,0,2,5
77497,3,3,271660,271660,271663,0,3,1
77498,4,1,271664,271664,271665,0,1,1
77499,4,2,271668,271668,271670,0,2,3
77500,2,3,271670,271670,271673,0,3,0
77501,3,2,271673,271673,271675,0,2,0
77502,5,2,271678,271678,271680,0,2,3
77503,4,2,271682,271682,271684,0,2,2
77504,3,2,271685,271685,271687,0,2,1
77505,6,3,271691,271691,271694,0,3,4
77506,5,2,271696,271696,271698,0,2,2
77507,6,2,271702,271702,271704,0,2,4
77508,3,1,271705,271705,271706,0,1,1
77509,5,2,271710,271710,271712,0,2,4
77510,4,2,271714,271714,271716,0,2,2
77511,5,2,271719,271719,271721,0,2,3
77512,2,1,271721,271721,271722,0,1,0
77513,1,1,271722,271722,271723,0,1,0
77514,6,1,271728,271728,271729,0,1,5
77515,3,1,271731,271731,271732,0,1,2
77516,5,1,271736,271736,271737,0,1,4
77517,6,3,271742,271742,271745,0,3,5
77518,4,3,271746,271746,271749,0,3,1
77519,6,1,271752,271752,271753,0,1,3
77520,4,3,271756,271756,271759,0,3,3
77521,1,3,271757,271759,271762,2,5,0
77522,5,3,271762,271762,271765,0,3,0
77523,1,1,271763,271765,271766,2,3,0
77524,1,3,271764,271766,271769,2,5,0
77525,5,3,271769,271769,271772,0,3,0
77526,6,1,271775,271775,271776,0,1,3
77527,3,1,271778,271778,271779,0,1,2
77528,3,1,271781,271781,271782,0,1,2
77529,1,2,271782,271782,271784,0,2,0
77530,3,2,271785,271785,271787,0,2,1
77531,3,1,271788,271788,271789,0,1,1
77532,6,2,271794,271794,271796,0,2,5
77533,2,1,271796,271796,271797,0,1,0
77534,5,3,271801,271801,271804,0,3,4
77535,3,2,271804,271804,271806,0,2,0
77536,4,3,271808,271808,271811,0,3,2
77537,3,2,271811,271811,271813,0,2,0
77538,4,3,271815,271815,271818,0,3,2
77539,3,1,271818,271818,271819,0,1,0
77540,6,3,271824,271824,271827,0,3,5
77541,6,1,271830,271830,271831,0,1,3
77542,3,3,271833,271833,271836,0,3,2
77543,5,3,271838,271838,271841,0,3,2
77544,3,1,271841,271841,271842,0,1,0
77545,3,3,271844,271844,271847,0,3,2
77546,4,2,271848,271848,271850,0,2,1
77547,4,1,271852,271852,271853,0,1,2
77548,4,1,271856,271856,271857,0,1,3
77549,2,3,271858,271858,271861,0,3,1
77550,5,3,271863,271863,271866,0,3,2
77551,1,2,271864,271866,271868,2,4,0
77552,2,2,271866,271868,271870,2,4,0
77553,6,1,271872,271872,271873,0,1,2
77554,6,2,271878,271878,271880,0,2,5
77555,6,1,271884,271884,271885,0,1,4
77556,5,3,271889,271889,271892,0,3,4
77557,5,2,271894,271894,271896,0,2,2
77558,2,3,271896,271896,271899,0,3,0
77559,2,1,271898,271899,271900,1,2,0
77560,4,2,271902,271902,271904,0,2,2
77561,6,2,271908,271908,271910,0,2,4
77562,4,1,271912,271912,271913,0,1,2
77563,6,2,271918,271918,271920,0,2,5
77564,6,2,271924,271924,271926,0,2,4
77565,4,2,271928,271928,271930,0,2,2
77566,2,1,271930,271930,271931,0,1,0
77567,3,3,271933,271933,271936,0,3,2
77568,2,3,271935,271936,271939,1,4,0
77569,1,3,271936,271939,271942,3,6,0
77570,6,3,271942,271942,271945,0,3,0
77571,5,2,271947,271947,271949,0,2,2
77572,4,1,271951,271951,271952,0,1,2
77573,1,1,271952,271952,271953,0,1,0
77574,1,2,271953,271953,271955,0,2,0
77575,5,1,271958,271958,271959,0,1,3
77576,4,2,271962,271962,271964,0,2,3
77577,2,3,271964,271964,271967,0,3,0
77578,4,3,271968,271968,271971,0,3,1
77579,3,1,271971,271971,271972,0,1,0
77580,3,2,271974,271974,271976,0,2,2
77581,1,3,271975,271976,271979,1,4,0
77582,6,2,271981,271981,271983,0,2,2
77583,6,1,271987,271987,271988,0,1,4
77584,4,1,271991,271991,271992,0,1,3
77585,6,1,271997,271997,271998,0,1,5
77586,6,3,272003,272003,272006,0,3,5
77587,4,2,272007,272007,272009,0,2,1
77588,6,2,272013,272013,272015,0,2,4
77589,4,2,272017,272017,272019,0,2,2
77590,2,2,272019,272019,272021,0,2,0
77591,3,3,272022,272022,272025,0,3,1
77592,2,1,272024,272025,272026,1,2,0
77593,3,1,272027,272027,272028,0,1,1
77594,3,1,272030,272030,272031,0,1,2
77595,6,1,272036,272036,272037,0,1,5
77596,5,3,272041,272041,272044,0,3,4
77597,1,1,272042,272044,272045,2,3,0
77598,2,3,272044,272045,272048,1,4,0
77599,5,3,272049,272049,272052,0,3,1
77600,5,3,272054,272054,272057,0,3,2
77601,6,1,272060,272060,272061,0,1,3
77602,3,1,272063,272063,272064,0,1,2
77603,4,3,272067,272067,272070,0,3,3
77604,1,1,272068,272070,272071,2,3,0
77605,5,2,272073,272073,272075,0,2,2
77606,2,2,272075,272075,272077,0,2,0
77607,3,3,272078,272078,272081,0,3,1
77608,6,1,272084,272084,272085,0,1,3
77609,1,2,272085,272085,272087,0,2,0
77610,4,2,272089,272089,272091,0,2,2
77611,2,1,272091,272091,272092,0,1,0
77612,4,2,272095,272095,272097,0,2,3
77613,6,2,272101,272101,272103,0,2,4
77614,5,3,272106,272106,272109,0,3,3
77615,4,2,272110,272110,272112,0,2,1
77616,4,2,272114,272114,272116,0,2,2
77617,3,1,272117,272117,272118,0,1,1
77618,3,1,272120,272120,272121,0,1,2
77619,5,1,272125,272125,272126,0,1,4
77620,5,3,272130,272130,272133,0,3,4
77621,6,1,272136,272136,272137,0,1,3
77622,3,2,272139,272139,272141,0,2,2
77623,1,1,272140,272141,272142,1,2,0
77624,5,1,272145,272145,272146,0,1,3
77625,1,3,272146,272146,272149,0,3,0
77626,6,2,272152,272152,272154,0,2,3
77627,2,1,272154,272154,272155,0,1,0
77628,4,1,272158,272158,272159,0,1,3
77629,2,2,272160,272160,272162,0,2,1
77630,1,3,272161,272162,272165,1,4,0
77631,4,3,272165,272165,272168,0,3,0
77632,4,1,272169,272169,272170,0,1,1
77633,1,3,272170,272170,272173,0,3,0
77634,1,1,272171,272173,272174,2,3,0
77635,6,2,272177,272177,272179,0,2,3
77636,3,3,272180,272180,272183,0,3,1
77637,6,2,272186,272186,272188,0,2,3
77638,6,3,272192,272192,272195,0,3,4
77639,6,1,272198,272198,272199,0,1,3
77640,4,1,272202,272202,272203,0,1,3
77641,5,2,272207,272207,272209,0,2,4
77642,5,3,272212,272212,272215,0,3,3
77643,1,2,272213,272215,272217,2,4,0
77644,6,2,272219,272219,272221,0,2,2
77645,4,2,272223,272223,272225,0,2,2
77646,2,2,272225,272225,272227,0,2,0
77647,1,1,272226,272227,272228,1,2,0
77648,2,2,272228,272228,272230,0,2,0
77649,1,2,272229,272230,272232,1,3,0
77650,3,2,272232,272232,272234,0,2,0
77651,2,2,272234,272234,272236,0,2,0
77652,3,2,272237,272237,272239,0,2,1
77653,4,1,272241,272241,272242,0,1,2
77654,2,1,272243,272243,272244,0,1,1
77655,6,2,272249,272249,272251,0,2,5
77656,5,3,272254,272254,272257,0,3,3
77657,4,3,272258,272258,272261,0,3,1
77658,5,1,272263,272263,272264,0,1,2
77659,3,2,272266,272266,272268,0,2,2
77660,2,2,272268,272268,272270,0,2,0
77661,2,3,272270,272270,272273,0,3,0
77662,4,3,272274,272274,272277,0,3,1
77663,3,1,272277,272277,272278,0,1,0
77664,4,1,272281,272281,272282,0,1,3
77665,1,2,272282,272282,272284,0,2,0
77666,1,3,272283,272284,272287,1,4,0
77667,5,1,272288,272288,272289,0,1,1
77668,3,1,272291,272291,272292,0,1,2
77669,3,3,272294,272294,272297,0,3,2
77670,6,3,272300,272300,272303,0,3,3
77671,5,1,272305,272305,272306,0,1,2
77672,2,1,272307,272307,272308,0,1,1
77673,2,2,272309,272309,272311,0,2,1
77674,3,2,272312,272312,272314,0,2,1
77675,5,1,272317,272317,272318,0,1,3
77676,3,3,272320,272320,272323,0,3,2
77677,6,1,272326,272326,272327,0,1,3
77678,1,1,272327,272327,272328,0,1,0
77679,4,2,272331,272331,272333,0,2,3
77680,3,2,272334,272334,272336,0,2,1
77681,1,3,272335,272336,272339,1,4,0
77682,2,3,272337,272339,272342,2,5,0
77683,3,3,272340,272342,272345,2,5,0
77684,6,1,272346,272346,272347,0,1,1
77685,6,1,272352,272352,272353,0,1,5
77686,4,1,272356,272356,272357,0,1,3
77687,1,1,272357,272357,272358,0,1,0
77688,4,3,272361,272361,272364,0,3,3
77689,5,1,272366,272366,272367,0,1,2
77690,2,2,272368,272368,272370,0,2,1
77691,1,1,272369,272370,272371,1,2,0
77692,3,1,272372,272372,272373,0,1,1
77693,1,2,272373,272373,272375,0,2,0
77694,4,1,272377,272377,272378,0,1,2
77695,5,3,272382,272382,272385,0,3,4
77696,2,1,272384,272385,272386,1,2,0
77697,1,2,272385,272386,272388,1,3,0
77698,1,3,272386,272388,272391,2,5,0
77699,5,1,272391,272391,272392,0,1,0
77700,4,2,272395,272395,272397,0,2,3
77701,6,2,272401,272401,272403,0,2,4
77702,1,3,272402,272403,272406,1,4,0
77703,4,1,272406,272406,272407,0,1,0
77704,3,3,272409,272409,272412,0,3,2
77705,3,3,272412,272412,272415,0,3,0
77706,5,3,272417,272417,272420,0,3,2
77707,1,1,272418,272420,272421,2,3,0
77708,1,3,272419,272421,272424,2,5,0
77709,1,3,272420,272424,272427,4,7,0
77710,2,1,272422,272427,272428,5,6,0
77711,3,3,272425,272428,272431,3,6,0
77712,4,1,272429,272431,272432,2,3,0
77713,3,3,272432,272432,272435,0,3,0
77714,4,1,272436,272436,272437,0,1,1
77715,5,1,272441,272441,272442,0,1,4
77716,1,1,272442,272442,272443,0,1,0
77717,6,1,272448,272448,272449,0,1,5
77718,5,1,272453,272453,272454,0,1,4
77719,6,3,272459,272459,272462,0,3,5
77720,2,3,272461,272462,272465,1,4,0
77721,4,3,272465,272465,272468,0,3,0
77722,2,2,272467,272468,272470,1,3,0
77723,2,1,272469,272470,272471,1,2,0
77724,1,2,272470,272471,272473,1,3,0
77725,2,1,272472,272473,272474,1,2,0
77726,3,2,272475,272475,272477,0,2,1
77727,4,3,272479,272479,272482,0,3,2
77728,4,1,272483,272483,272484,0,1,1
77729,2,2,272485,272485,272487,0,2,1
77730,3,3,272488,272488,272491,0,3,1
77731,2,2,272490,272491,272493,1,3,0
77732,2,2,272492,272493,272495,1,3,0
77733,1,3,272493,272495,272498,2,5,0
77734,4,2,272497,272498,272500,1,3,0
77735,2,2,272499,272500,272502,1,3,0
77736,4,1,272503,272503,272504,0,1,1
77737,3,1,272506,272506,272507,0,1,2
77738,1,2,272507,272507,272509,0,2,0
77739,5,2,272512,272512,272514,0,2,3
77740,3,1,272515,272515,272516,0,1,1
77741,6,3,272521,272521,272524,0,3,5
77742,4,3,272525,272525,272528,0,3,1
77743,5,2,272530,272530,272532,0,2,2
77744,5,1,272535,272535,272536,0,1,3
77745,6,1,272541,272541,272542,0,1,5
77746,4,1,272545,272545,272546,0,1,3
77747,2,2,272547,272547,272549,0,2,1
77748,4,2,272551,272551,272553,0,2,2
77749,1,3,272552,272553,272556,1,4,0
77750,3,1,272555,272556,272557,1,2,0
77751,4,1,272559,272559,272560,0,1,2
77752,5,3,272564,272564,272567,0,3,4
77753,1,1,272565,272567,272568,2,3,0
77754,2,1,272567,272568,272569,1,2,0
77755,5,1,272572,272572,272573,0,1,3
77756,2,3,272574,272574,272577,0,3,1
77757,1,2,272575,272577,272579,2,4,0
77758,2,1,272577,272579,272580,2,3,0
77759,4,2,272581,272581,272583,0,2,1
77760,4,3,272585,272585,272588,0,3,2
77761,4,3,272589,272589,272592,0,3,1
77762,2,1,272591,272592,272593,1,2,0
77763,4,2,272595,272595,272597,0,2,2
77764,4,3,272599,272599,272602,0,3,2
77765,6,1,272605,272605,272606,0,1,3
77766,3,2,272608,272608,272610,0,2,2
77767,2,1,272610,272610,272611,0,1,0
77768,4,1,272614,272614,272615,0,1,3
77769,2,1,272616,272616,272617,0,1,1
77770,3,2,272619,272619,272621,0,2,2
77771,6,2,272625,272625,272627,0,2,4
77772,4,1,272629,272629,272630,0,1,2
77773,5,2,272634,272634,272636,0,2,4
77774,5,3,272639,272639,272642,0,3,3
77775,2,2,272641,272642,272644,1,3,0
77776,6,2,272647,272647,272649,0,2,3
77777,4,3,272651,272651,272654,0,3,2
77778,6,3,272657,272657,272660,0,3,3
77779,2,2,272659,272660,272662,1,3,0
77780,4,2,272663,272663,272665,0,2,1
77781,5,1,272668,272668,272669,0,1,3
77782,3,1,272671,272671,272672,0,1,2
77783,4,1,272675,272675,272676,0,1,3
77784,6,2,272681,272681,272683,0,2,5
77785,1,1,272682,272683,272684,1,2,0
77786,3,1,272685,272685,272686,0,1,1
77787,5,1,272690,272690,272691,0,1,4
77788,5,2,272695,272695,272697,0,2,4
77789,4,2,272699,272699,272701,0,2,2
77790,3,3,272702,272702,272705,0,3,1
77791,3,1,272705,272705,272706,0,1,0
77792,1,1,272706,272706,272707,0,1,0
77793,1,1,272707,272707,272708,0,1,0
77794,2,2,272709,272709,272711,0,2,1
77795,4,3,272713,272713,272716,0,3,2
77796,3,2,272716,272716,272718,0,2,0
77797,5,3,272721,272721,272724,0,3,3
77798,6,1,272727,272727,272728,0,1,3
77799,4,2,272731,272731,272733,0,2,3
77800,5,3,272736,272736,272739,0,3,3
77801,4,3,272740,272740,272743,0,3,1
77802,4,3,272744,272744,272747,0,3,1
77803,4,3,272748,272748,272751,0,3,1
77804,2,1,272750,272751,272752,1,2,0
77805,1,1,272751,272752,272753,1,2,0
77806,1,3,272752,272753,272756,1,4,0
77807,6,1,272758,272758,272759,0,1,2
77808,6,3,272764,272764,272767,0,3,5
77809,2,1,272766,272767,272768,1,2,0
77810,1,2,272767,272768,272770,1,3,0
77811,3,1,272770,272770,272771,0,1,0
77812,3,2,272773,272773,272775,0,2,2
77813,1,3,272774,272775,272778,1,4,0
77814,1,2,272775,272778,272780,3,5,0
77815,1,1,272776,272780,272781,4,5,0
77816,4,3,272780,272781,272784,1,4,0
77817,6,1,272786,272786,272787,0,1,2
77818,6,1,272792,272792,272793,0,1,5
77819,6,2,272798,272798,272800,0,2,5
77820,1,3,272799,272800,272803,1,4,0
77821,3,1,272802,272803,272804,1,2,0
77822,2,3,272804,272804,272807,0,3,0
77823,6,3,272810,272810,272813,0,3,3
77824,2,2,272812,272813,272815,1,3,0
77825,1,2,272813,272815,272817,2,4,0
77826,5,3,272818,272818,272821,0,3,1
77827,3,3,272821,272821,272824,0,3,0
77828,6,2,272827,272827,272829,0,2,3
77829,2,1,272829,272829,272830,0,1,0
77830,6,3,272835,272835,272838,0,3,5
77831,4,1,272839,272839,272840,0,1,1
77832,6,3,272845,272845,272848,0,3,5
77833,1,3,272846,272848,272851,2,5,0
77834,3,2,272849,272851,272853,2,4,0
77835,5,2,272854,272854,272856,0,2,1
77836,5,2,272859,272859,272861,0,2,3
77837,4,3,272863,272863,272866,0,3,2
77838,2,1,272865,272866,272867,1,2,0
77839,3,3,272868,272868,272871,0,3,1
77840,5,2,272873,272873,272875,0,2,2
77841,6,2,272879,272879,272881,0,2,4
77842,5,3,272884,272884,272887,0,3,3
77843,3,3,272887,272887,272890,0,3,0
77844,5,1,272892,272892,272893,0,1,2
77845,6,2,272898,272898,272900,0,2,5
77846,2,3,272900,272900,272903,0,3,0
77847,2,2,272902,272903,272905,1,3,0
77848,4,1,272906,272906,272907,0,1,1
77849,3,2,272909,272909,272911,0,2,2
77850,4,3,272913,272913,272916,0,3,2
77851,2,3,272915,272916,272919,1,4,0
77852,2,1,272917,272919,272920,2,3,0
77853,4,3,272921,272921,272924,0,3,1
77854,5,1,272926,272926,272927,0,1,2
77855,6,1,272932,272932,272933,0,1,5
77856,2,2,272934,272934,272936,0,2,1
77857,4,1,272938,272938,272939,0,1,2
77858,6,2,272944,272944,272946,0,2,5
77859,1,2,272945,272946,272948,1,3,0
77860,5,3,272950,272950,272953,0,3,2
77861,1,2,272951,272953,272955,2,4,0
77862,2,2,272953,272955,272957,2,4,0
77863,5,3,272958,272958,272961,0,3,1
77864,4,1,272962,272962,272963,0,1,1
77865,3,2,272965,272965,272967,0,2,2
77866,1,3,272966,272967,272970,1,4,0
77867,1,1,272967,272970,272971,3,4,0
77868,4,3,272971,272971,272974,0,3,0
77869,4,3,272975,272975,272978,0,3,1
77870,1,1,272976,272978,272979,2,3,0
77871,5,3,272981,272981,272984,0,3,2
77872,3,3,272984,272984,272987,0,3,0
77873,2,3,272986,272987,272990,1,4,0
77874,3,3,272989,272990,272993,1,4,0
77875,2,3,272991,272993,272996,2,5,0
77876,1,1,272992,272996,272997,4,5,0
77877,6,3,272998,272998,273001,0,3,1
77878,6,3,273004,273004,273007,0,3,3
77879,5,2,273009,273009,273011,0,2,2
77880,4,3,273013,273013,273016,0,3,2
77881,2,1,273015,273016,273017,1,2,0
77882,1,3,273016,273017,273020,1,4,0
77883,5,1,273021,273021,273022,0,1,1
77884,1,2,273022,273022,273024,0,2,0
77885,2,3,273024,273024,273027,0,3,0
77886,1,1,273025,273027,273028,2,3,0
77887,4,2,273029,273029,273031,0,2,1
77888,5,2,273034,273034,273036,0,2,3
77889,5,1,273039,273039,273040,0,1,3
77890,4,3,273043,273043,273046,0,3,3
77891,3,2,273046,273046,273048,0,2,0
77892,6,3,273052,273052,273055,0,3,4
77893,1,1,273053,273055,273056,2,3,0
77894,4,1,273057,273057,273058,0,1,1
77895,5,2,273062,273062,273064,0,2,4
77896,4,3,273066,273066,273069,0,3,2
77897,6,1,273072,273072,273073,0,1,3
77898,5,1,273077,273077,273078,0,1,4
77899,6,1,273083,273083,273084,0,1,5
77900,4,2,273087,273087,273089,0,2,3
77901,6,3,273093,273093,273096,0,3,4
77902,2,2,273095,273096,273098,1,3,0
77903,2,3,273097,273098,273101,1,4,0
77904,5,2,273102,273102,273104,0,2,1
77905,5,2,273107,273107,273109,0,2,3
77906,3,1,273110,273110,273111,0,1,1
77907,5,1,273115,273115,273116,0,1,4
77908,5,3,273120,273120,273123,0,3,4
77909,1,1,273121,273123,273124,2,3,0
77910,4,2,273125,273125,273127,0,2,1
77911,6,3,273131,273131,273134,0,3,4
77912,6,3,273137,273137,273140,0,3,3
77913,4,1,273141,273141,273142,0,1,1
77914,4,1,273145,273145,273146,0,1,3
77915,6,1,273151,273151,273152,0,1,5
77916,5,2,273156,273156,273158,0,2,4
77917,4,2,273160,273160,273162,0,2,2
77918,4,2,273164,273164,273166,0,2,2
77919,4,3,273168,273168,273171,0,3,2
77920,2,2,273170,273171,273173,1,3,0
77921,4,3,273174,273174,273177,0,3,1
77922,3,2,273177,273177,273179,0,2,0
77923,2,1,273179,273179,273180,0,1,0
77924,3,1,273182,273182,273183,0,1,2
77925,1,3,273183,273183,273186,0,3,0
77926,3,3,273186,273186,273189,0,3,0
77927,2,1,273188,273189,273190,1,2,0
77928,3,3,273191,273191,273194,0,3,1
77929,4,2,273195,273195,273197,0,2,1
77930,4,1,273199,273199,273200,0,1,2
77931,2,2,273201,273201,273203,0,2,1
77932,5,2,273206,273206,273208,0,2,3
77933,5,2,273211,273211,273213,0,2,3
77934,4,1,273215,273215,273216,0,1,2
77935,5,1,273220,273220,273221,0,1,4
77936,6,2,273226,273226,273228,0,2,5
77937,2,2,273228,273228,273230,0,2,0
77938,6,3,273234,273234,273237,0,3,4
77939,1,2,273235,273237,273239,2,4,0
77940,2,1,273237,273239,273240,2,3,0
77941,5,1,273242,273242,273243,0,1,2
77942,4,2,273246,273246,273248,0,2,3
77943,1,2,273247,273248,273250,1,3,0
77944,6,3,273253,273253,273256,0,3,3
77945,5,3,273258,273258,273261,0,3,2
77946,5,2,273263,273263,273265,0,2,2
77947,4,3,273267,273267,273270,0,3,2
77948,1,3,273268,273270,273273,2,5,0
77949,4,2,273272,273273,273275,1,3,0
77950,5,1,273277,273277,273278,0,1,2
77951,3,3,273280,273280,273283,0,3,2
77952,4,3,273284,273284,273287,0,3,1
77953,6,1,273290,273290,273291,0,1,3
77954,4,2,273294,273294,273296,0,2,3
77955,1,2,273295,273296,273298,1,3,0
77956,6,3,273301,273301,273304,0,3,3
77957,4,3,273305,273305,273308,0,3,1
77958,5,3,273310,273310,273313,0,3,2
77959,4,3,273314,273314,273317,0,3,1
77960,5,3,273319,273319,273322,0,3,2
77961,3,2,273322,273322,273324,0,2,0
77962,6,1,273328,273328,273329,0,1,4
77963,2,2,273330,273330,273332,0,2,1
77964,4,2,273334,273334,273336,0,2,2
77965,3,2,273337,273337,273339,0,2,1
77966,3,1,273340,273340,273341,0,1,1
77967,3,1,273343,273343,273344,0,1,2
77968,2,3,273345,273345,273348,0,3,1
77969,5,2,273350,273350,273352,0,2,2
77970,2,2,273352,273352,273354,0,2,0
77971,3,1,273355,273355,273356,0,1,1
77972,1,1,273356,273356,273357,0,1,0
77973,6,3,273362,273362,273365,0,3,5
77974,2,2,273364,273365,273367,1,3,0
77975,3,1,273367,273367,273368,0,1,0
77976,5,1,273372,273372,273373,0,1,4
77977,1,1,273373,273373,273374,0,1,0
77978,1,2,273374,273374,273376,0,2,0
77979,3,3,273377,273377,273380,0,3,1
77980,3,1,273380,273380,273381,0,1,0
77981,5,2,273385,273385,273387,0,2,4
77982,6,3,273391,273391,273394,0,3,4
77983,3,3,273394,273394,273397,0,3,0
77984,3,1,273397,273397,273398,0,1,0
77985,5,1,273402,273402,273403,0,1,4
77986,1,3,273403,273403,273406,0,3,0
77987,5,1,273408,273408,273409,0,1,2
77988,2,3,273410,273410,273413,0,3,1
77989,5,3,273415,273415,273418,0,3,2
77990,5,2,273420,273420,273422,0,2,2
77991,5,1,273425,273425,273426,0,1,3
77992,6,2,273431,273431,273433,0,2,5
77993,2,2,273433,273433,273435,0,2,0
77994,4,1,273437,273437,273438,0,1,2
77995,2,1,273439,273439,273440,0,1,1
77996,4,3,273443,273443,273446,0,3,3
77997,2,1,273445,273446,273447,1,2,0
77998,4,2,273449,273449,273451,0,2,2
77999,5,3,273454,273454,273457,0,3,3
78000,5,1,273459,273459,273460,0,1,2
78001,6,1,273465,273465,273466,0,1,5
78002,6,1,273471,273471,273472,0,1,5
78003,1,1,273472,273472,273473,0,1,0
78004,6,3,273478,273478,273481,0,3,5
78005,3,3,273481,273481,273484,0,3,0
78006,2,1,273483,273484,273485,1,2,0
78007,2,3,273485,273485,273488,0,3,0
78008,1,1,273486,273488,273489,2,3,0
78009,2,1,273488,273489,273490,1,2,0
78010,6,3,273494,273494,273497,0,3,4
78011,1,3,273495,273497,273500,2,5,0
78012,6,1,273501,273501,273502,0,1,1
78013,6,2,273507,273507,273509,0,2,5
78014,5,3,273512,273512,273515,0,3,3
78015,1,2,273513,273515,273517,2,4,0
78016,4,1,273517,273517,273518,0,1,0
78017,4,2,273521,273521,273523,0,2,3
78018,6,2,273527,273527,273529,0,2,4
78019,1,3,273528,273529,273532,1,4,0
78020,5,3,273533,273533,273536,0,3,1
78021,6,2,273539,273539,273541,0,2,3
78022,2,2,273541,273541,273543,0,2,0
78023,5,3,273546,273546,273549,0,3,3
78024,5,2,273551,273551,273553,0,2,2
78025,3,2,273554,273554,273556,0,2,1
78026,1,1,273555,273556,273557,1,2,0
78027,6,2,273561,273561,273563,0,2,4
78028,1,1,273562,273563,273564,1,2,0
78029,4,1,273566,273566,273567,0,1,2
78030,1,2,273567,273567,273569,0,2,0
78031,3,2,273570,273570,273572,0,2,1
78032,1,2,273571,273572,273574,1,3,0
78033,6,1,273577,273577,273578,0,1,3
78034,1,2,273578,273578,273580,0,2,0
78035,6,1,273584,273584,273585,0,1,4
78036,4,3,273588,273588,273591,0,3,3
78037,6,3,273594,273594,273597,0,3,3
78038,6,2,273600,273600,273602,0,2,3
78039,3,2,273603,273603,273605,0,2,1
78040,5,3,273608,273608,273611,0,3,3
78041,3,3,273611,273611,273614,0,3,0
78042,3,2,273614,273614,273616,0,2,0
78043,6,2,273620,273620,273622,0,2,4
78044,6,3,273626,273626,273629,0,3,4
78045,5,3,273631,273631,273634,0,3,2
78046,3,3,273634,273634,273637,0,3,0
78047,6,3,273640,273640,273643,0,3,3
78048,6,1,273646,273646,273647,0,1,3
78049,1,3,273647,273647,273650,0,3,0
78050,1,3,273648,273650,273653,2,5,0
78051,1,1,273649,273653,273654,4,5,0
78052,2,1,273651,273654,273655,3,4,0
78053,4,3,273655,273655,273658,0,3,0
78054,5,2,273660,273660,273662,0,2,2
78055,4,3,273664,273664,273667,0,3,2
78056,2,3,273666,273667,273670,1,4,0
78057,3,1,273669,273670,273671,1,2,0
78058,6,3,273675,273675,273678,0,3,4
78059,2,1,273677,273678,273679,1,2,0
78060,3,1,273680,273680,273681,0,1,1
78061,1,2,273681,273681,273683,0,2,0
78062,5,2,273686,273686,273688,0,2,3
78063,4,2,273690,273690,273692,0,2,2
78064,2,2,273692,273692,273694,0,2,0
78065,5,1,273697,273697,273698,0,1,3
78066,1,2,273698,273698,273700,0,2,0
78067,3,2,273701,273701,273703,0,2,1
78068,2,2,273703,273703,273705,0,2,0
78069,1,1,273704,273705,273706,1,2,0
78070,5,1,273709,273709,273710,0,1,3
78071,2,3,273711,273711,273714,0,3,1
78072,5,1,273716,273716,273717,0,1,2
78073,1,2,273717,273717,273719,0,2,0
78074,2,1,273719,273719,273720,0,1,0
78075,2,3,273721,273721,273724,0,3,1
78076,4,2,273725,273725,273727,0,2,1
78077,2,2,273727,273727,273729,0,2,0
78078,2,2,273729,273729,273731,0,2,0
78079,4,1,273733,273733,273734,0,1,2
78080,6,1,273739,273739,273740,0,1,5
78081,1,2,273740,273740,273742,0,2,0
78082,2,2,273742,273742,273744,0,2,0
78083,5,3,273747,273747,273750,0,3,3
78084,3,1,273750,273750,273751,0,1,0
78085,1,1,273751,273751,273752,0,1,0
78086,4,1,273755,273755,273756,0,1,3
78087,3,3,273758,273758,273761,0,3,2
78088,2,2,273760,273761,273763,1,3,0
78089,2,3,273762,273763,273766,1,4,0
78090,5,3,273767,273767,273770,0,3,1
78091,5,3,273772,273772,273775,0,3,2
78092,6,1,273778,273778,273779,0,1,3
78093,1,1,273779,273779,273780,0,1,0
78094,4,2,273783,273783,273785,0,2,3
78095,6,1,273789,273789,273790,0,1,4
78096,2,3,273791,273791,273794,0,3,1
78097,4,2,273795,273795,273797,0,2,1
78098,4,2,273799,273799,273801,0,2,2
78099,4,3,273803,273803,273806,0,3,2
78100,2,2,273805,273806,273808,1,3,0
78101,1,3,273806,273808,273811,2,5,0
78102,3,2,273809,273811,273813,2,4,0
78103,2,1,273811,273813,273814,2,3,0
78104,4,3,273815,273815,273818,0,3,1
78105,5,1,273820,273820,273821,0,1,2
78106,5,2,273825,273825,273827,0,2,4
78107,3,3,273828,273828,273831,0,3,1
78108,2,2,273830,273831,273833,1,3,0
78109,2,3,273832,273833,273836,1,4,0
78110,6,2,273838,273838,273840,0,2,2
78111,6,3,273844,273844,273847,0,3,4
78112,4,1,273848,273848,273849,0,1,1
78113,1,3,273849,273849,273852,0,3,0
78114,4,1,273853,273853,273854,0,1,1
78115,1,2,273854,273854,273856,0,2,0
78116,5,1,273859,273859,273860,0,1,3
78117,1,3,273860,273860,273863,0,3,0
78118,1,1,273861,273863,273864,2,3,0
78119,5,1,273866,273866,273867,0,1,2
78120,6,2,273872,273872,273874,0,2,5
78121,4,3,273876,273876,273879,0,3,2
78122,5,1,273881,273881,273882,0,1,2
78123,1,1,273882,273882,273883,0,1,0
78124,2,2,273884,273884,273886,0,2,1
78125,3,1,273887,273887,273888,0,1,1
78126,2,3,273889,273889,273892,0,3,1
78127,1,3,273890,273892,273895,2,5,0
78128,3,3,273893,273895,273898,2,5,0
78129,2,3,273895,273898,273901,3,6,0
78130,6,3,273901,273901,273904,0,3,0
78131,2,3,273903,273904,273907,1,4,0
78132,6,3,273909,273909,273912,0,3,2
78133,4,2,273913,273913,273915,0,2,1
78134,2,2,273915,273915,273917,0,2,0
78135,3,2,273918,273918,273920,0,2,1
78136,6,1,273924,273924,273925,0,1,4
78137,5,3,273929,273929,273932,0,3,4
78138,5,2,273934,273934,273936,0,2,2
78139,1,3,273935,273936,273939,1,4,0
78140,6,2,273941,273941,273943,0,2,2
78141,6,2,273947,273947,273949,0,2,4
78142,3,2,273950,273950,273952,0,2,1
78143,6,3,273956,273956,273959,0,3,4
78144,6,3,273962,273962,273965,0,3,3
78145,5,3,273967,273967,273970,0,3,2
78146,3,2,273970,273970,273972,0,2,0
78147,6,1,273976,273976,273977,0,1,4
78148,4,1,273980,273980,273981,0,1,3
78149,5,2,273985,273985,273987,0,2,4
78150,4,1,273989,273989,273990,0,1,2
78151,2,3,273991,273991,273994,0,3,1
78152,5,2,273996,273996,273998,0,2,2
78153,2,2,273998,273998,274000,0,2,0
78154,5,3,274003,274003,274006,0,3,3
78155,5,1,274008,274008,274009,0,1,2
78156,4,3,274012,274012,274015,0,3,3
78157,5,1,274017,274017,274018,0,1,2
78158,6,3,274023,274023,274026,0,3,5
78159,4,2,274027,274027,274029,0,2,1
78160,4,1,274031,274031,274032,0,1,2
78161,5,3,274036,274036,274039,0,3,4
78162,4,3,274040,274040,274043,0,3,1
78163,6,2,274046,274046,274048,0,2,3
78164,6,3,274052,274052,274055,0,3,4
78165,3,3,274055,274055,274058,0,3,0
78166,3,1,274058,274058,274059,0,1,0
78167,6,3,274064,274064,274067,0,3,5
78168,1,1,274065,274067,274068,2,3,0
78169,5,2,274070,274070,274072,0,2,2
78170,4,2,274074,274074,274076,0,2,2
78171,5,2,274079,274079,274081,0,2,3
78172,4,3,274083,274083,274086,0,3,2
78173,4,2,274087,274087,274089,0,2,1
78174,2,1,274089,274089,274090,0,1,0
78175,3,2,274092,274092,274094,0,2,2
78176,2,1,274094,274094,274095,0,1,0
78177,1,1,274095,274095,274096,0,1,0
78178,3,1,274098,274098,274099,0,1,2
78179,4,1,274102,274102,274103,0,1,3
78180,4,2,274106,274106,274108,0,2,3
78181,1,3,274107,274108,274111,1,4,0
78182,2,2,274109,274111,274113,2,4,0
78183,6,3,274115,274115,274118,0,3,2
78184,2,3,274117,274118,274121,1,4,0
78185,3,3,274120,274121,274124,1,4,0
78186,4,3,274124,274124,274127,0,3,0
78187,4,1,274128,274128,274129,0,1,1
78188,6,1,274134,274134,274135,0,1,5
78189,2,2,274136,274136,274138,0,2,1
78190,2,3,274138,274138,274141,0,3,0
78191,1,2,274139,274141,274143,2,4,0
78192,5,3,274144,274144,274147,0,3,1
78193,6,2,274150,274150,274152,0,2,3
78194,3,3,274153,274153,274156,0,3,1
78195,6,3,274159,274159,274162,0,3,3
78196,3,1,274162,274162,274163,0,1,0
78197,6,1,274168,274168,274169,0,1,5
78198,4,2,274172,274172,274174,0,2,3
78199,3,2,274175,274175,274177,0,2,1
78200,4,2,274179,274179,274181,0,2,2
78201,3,1,274182,274182,274183,0,1,1
78202,1,1,274183,274183,274184,0,1,0
78203,5,2,274188,274188,274190,0,2,4
78204,2,3,274190,274190,274193,0,3,0
78205,4,3,274194,274194,274197,0,3,1
78206,2,2,274196,274197,274199,1,3,0
78207,1,3,274197,274199,274202,2,5,0
78208,2,3,274199,274202,274205,3,6,0
78209,5,1,274204,274205,274206,1,2,0
78210,1,1,274205,274206,274207,1,2,0
78211,4,2,274209,274209,274211,0,2,2
78212,5,3,274214,274214,274217,0,3,3
78213,5,1,274219,274219,274220,0,1,2
78214,2,3,274221,274221,274224,0,3,1
78215,3,3,274224,274224,274227,0,3,0
78216,3,3,274227,274227,274230,0,3,0
78217,2,1,274229,274230,274231,1,2,0
78218,3,2,274232,274232,274234,0,2,1
78219,6,3,274238,274238,274241,0,3,4
78220,3,2,274241,274241,274243,0,2,0
78221,1,1,274242,274243,274244,1,2,0
78222,4,2,274246,274246,274248,0,2,2
78223,6,2,274252,274252,274254,0,2,4
78224,4,1,274256,274256,274257,0,1,2
78225,6,3,274262,274262,274265,0,3,5
78226,6,2,274268,274268,274270,0,2,3
78227,4,3,274272,274272,274275,0,3,2
78228,2,1,274274,274275,274276,1,2,0
78229,6,1,274280,274280,274281,0,1,4
78230,2,2,274282,274282,274284,0,2,1
78231,1,3,274283,274284,274287,1,4,0
78232,6,3,274289,274289,274292,0,3,2
78233,5,1,274294,274294,274295,0,1,2
78234,4,1,274298,274298,274299,0,1,3
78235,3,1,274301,274301,274302,0,1,2
78236,5,1,274306,274306,274307,0,1,4
78237,3,3,274309,274309,274312,0,3,2
78238,6,1,274315,274315,274316,0,1,3
78239,6,2,274321,274321,274323,0,2,5
78240,5,3,274326,274326,274329,0,3,3
78241,2,1,274328,274329,274330,1,2,0
78242,1,3,274329,274330,274333,1,4,0
78243,6,2,274335,274335,274337,0,2,2
78244,4,1,274339,274339,274340,0,1,2
78245,3,2,274342,274342,274344,0,2,2
78246,3,1,274345,274345,274346,0,1,1
78247,4,1,274349,274349,274350,0,1,3
78248,3,1,274352,274352,274353,0,1,2
78249,3,2,274355,274355,274357,0,2,2
78250,3,1,274358,274358,274359,0,1,1
78251,4,1,274362,274362,274363,0,1,3
78252,3,3,274365,274365,274368,0,3,2
78253,2,3,274367,274368,274371,1,4,0
78254,3,2,274370,274371,274373,1,3,0
78255,1,3,274371,274373,274376,2,5,0
78256,2,1,274373,274376,274377,3,4,0
78257,5,2,274378,274378,274380,0,2,1
78258,6,2,274384,274384,274386,0,2,4
78259,4,1,274388,274388,274389,0,1,2
78260,2,3,274390,274390,274393,0,3,1
78261,2,3,274392,274393,274396,1,4,0
78262,6,1,274398,274398,274399,0,1,2
78263,2,2,274400,274400,274402,0,2,1
78264,2,3,274402,274402,274405,0,3,0
78265,4,3,274406,274406,274409,0,3,1
78266,2,3,274408,274409,274412,1,4,0
78267,2,1,274410,274412,274413,2,3,0
78268,4,2,274414,274414,274416,0,2,1
78269,2,1,274416,274416,274417,0,1,0
78270,4,2,274420,274420,274422,0,2,3
78271,4,2,274424,274424,274426,0,2,2
78272,4,1,274428,274428,274429,0,1,2
78273,3,1,274431,274431,274432,0,1,2
78274,1,3,274432,274432,274435,0,3,0
78275,3,3,274435,274435,274438,0,3,0
78276,6,3,274441,274441,274444,0,3,3
78277,5,2,274446,274446,274448,0,2,2
78278,4,1,274450,274450,274451,0,1,2
78279,3,1,274453,274453,274454,0,1,2
78280,5,3,274458,274458,274461,0,3,4
78281,6,3,274464,274464,274467,0,3,3
78282,1,1,274465,274467,274468,2,3,0
78283,2,1,274467,274468,274469,1,2,0
78284,3,1,274470,274470,274471,0,1,1
78285,1,2,274471,274471,274473,0,2,0
78286,1,2,274472,274473,274475,1,3,0
78287,6,1,274478,274478,274479,0,1,3
78288,1,1,274479,274479,274480,0,1,0
78289,3,1,274482,274482,274483,0,1,2
78290,2,1,274484,274484,274485,0,1,1
78291,6,2,274490,274490,274492,0,2,5
78292,2,2,274492,274492,274494,0,2,0
78293,3,1,274495,274495,274496,0,1,1
78294,5,3,274500,274500,274503,0,3,4
78295,1,3,274501,274503,274506,2,5,0
78296,5,2,274506,274506,274508,0,2,0
78297,1,1,274507,274508,274509,1,2,0
78298,6,1,274513,274513,274514,0,1,4
78299,2,3,274515,274515,274518,0,3,1
78300,2,3,274517,274518,274521,1,4,0
78301,3,3,274520,274521,274524,1,4,0
78302,4,3,274524,274524,274527,0,3,0
78303,1,2,274525,274527,274529,2,4,0
78304,4,1,274529,274529,274530,0,1,0
78305,1,3,274530,274530,274533,0,3,0
78306,3,2,274533,274533,274535,0,2,0
78307,1,2,274534,274535,274537,1,3,0
78308,6,2,274540,274540,274542,0,2,3
78309,1,1,274541,274542,274543,1,2,0
78310,4,3,274545,274545,274548,0,3,2
78311,4,2,274549,274549,274551,0,2,1
78312,2,2,274551,274551,274553,0,2,0
78313,3,3,274554,274554,274557,0,3,1
78314,4,3,274558,274558,274561,0,3,1
78315,5,2,274563,274563,274565,0,2,2
78316,3,3,274566,274566,274569,0,3,1
78317,1,3,274567,274569,274572,2,5,0
78318,4,1,274571,274572,274573,1,2,0
78319,1,1,274572,274573,274574,1,2,0
78320,5,3,274577,274577,274580,0,3,3
78321,1,3,274578,274580,274583,2,5,0
78322,3,3,274581,274583,274586,2,5,0
78323,2,3,274583,274586,274589,3,6,0
78324,3,2,274586,274589,274591,3,5,0
78325,3,1,274589,274591,274592,2,3,0
78326,5,3,274594,274594,274597,0,3,2
78327,1,3,274595,274597,274600,2,5,0
78328,6,2,274601,274601,274603,0,2,1
78329,4,1,274605,274605,274606,0,1,2
78330,1,1,274606,274606,274607,0,1,0
78331,1,1,274607,274607,274608,0,1,0
78332,4,3,274611,274611,274614,0,3,3
78333,5,1,274616,274616,274617,0,1,2
78334,4,2,274620,274620,274622,0,2,3
78335,1,1,274621,274622,274623,1,2,0
78336,4,3,274625,274625,274628,0,3,2
78337,1,2,274626,274628,274630,2,4,0
78338,1,1,274627,274630,274631,3,4,0
78339,2,3,274629,274631,274634,2,5,0
78340,2,3,274631,274634,274637,3,6,0
78341,6,2,274637,274637,274639,0,2,0
78342,4,2,274641,274641,274643,0,2,2
78343,2,2,274643,274643,274645,0,2,0
78344,2,2,274645,274645,274647,0,2,0
78345,1,2,274646,274647,274649,1,3,0
78346,5,3,274651,274651,274654,0,3,2
78347,1,3,274652,274654,274657,2,5,0
78348,5,3,274657,274657,274660,0,3,0
78349,4,1,274661,274661,274662,0,1,1
78350,6,2,274667,274667,274669,0,2,5
78351,1,1,274668,274669,274670,1,2,0
78352,4,1,274672,274672,274673,0,1,2
78353,1,2,274673,274673,274675,0,2,0
78354,6,2,274679,274679,274681,0,2,4
78355,1,3,274680,274681,274684,1,4,0
78356,5,2,274685,274685,274687,0,2,1
78357,5,3,274690,274690,274693,0,3,3
78358,3,2,274693,274693,274695,0,2,0
78359,3,3,274696,274696,274699,0,3,1
78360,1,2,274697,274699,274701,2,4,0
78361,3,2,274700,274701,274703,1,3,0
78362,5,3,274705,274705,274708,0,3,2
78363,1,3,274706,274708,274711,2,5,0
78364,1,1,274707,274711,274712,4,5,0
78365,4,1,274711,274712,274713,1,2,0
78366,3,3,274714,274714,274717,0,3,1
78367,5,3,274719,274719,274722,0,3,2
78368,5,2,274724,274724,274726,0,2,2
78369,1,2,274725,274726,274728,1,3,0
78370,3,2,274728,274728,274730,0,2,0
78371,4,3,274732,274732,274735,0,3,2
78372,6,2,274738,274738,274740,0,2,3
78373,4,2,274742,274742,274744,0,2,2
78374,3,2,274745,274745,274747,0,2,1
78375,3,3,274748,274748,274751,0,3,1
78376,4,3,274752,274752,274755,0,3,1
78377,5,1,274757,274757,274758,0,1,2
78378,1,2,274758,274758,274760,0,2,0
78379,5,3,274763,274763,274766,0,3,3
78380,6,1,274769,274769,274770,0,1,3
78381,4,3,274773,274773,274776,0,3,3
78382,6,3,274779,274779,274782,0,3,3
78383,2,2,274781,274782,274784,1,3,0
78384,6,3,274787,274787,274790,0,3,3
78385,5,1,274792,274792,274793,0,1,2
78386,3,3,274795,274795,274798,0,3,2
78387,4,3,274799,274799,274802,0,3,1
78388,4,3,274803,274803,274806,0,3,1
78389,2,1,274805,274806,274807,1,2,0
78390,6,2,274811,274811,274813,0,2,4
78391,1,3,274812,274813,274816,1,4,0
78392,4,2,274816,274816,274818,0,2,0
78393,5,1,274821,274821,274822,0,1,3
78394,1,2,274822,274822,274824,0,2,0
78395,6,1,274828,274828,274829,0,1,4
78396,2,2,274830,274830,274832,0,2,1
78397,3,3,274833,274833,274836,0,3,1
78398,3,1,274836,274836,274837,0,1,0
78399,5,2,274841,274841,274843,0,2,4
78400,4,1,274845,274845,274846,0,1,2
78401,2,2,274847,274847,274849,0,2,1
78402,1,2,274848,274849,274851,1,3,0
78403,1,2,274849,274851,274853,2,4,0
78404,4,2,274853,274853,274855,0,2,0
78405,1,2,274854,274855,274857,1,3,0
78406,6,1,274860,274860,274861,0,1,3
78407,3,2,274863,274863,274865,0,2,2
78408,4,1,274867,274867,274868,0,1,2
78409,1,2,274868,274868,274870,0,2,0
78410,2,2,274870,274870,274872,0,2,0
78411,3,1,274873,274873,274874,0,1,1
78412,4,1,274877,274877,274878,0,1,3
78413,5,2,274882,274882,274884,0,2,4
78414,5,2,274887,274887,274889,0,2,3
78415,4,2,274891,274891,274893,0,2,2
78416,4,1,274895,274895,274896,0,1,2
78417,1,1,274896,274896,274897,0,1,0
78418,2,3,274898,274898,274901,0,3,1
78419,2,1,274900,274901,274902,1,2,0
78420,5,1,274905,274905,274906,0,1,3
78421,6,3,274911,274911,274914,0,3,5
78422,1,2,274912,274914,274916,2,4,0
78423,6,1,274918,274918,274919,0,1,2
78424,1,2,274919,274919,274921,0,2,0
78425,2,3,274921,274921,274924,0,3,0
78426,2,3,274923,274924,274927,1,4,0
78427,1,1,274924,274927,274928,3,4,0
78428,3,2,274927,274928,274930,1,3,0
78429,6,1,274933,274933,274934,0,1,3
78430,3,1,274936,274936,274937,0,1,2
78431,2,2,274938,274938,274940,0,2,1
78432,6,2,274944,274944,274946,0,2,4
78433,3,1,274947,274947,274948,0,1,1
78434,6,2,274953,274953,274955,0,2,5
78435,3,3,274956,274956,274959,0,3,1
78436,5,3,274961,274961,274964,0,3,2
78437,4,2,274965,274965,274967,0,2,1
78438,3,2,274968,274968,274970,0,2,1
78439,6,3,274974,274974,274977,0,3,4
78440,2,3,274976,274977,274980,1,4,0
78441,2,3,274978,274980,274983,2,5,0
78442,5,1,274983,274983,274984,0,1,0
78443,6,1,274989,274989,274990,0,1,5
78444,4,3,274993,274993,274996,0,3,3
78445,2,2,274995,274996,274998,1,3,0
78446,1,3,274996,274998,275001,2,5,0
78447,3,3,274999,275001,275004,2,5,0
78448,2,1,275001,275004,275005,3,4,0
78449,6,3,275007,275007,275010,0,3,2
78450,6,2,275013,275013,275015,0,2,3
78451,1,3,275014,275015,275018,1,4,0
78452,3,3,275017,275018,275021,1,4,0
78453,5,1,275022,275022,275023,0,1,1
78454,5,3,275027,275027,275030,0,3,4
78455,2,1,275029,275030,275031,1,2,0
78456,5,3,275034,275034,275037,0,3,3
78457,1,1,275035,275037,275038,2,3,0
78458,3,2,275038,275038,275040,0,2,0
78459,3,2,275041,275041,275043,0,2,1
78460,4,3,275045,275045,275048,0,3,2
78461,5,2,275050,275050,275052,0,2,2
78462,3,2,275053,275053,275055,0,2,1
78463,6,2,275059,275059,275061,0,2,4
78464,6,3,275065,275065,275068,0,3,4
78465,3,3,275068,275068,275071,0,3,0
78466,4,2,275072,275072,275074,0,2,1
78467,6,1,275078,275078,275079,0,1,4
78468,1,2,275079,275079,275081,0,2,0
78469,3,3,275082,275082,275085,0,3,1
78470,1,1,275083,275085,275086,2,3,0
78471,3,1,275086,275086,275087,0,1,0
78472,5,2,275091,275091,275093,0,2,4
78473,4,2,275095,275095,275097,0,2,2
78474,3,3,275098,275098,275101,0,3,1
78475,3,2,275101,275101,275103,0,2,0
78476,1,3,275102,275103,275106,1,4,0
78477,3,2,275105,275106,275108,1,3,0
78478,4,1,275109,275109,275110,0,1,1
78479,1,3,275110,275110,275113,0,3,0
78480,3,3,275113,275113,275116,0,3,0
78481,4,1,275117,275117,275118,0,1,1
78482,3,1,275120,275120,275121,0,1,2
78483,4,2,275124,275124,275126,0,2,3
78484,5,1,275129,275129,275130,0,1,3
78485,4,3,275133,275133,275136,0,3,3
78486,2,1,275135,275136,275137,1,2,0
78487,1,3,275136,275137,275140,1,4,0
78488,4,1,275140,275140,275141,0,1,0
78489,5,2,275145,275145,275147,0,2,4
78490,1,1,275146,275147,275148,1,2,0
78491,4,2,275150,275150,275152,0,2,2
78492,3,1,275153,275153,275154,0,1,1
78493,2,3,275155,275155,275158,0,3,1
78494,6,1,275161,275161,275162,0,1,3
78495,2,1,275163,275163,275164,0,1,1
78496,3,1,275166,275166,275167,0,1,2
78497,4,2,275170,275170,275172,0,2,3
78498,3,1,275173,275173,275174,0,1,1
78499,2,2,275175,275175,275177,0,2,1
78500,6,3,275181,275181,275184,0,3,4
78501,4,3,275185,275185,275188,0,3,1
78502,2,2,275187,275188,275190,1,3,0
78503,3,2,275190,275190,275192,0,2,0
78504,3,2,275193,275193,275195,0,2,1
78505,1,1,275194,275195,275196,1,2,0
78506,3,3,275197,275197,275200,0,3,1
78507,6,2,275203,275203,275205,0,2,3
78508,2,3,275205,275205,275208,0,3,0
78509,2,1,275207,275208,275209,1,2,0
78510,3,3,275210,275210,275213,0,3,1
78511,3,2,275213,275213,275215,0,2,0
78512,4,2,275217,275217,275219,0,2,2
78513,3,1,275220,275220,275221,0,1,1
78514,4,1,275224,275224,275225,0,1,3
78515,2,1,275226,275226,275227,0,1,1
78516,4,2,275230,275230,275232,0,2,3
78517,3,1,275233,275233,275234,0,1,1
78518,2,1,275235,275235,275236,0,1,1
78519,4,1,275239,275239,275240,0,1,3
78520,1,3,275240,275240,275243,0,3,0
78521,6,3,275246,275246,275249,0,3,3
78522,5,3,275251,275251,275254,0,3,2
78523,3,2,275254,275254,275256,0,2,0
78524,5,3,275259,275259,275262,0,3,3
78525,1,3,275260,275262,275265,2,5,0
78526,6,2,275266,275266,275268,0,2,1
78527,3,2,275269,275269,275271,0,2,1
78528,4,1,275273,275273,275274,0,1,2
78529,2,1,275275,275275,275276,0,1,1
78530,4,2,275279,275279,275281,0,2,3
78531,1,3,275280,275281,275284,1,4,0
78532,6,2,275286,275286,275288,0,2,2
78533,5,2,275291,275291,275293,0,2,3
78534,2,1,275293,275293,275294,0,1,0
78535,2,3,275295,275295,275298,0,3,1
78536,6,2,275301,275301,275303,0,2,3
78537,6,1,275307,275307,275308,0,1,4
78538,4,2,275311,275311,275313,0,2,3
78539,3,2,275314,275314,275316,0,2,1
78540,1,1,275315,275316,275317,1,2,0
78541,1,1,275316,275317,275318,1,2,0
78542,6,2,275322,275322,275324,0,2,4
78543,1,2,275323,275324,275326,1,3,0
78544,6,1,275329,275329,275330,0,1,3
78545,6,2,275335,275335,275337,0,2,5
78546,6,2,275341,275341,275343,0,2,4
78547,6,2,275347,275347,275349,0,2,4
78548,1,1,275348,275349,275350,1,2,0
78549,6,3,275354,275354,275357,0,3,4
78550,3,2,275357,275357,275359,0,2,0
78551,1,3,275358,275359,275362,1,4,0
78552,4,2,275362,275362,275364,0,2,0
78553,6,3,275368,275368,275371,0,3,4
78554,1,2,275369,275371,275373,2,4,0
78555,1,2,275370,275373,275375,3,5,0
78556,3,1,275373,275375,275376,2,3,0
78557,4,1,275377,275377,275378,0,1,1
78558,3,3,275380,275380,275383,0,3,2
78559,5,1,275385,275385,275386,0,1,2
78560,4,3,275389,275389,275392,0,3,3
78561,1,2,275390,275392,275394,2,4,0
78562,6,1,275396,275396,275397,0,1,2
78563,6,2,275402,275402,275404,0,2,5
78564,1,1,275403,275404,275405,1,2,0
78565,6,1,275409,275409,275410,0,1,4
78566,2,3,275411,275411,275414,0,3,1
78567,3,2,275414,275414,275416,0,2,0
78568,2,2,275416,275416,275418,0,2,0
78569,6,3,275422,275422,275425,0,3,4
78570,3,3,275425,275425,275428,0,3,0
78571,6,2,275431,275431,275433,0,2,3
78572,5,3,275436,275436,275439,0,3,3
78573,5,3,275441,275441,275444,0,3,2
78574,2,3,275443,275444,275447,1,4,0
78575,3,2,275446,275447,275449,1,3,0
78576,1,1,275447,275449,275450,2,3,0
78577,1,2,275448,275450,275452,2,4,0
78578,2,3,275450,275452,275455,2,5,0
78579,2,2,275452,275455,275457,3,5,0
78580,2,1,275454,275457,275458,3,4,0
78581,6,2,275460,275460,275462,0,2,2
78582,4,1,275464,275464,275465,0,1,2
78583,6,2,275470,275470,275472,0,2,5
78584,2,2,275472,275472,275474,0,2,0
78585,6,2,275478,275478,275480,0,2,4
78586,4,2,275482,275482,275484,0,2,2
78587,3,2,275485,275485,275487,0,2,1
78588,3,1,275488,275488,275489,0,1,1
78589,6,2,275494,275494,275496,0,2,5
78590,2,2,275496,275496,275498,0,2,0
78591,5,3,275501,275501,275504,0,3,3
78592,5,1,275506,275506,275507,0,1,2
78593,3,3,275509,275509,275512,0,3,2
78594,4,3,275513,275513,275516,0,3,1
78595,3,1,275516,275516,275517,0,1,0
78596,3,1,275519,275519,275520,0,1,2
78597,5,3,275524,275524,275527,0,3,4
78598,4,1,275528,275528,275529,0,1,1
78599,3,1,275531,275531,275532,0,1,2
78600,5,1,275536,275536,275537,0,1,4
78601,6,2,275542,275542,275544,0,2,5
78602,6,2,275548,275548,275550,0,2,4
78603,6,3,275554,275554,275557,0,3,4
78604,5,1,275559,275559,275560,0,1,2
78605,4,1,275563,275563,275564,0,1,3
78606,2,3,275565,275565,275568,0,3,1
78607,5,2,275570,275570,275572,0,2,2
78608,6,1,275576,275576,275577,0,1,4
78609,1,3,275577,275577,275580,0,3,0
78610,2,3,275579,275580,275583,1,4,0
78611,4,2,275583,275583,275585,0,2,0
78612,1,2,275584,275585,275587,1,3,0
78613,3,2,275587,275587,275589,0,2,0
78614,6,1,275593,275593,275594,0,1,4
78615,6,1,275599,275599,275600,0,1,5
78616,6,3,275605,275605,275608,0,3,5
78617,2,1,275607,275608,275609,1,2,0
78618,3,1,275610,275610,275611,0,1,1
78619,3,2,275613,275613,275615,0,2,2
78620,4,1,275617,275617,275618,0,1,2
78621,4,1,275621,275621,275622,0,1,3
78622,2,3,275623,275623,275626,0,3,1
78623,5,2,275628,275628,275630,0,2,2
78624,5,2,275633,275633,275635,0,2,3
78625,3,3,275636,275636,275639,0,3,1
78626,1,1,275637,275639,275640,2,3,0
78627,1,2,275638,275640,275642,2,4,0
78628,1,2,275639,275642,275644,3,5,0
78629,3,3,275642,275644,275647,2,5,0
78630,3,3,275645,275647,275650,2,5,0
78631,5,2,275650,275650,275652,0,2,0
78632,5,3,275655,275655,275658,0,3,3
78633,1,1,275656,275658,275659,2,3,0
78634,4,3,275660,275660,275663,0,3,1
78635,1,1,275661,275663,275664,2,3,0
78636,3,2,275664,275664,275666,0,2,0
78637,4,2,275668,275668,275670,0,2,2
78638,2,1,275670,275670,275671,0,1,0
78639,1,2,275671,275671,275673,0,2,0
78640,6,2,275677,275677,275679,0,2,4
78641,2,1,275679,275679,275680,0,1,0
78642,1,3,275680,275680,275683,0,3,0
78643,4,1,275684,275684,275685,0,1,1
78644,2,3,275686,275686,275689,0,3,1
78645,3,2,275689,275689,275691,0,2,0
78646,4,3,275693,275693,275696,0,3,2
78647,2,3,275695,275696,275699,1,4,0
78648,6,1,275701,275701,275702,0,1,2
78649,2,2,275703,275703,275705,0,2,1
78650,1,3,275704,275705,275708,1,4,0
78651,2,2,275706,275708,275710,2,4,0
78652,3,2,275709,275710,275712,1,3,0
78653,5,2,275714,275714,275716,0,2,2
78654,3,2,275717,275717,275719,0,2,1
78655,2,2,275719,275719,275721,0,2,0
78656,1,2,275720,275721,275723,1,3,0
78657,6,1,275726,275726,275727,0,1,3
78658,3,2,275729,275729,275731,0,2,2
78659,2,3,275731,275731,275734,0,3,0
78660,2,1,275733,275734,275735,1,2,0
78661,5,2,275738,275738,275740,0,2,3
78662,5,1,275743,275743,275744,0,1,3
78663,3,2,275746,275746,275748,0,2,2
78664,5,1,275751,275751,275752,0,1,3
78665,1,3,275752,275752,275755,0,3,0
78666,3,2,275755,275755,275757,0,2,0
78667,1,2,275756,275757,275759,1,3,0
78668,5,1,275761,275761,275762,0,1,2
78669,1,2,275762,275762,275764,0,2,0
78670,3,3,275765,275765,275768,0,3,1
78671,6,3,275771,275771,275774,0,3,3
78672,1,1,275772,275774,275775,2,3,0
78673,2,3,275774,275775,275778,1,4,0
78674,1,3,275775,275778,275781,3,6,0
78675,5,1,275780,275781,275782,1,2,0
78676,1,2,275781,275782,275784,1,3,0
78677,6,2,275787,275787,275789,0,2,3
78678,5,1,275792,275792,275793,0,1,3
78679,3,1,275795,275795,275796,0,1,2
78680,5,3,275800,275800,275803,0,3,4
78681,6,2,275806,275806,275808,0,2,3
78682,3,3,275809,275809,275812,0,3,1
78683,1,2,275810,275812,275814,2,4,0
78684,3,2,275813,275814,275816,1,3,0
78685,4,3,275817,275817,275820,0,3,1
78686,3,3,275820,275820,275823,0,3,0
78687,4,1,275824,275824,275825,0,1,1
78688,4,1,275828,275828,275829,0,1,3
78689,2,2,275830,275830,275832,0,2,1
78690,5,1,275835,275835,275836,0,1,3
78691,4,3,275839,275839,275842,0,3,3
78692,3,2,275842,275842,275844,0,2,0
78693,1,2,275843,275844,275846,1,3,0
78694,5,3,275848,275848,275851,0,3,2
78695,5,3,275853,275853,275856,0,3,2
78696,1,3,275854,275856,275859,2,5,0
78697,2,3,275856,275859,275862,3,6,0
78698,1,3,275857,275862,275865,5,8,0
78699,5,2,275862,275865,275867,3,5,0
78700,1,3,275863,275867,275870,4,7,0
78701,3,3,275866,275870,275873,4,7,0
78702,2,1,275868,275873,275874,5,6,0
78703,1,3,275869,275874,275877,5,8,0
78704,4,1,275873,275877,275878,4,5,0
78705,4,2,275877,275878,275880,1,3,0
78706,2,3,275879,275880,275883,1,4,0
78707,1,3,275880,275883,275886,3,6,0
78708,2,3,275882,275886,275889,4,7,0
78709,4,2,275886,275889,275891,3,5,0
78710,3,2,275889,275891,275893,2,4,0
78711,2,2,275891,275893,275895,2,4,0
78712,3,1,275894,275895,275896,1,2,0
78713,4,2,275898,275898,275900,0,2,2
78714,2,1,275900,275900,275901,0,1,0
78715,2,1,275902,275902,275903,0,1,1
78716,6,2,275908,275908,275910,0,2,5
78717,1,3,275909,275910,275913,1,4,0
78718,1,3,275910,275913,275916,3,6,0
78719,4,1,275914,275916,275917,2,3,0
78720,1,3,275915,275917,275920,2,5,0
78721,1,2,275916,275920,275922,4,6,0
78722,3,2,275919,275922,275924,3,5,0
78723,1,1,275920,275924,275925,4,5,0
78724,4,1,275924,275925,275926,1,2,0
78725,2,1,275926,275926,275927,0,1,0
78726,6,3,275932,275932,275935,0,3,5
78727,2,3,275934,275935,275938,1,4,0
78728,6,3,275940,275940,275943,0,3,2
78729,1,3,275941,275943,275946,2,5,0
78730,4,3,275945,275946,275949,1,4,0
78731,6,3,275951,275951,275954,0,3,2
78732,1,1,275952,275954,275955,2,3,0
78733,6,2,275958,275958,275960,0,2,3
78734,4,3,275962,275962,275965,0,3,2
78735,2,3,275964,275965,275968,1,4,0
78736,5,1,275969,275969,275970,0,1,1
78737,6,1,275975,275975,275976,0,1,5
78738,5,1,275980,275980,275981,0,1,4
78739,3,3,275983,275983,275986,0,3,2
78740,6,1,275989,275989,275990,0,1,3
78741,3,2,275992,275992,275994,0,2,2
78742,4,2,275996,275996,275998,0,2,2
78743,3,1,275999,275999,276000,0,1,1
78744,3,3,276002,276002,276005,0,3,2
78745,2,1,276004,276005,276006,1,2,0
78746,5,2,276009,276009,276011,0,2,3
78747,2,3,276011,276011,276014,0,3,0
78748,1,3,276012,276014,276017,2,5,0
78749,4,3,276016,276017,276020,1,4,0
78750,6,2,276022,276022,276024,0,2,2
78751,5,3,276027,276027,276030,0,3,3
78752,2,1,276029,276030,276031,1,2,0
78753,3,2,276032,276032,276034,0,2,1
78754,1,1,276033,276034,276035,1,2,0
78755,3,1,276036,276036,276037,0,1,1
78756,2,2,276038,276038,276040,0,2,1
78757,2,1,276040,276040,276041,0,1,0
78758,5,1,276045,276045,276046,0,1,4
78759,1,2,276046,276046,276048,0,2,0
78760,5,3,276051,276051,276054,0,3,3
78761,6,2,276057,276057,276059,0,2,3
78762,1,2,276058,276059,276061,1,3,0
78763,6,2,276064,276064,276066,0,2,3
78764,2,1,276066,276066,276067,0,1,0
78765,2,1,276068,276068,276069,0,1,1
78766,6,1,276074,276074,276075,0,1,5
78767,5,1,276079,276079,276080,0,1,4
78768,5,3,276084,276084,276087,0,3,4
78769,2,1,276086,276087,276088,1,2,0
78770,2,3,276088,276088,276091,0,3,0
78771,4,1,276092,276092,276093,0,1,1
78772,6,1,276098,276098,276099,0,1,5
78773,6,1,276104,276104,276105,0,1,5
78774,4,2,276108,276108,276110,0,2,3
78775,2,2,276110,276110,276112,0,2,0
78776,1,1,276111,276112,276113,1,2,0
78777,2,3,276113,276113,276116,0,3,0
78778,4,3,276117,276117,276120,0,3,1
78779,5,3,276122,276122,276125,0,3,2
78780,3,3,276125,276125,276128,0,3,0
78781,5,3,276130,276130,276133,0,3,2
78782,2,1,276132,276133,276134,1,2,0
78783,4,1,276136,276136,276137,0,1,2
78784,5,3,276141,276141,276144,0,3,4
78785,3,3,276144,276144,276147,0,3,0
78786,3,1,276147,276147,276148,0,1,0
78787,2,1,276149,276149,276150,0,1,1
78788,5,3,276154,276154,276157,0,3,4
78789,6,1,276160,276160,276161,0,1,3
78790,3,3,276163,276163,276166,0,3,2
78791,5,1,276168,276168,276169,0,1,2
78792,2,1,276170,276170,276171,0,1,1
78793,2,3,276172,276172,276175,0,3,1
78794,5,3,276177,276177,276180,0,3,2
78795,3,3,276180,276180,276183,0,3,0
78796,4,3,276184,276184,276187,0,3,1
78797,1,2,276185,276187,276189,2,4,0
78798,1,3,276186,276189,276192,3,6,0
78799,2,1,276188,276192,276193,4,5,0
78800,2,2,276190,276193,276195,3,5,0
78801,1,3,276191,276195,276198,4,7,0
78802,1,3,276192,276198,276201,6,9,0
78803,5,3,276197,276201,276204,4,7,0
78804,1,2,276198,276204,276206,6,8,0
78805,2,3,276200,276206,276209,6,9,0
78806,3,2,276203,276209,276211,6,8,0
78807,3,1,276206,276211,276212,5,6,0
78808,6,2,276212,276212,276214,0,2,0
78809,4,2,276216,276216,276218,0,2,2
78810,4,3,276220,276220,276223,0,3,2
78811,3,3,276223,276223,276226,0,3,0
78812,6,3,276229,276229,276232,0,3,3
78813,5,2,276234,276234,276236,0,2,2
78814,5,1,276239,276239,276240,0,1,3
78815,6,2,276245,276245,276247,0,2,5
78816,4,1,276249,276249,276250,0,1,2
78817,5,1,276254,276254,276255,0,1,4
78818,5,2,276259,276259,276261,0,2,4
78819,3,1,276262,276262,276263,0,1,1
78820,2,3,276264,276264,276267,0,3,1
78821,4,2,276268,276268,276270,0,2,1
78822,2,1,276270,276270,276271,0,1,0
78823,5,3,276275,276275,276278,0,3,4
78824,6,1,276281,276281,276282,0,1,3
78825,3,2,276284,276284,276286,0,2,2
78826,5,1,276289,276289,276290,0,1,3
78827,1,2,276290,276290,276292,0,2,0
78828,3,3,276293,276293,276296,0,3,1
78829,6,1,276299,276299,276300,0,1,3
78830,2,2,276301,276301,276303,0,2,1
78831,3,3,276304,276304,276307,0,3,1
78832,4,3,276308,276308,276311,0,3,1
78833,3,3,276311,276311,276314,0,3,0
78834,1,1,276312,276314,276315,2,3,0
78835,3,1,276315,276315,276316,0,1,0
78836,4,3,276319,276319,276322,0,3,3
78837,4,3,276323,276323,276326,0,3,1
78838,4,2,276327,276327,276329,0,2,1
78839,5,3,276332,276332,276335,0,3,3
78840,6,3,276338,276338,276341,0,3,3
78841,3,2,276341,276341,276343,0,2,0
78842,2,2,276343,276343,276345,0,2,0
78843,1,1,276344,276345,276346,1,2,0
78844,5,2,276349,276349,276351,0,2,3
78845,3,2,276352,276352,276354,0,2,1
78846,2,2,276354,276354,276356,0,2,0
78847,5,1,276359,276359,276360,0,1,3
78848,5,3,276364,276364,276367,0,3,4
78849,2,1,276366,276367,276368,1,2,0
78850,6,3,276372,276372,276375,0,3,4
78851,6,1,276378,276378,276379,0,1,3
78852,6,1,276384,276384,276385,0,1,5
78853,5,1,276389,276389,276390,0,1,4
78854,3,3,276392,276392,276395,0,3,2
78855,1,1,276393,276395,276396,2,3,0
78856,5,1,276398,276398,276399,0,1,2
78857,1,1,276399,276399,276400,0,1,0
78858,5,2,276404,276404,276406,0,2,4
78859,4,2,276408,276408,276410,0,2,2
78860,4,3,276412,276412,276415,0,3,2
78861,6,3,276418,276418,276421,0,3,3
78862,1,3,276419,276421,276424,2,5,0
78863,1,1,276420,276424,276425,4,5,0
78864,3,1,276423,276425,276426,2,3,0
78865,6,3,276429,276429,276432,0,3,3
78866,5,3,276434,276434,276437,0,3,2
78867,4,2,276438,276438,276440,0,2,1
78868,2,3,276440,276440,276443,0,3,0
78869,4,1,276444,276444,276445,0,1,1
78870,1,2,276445,276445,276447,0,2,0
78871,3,3,276448,276448,276451,0,3,1
78872,3,1,276451,276451,276452,0,1,0
78873,1,1,276452,276452,276453,0,1,0
78874,4,3,276456,276456,276459,0,3,3
78875,2,3,276458,276459,276462,1,4,0
78876,5,1,276463,276463,276464,0,1,1
78877,6,1,276469,276469,276470,0,1,5
78878,2,2,276471,276471,276473,0,2,1
78879,3,1,276474,276474,276475,0,1,1
78880,5,1,276479,276479,276480,0,1,4
78881,1,1,276480,276480,276481,0,1,0
78882,1,2,276481,276481,276483,0,2,0
78883,5,3,276486,276486,276489,0,3,3
78884,6,1,276492,276492,276493,0,1,3
78885,2,3,276494,276494,276497,0,3,1
78886,4,2,276498,276498,276500,0,2,1
78887,4,1,276502,276502,276503,0,1,2
78888,2,3,276504,276504,276507,0,3,1
78889,4,3,276508,276508,276511,0,3,1
78890,1,2,276509,276511,276513,2,4,0
78891,4,3,276513,276513,276516,0,3,0
78892,6,3,276519,276519,276522,0,3,3
78893,3,1,276522,276522,276523,0,1,0
78894,2,2,276524,276524,276526,0,2,1
78895,2,2,276526,276526,276528,0,2,0
78896,4,1,276530,276530,276531,0,1,2
78897,2,1,276532,276532,276533,0,1,1
78898,1,1,276533,276533,276534,0,1,0
78899,3,1,276536,276536,276537,0,1,2
78900,4,1,276540,276540,276541,0,1,3
78901,3,2,276543,276543,276545,0,2,2
78902,4,2,276547,276547,276549,0,2,2
78903,1,3,276548,276549,276552,1,4,0
78904,3,3,276551,276552,276555,1,4,0
78905,2,1,276553,276555,276556,2,3,0
78906,2,1,276555,276556,276557,1,2,0
78907,6,2,276561,276561,276563,0,2,4
78908,5,2,276566,276566,276568,0,2,3
78909,5,2,276571,276571,276573,0,2,3
78910,4,3,276575,276575,276578,0,3,2
78911,6,2,276581,276581,276583,0,2,3
78912,3,3,276584,276584,276587,0,3,1
78913,6,2,276590,276590,276592,0,2,3
78914,3,3,276593,276593,276596,0,3,1
78915,5,2,276598,276598,276600,0,2,2
78916,6,1,276604,276604,276605,0,1,4
78917,4,1,276608,276608,276609,0,1,3
78918,3,3,276611,276611,276614,0,3,2
78919,3,3,276614,276614,276617,0,3,0
78920,5,3,276619,276619,276622,0,3,2
78921,1,2,276620,276622,276624,2,4,0
78922,5,1,276625,276625,276626,0,1,1
78923,6,2,276631,276631,276633,0,2,5
78924,6,3,276637,276637,276640,0,3,4
78925,2,1,276639,276640,276641,1,2,0
78926,4,3,276643,276643,276646,0,3,2
78927,3,1,276646,276646,276647,0,1,0
78928,3,2,276649,276649,276651,0,2,2
78929,4,2,276653,276653,276655,0,2,2
78930,5,1,276658,276658,276659,0,1,3
78931,2,2,276660,276660,276662,0,2,1
78932,6,2,276666,276666,276668,0,2,4
78933,6,3,276672,276672,276675,0,3,4
78934,1,2,276673,276675,276677,2,4,0
78935,1,1,276674,276677,276678,3,4,0
78936,2,2,276676,276678,276680,2,4,0
78937,3,3,276679,276680,276683,1,4,0
78938,1,1,276680,276683,276684,3,4,0
78939,3,3,276683,276684,276687,1,4,0
78940,6,2,276689,276689,276691,0,2,2
78941,3,3,276692,276692,276695,0,3,1
78942,5,2,276697,276697,276699,0,2,2
78943,5,2,276702,276702,276704,0,2,3
78944,5,3,276707,276707,276710,0,3,3
78945,4,2,276711,276711,276713,0,2,1
78946,3,2,276714,276714,276716,0,2,1
78947,6,3,276720,276720,276723,0,3,4
78948,6,2,276726,276726,276728,0,2,3
78949,1,2,276727,276728,276730,1,3,0
78950,2,3,276729,276730,276733,1,4,0
78951,1,1,276730,276733,276734,3,4,0
78952,2,2,276732,276734,276736,2,4,0
78953,2,1,276734,276736,276737,2,3,0
78954,1,2,276735,276737,276739,2,4,0
78955,1,2,276736,276739,276741,3,5,0
78956,1,2,276737,276741,276743,4,6,0
78957,1,1,276738,276743,276744,5,6,0
78958,5,3,276743,276744,276747,1,4,0
78959,2,3,276745,276747,276750,2,5,0
78960,6,3,276751,276751,276754,0,3,1
78961,4,3,276755,276755,276758,0,3,1
78962,2,1,276757,276758,276759,1,2,0
78963,3,1,276760,276760,276761,0,1,1
78964,6,1,276766,276766,276767,0,1,5
78965,5,2,276771,276771,276773,0,2,4
78966,5,2,276776,276776,276778,0,2,3
78967,5,2,276781,276781,276783,0,2,3
78968,5,1,276786,276786,276787,0,1,3
78969,1,3,276787,276787,276790,0,3,0
78970,4,3,276791,276791,276794,0,3,1
78971,3,3,276794,276794,276797,0,3,0
78972,3,3,276797,276797,276800,0,3,0
78973,3,1,276800,276800,276801,0,1,0
78974,3,3,276803,276803,276806,0,3,2
78975,3,1,276806,276806,276807,0,1,0
78976,3,1,276809,276809,276810,0,1,2
78977,3,3,276812,276812,276815,0,3,2
78978,6,1,276818,276818,276819,0,1,3
78979,4,2,276822,276822,276824,0,2,3
78980,2,1,276824,276824,276825,0,1,0
78981,2,1,276826,276826,276827,0,1,1
78982,3,3,276829,276829,276832,0,3,2
78983,6,3,276835,276835,276838,0,3,3
78984,3,3,276838,276838,276841,0,3,0
78985,2,2,276840,276841,276843,1,3,0
78986,4,3,276844,276844,276847,0,3,1
78987,1,1,276845,276847,276848,2,3,0
78988,4,1,276849,276849,276850,0,1,1
78989,3,2,276852,276852,276854,0,2,2
78990,5,1,276857,276857,276858,0,1,3
78991,5,1,276862,276862,276863,0,1,4
78992,4,1,276866,276866,276867,0,1,3
78993,6,2,276872,276872,276874,0,2,5
78994,5,1,276877,276877,276878,0,1,3
78995,5,1,276882,276882,276883,0,1,4
78996,6,1,276888,276888,276889,0,1,5
78997,2,1,276890,276890,276891,0,1,1
78998,4,1,276894,276894,276895,0,1,3
78999,6,2,276900,276900,276902,0,2,5
79000,4,2,276904,276904,276906,0,2,2
79001,4,2,276908,276908,276910,0,2,2
79002,3,1,276911,276911,276912,0,1,1
79003,1,1,276912,276912,276913,0,1,0
79004,5,3,276917,276917,276920,0,3,4
79005,4,1,276921,276921,276922,0,1,1
79006,5,2,276926,276926,276928,0,2,4
79007,1,1,276927,276928,276929,1,2,0
79008,2,1,276929,276929,276930,0,1,0
79009,4,2,276933,276933,276935,0,2,3
79010,5,1,276938,276938,276939,0,1,3
79011,6,1,276944,276944,276945,0,1,5
79012,1,3,276945,276945,276948,0,3,0
79013,5,2,276950,276950,276952,0,2,2
79014,1,1,276951,276952,276953,1,2,0
79015,5,1,276956,276956,276957,0,1,3
79016,1,3,276957,276957,276960,0,3,0
79017,4,2,276961,276961,276963,0,2,1
79018,1,1,276962,276963,276964,1,2,0
79019,5,3,276967,276967,276970,0,3,3
79020,1,3,276968,276970,276973,2,5,0
79021,4,1,276972,276973,276974,1,2,0
79022,2,2,276974,276974,276976,0,2,0
79023,6,2,276980,276980,276982,0,2,4
79024,1,2,276981,276982,276984,1,3,0
79025,5,2,276986,276986,276988,0,2,2
79026,6,1,276992,276992,276993,0,1,4
79027,2,2,276994,276994,276996,0,2,1
79028,1,2,276995,276996,276998,1,3,0
79029,5,2,277000,277000,277002,0,2,2
79030,1,2,277001,277002,277004,1,3,0
79031,3,1,277004,277004,277005,0,1,0
79032,1,2,277005,277005,277007,0,2,0
79033,5,3,277010,277010,277013,0,3,3
79034,5,3,277015,277015,277018,0,3,2
79035,4,2,277019,277019,277021,0,2,1
79036,1,3,277020,277021,277024,1,4,0
79037,1,3,277021,277024,277027,3,6,0
79038,2,2,277023,277027,277029,4,6,0
79039,6,3,277029,277029,277032,0,3,0
79040,1,1,277030,277032,277033,2,3,0
79041,2,3,277032,277033,277036,1,4,0
79042,6,2,277038,277038,277040,0,2,2
79043,3,3,277041,277041,277044,0,3,1
79044,4,3,277045,277045,277048,0,3,1
79045,4,1,277049,277049,277050,0,1,1
79046,5,1,277054,277054,277055,0,1,4
79047,5,1,277059,277059,277060,0,1,4
79048,4,3,277063,277063,277066,0,3,3
79049,3,3,277066,277066,277069,0,3,0
79050,4,2,277070,277070,277072,0,2,1
79051,2,3,277072,277072,277075,0,3,0
79052,4,3,277076,277076,277079,0,3,1
79053,3,3,277079,277079,277082,0,3,0
79054,3,2,277082,277082,277084,0,2,0
79055,3,3,277085,277085,277088,0,3,1
79056,5,3,277090,277090,277093,0,3,2
79057,5,1,277095,277095,277096,0,1,2
79058,3,3,277098,277098,277101,0,3,2
79059,6,1,277104,277104,277105,0,1,3
79060,6,2,277110,277110,277112,0,2,5
79061,1,2,277111,277112,277114,1,3,0
79062,3,1,277114,277114,277115,0,1,0
79063,3,3,277117,277117,277120,0,3,2
79064,4,2,277121,277121,277123,0,2,1
79065,4,3,277125,277125,277128,0,3,2
79066,6,3,277131,277131,277134,0,3,3
79067,3,3,277134,277134,277137,0,3,0
79068,4,2,277138,277138,277140,0,2,1
79069,1,1,277139,277140,277141,1,2,0
79070,5,2,277144,277144,277146,0,2,3
79071,1,1,277145,277146,277147,1,2,0
79072,1,3,277146,277147,277150,1,4,0
79073,3,1,277149,277150,277151,1,2,0
79074,4,3,277153,277153,277156,0,3,2
79075,1,1,277154,277156,277157,2,3,0
79076,3,2,277157,277157,277159,0,2,0
79077,1,1,277158,277159,277160,1,2,0
79078,6,1,277164,277164,277165,0,1,4
79079,5,3,277169,277169,277172,0,3,4
79080,5,2,277174,277174,277176,0,2,2
79081,1,2,277175,277176,277178,1,3,0
79082,5,1,277180,277180,277181,0,1,2
79083,3,2,277183,277183,277185,0,2,2
79084,5,3,277188,277188,277191,0,3,3
79085,1,2,277189,277191,277193,2,4,0
79086,3,1,277192,277193,277194,1,2,0
79087,5,2,277197,277197,277199,0,2,3
79088,4,3,277201,277201,277204,0,3,2
79089,2,2,277203,277204,277206,1,3,0
79090,5,2,277208,277208,277210,0,2,2
79091,1,1,277209,277210,277211,1,2,0
79092,2,3,277211,277211,277214,0,3,0
79093,2,2,277213,277214,277216,1,3,0
79094,5,1,277218,277218,277219,0,1,2
79095,6,2,277224,277224,277226,0,2,5
79096,3,3,277227,277227,277230,0,3,1
79097,4,3,277231,277231,277234,0,3,1
79098,3,1,277234,277234,277235,0,1,0
79099,6,3,277240,277240,277243,0,3,5
79100,4,2,277244,277244,277246,0,2,1
79101,6,2,277250,277250,277252,0,2,4
79102,5,1,277255,277255,277256,0,1,3
79103,2,2,277257,277257,277259,0,2,1
79104,1,2,277258,277259,277261,1,3,0
79105,3,2,277261,277261,277263,0,2,0
79106,5,1,277266,277266,277267,0,1,3
79107,5,3,277271,277271,277274,0,3,4
79108,2,1,277273,277274,277275,1,2,0
79109,5,3,277278,277278,277281,0,3,3
79110,2,1,277280,277281,277282,1,2,0
79111,2,1,277282,277282,277283,0,1,0
79112,1,1,277283,277283,277284,0,1,0
79113,4,3,277287,277287,277290,0,3,3
79114,2,3,277289,277290,277293,1,4,0
79115,5,3,277294,277294,277297,0,3,1
79116,6,3,277300,277300,277303,0,3,3
79117,2,3,277302,277303,277306,1,4,0
79118,1,3,277303,277306,277309,3,6,0
79119,2,3,277305,277309,277312,4,7,0
79120,1,1,277306,277312,277313,6,7,0
79121,1,3,277307,277313,277316,6,9,0
79122,1,2,277308,277316,277318,8,10,0
79123,3,3,277311,277318,277321,7,10,0
79124,3,2,277314,277321,277323,7,9,0
79125,4,2,277318,277323,277325,5,7,0
79126,3,2,277321,277325,277327,4,6,0
79127,6,1,277327,277327,277328,0,1,0
79128,2,2,277329,277329,277331,0,2,1
79129,1,3,277330,277331,277334,1,4,0
79130,5,3,277335,277335,277338,0,3,1
79131,1,3,277336,277338,277341,2,5,0
79132,4,1,277340,277341,277342,1,2,0
79133,3,1,277343,277343,277344,0,1,1
79134,2,3,277345,277345,277348,0,3,1
79135,5,1,277350,277350,277351,0,1,2
79136,5,2,277355,277355,277357,0,2,4
79137,6,2,277361,277361,277363,0,2,4
79138,2,1,277363,277363,277364,0,1,0
79139,5,2,277368,277368,277370,0,2,4
79140,1,2,277369,277370,277372,1,3,0
79141,2,1,277371,277372,277373,1,2,0
79142,4,2,277375,277375,277377,0,2,2
79143,1,3,277376,277377,277380,1,4,0
79144,4,3,277380,277380,277383,0,3,0
79145,6,3,277386,277386,277389,0,3,3
79146,4,3,277390,277390,277393,0,3,1
79147,3,3,277393,277393,277396,0,3,0
79148,3,3,277396,277396,277399,0,3,0
79149,6,3,277402,277402,277405,0,3,3
79150,5,1,277407,277407,277408,0,1,2
79151,5,3,277412,277412,277415,0,3,4
79152,6,2,277418,277418,277420,0,2,3
79153,3,3,277421,277421,277424,0,3,1
79154,6,2,277427,277427,277429,0,2,3
79155,3,2,277430,277430,277432,0,2,1
79156,4,2,277434,277434,277436,0,2,2
79157,6,1,277440,277440,277441,0,1,4
79158,4,2,277444,277444,277446,0,2,3
79159,1,3,277445,277446,277449,1,4,0
79160,1,1,277446,277449,277450,3,4,0
79161,1,1,277447,277450,277451,3,4,0
79162,1,2,277448,277451,277453,3,5,0
79163,1,2,277449,277453,277455,4,6,0
79164,4,2,277453,277455,277457,2,4,0
79165,5,2,277458,277458,277460,0,2,1
79166,1,2,277459,277460,277462,1,3,0
79167,3,2,277462,277462,277464,0,2,0
79168,1,1,277463,277464,277465,1,2,0
79169,4,3,277467,277467,277470,0,3,2
79170,2,1,277469,277470,277471,1,2,0
79171,6,2,277475,277475,277477,0,2,4
79172,5,2,277480,277480,277482,0,2,3
79173,4,2,277484,277484,277486,0,2,2
79174,4,3,277488,277488,277491,0,3,2
79175,1,1,277489,277491,277492,2,3,0
79176,3,2,277492,277492,277494,0,2,0
79177,2,1,277494,277494,277495,0,1,0
79178,6,2,277500,277500,277502,0,2,5
79179,3,3,277503,277503,277506,0,3,1
79180,4,1,277507,277507,277508,0,1,1
79181,2,2,277509,277509,277511,0,2,1
79182,3,1,277512,277512,277513,0,1,1
79183,5,3,277517,277517,277520,0,3,4
79184,1,3,277518,277520,277523,2,5,0
79185,3,3,277521,277523,277526,2,5,0
79186,4,1,277525,277526,277527,1,2,0
79187,1,3,277526,277527,277530,1,4,0
79188,6,3,277532,277532,277535,0,3,2
79189,3,2,277535,277535,277537,0,2,0
79190,1,2,277536,277537,277539,1,3,0
79191,5,1,277541,277541,277542,0,1,2
79192,4,2,277545,277545,277547,0,2,3
79193,1,1,277546,277547,277548,1,2,0
79194,3,1,277549,277549,277550,0,1,1
79195,4,1,277553,277553,277554,0,1,3
79196,1,2,277554,277554,277556,0,2,0
79197,1,2,277555,277556,277558,1,3,0
79198,4,3,277559,277559,277562,0,3,1
79199,1,2,277560,277562,277564,2,4,0
79200,5,3,277565,277565,277568,0,3,1
79201,1,2,277566,277568,277570,2,4,0
79202,3,1,277569,277570,277571,1,2,0
79203,4,2,277573,277573,277575,0,2,2
79204,2,3,277575,277575,277578,0,3,0
79205,1,1,277576,277578,277579,2,3,0
79206,4,1,277580,277580,277581,0,1,1
79207,5,3,277585,277585,277588,0,3,4
79208,4,1,277589,277589,277590,0,1,1
79209,4,1,277593,277593,277594,0,1,3
79210,6,3,277599,277599,277602,0,3,5
79211,6,2,277605,277605,277607,0,2,3
79212,5,1,277610,277610,277611,0,1,3
79213,1,3,277611,277611,277614,0,3,0
79214,3,3,277614,277614,277617,0,3,0
79215,3,2,277617,277617,277619,0,2,0
79216,5,1,277622,277622,277623,0,1,3
79217,3,1,277625,277625,277626,0,1,2
79218,5,1,277630,277630,277631,0,1,4
79219,6,2,277636,277636,277638,0,2,5
79220,1,3,277637,277638,277641,1,4,0
79221,2,3,277639,277641,277644,2,5,0
79222,3,1,277642,277644,277645,2,3,0
79223,5,3,277647,277647,277650,0,3,2
79224,5,2,277652,277652,277654,0,2,2
79225,4,2,277656,277656,277658,0,2,2
79226,4,3,277660,277660,277663,0,3,2
79227,5,2,277665,277665,277667,0,2,2
79228,3,3,277668,277668,277671,0,3,1
79229,3,2,277671,277671,277673,0,2,0
79230,4,2,277675,277675,277677,0,2,2
79231,1,1,277676,277677,277678,1,2,0
79232,4,3,277680,277680,277683,0,3,2
79233,6,1,277686,277686,277687,0,1,3
79234,5,3,277691,277691,277694,0,3,4
79235,2,1,277693,277694,277695,1,2,0
79236,5,2,277698,277698,277700,0,2,3
79237,2,1,277700,277700,277701,0,1,0
79238,2,2,277702,277702,277704,0,2,1
79239,2,2,277704,277704,277706,0,2,0
79240,1,2,277705,277706,277708,1,3,0
79241,4,2,277709,277709,277711,0,2,1
79242,2,3,277711,277711,277714,0,3,0
79243,4,2,277715,277715,277717,0,2,1
79244,4,2,277719,277719,277721,0,2,2
79245,1,3,277720,277721,277724,1,4,0
79246,6,1,277726,277726,277727,0,1,2
79247,1,3,277727,277727,277730,0,3,0
79248,4,1,277731,277731,277732,0,1,1
79249,2,1,277733,277733,277734,0,1,1
79250,2,2,277735,277735,277737,0,2,1
79251,3,3,277738,277738,277741,0,3,1
79252,2,1,277740,277741,277742,1,2,0
79253,3,2,277743,277743,277745,0,2,1
79254,1,2,277744,277745,277747,1,3,0
79255,5,2,277749,277749,277751,0,2,2
79256,3,2,277752,277752,277754,0,2,1
79257,6,3,277758,277758,277761,0,3,4
79258,4,3,277762,277762,277765,0,3,1
79259,2,3,277764,277765,277768,1,4,0
79260,1,2,277765,277768,277770,3,5,0
79261,3,2,277768,277770,277772,2,4,0
79262,5,2,277773,277773,277775,0,2,1
79263,5,2,277778,277778,277780,0,2,3
79264,6,2,277784,277784,277786,0,2,4
79265,6,1,277790,277790,277791,0,1,4
79266,4,1,277794,277794,277795,0,1,3
79267,4,2,277798,277798,277800,0,2,3
79268,6,1,277804,277804,277805,0,1,4
79269,4,3,277808,277808,277811,0,3,3
79270,5,3,277813,277813,277816,0,3,2
79271,4,3,277817,277817,277820,0,3,1
79272,1,1,277818,277820,277821,2,3,0
79273,5,2,277823,277823,277825,0,2,2
79274,4,1,277827,277827,277828,0,1,2
79275,3,3,277830,277830,277833,0,3,2
79276,1,3,277831,277833,277836,2,5,0
79277,1,2,277832,277836,277838,4,6,0
79278,4,1,277836,277838,277839,2,3,0
79279,6,2,277842,277842,277844,0,2,3
79280,1,2,277843,277844,277846,1,3,0
79281,4,1,277847,277847,277848,0,1,1
79282,1,1,277848,277848,277849,0,1,0
79283,5,2,277853,277853,277855,0,2,4
79284,1,1,277854,277855,277856,1,2,0
79285,5,2,277859,277859,277861,0,2,3
79286,5,1,277864,277864,277865,0,1,3
79287,1,3,277865,277865,277868,0,3,0
79288,6,3,277871,277871,277874,0,3,3
79289,6,3,277877,277877,277880,0,3,3
79290,4,3,277881,277881,277884,0,3,1
79291,1,2,277882,277884,277886,2,4,0
79292,2,1,277884,277886,277887,2,3,0
79293,5,1,277889,277889,277890,0,1,2
79294,5,1,277894,277894,277895,0,1,4
79295,3,2,277897,277897,277899,0,2,2
79296,6,2,277903,277903,277905,0,2,4
79297,1,1,277904,277905,277906,1,2,0
79298,6,3,277910,277910,277913,0,3,4
79299,1,3,277911,277913,277916,2,5,0
79300,1,2,277912,277916,277918,4,6,0
79301,5,1,277917,277918,277919,1,2,0
79302,3,2,277920,277920,277922,0,2,1
79303,6,2,277926,277926,277928,0,2,4
79304,4,3,277930,277930,277933,0,3,2
79305,6,2,277936,277936,277938,0,2,3
79306,5,2,277941,277941,277943,0,2,3
79307,3,1,277944,277944,277945,0,1,1
79308,2,3,277946,277946,277949,0,3,1
79309,1,1,277947,277949,277950,2,3,0
79310,5,1,277952,277952,277953,0,1,2
79311,5,1,277957,277957,277958,0,1,4
79312,1,1,277958,277958,277959,0,1,0
79313,5,3,277963,277963,277966,0,3,4
79314,6,2,277969,277969,277971,0,2,3
79315,5,2,277974,277974,277976,0,2,3
79316,6,2,277980,277980,277982,0,2,4
79317,5,1,277985,277985,277986,0,1,3
79318,6,1,277991,277991,277992,0,1,5
79319,6,2,277997,277997,277999,0,2,5
79320,4,3,278001,278001,278004,0,3,2
79321,3,1,278004,278004,278005,0,1,0
79322,1,3,278005,278005,278008,0,3,0
79323,4,2,278009,278009,278011,0,2,1
79324,1,1,278010,278011,278012,1,2,0
79325,6,2,278016,278016,278018,0,2,4
79326,3,3,278019,278019,278022,0,3,1
79327,3,2,278022,278022,278024,0,2,0
79328,6,1,278028,278028,278029,0,1,4
79329,1,2,278029,278029,278031,0,2,0
79330,6,2,278035,278035,278037,0,2,4
79331,3,2,278038,278038,278040,0,2,1
79332,5,2,278043,278043,278045,0,2,3
79333,3,1,278046,278046,278047,0,1,1
79334,2,1,278048,278048,278049,0,1,1
79335,4,1,278052,278052,278053,0,1,3
79336,2,2,278054,278054,278056,0,2,1
79337,2,3,278056,278056,278059,0,3,0
79338,6,3,278062,278062,278065,0,3,3
79339,6,3,278068,278068,278071,0,3,3
79340,5,2,278073,278073,278075,0,2,2
79341,3,3,278076,278076,278079,0,3,1
79342,1,3,278077,278079,278082,2,5,0
79343,2,3,278079,278082,278085,3,6,0
79344,2,1,278081,278085,278086,4,5,0
79345,2,3,278083,278086,278089,3,6,0
79346,2,2,278085,278089,278091,4,6,0
79347,5,3,278090,278091,278094,1,4,0
79348,1,3,278091,278094,278097,3,6,0
79349,6,2,278097,278097,278099,0,2,0
79350,3,3,278100,278100,278103,0,3,1
79351,6,3,278106,278106,278109,0,3,3
79352,6,1,278112,278112,278113,0,1,3
79353,4,2,278116,278116,278118,0,2,3
79354,5,2,278121,278121,278123,0,2,3
79355,1,1,278122,278123,278124,1,2,0
79356,4,2,278126,278126,278128,0,2,2
79357,4,1,278130,278130,278131,0,1,2
79358,2,3,278132,278132,278135,0,3,1
79359,3,3,278135,278135,278138,0,3,0
79360,2,1,278137,278138,278139,1,2,0
79361,5,1,278142,278142,278143,0,1,3
79362,2,1,278144,278144,278145,0,1,1
79363,6,2,278150,278150,278152,0,2,5
79364,5,3,278155,278155,278158,0,3,3
79365,2,3,278157,278158,278161,1,4,0
79366,3,1,278160,278161,278162,1,2,0
79367,3,3,278163,278163,278166,0,3,1
79368,4,3,278167,278167,278170,0,3,1
79369,3,2,278170,278170,278172,0,2,0
79370,5,3,278175,278175,278178,0,3,3
79371,3,3,278178,278178,278181,0,3,0
79372,4,2,278182,278182,278184,0,2,1
79373,1,1,278183,278184,278185,1,2,0
79374,5,1,278188,278188,278189,0,1,3
79375,1,1,278189,278189,278190,0,1,0
79376,6,3,278195,278195,278198,0,3,5
79377,2,2,278197,278198,278200,1,3,0
79378,2,1,278199,278200,278201,1,2,0
79379,6,2,278205,278205,278207,0,2,4
79380,2,1,278207,278207,278208,0,1,0
79381,6,3,278213,278213,278216,0,3,5
79382,6,2,278219,278219,278221,0,2,3
79383,5,3,278224,278224,278227,0,3,3
79384,5,2,278229,278229,278231,0,2,2
79385,2,1,278231,278231,278232,0,1,0
79386,3,1,278234,278234,278235,0,1,2
79387,3,1,278237,278237,278238,0,1,2
79388,1,1,278238,278238,278239,0,1,0
79389,6,2,278244,278244,278246,0,2,5
79390,2,3,278246,278246,278249,0,3,0
79391,6,2,278252,278252,278254,0,2,3
79392,4,2,278256,278256,278258,0,2,2
79393,5,2,278261,278261,278263,0,2,3
79394,3,1,278264,278264,278265,0,1,1
79395,1,1,278265,278265,278266,0,1,0
79396,3,2,278268,278268,278270,0,2,2
79397,1,1,278269,278270,278271,1,2,0
79398,4,2,278273,278273,278275,0,2,2
79399,1,3,278274,278275,278278,1,4,0
79400,5,2,278279,278279,278281,0,2,1
79401,2,1,278281,278281,278282,0,1,0
79402,5,3,278286,278286,278289,0,3,4
79403,3,1,278289,278289,278290,0,1,0
79404,1,3,278290,278290,278293,0,3,0
79405,4,1,278294,278294,278295,0,1,1
79406,5,3,278299,278299,278302,0,3,4
79407,5,1,278304,278304,278305,0,1,2
79408,2,1,278306,278306,278307,0,1,1
79409,4,3,278310,278310,278313,0,3,3
79410,5,2,278315,278315,278317,0,2,2
79411,6,1,278321,278321,278322,0,1,4
79412,2,3,278323,278323,278326,0,3,1
79413,2,3,278325,278326,278329,1,4,0
79414,2,1,278327,278329,278330,2,3,0
79415,1,2,278328,278330,278332,2,4,0
79416,4,1,278332,278332,278333,0,1,0
79417,5,3,278337,278337,278340,0,3,4
79418,4,3,278341,278341,278344,0,3,1
79419,4,1,278345,278345,278346,0,1,1
79420,5,2,278350,278350,278352,0,2,4
79421,5,1,278355,278355,278356,0,1,3
79422,4,1,278359,278359,278360,0,1,3
79423,6,1,278365,278365,278366,0,1,5
79424,4,3,278369,278369,278372,0,3,3
79425,3,3,278372,278372,278375,0,3,0
79426,5,1,278377,278377,278378,0,1,2
79427,3,3,278380,278380,278383,0,3,2
79428,5,2,278385,278385,278387,0,2,2
79429,6,3,278391,278391,278394,0,3,4
79430,1,2,278392,278394,278396,2,4,0
79431,2,1,278394,278396,278397,2,3,0
79432,1,3,278395,278397,278400,2,5,0
79433,1,3,278396,278400,278403,4,7,0
79434,3,2,278399,278403,278405,4,6,0
79435,6,2,278405,278405,278407,0,2,0
79436,5,1,278410,278410,278411,0,1,3
79437,5,1,278415,278415,278416,0,1,4
79438,5,2,278420,278420,278422,0,2,4
79439,3,1,278423,278423,278424,0,1,1
79440,5,1,278428,278428,278429,0,1,4
79441,5,3,278433,278433,278436,0,3,4
79442,1,3,278434,278436,278439,2,5,0
79443,5,1,278439,278439,278440,0,1,0
79444,4,1,278443,278443,278444,0,1,3
79445,5,2,278448,278448,278450,0,2,4
79446,2,2,278450,278450,278452,0,2,0
79447,2,1,278452,278452,278453,0,1,0
79448,3,1,278455,278455,278456,0,1,2
79449,4,1,278459,278459,278460,0,1,3
79450,2,1,278461,278461,278462,0,1,1
79451,2,2,278463,278463,278465,0,2,1
79452,1,2,278464,278465,278467,1,3,0
79453,4,2,278468,278468,278470,0,2,1
79454,4,2,278472,278472,278474,0,2,2
79455,4,2,278476,278476,278478,0,2,2
79456,5,2,278481,278481,278483,0,2,3
79457,5,2,278486,278486,278488,0,2,3
79458,1,3,278487,278488,278491,1,4,0
79459,2,1,278489,278491,278492,2,3,0
79460,3,2,278492,278492,278494,0,2,0
79461,2,1,278494,278494,278495,0,1,0
79462,3,3,278497,278497,278500,0,3,2
79463,5,2,278502,278502,278504,0,2,2
79464,1,3,278503,278504,278507,1,4,0
79465,4,3,278507,278507,278510,0,3,0
79466,5,1,278512,278512,278513,0,1,2
79467,6,3,278518,278518,278521,0,3,5
79468,6,2,278524,278524,278526,0,2,3
79469,4,2,278528,278528,278530,0,2,2
79470,1,2,278529,278530,278532,1,3,0
79471,4,1,278533,278533,278534,0,1,1
79472,3,1,278536,278536,278537,0,1,2
79473,3,3,278539,278539,278542,0,3,2
79474,5,3,278544,278544,278547,0,3,2
79475,2,3,278546,278547,278550,1,4,0
79476,6,2,278552,278552,278554,0,2,2
79477,3,1,278555,278555,278556,0,1,1
79478,3,2,278558,278558,278560,0,2,2
79479,2,2,278560,278560,278562,0,2,0
79480,3,3,278563,278563,278566,0,3,1
79481,5,3,278568,278568,278571,0,3,2
79482,2,1,278570,278571,278572,1,2,0
79483,5,1,278575,278575,278576,0,1,3
79484,4,2,278579,278579,278581,0,2,3
79485,2,3,278581,278581,278584,0,3,0
79486,4,2,278585,278585,278587,0,2,1
79487,1,3,278586,278587,278590,1,4,0
79488,3,3,278589,278590,278593,1,4,0
79489,4,1,278593,278593,278594,0,1,0
79490,6,1,278599,278599,278600,0,1,5
79491,1,3,278600,278600,278603,0,3,0
79492,3,1,278603,278603,278604,0,1,0
79493,3,3,278606,278606,278609,0,3,2
79494,6,1,278612,278612,278613,0,1,3
79495,5,3,278617,278617,278620,0,3,4
79496,5,1,278622,278622,278623,0,1,2
79497,2,2,278624,278624,278626,0,2,1
79498,3,1,278627,278627,278628,0,1,1
79499,2,2,278629,278629,278631,0,2,1
79500,4,3,278633,278633,278636,0,3,2
79501,3,1,278636,278636,278637,0,1,0
79502,2,3,278638,278638,278641,0,3,1
79503,1,3,278639,278641,278644,2,5,0
79504,6,3,278645,278645,278648,0,3,1
79505,5,3,278650,278650,278653,0,3,2
79506,1,3,278651,278653,278656,2,5,0
79507,2,3,278653,278656,278659,3,6,0
79508,2,2,278655,278659,278661,4,6,0
79509,4,1,278659,278661,278662,2,3,0
79510,3,2,278662,278662,278664,0,2,0
79511,5,2,278667,278667,278669,0,2,3
79512,2,2,278669,278669,278671,0,2,0
79513,3,1,278672,278672,278673,0,1,1
79514,2,1,278674,278674,278675,0,1,1
79515,1,2,278675,278675,278677,0,2,0
79516,2,2,278677,278677,278679,0,2,0
79517,6,1,278683,278683,278684,0,1,4
79518,3,1,278686,278686,278687,0,1,2
79519,2,1,278688,278688,278689,0,1,1
79520,5,3,278693,278693,278696,0,3,4
79521,6,1,278699,278699,278700,0,1,3
79522,5,3,278704,278704,278707,0,3,4
79523,1,1,278705,278707,278708,2,3,0
79524,5,1,278710,278710,278711,0,1,2
79525,6,1,278716,278716,278717,0,1,5
79526,1,1,278717,278717,278718,0,1,0
79527,6,1,278723,278723,278724,0,1,5
79528,5,2,278728,278728,278730,0,2,4
79529,2,1,278730,278730,278731,0,1,0
79530,4,3,278734,278734,278737,0,3,3
79531,6,3,278740,278740,278743,0,3,3
79532,4,3,278744,278744,278747,0,3,1
79533,3,1,278747,278747,278748,0,1,0
79534,4,3,278751,278751,278754,0,3,3
79535,3,3,278754,278754,278757,0,3,0
79536,3,1,278757,278757,278758,0,1,0
79537,5,3,278762,278762,278765,0,3,4
79538,3,3,278765,278765,278768,0,3,0
79539,3,1,278768,278768,278769,0,1,0
79540,1,1,278769,278769,278770,0,1,0
79541,4,2,278773,278773,278775,0,2,3
79542,1,2,278774,278775,278777,1,3,0
79543,1,3,278775,278777,278780,2,5,0
79544,4,2,278779,278780,278782,1,3,0
79545,3,3,278782,278782,278785,0,3,0
79546,3,2,278785,278785,278787,0,2,0
79547,2,2,278787,278787,278789,0,2,0
79548,1,2,278788,278789,278791,1,3,0
79549,3,2,278791,278791,278793,0,2,0
79550,5,2,278796,278796,278798,0,2,3
79551,4,3,278800,278800,278803,0,3,2
79552,4,1,278804,278804,278805,0,1,1
79553,1,1,278805,278805,278806,0,1,0
79554,3,1,278808,278808,278809,0,1,2
79555,6,1,278814,278814,278815,0,1,5
79556,5,2,278819,278819,278821,0,2,4
79557,3,3,278822,278822,278825,0,3,1
79558,6,3,278828,278828,278831,0,3,3
79559,5,3,278833,278833,278836,0,3,2
79560,1,2,278834,278836,278838,2,4,0
79561,6,3,278840,278840,278843,0,3,2
79562,4,2,278844,278844,278846,0,2,1
79563,3,2,278847,278847,278849,0,2,1
79564,5,2,278852,278852,278854,0,2,3
79565,5,1,278857,278857,278858,0,1,3
79566,3,3,278860,278860,278863,0,3,2
79567,3,2,278863,278863,278865,0,2,0
79568,2,1,278865,278865,278866,0,1,0
79569,3,3,278868,278868,278871,0,3,2
79570,1,1,278869,278871,278872,2,3,0
79571,5,3,278874,278874,278877,0,3,2
79572,5,2,278879,278879,278881,0,2,2
79573,5,2,278884,278884,278886,0,2,3
79574,6,3,278890,278890,278893,0,3,4
79575,1,3,278891,278893,278896,2,5,0
79576,2,3,278893,278896,278899,3,6,0
79577,3,2,278896,278899,278901,3,5,0
79578,4,3,278900,278901,278904,1,4,0
79579,6,1,278906,278906,278907,0,1,2
79580,2,2,278908,278908,278910,0,2,1
79581,6,2,278914,278914,278916,0,2,4
79582,6,3,278920,278920,278923,0,3,4
79583,3,1,278923,278923,278924,0,1,0
79584,3,3,278926,278926,278929,0,3,2
79585,3,3,278929,278929,278932,0,3,0
79586,3,1,278932,278932,278933,0,1,0
79587,3,3,278935,278935,278938,0,3,2
79588,4,1,278939,278939,278940,0,1,1
79589,3,2,278942,278942,278944,0,2,2
79590,3,3,278945,278945,278948,0,3,1
79591,2,1,278947,278948,278949,1,2,0
79592,1,2,278948,278949,278951,1,3,0
79593,1,1,278949,278951,278952,2,3,0
79594,6,3,278955,278955,278958,0,3,3
79595,5,1,278960,278960,278961,0,1,2
79596,1,3,278961,278961,278964,0,3,0
79597,6,3,278967,278967,278970,0,3,3
79598,5,1,278972,278972,278973,0,1,2
79599,2,1,278974,278974,278975,0,1,1
79600,4,1,278978,278978,278979,0,1,3
79601,4,1,278982,278982,278983,0,1,3
79602,2,2,278984,278984,278986,0,2,1
79603,5,2,278989,278989,278991,0,2,3
79604,2,1,278991,278991,278992,0,1,0
79605,3,1,278994,278994,278995,0,1,2
79606,3,2,278997,278997,278999,0,2,2
79607,4,1,279001,279001,279002,0,1,2
79608,4,1,279005,279005,279006,0,1,3
79609,5,2,279010,279010,279012,0,2,4
79610,3,3,279013,279013,279016,0,3,1
79611,3,2,279016,279016,279018,0,2,0
79612,5,3,279021,279021,279024,0,3,3
79613,2,1,279023,279024,279025,1,2,0
79614,1,1,279024,279025,279026,1,2,0
79615,5,2,279029,279029,279031,0,2,3
79616,2,2,279031,279031,279033,0,2,0
79617,2,1,279033,279033,279034,0,1,0
79618,4,2,279037,279037,279039,0,2,3
79619,6,1,279043,279043,279044,0,1,4
79620,3,1,279046,279046,279047,0,1,2
79621,3,1,279049,279049,279050,0,1,2
79622,1,1,279050,279050,279051,0,1,0
79623,4,2,279054,279054,279056,0,2,3
79624,1,2,279055,279056,279058,1,3,0
79625,2,3,279057,279058,279061,1,4,0
79626,1,1,279058,279061,279062,3,4,0
79627,4,2,279062,279062,279064,0,2,0
79628,6,2,279068,279068,279070,0,2,4
79629,1,3,279069,279070,279073,1,4,0
79630,6,3,279075,279075,279078,0,3,2
79631,3,2,279078,279078,279080,0,2,0
79632,5,1,279083,279083,279084,0,1,3
79633,2,2,279085,279085,279087,0,2,1
79634,1,3,279086,279087,279090,1,4,0
79635,6,3,279092,279092,279095,0,3,2
79636,3,1,279095,279095,279096,0,1,0
79637,2,2,279097,279097,279099,0,2,1
79638,2,2,279099,279099,279101,0,2,0
79639,5,1,279104,279104,279105,0,1,3
79640,4,1,279108,279108,279109,0,1,3
79641,3,2,279111,279111,279113,0,2,2
79642,1,3,279112,279113,279116,1,4,0
79643,2,1,279114,279116,279117,2,3,0
79644,2,3,279116,279117,279120,1,4,0
79645,5,3,279121,279121,279124,0,3,1
79646,1,3,279122,279124,279127,2,5,0
79647,1,2,279123,279127,279129,4,6,0
79648,1,2,279124,279129,279131,5,7,0
79649,5,3,279129,279131,279134,2,5,0
79650,4,3,279133,279134,279137,1,4,0
79651,2,2,279135,279137,279139,2,4,0
79652,2,3,279137,279139,279142,2,5,0
79653,3,3,279140,279142,279145,2,5,0
79654,1,1,279141,279145,279146,4,5,0
79655,1,1,279142,279146,279147,4,5,0
79656,1,2,279143,279147,279149,4,6,0
79657,1,1,279144,279149,279150,5,6,0
79658,5,3,279149,279150,279153,1,4,0
79659,4,2,279153,279153,279155,0,2,0
79660,6,2,279159,279159,279161,0,2,4
79661,5,1,279164,279164,279165,0,1,3
79662,4,3,279168,279168,279171,0,3,3
79663,1,2,279169,279171,279173,2,4,0
79664,6,2,279175,279175,279177,0,2,2
79665,6,1,279181,279181,279182,0,1,4
79666,5,3,279186,279186,279189,0,3,4
79667,5,1,279191,279191,279192,0,1,2
79668,4,3,279195,279195,279198,0,3,3
79669,4,2,279199,279199,279201,0,2,1
79670,4,3,279203,279203,279206,0,3,2
79671,3,3,279206,279206,279209,0,3,0
79672,1,1,279207,279209,279210,2,3,0
79673,2,2,279209,279210,279212,1,3,0
79674,4,2,279213,279213,279215,0,2,1
79675,5,2,279218,279218,279220,0,2,3
79676,4,1,279222,279222,279223,0,1,2
79677,6,3,279228,279228,279231,0,3,5
79678,3,1,279231,279231,279232,0,1,0
79679,1,2,279232,279232,279234,0,2,0
79680,6,2,279238,279238,279240,0,2,4
79681,3,3,279241,279241,279244,0,3,1
79682,4,3,279245,279245,279248,0,3,1
79683,6,2,279251,279251,279253,0,2,3
79684,3,2,279254,279254,279256,0,2,1
79685,5,2,279259,279259,279261,0,2,3
79686,2,3,279261,279261,279264,0,3,0
79687,6,3,279267,279267,279270,0,3,3
79688,6,2,279273,279273,279275,0,2,3
79689,1,2,279274,279275,279277,1,3,0
79690,4,2,279278,279278,279280,0,2,1
79691,6,3,279284,279284,279287,0,3,4
79692,6,3,279290,279290,279293,0,3,3
79693,4,3,279294,279294,279297,0,3,1
79694,2,3,279296,279297,279300,1,4,0
79695,6,1,279302,279302,279303,0,1,2
79696,1,1,279303,279303,279304,0,1,0
79697,3,3,279306,279306,279309,0,3,2
79698,6,2,279312,279312,279314,0,2,3
79699,3,1,279315,279315,279316,0,1,1
79700,3,2,279318,279318,279320,0,2,2
79701,5,3,279323,279323,279326,0,3,3
79702,6,1,279329,279329,279330,0,1,3
79703,3,3,279332,279332,279335,0,3,2
79704,3,3,279335,279335,279338,0,3,0
79705,1,3,279336,279338,279341,2,5,0
79706,4,1,279340,279341,279342,1,2,0
79707,1,2,279341,279342,279344,1,3,0
79708,4,3,279345,279345,279348,0,3,1
79709,6,1,279351,279351,279352,0,1,3
79710,5,2,279356,279356,279358,0,2,4
79711,3,2,279359,279359,279361,0,2,1
79712,3,1,279362,279362,279363,0,1,1
79713,6,2,279368,279368,279370,0,2,5
79714,5,3,279373,279373,279376,0,3,3
79715,6,2,279379,279379,279381,0,2,3
79716,2,1,279381,279381,279382,0,1,0
79717,2,2,279383,279383,279385,0,2,1
79718,2,2,279385,279385,279387,0,2,0
79719,1,1,279386,279387,279388,1,2,0
79720,3,2,279389,279389,279391,0,2,1
79721,3,2,279392,279392,279394,0,2,1
79722,2,3,279394,279394,279397,0,3,0
79723,3,3,279397,279397,279400,0,3,0
79724,1,2,279398,279400,279402,2,4,0
79725,1,2,279399,279402,279404,3,5,0
79726,6,2,279405,279405,279407,0,2,1
79727,1,3,279406,279407,279410,1,4,0
79728,2,3,279408,279410,279413,2,5,0
79729,5,3,279413,279413,279416,0,3,0
79730,2,3,279415,279416,279419,1,4,0
79731,3,3,279418,279419,279422,1,4,0
79732,2,1,279420,279422,279423,2,3,0
79733,4,2,279424,279424,279426,0,2,1
79734,1,2,279425,279426,279428,1,3,0
79735,4,2,279429,279429,279431,0,2,1
79736,5,2,279434,279434,279436,0,2,3
79737,5,1,279439,279439,279440,0,1,3
79738,6,1,279445,279445,279446,0,1,5
79739,4,3,279449,279449,279452,0,3,3
79740,1,3,279450,279452,279455,2,5,0
79741,5,3,279455,279455,279458,0,3,0
79742,5,3,279460,279460,279463,0,3,2
79743,4,2,279464,279464,279466,0,2,1
79744,2,1,279466,279466,279467,0,1,0
79745,6,1,279472,279472,279473,0,1,5
79746,3,2,279475,279475,279477,0,2,2
79747,1,2,279476,279477,279479,1,3,0
79748,3,1,279479,279479,279480,0,1,0
79749,3,3,279482,279482,279485,0,3,2
79750,4,2,279486,279486,279488,0,2,1
79751,2,1,279488,279488,279489,0,1,0
79752,6,3,279494,279494,279497,0,3,5
79753,4,3,279498,279498,279501,0,3,1
79754,3,1,279501,279501,279502,0,1,0
79755,3,1,279504,279504,279505,0,1,2
79756,2,3,279506,279506,279509,0,3,1
79757,2,3,279508,279509,279512,1,4,0
79758,4,1,279512,279512,279513,0,1,0
79759,6,3,279518,279518,279521,0,3,5
79760,2,2,279520,279521,279523,1,3,0
79761,6,2,279526,279526,279528,0,2,3
79762,3,2,279529,279529,279531,0,2,1
79763,2,3,279531,279531,279534,0,3,0
79764,1,2,279532,279534,279536,2,4,0
79765,4,2,279536,279536,279538,0,2,0
79766,2,3,279538,279538,279541,0,3,0
79767,5,2,279543,279543,279545,0,2,2
79768,1,3,279544,279545,279548,1,4,0
79769,3,1,279547,279548,279549,1,2,0
79770,4,3,279551,279551,279554,0,3,2
79771,5,2,279556,279556,279558,0,2,2
79772,2,1,279558,279558,279559,0,1,0
79773,4,2,279562,279562,279564,0,2,3
79774,4,3,279566,279566,279569,0,3,2
79775,4,3,279570,279570,279573,0,3,1
79776,1,1,279571,279573,279574,2,3,0
79777,4,3,279575,279575,279578,0,3,1
79778,6,1,279581,279581,279582,0,1,3
79779,3,2,279584,279584,279586,0,2,2
79780,2,3,279586,279586,279589,0,3,0
79781,1,1,279587,279589,279590,2,3,0
79782,2,2,279589,279590,279592,1,3,0
79783,3,3,279592,279592,279595,0,3,0
79784,1,2,279593,279595,279597,2,4,0
79785,6,1,279599,279599,279600,0,1,2
79786,5,2,279604,279604,279606,0,2,4
79787,2,1,279606,279606,279607,0,1,0
79788,5,1,279611,279611,279612,0,1,4
79789,2,3,279613,279613,279616,0,3,1
79790,5,2,279618,279618,279620,0,2,2
79791,1,2,279619,279620,279622,1,3,0
79792,1,1,279620,279622,279623,2,3,0
79793,2,2,279622,279623,279625,1,3,0
79794,1,3,279623,279625,279628,2,5,0
79795,3,3,279626,279628,279631,2,5,0
79796,5,3,279631,279631,279634,0,3,0
79797,4,2,279635,279635,279637,0,2,1
79798,2,2,279637,279637,279639,0,2,0
79799,4,1,279641,279641,279642,0,1,2
79800,3,1,279644,279644,279645,0,1,2
79801,3,2,279647,279647,279649,0,2,2
79802,5,3,279652,279652,279655,0,3,3
79803,3,3,279655,279655,279658,0,3,0
79804,3,3,279658,279658,279661,0,3,0
79805,4,2,279662,279662,279664,0,2,1
79806,1,2,279663,279664,279666,1,3,0
79807,2,3,279665,279666,279669,1,4,0
79808,2,2,279667,279669,279671,2,4,0
79809,6,3,279673,279673,279676,0,3,2
79810,3,2,279676,279676,279678,0,2,0
79811,6,1,279682,279682,279683,0,1,4
79812,1,3,279683,279683,279686,0,3,0
79813,5,2,279688,279688,279690,0,2,2
79814,4,2,279692,279692,279694,0,2,2
79815,5,2,279697,279697,279699,0,2,3
79816,2,2,279699,279699,279701,0,2,0
79817,2,1,279701,279701,279702,0,1,0
79818,3,2,279704,279704,279706,0,2,2
79819,3,3,279707,279707,279710,0,3,1
79820,1,1,279708,279710,279711,2,3,0
79821,4,1,279712,279712,279713,0,1,1
79822,5,2,279717,279717,279719,0,2,4
79823,3,3,279720,279720,279723,0,3,1
79824,5,3,279725,279725,279728,0,3,2
79825,2,3,279727,279728,279731,1,4,0
79826,5,1,279732,279732,279733,0,1,1
79827,1,1,279733,279733,279734,0,1,0
79828,4,3,279737,279737,279740,0,3,3
79829,1,2,279738,279740,279742,2,4,0
79830,2,2,279740,279742,279744,2,4,0
79831,2,2,279742,279744,279746,2,4,0
79832,4,1,279746,279746,279747,0,1,0
79833,5,2,279751,279751,279753,0,2,4
79834,1,2,279752,279753,279755,1,3,0
79835,1,2,279753,279755,279757,2,4,0
79836,5,3,279758,279758,279761,0,3,1
79837,3,3,279761,279761,279764,0,3,0
79838,4,1,279765,279765,279766,0,1,1
79839,3,3,279768,279768,279771,0,3,2
79840,1,1,279769,279771,279772,2,3,0
79841,4,1,279773,279773,279774,0,1,1
79842,1,1,279774,279774,279775,0,1,0
79843,3,3,279777,279777,279780,0,3,2
79844,1,2,279778,279780,279782,2,4,0
79845,3,1,279781,279782,279783,1,2,0
79846,2,1,279783,279783,279784,0,1,0
79847,4,3,279787,279787,279790,0,3,3
79848,3,2,279790,279790,279792,0,2,0
79849,2,2,279792,279792,279794,0,2,0
79850,6,1,279798,279798,279799,0,1,4
79851,4,3,279802,279802,279805,0,3,3
79852,6,3,279808,279808,279811,0,3,3
79853,3,1,279811,279811,279812,0,1,0
79854,1,2,279812,279812,279814,0,2,0
79855,4,2,279816,279816,279818,0,2,2
79856,4,2,279820,279820,279822,0,2,2
79857,4,3,279824,279824,279827,0,3,2
79858,3,2,279827,279827,279829,0,2,0
79859,1,2,279828,279829,279831,1,3,0
79860,3,1,279831,279831,279832,0,1,0
79861,6,3,279837,279837,279840,0,3,5
79862,5,1,279842,279842,279843,0,1,2
79863,6,3,279848,279848,279851,0,3,5
79864,2,1,279850,279851,279852,1,2,0
79865,2,1,279852,279852,279853,0,1,0
79866,1,3,279853,279853,279856,0,3,0
79867,1,2,279854,279856,279858,2,4,0
79868,2,1,279856,279858,279859,2,3,0
79869,6,3,279862,279862,279865,0,3,3
79870,4,2,279866,279866,279868,0,2,1
79871,6,1,279872,279872,279873,0,1,4
79872,2,2,279874,279874,279876,0,2,1
79873,2,2,279876,279876,279878,0,2,0
79874,5,1,279881,279881,279882,0,1,3
79875,5,2,279886,279886,279888,0,2,4
79876,4,1,279890,279890,279891,0,1,2
79877,1,1,279891,279891,279892,0,1,0
79878,3,3,279894,279894,279897,0,3,2
79879,6,1,279900,279900,279901,0,1,3
79880,4,1,279904,279904,279905,0,1,3
79881,5,3,279909,279909,279912,0,3,4
79882,6,3,279915,279915,279918,0,3,3
79883,1,1,279916,279918,279919,2,3,0
79884,3,3,279919,279919,279922,0,3,0
79885,4,3,279923,279923,279926,0,3,1
79886,2,1,279925,279926,279927,1,2,0
79887,4,3,279929,279929,279932,0,3,2
79888,4,3,279933,279933,279936,0,3,1
79889,2,2,279935,279936,279938,1,3,0
79890,6,3,279941,279941,279944,0,3,3
79891,5,2,279946,279946,279948,0,2,2
79892,2,2,279948,279948,279950,0,2,0
79893,4,1,279952,279952,279953,0,1,2
79894,1,1,279953,279953,279954,0,1,0
79895,4,3,279957,279957,279960,0,3,3
79896,4,3,279961,279961,279964,0,3,1
79897,4,1,279965,279965,279966,0,1,1
79898,6,3,279971,279971,279974,0,3,5
79899,6,3,279977,279977,279980,0,3,3
79900,1,3,279978,279980,279983,2,5,0
79901,4,3,279982,279983,279986,1,4,0
79902,2,3,279984,279986,279989,2,5,0
79903,3,1,279987,279989,279990,2,3,0
79904,5,1,279992,279992,279993,0,1,2
79905,2,1,279994,279994,279995,0,1,1
79906,2,3,279996,279996,279999,0,3,1
79907,5,3,280001,280001,280004,0,3,2
79908,2,1,280003,280004,280005,1,2,0
79909,5,2,280008,280008,280010,0,2,3
79910,2,1,280010,280010,280011,0,1,0
79911,3,1,280013,280013,280014,0,1,2
79912,5,3,280018,280018,280021,0,3,4
79913,1,1,280019,280021,280022,2,3,0
79914,4,3,280023,280023,280026,0,3,1
79915,3,3,280026,280026,280029,0,3,0
79916,1,1,280027,280029,280030,2,3,0
79917,2,1,280029,280030,280031,1,2,0
79918,2,1,280031,280031,280032,0,1,0
79919,5,2,280036,280036,280038,0,2,4
79920,4,2,280040,280040,280042,0,2,2
79921,3,2,280043,280043,280045,0,2,1
79922,2,1,280045,280045,280046,0,1,0
79923,1,1,280046,280046,280047,0,1,0
79924,2,3,280048,280048,280051,0,3,1
79925,4,1,280052,280052,280053,0,1,1
79926,1,3,280053,280053,280056,0,3,0
79927,6,2,280059,280059,280061,0,2,3
79928,2,1,280061,280061,280062,0,1,0
79929,3,1,280064,280064,280065,0,1,2
79930,6,2,280070,280070,280072,0,2,5
79931,2,1,280072,280072,280073,0,1,0
79932,3,3,280075,280075,280078,0,3,2
79933,4,2,280079,280079,280081,0,2,1
79934,2,1,280081,280081,280082,0,1,0
79935,4,3,280085,280085,280088,0,3,3
79936,2,2,280087,280088,280090,1,3,0
79937,5,2,280092,280092,280094,0,2,2
79938,2,2,280094,280094,280096,0,2,0
79939,3,3,280097,280097,280100,0,3,1
79940,4,1,280101,280101,280102,0,1,1
79941,4,3,280105,280105,280108,0,3,3
79942,3,3,280108,280108,280111,0,3,0
79943,6,3,280114,280114,280117,0,3,3
79944,3,1,280117,280117,280118,0,1,0
79945,2,3,280119,280119,280122,0,3,1
79946,4,1,280123,280123,280124,0,1,1
79947,3,2,280126,280126,280128,0,2,2
79948,1,2,280127,280128,280130,1,3,0
79949,4,1,280131,280131,280132,0,1,1
79950,1,1,280132,280132,280133,0,1,0
79951,2,1,280134,280134,280135,0,1,1
79952,6,2,280140,280140,280142,0,2,5
79953,4,3,280144,280144,280147,0,3,2
79954,4,1,280148,280148,280149,0,1,1
79955,6,2,280154,280154,280156,0,2,5
79956,4,2,280158,280158,280160,0,2,2
79957,1,3,280159,280160,280163,1,4,0
79958,5,3,280164,280164,280167,0,3,1
79959,6,1,280170,280170,280171,0,1,3
79960,2,2,280172,280172,280174,0,2,1
79961,3,1,280175,280175,280176,0,1,1
79962,2,3,280177,280177,280180,0,3,1
79963,2,1,280179,280180,280181,1,2,0
79964,1,2,280180,280181,280183,1,3,0
79965,4,1,280184,280184,280185,0,1,1
79966,1,2,280185,280185,280187,0,2,0
79967,6,3,280191,280191,280194,0,3,4
79968,1,3,280192,280194,280197,2,5,0
79969,5,3,280197,280197,280200,0,3,0
79970,1,3,280198,280200,280203,2,5,0
79971,4,2,280202,280203,280205,1,3,0
79972,5,3,280207,280207,280210,0,3,2
79973,1,3,280208,280210,280213,2,5,0
79974,1,2,280209,280213,280215,4,6,0
79975,4,1,280213,280215,280216,2,3,0
79976,5,3,280218,280218,280221,0,3,2
79977,6,1,280224,280224,280225,0,1,3
79978,2,2,280226,280226,280228,0,2,1
79979,1,3,280227,280228,280231,1,4,0
79980,4,3,280231,280231,280234,0,3,0
79981,2,1,280233,280234,280235,1,2,0
79982,5,1,280238,280238,280239,0,1,3
79983,5,1,280243,280243,280244,0,1,4
79984,3,3,280246,280246,280249,0,3,2
79985,2,3,280248,280249,280252,1,4,0
79986,3,1,280251,280252,280253,1,2,0
79987,3,1,280254,280254,280255,0,1,1
79988,6,1,280260,280260,280261,0,1,5
79989,1,1,280261,280261,280262,0,1,0
79990,3,3,280264,280264,280267,0,3,2
79991,6,3,280270,280270,280273,0,3,3
79992,3,1,280273,280273,280274,0,1,0
79993,1,3,280274,280274,280277,0,3,0
79994,5,1,280279,280279,280280,0,1,2
79995,6,1,280285,280285,280286,0,1,5
79996,2,2,280287,280287,280289,0,2,1
79997,3,1,280290,280290,280291,0,1,1
79998,3,1,280293,280293,280294,0,1,2
79999,4,3,280297,280297,280300,0,3,3
80000,2,2,280299,280300,280302,1,3,0
80001,1,1,280300,280302,280303,2,3,0
80002,1,1,280301,280303,280304,2,3,0
80003,5,1,280306,280306,280307,0,1,2
80004,6,1,280312,280312,280313,0,1,5
80005,3,1,280315,280315,280316,0,1,2
80006,3,3,280318,280318,280321,0,3,2
80007,2,3,280320,280321,280324,1,4,0
80008,1,3,280321,280324,280327,3,6,0
80009,2,2,280323,280327,280329,4,6,0
80010,5,2,280328,280329,280331,1,3,0
80011,1,2,280329,280331,280333,2,4,0
80012,5,1,280334,280334,280335,0,1,1
80013,2,2,280336,280336,280338,0,2,1
80014,4,1,280340,280340,280341,0,1,2
80015,2,2,280342,280342,280344,0,2,1
80016,6,1,280348,280348,280349,0,1,4
80017,1,1,280349,280349,280350,0,1,0
80018,1,1,280350,280350,280351,0,1,0
80019,5,3,280355,280355,280358,0,3,4
80020,4,3,280359,280359,280362,0,3,1
80021,4,1,280363,280363,280364,0,1,1
80022,3,3,280366,280366,280369,0,3,2
80023,4,1,280370,280370,280371,0,1,1
80024,2,1,280372,280372,280373,0,1,1
80025,5,3,280377,280377,280380,0,3,4
80026,2,1,280379,280380,280381,1,2,0
80027,4,1,280383,280383,280384,0,1,2
80028,1,3,280384,280384,280387,0,3,0
80029,1,1,280385,280387,280388,2,3,0
80030,5,1,280390,280390,280391,0,1,2
80031,6,2,280396,280396,280398,0,2,5
80032,1,2,280397,280398,280400,1,3,0
80033,4,3,280401,280401,280404,0,3,1
80034,6,2,280407,280407,280409,0,2,3
80035,2,2,280409,280409,280411,0,2,0
80036,2,3,280411,280411,280414,0,3,0
80037,2,2,280413,280414,280416,1,3,0
80038,1,1,280414,280416,280417,2,3,0
80039,2,1,280416,280417,280418,1,2,0
80040,6,1,280422,280422,280423,0,1,4
80041,1,2,280423,280423,280425,0,2,0
80042,4,1,280427,280427,280428,0,1,2
80043,4,3,280431,280431,280434,0,3,3
80044,2,3,280433,280434,280437,1,4,0
80045,4,1,280437,280437,280438,0,1,0
80046,1,3,280438,280438,280441,0,3,0
80047,6,1,280444,280444,280445,0,1,3
80048,1,1,280445,280445,280446,0,1,0
80049,5,3,280450,280450,280453,0,3,4
80050,1,3,280451,280453,280456,2,5,0
80051,5,3,280456,280456,280459,0,3,0
80052,3,1,280459,280459,280460,0,1,0
80053,3,3,280462,280462,280465,0,3,2
80054,4,1,280466,280466,280467,0,1,1
80055,2,2,280468,280468,280470,0,2,1
80056,4,2,280472,280472,280474,0,2,2
80057,4,2,280476,280476,280478,0,2,2
80058,2,3,280478,280478,280481,0,3,0
80059,1,3,280479,280481,280484,2,5,0
80060,1,2,280480,280484,280486,4,6,0
80061,2,1,280482,280486,280487,4,5,0
80062,5,2,280487,280487,280489,0,2,0
80063,6,1,280493,280493,280494,0,1,4
80064,5,1,280498,280498,280499,0,1,4
80065,6,1,280504,280504,280505,0,1,5
80066,5,3,280509,280509,280512,0,3,4
80067,4,2,280513,280513,280515,0,2,1
80068,4,3,280517,280517,280520,0,3,2
80069,6,3,280523,280523,280526,0,3,3
80070,3,3,280526,280526,280529,0,3,0
80071,1,1,280527,280529,280530,2,3,0
80072,2,3,280529,280530,280533,1,4,0
80073,6,3,280535,280535,280538,0,3,2
80074,3,3,280538,280538,280541,0,3,0
80075,1,1,280539,280541,280542,2,3,0
80076,5,3,280544,280544,280547,0,3,2
80077,4,3,280548,280548,280551,0,3,1
80078,2,2,280550,280551,280553,1,3,0
80079,3,1,280553,280553,280554,0,1,0
80080,1,2,280554,280554,280556,0,2,0
80081,6,1,280560,280560,280561,0,1,4
80082,5,3,280565,280565,280568,0,3,4
80083,4,3,280569,280569,280572,0,3,1
80084,3,2,280572,280572,280574,0,2,0
80085,2,2,280574,280574,280576,0,2,0
80086,3,1,280577,280577,280578,0,1,1
80087,1,1,280578,280578,280579,0,1,0
80088,5,1,280583,280583,280584,0,1,4
80089,5,1,280588,280588,280589,0,1,4
80090,4,2,280592,280592,280594,0,2,3
80091,6,2,280598,280598,280600,0,2,4
80092,5,2,280603,280603,280605,0,2,3
80093,4,1,280607,280607,280608,0,1,2
80094,6,2,280613,280613,280615,0,2,5
80095,5,3,280618,280618,280621,0,3,3
80096,4,3,280622,280622,280625,0,3,1
80097,1,2,280623,280625,280627,2,4,0
80098,3,3,280626,280627,280630,1,4,0
80099,2,1,280628,280630,280631,2,3,0
80100,3,3,280631,280631,280634,0,3,0
80101,2,3,280633,280634,280637,1,4,0
80102,2,2,280635,280637,280639,2,4,0
80103,1,1,280636,280639,280640,3,4,0
80104,2,2,280638,280640,280642,2,4,0
80105,2,3,280640,280642,280645,2,5,0
80106,6,3,280646,280646,280649,0,3,1
80107,6,1,280652,280652,280653,0,1,3
80108,2,1,280654,280654,280655,0,1,1
80109,4,1,280658,280658,280659,0,1,3
80110,4,1,280662,280662,280663,0,1,3
80111,6,1,280668,280668,280669,0,1,5
80112,6,3,280674,280674,280677,0,3,5
80113,4,2,280678,280678,280680,0,2,1
80114,1,1,280679,280680,280681,1,2,0
80115,3,1,280682,280682,280683,0,1,1
80116,3,2,280685,280685,280687,0,2,2
80117,1,3,280686,280687,280690,1,4,0
80118,2,1,280688,280690,280691,2,3,0
80119,2,1,280690,280691,280692,1,2,0
80120,2,1,280692,280692,280693,0,1,0
80121,1,3,280693,280693,280696,0,3,0
80122,5,2,280698,280698,280700,0,2,2
80123,6,2,280704,280704,280706,0,2,4
80124,2,1,280706,280706,280707,0,1,0
80125,4,3,280710,280710,280713,0,3,3
80126,5,2,280715,280715,280717,0,2,2
80127,4,3,280719,280719,280722,0,3,2
80128,2,3,280721,280722,280725,1,4,0
80129,5,2,280726,280726,280728,0,2,1
80130,2,1,280728,280728,280729,0,1,0
80131,5,2,280733,280733,280735,0,2,4
80132,5,1,280738,280738,280739,0,1,3
80133,4,2,280742,280742,280744,0,2,3
80134,3,1,280745,280745,280746,0,1,1
80135,2,1,280747,280747,280748,0,1,1
80136,3,3,280750,280750,280753,0,3,2
80137,1,2,280751,280753,280755,2,4,0
80138,4,1,280755,280755,280756,0,1,0
80139,3,3,280758,280758,280761,0,3,2
80140,5,3,280763,280763,280766,0,3,2
80141,4,3,280767,280767,280770,0,3,1
80142,1,2,280768,280770,280772,2,4,0
80143,2,3,280770,280772,280775,2,5,0
80144,4,1,280774,280775,280776,1,2,0
80145,4,2,280778,280778,280780,0,2,2
80146,3,3,280781,280781,280784,0,3,1
80147,3,3,280784,280784,280787,0,3,0
80148,3,2,280787,280787,280789,0,2,0
80149,1,1,280788,280789,280790,1,2,0
80150,1,2,280789,280790,280792,1,3,0
80151,4,2,280793,280793,280795,0,2,1
80152,5,3,280798,280798,280801,0,3,3
80153,2,1,280800,280801,280802,1,2,0
80154,3,3,280803,280803,280806,0,3,1
80155,2,2,280805,280806,280808,1,3,0
80156,5,1,280810,280810,280811,0,1,2
80157,5,1,280815,280815,280816,0,1,4
80158,3,2,280818,280818,280820,0,2,2
80159,6,3,280824,280824,280827,0,3,4
80160,3,3,280827,280827,280830,0,3,0
80161,1,3,280828,280830,280833,2,5,0
80162,4,3,280832,280833,280836,1,4,0
80163,1,2,280833,280836,280838,3,5,0
80164,1,1,280834,280838,280839,4,5,0
80165,1,2,280835,280839,280841,4,6,0
80166,4,2,280839,280841,280843,2,4,0
80167,6,1,280845,280845,280846,0,1,2
80168,5,1,280850,280850,280851,0,1,4
80169,2,2,280852,280852,280854,0,2,1
80170,6,1,280858,280858,280859,0,1,4
80171,6,3,280864,280864,280867,0,3,5
80172,3,2,280867,280867,280869,0,2,0
80173,4,3,280871,280871,280874,0,3,2
80174,5,1,280876,280876,280877,0,1,2
80175,4,3,280880,280880,280883,0,3,3
80176,1,3,280881,280883,280886,2,5,0
80177,2,1,280883,280886,280887,3,4,0
80178,5,1,280888,280888,280889,0,1,1
80179,6,1,280894,280894,280895,0,1,5
80180,6,1,280900,280900,280901,0,1,5
80181,3,1,280903,280903,280904,0,1,2
80182,1,2,280904,280904,280906,0,2,0
80183,3,1,280907,280907,280908,0,1,1
80184,6,2,280913,280913,280915,0,2,5
80185,3,1,280916,280916,280917,0,1,1
80186,6,1,280922,280922,280923,0,1,5
80187,3,3,280925,280925,280928,0,3,2
80188,4,2,280929,280929,280931,0,2,1
80189,5,3,280934,280934,280937,0,3,3
80190,4,3,280938,280938,280941,0,3,1
80191,2,2,280940,280941,280943,1,3,0
80192,4,1,280944,280944,280945,0,1,1
80193,3,3,280947,280947,280950,0,3,2
80194,3,1,280950,280950,280951,0,1,0
80195,1,3,280951,280951,280954,0,3,0
80196,3,2,280954,280954,280956,0,2,0
80197,4,3,280958,280958,280961,0,3,2
80198,4,1,280962,280962,280963,0,1,1
80199,6,3,280968,280968,280971,0,3,5
80200,1,1,280969,280971,280972,2,3,0
80201,4,3,280973,280973,280976,0,3,1
80202,1,3,280974,280976,280979,2,5,0
80203,4,1,280978,280979,280980,1,2,0
80204,2,1,280980,280980,280981,0,1,0
80205,4,1,280984,280984,280985,0,1,3
80206,4,1,280988,280988,280989,0,1,3
80207,3,1,280991,280991,280992,0,1,2
80208,4,1,280995,280995,280996,0,1,3
80209,4,1,280999,280999,281000,0,1,3
80210,2,1,281001,281001,281002,0,1,1
80211,1,2,281002,281002,281004,0,2,0
80212,2,3,281004,281004,281007,0,3,0
80213,6,3,281010,281010,281013,0,3,3
80214,2,3,281012,281013,281016,1,4,0
80215,2,2,281014,281016,281018,2,4,0
80216,3,1,281017,281018,281019,1,2,0
80217,4,2,281021,281021,281023,0,2,2
80218,1,1,281022,281023,281024,1,2,0
80219,6,2,281028,281028,281030,0,2,4
80220,2,3,281030,281030,281033,0,3,0
80221,2,3,281032,281033,281036,1,4,0
80222,5,2,281037,281037,281039,0,2,1
80223,3,3,281040,281040,281043,0,3,1
80224,2,1,281042,281043,281044,1,2,0
80225,5,2,281047,281047,281049,0,2,3
80226,2,2,281049,281049,281051,0,2,0
80227,2,3,281051,281051,281054,0,3,0
80228,3,1,281054,281054,281055,0,1,0
80229,5,2,281059,281059,281061,0,2,4
80230,1,2,281060,281061,281063,1,3,0
80231,4,3,281064,281064,281067,0,3,1
80232,5,3,281069,281069,281072,0,3,2
80233,3,3,281072,281072,281075,0,3,0
80234,6,1,281078,281078,281079,0,1,3
80235,5,1,281083,281083,281084,0,1,4
80236,5,3,281088,281088,281091,0,3,4
80237,1,2,281089,281091,281093,2,4,0
80238,4,1,281093,281093,281094,0,1,0
80239,2,3,281095,281095,281098,0,3,1
80240,3,1,281098,281098,281099,0,1,0
80241,1,2,281099,281099,281101,0,2,0
80242,4,3,281103,281103,281106,0,3,2
80243,4,2,281107,281107,281109,0,2,1
80244,2,3,281109,281109,281112,0,3,0
80245,2,2,281111,281112,281114,1,3,0
80246,3,2,281114,281114,281116,0,2,0
80247,6,1,281120,281120,281121,0,1,4
80248,6,3,281126,281126,281129,0,3,5
80249,1,1,281127,281129,281130,2,3,0
80250,3,3,281130,281130,281133,0,3,0
80251,1,3,281131,281133,281136,2,5,0
80252,3,2,281134,281136,281138,2,4,0
80253,6,2,281140,281140,281142,0,2,2
80254,6,2,281146,281146,281148,0,2,4
80255,3,1,281149,281149,281150,0,1,1
80256,2,3,281151,281151,281154,0,3,1
80257,6,1,281157,281157,281158,0,1,3
80258,4,3,281161,281161,281164,0,3,3
80259,3,3,281164,281164,281167,0,3,0
80260,4,2,281168,281168,281170,0,2,1
80261,4,3,281172,281172,281175,0,3,2
80262,5,1,281177,281177,281178,0,1,2
80263,6,1,281183,281183,281184,0,1,5
80264,6,1,281189,281189,281190,0,1,5
80265,3,2,281192,281192,281194,0,2,2
80266,4,3,281196,281196,281199,0,3,2
80267,3,2,281199,281199,281201,0,2,0
80268,3,3,281202,281202,281205,0,3,1
80269,1,2,281203,281205,281207,2,4,0
80270,5,2,281208,281208,281210,0,2,1
80271,5,3,281213,281213,281216,0,3,3
80272,3,3,281216,281216,281219,0,3,0
80273,4,1,281220,281220,281221,0,1,1
80274,4,2,281224,281224,281226,0,2,3
80275,1,2,281225,281226,281228,1,3,0
80276,2,3,281227,281228,281231,1,4,0
80277,5,2,281232,281232,281234,0,2,1
80278,3,1,281235,281235,281236,0,1,1
80279,1,2,281236,281236,281238,0,2,0
80280,6,2,281242,281242,281244,0,2,4
80281,1,3,281243,281244,281247,1,4,0
80282,1,2,281244,281247,281249,3,5,0
80283,1,2,281245,281249,281251,4,6,0
80284,5,2,281250,281251,281253,1,3,0
80285,1,3,281251,281253,281256,2,5,0
80286,6,2,281257,281257,281259,0,2,1
80287,2,3,281259,281259,281262,0,3,0
80288,2,1,281261,281262,281263,1,2,0
80289,3,2,281264,281264,281266,0,2,1
80290,2,1,281266,281266,281267,0,1,0
80291,1,1,281267,281267,281268,0,1,0
80292,2,2,281269,281269,281271,0,2,1
80293,2,3,281271,281271,281274,0,3,0
80294,2,1,281273,281274,281275,1,2,0
80295,2,1,281275,281275,281276,0,1,0
80296,4,2,281279,281279,281281,0,2,3
80297,6,3,281285,281285,281288,0,3,4
80298,3,3,281288,281288,281291,0,3,0
80299,4,3,281292,281292,281295,0,3,1
80300,3,3,281295,281295,281298,0,3,0
80301,1,3,281296,281298,281301,2,5,0
80302,2,3,281298,281301,281304,3,6,0
80303,4,2,281302,281304,281306,2,4,0
80304,5,2,281307,281307,281309,0,2,1
80305,1,2,281308,281309,281311,1,3,0
80306,6,1,281314,281314,281315,0,1,3
80307,6,2,281320,281320,281322,0,2,5
80308,5,1,281325,281325,281326,0,1,3
80309,2,2,281327,281327,281329,0,2,1
80310,4,1,281331,281331,281332,0,1,2
80311,6,3,281337,281337,281340,0,3,5
80312,4,2,281341,281341,281343,0,2,1
80313,5,3,281346,281346,281349,0,3,3
80314,3,2,281349,281349,281351,0,2,0
80315,4,3,281353,281353,281356,0,3,2
80316,3,3,281356,281356,281359,0,3,0
80317,1,2,281357,281359,281361,2,4,0
80318,1,2,281358,281361,281363,3,5,0
80319,4,2,281362,281363,281365,1,3,0
80320,2,1,281364,281365,281366,1,2,0
80321,6,1,281370,281370,281371,0,1,4
80322,1,2,281371,281371,281373,0,2,0
80323,5,3,281376,281376,281379,0,3,3
80324,6,2,281382,281382,281384,0,2,3
80325,5,2,281387,281387,281389,0,2,3
80326,5,3,281392,281392,281395,0,3,3
80327,4,2,281396,281396,281398,0,2,1
80328,5,3,281401,281401,281404,0,3,3
80329,1,1,281402,281404,281405,2,3,0
80330,3,2,281405,281405,281407,0,2,0
80331,6,1,281411,281411,281412,0,1,4
80332,5,2,281416,281416,281418,0,2,4
80333,6,3,281422,281422,281425,0,3,4
80334,4,3,281426,281426,281429,0,3,1
80335,1,2,281427,281429,281431,2,4,0
80336,1,2,281428,281431,281433,3,5,0
80337,2,2,281430,281433,281435,3,5,0
80338,2,2,281432,281435,281437,3,5,0
80339,1,1,281433,281437,281438,4,5,0
80340,2,1,281435,281438,281439,3,4,0
80341,3,2,281438,281439,281441,1,3,0
80342,6,2,281444,281444,281446,0,2,3
80343,3,3,281447,281447,281450,0,3,1
80344,2,1,281449,281450,281451,1,2,0
80345,5,2,281454,281454,281456,0,2,3
80346,4,2,281458,281458,281460,0,2,2
80347,4,2,281462,281462,281464,0,2,2
80348,3,1,281465,281465,281466,0,1,1
80349,4,1,281469,281469,281470,0,1,3
80350,2,1,281471,281471,281472,0,1,1
80351,2,3,281473,281473,281476,0,3,1
80352,2,3,281475,281476,281479,1,4,0
80353,1,2,281476,281479,281481,3,5,0
80354,3,3,281479,281481,281484,2,5,0
80355,5,2,281484,281484,281486,0,2,0
80356,4,3,281488,281488,281491,0,3,2
80357,5,3,281493,281493,281496,0,3,2
80358,3,1,281496,281496,281497,0,1,0
80359,6,3,281502,281502,281505,0,3,5
80360,6,3,281508,281508,281511,0,3,3
80361,2,2,281510,281511,281513,1,3,0
80362,2,3,281512,281513,281516,1,4,0
80363,2,2,281514,281516,281518,2,4,0
80364,4,3,281518,281518,281521,0,3,0
80365,1,3,281519,281521,281524,2,5,0
80366,1,2,281520,281524,281526,4,6,0
80367,5,2,281525,281526,281528,1,3,0
80368,3,3,281528,281528,281531,0,3,0
80369,5,2,281533,281533,281535,0,2,2
80370,5,2,281538,281538,281540,0,2,3
80371,1,1,281539,281540,281541,1,2,0
80372,6,3,281545,281545,281548,0,3,4
80373,3,2,281548,281548,281550,0,2,0
80374,5,2,281553,281553,281555,0,2,3
80375,3,3,281556,281556,281559,0,3,1
80376,4,3,281560,281560,281563,0,3,1
80377,1,2,281561,281563,281565,2,4,0
80378,5,3,281566,281566,281569,0,3,1
80379,3,2,281569,281569,281571,0,2,0
80380,3,3,281572,281572,281575,0,3,1
80381,3,1,281575,281575,281576,0,1,0
80382,2,2,281577,281577,281579,0,2,1
80383,5,2,281582,281582,281584,0,2,3
80384,4,2,281586,281586,281588,0,2,2
80385,5,1,281591,281591,281592,0,1,3
80386,6,1,281597,281597,281598,0,1,5
80387,1,1,281598,281598,281599,0,1,0
80388,1,3,281599,281599,281602,0,3,0
80389,6,1,281605,281605,281606,0,1,3
80390,6,1,281611,281611,281612,0,1,5
80391,5,2,281616,281616,281618,0,2,4
80392,2,2,281618,281618,281620,0,2,0
80393,2,2,281620,281620,281622,0,2,0
80394,4,2,281624,281624,281626,0,2,2
80395,6,3,281630,281630,281633,0,3,4
80396,6,2,281636,281636,281638,0,2,3
80397,6,2,281642,281642,281644,0,2,4
80398,2,1,281644,281644,281645,0,1,0
80399,6,1,281650,281650,281651,0,1,5
80400,3,1,281653,281653,281654,0,1,2
80401,4,2,281657,281657,281659,0,2,3
80402,2,1,281659,281659,281660,0,1,0
80403,3,3,281662,281662,281665,0,3,2
80404,5,1,281667,281667,281668,0,1,2
80405,5,2,281672,281672,281674,0,2,4
80406,3,1,281675,281675,281676,0,1,1
80407,3,3,281678,281678,281681,0,3,2
80408,1,3,281679,281681,281684,2,5,0
80409,5,3,281684,281684,281687,0,3,0
80410,4,3,281688,281688,281691,0,3,1
80411,6,2,281694,281694,281696,0,2,3
80412,1,1,281695,281696,281697,1,2,0
80413,6,2,281701,281701,281703,0,2,4
80414,4,1,281705,281705,281706,0,1,2
80415,2,2,281707,281707,281709,0,2,1
80416,1,3,281708,281709,281712,1,4,0
80417,3,2,281711,281712,281714,1,3,0
80418,2,1,281713,281714,281715,1,2,0
80419,2,1,281715,281715,281716,0,1,0
80420,6,1,281721,281721,281722,0,1,5
80421,5,3,281726,281726,281729,0,3,4
80422,5,3,281731,281731,281734,0,3,2
80423,3,3,281734,281734,281737,0,3,0
80424,3,2,281737,281737,281739,0,2,0
80425,2,3,281739,281739,281742,0,3,0
80426,3,3,281742,281742,281745,0,3,0
80427,4,2,281746,281746,281748,0,2,1
80428,3,1,281749,281749,281750,0,1,1
80429,3,1,281752,281752,281753,0,1,2
80430,5,1,281757,281757,281758,0,1,4
80431,4,2,281761,281761,281763,0,2,3
80432,4,2,281765,281765,281767,0,2,2
80433,6,2,281771,281771,281773,0,2,4
80434,4,3,281775,281775,281778,0,3,2
80435,6,3,281781,281781,281784,0,3,3
80436,2,1,281783,281784,281785,1,2,0
80437,1,3,281784,281785,281788,1,4,0
80438,2,2,281786,281788,281790,2,4,0
80439,3,2,281789,281790,281792,1,3,0
80440,3,3,281792,281792,281795,0,3,0
80441,6,3,281798,281798,281801,0,3,3
80442,5,1,281803,281803,281804,0,1,2
80443,4,1,281807,281807,281808,0,1,3
80444,4,3,281811,281811,281814,0,3,3
80445,1,2,281812,281814,281816,2,4,0
80446,5,3,281817,281817,281820,0,3,1
80447,2,3,281819,281820,281823,1,4,0
80448,4,2,281823,281823,281825,0,2,0
80449,6,1,281829,281829,281830,0,1,4
80450,1,3,281830,281830,281833,0,3,0
80451,2,3,281832,281833,281836,1,4,0
80452,4,1,281836,281836,281837,0,1,0
80453,3,3,281839,281839,281842,0,3,2
80454,2,3,281841,281842,281845,1,4,0
80455,5,3,281846,281846,281849,0,3,1
80456,4,1,281850,281850,281851,0,1,1
80457,1,2,281851,281851,281853,0,2,0
80458,2,1,281853,281853,281854,0,1,0
80459,4,2,281857,281857,281859,0,2,3
80460,6,3,281863,281863,281866,0,3,4
80461,2,2,281865,281866,281868,1,3,0
80462,5,1,281870,281870,281871,0,1,2
80463,6,3,281876,281876,281879,0,3,5
80464,2,3,281878,281879,281882,1,4,0
80465,4,3,281882,281882,281885,0,3,0
80466,3,3,281885,281885,281888,0,3,0
80467,4,3,281889,281889,281892,0,3,1
80468,3,2,281892,281892,281894,0,2,0
80469,6,1,281898,281898,281899,0,1,4
80470,6,2,281904,281904,281906,0,2,5
80471,6,3,281910,281910,281913,0,3,4
80472,1,2,281911,281913,281915,2,4,0
80473,1,3,281912,281915,281918,3,6,0
80474,1,2,281913,281918,281920,5,7,0
80475,5,3,281918,281920,281923,2,5,0
80476,2,2,281920,281923,281925,3,5,0
80477,3,3,281923,281925,281928,2,5,0
80478,2,3,281925,281928,281931,3,6,0
80479,2,3,281927,281931,281934,4,7,0
80480,6,2,281933,281934,281936,1,3,0
80481,4,2,281937,281937,281939,0,2,1
80482,1,2,281938,281939,281941,1,3,0
80483,4,2,281942,281942,281944,0,2,1
80484,3,1,281945,281945,281946,0,1,1
80485,6,3,281951,281951,281954,0,3,5
80486,3,3,281954,281954,281957,0,3,0
80487,1,1,281955,281957,281958,2,3,0
80488,2,1,281957,281958,281959,1,2,0
80489,4,2,281961,281961,281963,0,2,2
80490,6,1,281967,281967,281968,0,1,4
80491,1,1,281968,281968,281969,0,1,0
80492,4,2,281972,281972,281974,0,2,3
80493,3,3,281975,281975,281978,0,3,1
80494,1,3,281976,281978,281981,2,5,0
80495,6,2,281982,281982,281984,0,2,1
80496,3,3,281985,281985,281988,0,3,1
80497,3,1,281988,281988,281989,0,1,0
80498,5,1,281993,281993,281994,0,1,4
80499,6,1,281999,281999,282000,0,1,5
80500,1,2,282000,282000,282002,0,2,0
80501,1,2,282001,282002,282004,1,3,0
80502,5,1,282006,282006,282007,0,1,2
80503,4,3,282010,282010,282013,0,3,3
80504,2,1,282012,282013,282014,1,2,0
80505,1,3,282013,282014,282017,1,4,0
80506,6,1,282019,282019,282020,0,1,2
80507,4,2,282023,282023,282025,0,2,3
80508,6,3,282029,282029,282032,0,3,4
80509,3,3,282032,282032,282035,0,3,0
80510,3,3,282035,282035,282038,0,3,0
80511,1,3,282036,282038,282041,2,5,0
80512,4,1,282040,282041,282042,1,2,0
80513,3,2,282043,282043,282045,0,2,1
80514,5,2,282048,282048,282050,0,2,3
80515,3,3,282051,282051,282054,0,3,1
80516,2,3,282053,282054,282057,1,4,0
80517,3,2,282056,282057,282059,1,3,0
80518,2,1,282058,282059,282060,1,2,0
80519,1,3,282059,282060,282063,1,4,0
80520,5,2,282064,282064,282066,0,2,1
80521,6,1,282070,282070,282071,0,1,4
80522,2,2,282072,282072,282074,0,2,1
80523,6,1,282078,282078,282079,0,1,4
80524,1,1,282079,282079,282080,0,1,0
80525,1,2,282080,282080,282082,0,2,0
80526,5,1,282085,282085,282086,0,1,3
80527,3,2,282088,282088,282090,0,2,2
80528,1,2,282089,282090,282092,1,3,0
80529,1,3,282090,282092,282095,2,5,0
80530,4,1,282094,282095,282096,1,2,0
80531,5,2,282099,282099,282101,0,2,3
80532,6,3,282105,282105,282108,0,3,4
80533,1,1,282106,282108,282109,2,3,0
80534,1,1,282107,282109,282110,2,3,0
80535,2,3,282109,282110,282113,1,4,0
80536,3,2,282112,282113,282115,1,3,0
80537,5,3,282117,282117,282120,0,3,2
80538,3,1,282120,282120,282121,0,1,0
80539,4,2,282124,282124,282126,0,2,3
80540,2,3,282126,282126,282129,0,3,0
80541,6,1,282132,282132,282133,0,1,3
80542,2,1,282134,282134,282135,0,1,1
80543,3,3,282137,282137,282140,0,3,2
80544,5,2,282142,282142,282144,0,2,2
80545,1,3,282143,282144,282147,1,4,0
80546,5,1,282148,282148,282149,0,1,1
80547,4,2,282152,282152,282154,0,2,3
80548,5,3,282157,282157,282160,0,3,3
80549,5,2,282162,282162,282164,0,2,2
80550,1,2,282163,282164,282166,1,3,0
80551,6,3,282169,282169,282172,0,3,3
80552,5,3,282174,282174,282177,0,3,2
80553,1,1,282175,282177,282178,2,3,0
80554,1,1,282176,282178,282179,2,3,0
80555,6,3,282182,282182,282185,0,3,3
80556,5,1,282187,282187,282188,0,1,2
80557,6,2,282193,282193,282195,0,2,5
80558,3,2,282196,282196,282198,0,2,1
80559,6,1,282202,282202,282203,0,1,4
80560,6,3,282208,282208,282211,0,3,5
80561,3,2,282211,282211,282213,0,2,0
80562,6,2,282217,282217,282219,0,2,4
80563,1,1,282218,282219,282220,1,2,0
80564,4,1,282222,282222,282223,0,1,2
80565,3,2,282225,282225,282227,0,2,2
80566,5,3,282230,282230,282233,0,3,3
80567,3,3,282233,282233,282236,0,3,0
80568,2,1,282235,282236,282237,1,2,0
80569,1,1,282236,282237,282238,1,2,0
80570,2,1,282238,282238,282239,0,1,0
80571,4,1,282242,282242,282243,0,1,3
80572,6,3,282248,282248,282251,0,3,5
80573,2,2,282250,282251,282253,1,3,0
80574,4,2,282254,282254,282256,0,2,1
80575,6,1,282260,282260,282261,0,1,4
80576,4,1,282264,282264,282265,0,1,3
80577,6,2,282270,282270,282272,0,2,5
80578,5,1,282275,282275,282276,0,1,3
80579,3,2,282278,282278,282280,0,2,2
80580,3,3,282281,282281,282284,0,3,1
80581,6,1,282287,282287,282288,0,1,3
80582,4,1,282291,282291,282292,0,1,3
80583,5,3,282296,282296,282299,0,3,4
80584,5,3,282301,282301,282304,0,3,2
80585,5,1,282306,282306,282307,0,1,2
80586,2,1,282308,282308,282309,0,1,1
80587,3,2,282311,282311,282313,0,2,2
80588,2,3,282313,282313,282316,0,3,0
80589,2,3,282315,282316,282319,1,4,0
80590,5,2,282320,282320,282322,0,2,1
80591,4,2,282324,282324,282326,0,2,2
80592,6,3,282330,282330,282333,0,3,4
80593,5,1,282335,282335,282336,0,1,2
80594,6,1,282341,282341,282342,0,1,5
80595,2,1,282343,282343,282344,0,1,1
80596,4,1,282347,282347,282348,0,1,3
80597,4,2,282351,282351,282353,0,2,3
80598,3,2,282354,282354,282356,0,2,1
80599,4,1,282358,282358,282359,0,1,2
80600,6,1,282364,282364,282365,0,1,5
80601,6,1,282370,282370,282371,0,1,5
80602,2,2,282372,282372,282374,0,2,1
80603,1,2,282373,282374,282376,1,3,0
80604,4,3,282377,282377,282380,0,3,1
80605,2,1,282379,282380,282381,1,2,0
80606,1,2,282380,282381,282383,1,3,0
80607,5,1,282385,282385,282386,0,1,2
80608,1,1,282386,282386,282387,0,1,0
80609,1,1,282387,282387,282388,0,1,0
80610,5,1,282392,282392,282393,0,1,4
80611,4,3,282396,282396,282399,0,3,3
80612,1,2,282397,282399,282401,2,4,0
80613,6,3,282403,282403,282406,0,3,2
80614,4,1,282407,282407,282408,0,1,1
80615,4,1,282411,282411,282412,0,1,3
80616,1,2,282412,282412,282414,0,2,0
80617,5,2,282417,282417,282419,0,2,3
80618,6,2,282423,282423,282425,0,2,4
80619,4,3,282427,282427,282430,0,3,2
80620,5,2,282432,282432,282434,0,2,2
80621,3,2,282435,282435,282437,0,2,1
80622,1,1,282436,282437,282438,1,2,0
80623,2,2,282438,282438,282440,0,2,0
80624,6,3,282444,282444,282447,0,3,4
80625,5,1,282449,282449,282450,0,1,2
80626,6,3,282455,282455,282458,0,3,5
80627,1,3,282456,282458,282461,2,5,0
80628,5,3,282461,282461,282464,0,3,0
80629,2,1,282463,282464,282465,1,2,0
80630,1,3,282464,282465,282468,1,4,0
80631,5,1,282469,282469,282470,0,1,1
80632,2,3,282471,282471,282474,0,3,1
80633,5,1,282476,282476,282477,0,1,2
80634,1,3,282477,282477,282480,0,3,0
80635,4,3,282481,282481,282484,0,3,1
80636,6,3,282487,282487,282490,0,3,3
80637,1,3,282488,282490,282493,2,5,0
80638,5,1,282493,282493,282494,0,1,0
80639,2,2,282495,282495,282497,0,2,1
80640,6,3,282501,282501,282504,0,3,4
80641,6,2,282507,282507,282509,0,2,3
80642,4,3,282511,282511,282514,0,3,2
80643,5,1,282516,282516,282517,0,1,2
80644,1,2,282517,282517,282519,0,2,0
80645,6,1,282523,282523,282524,0,1,4
80646,4,3,282527,282527,282530,0,3,3
80647,4,1,282531,282531,282532,0,1,1
80648,3,1,282534,282534,282535,0,1,2
80649,2,2,282536,282536,282538,0,2,1
80650,5,3,282541,282541,282544,0,3,3
80651,3,1,282544,282544,282545,0,1,0
80652,4,3,282548,282548,282551,0,3,3
80653,4,1,282552,282552,282553,0,1,1
80654,3,3,282555,282555,282558,0,3,2
80655,3,1,282558,282558,282559,0,1,0
80656,1,3,282559,282559,282562,0,3,0
80657,2,2,282561,282562,282564,1,3,0
80658,1,3,282562,282564,282567,2,5,0
80659,1,1,282563,282567,282568,4,5,0
80660,3,3,282566,282568,282571,2,5,0
80661,1,3,282567,282571,282574,4,7,0
80662,3,2,282570,282574,282576,4,6,0
80663,3,1,282573,282576,282577,3,4,0
80664,2,3,282575,282577,282580,2,5,0
80665,5,1,282580,282580,282581,0,1,0
80666,1,1,282581,282581,282582,0,1,0
80667,2,3,282583,282583,282586,0,3,1
80668,6,1,282589,282589,282590,0,1,3
80669,3,1,282592,282592,282593,0,1,2
80670,4,1,282596,282596,282597,0,1,3
80671,5,1,282601,282601,282602,0,1,4
80672,2,3,282603,282603,282606,0,3,1
80673,5,1,282608,282608,282609,0,1,2
80674,5,3,282613,282613,282616,0,3,4
80675,3,2,282616,282616,282618,0,2,0
80676,6,3,282622,282622,282625,0,3,4
80677,6,1,282628,282628,282629,0,1,3
80678,3,1,282631,282631,282632,0,1,2
80679,2,1,282633,282633,282634,0,1,1
80680,5,3,282638,282638,282641,0,3,4
80681,1,2,282639,282641,282643,2,4,0
80682,4,3,282643,282643,282646,0,3,0
80683,4,2,282647,282647,282649,0,2,1
80684,2,2,282649,282649,282651,0,2,0
80685,2,3,282651,282651,282654,0,3,0
80686,1,1,282652,282654,282655,2,3,0
80687,4,2,282656,282656,282658,0,2,1
80688,1,1,282657,282658,282659,1,2,0
80689,4,3,282661,282661,282664,0,3,2
80690,4,2,282665,282665,282667,0,2,1
80691,2,2,282667,282667,282669,0,2,0
80692,1,3,282668,282669,282672,1,4,0
80693,4,1,282672,282672,282673,0,1,0
80694,5,3,282677,282677,282680,0,3,4
80695,2,3,282679,282680,282683,1,4,0
80696,2,2,282681,282683,282685,2,4,0
80697,5,2,282686,282686,282688,0,2,1
80698,5,2,282691,282691,282693,0,2,3
80699,6,2,282697,282697,282699,0,2,4
80700,3,1,282700,282700,282701,0,1,1
80701,3,2,282703,282703,282705,0,2,2
80702,3,1,282706,282706,282707,0,1,1
80703,2,3,282708,282708,282711,0,3,1
80704,1,3,282709,282711,282714,2,5,0
80705,5,3,282714,282714,282717,0,3,0
80706,6,3,282720,282720,282723,0,3,3
80707,6,1,282726,282726,282727,0,1,3
80708,4,3,282730,282730,282733,0,3,3
80709,3,1,282733,282733,282734,0,1,0
80710,3,1,282736,282736,282737,0,1,2
80711,3,1,282739,282739,282740,0,1,2
80712,1,1,282740,282740,282741,0,1,0
80713,4,3,282744,282744,282747,0,3,3
80714,2,2,282746,282747,282749,1,3,0
80715,2,1,282748,282749,282750,1,2,0
80716,3,1,282751,282751,282752,0,1,1
80717,2,2,282753,282753,282755,0,2,1
80718,3,2,282756,282756,282758,0,2,1
80719,1,3,282757,282758,282761,1,4,0
80720,5,3,282762,282762,282765,0,3,1
80721,5,2,282767,282767,282769,0,2,2
80722,1,3,282768,282769,282772,1,4,0
80723,5,3,282773,282773,282776,0,3,1
80724,4,1,282777,282777,282778,0,1,1
80725,4,3,282781,282781,282784,0,3,3
80726,4,1,282785,282785,282786,0,1,1
80727,2,1,282787,282787,282788,0,1,1
80728,4,2,282791,282791,282793,0,2,3
80729,1,3,282792,282793,282796,1,4,0
80730,5,3,282797,282797,282800,0,3,1
80731,2,3,282799,282800,282803,1,4,0
80732,6,2,282805,282805,282807,0,2,2
80733,1,2,282806,282807,282809,1,3,0
80734,4,2,282810,282810,282812,0,2,1
80735,1,1,282811,282812,282813,1,2,0
80736,2,2,282813,282813,282815,0,2,0
80737,4,3,282817,282817,282820,0,3,2
80738,6,3,282823,282823,282826,0,3,3
80739,2,3,282825,282826,282829,1,4,0
80740,5,3,282830,282830,282833,0,3,1
80741,5,2,282835,282835,282837,0,2,2
80742,6,3,282841,282841,282844,0,3,4
80743,6,2,282847,282847,282849,0,2,3
80744,6,2,282853,282853,282855,0,2,4
80745,6,2,282859,282859,282861,0,2,4
80746,5,3,282864,282864,282867,0,3,3
80747,2,1,282866,282867,282868,1,2,0
80748,6,2,282872,282872,282874,0,2,4
80749,5,1,282877,282877,282878,0,1,3
80750,2,2,282879,282879,282881,0,2,1
80751,2,2,282881,282881,282883,0,2,0
80752,5,1,282886,282886,282887,0,1,3
80753,4,1,282890,282890,282891,0,1,3
80754,4,2,282894,282894,282896,0,2,3
80755,2,2,282896,282896,282898,0,2,0
80756,4,2,282900,282900,282902,0,2,2
80757,3,3,282903,282903,282906,0,3,1
80758,2,2,282905,282906,282908,1,3,0
80759,4,3,282909,282909,282912,0,3,1
80760,2,3,282911,282912,282915,1,4,0
80761,1,2,282912,282915,282917,3,5,0
80762,3,1,282915,282917,282918,2,3,0
80763,4,1,282919,282919,282920,0,1,1
80764,2,3,282921,282921,282924,0,3,1
80765,6,1,282927,282927,282928,0,1,3
80766,3,3,282930,282930,282933,0,3,2
80767,6,3,282936,282936,282939,0,3,3
80768,6,3,282942,282942,282945,0,3,3
80769,6,3,282948,282948,282951,0,3,3
80770,4,1,282952,282952,282953,0,1,1
80771,1,3,282953,282953,282956,0,3,0
80772,5,2,282958,282958,282960,0,2,2
80773,2,3,282960,282960,282963,0,3,0
80774,2,3,282962,282963,282966,1,4,0
80775,2,2,282964,282966,282968,2,4,0
80776,6,3,282970,282970,282973,0,3,2
80777,2,1,282972,282973,282974,1,2,0
80778,5,3,282977,282977,282980,0,3,3
80779,5,1,282982,282982,282983,0,1,2
80780,3,1,282985,282985,282986,0,1,2
80781,3,2,282988,282988,282990,0,2,2
80782,6,1,282994,282994,282995,0,1,4
80783,3,3,282997,282997,283000,0,3,2
80784,2,2,282999,283000,283002,1,3,0
80785,1,3,283000,283002,283005,2,5,0
80786,6,2,283006,283006,283008,0,2,1
80787,1,2,283007,283008,283010,1,3,0
80788,1,3,283008,283010,283013,2,5,0
80789,1,2,283009,283013,283015,4,6,0
80790,5,2,283014,283015,283017,1,3,0
80791,3,2,283017,283017,283019,0,2,0
80792,5,3,283022,283022,283025,0,3,3
80793,2,3,283024,283025,283028,1,4,0
80794,1,1,283025,283028,283029,3,4,0
80795,1,1,283026,283029,283030,3,4,0
80796,2,2,283028,283030,283032,2,4,0
80797,6,1,283034,283034,283035,0,1,2
80798,3,2,283037,283037,283039,0,2,2
80799,6,1,283043,283043,283044,0,1,4
80800,5,1,283048,283048,283049,0,1,4
80801,1,2,283049,283049,283051,0,2,0
80802,5,2,283054,283054,283056,0,2,3
80803,5,3,283059,283059,283062,0,3,3
80804,5,2,283064,283064,283066,0,2,2
80805,5,1,283069,283069,283070,0,1,3
80806,6,2,283075,283075,283077,0,2,5
80807,6,3,283081,283081,283084,0,3,4
80808,3,1,283084,283084,283085,0,1,0
80809,5,1,283089,283089,283090,0,1,4
80810,2,1,283091,283091,283092,0,1,1
80811,3,3,283094,283094,283097,0,3,2
80812,4,1,283098,283098,283099,0,1,1
80813,1,2,283099,283099,283101,0,2,0
80814,2,2,283101,283101,283103,0,2,0
80815,5,2,283106,283106,283108,0,2,3
80816,2,3,283108,283108,283111,0,3,0
80817,6,3,283114,283114,283117,0,3,3
80818,6,3,283120,283120,283123,0,3,3
80819,1,1,283121,283123,283124,2,3,0
80820,3,2,283124,283124,283126,0,2,0
80821,6,2,283130,283130,283132,0,2,4
80822,6,1,283136,283136,283137,0,1,4
80823,2,3,283138,283138,283141,0,3,1
80824,4,2,283142,283142,283144,0,2,1
80825,2,3,283144,283144,283147,0,3,0
80826,1,2,283145,283147,283149,2,4,0
80827,2,1,283147,283149,283150,2,3,0
80828,3,3,283150,283150,283153,0,3,0
80829,5,2,283155,283155,283157,0,2,2
80830,4,3,283159,283159,283162,0,3,2
80831,6,3,283165,283165,283168,0,3,3
80832,6,3,283171,283171,283174,0,3,3
80833,1,3,283172,283174,283177,2,5,0
80834,4,2,283176,283177,283179,1,3,0
80835,3,2,283179,283179,283181,0,2,0
80836,3,2,283182,283182,283184,0,2,1
80837,2,3,283184,283184,283187,0,3,0
80838,5,1,283189,283189,283190,0,1,2
80839,6,1,283195,283195,283196,0,1,5
80840,5,3,283200,283200,283203,0,3,4
80841,6,2,283206,283206,283208,0,2,3
80842,5,2,283211,283211,283213,0,2,3
80843,3,3,283214,283214,283217,0,3,1
80844,4,3,283218,283218,283221,0,3,1
80845,4,1,283222,283222,283223,0,1,1
80846,5,1,283227,283227,283228,0,1,4
80847,4,1,283231,283231,283232,0,1,3
80848,2,3,283233,283233,283236,0,3,1
80849,5,3,283238,283238,283241,0,3,2
80850,2,3,283240,283241,283244,1,4,0
80851,6,1,283246,283246,283247,0,1,2
80852,5,1,283251,283251,283252,0,1,4
80853,1,3,283252,283252,283255,0,3,0
80854,4,3,283256,283256,283259,0,3,1
80855,2,2,283258,283259,283261,1,3,0
80856,5,1,283263,283263,283264,0,1,2
80857,3,1,283266,283266,283267,0,1,2
80858,3,2,283269,283269,283271,0,2,2
80859,1,2,283270,283271,283273,1,3,0
80860,4,2,283274,283274,283276,0,2,1
80861,3,2,283277,283277,283279,0,2,1
80862,2,2,283279,283279,283281,0,2,0
80863,1,2,283280,283281,283283,1,3,0
80864,6,1,283286,283286,283287,0,1,3
80865,4,1,283290,283290,283291,0,1,3
80866,2,3,283292,283292,283295,0,3,1
80867,6,3,283298,283298,283301,0,3,3
80868,5,2,283303,283303,283305,0,2,2
80869,3,2,283306,283306,283308,0,2,1
80870,6,1,283312,283312,283313,0,1,4
80871,2,3,283314,283314,283317,0,3,1
80872,2,2,283316,283317,283319,1,3,0
80873,3,1,283319,283319,283320,0,1,0
80874,3,2,283322,283322,283324,0,2,2
80875,4,1,283326,283326,283327,0,1,2
80876,5,1,283331,283331,283332,0,1,4
80877,1,1,283332,283332,283333,0,1,0
80878,2,2,283334,283334,283336,0,2,1
80879,6,1,283340,283340,283341,0,1,4
80880,1,3,283341,283341,283344,0,3,0
80881,6,3,283347,283347,283350,0,3,3
80882,1,3,283348,283350,283353,2,5,0
80883,3,3,283351,283353,283356,2,5,0
80884,3,3,283354,283356,283359,2,5,0
80885,5,3,283359,283359,283362,0,3,0
80886,5,1,283364,283364,283365,0,1,2
80887,5,2,283369,283369,283371,0,2,4
80888,5,1,283374,283374,283375,0,1,3
80889,1,1,283375,283375,283376,0,1,0
80890,5,3,283380,283380,283383,0,3,4
80891,6,2,283386,283386,283388,0,2,3
80892,5,2,283391,283391,283393,0,2,3
80893,3,1,283394,283394,283395,0,1,1
80894,3,3,283397,283397,283400,0,3,2
80895,5,3,283402,283402,283405,0,3,2
80896,3,1,283405,283405,283406,0,1,0
80897,2,3,283407,283407,283410,0,3,1
80898,1,3,283408,283410,283413,2,5,0
80899,1,2,283409,283413,283415,4,6,0
80900,4,2,283413,283415,283417,2,4,0
80901,6,2,283419,283419,283421,0,2,2
80902,6,1,283425,283425,283426,0,1,4
80903,4,3,283429,283429,283432,0,3,3
80904,3,2,283432,283432,283434,0,2,0
80905,1,3,283433,283434,283437,1,4,0
80906,3,2,283436,283437,283439,1,3,0
80907,3,1,283439,283439,283440,0,1,0
80908,2,3,283441,283441,283444,0,3,1
80909,5,1,283446,283446,283447,0,1,2
80910,5,1,283451,283451,283452,0,1,4
80911,3,3,283454,283454,283457,0,3,2
80912,1,1,283455,283457,283458,2,3,0
80913,1,3,283456,283458,283461,2,5,0
80914,5,1,283461,283461,283462,0,1,0
80915,2,2,283463,283463,283465,0,2,1
80916,1,3,283464,283465,283468,1,4,0
80917,5,2,283469,283469,283471,0,2,1
80918,1,1,283470,283471,283472,1,2,0
80919,4,3,283474,283474,283477,0,3,2
80920,6,2,283480,283480,283482,0,2,3
80921,5,1,283485,283485,283486,0,1,3
80922,1,1,283486,283486,283487,0,1,0
80923,6,2,283492,283492,283494,0,2,5
80924,3,1,283495,283495,283496,0,1,1
80925,2,2,283497,283497,283499,0,2,1
80926,2,2,283499,283499,283501,0,2,0
80927,5,2,283504,283504,283506,0,2,3
80928,1,2,283505,283506,283508,1,3,0
80929,4,2,283509,283509,283511,0,2,1
80930,6,1,283515,283515,283516,0,1,4
80931,2,1,283517,283517,283518,0,1,1
80932,1,3,283518,283518,283521,0,3,0
80933,2,2,283520,283521,283523,1,3,0
80934,4,2,283524,283524,283526,0,2,1
80935,1,1,283525,283526,283527,1,2,0
80936,4,1,283529,283529,283530,0,1,2
80937,2,2,283531,283531,283533,0,2,1
80938,5,3,283536,283536,283539,0,3,3
80939,2,3,283538,283539,283542,1,4,0
80940,1,3,283539,283542,283545,3,6,0
80941,1,1,283540,283545,283546,5,6,0
80942,5,2,283545,283546,283548,1,3,0
80943,5,1,283550,283550,283551,0,1,2
80944,1,3,283551,283551,283554,0,3,0
80945,3,3,283554,283554,283557,0,3,0
80946,1,3,283555,283557,283560,2,5,0
80947,1,1,283556,283560,283561,4,5,0
80948,2,3,283558,283561,283564,3,6,0
80949,5,2,283563,283564,283566,1,3,0
80950,4,3,283567,283567,283570,0,3,1
80951,2,1,283569,283570,283571,1,2,0
80952,6,3,283575,283575,283578,0,3,4
80953,5,3,283580,283580,283583,0,3,2
80954,3,3,283583,283583,283586,0,3,0
80955,4,3,283587,283587,283590,0,3,1
80956,1,2,283588,283590,283592,2,4,0
80957,4,1,283592,283592,283593,0,1,0
80958,2,2,283594,283594,283596,0,2,1
80959,3,3,283597,283597,283600,0,3,1
80960,1,2,283598,283600,283602,2,4,0
80961,5,2,283603,283603,283605,0,2,1
80962,1,2,283604,283605,283607,1,3,0
80963,4,3,283608,283608,283611,0,3,1
80964,1,3,283609,283611,283614,2,5,0
80965,2,3,283611,283614,283617,3,6,0
80966,6,3,283617,283617,283620,0,3,0
80967,5,1,283622,283622,283623,0,1,2
80968,5,1,283627,283627,283628,0,1,4
80969,5,3,283632,283632,283635,0,3,4
80970,5,1,283637,283637,283638,0,1,2
80971,1,1,283638,283638,283639,0,1,0
80972,3,1,283641,283641,283642,0,1,2
80973,6,1,283647,283647,283648,0,1,5
80974,4,1,283651,283651,283652,0,1,3
80975,2,3,283653,283653,283656,0,3,1
80976,4,1,283657,283657,283658,0,1,1
80977,1,3,283658,283658,283661,0,3,0
80978,3,3,283661,283661,283664,0,3,0
80979,6,2,283667,283667,283669,0,2,3
80980,1,3,283668,283669,283672,1,4,0
80981,1,1,283669,283672,283673,3,4,0
80982,3,3,283672,283673,283676,1,4,0
80983,4,1,283676,283676,283677,0,1,0
80984,1,3,283677,283677,283680,0,3,0
80985,2,3,283679,283680,283683,1,4,0
80986,4,1,283683,283683,283684,0,1,0
80987,4,2,283687,283687,283689,0,2,3
80988,6,1,283693,283693,283694,0,1,4
80989,5,2,283698,283698,283700,0,2,4
80990,3,1,283701,283701,283702,0,1,1
80991,6,2,283707,283707,283709,0,2,5
80992,6,1,283713,283713,283714,0,1,4
80993,5,1,283718,283718,283719,0,1,4
80994,5,1,283723,283723,283724,0,1,4
80995,4,1,283727,283727,283728,0,1,3
80996,2,3,283729,283729,283732,0,3,1
80997,3,3,283732,283732,283735,0,3,0
80998,5,1,283737,283737,283738,0,1,2
80999,6,2,283743,283743,283745,0,2,5
81000,1,2,283744,283745,283747,1,3,0
81001,3,3,283747,283747,283750,0,3,0
81002,4,2,283751,283751,283753,0,2,1
81003,5,1,283756,283756,283757,0,1,3
81004,6,1,283762,283762,283763,0,1,5
81005,2,1,283764,283764,283765,0,1,1
81006,1,3,283765,283765,283768,0,3,0
81007,1,3,283766,283768,283771,2,5,0
81008,1,1,283767,283771,283772,4,5,0
81009,5,2,283772,283772,283774,0,2,0
81010,6,2,283778,283778,283780,0,2,4
81011,1,3,283779,283780,283783,1,4,0
81012,5,3,283784,283784,283787,0,3,1
81013,3,1,283787,283787,283788,0,1,0
81014,4,2,283791,283791,283793,0,2,3
81015,3,1,283794,283794,283795,0,1,1
81016,4,1,283798,283798,283799,0,1,3
81017,4,1,283802,283802,283803,0,1,3
81018,3,1,283805,283805,283806,0,1,2
81019,4,1,283809,283809,283810,0,1,3
81020,5,1,283814,283814,283815,0,1,4
81021,3,1,283817,283817,283818,0,1,2
81022,4,3,283821,283821,283824,0,3,3
81023,5,2,283826,283826,283828,0,2,2
81024,2,1,283828,283828,283829,0,1,0
81025,1,2,283829,283829,283831,0,2,0
81026,2,2,283831,283831,283833,0,2,0
81027,1,2,283832,283833,283835,1,3,0
81028,6,3,283838,283838,283841,0,3,3
81029,2,1,283840,283841,283842,1,2,0
81030,5,3,283845,283845,283848,0,3,3
81031,2,2,283847,283848,283850,1,3,0
81032,4,1,283851,283851,283852,0,1,1
81033,5,2,283856,283856,283858,0,2,4
81034,6,2,283862,283862,283864,0,2,4
81035,2,1,283864,283864,283865,0,1,0
81036,5,2,283869,283869,283871,0,2,4
81037,1,1,283870,283871,283872,1,2,0
81038,6,2,283876,283876,283878,0,2,4
81039,1,3,283877,283878,283881,1,4,0
81040,4,2,283881,283881,283883,0,2,0
81041,1,2,283882,283883,283885,1,3,0
81042,2,2,283884,283885,283887,1,3,0
81043,3,2,283887,283887,283889,0,2,0
81044,6,2,283893,283893,283895,0,2,4
81045,4,2,283897,283897,283899,0,2,2
81046,3,2,283900,283900,283902,0,2,1
81047,5,2,283905,283905,283907,0,2,3
81048,1,2,283906,283907,283909,1,3,0
81049,6,1,283912,283912,283913,0,1,3
81050,3,1,283915,283915,283916,0,1,2
81051,3,3,283918,283918,283921,0,3,2
81052,2,2,283920,283921,283923,1,3,0
81053,6,3,283926,283926,283929,0,3,3
81054,3,1,283929,283929,283930,0,1,0
81055,1,3,283930,283930,283933,0,3,0
81056,4,2,283934,283934,283936,0,2,1
81057,2,1,283936,283936,283937,0,1,0
81058,2,3,283938,283938,283941,0,3,1
81059,4,1,283942,283942,283943,0,1,1
81060,1,2,283943,283943,283945,0,2,0
81061,5,3,283948,283948,283951,0,3,3
81062,6,3,283954,283954,283957,0,3,3
81063,2,2,283956,283957,283959,1,3,0
81064,4,1,283960,283960,283961,0,1,1
81065,3,1,283963,283963,283964,0,1,2
81066,4,3,283967,283967,283970,0,3,3
81067,6,2,283973,283973,283975,0,2,3
81068,2,1,283975,283975,283976,0,1,0
81069,4,3,283979,283979,283982,0,3,3
81070,5,1,283984,283984,283985,0,1,2
81071,5,3,283989,283989,283992,0,3,4
81072,1,1,283990,283992,283993,2,3,0
81073,1,3,283991,283993,283996,2,5,0
81074,4,2,283995,283996,283998,1,3,0
81075,5,1,284000,284000,284001,0,1,2
81076,1,2,284001,284001,284003,0,2,0
81077,2,1,284003,284003,284004,0,1,0
81078,5,3,284008,284008,284011,0,3,4
81079,4,2,284012,284012,284014,0,2,1
81080,5,3,284017,284017,284020,0,3,3
81081,5,2,284022,284022,284024,0,2,2
81082,1,1,284023,284024,284025,1,2,0
81083,3,1,284026,284026,284027,0,1,1
81084,5,1,284031,284031,284032,0,1,4
81085,3,1,284034,284034,284035,0,1,2
81086,4,2,284038,284038,284040,0,2,3
81087,2,3,284040,284040,284043,0,3,0
81088,4,3,284044,284044,284047,0,3,1
81089,1,2,284045,284047,284049,2,4,0
81090,4,1,284049,284049,284050,0,1,0
81091,6,1,284055,284055,284056,0,1,5
81092,5,2,284060,284060,284062,0,2,4
81093,5,3,284065,284065,284068,0,3,3
81094,1,3,284066,284068,284071,2,5,0
81095,1,1,284067,284071,284072,4,5,0
81096,3,1,284070,284072,284073,2,3,0
81097,5,1,284075,284075,284076,0,1,2
81098,3,3,284078,284078,284081,0,3,2
81099,3,3,284081,284081,284084,0,3,0
81100,3,1,284084,284084,284085,0,1,0
81101,2,3,284086,284086,284089,0,3,1
81102,4,3,284090,284090,284093,0,3,1
81103,5,2,284095,284095,284097,0,2,2
81104,5,1,284100,284100,284101,0,1,3
81105,3,2,284103,284103,284105,0,2,2
81106,4,2,284107,284107,284109,0,2,2
81107,3,3,284110,284110,284113,0,3,1
81108,3,3,284113,284113,284116,0,3,0
81109,5,1,284118,284118,284119,0,1,2
81110,2,3,284120,284120,284123,0,3,1
81111,2,3,284122,284123,284126,1,4,0
81112,3,2,284125,284126,284128,1,3,0
81113,2,1,284127,284128,284129,1,2,0
81114,2,2,284129,284129,284131,0,2,0
81115,5,1,284134,284134,284135,0,1,3
81116,6,3,284140,284140,284143,0,3,5
81117,2,2,284142,284143,284145,1,3,0
81118,4,1,284146,284146,284147,0,1,1
81119,2,3,284148,284148,284151,0,3,1
81120,5,1,284153,284153,284154,0,1,2
81121,3,1,284156,284156,284157,0,1,2
81122,4,2,284160,284160,284162,0,2,3
81123,4,3,284164,284164,284167,0,3,2
81124,4,2,284168,284168,284170,0,2,1
81125,1,2,284169,284170,284172,1,3,0
81126,1,3,284170,284172,284175,2,5,0
81127,5,3,284175,284175,284178,0,3,0
81128,4,2,284179,284179,284181,0,2,1
81129,4,2,284183,284183,284185,0,2,2
81130,3,1,284186,284186,284187,0,1,1
81131,5,2,284191,284191,284193,0,2,4
81132,4,1,284195,284195,284196,0,1,2
81133,2,2,284197,284197,284199,0,2,1
81134,4,3,284201,284201,284204,0,3,2
81135,4,3,284205,284205,284208,0,3,1
81136,5,3,284210,284210,284213,0,3,2
81137,3,1,284213,284213,284214,0,1,0
81138,6,1,284219,284219,284220,0,1,5
81139,6,2,284225,284225,284227,0,2,5
81140,5,3,284230,284230,284233,0,3,3
81141,6,1,284236,284236,284237,0,1,3
81142,6,1,284242,284242,284243,0,1,5
81143,6,2,284248,284248,284250,0,2,5
81144,3,1,284251,284251,284252,0,1,1
81145,1,2,284252,284252,284254,0,2,0
81146,1,1,284253,284254,284255,1,2,0
81147,2,1,284255,284255,284256,0,1,0
81148,4,3,284259,284259,284262,0,3,3
81149,6,2,284265,284265,284267,0,2,3
81150,6,1,284271,284271,284272,0,1,4
81151,5,3,284276,284276,284279,0,3,4
81152,3,2,284279,284279,284281,0,2,0
81153,4,1,284283,284283,284284,0,1,2
81154,5,3,284288,284288,284291,0,3,4
81155,2,3,284290,284291,284294,1,4,0
81156,6,1,284296,284296,284297,0,1,2
81157,6,3,284302,284302,284305,0,3,5
81158,2,2,284304,284305,284307,1,3,0
81159,1,3,284305,284307,284310,2,5,0
81160,3,3,284308,284310,284313,2,5,0
81161,4,2,284312,284313,284315,1,3,0
81162,5,3,284317,284317,284320,0,3,2
81163,4,1,284321,284321,284322,0,1,1
81164,6,1,284327,284327,284328,0,1,5
81165,6,2,284333,284333,284335,0,2,5
81166,1,1,284334,284335,284336,1,2,0
81167,1,2,284335,284336,284338,1,3,0
81168,3,3,284338,284338,284341,0,3,0
81169,5,3,284343,284343,284346,0,3,2
81170,4,3,284347,284347,284350,0,3,1
81171,6,3,284353,284353,284356,0,3,3
81172,1,2,284354,284356,284358,2,4,0
81173,4,3,284358,284358,284361,0,3,0
81174,2,3,284360,284361,284364,1,4,0
81175,2,1,284362,284364,284365,2,3,0
81176,4,3,284366,284366,284369,0,3,1
81177,5,3,284371,284371,284374,0,3,2
81178,3,2,284374,284374,284376,0,2,0
81179,1,2,284375,284376,284378,1,3,0
81180,4,3,284379,284379,284382,0,3,1
81181,1,3,284380,284382,284385,2,5,0
81182,6,1,284386,284386,284387,0,1,1
81183,1,1,284387,284387,284388,0,1,0
81184,5,2,284392,284392,284394,0,2,4
81185,3,2,284395,284395,284397,0,2,1
81186,1,3,284396,284397,284400,1,4,0
81187,4,3,284400,284400,284403,0,3,0
81188,5,3,284405,284405,284408,0,3,2
81189,6,2,284411,284411,284413,0,2,3
81190,6,3,284417,284417,284420,0,3,4
81191,3,3,284420,284420,284423,0,3,0
81192,3,2,284423,284423,284425,0,2,0
81193,3,1,284426,284426,284427,0,1,1
81194,4,1,284430,284430,284431,0,1,3
81195,6,2,284436,284436,284438,0,2,5
81196,6,2,284442,284442,284444,0,2,4
81197,6,1,284448,284448,284449,0,1,4
81198,5,3,284453,284453,284456,0,3,4
81199,4,3,284457,284457,284460,0,3,1
81200,1,2,284458,284460,284462,2,4,0
81201,4,1,284462,284462,284463,0,1,0
81202,5,2,284467,284467,284469,0,2,4
81203,6,3,284473,284473,284476,0,3,4
81204,5,3,284478,284478,284481,0,3,2
81205,4,3,284482,284482,284485,0,3,1
81206,1,3,284483,284485,284488,2,5,0
81207,1,3,284484,284488,284491,4,7,0
81208,3,1,284487,284491,284492,4,5,0
81209,2,2,284489,284492,284494,3,5,0
81210,5,1,284494,284494,284495,0,1,0
81211,6,1,284500,284500,284501,0,1,5
81212,3,2,284503,284503,284505,0,2,2
81213,4,2,284507,284507,284509,0,2,2
81214,2,2,284509,284509,284511,0,2,0
81215,5,3,284514,284514,284517,0,3,3
81216,5,2,284519,284519,284521,0,2,2
81217,1,1,284520,284521,284522,1,2,0
81218,5,2,284525,284525,284527,0,2,3
81219,2,1,284527,284527,284528,0,1,0
81220,6,2,284533,284533,284535,0,2,5
81221,6,1,284539,284539,284540,0,1,4
81222,1,1,284540,284540,284541,0,1,0
81223,5,2,284545,284545,284547,0,2,4
81224,1,3,284546,284547,284550,1,4,0
81225,3,1,284549,284550,284551,1,2,0
81226,2,1,284551,284551,284552,0,1,0
81227,1,1,284552,284552,284553,0,1,0
81228,5,2,284557,284557,284559,0,2,4
81229,4,3,284561,284561,284564,0,3,2
81230,3,1,284564,284564,284565,0,1,0
81231,6,3,284570,284570,284573,0,3,5
81232,2,1,284572,284573,284574,1,2,0
81233,6,3,284578,284578,284581,0,3,4
81234,6,2,284584,284584,284586,0,2,3
81235,4,3,284588,284588,284591,0,3,2
81236,6,2,284594,284594,284596,0,2,3
81237,4,1,284598,284598,284599,0,1,2
81238,6,1,284604,284604,284605,0,1,5
81239,1,2,284605,284605,284607,0,2,0
81240,1,2,284606,284607,284609,1,3,0
81241,4,2,284610,284610,284612,0,2,1
81242,4,1,284614,284614,284615,0,1,2
81243,3,2,284617,284617,284619,0,2,2
81244,4,3,284621,284621,284624,0,3,2
81245,1,1,284622,284624,284625,2,3,0
81246,3,1,284625,284625,284626,0,1,0
81247,1,2,284626,284626,284628,0,2,0
81248,5,3,284631,284631,284634,0,3,3
81249,1,1,284632,284634,284635,2,3,0
81250,2,2,284634,284635,284637,1,3,0
81251,5,2,284639,284639,284641,0,2,2
81252,5,2,284644,284644,284646,0,2,3
81253,2,2,284646,284646,284648,0,2,0
81254,4,1,284650,284650,284651,0,1,2
81255,1,1,284651,284651,284652,0,1,0
81256,4,2,284655,284655,284657,0,2,3
81257,5,3,284660,284660,284663,0,3,3
81258,6,3,284666,284666,284669,0,3,3
81259,6,2,284672,284672,284674,0,2,3
81260,5,3,284677,284677,284680,0,3,3
81261,6,1,284683,284683,284684,0,1,3
81262,5,3,284688,284688,284691,0,3,4
81263,5,2,284693,284693,284695,0,2,2
81264,2,1,284695,284695,284696,0,1,0
81265,2,3,284697,284697,284700,0,3,1
81266,5,2,284702,284702,284704,0,2,2
81267,2,3,284704,284704,284707,0,3,0
81268,1,2,284705,284707,284709,2,4,0
81269,1,3,284706,284709,284712,3,6,0
81270,2,2,284708,284712,284714,4,6,0
81271,1,2,284709,284714,284716,5,7,0
81272,5,3,284714,284716,284719,2,5,0
81273,6,3,284720,284720,284723,0,3,1
81274,1,1,284721,284723,284724,2,3,0
81275,1,3,284722,284724,284727,2,5,0
81276,6,3,284728,284728,284731,0,3,1
81277,2,3,284730,284731,284734,1,4,0
81278,2,1,284732,284734,284735,2,3,0
81279,2,1,284734,284735,284736,1,2,0
81280,4,3,284738,284738,284741,0,3,2
81281,5,3,284743,284743,284746,0,3,2
81282,1,1,284744,284746,284747,2,3,0
81283,5,1,284749,284749,284750,0,1,2
81284,3,2,284752,284752,284754,0,2,2
81285,5,1,284757,284757,284758,0,1,3
81286,2,2,284759,284759,284761,0,2,1
81287,6,2,284765,284765,284767,0,2,4
81288,2,3,284767,284767,284770,0,3,0
81289,3,2,284770,284770,284772,0,2,0
81290,5,2,284775,284775,284777,0,2,3
81291,5,1,284780,284780,284781,0,1,3
81292,2,3,284782,284782,284785,0,3,1
81293,1,1,284783,284785,284786,2,3,0
81294,2,3,284785,284786,284789,1,4,0
81295,2,2,284787,284789,284791,2,4,0
81296,2,3,284789,284791,284794,2,5,0
81297,5,2,284794,284794,284796,0,2,0
81298,3,1,284797,284797,284798,0,1,1
81299,6,3,284803,284803,284806,0,3,5
81300,6,3,284809,284809,284812,0,3,3
81301,3,2,284812,284812,284814,0,2,0
81302,3,1,284815,284815,284816,0,1,1
81303,5,3,284820,284820,284823,0,3,4
81304,6,1,284826,284826,284827,0,1,3
81305,1,3,284827,284827,284830,0,3,0
81306,3,1,284830,284830,284831,0,1,0
81307,6,1,284836,284836,284837,0,1,5
81308,4,1,284840,284840,284841,0,1,3
81309,5,1,284845,284845,284846,0,1,4
81310,3,2,284848,284848,284850,0,2,2
81311,1,3,284849,284850,284853,1,4,0
81312,6,1,284855,284855,284856,0,1,2
81313,2,1,284857,284857,284858,0,1,1
81314,1,2,284858,284858,284860,0,2,0
81315,2,2,284860,284860,284862,0,2,0
81316,3,1,284863,284863,284864,0,1,1
81317,5,2,284868,284868,284870,0,2,4
81318,3,1,284871,284871,284872,0,1,1
81319,4,1,284875,284875,284876,0,1,3
81320,4,1,284879,284879,284880,0,1,3
81321,1,3,284880,284880,284883,0,3,0
81322,6,2,284886,284886,284888,0,2,3
81323,4,2,284890,284890,284892,0,2,2
81324,6,3,284896,284896,284899,0,3,4
81325,4,3,284900,284900,284903,0,3,1
81326,2,3,284902,284903,284906,1,4,0
81327,4,1,284906,284906,284907,0,1,0
81328,5,1,284911,284911,284912,0,1,4
81329,3,1,284914,284914,284915,0,1,2
81330,3,3,284917,284917,284920,0,3,2
81331,6,1,284923,284923,284924,0,1,3
81332,4,1,284927,284927,284928,0,1,3
81333,4,2,284931,284931,284933,0,2,3
81334,4,3,284935,284935,284938,0,3,2
81335,3,3,284938,284938,284941,0,3,0
81336,6,3,284944,284944,284947,0,3,3
81337,5,1,284949,284949,284950,0,1,2
81338,1,1,284950,284950,284951,0,1,0
81339,3,1,284953,284953,284954,0,1,2
81340,3,2,284956,284956,284958,0,2,2
81341,4,1,284960,284960,284961,0,1,2
81342,6,1,284966,284966,284967,0,1,5
81343,1,2,284967,284967,284969,0,2,0
81344,5,3,284972,284972,284975,0,3,3
81345,3,3,284975,284975,284978,0,3,0
81346,4,3,284979,284979,284982,0,3,1
81347,2,3,284981,284982,284985,1,4,0
81348,6,1,284987,284987,284988,0,1,2
81349,2,1,284989,284989,284990,0,1,1
81350,5,2,284994,284994,284996,0,2,4
81351,5,2,284999,284999,285001,0,2,3
81352,3,2,285002,285002,285004,0,2,1
81353,2,3,285004,285004,285007,0,3,0
81354,6,2,285010,285010,285012,0,2,3
81355,1,3,285011,285012,285015,1,4,0
81356,5,1,285016,285016,285017,0,1,1
81357,5,3,285021,285021,285024,0,3,4
81358,5,2,285026,285026,285028,0,2,2
81359,1,3,285027,285028,285031,1,4,0
81360,5,3,285032,285032,285035,0,3,1
81361,5,1,285037,285037,285038,0,1,2
81362,4,2,285041,285041,285043,0,2,3
81363,2,3,285043,285043,285046,0,3,0
81364,1,1,285044,285046,285047,2,3,0
81365,6,3,285050,285050,285053,0,3,3
81366,5,3,285055,285055,285058,0,3,2
81367,2,1,285057,285058,285059,1,2,0
81368,3,1,285060,285060,285061,0,1,1
81369,1,2,285061,285061,285063,0,2,0
81370,3,3,285064,285064,285067,0,3,1
81371,1,2,285065,285067,285069,2,4,0
81372,6,1,285071,285071,285072,0,1,2
81373,5,3,285076,285076,285079,0,3,4
81374,1,3,285077,285079,285082,2,5,0
81375,5,3,285082,285082,285085,0,3,0
81376,1,3,285083,285085,285088,2,5,0
81377,4,3,285087,285088,285091,1,4,0
81378,4,1,285091,285091,285092,0,1,0
81379,3,3,285094,285094,285097,0,3,2
81380,1,3,285095,285097,285100,2,5,0
81381,4,1,285099,285100,285101,1,2,0
81382,1,2,285100,285101,285103,1,3,0
81383,1,3,285101,285103,285106,2,5,0
81384,1,1,285102,285106,285107,4,5,0
81385,5,1,285107,285107,285108,0,1,0
81386,3,3,285110,285110,285113,0,3,2
81387,3,2,285113,285113,285115,0,2,0
81388,5,2,285118,285118,285120,0,2,3
81389,6,1,285124,285124,285125,0,1,4
81390,4,3,285128,285128,285131,0,3,3
81391,4,3,285132,285132,285135,0,3,1
81392,3,1,285135,285135,285136,0,1,0
81393,3,1,285138,285138,285139,0,1,2
81394,2,2,285140,285140,285142,0,2,1
81395,5,3,285145,285145,285148,0,3,3
81396,4,1,285149,285149,285150,0,1,1
81397,2,2,285151,285151,285153,0,2,1
81398,2,1,285153,285153,285154,0,1,0
81399,5,3,285158,285158,285161,0,3,4
81400,5,3,285163,285163,285166,0,3,2
81401,6,3,285169,285169,285172,0,3,3
81402,5,1,285174,285174,285175,0,1,2
81403,4,1,285178,285178,285179,0,1,3
81404,2,3,285180,285180,285183,0,3,1
81405,5,2,285185,285185,285187,0,2,2
81406,2,3,285187,285187,285190,0,3,0
81407,5,3,285192,285192,285195,0,3,2
81408,1,1,285193,285195,285196,2,3,0
81409,1,1,285194,285196,285197,2,3,0
81410,6,3,285200,285200,285203,0,3,3
81411,3,2,285203,285203,285205,0,2,0
81412,2,1,285205,285205,285206,0,1,0
81413,4,3,285209,285209,285212,0,3,3
81414,4,2,285213,285213,285215,0,2,1
81415,2,1,285215,285215,285216,0,1,0
81416,6,2,285221,285221,285223,0,2,5
81417,1,3,285222,285223,285226,1,4,0
81418,1,2,285223,285226,285228,3,5,0
81419,4,1,285227,285228,285229,1,2,0
81420,2,3,285229,285229,285232,0,3,0
81421,4,1,285233,285233,285234,0,1,1
81422,6,3,285239,285239,285242,0,3,5
81423,6,2,285245,285245,285247,0,2,3
81424,4,2,285249,285249,285251,0,2,2
81425,2,2,285251,285251,285253,0,2,0
81426,5,2,285256,285256,285258,0,2,3
81427,5,3,285261,285261,285264,0,3,3
81428,6,3,285267,285267,285270,0,3,3
81429,3,1,285270,285270,285271,0,1,0
81430,4,1,285274,285274,285275,0,1,3
81431,3,2,285277,285277,285279,0,2,2
81432,3,2,285280,285280,285282,0,2,1
81433,1,2,285281,285282,285284,1,3,0
81434,2,1,285283,285284,285285,1,2,0
81435,6,3,285289,285289,285292,0,3,4
81436,6,3,285295,285295,285298,0,3,3
81437,3,2,285298,285298,285300,0,2,0
81438,4,3,285302,285302,285305,0,3,2
81439,6,1,285308,285308,285309,0,1,3
81440,6,2,285314,285314,285316,0,2,5
81441,6,2,285320,285320,285322,0,2,4
81442,6,1,285326,285326,285327,0,1,4
81443,2,1,285328,285328,285329,0,1,1
81444,3,2,285331,285331,285333,0,2,2
81445,5,3,285336,285336,285339,0,3,3
81446,3,1,285339,285339,285340,0,1,0
81447,1,1,285340,285340,285341,0,1,0
81448,4,3,285344,285344,285347,0,3,3
81449,4,1,285348,285348,285349,0,1,1
81450,3,3,285351,285351,285354,0,3,2
81451,4,2,285355,285355,285357,0,2,1
81452,5,1,285360,285360,285361,0,1,3
81453,4,3,285364,285364,285367,0,3,3
81454,3,1,285367,285367,285368,0,1,0
81455,5,2,285372,285372,285374,0,2,4
81456,2,3,285374,285374,285377,0,3,0
81457,1,2,285375,285377,285379,2,4,0
81458,3,1,285378,285379,285380,1,2,0
81459,6,2,285384,285384,285386,0,2,4
81460,3,1,285387,285387,285388,0,1,1
81461,6,1,285393,285393,285394,0,1,5
81462,5,2,285398,285398,285400,0,2,4
81463,3,1,285401,285401,285402,0,1,1
81464,6,3,285407,285407,285410,0,3,5
81465,4,2,285411,285411,285413,0,2,1
81466,3,2,285414,285414,285416,0,2,1
81467,2,1,285416,285416,285417,0,1,0
81468,1,2,285417,285417,285419,0,2,0
81469,5,3,285422,285422,285425,0,3,3
81470,5,3,285427,285427,285430,0,3,2
81471,4,2,285431,285431,285433,0,2,1
81472,1,1,285432,285433,285434,1,2,0
81473,3,1,285435,285435,285436,0,1,1
81474,3,1,285438,285438,285439,0,1,2
81475,4,3,285442,285442,285445,0,3,3
81476,3,1,285445,285445,285446,0,1,0
81477,2,2,285447,285447,285449,0,2,1
81478,3,2,285450,285450,285452,0,2,1
81479,6,2,285456,285456,285458,0,2,4
81480,5,1,285461,285461,285462,0,1,3
81481,2,1,285463,285463,285464,0,1,1
81482,5,1,285468,285468,285469,0,1,4
81483,2,1,285470,285470,285471,0,1,1
81484,6,2,285476,285476,285478,0,2,5
81485,4,2,285480,285480,285482,0,2,2
81486,6,1,285486,285486,285487,0,1,4
81487,5,3,285491,285491,285494,0,3,4
81488,3,3,285494,285494,285497,0,3,0
81489,4,2,285498,285498,285500,0,2,1
81490,3,1,285501,285501,285502,0,1,1
81491,3,3,285504,285504,285507,0,3,2
81492,1,2,285505,285507,285509,2,4,0
81493,4,1,285509,285509,285510,0,1,0
81494,2,2,285511,285511,285513,0,2,1
81495,1,3,285512,285513,285516,1,4,0
81496,4,1,285516,285516,285517,0,1,0
81497,6,3,285522,285522,285525,0,3,5
81498,6,1,285528,285528,285529,0,1,3
81499,1,2,285529,285529,285531,0,2,0
81500,4,2,285533,285533,285535,0,2,2
81501,4,1,285537,285537,285538,0,1,2
81502,5,2,285542,285542,285544,0,2,4
81503,5,1,285547,285547,285548,0,1,3
81504,3,3,285550,285550,285553,0,3,2
81505,3,3,285553,285553,285556,0,3,0
81506,2,3,285555,285556,285559,1,4,0
81507,1,2,285556,285559,285561,3,5,0
81508,6,2,285562,285562,285564,0,2,1
81509,6,1,285568,285568,285569,0,1,4
81510,3,2,285571,285571,285573,0,2,2
81511,2,2,285573,285573,285575,0,2,0
81512,2,1,285575,285575,285576,0,1,0
81513,5,2,285580,285580,285582,0,2,4
81514,2,2,285582,285582,285584,0,2,0
81515,6,2,285588,285588,285590,0,2,4
81516,6,1,285594,285594,285595,0,1,4
81517,6,1,285600,285600,285601,0,1,5
81518,6,2,285606,285606,285608,0,2,5
81519,4,2,285610,285610,285612,0,2,2
81520,4,2,285614,285614,285616,0,2,2
81521,1,2,285615,285616,285618,1,3,0
81522,3,3,285618,285618,285621,0,3,0
81523,6,1,285624,285624,285625,0,1,3
81524,1,3,285625,285625,285628,0,3,0
81525,2,2,285627,285628,285630,1,3,0
81526,4,1,285631,285631,285632,0,1,1
81527,6,2,285637,285637,285639,0,2,5
81528,1,1,285638,285639,285640,1,2,0
81529,4,2,285642,285642,285644,0,2,2
81530,6,1,285648,285648,285649,0,1,4
81531,5,2,285653,285653,285655,0,2,4
81532,1,1,285654,285655,285656,1,2,0
81533,3,2,285657,285657,285659,0,2,1
81534,2,1,285659,285659,285660,0,1,0
81535,4,3,285663,285663,285666,0,3,3
81536,5,2,285668,285668,285670,0,2,2
81537,1,1,285669,285670,285671,1,2,0
81538,3,1,285672,285672,285673,0,1,1
81539,3,3,285675,285675,285678,0,3,2
81540,6,1,285681,285681,285682,0,1,3
81541,5,2,285686,285686,285688,0,2,4
81542,3,3,285689,285689,285692,0,3,1
81543,4,3,285693,285693,285696,0,3,1
81544,2,1,285695,285696,285697,1,2,0
81545,4,2,285699,285699,285701,0,2,2
81546,2,2,285701,285701,285703,0,2,0
81547,2,3,285703,285703,285706,0,3,0
81548,2,2,285705,285706,285708,1,3,0
81549,5,1,285710,285710,285711,0,1,2
81550,1,1,285711,285711,285712,0,1,0
81551,1,3,285712,285712,285715,0,3,0
81552,5,3,285717,285717,285720,0,3,2
81553,6,2,285723,285723,285725,0,2,3
81554,2,3,285725,285725,285728,0,3,0
81555,6,1,285731,285731,285732,0,1,3
81556,3,3,285734,285734,285737,0,3,2
81557,3,2,285737,285737,285739,0,2,0
81558,5,2,285742,285742,285744,0,2,3
81559,3,1,285745,285745,285746,0,1,1
81560,4,3,285749,285749,285752,0,3,3
81561,6,1,285755,285755,285756,0,1,3
81562,2,2,285757,285757,285759,0,2,1
81563,1,2,285758,285759,285761,1,3,0
81564,4,3,285762,285762,285765,0,3,1
81565,5,1,285767,285767,285768,0,1,2
81566,1,2,285768,285768,285770,0,2,0
81567,1,1,285769,285770,285771,1,2,0
81568,5,2,285774,285774,285776,0,2,3
81569,3,3,285777,285777,285780,0,3,1
81570,4,1,285781,285781,285782,0,1,1
81571,6,2,285787,285787,285789,0,2,5
81572,1,3,285788,285789,285792,1,4,0
81573,4,2,285792,285792,285794,0,2,0
81574,1,2,285793,285794,285796,1,3,0
81575,1,1,285794,285796,285797,2,3,0
81576,1,3,285795,285797,285800,2,5,0
81577,2,2,285797,285800,285802,3,5,0
81578,4,2,285801,285802,285804,1,3,0
81579,3,3,285804,285804,285807,0,3,0
81580,5,2,285809,285809,285811,0,2,2
81581,1,1,285810,285811,285812,1,2,0
81582,1,3,285811,285812,285815,1,4,0
81583,1,3,285812,285815,285818,3,6,0
81584,2,1,285814,285818,285819,4,5,0
81585,5,1,285819,285819,285820,0,1,0
81586,1,1,285820,285820,285821,0,1,0
81587,5,1,285825,285825,285826,0,1,4
81588,6,2,285831,285831,285833,0,2,5
81589,2,2,285833,285833,285835,0,2,0
81590,2,1,285835,285835,285836,0,1,0
81591,4,3,285839,285839,285842,0,3,3
81592,4,1,285843,285843,285844,0,1,1
81593,1,3,285844,285844,285847,0,3,0
81594,3,3,285847,285847,285850,0,3,0
81595,6,1,285853,285853,285854,0,1,3
81596,2,3,285855,285855,285858,0,3,1
81597,2,3,285857,285858,285861,1,4,0
81598,1,3,285858,285861,285864,3,6,0
81599,4,1,285862,285864,285865,2,3,0
81600,1,2,285863,285865,285867,2,4,0
81601,5,1,285868,285868,285869,0,1,1
81602,4,1,285872,285872,285873,0,1,3
81603,2,2,285874,285874,285876,0,2,1
81604,4,3,285878,285878,285881,0,3,2
81605,6,2,285884,285884,285886,0,2,3
81606,4,1,285888,285888,285889,0,1,2
81607,2,1,285890,285890,285891,0,1,1
81608,4,2,285894,285894,285896,0,2,3
81609,6,3,285900,285900,285903,0,3,4
81610,4,1,285904,285904,285905,0,1,1
81611,2,3,285906,285906,285909,0,3,1
81612,2,1,285908,285909,285910,1,2,0
81613,3,1,285911,285911,285912,0,1,1
81614,1,3,285912,285912,285915,0,3,0
81615,2,2,285914,285915,285917,1,3,0
81616,1,3,285915,285917,285920,2,5,0
81617,5,1,285920,285920,285921,0,1,0
81618,1,2,285921,285921,285923,0,2,0
81619,1,2,285922,285923,285925,1,3,0
81620,5,2,285927,285927,285929,0,2,2
81621,4,1,285931,285931,285932,0,1,2
81622,6,3,285937,285937,285940,0,3,5
81623,3,1,285940,285940,285941,0,1,0
81624,2,2,285942,285942,285944,0,2,1
81625,4,3,285946,285946,285949,0,3,2
81626,6,1,285952,285952,285953,0,1,3
81627,1,2,285953,285953,285955,0,2,0
81628,5,1,285958,285958,285959,0,1,3
81629,4,2,285962,285962,285964,0,2,3
81630,5,3,285967,285967,285970,0,3,3
81631,3,1,285970,285970,285971,0,1,0
81632,1,1,285971,285971,285972,0,1,0
81633,3,3,285974,285974,285977,0,3,2
81634,6,2,285980,285980,285982,0,2,3
81635,2,1,285982,285982,285983,0,1,0
81636,5,1,285987,285987,285988,0,1,4
81637,3,3,285990,285990,285993,0,3,2
81638,4,3,285994,285994,285997,0,3,1
81639,4,2,285998,285998,286000,0,2,1
81640,5,2,286003,286003,286005,0,2,3
81641,2,1,286005,286005,286006,0,1,0
81642,2,2,286007,286007,286009,0,2,1
81643,1,1,286008,286009,286010,1,2,0
81644,3,3,286011,286011,286014,0,3,1
81645,6,2,286017,286017,286019,0,2,3
81646,5,2,286022,286022,286024,0,2,3
81647,6,3,286028,286028,286031,0,3,4
81648,4,2,286032,286032,286034,0,2,1
81649,3,2,286035,286035,286037,0,2,1
81650,5,1,286040,286040,286041,0,1,3
81651,4,1,286044,286044,286045,0,1,3
81652,3,2,286047,286047,286049,0,2,2
81653,1,1,286048,286049,286050,1,2,0
81654,5,3,286053,286053,286056,0,3,3
81655,1,1,286054,286056,286057,2,3,0
81656,6,1,286060,286060,286061,0,1,3
81657,2,1,286062,286062,286063,0,1,1
81658,5,2,286067,286067,286069,0,2,4
81659,6,2,286073,286073,286075,0,2,4
81660,3,2,286076,286076,286078,0,2,1
81661,1,2,286077,286078,286080,1,3,0
81662,1,1,286078,286080,286081,2,3,0
81663,1,3,286079,286081,286084,2,5,0
81664,3,2,286082,286084,286086,2,4,0
81665,4,3,286086,286086,286089,0,3,0
81666,3,1,286089,286089,286090,0,1,0
81667,3,3,286092,286092,286095,0,3,2
81668,4,1,286096,286096,286097,0,1,1
81669,4,2,286100,286100,286102,0,2,3
81670,4,1,286104,286104,286105,0,1,2
81671,3,2,286107,286107,286109,0,2,2
81672,5,1,286112,286112,286113,0,1,3
81673,6,2,286118,286118,286120,0,2,5
81674,2,2,286120,286120,286122,0,2,0
81675,2,3,286122,286122,286125,0,3,0
81676,4,1,286126,286126,286127,0,1,1
81677,1,3,286127,286127,286130,0,3,0
81678,4,2,286131,286131,286133,0,2,1
81679,3,1,286134,286134,286135,0,1,1
81680,3,1,286137,286137,286138,0,1,2
81681,2,1,286139,286139,286140,0,1,1
81682,4,3,286143,286143,286146,0,3,3
81683,2,3,286145,286146,286149,1,4,0
81684,6,3,286151,286151,286154,0,3,2
81685,3,1,286154,286154,286155,0,1,0
81686,5,1,286159,286159,286160,0,1,4
81687,4,1,286163,286163,286164,0,1,3
81688,3,3,286166,286166,286169,0,3,2
81689,2,3,286168,286169,286172,1,4,0
81690,4,2,286172,286172,286174,0,2,0
81691,4,1,286176,286176,286177,0,1,2
81692,3,3,286179,286179,286182,0,3,2
81693,5,2,286184,286184,286186,0,2,2
81694,5,2,286189,286189,286191,0,2,3
81695,4,2,286193,286193,286195,0,2,2
81696,6,2,286199,286199,286201,0,2,4
81697,4,1,286203,286203,286204,0,1,2
81698,3,3,286206,286206,286209,0,3,2
81699,3,2,286209,286209,286211,0,2,0
81700,2,1,286211,286211,286212,0,1,0
81701,4,3,286215,286215,286218,0,3,3
81702,2,2,286217,286218,286220,1,3,0
81703,2,1,286219,286220,286221,1,2,0
81704,4,1,286223,286223,286224,0,1,2
81705,1,3,286224,286224,286227,0,3,0
81706,1,2,286225,286227,286229,2,4,0
81707,3,3,286228,286229,286232,1,4,0
81708,1,3,286229,286232,286235,3,6,0
81709,5,2,286234,286235,286237,1,3,0
81710,6,3,286240,286240,286243,0,3,3
81711,1,3,286241,286243,286246,2,5,0
81712,6,1,286247,286247,286248,0,1,1
81713,2,1,286249,286249,286250,0,1,1
81714,2,1,286251,286251,286252,0,1,1
81715,2,2,286253,286253,286255,0,2,1
81716,2,3,286255,286255,286258,0,3,0
81717,2,3,286257,286258,286261,1,4,0
81718,4,2,286261,286261,286263,0,2,0
81719,5,1,286266,286266,286267,0,1,3
81720,1,2,286267,286267,286269,0,2,0
81721,2,1,286269,286269,286270,0,1,0
81722,3,3,286272,286272,286275,0,3,2
81723,6,3,286278,286278,286281,0,3,3
81724,1,1,286279,286281,286282,2,3,0
81725,2,1,286281,286282,286283,1,2,0
81726,6,3,286287,286287,286290,0,3,4
81727,4,2,286291,286291,286293,0,2,1
81728,3,3,286294,286294,286297,0,3,1
81729,5,1,286299,286299,286300,0,1,2
81730,3,2,286302,286302,286304,0,2,2
81731,1,3,286303,286304,286307,1,4,0
81732,6,1,286309,286309,286310,0,1,2
81733,1,1,286310,286310,286311,0,1,0
81734,1,3,286311,286311,286314,0,3,0
81735,2,3,286313,286314,286317,1,4,0
81736,6,2,286319,286319,286321,0,2,2
81737,6,1,286325,286325,286326,0,1,4
81738,2,1,286327,286327,286328,0,1,1
81739,1,2,286328,286328,286330,0,2,0
81740,6,3,286334,286334,286337,0,3,4
81741,2,2,286336,286337,286339,1,3,0
81742,6,3,286342,286342,286345,0,3,3
81743,3,3,286345,286345,286348,0,3,0
81744,2,3,286347,286348,286351,1,4,0
81745,5,3,286352,286352,286355,0,3,1
81746,6,2,286358,286358,286360,0,2,3
81747,4,1,286362,286362,286363,0,1,2
81748,5,2,286367,286367,286369,0,2,4
81749,5,3,286372,286372,286375,0,3,3
81750,5,3,286377,286377,286380,0,3,2
81751,2,1,286379,286380,286381,1,2,0
81752,6,1,286385,286385,286386,0,1,4
81753,6,1,286391,286391,286392,0,1,5
81754,2,2,286393,286393,286395,0,2,1
81755,5,3,286398,286398,286401,0,3,3
81756,5,2,286403,286403,286405,0,2,2
81757,5,3,286408,286408,286411,0,3,3
81758,1,2,286409,286411,286413,2,4,0
81759,1,2,286410,286413,286415,3,5,0
81760,1,3,286411,286415,286418,4,7,0
81761,5,1,286416,286418,286419,2,3,0
81762,1,1,286417,286419,286420,2,3,0
81763,5,3,286422,286422,286425,0,3,2
81764,4,3,286426,286426,286429,0,3,1
81765,3,3,286429,286429,286432,0,3,0
81766,2,3,286431,286432,286435,1,4,0
81767,6,1,286437,286437,286438,0,1,2
81768,1,3,286438,286438,286441,0,3,0
81769,1,3,286439,286441,286444,2,5,0
81770,5,1,286444,286444,286445,0,1,0
81771,1,2,286445,286445,286447,0,2,0
81772,1,3,286446,286447,286450,1,4,0
81773,6,3,286452,286452,286455,0,3,2
81774,5,3,286457,286457,286460,0,3,2
81775,6,1,286463,286463,286464,0,1,3
81776,3,3,286466,286466,286469,0,3,2
81777,1,2,286467,286469,286471,2,4,0
81778,1,3,286468,286471,286474,3,6,0
81779,1,1,286469,286474,286475,5,6,0
81780,4,1,286473,286475,286476,2,3,0
81781,5,1,286478,286478,286479,0,1,2
81782,2,1,286480,286480,286481,0,1,1
81783,6,3,286486,286486,286489,0,3,5
81784,4,2,286490,286490,286492,0,2,1
81785,1,2,286491,286492,286494,1,3,0
81786,6,2,286497,286497,286499,0,2,3
81787,1,1,286498,286499,286500,1,2,0
81788,2,1,286500,286500,286501,0,1,0
81789,3,2,286503,286503,286505,0,2,2
81790,5,1,286508,286508,286509,0,1,3
81791,6,1,286514,286514,286515,0,1,5
81792,1,1,286515,286515,286516,0,1,0
81793,3,1,286518,286518,286519,0,1,2
81794,4,3,286522,286522,286525,0,3,3
81795,3,2,286525,286525,286527,0,2,0
81796,5,1,286530,286530,286531,0,1,3
81797,1,2,286531,286531,286533,0,2,0
81798,3,2,286534,286534,286536,0,2,1
81799,5,1,286539,286539,286540,0,1,3
81800,5,1,286544,286544,286545,0,1,4
81801,1,3,286545,286545,286548,0,3,0
81802,6,3,286551,286551,286554,0,3,3
81803,6,3,286557,286557,286560,0,3,3
81804,3,1,286560,286560,286561,0,1,0
81805,6,2,286566,286566,286568,0,2,5
81806,5,1,286571,286571,286572,0,1,3
81807,3,2,286574,286574,286576,0,2,2
81808,3,3,286577,286577,286580,0,3,1
81809,6,2,286583,286583,286585,0,2,3
81810,1,3,286584,286585,286588,1,4,0
81811,4,2,286588,286588,286590,0,2,0
81812,1,1,286589,286590,286591,1,2,0
81813,1,3,286590,286591,286594,1,4,0
81814,6,3,286596,286596,286599,0,3,2
81815,3,1,286599,286599,286600,0,1,0
81816,2,3,286601,286601,286604,0,3,1
81817,3,2,286604,286604,286606,0,2,0
81818,5,2,286609,286609,286611,0,2,3
81819,1,3,286610,286611,286614,1,4,0
81820,4,1,286614,286614,286615,0,1,0
81821,3,1,286617,286617,286618,0,1,2
81822,5,1,286622,286622,286623,0,1,4
81823,3,3,286625,286625,286628,0,3,2
81824,4,1,286629,286629,286630,0,1,1
81825,3,2,286632,286632,286634,0,2,2
81826,6,3,286638,286638,286641,0,3,4
81827,6,1,286644,286644,286645,0,1,3
81828,2,3,286646,286646,286649,0,3,1
81829,4,2,286650,286650,286652,0,2,1
81830,2,3,286652,286652,286655,0,3,0
81831,2,2,286654,286655,286657,1,3,0
81832,6,3,286660,286660,286663,0,3,3
81833,2,3,286662,286663,286666,1,4,0
81834,1,1,286663,286666,286667,3,4,0
81835,5,1,286668,286668,286669,0,1,1
81836,1,1,286669,286669,286670,0,1,0
81837,6,1,286675,286675,286676,0,1,5
81838,6,1,286681,286681,286682,0,1,5
81839,6,1,286687,286687,286688,0,1,5
81840,5,2,286692,286692,286694,0,2,4
81841,6,3,286698,286698,286701,0,3,4
81842,3,2,286701,286701,286703,0,2,0
81843,3,3,286704,286704,286707,0,3,1
81844,3,1,286707,286707,286708,0,1,0
81845,3,3,286710,286710,286713,0,3,2
81846,2,2,286712,286713,286715,1,3,0
81847,3,1,286715,286715,286716,0,1,0
81848,5,1,286720,286720,286721,0,1,4
81849,6,3,286726,286726,286729,0,3,5
81850,2,2,286728,286729,286731,1,3,0
81851,2,2,286730,286731,286733,1,3,0
81852,6,1,286736,286736,286737,0,1,3
81853,1,3,286737,286737,286740,0,3,0
81854,4,1,286741,286741,286742,0,1,1
81855,1,2,286742,286742,286744,0,2,0
81856,3,3,286745,286745,286748,0,3,1
81857,1,1,286746,286748,286749,2,3,0
81858,1,3,286747,286749,286752,2,5,0
81859,1,3,286748,286752,286755,4,7,0
81860,2,3,286750,286755,286758,5,8,0
81861,6,3,286756,286758,286761,2,5,0
81862,2,1,286758,286761,286762,3,4,0
81863,5,2,286763,286763,286765,0,2,1
81864,3,2,286766,286766,286768,0,2,1
81865,2,1,286768,286768,286769,0,1,0
81866,4,2,286772,286772,286774,0,2,3
81867,3,2,286775,286775,286777,0,2,1
81868,1,2,286776,286777,286779,1,3,0
81869,6,3,286782,286782,286785,0,3,3
81870,6,1,286788,286788,286789,0,1,3
81871,4,1,286792,286792,286793,0,1,3
81872,6,2,286798,286798,286800,0,2,5
81873,4,2,286802,286802,286804,0,2,2
81874,5,2,286807,286807,286809,0,2,3
81875,4,3,286811,286811,286814,0,3,2
81876,6,3,286817,286817,286820,0,3,3
81877,1,1,286818,286820,286821,2,3,0
81878,4,1,286822,286822,286823,0,1,1
81879,6,1,286828,286828,286829,0,1,5
81880,4,3,286832,286832,286835,0,3,3
81881,1,3,286833,286835,286838,2,5,0
81882,5,2,286838,286838,286840,0,2,0
81883,4,1,286842,286842,286843,0,1,2
81884,2,3,286844,286844,286847,0,3,1
81885,4,2,286848,286848,286850,0,2,1
81886,2,2,286850,286850,286852,0,2,0
81887,6,2,286856,286856,286858,0,2,4
81888,2,2,286858,286858,286860,0,2,0
81889,3,2,286861,286861,286863,0,2,1
81890,6,2,286867,286867,286869,0,2,4
81891,6,3,286873,286873,286876,0,3,4
81892,6,2,286879,286879,286881,0,2,3
81893,1,1,286880,286881,286882,1,2,0
81894,1,2,286881,286882,286884,1,3,0
81895,1,1,286882,286884,286885,2,3,0
81896,2,2,286884,286885,286887,1,3,0
81897,3,1,286887,286887,286888,0,1,0
81898,5,2,286892,286892,286894,0,2,4
81899,6,1,286898,286898,286899,0,1,4
81900,4,3,286902,286902,286905,0,3,3
81901,5,2,286907,286907,286909,0,2,2
81902,6,1,286913,286913,286914,0,1,4
81903,1,1,286914,286914,286915,0,1,0
81904,6,3,286920,286920,286923,0,3,5
81905,3,3,286923,286923,286926,0,3,0
81906,2,1,286925,286926,286927,1,2,0
81907,5,2,286930,286930,286932,0,2,3
81908,1,3,286931,286932,286935,1,4,0
81909,4,2,286935,286935,286937,0,2,0
81910,6,2,286941,286941,286943,0,2,4
81911,3,1,286944,286944,286945,0,1,1
81912,5,1,286949,286949,286950,0,1,4
81913,5,1,286954,286954,286955,0,1,4
81914,1,3,286955,286955,286958,0,3,0
81915,6,1,286961,286961,286962,0,1,3
81916,6,2,286967,286967,286969,0,2,5
81917,2,3,286969,286969,286972,0,3,0
81918,5,3,286974,286974,286977,0,3,2
81919,3,3,286977,286977,286980,0,3,0
81920,5,3,286982,286982,286985,0,3,2
81921,6,3,286988,286988,286991,0,3,3
81922,1,3,286989,286991,286994,2,5,0
81923,2,1,286991,286994,286995,3,4,0
81924,5,2,286996,286996,286998,0,2,1
81925,4,2,287000,287000,287002,0,2,2
81926,2,2,287002,287002,287004,0,2,0
81927,2,2,287004,287004,287006,0,2,0
81928,4,3,287008,287008,287011,0,3,2
81929,5,2,287013,287013,287015,0,2,2
81930,5,2,287018,287018,287020,0,2,3
81931,4,3,287022,287022,287025,0,3,2
81932,5,2,287027,287027,287029,0,2,2
81933,2,2,287029,287029,287031,0,2,0
81934,6,2,287035,287035,287037,0,2,4
81935,5,3,287040,287040,287043,0,3,3
81936,3,3,287043,287043,287046,0,3,0
81937,2,1,287045,287046,287047,1,2,0
81938,1,2,287046,287047,287049,1,3,0
81939,3,2,287049,287049,287051,0,2,0
81940,2,1,287051,287051,287052,0,1,0
81941,3,3,287054,287054,287057,0,3,2
81942,4,2,287058,287058,287060,0,2,1
81943,1,3,287059,287060,287063,1,4,0
81944,3,1,287062,287063,287064,1,2,0
81945,4,2,287066,287066,287068,0,2,2
81946,4,3,287070,287070,287073,0,3,2
81947,6,1,287076,287076,287077,0,1,3
81948,1,3,287077,287077,287080,0,3,0
81949,5,3,287082,287082,287085,0,3,2
81950,4,2,287086,287086,287088,0,2,1
81951,2,2,287088,287088,287090,0,2,0
81952,3,2,287091,287091,287093,0,2,1
81953,3,1,287094,287094,287095,0,1,1
81954,1,1,287095,287095,287096,0,1,0
81955,1,1,287096,287096,287097,0,1,0
81956,6,1,287102,287102,287103,0,1,5
81957,4,2,287106,287106,287108,0,2,3
81958,1,2,287107,287108,287110,1,3,0
81959,1,1,287108,287110,287111,2,3,0
81960,4,2,287112,287112,287114,0,2,1
81961,5,3,287117,287117,287120,0,3,3
81962,4,3,287121,287121,287124,0,3,1
81963,1,1,287122,287124,287125,2,3,0
81964,6,3,287128,287128,287131,0,3,3
81965,2,2,287130,287131,287133,1,3,0
81966,1,1,287131,287133,287134,2,3,0
81967,1,1,287132,287134,287135,2,3,0
81968,6,3,287138,287138,287141,0,3,3
81969,1,3,287139,287141,287144,2,5,0
81970,3,2,287142,287144,287146,2,4,0
81971,1,2,287143,287146,287148,3,5,0
81972,3,3,287146,287148,287151,2,5,0
81973,1,2,287147,287151,287153,4,6,0
81974,6,2,287153,287153,287155,0,2,0
81975,6,2,287159,287159,287161,0,2,4
81976,3,1,287162,287162,287163,0,1,1
81977,6,3,287168,287168,287171,0,3,5
81978,3,3,287171,287171,287174,0,3,0
81979,2,1,287173,287174,287175,1,2,0
81980,2,1,287175,287175,287176,0,1,0
81981,2,2,287177,287177,287179,0,2,1
81982,5,2,287182,287182,287184,0,2,3
81983,3,2,287185,287185,287187,0,2,1
81984,3,3,287188,287188,287191,0,3,1
81985,5,1,287193,287193,287194,0,1,2
81986,3,1,287196,287196,287197,0,1,2
81987,2,2,287198,287198,287200,0,2,1
81988,4,2,287202,287202,287204,0,2,2
81989,4,1,287206,287206,287207,0,1,2
81990,4,1,287210,287210,287211,0,1,3
81991,3,2,287213,287213,287215,0,2,2
81992,2,2,287215,287215,287217,0,2,0
81993,5,2,287220,287220,287222,0,2,3
81994,6,1,287226,287226,287227,0,1,4
81995,3,1,287229,287229,287230,0,1,2
81996,1,2,287230,287230,287232,0,2,0
81997,1,1,287231,287232,287233,1,2,0
81998,5,3,287236,287236,287239,0,3,3
81999,2,1,287238,287239,287240,1,2,0
82000,4,2,287242,287242,287244,0,2,2
82001,6,2,287248,287248,287250,0,2,4
82002,1,2,287249,287250,287252,1,3,0
82003,6,3,287255,287255,287258,0,3,3
82004,1,2,287256,287258,287260,2,4,0
82005,5,1,287261,287261,287262,0,1,1
82006,2,2,287263,287263,287265,0,2,1
82007,6,2,287269,287269,287271,0,2,4
82008,3,2,287272,287272,287274,0,2,1
82009,4,1,287276,287276,287277,0,1,2
82010,4,3,287280,287280,287283,0,3,3
82011,5,1,287285,287285,287286,0,1,2
82012,2,2,287287,287287,287289,0,2,1
82013,5,2,287292,287292,287294,0,2,3
82014,2,1,287294,287294,287295,0,1,0
82015,4,1,287298,287298,287299,0,1,3
82016,6,3,287304,287304,287307,0,3,5
82017,2,2,287306,287307,287309,1,3,0
82018,6,2,287312,287312,287314,0,2,3
82019,5,1,287317,287317,287318,0,1,3
82020,1,1,287318,287318,287319,0,1,0
82021,5,3,287323,287323,287326,0,3,4
82022,1,2,287324,287326,287328,2,4,0
82023,6,2,287330,287330,287332,0,2,2
82024,2,1,287332,287332,287333,0,1,0
82025,5,3,287337,287337,287340,0,3,4
82026,4,3,287341,287341,287344,0,3,1
82027,2,2,287343,287344,287346,1,3,0
82028,1,3,287344,287346,287349,2,5,0
82029,6,1,287350,287350,287351,0,1,1
82030,3,3,287353,287353,287356,0,3,2
82031,4,1,287357,287357,287358,0,1,1
82032,3,2,287360,287360,287362,0,2,2
82033,1,1,287361,287362,287363,1,2,0
82034,5,2,287366,287366,287368,0,2,3
82035,5,1,287371,287371,287372,0,1,3
82036,3,2,287374,287374,287376,0,2,2
82037,5,1,287379,287379,287380,0,1,3
82038,3,3,287382,287382,287385,0,3,2
82039,2,2,287384,287385,287387,1,3,0
82040,5,2,287389,287389,287391,0,2,2
82041,4,3,287393,287393,287396,0,3,2
82042,6,3,287399,287399,287402,0,3,3
82043,5,2,287404,287404,287406,0,2,2
82044,3,2,287407,287407,287409,0,2,1
82045,5,3,287412,287412,287415,0,3,3
82046,1,2,287413,287415,287417,2,4,0
82047,4,2,287417,287417,287419,0,2,0
82048,6,2,287423,287423,287425,0,2,4
82049,3,3,287426,287426,287429,0,3,1
82050,1,1,287427,287429,287430,2,3,0
82051,6,1,287433,287433,287434,0,1,3
82052,3,2,287436,287436,287438,0,2,2
82053,4,3,287440,287440,287443,0,3,2
82054,1,3,287441,287443,287446,2,5,0
82055,1,1,287442,287446,287447,4,5,0
82056,2,2,287444,287447,287449,3,5,0
82057,4,1,287448,287449,287450,1,2,0
82058,3,2,287451,287451,287453,0,2,1
82059,5,2,287456,287456,287458,0,2,3
82060,3,3,287459,287459,287462,0,3,1
82061,1,3,287460,287462,287465,2,5,0
82062,2,3,287462,287465,287468,3,6,0
82063,6,2,287468,287468,287470,0,2,0
82064,3,3,287471,287471,287474,0,3,1
82065,1,1,287472,287474,287475,2,3,0
82066,1,3,287473,287475,287478,2,5,0
82067,1,2,287474,287478,287480,4,6,0
82068,3,2,287477,287480,287482,3,5,0
82069,5,2,287482,287482,287484,0,2,0
82070,6,2,287488,287488,287490,0,2,4
82071,2,3,287490,287490,287493,0,3,0
82072,4,2,287494,287494,287496,0,2,1
82073,4,1,287498,287498,287499,0,1,2
82074,4,3,287502,287502,287505,0,3,3
82075,3,2,287505,287505,287507,0,2,0
82076,6,2,287511,287511,287513,0,2,4
82077,6,2,287517,287517,287519,0,2,4
82078,3,1,287520,287520,287521,0,1,1
82079,1,2,287521,287521,287523,0,2,0
82080,6,1,287527,287527,287528,0,1,4
82081,5,2,287532,287532,287534,0,2,4
82082,5,1,287537,287537,287538,0,1,3
82083,4,1,287541,287541,287542,0,1,3
82084,4,1,287545,287545,287546,0,1,3
82085,5,3,287550,287550,287553,0,3,4
82086,5,3,287555,287555,287558,0,3,2
82087,1,1,287556,287558,287559,2,3,0
82088,1,3,287557,287559,287562,2,5,0
82089,2,2,287559,287562,287564,3,5,0
82090,6,1,287565,287565,287566,0,1,1
82091,1,1,287566,287566,287567,0,1,0
82092,4,1,287570,287570,287571,0,1,3
82093,1,2,287571,287571,287573,0,2,0
82094,3,1,287574,287574,287575,0,1,1
82095,1,2,287575,287575,287577,0,2,0
82096,3,2,287578,287578,287580,0,2,1
82097,3,1,287581,287581,287582,0,1,1
82098,6,2,287587,287587,287589,0,2,5
82099,3,1,287590,287590,287591,0,1,1
82100,6,3,287596,287596,287599,0,3,5
82101,6,3,287602,287602,287605,0,3,3
82102,4,2,287606,287606,287608,0,2,1
82103,4,2,287610,287610,287612,0,2,2
82104,4,3,287614,287614,287617,0,3,2
82105,1,3,287615,287617,287620,2,5,0
82106,4,3,287619,287620,287623,1,4,0
82107,3,2,287622,287623,287625,1,3,0
82108,6,2,287628,287628,287630,0,2,3
82109,1,3,287629,287630,287633,1,4,0
82110,3,1,287632,287633,287634,1,2,0
82111,2,3,287634,287634,287637,0,3,0
82112,5,1,287639,287639,287640,0,1,2
82113,3,2,287642,287642,287644,0,2,2
82114,1,3,287643,287644,287647,1,4,0
82115,1,1,287644,287647,287648,3,4,0
82116,6,2,287650,287650,287652,0,2,2
82117,1,2,287651,287652,287654,1,3,0
82118,2,3,287653,287654,287657,1,4,0
82119,5,1,287658,287658,287659,0,1,1
82120,6,1,287664,287664,287665,0,1,5
82121,1,3,287665,287665,287668,0,3,0
82122,5,3,287670,287670,287673,0,3,2
82123,1,3,287671,287673,287676,2,5,0
82124,5,1,287676,287676,287677,0,1,0
82125,6,1,287682,287682,287683,0,1,5
82126,2,1,287684,287684,287685,0,1,1
82127,6,3,287690,287690,287693,0,3,5
82128,2,2,287692,287693,287695,1,3,0
82129,1,1,287693,287695,287696,2,3,0
82130,3,1,287696,287696,287697,0,1,0
82131,2,2,287698,287698,287700,0,2,1
82132,3,1,287701,287701,287702,0,1,1
82133,4,3,287705,287705,287708,0,3,3
82134,4,3,287709,287709,287712,0,3,1
82135,1,3,287710,287712,287715,2,5,0
82136,2,2,287712,287715,287717,3,5,0
82137,5,3,287717,287717,287720,0,3,0
82138,5,2,287722,287722,287724,0,2,2
82139,6,3,287728,287728,287731,0,3,4
82140,4,3,287732,287732,287735,0,3,1
82141,3,3,287735,287735,287738,0,3,0
82142,4,1,287739,287739,287740,0,1,1
82143,4,2,287743,287743,287745,0,2,3
82144,4,3,287747,287747,287750,0,3,2
82145,2,1,287749,287750,287751,1,2,0
82146,2,3,287751,287751,287754,0,3,0
82147,3,3,287754,287754,287757,0,3,0
82148,5,2,287759,287759,287761,0,2,2
82149,5,2,287764,287764,287766,0,2,3
82150,2,3,287766,287766,287769,0,3,0
82151,5,3,287771,287771,287774,0,3,2
82152,3,3,287774,287774,287777,0,3,0
82153,1,2,287775,287777,287779,2,4,0
82154,2,3,287777,287779,287782,2,5,0
82155,5,1,287782,287782,287783,0,1,0
82156,1,2,287783,287783,287785,0,2,0
82157,1,3,287784,287785,287788,1,4,0
82158,3,1,287787,287788,287789,1,2,0
82159,1,1,287788,287789,287790,1,2,0
82160,2,1,287790,287790,287791,0,1,0
82161,5,3,287795,287795,287798,0,3,4
82162,6,2,287801,287801,287803,0,2,3
82163,5,1,287806,287806,287807,0,1,3
82164,1,1,287807,287807,287808,0,1,0
82165,3,1,287810,287810,287811,0,1,2
82166,2,2,287812,287812,287814,0,2,1
82167,1,3,287813,287814,287817,1,4,0
82168,6,1,287819,287819,287820,0,1,2
82169,6,2,287825,287825,287827,0,2,5
82170,6,1,287831,287831,287832,0,1,4
82171,5,1,287836,287836,287837,0,1,4
82172,1,1,287837,287837,287838,0,1,0
82173,5,1,287842,287842,287843,0,1,4
82174,4,2,287846,287846,287848,0,2,3
82175,1,2,287847,287848,287850,1,3,0
82176,4,1,287851,287851,287852,0,1,1
82177,2,2,287853,287853,287855,0,2,1
82178,6,3,287859,287859,287862,0,3,4
82179,6,1,287865,287865,287866,0,1,3
82180,3,3,287868,287868,287871,0,3,2
82181,6,3,287874,287874,287877,0,3,3
82182,4,2,287878,287878,287880,0,2,1
82183,2,3,287880,287880,287883,0,3,0
82184,1,2,287881,287883,287885,2,4,0
82185,5,2,287886,287886,287888,0,2,1
82186,3,3,287889,287889,287892,0,3,1
82187,1,3,287890,287892,287895,2,5,0
82188,4,1,287894,287895,287896,1,2,0
82189,3,2,287897,287897,287899,0,2,1
82190,3,3,287900,287900,287903,0,3,1
82191,1,3,287901,287903,287906,2,5,0
82192,6,3,287907,287907,287910,0,3,1
82193,2,3,287909,287910,287913,1,4,0
82194,6,2,287915,287915,287917,0,2,2
82195,5,2,287920,287920,287922,0,2,3
82196,3,1,287923,287923,287924,0,1,1
82197,1,1,287924,287924,287925,0,1,0
82198,4,3,287928,287928,287931,0,3,3
82199,6,2,287934,287934,287936,0,2,3
82200,5,1,287939,287939,287940,0,1,3
82201,3,3,287942,287942,287945,0,3,2
82202,4,1,287946,287946,287947,0,1,1
82203,2,1,287948,287948,287949,0,1,1
82204,1,3,287949,287949,287952,0,3,0
82205,1,1,287950,287952,287953,2,3,0
82206,5,1,287955,287955,287956,0,1,2
82207,5,2,287960,287960,287962,0,2,4
82208,1,1,287961,287962,287963,1,2,0
82209,3,1,287964,287964,287965,0,1,1
82210,5,3,287969,287969,287972,0,3,4
82211,2,3,287971,287972,287975,1,4,0
82212,2,3,287973,287975,287978,2,5,0
82213,1,2,287974,287978,287980,4,6,0
82214,4,3,287978,287980,287983,2,5,0
82215,5,3,287983,287983,287986,0,3,0
82216,4,2,287987,287987,287989,0,2,1
82217,4,2,287991,287991,287993,0,2,2
82218,1,3,287992,287993,287996,1,4,0
82219,4,3,287996,287996,287999,0,3,0
82220,6,3,288002,288002,288005,0,3,3
82221,2,3,288004,288005,288008,1,4,0
82222,1,2,288005,288008,288010,3,5,0
82223,5,1,288010,288010,288011,0,1,0
82224,3,2,288013,288013,288015,0,2,2
82225,3,3,288016,288016,288019,0,3,1
82226,4,3,288020,288020,288023,0,3,1
82227,1,3,288021,288023,288026,2,5,0
82228,2,2,288023,288026,288028,3,5,0
82229,3,3,288026,288028,288031,2,5,0
82230,1,3,288027,288031,288034,4,7,0
82231,3,3,288030,288034,288037,4,7,0
82232,6,2,288036,288037,288039,1,3,0
82233,2,3,288038,288039,288042,1,4,0
82234,3,1,288041,288042,288043,1,2,0
82235,6,1,288047,288047,288048,0,1,4
82236,2,1,288049,288049,288050,0,1,1
82237,5,3,288054,288054,288057,0,3,4
82238,4,3,288058,288058,288061,0,3,1
82239,6,3,288064,288064,288067,0,3,3
82240,2,3,288066,288067,288070,1,4,0
82241,3,3,288069,288070,288073,1,4,0
82242,3,2,288072,288073,288075,1,3,0
82243,4,2,288076,288076,288078,0,2,1
82244,3,2,288079,288079,288081,0,2,1
82245,4,2,288083,288083,288085,0,2,2
82246,6,2,288089,288089,288091,0,2,4
82247,2,1,288091,288091,288092,0,1,0
82248,4,3,288095,288095,288098,0,3,3
82249,6,3,288101,288101,288104,0,3,3
82250,5,2,288106,288106,288108,0,2,2
82251,1,1,288107,288108,288109,1,2,0
82252,6,3,288113,288113,288116,0,3,4
82253,1,3,288114,288116,288119,2,5,0
82254,6,2,288120,288120,288122,0,2,1
82255,5,1,288125,288125,288126,0,1,3
82256,1,2,288126,288126,288128,0,2,0
82257,1,1,288127,288128,288129,1,2,0
82258,2,2,288129,288129,288131,0,2,0
82259,5,3,288134,288134,288137,0,3,3
82260,2,2,288136,288137,288139,1,3,0
82261,2,3,288138,288139,288142,1,4,0
82262,2,2,288140,288142,288144,2,4,0
82263,3,2,288143,288144,288146,1,3,0
82264,6,2,288149,288149,288151,0,2,3
82265,4,3,288153,288153,288156,0,3,2
82266,6,1,288159,288159,288160,0,1,3
82267,6,3,288165,288165,288168,0,3,5
82268,2,2,288167,288168,288170,1,3,0
82269,5,1,288172,288172,288173,0,1,2
82270,2,1,288174,288174,288175,0,1,1
82271,5,2,288179,288179,288181,0,2,4
82272,5,3,288184,288184,288187,0,3,3
82273,4,1,288188,288188,288189,0,1,1
82274,6,2,288194,288194,288196,0,2,5
82275,2,1,288196,288196,288197,0,1,0
82276,4,2,288200,288200,288202,0,2,3
82277,6,2,288206,288206,288208,0,2,4
82278,3,3,288209,288209,288212,0,3,1
82279,2,2,288211,288212,288214,1,3,0
82280,5,1,288216,288216,288217,0,1,2
82281,2,1,288218,288218,288219,0,1,1
82282,6,3,288224,288224,288227,0,3,5
82283,5,2,288229,288229,288231,0,2,2
82284,5,1,288234,288234,288235,0,1,3
82285,6,3,288240,288240,288243,0,3,5
82286,3,1,288243,288243,288244,0,1,0
82287,1,3,288244,288244,288247,0,3,0
82288,3,2,288247,288247,288249,0,2,0
82289,6,3,288253,288253,288256,0,3,4
82290,5,2,288258,288258,288260,0,2,2
82291,4,2,288262,288262,288264,0,2,2
82292,2,1,288264,288264,288265,0,1,0
82293,4,3,288268,288268,288271,0,3,3
82294,2,1,288270,288271,288272,1,2,0
82295,4,3,288274,288274,288277,0,3,2
82296,5,3,288279,288279,288282,0,3,2
82297,5,1,288284,288284,288285,0,1,2
82298,2,2,288286,288286,288288,0,2,1
82299,6,1,288292,288292,288293,0,1,4
82300,1,2,288293,288293,288295,0,2,0
82301,6,1,288299,288299,288300,0,1,4
82302,3,1,288302,288302,288303,0,1,2
82303,3,2,288305,288305,288307,0,2,2
82304,1,1,288306,288307,288308,1,2,0
82305,6,1,288312,288312,288313,0,1,4
82306,1,1,288313,288313,288314,0,1,0
82307,4,2,288317,288317,288319,0,2,3
82308,6,1,288323,288323,288324,0,1,4
82309,1,3,288324,288324,288327,0,3,0
82310,1,2,288325,288327,288329,2,4,0
82311,1,2,288326,288329,288331,3,5,0
82312,3,1,288329,288331,288332,2,3,0
82313,1,3,288330,288332,288335,2,5,0
82314,2,3,288332,288335,288338,3,6,0
82315,4,1,288336,288338,288339,2,3,0
82316,1,1,288337,288339,288340,2,3,0
82317,4,3,288341,288341,288344,0,3,1
82318,1,3,288342,288344,288347,2,5,0
82319,5,1,288347,288347,288348,0,1,0
82320,4,1,288351,288351,288352,0,1,3
82321,1,2,288352,288352,288354,0,2,0
82322,3,1,288355,288355,288356,0,1,1
82323,6,1,288361,288361,288362,0,1,5
82324,4,3,288365,288365,288368,0,3,3
82325,4,1,288369,288369,288370,0,1,1
82326,6,2,288375,288375,288377,0,2,5
82327,4,3,288379,288379,288382,0,3,2
82328,4,2,288383,288383,288385,0,2,1
82329,6,3,288389,288389,288392,0,3,4
82330,5,1,288394,288394,288395,0,1,2
82331,6,1,288400,288400,288401,0,1,5
82332,6,1,288406,288406,288407,0,1,5
82333,5,2,288411,288411,288413,0,2,4
82334,2,1,288413,288413,288414,0,1,0
82335,2,2,288415,288415,288417,0,2,1
82336,3,3,288418,288418,288421,0,3,1
82337,2,3,288420,288421,288424,1,4,0
82338,4,1,288424,288424,288425,0,1,0
82339,5,3,288429,288429,288432,0,3,4
82340,5,1,288434,288434,288435,0,1,2
82341,5,2,288439,288439,288441,0,2,4
82342,5,3,288444,288444,288447,0,3,3
82343,6,2,288450,288450,288452,0,2,3
82344,5,2,288455,288455,288457,0,2,3
82345,4,3,288459,288459,288462,0,3,2
82346,3,2,288462,288462,288464,0,2,0
82347,4,2,288466,288466,288468,0,2,2
82348,6,1,288472,288472,288473,0,1,4
82349,2,2,288474,288474,288476,0,2,1
82350,3,1,288477,288477,288478,0,1,1
82351,3,1,288480,288480,288481,0,1,2
82352,6,2,288486,288486,288488,0,2,5
82353,5,2,288491,288491,288493,0,2,3
82354,4,2,288495,288495,288497,0,2,2
82355,4,1,288499,288499,288500,0,1,2
82356,6,2,288505,288505,288507,0,2,5
82357,4,2,288509,288509,288511,0,2,2
82358,3,2,288512,288512,288514,0,2,1
82359,6,2,288518,288518,288520,0,2,4
82360,6,2,288524,288524,288526,0,2,4
82361,6,1,288530,288530,288531,0,1,4
82362,5,3,288535,288535,288538,0,3,4
82363,5,2,288540,288540,288542,0,2,2
82364,4,1,288544,288544,288545,0,1,2
82365,1,2,288545,288545,288547,0,2,0
82366,3,1,288548,288548,288549,0,1,1
82367,3,3,288551,288551,288554,0,3,2
82368,4,1,288555,288555,288556,0,1,1
82369,3,1,288558,288558,288559,0,1,2
82370,6,1,288564,288564,288565,0,1,5
82371,3,1,288567,288567,288568,0,1,2
82372,2,2,288569,288569,288571,0,2,1
82373,3,1,288572,288572,288573,0,1,1
82374,4,1,288576,288576,288577,0,1,3
82375,1,1,288577,288577,288578,0,1,0
82376,6,1,288583,288583,288584,0,1,5
82377,1,3,288584,288584,288587,0,3,0
82378,4,3,288588,288588,288591,0,3,1
82379,3,1,288591,288591,288592,0,1,0
82380,5,3,288596,288596,288599,0,3,4
82381,6,2,288602,288602,288604,0,2,3
82382,5,3,288607,288607,288610,0,3,3
82383,4,1,288611,288611,288612,0,1,1
82384,4,2,288615,288615,288617,0,2,3
82385,6,3,288621,288621,288624,0,3,4
82386,6,3,288627,288627,288630,0,3,3
82387,3,1,288630,288630,288631,0,1,0
82388,2,3,288632,288632,288635,0,3,1
82389,3,2,288635,288635,288637,0,2,0
82390,2,2,288637,288637,288639,0,2,0
82391,5,3,288642,288642,288645,0,3,3
82392,1,2,288643,288645,288647,2,4,0
82393,2,3,288645,288647,288650,2,5,0
82394,6,2,288651,288651,288653,0,2,1
82395,6,2,288657,288657,288659,0,2,4
82396,5,3,288662,288662,288665,0,3,3
82397,6,3,288668,288668,288671,0,3,3
82398,1,2,288669,288671,288673,2,4,0
82399,5,2,288674,288674,288676,0,2,1
82400,5,1,288679,288679,288680,0,1,3
82401,6,3,288685,288685,288688,0,3,5
82402,3,1,288688,288688,288689,0,1,0
82403,6,1,288694,288694,288695,0,1,5
82404,3,3,288697,288697,288700,0,3,2
82405,4,2,288701,288701,288703,0,2,1
82406,4,1,288705,288705,288706,0,1,2
82407,4,3,288709,288709,288712,0,3,3
82408,2,1,288711,288712,288713,1,2,0
82409,6,1,288717,288717,288718,0,1,4
82410,2,3,288719,288719,288722,0,3,1
82411,3,1,288722,288722,288723,0,1,0
82412,3,2,288725,288725,288727,0,2,2
82413,4,3,288729,288729,288732,0,3,2
82414,2,2,288731,288732,288734,1,3,0
82415,4,2,288735,288735,288737,0,2,1
82416,6,3,288741,288741,288744,0,3,4
82417,2,1,288743,288744,288745,1,2,0
82418,4,2,288747,288747,288749,0,2,2
82419,5,1,288752,288752,288753,0,1,3
82420,4,1,288756,288756,288757,0,1,3
82421,5,3,288761,288761,288764,0,3,4
82422,4,2,288765,288765,288767,0,2,1
82423,2,1,288767,288767,288768,0,1,0
82424,2,2,288769,288769,288771,0,2,1
82425,5,1,288774,288774,288775,0,1,3
82426,6,2,288780,288780,288782,0,2,5
82427,5,1,288785,288785,288786,0,1,3
82428,2,2,288787,288787,288789,0,2,1
82429,2,3,288789,288789,288792,0,3,0
82430,1,1,288790,288792,288793,2,3,0
82431,1,3,288791,288793,288796,2,5,0
82432,6,3,288797,288797,288800,0,3,1
82433,1,2,288798,288800,288802,2,4,0
82434,6,1,288804,288804,288805,0,1,2
82435,2,3,288806,288806,288809,0,3,1
82436,6,3,288812,288812,288815,0,3,3
82437,2,3,288814,288815,288818,1,4,0
82438,6,3,288820,288820,288823,0,3,2
82439,2,3,288822,288823,288826,1,4,0
82440,5,1,288827,288827,288828,0,1,1
82441,6,3,288833,288833,288836,0,3,5
82442,5,3,288838,288838,288841,0,3,2
82443,5,2,288843,288843,288845,0,2,2
82444,4,1,288847,288847,288848,0,1,2
82445,5,1,288852,288852,288853,0,1,4
82446,3,1,288855,288855,288856,0,1,2
82447,5,1,288860,288860,288861,0,1,4
82448,6,2,288866,288866,288868,0,2,5
82449,1,2,288867,288868,288870,1,3,0
82450,5,1,288872,288872,288873,0,1,2
82451,4,1,288876,288876,288877,0,1,3
82452,1,2,288877,288877,288879,0,2,0
82453,1,1,288878,288879,288880,1,2,0
82454,1,3,288879,288880,288883,1,4,0
82455,3,3,288882,288883,288886,1,4,0
82456,3,2,288885,288886,288888,1,3,0
82457,4,2,288889,288889,288891,0,2,1
82458,6,1,288895,288895,288896,0,1,4
82459,2,2,288897,288897,288899,0,2,1
82460,2,2,288899,288899,288901,0,2,0
82461,6,2,288905,288905,288907,0,2,4
82462,5,3,288910,288910,288913,0,3,3
82463,1,3,288911,288913,288916,2,5,0
82464,2,1,288913,288916,288917,3,4,0
82465,2,1,288915,288917,288918,2,3,0
82466,4,1,288919,288919,288920,0,1,1
82467,5,2,288924,288924,288926,0,2,4
82468,2,2,288926,288926,288928,0,2,0
82469,1,1,288927,288928,288929,1,2,0
82470,6,3,288933,288933,288936,0,3,4
82471,4,2,288937,288937,288939,0,2,1
82472,1,2,288938,288939,288941,1,3,0
82473,6,2,288944,288944,288946,0,2,3
82474,2,2,288946,288946,288948,0,2,0
82475,4,1,288950,288950,288951,0,1,2
82476,4,1,288954,288954,288955,0,1,3
82477,5,2,288959,288959,288961,0,2,4
82478,6,1,288965,288965,288966,0,1,4
82479,1,1,288966,288966,288967,0,1,0
82480,6,2,288972,288972,288974,0,2,5
82481,6,3,288978,288978,288981,0,3,4
82482,2,3,288980,288981,288984,1,4,0
82483,1,3,288981,288984,288987,3,6,0
82484,2,1,288983,288987,288988,4,5,0
82485,2,3,288985,288988,288991,3,6,0
82486,2,3,288987,288991,288994,4,7,0
82487,3,3,288990,288994,288997,4,7,0
82488,2,3,288992,288997,289000,5,8,0
82489,5,2,288997,289000,289002,3,5,0
82490,3,2,289000,289002,289004,2,4,0
82491,4,2,289004,289004,289006,0,2,0
82492,4,3,289008,289008,289011,0,3,2
82493,4,2,289012,289012,289014,0,2,1
82494,5,3,289017,289017,289020,0,3,3
82495,2,1,289019,289020,289021,1,2,0
82496,6,1,289025,289025,289026,0,1,4
82497,5,1,289030,289030,289031,0,1,4
82498,6,3,289036,289036,289039,0,3,5
82499,6,1,289042,289042,289043,0,1,3
82500,5,3,289047,289047,289050,0,3,4
82501,5,1,289052,289052,289053,0,1,2
82502,6,1,289058,289058,289059,0,1,5
82503,5,3,289063,289063,289066,0,3,4
82504,3,2,289066,289066,289068,0,2,0
82505,4,3,289070,289070,289073,0,3,2
82506,2,3,289072,289073,289076,1,4,0
82507,1,1,289073,289076,289077,3,4,0
82508,5,3,289078,289078,289081,0,3,1
82509,3,1,289081,289081,289082,0,1,0
82510,5,2,289086,289086,289088,0,2,4
82511,3,3,289089,289089,289092,0,3,1
82512,2,1,289091,289092,289093,1,2,0
82513,4,2,289095,289095,289097,0,2,2
82514,4,2,289099,289099,289101,0,2,2
82515,4,2,289103,289103,289105,0,2,2
82516,3,1,289106,289106,289107,0,1,1
82517,6,2,289112,289112,289114,0,2,5
82518,1,2,289113,289114,289116,1,3,0
82519,5,2,289118,289118,289120,0,2,2
82520,4,2,289122,289122,289124,0,2,2
82521,4,1,289126,289126,289127,0,1,2
82522,1,2,289127,289127,289129,0,2,0
82523,4,1,289131,289131,289132,0,1,2
82524,5,2,289136,289136,289138,0,2,4
82525,1,3,289137,289138,289141,1,4,0
82526,4,2,289141,289141,289143,0,2,0
82527,5,2,289146,289146,289148,0,2,3
82528,1,3,289147,289148,289151,1,4,0
82529,4,2,289151,289151,289153,0,2,0
82530,4,3,289155,289155,289158,0,3,2
82531,6,1,289161,289161,289162,0,1,3
82532,2,2,289163,289163,289165,0,2,1
82533,3,3,289166,289166,289169,0,3,1
82534,5,1,289171,289171,289172,0,1,2
82535,1,3,289172,289172,289175,0,3,0
82536,4,2,289176,289176,289178,0,2,1
82537,2,2,289178,289178,289180,0,2,0
82538,1,3,289179,289180,289183,1,4,0
82539,4,1,289183,289183,289184,0,1,0
82540,3,3,289186,289186,289189,0,3,2
82541,3,3,289189,289189,289192,0,3,0
82542,1,3,289190,289192,289195,2,5,0
82543,4,1,289194,289195,289196,1,2,0
82544,5,2,289199,289199,289201,0,2,3
82545,2,2,289201,289201,289203,0,2,0
82546,3,3,289204,289204,289207,0,3,1
82547,3,3,289207,289207,289210,0,3,0
82548,5,1,289212,289212,289213,0,1,2
82549,6,3,289218,289218,289221,0,3,5
82550,5,2,289223,289223,289225,0,2,2
82551,4,1,289227,289227,289228,0,1,2
82552,4,3,289231,289231,289234,0,3,3
82553,3,2,289234,289234,289236,0,2,0
82554,1,3,289235,289236,289239,1,4,0
82555,2,2,289237,289239,289241,2,4,0
82556,3,2,289240,289241,289243,1,3,0
82557,6,2,289246,289246,289248,0,2,3
82558,2,1,289248,289248,289249,0,1,0
82559,1,1,289249,289249,289250,0,1,0
82560,6,1,289255,289255,289256,0,1,5
82561,1,3,289256,289256,289259,0,3,0
82562,1,3,289257,289259,289262,2,5,0
82563,6,3,289263,289263,289266,0,3,1
82564,3,3,289266,289266,289269,0,3,0
82565,4,2,289270,289270,289272,0,2,1
82566,1,2,289271,289272,289274,1,3,0
82567,1,1,289272,289274,289275,2,3,0
82568,5,3,289277,289277,289280,0,3,2
82569,6,3,289283,289283,289286,0,3,3
82570,5,1,289288,289288,289289,0,1,2
82571,1,1,289289,289289,289290,0,1,0
82572,4,3,289293,289293,289296,0,3,3
82573,4,2,289297,289297,289299,0,2,1
82574,3,2,289300,289300,289302,0,2,1
82575,3,1,289303,289303,289304,0,1,1
82576,4,1,289307,289307,289308,0,1,3
82577,5,2,289312,289312,289314,0,2,4
82578,2,3,289314,289314,289317,0,3,0
82579,2,3,289316,289317,289320,1,4,0
82580,5,3,289321,289321,289324,0,3,1
82581,5,3,289326,289326,289329,0,3,2
82582,3,2,289329,289329,289331,0,2,0
82583,6,1,289335,289335,289336,0,1,4
82584,4,2,289339,289339,289341,0,2,3
82585,6,2,289345,289345,289347,0,2,4
82586,2,2,289347,289347,289349,0,2,0
82587,1,1,289348,289349,289350,1,2,0
82588,1,2,289349,289350,289352,1,3,0
82589,1,2,289350,289352,289354,2,4,0
82590,5,3,289355,289355,289358,0,3,1
82591,2,3,289357,289358,289361,1,4,0
82592,1,2,289358,289361,289363,3,5,0
82593,1,2,289359,289363,289365,4,6,0
82594,3,1,289362,289365,289366,3,4,0
82595,2,1,289364,289366,289367,2,3,0
82596,5,3,289369,289369,289372,0,3,2
82597,3,1,289372,289372,289373,0,1,0
82598,2,1,289374,289374,289375,0,1,1
82599,3,2,289377,289377,289379,0,2,2
82600,4,2,289381,289381,289383,0,2,2
82601,4,3,289385,289385,289388,0,3,2
82602,5,1,289390,289390,289391,0,1,2
82603,5,2,289395,289395,289397,0,2,4
82604,5,2,289400,289400,289402,0,2,3
82605,3,2,289403,289403,289405,0,2,1
82606,2,2,289405,289405,289407,0,2,0
82607,6,3,289411,289411,289414,0,3,4
82608,4,2,289415,289415,289417,0,2,1
82609,6,2,289421,289421,289423,0,2,4
82610,5,2,289426,289426,289428,0,2,3
82611,2,3,289428,289428,289431,0,3,0
82612,4,2,289432,289432,289434,0,2,1
82613,6,2,289438,289438,289440,0,2,4
82614,2,2,289440,289440,289442,0,2,0
82615,3,1,289443,289443,289444,0,1,1
82616,1,3,289444,289444,289447,0,3,0
82617,6,2,289450,289450,289452,0,2,3
82618,2,2,289452,289452,289454,0,2,0
82619,5,1,289457,289457,289458,0,1,3
82620,1,3,289458,289458,289461,0,3,0
82621,1,2,289459,289461,289463,2,4,0
82622,1,2,289460,289463,289465,3,5,0
82623,4,3,289464,289465,289468,1,4,0
82624,6,3,289470,289470,289473,0,3,2
82625,5,3,289475,289475,289478,0,3,2
82626,1,3,289476,289478,289481,2,5,0
82627,3,2,289479,289481,289483,2,4,0
82628,6,2,289485,289485,289487,0,2,2
82629,6,2,289491,289491,289493,0,2,4
82630,5,2,289496,289496,289498,0,2,3
82631,3,1,289499,289499,289500,0,1,1
82632,2,1,289501,289501,289502,0,1,1
82633,3,3,289504,289504,289507,0,3,2
82634,1,2,289505,289507,289509,2,4,0
82635,1,2,289506,289509,289511,3,5,0
82636,3,1,289509,289511,289512,2,3,0
82637,1,1,289510,289512,289513,2,3,0
82638,3,1,289513,289513,289514,0,1,0
82639,4,3,289517,289517,289520,0,3,3
82640,4,3,289521,289521,289524,0,3,1
82641,1,2,289522,289524,289526,2,4,0
82642,3,1,289525,289526,289527,1,2,0
82643,1,2,289526,289527,289529,1,3,0
82644,1,2,289527,289529,289531,2,4,0
82645,4,1,289531,289531,289532,0,1,0
82646,4,1,289535,289535,289536,0,1,3
82647,5,1,289540,289540,289541,0,1,4
82648,1,2,289541,289541,289543,0,2,0
82649,4,3,289545,289545,289548,0,3,2
82650,3,1,289548,289548,289549,0,1,0
82651,2,3,289550,289550,289553,0,3,1
82652,1,2,289551,289553,289555,2,4,0
82653,2,2,289553,289555,289557,2,4,0
82654,4,1,289557,289557,289558,0,1,0
82655,4,2,289561,289561,289563,0,2,3
82656,5,2,289566,289566,289568,0,2,3
82657,5,1,289571,289571,289572,0,1,3
82658,2,3,289573,289573,289576,0,3,1
82659,4,3,289577,289577,289580,0,3,1
82660,4,3,289581,289581,289584,0,3,1
82661,2,3,289583,289584,289587,1,4,0
82662,1,2,289584,289587,289589,3,5,0
82663,3,1,289587,289589,289590,2,3,0
82664,6,1,289593,289593,289594,0,1,3
82665,3,3,289596,289596,289599,0,3,2
82666,1,1,289597,289599,289600,2,3,0
82667,2,3,289599,289600,289603,1,4,0
82668,4,3,289603,289603,289606,0,3,0
82669,2,1,289605,289606,289607,1,2,0
82670,3,1,289608,289608,289609,0,1,1
82671,3,1,289611,289611,289612,0,1,2
82672,4,3,289615,289615,289618,0,3,3
82673,1,2,289616,289618,289620,2,4,0
82674,3,2,289619,289620,289622,1,3,0
82675,1,2,289620,289622,289624,2,4,0
82676,3,3,289623,289624,289627,1,4,0
82677,1,1,289624,289627,289628,3,4,0
82678,6,2,289630,289630,289632,0,2,2
82679,2,2,289632,289632,289634,0,2,0
82680,4,1,289636,289636,289637,0,1,2
82681,5,3,289641,289641,289644,0,3,4
82682,1,3,289642,289644,289647,2,5,0
82683,3,3,289645,289647,289650,2,5,0
82684,4,2,289649,289650,289652,1,3,0
82685,3,1,289652,289652,289653,0,1,0
82686,6,2,289658,289658,289660,0,2,5
82687,2,1,289660,289660,289661,0,1,0
82688,5,3,289665,289665,289668,0,3,4
82689,5,2,289670,289670,289672,0,2,2
82690,4,2,289674,289674,289676,0,2,2
82691,4,2,289678,289678,289680,0,2,2
82692,5,3,289683,289683,289686,0,3,3
82693,4,2,289687,289687,289689,0,2,1
82694,3,2,289690,289690,289692,0,2,1
82695,3,3,289693,289693,289696,0,3,1
82696,3,2,289696,289696,289698,0,2,0
82697,6,3,289702,289702,289705,0,3,4
82698,1,3,289703,289705,289708,2,5,0
82699,3,1,289706,289708,289709,2,3,0
82700,5,1,289711,289711,289712,0,1,2
82701,3,1,289714,289714,289715,0,1,2
82702,2,3,289716,289716,289719,0,3,1
82703,5,2,289721,289721,289723,0,2,2
82704,6,2,289727,289727,289729,0,2,4
82705,1,3,289728,289729,289732,1,4,0
82706,3,2,289731,289732,289734,1,3,0
82707,2,3,289733,289734,289737,1,4,0
82708,5,1,289738,289738,289739,0,1,1
82709,2,2,289740,289740,289742,0,2,1
82710,5,2,289745,289745,289747,0,2,3
82711,4,3,289749,289749,289752,0,3,2
82712,3,3,289752,289752,289755,0,3,0
82713,3,3,289755,289755,289758,0,3,0
82714,2,3,289757,289758,289761,1,4,0
82715,1,3,289758,289761,289764,3,6,0
82716,3,2,289761,289764,289766,3,5,0
82717,3,3,289764,289766,289769,2,5,0
82718,3,1,289767,289769,289770,2,3,0
82719,4,2,289771,289771,289773,0,2,1
82720,5,3,289776,289776,289779,0,3,3
82721,1,3,289777,289779,289782,2,5,0
82722,3,3,289780,289782,289785,2,5,0
82723,6,1,289786,289786,289787,0,1,1
82724,5,1,289791,289791,289792,0,1,4
82725,3,2,289794,289794,289796,0,2,2
82726,1,1,289795,289796,289797,1,2,0
82727,5,2,289800,289800,289802,0,2,3
82728,4,2,289804,289804,289806,0,2,2
82729,6,3,289810,289810,289813,0,3,4
82730,3,2,289813,289813,289815,0,2,0
82731,6,2,289819,289819,289821,0,2,4
82732,6,1,289825,289825,289826,0,1,4
82733,6,3,289831,289831,289834,0,3,5
82734,1,1,289832,289834,289835,2,3,0
82735,6,3,289838,289838,289841,0,3,3
82736,3,3,289841,289841,289844,0,3,0
82737,2,1,289843,289844,289845,1,2,0
82738,6,2,289849,289849,289851,0,2,4
82739,1,1,289850,289851,289852,1,2,0
82740,1,1,289851,289852,289853,1,2,0
82741,3,2,289854,289854,289856,0,2,1
82742,2,1,289856,289856,289857,0,1,0
82743,3,3,289859,289859,289862,0,3,2
82744,3,2,289862,289862,289864,0,2,0
82745,1,3,289863,289864,289867,1,4,0
82746,3,1,289866,289867,289868,1,2,0
82747,2,1,289868,289868,289869,0,1,0
82748,1,3,289869,289869,289872,0,3,0
82749,1,1,289870,289872,289873,2,3,0
82750,4,2,289874,289874,289876,0,2,1
82751,2,2,289876,289876,289878,0,2,0
82752,5,3,289881,289881,289884,0,3,3
82753,4,2,289885,289885,289887,0,2,1
82754,6,1,289891,289891,289892,0,1,4
82755,6,3,289897,289897,289900,0,3,5
82756,3,3,289900,289900,289903,0,3,0
82757,1,2,289901,289903,289905,2,4,0
82758,2,2,289903,289905,289907,2,4,0
82759,2,2,289905,289907,289909,2,4,0
82760,6,2,289911,289911,289913,0,2,2
82761,3,2,289914,289914,289916,0,2,1
82762,1,3,289915,289916,289919,1,4,0
82763,1,3,289916,289919,289922,3,6,0
82764,6,2,289922,289922,289924,0,2,0
82765,3,3,289925,289925,289928,0,3,1
82766,3,1,289928,289928,289929,0,1,0
82767,6,1,289934,289934,289935,0,1,5
82768,3,1,289937,289937,289938,0,1,2
82769,2,2,289939,289939,289941,0,2,1
82770,6,3,289945,289945,289948,0,3,4
82771,6,3,289951,289951,289954,0,3,3
82772,2,1,289953,289954,289955,1,2,0
82773,1,2,289954,289955,289957,1,3,0
82774,3,3,289957,289957,289960,0,3,0
82775,1,1,289958,289960,289961,2,3,0
82776,6,2,289964,289964,289966,0,2,3
82777,4,1,289968,289968,289969,0,1,2
82778,2,1,289970,289970,289971,0,1,1
82779,3,2,289973,289973,289975,0,2,2
82780,4,1,289977,289977,289978,0,1,2
82781,2,3,289979,289979,289982,0,3,1
82782,4,1,289983,289983,289984,0,1,1
82783,6,1,289989,289989,289990,0,1,5
82784,4,1,289993,289993,289994,0,1,3
82785,5,2,289998,289998,290000,0,2,4
82786,5,3,290003,290003,290006,0,3,3
82787,6,2,290009,290009,290011,0,2,3
82788,2,1,290011,290011,290012,0,1,0
82789,6,2,290017,290017,290019,0,2,5
82790,3,1,290020,290020,290021,0,1,1
82791,2,2,290022,290022,290024,0,2,1
82792,4,2,290026,290026,290028,0,2,2
82793,2,1,290028,290028,290029,0,1,0
82794,1,1,290029,290029,290030,0,1,0
82795,4,3,290033,290033,290036,0,3,3
82796,3,1,290036,290036,290037,0,1,0
82797,1,3,290037,290037,290040,0,3,0
82798,6,3,290043,290043,290046,0,3,3
82799,2,2,290045,290046,290048,1,3,0
82800,4,2,290049,290049,290051,0,2,1
82801,3,3,290052,290052,290055,0,3,1
82802,6,2,290058,290058,290060,0,2,3
82803,6,3,290064,290064,290067,0,3,4
82804,3,1,290067,290067,290068,0,1,0
82805,5,1,290072,290072,290073,0,1,4
82806,1,2,290073,290073,290075,0,2,0
82807,6,2,290079,290079,290081,0,2,4
82808,6,2,290085,290085,290087,0,2,4
82809,1,2,290086,290087,290089,1,3,0
82810,1,1,290087,290089,290090,2,3,0
82811,1,1,290088,290090,290091,2,3,0
82812,4,1,290092,290092,290093,0,1,1
82813,6,1,290098,290098,290099,0,1,5
82814,2,2,290100,290100,290102,0,2,1
82815,2,1,290102,290102,290103,0,1,0
82816,6,3,290108,290108,290111,0,3,5
82817,2,1,290110,290111,290112,1,2,0
82818,3,3,290113,290113,290116,0,3,1
82819,4,1,290117,290117,290118,0,1,1
82820,6,3,290123,290123,290126,0,3,5
82821,1,1,290124,290126,290127,2,3,0
82822,5,1,290129,290129,290130,0,1,2
82823,3,3,290132,290132,290135,0,3,2
82824,5,2,290137,290137,290139,0,2,2
82825,4,2,290141,290141,290143,0,2,2
82826,2,1,290143,290143,290144,0,1,0
82827,3,2,290146,290146,290148,0,2,2
82828,6,1,290152,290152,290153,0,1,4
82829,3,1,290155,290155,290156,0,1,2
82830,1,3,290156,290156,290159,0,3,0
82831,5,2,290161,290161,290163,0,2,2
82832,6,3,290167,290167,290170,0,3,4
82833,5,2,290172,290172,290174,0,2,2
82834,1,2,290173,290174,290176,1,3,0
82835,1,3,290174,290176,290179,2,5,0
82836,6,2,290180,290180,290182,0,2,1
82837,5,2,290185,290185,290187,0,2,3
82838,6,2,290191,290191,290193,0,2,4
82839,3,3,290194,290194,290197,0,3,1
82840,4,3,290198,290198,290201,0,3,1
82841,5,2,290203,290203,290205,0,2,2
82842,5,1,290208,290208,290209,0,1,3
82843,5,2,290213,290213,290215,0,2,4
82844,3,2,290216,290216,290218,0,2,1
82845,5,3,290221,290221,290224,0,3,3
82846,6,3,290227,290227,290230,0,3,3
82847,3,3,290230,290230,290233,0,3,0
82848,1,2,290231,290233,290235,2,4,0
82849,3,3,290234,290235,290238,1,4,0
82850,5,3,290239,290239,290242,0,3,1
82851,3,2,290242,290242,290244,0,2,0
82852,6,2,290248,290248,290250,0,2,4
82853,3,2,290251,290251,290253,0,2,1
82854,3,3,290254,290254,290257,0,3,1
82855,1,2,290255,290257,290259,2,4,0
82856,3,3,290258,290259,290262,1,4,0
82857,5,1,290263,290263,290264,0,1,1
82858,5,3,290268,290268,290271,0,3,4
82859,1,2,290269,290271,290273,2,4,0
82860,1,1,290270,290273,290274,3,4,0
82861,1,2,290271,290274,290276,3,5,0
82862,2,2,290273,290276,290278,3,5,0
82863,6,1,290279,290279,290280,0,1,1
82864,5,1,290284,290284,290285,0,1,4
82865,5,1,290289,290289,290290,0,1,4
82866,5,1,290294,290294,290295,0,1,4
82867,4,2,290298,290298,290300,0,2,3
82868,5,1,290303,290303,290304,0,1,3
82869,1,1,290304,290304,290305,0,1,0
82870,4,3,290308,290308,290311,0,3,3
82871,6,2,290314,290314,290316,0,2,3
82872,1,2,290315,290316,290318,1,3,0
82873,6,3,290321,290321,290324,0,3,3
82874,3,2,290324,290324,290326,0,2,0
82875,5,1,290329,290329,290330,0,1,3
82876,3,2,290332,290332,290334,0,2,2
82877,2,1,290334,290334,290335,0,1,0
82878,6,3,290340,290340,290343,0,3,5
82879,2,1,290342,290343,290344,1,2,0
82880,4,2,290346,290346,290348,0,2,2
82881,3,1,290349,290349,290350,0,1,1
82882,1,3,290350,290350,290353,0,3,0
82883,4,1,290354,290354,290355,0,1,1
82884,1,3,290355,290355,290358,0,3,0
82885,5,3,290360,290360,290363,0,3,2
82886,3,2,290363,290363,290365,0,2,0
82887,1,1,290364,290365,290366,1,2,0
82888,3,2,290367,290367,290369,0,2,1
82889,1,2,290368,290369,290371,1,3,0
82890,5,3,290373,290373,290376,0,3,2
82891,2,1,290375,290376,290377,1,2,0
82892,4,3,290379,290379,290382,0,3,2
82893,6,2,290385,290385,290387,0,2,3
82894,3,3,290388,290388,290391,0,3,1
82895,4,3,290392,290392,290395,0,3,1
82896,3,2,290395,290395,290397,0,2,0
82897,4,1,290399,290399,290400,0,1,2
82898,5,1,290404,290404,290405,0,1,4
82899,4,3,290408,290408,290411,0,3,3
82900,5,1,290413,290413,290414,0,1,2
82901,4,3,290417,290417,290420,0,3,3
82902,2,3,290419,290420,290423,1,4,0
82903,5,3,290424,290424,290427,0,3,1
82904,4,2,290428,290428,290430,0,2,1
82905,6,3,290434,290434,290437,0,3,4
82906,5,3,290439,290439,290442,0,3,2
82907,2,3,290441,290442,290445,1,4,0
82908,1,2,290442,290445,290447,3,5,0
82909,1,1,290443,290447,290448,4,5,0
82910,2,3,290445,290448,290451,3,6,0
82911,6,2,290451,290451,290453,0,2,0
82912,4,3,290455,290455,290458,0,3,2
82913,6,1,290461,290461,290462,0,1,3
82914,5,3,290466,290466,290469,0,3,4
82915,5,2,290471,290471,290473,0,2,2
82916,3,2,290474,290474,290476,0,2,1
82917,5,1,290479,290479,290480,0,1,3
82918,2,2,290481,290481,290483,0,2,1
82919,4,3,290485,290485,290488,0,3,2
82920,1,2,290486,290488,290490,2,4,0
82921,4,3,290490,290490,290493,0,3,0
82922,5,1,290495,290495,290496,0,1,2
82923,4,1,290499,290499,290500,0,1,3
82924,4,3,290503,290503,290506,0,3,3
82925,2,1,290505,290506,290507,1,2,0
82926,2,2,290507,290507,290509,0,2,0
82927,2,3,290509,290509,290512,0,3,0
82928,1,3,290510,290512,290515,2,5,0
82929,6,2,290516,290516,290518,0,2,1
82930,5,3,290521,290521,290524,0,3,3
82931,3,2,290524,290524,290526,0,2,0
82932,6,1,290530,290530,290531,0,1,4
82933,2,2,290532,290532,290534,0,2,1
82934,1,1,290533,290534,290535,1,2,0
82935,3,1,290536,290536,290537,0,1,1
82936,6,1,290542,290542,290543,0,1,5
82937,3,3,290545,290545,290548,0,3,2
82938,4,3,290549,290549,290552,0,3,1
82939,1,2,290550,290552,290554,2,4,0
82940,5,2,290555,290555,290557,0,2,1
82941,3,3,290558,290558,290561,0,3,1
82942,6,2,290564,290564,290566,0,2,3
82943,1,1,290565,290566,290567,1,2,0
82944,1,2,290566,290567,290569,1,3,0
82945,2,2,290568,290569,290571,1,3,0
82946,2,1,290570,290571,290572,1,2,0
82947,5,3,290575,290575,290578,0,3,3
82948,3,1,290578,290578,290579,0,1,0
82949,6,2,290584,290584,290586,0,2,5
82950,3,3,290587,290587,290590,0,3,1
82951,5,1,290592,290592,290593,0,1,2
82952,2,1,290594,290594,290595,0,1,1
82953,1,2,290595,290595,290597,0,2,0
82954,1,2,290596,290597,290599,1,3,0
82955,6,1,290602,290602,290603,0,1,3
82956,5,2,290607,290607,290609,0,2,4
82957,1,1,290608,290609,290610,1,2,0
82958,2,1,290610,290610,290611,0,1,0
82959,5,1,290615,290615,290616,0,1,4
82960,1,2,290616,290616,290618,0,2,0
82961,3,2,290619,290619,290621,0,2,1
82962,3,3,290622,290622,290625,0,3,1
82963,2,2,290624,290625,290627,1,3,0
82964,6,1,290630,290630,290631,0,1,3
82965,6,2,290636,290636,290638,0,2,5
82966,3,2,290639,290639,290641,0,2,1
82967,2,1,290641,290641,290642,0,1,0
82968,6,2,290647,290647,290649,0,2,5
82969,3,3,290650,290650,290653,0,3,1
82970,2,1,290652,290653,290654,1,2,0
82971,5,3,290657,290657,290660,0,3,3
82972,5,3,290662,290662,290665,0,3,2
82973,1,2,290663,290665,290667,2,4,0
82974,3,3,290666,290667,290670,1,4,0
82975,4,3,290670,290670,290673,0,3,0
82976,3,1,290673,290673,290674,0,1,0
82977,1,2,290674,290674,290676,0,2,0
82978,1,2,290675,290676,290678,1,3,0
82979,4,3,290679,290679,290682,0,3,1
82980,5,1,290684,290684,290685,0,1,2
82981,1,3,290685,290685,290688,0,3,0
82982,6,3,290691,290691,290694,0,3,3
82983,6,1,290697,290697,290698,0,1,3
82984,4,3,290701,290701,290704,0,3,3
82985,3,2,290704,290704,290706,0,2,0
82986,2,2,290706,290706,290708,0,2,0
82987,1,3,290707,290708,290711,1,4,0
82988,6,1,290713,290713,290714,0,1,2
82989,3,2,290716,290716,290718,0,2,2
82990,5,1,290721,290721,290722,0,1,3
82991,5,1,290726,290726,290727,0,1,4
82992,6,2,290732,290732,290734,0,2,5
82993,4,3,290736,290736,290739,0,3,2
82994,1,2,290737,290739,290741,2,4,0
82995,5,1,290742,290742,290743,0,1,1
82996,5,3,290747,290747,290750,0,3,4
82997,4,2,290751,290751,290753,0,2,1
82998,1,2,290752,290753,290755,1,3,0
82999,6,3,290758,290758,290761,0,3,3
83000,1,1,290759,290761,290762,2,3,0
83001,5,3,290764,290764,290767,0,3,2
83002,1,3,290765,290767,290770,2,5,0
83003,3,2,290768,290770,290772,2,4,0
83004,2,3,290770,290772,290775,2,5,0
83005,1,3,290771,290775,290778,4,7,0
83006,4,2,290775,290778,290780,3,5,0
83007,2,1,290777,290780,290781,3,4,0
83008,1,2,290778,290781,290783,3,5,0
83009,3,3,290781,290783,290786,2,5,0
83010,1,2,290782,290786,290788,4,6,0
83011,2,2,290784,290788,290790,4,6,0
83012,1,3,290785,290790,290793,5,8,0
83013,5,2,290790,290793,290795,3,5,0
83014,6,3,290796,290796,290799,0,3,1
83015,4,3,290800,290800,290803,0,3,1
83016,4,2,290804,290804,290806,0,2,1
83017,1,2,290805,290806,290808,1,3,0
83018,3,2,290808,290808,290810,0,2,0
83019,4,2,290812,290812,290814,0,2,2
83020,1,2,290813,290814,290816,1,3,0
83021,4,3,290817,290817,290820,0,3,1
83022,1,1,290818,290820,290821,2,3,0
83023,3,1,290821,290821,290822,0,1,0
83024,6,1,290827,290827,290828,0,1,5
83025,6,1,290833,290833,290834,0,1,5
83026,1,1,290834,290834,290835,0,1,0
83027,5,3,290839,290839,290842,0,3,4
83028,4,3,290843,290843,290846,0,3,1
83029,2,1,290845,290846,290847,1,2,0
83030,3,3,290848,290848,290851,0,3,1
83031,4,3,290852,290852,290855,0,3,1
83032,4,2,290856,290856,290858,0,2,1
83033,3,2,290859,290859,290861,0,2,1
83034,5,3,290864,290864,290867,0,3,3
83035,4,1,290868,290868,290869,0,1,1
83036,6,1,290874,290874,290875,0,1,5
83037,6,2,290880,290880,290882,0,2,5
83038,1,2,290881,290882,290884,1,3,0
83039,3,3,290884,290884,290887,0,3,0
83040,2,1,290886,290887,290888,1,2,0
83041,4,2,290890,290890,290892,0,2,2
83042,5,3,290895,290895,290898,0,3,3
83043,2,2,290897,290898,290900,1,3,0
83044,4,1,290901,290901,290902,0,1,1
83045,6,1,290907,290907,290908,0,1,5
83046,3,1,290910,290910,290911,0,1,2
83047,3,1,290913,290913,290914,0,1,2
83048,3,2,290916,290916,290918,0,2,2
83049,2,3,290918,290918,290921,0,3,0
83050,5,3,290923,290923,290926,0,3,2
83051,6,1,290929,290929,290930,0,1,3
83052,6,2,290935,290935,290937,0,2,5
83053,1,1,290936,290937,290938,1,2,0
83054,5,1,290941,290941,290942,0,1,3
83055,3,1,290944,290944,290945,0,1,2
83056,2,2,290946,290946,290948,0,2,1
83057,6,2,290952,290952,290954,0,2,4
83058,2,2,290954,290954,290956,0,2,0
83059,1,2,290955,290956,290958,1,3,0
83060,6,3,290961,290961,290964,0,3,3
83061,4,1,290965,290965,290966,0,1,1
83062,1,1,290966,290966,290967,0,1,0
83063,2,1,290968,290968,290969,0,1,1
83064,3,2,290971,290971,290973,0,2,2
83065,3,1,290974,290974,290975,0,1,1
83066,5,2,290979,290979,290981,0,2,4
83067,5,2,290984,290984,290986,0,2,3
83068,6,3,290990,290990,290993,0,3,4
83069,5,1,290995,290995,290996,0,1,2
83070,3,1,290998,290998,290999,0,1,2
83071,6,3,291004,291004,291007,0,3,5
83072,4,1,291008,291008,291009,0,1,1
83073,5,3,291013,291013,291016,0,3,4
83074,5,2,291018,291018,291020,0,2,2
83075,2,2,291020,291020,291022,0,2,0
83076,5,3,291025,291025,291028,0,3,3
83077,1,2,291026,291028,291030,2,4,0
83078,5,3,291031,291031,291034,0,3,1
83079,1,1,291032,291034,291035,2,3,0
83080,1,1,291033,291035,291036,2,3,0
83081,3,1,291036,291036,291037,0,1,0
83082,1,1,291037,291037,291038,0,1,0
83083,6,3,291043,291043,291046,0,3,5
83084,4,3,291047,291047,291050,0,3,1
83085,6,2,291053,291053,291055,0,2,3
83086,3,2,291056,291056,291058,0,2,1
83087,3,3,291059,291059,291062,0,3,1
83088,3,1,291062,291062,291063,0,1,0
83089,4,2,291066,291066,291068,0,2,3
83090,6,3,291072,291072,291075,0,3,4
83091,5,3,291077,291077,291080,0,3,2
83092,5,3,291082,291082,291085,0,3,2
83093,5,2,291087,291087,291089,0,2,2
83094,2,3,291089,291089,291092,0,3,0
83095,5,1,291094,291094,291095,0,1,2
83096,5,1,291099,291099,291100,0,1,4
83097,2,2,291101,291101,291103,0,2,1
83098,5,3,291106,291106,291109,0,3,3
83099,6,3,291112,291112,291115,0,3,3
83100,5,3,291117,291117,291120,0,3,2
83101,2,1,291119,291120,291121,1,2,0
83102,5,3,291124,291124,291127,0,3,3
83103,5,1,291129,291129,291130,0,1,2
83104,3,3,291132,291132,291135,0,3,2
83105,5,2,291137,291137,291139,0,2,2
83106,2,3,291139,291139,291142,0,3,0
83107,1,1,291140,291142,291143,2,3,0
83108,1,1,291141,291143,291144,2,3,0
83109,1,1,291142,291144,291145,2,3,0
83110,4,1,291146,291146,291147,0,1,1
83111,6,1,291152,291152,291153,0,1,5
83112,6,1,291158,291158,291159,0,1,5
83113,6,1,291164,291164,291165,0,1,5
83114,6,1,291170,291170,291171,0,1,5
83115,4,2,291174,291174,291176,0,2,3
83116,2,2,291176,291176,291178,0,2,0
83117,5,3,291181,291181,291184,0,3,3
83118,3,2,291184,291184,291186,0,2,0
83119,3,2,291187,291187,291189,0,2,1
83120,5,2,291192,291192,291194,0,2,3
83121,1,1,291193,291194,291195,1,2,0
83122,2,1,291195,291195,291196,0,1,0
83123,4,3,291199,291199,291202,0,3,3
83124,4,2,291203,291203,291205,0,2,1
83125,4,1,291207,291207,291208,0,1,2
83126,1,2,291208,291208,291210,0,2,0
83127,4,3,291212,291212,291215,0,3,2
83128,2,3,291214,291215,291218,1,4,0
83129,1,3,291215,291218,291221,3,6,0
83130,5,3,291220,291221,291224,1,4,0
83131,2,3,291222,291224,291227,2,5,0
83132,4,3,291226,291227,291230,1,4,0
83133,2,1,291228,291230,291231,2,3,0
83134,4,2,291232,291232,291234,0,2,1
83135,4,2,291236,291236,291238,0,2,2
83136,1,3,291237,291238,291241,1,4,0
83137,2,2,291239,291241,291243,2,4,0
83138,2,3,291241,291243,291246,2,5,0
83139,3,3,291244,291246,291249,2,5,0
83140,6,1,291250,291250,291251,0,1,1
83141,4,2,291254,291254,291256,0,2,3
83142,5,2,291259,291259,291261,0,2,3
83143,1,1,291260,291261,291262,1,2,0
83144,4,2,291264,291264,291266,0,2,2
83145,1,1,291265,291266,291267,1,2,0
83146,3,3,291268,291268,291271,0,3,1
83147,3,2,291271,291271,291273,0,2,0
83148,3,1,291274,291274,291275,0,1,1
83149,2,2,291276,291276,291278,0,2,1
83150,3,3,291279,291279,291282,0,3,1
83151,1,2,291280,291282,291284,2,4,0
83152,2,3,291282,291284,291287,2,5,0
83153,5,2,291287,291287,291289,0,2,0
83154,3,1,291290,291290,291291,0,1,1
83155,3,3,291293,291293,291296,0,3,2
83156,6,1,291299,291299,291300,0,1,3
83157,3,3,291302,291302,291305,0,3,2
83158,1,3,291303,291305,291308,2,5,0
83159,3,2,291306,291308,291310,2,4,0
83160,4,3,291310,291310,291313,0,3,0
83161,1,2,291311,291313,291315,2,4,0
83162,1,2,291312,291315,291317,3,5,0
83163,6,2,291318,291318,291320,0,2,1
83164,4,1,291322,291322,291323,0,1,2
83165,6,3,291328,291328,291331,0,3,5
83166,1,2,291329,291331,291333,2,4,0
83167,2,3,291331,291333,291336,2,5,0
83168,6,2,291337,291337,291339,0,2,1
83169,2,1,291339,291339,291340,0,1,0
83170,4,3,291343,291343,291346,0,3,3
83171,4,1,291347,291347,291348,0,1,1
83172,4,1,291351,291351,291352,0,1,3
83173,2,2,291353,291353,291355,0,2,1
83174,5,2,291358,291358,291360,0,2,3
83175,1,1,291359,291360,291361,1,2,0
83176,5,2,291364,291364,291366,0,2,3
83177,6,1,291370,291370,291371,0,1,4
83178,6,3,291376,291376,291379,0,3,5
83179,3,1,291379,291379,291380,0,1,0
83180,2,1,291381,291381,291382,0,1,1
83181,3,2,291384,291384,291386,0,2,2
83182,1,2,291385,291386,291388,1,3,0
83183,5,1,291390,291390,291391,0,1,2
83184,5,3,291395,291395,291398,0,3,4
83185,5,2,291400,291400,291402,0,2,2
83186,3,1,291403,291403,291404,0,1,1
83187,3,3,291406,291406,291409,0,3,2
83188,5,1,291411,291411,291412,0,1,2
83189,3,3,291414,291414,291417,0,3,2
83190,6,1,291420,291420,291421,0,1,3
83191,2,2,291422,291422,291424,0,2,1
83192,1,3,291423,291424,291427,1,4,0
83193,6,2,291429,291429,291431,0,2,2
83194,1,2,291430,291431,291433,1,3,0
83195,5,1,291435,291435,291436,0,1,2
83196,2,1,291437,291437,291438,0,1,1
83197,2,3,291439,291439,291442,0,3,1
83198,5,1,291444,291444,291445,0,1,2
83199,4,3,291448,291448,291451,0,3,3
83200,3,3,291451,291451,291454,0,3,0
83201,5,3,291456,291456,291459,0,3,2
83202,6,3,291462,291462,291465,0,3,3
83203,3,1,291465,291465,291466,0,1,0
83204,6,3,291471,291471,291474,0,3,5
83205,2,2,291473,291474,291476,1,3,0
83206,5,2,291478,291478,291480,0,2,2
83207,6,2,291484,291484,291486,0,2,4
83208,4,2,291488,291488,291490,0,2,2
83209,3,3,291491,291491,291494,0,3,1
83210,3,3,291494,291494,291497,0,3,0
83211,3,2,291497,291497,291499,0,2,0
83212,6,1,291503,291503,291504,0,1,4
83213,4,2,291507,291507,291509,0,2,3
83214,6,2,291513,291513,291515,0,2,4
83215,2,1,291515,291515,291516,0,1,0
83216,2,1,291517,291517,291518,0,1,1
83217,1,1,291518,291518,291519,0,1,0
83218,4,2,291522,291522,291524,0,2,3
83219,4,3,291526,291526,291529,0,3,2
83220,2,2,291528,291529,291531,1,3,0
83221,6,2,291534,291534,291536,0,2,3
83222,1,3,291535,291536,291539,1,4,0
83223,3,1,291538,291539,291540,1,2,0
83224,3,1,291541,291541,291542,0,1,1
83225,6,1,291547,291547,291548,0,1,5
83226,3,3,291550,291550,291553,0,3,2
83227,1,1,291551,291553,291554,2,3,0
83228,4,2,291555,291555,291557,0,2,1
83229,3,2,291558,291558,291560,0,2,1
83230,4,3,291562,291562,291565,0,3,2
83231,1,1,291563,291565,291566,2,3,0
83232,4,1,291567,291567,291568,0,1,1
83233,2,2,291569,291569,291571,0,2,1
83234,3,2,291572,291572,291574,0,2,1
83235,5,1,291577,291577,291578,0,1,3
83236,3,1,291580,291580,291581,0,1,2
83237,2,1,291582,291582,291583,0,1,1
83238,3,3,291585,291585,291588,0,3,2
83239,6,2,291591,291591,291593,0,2,3
83240,4,3,291595,291595,291598,0,3,2
83241,3,3,291598,291598,291601,0,3,0
83242,4,1,291602,291602,291603,0,1,1
83243,6,1,291608,291608,291609,0,1,5
83244,6,2,291614,291614,291616,0,2,5
83245,2,2,291616,291616,291618,0,2,0
83246,1,1,291617,291618,291619,1,2,0
83247,4,3,291621,291621,291624,0,3,2
83248,6,2,291627,291627,291629,0,2,3
83249,1,2,291628,291629,291631,1,3,0
83250,4,3,291632,291632,291635,0,3,1
83251,2,3,291634,291635,291638,1,4,0
83252,6,1,291640,291640,291641,0,1,2
83253,5,1,291645,291645,291646,0,1,4
83254,4,2,291649,291649,291651,0,2,3
83255,1,1,291650,291651,291652,1,2,0
83256,6,3,291656,291656,291659,0,3,4
83257,1,2,291657,291659,291661,2,4,0
83258,3,2,291660,291661,291663,1,3,0
83259,6,2,291666,291666,291668,0,2,3
83260,5,3,291671,291671,291674,0,3,3
83261,1,2,291672,291674,291676,2,4,0
83262,4,1,291676,291676,291677,0,1,0
83263,2,3,291678,291678,291681,0,3,1
83264,2,3,291680,291681,291684,1,4,0
83265,6,2,291686,291686,291688,0,2,2
83266,3,2,291689,291689,291691,0,2,1
83267,3,3,291692,291692,291695,0,3,1
83268,6,1,291698,291698,291699,0,1,3
83269,2,1,291700,291700,291701,0,1,1
83270,3,2,291703,291703,291705,0,2,2
83271,4,1,291707,291707,291708,0,1,2
83272,4,1,291711,291711,291712,0,1,3
83273,2,1,291713,291713,291714,0,1,1
83274,5,3,291718,291718,291721,0,3,4
83275,3,2,291721,291721,291723,0,2,0
83276,5,3,291726,291726,291729,0,3,3
83277,5,2,291731,291731,291733,0,2,2
83278,5,3,291736,291736,291739,0,3,3
83279,2,3,291738,291739,291742,1,4,0
83280,5,3,291743,291743,291746,0,3,1
83281,3,3,291746,291746,291749,0,3,0
83282,5,3,291751,291751,291754,0,3,2
83283,1,2,291752,291754,291756,2,4,0
83284,4,3,291756,291756,291759,0,3,0
83285,6,1,291762,291762,291763,0,1,3
83286,2,3,291764,291764,291767,0,3,1
83287,2,2,291766,291767,291769,1,3,0
83288,3,3,291769,291769,291772,0,3,0
83289,1,1,291770,291772,291773,2,3,0
83290,2,3,291772,291773,291776,1,4,0
83291,3,2,291775,291776,291778,1,3,0
83292,4,1,291779,291779,291780,0,1,1
83293,1,2,291780,291780,291782,0,2,0
83294,4,3,291784,291784,291787,0,3,2
83295,4,3,291788,291788,291791,0,3,1
83296,6,2,291794,291794,291796,0,2,3
83297,3,1,291797,291797,291798,0,1,1
83298,5,3,291802,291802,291805,0,3,4
83299,4,3,291806,291806,291809,0,3,1
83300,5,2,291811,291811,291813,0,2,2
83301,2,2,291813,291813,291815,0,2,0
83302,6,3,291819,291819,291822,0,3,4
83303,2,3,291821,291822,291825,1,4,0
83304,4,1,291825,291825,291826,0,1,0
83305,5,1,291830,291830,291831,0,1,4
83306,3,3,291833,291833,291836,0,3,2
83307,2,2,291835,291836,291838,1,3,0
83308,4,3,291839,291839,291842,0,3,1
83309,1,2,291840,291842,291844,2,4,0
83310,1,1,291841,291844,291845,3,4,0
83311,1,3,291842,291845,291848,3,6,0
83312,6,3,291848,291848,291851,0,3,0
83313,3,1,291851,291851,291852,0,1,0
83314,1,3,291852,291852,291855,0,3,0
83315,5,3,291857,291857,291860,0,3,2
83316,3,1,291860,291860,291861,0,1,0
83317,4,2,291864,291864,291866,0,2,3
83318,1,3,291865,291866,291869,1,4,0
83319,5,1,291870,291870,291871,0,1,1
83320,5,1,291875,291875,291876,0,1,4
83321,1,3,291876,291876,291879,0,3,0
83322,5,1,291881,291881,291882,0,1,2
83323,4,1,291885,291885,291886,0,1,3
83324,4,2,291889,291889,291891,0,2,3
83325,3,3,291892,291892,291895,0,3,1
83326,1,1,291893,291895,291896,2,3,0
83327,4,1,291897,291897,291898,0,1,1
83328,6,1,291903,291903,291904,0,1,5
83329,6,1,291909,291909,291910,0,1,5
83330,4,1,291913,291913,291914,0,1,3
83331,3,1,291916,291916,291917,0,1,2
83332,3,2,291919,291919,291921,0,2,2
83333,6,3,291925,291925,291928,0,3,4
83334,3,2,291928,291928,291930,0,2,0
83335,4,1,291932,291932,291933,0,1,2
83336,5,2,291937,291937,291939,0,2,4
83337,1,1,291938,291939,291940,1,2,0
83338,2,3,291940,291940,291943,0,3,0
83339,4,1,291944,291944,291945,0,1,1
83340,1,3,291945,291945,291948,0,3,0
83341,5,3,291950,291950,291953,0,3,2
83342,2,2,291952,291953,291955,1,3,0
83343,5,3,291957,291957,291960,0,3,2
83344,4,2,291961,291961,291963,0,2,1
83345,4,2,291965,291965,291967,0,2,2
83346,1,1,291966,291967,291968,1,2,0
83347,2,2,291968,291968,291970,0,2,0
83348,3,3,291971,291971,291974,0,3,1
83349,2,1,291973,291974,291975,1,2,0
83350,4,2,291977,291977,291979,0,2,2
83351,2,2,291979,291979,291981,0,2,0
83352,4,2,291983,291983,291985,0,2,2
83353,4,1,291987,291987,291988,0,1,2
83354,5,2,291992,291992,291994,0,2,4
83355,1,2,291993,291994,291996,1,3,0
83356,1,3,291994,291996,291999,2,5,0
83357,4,2,291998,291999,292001,1,3,0
83358,3,2,292001,292001,292003,0,2,0
83359,3,3,292004,292004,292007,0,3,1
83360,5,1,292009,292009,292010,0,1,2
83361,2,1,292011,292011,292012,0,1,1
83362,6,1,292017,292017,292018,0,1,5
83363,5,3,292022,292022,292025,0,3,4
83364,2,3,292024,292025,292028,1,4,0
83365,5,2,292029,292029,292031,0,2,1
83366,5,1,292034,292034,292035,0,1,3
83367,6,2,292040,292040,292042,0,2,5
83368,1,3,292041,292042,292045,1,4,0
83369,3,2,292044,292045,292047,1,3,0
83370,3,2,292047,292047,292049,0,2,0
83371,1,3,292048,292049,292052,1,4,0
83372,6,3,292054,292054,292057,0,3,2
83373,3,2,292057,292057,292059,0,2,0
83374,5,3,292062,292062,292065,0,3,3
83375,3,1,292065,292065,292066,0,1,0
83376,6,2,292071,292071,292073,0,2,5
83377,5,1,292076,292076,292077,0,1,3
83378,4,2,292080,292080,292082,0,2,3
83379,5,1,292085,292085,292086,0,1,3
83380,1,3,292086,292086,292089,0,3,0
83381,5,3,292091,292091,292094,0,3,2
83382,1,2,292092,292094,292096,2,4,0
83383,4,2,292096,292096,292098,0,2,0
83384,1,2,292097,292098,292100,1,3,0
83385,2,3,292099,292100,292103,1,4,0
83386,2,1,292101,292103,292104,2,3,0
83387,3,1,292104,292104,292105,0,1,0
83388,6,2,292110,292110,292112,0,2,5
83389,5,1,292115,292115,292116,0,1,3
83390,4,2,292119,292119,292121,0,2,3
83391,3,3,292122,292122,292125,0,3,1
83392,4,2,292126,292126,292128,0,2,1
83393,4,1,292130,292130,292131,0,1,2
83394,4,1,292134,292134,292135,0,1,3
83395,2,2,292136,292136,292138,0,2,1
83396,6,2,292142,292142,292144,0,2,4
83397,1,1,292143,292144,292145,1,2,0
83398,4,3,292147,292147,292150,0,3,2
83399,2,3,292149,292150,292153,1,4,0
83400,4,2,292153,292153,292155,0,2,0
83401,4,2,292157,292157,292159,0,2,2
83402,4,3,292161,292161,292164,0,3,2
83403,1,3,292162,292164,292167,2,5,0
83404,3,3,292165,292167,292170,2,5,0
83405,3,1,292168,292170,292171,2,3,0
83406,4,2,292172,292172,292174,0,2,1
83407,5,3,292177,292177,292180,0,3,3
83408,4,3,292181,292181,292184,0,3,1
83409,4,3,292185,292185,292188,0,3,1
83410,1,3,292186,292188,292191,2,5,0
83411,4,1,292190,292191,292192,1,2,0
83412,4,2,292194,292194,292196,0,2,2
83413,2,2,292196,292196,292198,0,2,0
83414,4,2,292200,292200,292202,0,2,2
83415,6,2,292206,292206,292208,0,2,4
83416,4,1,292210,292210,292211,0,1,2
83417,2,1,292212,292212,292213,0,1,1
83418,2,1,292214,292214,292215,0,1,1
83419,6,3,292220,292220,292223,0,3,5
83420,6,1,292226,292226,292227,0,1,3
83421,4,2,292230,292230,292232,0,2,3
83422,1,2,292231,292232,292234,1,3,0
83423,3,1,292234,292234,292235,0,1,0
83424,1,1,292235,292235,292236,0,1,0
83425,5,2,292240,292240,292242,0,2,4
83426,5,1,292245,292245,292246,0,1,3
83427,6,1,292251,292251,292252,0,1,5
83428,4,2,292255,292255,292257,0,2,3
83429,2,1,292257,292257,292258,0,1,0
83430,6,3,292263,292263,292266,0,3,5
83431,2,2,292265,292266,292268,1,3,0
83432,6,1,292271,292271,292272,0,1,3
83433,5,1,292276,292276,292277,0,1,4
83434,4,1,292280,292280,292281,0,1,3
83435,5,1,292285,292285,292286,0,1,4
83436,4,2,292289,292289,292291,0,2,3
83437,1,1,292290,292291,292292,1,2,0
83438,4,1,292294,292294,292295,0,1,2
83439,1,1,292295,292295,292296,0,1,0
83440,6,1,292301,292301,292302,0,1,5
83441,5,3,292306,292306,292309,0,3,4
83442,6,3,292312,292312,292315,0,3,3
83443,1,3,292313,292315,292318,2,5,0
83444,4,2,292317,292318,292320,1,3,0
83445,1,2,292318,292320,292322,2,4,0
83446,4,2,292322,292322,292324,0,2,0
83447,4,3,292326,292326,292329,0,3,2
83448,1,2,292327,292329,292331,2,4,0
83449,6,2,292333,292333,292335,0,2,2
83450,6,3,292339,292339,292342,0,3,4
83451,2,3,292341,292342,292345,1,4,0
83452,3,1,292344,292345,292346,1,2,0
83453,5,1,292349,292349,292350,0,1,3
83454,3,3,292352,292352,292355,0,3,2
83455,4,1,292356,292356,292357,0,1,1
83456,6,3,292362,292362,292365,0,3,5
83457,1,2,292363,292365,292367,2,4,0
83458,4,2,292367,292367,292369,0,2,0
83459,1,2,292368,292369,292371,1,3,0
83460,6,3,292374,292374,292377,0,3,3
83461,2,2,292376,292377,292379,1,3,0
83462,4,3,292380,292380,292383,0,3,1
83463,2,3,292382,292383,292386,1,4,0
83464,2,2,292384,292386,292388,2,4,0
83465,5,2,292389,292389,292391,0,2,1
83466,3,2,292392,292392,292394,0,2,1
83467,1,2,292393,292394,292396,1,3,0
83468,2,2,292395,292396,292398,1,3,0
83469,3,1,292398,292398,292399,0,1,0
83470,4,3,292402,292402,292405,0,3,3
83471,6,2,292408,292408,292410,0,2,3
83472,1,1,292409,292410,292411,1,2,0
83473,2,1,292411,292411,292412,0,1,0
83474,3,3,292414,292414,292417,0,3,2
83475,6,3,292420,292420,292423,0,3,3
83476,1,3,292421,292423,292426,2,5,0
83477,5,2,292426,292426,292428,0,2,0
83478,4,2,292430,292430,292432,0,2,2
83479,3,3,292433,292433,292436,0,3,1
83480,2,2,292435,292436,292438,1,3,0
83481,1,2,292436,292438,292440,2,4,0
83482,6,2,292442,292442,292444,0,2,2
83483,1,3,292443,292444,292447,1,4,0
83484,5,3,292448,292448,292451,0,3,1
83485,3,2,292451,292451,292453,0,2,0
83486,3,1,292454,292454,292455,0,1,1
83487,6,2,292460,292460,292462,0,2,5
83488,3,1,292463,292463,292464,0,1,1
83489,1,1,292464,292464,292465,0,1,0
83490,4,1,292468,292468,292469,0,1,3
83491,1,2,292469,292469,292471,0,2,0
83492,3,1,292472,292472,292473,0,1,1
83493,3,3,292475,292475,292478,0,3,2
83494,5,1,292480,292480,292481,0,1,2
83495,2,3,292482,292482,292485,0,3,1
83496,2,2,292484,292485,292487,1,3,0
83497,5,3,292489,292489,292492,0,3,2
83498,4,1,292493,292493,292494,0,1,1
83499,2,2,292495,292495,292497,0,2,1
83500,2,2,292497,292497,292499,0,2,0
83501,4,3,292501,292501,292504,0,3,2
83502,3,1,292504,292504,292505,0,1,0
83503,5,2,292509,292509,292511,0,2,4
83504,3,1,292512,292512,292513,0,1,1
83505,1,3,292513,292513,292516,0,3,0
83506,6,1,292519,292519,292520,0,1,3
83507,6,3,292525,292525,292528,0,3,5
83508,1,3,292526,292528,292531,2,5,0
83509,1,2,292527,292531,292533,4,6,0
83510,5,3,292532,292533,292536,1,4,0
83511,5,2,292537,292537,292539,0,2,1
83512,5,2,292542,292542,292544,0,2,3
83513,5,2,292547,292547,292549,0,2,3
83514,5,3,292552,292552,292555,0,3,3
83515,1,1,292553,292555,292556,2,3,0
83516,6,3,292559,292559,292562,0,3,3
83517,5,1,292564,292564,292565,0,1,2
83518,6,1,292570,292570,292571,0,1,5
83519,6,2,292576,292576,292578,0,2,5
83520,4,3,292580,292580,292583,0,3,2
83521,3,3,292583,292583,292586,0,3,0
83522,6,3,292589,292589,292592,0,3,3
83523,1,3,292590,292592,292595,2,5,0
83524,1,2,292591,292595,292597,4,6,0
83525,3,1,292594,292597,292598,3,4,0
83526,3,3,292597,292598,292601,1,4,0
83527,4,2,292601,292601,292603,0,2,0
83528,5,3,292606,292606,292609,0,3,3
83529,6,3,292612,292612,292615,0,3,3
83530,1,1,292613,292615,292616,2,3,0
83531,5,3,292618,292618,292621,0,3,2
83532,5,3,292623,292623,292626,0,3,2
83533,2,3,292625,292626,292629,1,4,0
83534,1,2,292626,292629,292631,3,5,0
83535,2,3,292628,292631,292634,3,6,0
83536,4,2,292632,292634,292636,2,4,0
83537,4,1,292636,292636,292637,0,1,0
83538,4,2,292640,292640,292642,0,2,3
83539,5,3,292645,292645,292648,0,3,3
83540,1,3,292646,292648,292651,2,5,0
83541,4,1,292650,292651,292652,1,2,0
83542,2,1,292652,292652,292653,0,1,0
83543,1,3,292653,292653,292656,0,3,0
83544,1,2,292654,292656,292658,2,4,0
83545,4,2,292658,292658,292660,0,2,0
83546,4,3,292662,292662,292665,0,3,2
83547,1,3,292663,292665,292668,2,5,0
83548,1,2,292664,292668,292670,4,6,0
83549,6,3,292670,292670,292673,0,3,0
83550,6,3,292676,292676,292679,0,3,3
83551,2,1,292678,292679,292680,1,2,0
83552,1,2,292679,292680,292682,1,3,0
83553,6,2,292685,292685,292687,0,2,3
83554,4,3,292689,292689,292692,0,3,2
83555,3,2,292692,292692,292694,0,2,0
83556,6,1,292698,292698,292699,0,1,4
83557,2,3,292700,292700,292703,0,3,1
83558,1,2,292701,292703,292705,2,4,0
83559,5,2,292706,292706,292708,0,2,1
83560,2,1,292708,292708,292709,0,1,0
83561,5,2,292713,292713,292715,0,2,4
83562,3,3,292716,292716,292719,0,3,1
83563,5,3,292721,292721,292724,0,3,2
83564,3,2,292724,292724,292726,0,2,0
83565,3,3,292727,292727,292730,0,3,1
83566,6,1,292733,292733,292734,0,1,3
83567,4,2,292737,292737,292739,0,2,3
83568,5,1,292742,292742,292743,0,1,3
83569,4,2,292746,292746,292748,0,2,3
83570,3,3,292749,292749,292752,0,3,1
83571,6,1,292755,292755,292756,0,1,3
83572,6,1,292761,292761,292762,0,1,5
83573,1,1,292762,292762,292763,0,1,0
83574,6,1,292768,292768,292769,0,1,5
83575,2,2,292770,292770,292772,0,2,1
83576,3,3,292773,292773,292776,0,3,1
83577,4,2,292777,292777,292779,0,2,1
83578,4,2,292781,292781,292783,0,2,2
83579,5,3,292786,292786,292789,0,3,3
83580,4,2,292790,292790,292792,0,2,1
83581,1,1,292791,292792,292793,1,2,0
83582,5,3,292796,292796,292799,0,3,3
83583,6,2,292802,292802,292804,0,2,3
83584,1,2,292803,292804,292806,1,3,0
83585,2,3,292805,292806,292809,1,4,0
83586,6,2,292811,292811,292813,0,2,2
83587,4,2,292815,292815,292817,0,2,2
83588,4,1,292819,292819,292820,0,1,2
83589,6,3,292825,292825,292828,0,3,5
83590,2,3,292827,292828,292831,1,4,0
83591,3,3,292830,292831,292834,1,4,0
83592,2,3,292832,292834,292837,2,5,0
83593,4,2,292836,292837,292839,1,3,0
83594,4,3,292840,292840,292843,0,3,1
83595,4,3,292844,292844,292847,0,3,1
83596,1,3,292845,292847,292850,2,5,0
83597,6,3,292851,292851,292854,0,3,1
83598,4,2,292855,292855,292857,0,2,1
83599,6,3,292861,292861,292864,0,3,4
83600,3,1,292864,292864,292865,0,1,0
83601,2,2,292866,292866,292868,0,2,1
83602,4,2,292870,292870,292872,0,2,2
83603,5,1,292875,292875,292876,0,1,3
83604,6,1,292881,292881,292882,0,1,5
83605,3,3,292884,292884,292887,0,3,2
83606,4,2,292888,292888,292890,0,2,1
83607,4,3,292892,292892,292895,0,3,2
83608,2,1,292894,292895,292896,1,2,0
83609,2,1,292896,292896,292897,0,1,0
83610,1,2,292897,292897,292899,0,2,0
83611,1,3,292898,292899,292902,1,4,0
83612,6,1,292904,292904,292905,0,1,2
83613,4,2,292908,292908,292910,0,2,3
83614,1,3,292909,292910,292913,1,4,0
83615,5,1,292914,292914,292915,0,1,1
83616,4,1,292918,292918,292919,0,1,3
83617,1,1,292919,292919,292920,0,1,0
83618,3,1,292922,292922,292923,0,1,2
83619,3,1,292925,292925,292926,0,1,2
83620,2,1,292927,292927,292928,0,1,1
83621,5,3,292932,292932,292935,0,3,4
83622,2,3,292934,292935,292938,1,4,0
83623,3,2,292937,292938,292940,1,3,0
83624,6,1,292943,292943,292944,0,1,3
83625,1,1,292944,292944,292945,0,1,0
83626,6,2,292950,292950,292952,0,2,5
83627,1,2,292951,292952,292954,1,3,0
83628,6,3,292957,292957,292960,0,3,3
83629,3,1,292960,292960,292961,0,1,0
83630,1,1,292961,292961,292962,0,1,0
83631,5,2,292966,292966,292968,0,2,4
83632,5,2,292971,292971,292973,0,2,3
83633,5,2,292976,292976,292978,0,2,3
83634,6,1,292982,292982,292983,0,1,4
83635,2,2,292984,292984,292986,0,2,1
83636,5,2,292989,292989,292991,0,2,3
83637,6,2,292995,292995,292997,0,2,4
83638,3,1,292998,292998,292999,0,1,1
83639,1,1,292999,292999,293000,0,1,0
83640,6,1,293005,293005,293006,0,1,5
83641,6,3,293011,293011,293014,0,3,5
83642,3,2,293014,293014,293016,0,2,0
83643,5,1,293019,293019,293020,0,1,3
83644,4,1,293023,293023,293024,0,1,3
83645,4,2,293027,293027,293029,0,2,3
83646,4,2,293031,293031,293033,0,2,2
83647,1,1,293032,293033,293034,1,2,0
83648,1,2,293033,293034,293036,1,3,0
83649,1,3,293034,293036,293039,2,5,0
83650,1,1,293035,293039,293040,4,5,0
83651,1,1,293036,293040,293041,4,5,0
83652,4,1,293040,293041,293042,1,2,0
83653,6,3,293046,293046,293049,0,3,4
83654,5,3,293051,293051,293054,0,3,2
83655,6,2,293057,293057,293059,0,2,3
83656,3,1,293060,293060,293061,0,1,1
83657,4,1,293064,293064,293065,0,1,3
83658,5,3,293069,293069,293072,0,3,4
83659,2,2,293071,293072,293074,1,3,0
83660,3,3,293074,293074,293077,0,3,0
83661,6,3,293080,293080,293083,0,3,3
83662,3,2,293083,293083,293085,0,2,0
83663,6,3,293089,293089,293092,0,3,4
83664,5,2,293094,293094,293096,0,2,2
83665,1,1,293095,293096,293097,1,2,0
83666,5,2,293100,293100,293102,0,2,3
83667,1,1,293101,293102,293103,1,2,0
83668,6,3,293107,293107,293110,0,3,4
83669,6,2,293113,293113,293115,0,2,3
83670,2,2,293115,293115,293117,0,2,0
83671,4,1,293119,293119,293120,0,1,2
83672,4,1,293123,293123,293124,0,1,3
83673,2,3,293125,293125,293128,0,3,1
83674,2,1,293127,293128,293129,1,2,0
83675,5,3,293132,293132,293135,0,3,3
83676,6,3,293138,293138,293141,0,3,3
83677,2,2,293140,293141,293143,1,3,0
83678,5,1,293145,293145,293146,0,1,2
83679,6,1,293151,293151,293152,0,1,5
83680,6,2,293157,293157,293159,0,2,5
83681,6,2,293163,293163,293165,0,2,4
83682,4,3,293167,293167,293170,0,3,2
83683,5,1,293172,293172,293173,0,1,2
83684,3,3,293175,293175,293178,0,3,2
83685,5,2,293180,293180,293182,0,2,2
83686,3,1,293183,293183,293184,0,1,1
83687,4,2,293187,293187,293189,0,2,3
83688,2,3,293189,293189,293192,0,3,0
83689,5,1,293194,293194,293195,0,1,2
83690,5,1,293199,293199,293200,0,1,4
83691,6,2,293205,293205,293207,0,2,5
83692,5,1,293210,293210,293211,0,1,3
83693,1,1,293211,293211,293212,0,1,0
83694,3,3,293214,293214,293217,0,3,2
83695,6,3,293220,293220,293223,0,3,3
83696,6,1,293226,293226,293227,0,1,3
83697,5,2,293231,293231,293233,0,2,4
83698,1,2,293232,293233,293235,1,3,0
83699,2,2,293234,293235,293237,1,3,0
83700,4,2,293238,293238,293240,0,2,1
83701,5,1,293243,293243,293244,0,1,3
83702,3,3,293246,293246,293249,0,3,2
83703,4,2,293250,293250,293252,0,2,1
83704,5,1,293255,293255,293256,0,1,3
83705,4,1,293259,293259,293260,0,1,3
83706,2,3,293261,293261,293264,0,3,1
83707,4,3,293265,293265,293268,0,3,1
83708,3,3,293268,293268,293271,0,3,0
83709,2,1,293270,293271,293272,1,2,0
83710,2,2,293272,293272,293274,0,2,0
83711,2,1,293274,293274,293275,0,1,0
83712,4,1,293278,293278,293279,0,1,3
83713,4,1,293282,293282,293283,0,1,3
83714,5,1,293287,293287,293288,0,1,4
83715,5,2,293292,293292,293294,0,2,4
83716,5,3,293297,293297,293300,0,3,3
83717,5,1,293302,293302,293303,0,1,2
83718,1,2,293303,293303,293305,0,2,0
83719,6,1,293309,293309,293310,0,1,4
83720,3,2,293312,293312,293314,0,2,2
83721,4,2,293316,293316,293318,0,2,2
83722,2,2,293318,293318,293320,0,2,0
83723,4,2,293322,293322,293324,0,2,2
83724,1,3,293323,293324,293327,1,4,0
83725,6,3,293329,293329,293332,0,3,2
83726,5,2,293334,293334,293336,0,2,2
83727,6,3,293340,293340,293343,0,3,4
83728,5,2,293345,293345,293347,0,2,2
83729,4,3,293349,293349,293352,0,3,2
83730,4,2,293353,293353,293355,0,2,1
83731,6,1,293359,293359,293360,0,1,4
83732,2,1,293361,293361,293362,0,1,1
83733,6,3,293367,293367,293370,0,3,5
83734,4,3,293371,293371,293374,0,3,1
83735,1,1,293372,293374,293375,2,3,0
83736,5,3,293377,293377,293380,0,3,2
83737,6,2,293383,293383,293385,0,2,3
83738,6,3,293389,293389,293392,0,3,4
83739,2,1,293391,293392,293393,1,2,0
83740,5,1,293396,293396,293397,0,1,3
83741,6,3,293402,293402,293405,0,3,5
83742,5,1,293407,293407,293408,0,1,2
83743,6,2,293413,293413,293415,0,2,5
83744,1,1,293414,293415,293416,1,2,0
83745,6,2,293420,293420,293422,0,2,4
83746,1,1,293421,293422,293423,1,2,0
83747,3,3,293424,293424,293427,0,3,1
83748,6,2,293430,293430,293432,0,2,3
83749,3,2,293433,293433,293435,0,2,1
83750,5,3,293438,293438,293441,0,3,3
83751,1,1,293439,293441,293442,2,3,0
83752,1,3,293440,293442,293445,2,5,0
83753,4,3,293444,293445,293448,1,4,0
83754,6,1,293450,293450,293451,0,1,2
83755,4,1,293454,293454,293455,0,1,3
83756,5,2,293459,293459,293461,0,2,4
83757,3,1,293462,293462,293463,0,1,1
83758,5,2,293467,293467,293469,0,2,4
83759,5,3,293472,293472,293475,0,3,3
83760,6,1,293478,293478,293479,0,1,3
83761,3,2,293481,293481,293483,0,2,2
83762,2,1,293483,293483,293484,0,1,0
83763,1,2,293484,293484,293486,0,2,0
83764,3,1,293487,293487,293488,0,1,1
83765,4,1,293491,293491,293492,0,1,3
83766,6,3,293497,293497,293500,0,3,5
83767,1,1,293498,293500,293501,2,3,0
83768,5,1,293503,293503,293504,0,1,2
83769,3,2,293506,293506,293508,0,2,2
83770,5,1,293511,293511,293512,0,1,3
83771,6,1,293517,293517,293518,0,1,5
83772,5,3,293522,293522,293525,0,3,4
83773,2,2,293524,293525,293527,1,3,0
83774,5,2,293529,293529,293531,0,2,2
83775,4,3,293533,293533,293536,0,3,2
83776,4,2,293537,293537,293539,0,2,1
83777,5,3,293542,293542,293545,0,3,3
83778,4,1,293546,293546,293547,0,1,1
83779,3,3,293549,293549,293552,0,3,2
83780,3,3,293552,293552,293555,0,3,0
83781,4,1,293556,293556,293557,0,1,1
83782,2,1,293558,293558,293559,0,1,1
83783,4,1,293562,293562,293563,0,1,3
83784,2,2,293564,293564,293566,0,2,1
83785,3,3,293567,293567,293570,0,3,1
83786,5,1,293572,293572,293573,0,1,2
83787,1,3,293573,293573,293576,0,3,0
83788,6,1,293579,293579,293580,0,1,3
83789,6,1,293585,293585,293586,0,1,5
83790,4,2,293589,293589,293591,0,2,3
83791,6,3,293595,293595,293598,0,3,4
83792,6,1,293601,293601,293602,0,1,3
83793,1,1,293602,293602,293603,0,1,0
83794,4,2,293606,293606,293608,0,2,3
83795,4,2,293610,293610,293612,0,2,2
83796,3,3,293613,293613,293616,0,3,1
83797,6,2,293619,293619,293621,0,2,3
83798,2,3,293621,293621,293624,0,3,0
83799,2,1,293623,293624,293625,1,2,0
83800,1,1,293624,293625,293626,1,2,0
83801,6,3,293630,293630,293633,0,3,4
83802,4,2,293634,293634,293636,0,2,1
83803,5,3,293639,293639,293642,0,3,3
83804,5,1,293644,293644,293645,0,1,2
83805,5,3,293649,293649,293652,0,3,4
83806,2,3,293651,293652,293655,1,4,0
83807,4,3,293655,293655,293658,0,3,0
83808,5,3,293660,293660,293663,0,3,2
83809,3,3,293663,293663,293666,0,3,0
83810,1,2,293664,293666,293668,2,4,0
83811,6,1,293670,293670,293671,0,1,2
83812,4,3,293674,293674,293677,0,3,3
83813,2,1,293676,293677,293678,1,2,0
83814,1,1,293677,293678,293679,1,2,0
83815,4,2,293681,293681,293683,0,2,2
83816,1,1,293682,293683,293684,1,2,0
83817,4,1,293686,293686,293687,0,1,2
83818,3,1,293689,293689,293690,0,1,2
83819,6,3,293695,293695,293698,0,3,5
83820,6,3,293701,293701,293704,0,3,3
83821,1,1,293702,293704,293705,2,3,0
83822,4,2,293706,293706,293708,0,2,1
83823,5,2,293711,293711,293713,0,2,3
83824,5,1,293716,293716,293717,0,1,3
83825,2,2,293718,293718,293720,0,2,1
83826,1,2,293719,293720,293722,1,3,0
83827,4,3,293723,293723,293726,0,3,1
83828,5,3,293728,293728,293731,0,3,2
83829,6,2,293734,293734,293736,0,2,3
83830,5,2,293739,293739,293741,0,2,3
83831,3,3,293742,293742,293745,0,3,1
83832,6,2,293748,293748,293750,0,2,3
83833,5,3,293753,293753,293756,0,3,3
83834,4,2,293757,293757,293759,0,2,1
83835,5,3,293762,293762,293765,0,3,3
83836,4,3,293766,293766,293769,0,3,1
83837,4,3,293770,293770,293773,0,3,1
83838,3,2,293773,293773,293775,0,2,0
83839,4,2,293777,293777,293779,0,2,2
83840,6,1,293783,293783,293784,0,1,4
83841,4,3,293787,293787,293790,0,3,3
83842,5,1,293792,293792,293793,0,1,2
83843,6,1,293798,293798,293799,0,1,5
83844,4,3,293802,293802,293805,0,3,3
83845,6,2,293808,293808,293810,0,2,3
83846,5,3,293813,293813,293816,0,3,3
83847,4,1,293817,293817,293818,0,1,1
83848,3,1,293820,293820,293821,0,1,2
83849,3,1,293823,293823,293824,0,1,2
83850,6,3,293829,293829,293832,0,3,5
83851,5,2,293834,293834,293836,0,2,2
83852,6,1,293840,293840,293841,0,1,4
83853,6,1,293846,293846,293847,0,1,5
83854,6,3,293852,293852,293855,0,3,5
83855,4,3,293856,293856,293859,0,3,1
83856,1,1,293857,293859,293860,2,3,0
83857,2,1,293859,293860,293861,1,2,0
83858,4,2,293863,293863,293865,0,2,2
83859,4,2,293867,293867,293869,0,2,2
83860,6,3,293873,293873,293876,0,3,4
83861,6,2,293879,293879,293881,0,2,3
83862,1,2,293880,293881,293883,1,3,0
83863,5,1,293885,293885,293886,0,1,2
83864,2,1,293887,293887,293888,0,1,1
83865,5,3,293892,293892,293895,0,3,4
83866,1,3,293893,293895,293898,2,5,0
83867,2,3,293895,293898,293901,3,6,0
83868,4,1,293899,293901,293902,2,3,0
83869,1,1,293900,293902,293903,2,3,0
83870,4,1,293904,293904,293905,0,1,1
83871,3,2,293907,293907,293909,0,2,2
83872,3,2,293910,293910,293912,0,2,1
83873,6,2,293916,293916,293918,0,2,4
83874,2,2,293918,293918,293920,0,2,0
83875,5,2,293923,293923,293925,0,2,3
83876,6,1,293929,293929,293930,0,1,4
83877,1,3,293930,293930,293933,0,3,0
83878,6,3,293936,293936,293939,0,3,3
83879,1,3,293937,293939,293942,2,5,0
83880,1,3,293938,293942,293945,4,7,0
83881,3,1,293941,293945,293946,4,5,0
83882,2,1,293943,293946,293947,3,4,0
83883,3,3,293946,293947,293950,1,4,0
83884,3,2,293949,293950,293952,1,3,0
83885,2,2,293951,293952,293954,1,3,0
83886,1,2,293952,293954,293956,2,4,0
83887,6,3,293958,293958,293961,0,3,2
83888,1,1,293959,293961,293962,2,3,0
83889,1,3,293960,293962,293965,2,5,0
83890,2,2,293962,293965,293967,3,5,0
83891,2,2,293964,293967,293969,3,5,0
83892,1,2,293965,293969,293971,4,6,0
83893,5,3,293970,293971,293974,1,4,0
83894,3,1,293973,293974,293975,1,2,0
83895,2,2,293975,293975,293977,0,2,0
83896,5,1,293980,293980,293981,0,1,3
83897,4,2,293984,293984,293986,0,2,3
83898,4,1,293988,293988,293989,0,1,2
83899,4,3,293992,293992,293995,0,3,3
83900,3,2,293995,293995,293997,0,2,0
83901,6,2,294001,294001,294003,0,2,4
83902,1,2,294002,294003,294005,1,3,0
83903,4,1,294006,294006,294007,0,1,1
83904,4,1,294010,294010,294011,0,1,3
83905,5,3,294015,294015,294018,0,3,4
83906,6,3,294021,294021,294024,0,3,3
83907,5,2,294026,294026,294028,0,2,2
83908,5,3,294031,294031,294034,0,3,3
83909,4,1,294035,294035,294036,0,1,1
83910,5,2,294040,294040,294042,0,2,4
83911,5,3,294045,294045,294048,0,3,3
83912,1,2,294046,294048,294050,2,4,0
83913,2,3,294048,294050,294053,2,5,0
83914,4,3,294052,294053,294056,1,4,0
83915,2,2,294054,294056,294058,2,4,0
83916,1,3,294055,294058,294061,3,6,0
83917,2,1,294057,294061,294062,4,5,0
83918,5,1,294062,294062,294063,0,1,0
83919,6,2,294068,294068,294070,0,2,5
83920,5,1,294073,294073,294074,0,1,3
83921,4,1,294077,294077,294078,0,1,3
83922,2,2,294079,294079,294081,0,2,1
83923,3,3,294082,294082,294085,0,3,1
83924,4,1,294086,294086,294087,0,1,1
83925,4,2,294090,294090,294092,0,2,3
83926,5,1,294095,294095,294096,0,1,3
83927,2,1,294097,294097,294098,0,1,1
83928,3,3,294100,294100,294103,0,3,2
83929,1,3,294101,294103,294106,2,5,0
83930,2,2,294103,294106,294108,3,5,0
83931,4,2,294107,294108,294110,1,3,0
83932,6,1,294113,294113,294114,0,1,3
83933,5,3,294118,294118,294121,0,3,4
83934,2,1,294120,294121,294122,1,2,0
83935,3,3,294123,294123,294126,0,3,1
83936,3,2,294126,294126,294128,0,2,0
83937,3,2,294129,294129,294131,0,2,1
83938,2,2,294131,294131,294133,0,2,0
83939,4,1,294135,294135,294136,0,1,2
83940,1,3,294136,294136,294139,0,3,0
83941,1,2,294137,294139,294141,2,4,0
83942,5,3,294142,294142,294145,0,3,1
83943,2,3,294144,294145,294148,1,4,0
83944,6,3,294150,294150,294153,0,3,2
83945,4,2,294154,294154,294156,0,2,1
83946,2,2,294156,294156,294158,0,2,0
83947,6,1,294162,294162,294163,0,1,4
83948,3,2,294165,294165,294167,0,2,2
83949,2,3,294167,294167,294170,0,3,0
83950,3,3,294170,294170,294173,0,3,0
83951,6,2,294176,294176,294178,0,2,3
83952,2,3,294178,294178,294181,0,3,0
83953,3,1,294181,294181,294182,0,1,0
83954,4,2,294185,294185,294187,0,2,3
83955,6,2,294191,294191,294193,0,2,4
83956,6,3,294197,294197,294200,0,3,4
83957,6,1,294203,294203,294204,0,1,3
83958,1,2,294204,294204,294206,0,2,0
83959,2,1,294206,294206,294207,0,1,0
83960,2,2,294208,294208,294210,0,2,1
83961,5,1,294213,294213,294214,0,1,3
83962,4,3,294217,294217,294220,0,3,3
83963,4,2,294221,294221,294223,0,2,1
83964,1,1,294222,294223,294224,1,2,0
83965,3,2,294225,294225,294227,0,2,1
83966,6,1,294231,294231,294232,0,1,4
83967,1,2,294232,294232,294234,0,2,0
83968,3,2,294235,294235,294237,0,2,1
83969,2,1,294237,294237,294238,0,1,0
83970,3,3,294240,294240,294243,0,3,2
83971,6,2,294246,294246,294248,0,2,3
83972,3,1,294249,294249,294250,0,1,1
83973,5,2,294254,294254,294256,0,2,4
83974,4,3,294258,294258,294261,0,3,2
83975,1,3,294259,294261,294264,2,5,0
83976,5,3,294264,294264,294267,0,3,0
83977,4,1,294268,294268,294269,0,1,1
83978,2,3,294270,294270,294273,0,3,1
83979,2,3,294272,294273,294276,1,4,0
83980,4,1,294276,294276,294277,0,1,0
83981,5,1,294281,294281,294282,0,1,4
83982,5,3,294286,294286,294289,0,3,4
83983,4,1,294290,294290,294291,0,1,1
83984,3,3,294293,294293,294296,0,3,2
83985,2,3,294295,294296,294299,1,4,0
83986,3,1,294298,294299,294300,1,2,0
83987,3,3,294301,294301,294304,0,3,1
83988,1,3,294302,294304,294307,2,5,0
83989,1,1,294303,294307,294308,4,5,0
83990,3,1,294306,294308,294309,2,3,0
83991,5,3,294311,294311,294314,0,3,2
83992,5,1,294316,294316,294317,0,1,2
83993,2,1,294318,294318,294319,0,1,1
83994,6,2,294324,294324,294326,0,2,5
83995,2,2,294326,294326,294328,0,2,0
83996,5,2,294331,294331,294333,0,2,3
83997,4,1,294335,294335,294336,0,1,2
83998,5,2,294340,294340,294342,0,2,4
83999,6,3,294346,294346,294349,0,3,4
84000,2,3,294348,294349,294352,1,4,0
84001,4,1,294352,294352,294353,0,1,0
84002,4,1,294356,294356,294357,0,1,3
84003,3,2,294359,294359,294361,0,2,2
84004,3,1,294362,294362,294363,0,1,1
84005,4,2,294366,294366,294368,0,2,3
84006,6,3,294372,294372,294375,0,3,4
84007,1,1,294373,294375,294376,2,3,0
84008,2,1,294375,294376,294377,1,2,0
84009,1,2,294376,294377,294379,1,3,0
84010,5,3,294381,294381,294384,0,3,2
84011,2,2,294383,294384,294386,1,3,0
84012,6,2,294389,294389,294391,0,2,3
84013,4,2,294393,294393,294395,0,2,2
84014,1,3,294394,294395,294398,1,4,0
84015,4,1,294398,294398,294399,0,1,0
84016,4,2,294402,294402,294404,0,2,3
84017,6,2,294408,294408,294410,0,2,4
84018,5,1,294413,294413,294414,0,1,3
84019,6,1,294419,294419,294420,0,1,5
84020,5,3,294424,294424,294427,0,3,4
84021,4,1,294428,294428,294429,0,1,1
84022,2,3,294430,294430,294433,0,3,1
84023,5,1,294435,294435,294436,0,1,2
84024,6,2,294441,294441,294443,0,2,5
84025,4,3,294445,294445,294448,0,3,2
84026,2,3,294447,294448,294451,1,4,0
84027,1,1,294448,294451,294452,3,4,0
84028,1,1,294449,294452,294453,3,4,0
84029,6,2,294455,294455,294457,0,2,2
84030,5,1,294460,294460,294461,0,1,3
84031,5,1,294465,294465,294466,0,1,4
84032,2,2,294467,294467,294469,0,2,1
84033,3,3,294470,294470,294473,0,3,1
84034,3,3,294473,294473,294476,0,3,0
84035,3,1,294476,294476,294477,0,1,0
84036,4,3,294480,294480,294483,0,3,3
84037,1,1,294481,294483,294484,2,3,0
84038,4,2,294485,294485,294487,0,2,1
84039,4,3,294489,294489,294492,0,3,2
84040,5,1,294494,294494,294495,0,1,2
84041,4,1,294498,294498,294499,0,1,3
84042,5,2,294503,294503,294505,0,2,4
84043,6,1,294509,294509,294510,0,1,4
84044,3,3,294512,294512,294515,0,3,2
84045,5,1,294517,294517,294518,0,1,2
84046,3,1,294520,294520,294521,0,1,2
84047,4,2,294524,294524,294526,0,2,3
84048,5,2,294529,294529,294531,0,2,3
84049,5,1,294534,294534,294535,0,1,3
84050,6,2,294540,294540,294542,0,2,5
84051,1,1,294541,294542,294543,1,2,0
84052,1,2,294542,294543,294545,1,3,0
84053,6,2,294548,294548,294550,0,2,3
84054,3,1,294551,294551,294552,0,1,1
84055,3,3,294554,294554,294557,0,3,2
84056,3,1,294557,294557,294558,0,1,0
84057,2,2,294559,294559,294561,0,2,1
84058,1,1,294560,294561,294562,1,2,0
84059,6,1,294566,294566,294567,0,1,4
84060,1,3,294567,294567,294570,0,3,0
84061,1,2,294568,294570,294572,2,4,0
84062,6,1,294574,294574,294575,0,1,2
84063,2,1,294576,294576,294577,0,1,1
84064,3,3,294579,294579,294582,0,3,2
84065,5,1,294584,294584,294585,0,1,2
84066,4,2,294588,294588,294590,0,2,3
84067,3,3,294591,294591,294594,0,3,1
84068,2,3,294593,294594,294597,1,4,0
84069,4,3,294597,294597,294600,0,3,0
84070,2,3,294599,294600,294603,1,4,0
84071,6,3,294605,294605,294608,0,3,2
84072,1,1,294606,294608,294609,2,3,0
84073,6,3,294612,294612,294615,0,3,3
84074,1,3,294613,294615,294618,2,5,0
84075,5,1,294618,294618,294619,0,1,0
84076,5,1,294623,294623,294624,0,1,4
84077,5,2,294628,294628,294630,0,2,4
84078,5,1,294633,294633,294634,0,1,3
84079,4,3,294637,294637,294640,0,3,3
84080,3,2,294640,294640,294642,0,2,0
84081,5,1,294645,294645,294646,0,1,3
84082,2,1,294647,294647,294648,0,1,1
84083,1,2,294648,294648,294650,0,2,0
84084,2,3,294650,294650,294653,0,3,0
84085,6,3,294656,294656,294659,0,3,3
84086,1,3,294657,294659,294662,2,5,0
84087,3,2,294660,294662,294664,2,4,0
84088,4,1,294664,294664,294665,0,1,0
84089,1,3,294665,294665,294668,0,3,0
84090,6,3,294671,294671,294674,0,3,3
84091,3,2,294674,294674,294676,0,2,0
84092,5,2,294679,294679,294681,0,2,3
84093,1,3,294680,294681,294684,1,4,0
84094,1,2,294681,294684,294686,3,5,0
84095,2,1,294683,294686,294687,3,4,0
84096,5,3,294688,294688,294691,0,3,1
84097,5,2,294693,294693,294695,0,2,2
84098,6,3,294699,294699,294702,0,3,4
84099,4,1,294703,294703,294704,0,1,1
84100,2,3,294705,294705,294708,0,3,1
84101,4,2,294709,294709,294711,0,2,1
84102,5,3,294714,294714,294717,0,3,3
84103,4,1,294718,294718,294719,0,1,1
84104,5,2,294723,294723,294725,0,2,4
84105,4,2,294727,294727,294729,0,2,2
84106,2,1,294729,294729,294730,0,1,0
84107,6,1,294735,294735,294736,0,1,5
84108,5,1,294740,294740,294741,0,1,4
84109,1,1,294741,294741,294742,0,1,0
84110,1,1,294742,294742,294743,0,1,0
84111,4,1,294746,294746,294747,0,1,3
84112,3,2,294749,294749,294751,0,2,2
84113,5,3,294754,294754,294757,0,3,3
84114,4,3,294758,294758,294761,0,3,1
84115,2,1,294760,294761,294762,1,2,0
84116,4,3,294764,294764,294767,0,3,2
84117,1,3,294765,294767,294770,2,5,0
84118,2,1,294767,294770,294771,3,4,0
84119,4,1,294771,294771,294772,0,1,0
84120,1,3,294772,294772,294775,0,3,0
84121,2,2,294774,294775,294777,1,3,0
84122,1,2,294775,294777,294779,2,4,0
84123,1,3,294776,294779,294782,3,6,0
84124,1,1,294777,294782,294783,5,6,0
84125,1,3,294778,294783,294786,5,8,0
84126,6,3,294784,294786,294789,2,5,0
84127,1,3,294785,294789,294792,4,7,0
84128,3,3,294788,294792,294795,4,7,0
84129,1,1,294789,294795,294796,6,7,0
84130,1,2,294790,294796,294798,6,8,0
84131,6,3,294796,294798,294801,2,5,0
84132,2,1,294798,294801,294802,3,4,0
84133,4,3,294802,294802,294805,0,3,0
84134,5,2,294807,294807,294809,0,2,2
84135,4,2,294811,294811,294813,0,2,2
84136,5,1,294816,294816,294817,0,1,3
84137,3,1,294819,294819,294820,0,1,2
84138,2,3,294821,294821,294824,0,3,1
84139,6,1,294827,294827,294828,0,1,3
84140,3,1,294830,294830,294831,0,1,2
84141,1,2,294831,294831,294833,0,2,0
84142,3,3,294834,294834,294837,0,3,1
84143,2,2,294836,294837,294839,1,3,0
84144,2,1,294838,294839,294840,1,2,0
84145,6,2,294844,294844,294846,0,2,4
84146,4,1,294848,294848,294849,0,1,2
84147,5,2,294853,294853,294855,0,2,4
84148,1,1,294854,294855,294856,1,2,0
84149,4,3,294858,294858,294861,0,3,2
84150,1,1,294859,294861,294862,2,3,0
84151,5,1,294864,294864,294865,0,1,2
84152,2,2,294866,294866,294868,0,2,1
84153,4,3,294870,294870,294873,0,3,2
84154,6,1,294876,294876,294877,0,1,3
84155,6,1,294882,294882,294883,0,1,5
84156,2,2,294884,294884,294886,0,2,1
84157,6,2,294890,294890,294892,0,2,4
84158,5,3,294895,294895,294898,0,3,3
84159,5,2,294900,294900,294902,0,2,2
84160,6,3,294906,294906,294909,0,3,4
84161,6,3,294912,294912,294915,0,3,3
84162,5,1,294917,294917,294918,0,1,2
84163,4,1,294921,294921,294922,0,1,3
84164,1,2,294922,294922,294924,0,2,0
84165,5,1,294927,294927,294928,0,1,3
84166,5,2,294932,294932,294934,0,2,4
84167,5,3,294937,294937,294940,0,3,3
84168,4,3,294941,294941,294944,0,3,1
84169,5,3,294946,294946,294949,0,3,2
84170,3,2,294949,294949,294951,0,2,0
84171,4,3,294953,294953,294956,0,3,2
84172,3,1,294956,294956,294957,0,1,0
84173,5,1,294961,294961,294962,0,1,4
84174,6,2,294967,294967,294969,0,2,5
84175,1,3,294968,294969,294972,1,4,0
84176,3,1,294971,294972,294973,1,2,0
84177,3,1,294974,294974,294975,0,1,1
84178,1,3,294975,294975,294978,0,3,0
84179,6,1,294981,294981,294982,0,1,3
84180,5,3,294986,294986,294989,0,3,4
84181,6,1,294992,294992,294993,0,1,3
84182,1,1,294993,294993,294994,0,1,0
84183,5,2,294998,294998,295000,0,2,4
84184,1,1,294999,295000,295001,1,2,0
84185,1,3,295000,295001,295004,1,4,0
84186,2,2,295002,295004,295006,2,4,0
84187,5,1,295007,295007,295008,0,1,1
84188,3,1,295010,295010,295011,0,1,2
84189,1,3,295011,295011,295014,0,3,0
84190,1,3,295012,295014,295017,2,5,0
84191,3,1,295015,295017,295018,2,3,0
84192,1,1,295016,295018,295019,2,3,0
84193,2,1,295018,295019,295020,1,2,0
84194,2,1,295020,295020,295021,0,1,0
84195,3,1,295023,295023,295024,0,1,2
84196,6,1,295029,295029,295030,0,1,5
84197,5,1,295034,295034,295035,0,1,4
84198,4,3,295038,295038,295041,0,3,3
84199,1,2,295039,295041,295043,2,4,0
84200,1,2,295040,295043,295045,3,5,0
84201,5,2,295045,295045,295047,0,2,0
84202,3,3,295048,295048,295051,0,3,1
84203,6,1,295054,295054,295055,0,1,3
84204,3,2,295057,295057,295059,0,2,2
84205,4,2,295061,295061,295063,0,2,2
84206,4,3,295065,295065,295068,0,3,2
84207,2,1,295067,295068,295069,1,2,0
84208,1,2,295068,295069,295071,1,3,0
84209,1,1,295069,295071,295072,2,3,0
84210,5,1,295074,295074,295075,0,1,2
84211,6,2,295080,295080,295082,0,2,5
84212,3,3,295083,295083,295086,0,3,1
84213,6,3,295089,295089,295092,0,3,3
84214,1,1,295090,295092,295093,2,3,0
84215,2,2,295092,295093,295095,1,3,0
84216,2,2,295094,295095,295097,1,3,0
84217,1,1,295095,295097,295098,2,3,0
84218,1,3,295096,295098,295101,2,5,0
84219,3,2,295099,295101,295103,2,4,0
84220,3,1,295102,295103,295104,1,2,0
84221,3,3,295105,295105,295108,0,3,1
84222,3,2,295108,295108,295110,0,2,0
84223,4,2,295112,295112,295114,0,2,2
84224,5,2,295117,295117,295119,0,2,3
84225,2,2,295119,295119,295121,0,2,0
84226,1,2,295120,295121,295123,1,3,0
84227,1,2,295121,295123,295125,2,4,0
84228,6,1,295127,295127,295128,0,1,2
84229,2,1,295129,295129,295130,0,1,1
84230,4,3,295133,295133,295136,0,3,3
84231,1,2,295134,295136,295138,2,4,0
84232,1,3,295135,295138,295141,3,6,0
84233,1,1,295136,295141,295142,5,6,0
84234,6,2,295142,295142,295144,0,2,0
84235,2,1,295144,295144,295145,0,1,0
84236,6,3,295150,295150,295153,0,3,5
84237,3,2,295153,295153,295155,0,2,0
84238,5,3,295158,295158,295161,0,3,3
84239,6,3,295164,295164,295167,0,3,3
84240,6,3,295170,295170,295173,0,3,3
84241,3,2,295173,295173,295175,0,2,0
84242,1,2,295174,295175,295177,1,3,0
84243,5,3,295179,295179,295182,0,3,2
84244,4,3,295183,295183,295186,0,3,1
84245,6,2,295189,295189,295191,0,2,3
84246,4,3,295193,295193,295196,0,3,2
84247,4,2,295197,295197,295199,0,2,1
84248,3,2,295200,295200,295202,0,2,1
84249,5,1,295205,295205,295206,0,1,3
84250,6,1,295211,295211,295212,0,1,5
84251,1,1,295212,295212,295213,0,1,0
84252,1,2,295213,295213,295215,0,2,0
84253,2,3,295215,295215,295218,0,3,0
84254,1,1,295216,295218,295219,2,3,0
84255,5,2,295221,295221,295223,0,2,2
84256,1,3,295222,295223,295226,1,4,0
84257,5,1,295227,295227,295228,0,1,1
84258,6,1,295233,295233,295234,0,1,5
84259,2,3,295235,295235,295238,0,3,1
84260,2,3,295237,295238,295241,1,4,0
84261,4,1,295241,295241,295242,0,1,0
84262,1,2,295242,295242,295244,0,2,0
84263,3,2,295245,295245,295247,0,2,1
84264,6,2,295251,295251,295253,0,2,4
84265,2,1,295253,295253,295254,0,1,0
84266,3,3,295256,295256,295259,0,3,2
84267,6,3,295262,295262,295265,0,3,3
84268,1,2,295263,295265,295267,2,4,0
84269,1,2,295264,295267,295269,3,5,0
84270,5,3,295269,295269,295272,0,3,0
84271,1,3,295270,295272,295275,2,5,0
84272,6,3,295276,295276,295279,0,3,1
84273,1,2,295277,295279,295281,2,4,0
84274,6,3,295283,295283,295286,0,3,2
84275,3,1,295286,295286,295287,0,1,0
84276,1,3,295287,295287,295290,0,3,0
84277,2,1,295289,295290,295291,1,2,0
84278,4,1,295293,295293,295294,0,1,2
84279,4,3,295297,295297,295300,0,3,3
84280,2,2,295299,295300,295302,1,3,0
84281,5,3,295304,295304,295307,0,3,2
84282,1,3,295305,295307,295310,2,5,0
84283,3,3,295308,295310,295313,2,5,0
84284,1,3,295309,295313,295316,4,7,0
84285,4,1,295313,295316,295317,3,4,0
84286,1,1,295314,295317,295318,3,4,0
84287,6,2,295320,295320,295322,0,2,2
84288,6,3,295326,295326,295329,0,3,4
84289,3,2,295329,295329,295331,0,2,0
84290,1,1,295330,295331,295332,1,2,0
84291,6,3,295336,295336,295339,0,3,4
84292,6,1,295342,295342,295343,0,1,3
84293,3,3,295345,295345,295348,0,3,2
84294,6,2,295351,295351,295353,0,2,3
84295,6,1,295357,295357,295358,0,1,4
84296,4,1,295361,295361,295362,0,1,3
84297,1,1,295362,295362,295363,0,1,0
84298,1,1,295363,295363,295364,0,1,0
84299,3,2,295366,295366,295368,0,2,2
84300,6,2,295372,295372,295374,0,2,4
84301,3,2,295375,295375,295377,0,2,1
84302,4,2,295379,295379,295381,0,2,2
84303,2,1,295381,295381,295382,0,1,0
84304,4,2,295385,295385,295387,0,2,3
84305,6,2,295391,295391,295393,0,2,4
84306,5,1,295396,295396,295397,0,1,3
84307,5,1,295401,295401,295402,0,1,4
84308,3,2,295404,295404,295406,0,2,2
84309,5,2,295409,295409,295411,0,2,3
84310,3,1,295412,295412,295413,0,1,1
84311,4,3,295416,295416,295419,0,3,3
84312,4,1,295420,295420,295421,0,1,1
84313,3,3,295423,295423,295426,0,3,2
84314,1,1,295424,295426,295427,2,3,0
84315,2,3,295426,295427,295430,1,4,0
84316,3,1,295429,295430,295431,1,2,0
84317,3,1,295432,295432,295433,0,1,1
84318,1,2,295433,295433,295435,0,2,0
84319,3,1,295436,295436,295437,0,1,1
84320,5,3,295441,295441,295444,0,3,4
84321,5,3,295446,295446,295449,0,3,2
84322,3,3,295449,295449,295452,0,3,0
84323,3,3,295452,295452,295455,0,3,0
84324,4,1,295456,295456,295457,0,1,1
84325,6,2,295462,295462,295464,0,2,5
84326,2,1,295464,295464,295465,0,1,0
84327,1,2,295465,295465,295467,0,2,0
84328,1,3,295466,295467,295470,1,4,0
84329,5,2,295471,295471,295473,0,2,1
84330,1,3,295472,295473,295476,1,4,0
84331,6,3,295478,295478,295481,0,3,2
84332,2,1,295480,295481,295482,1,2,0
84333,1,3,295481,295482,295485,1,4,0
84334,4,2,295485,295485,295487,0,2,0
84335,4,2,295489,295489,295491,0,2,2
84336,2,1,295491,295491,295492,0,1,0
84337,1,3,295492,295492,295495,0,3,0
84338,1,1,295493,295495,295496,2,3,0
84339,6,1,295499,295499,295500,0,1,3
84340,2,2,295501,295501,295503,0,2,1
84341,5,1,295506,295506,295507,0,1,3
84342,3,2,295509,295509,295511,0,2,2
84343,1,2,295510,295511,295513,1,3,0
84344,4,3,295514,295514,295517,0,3,1
84345,6,1,295520,295520,295521,0,1,3
84346,3,2,295523,295523,295525,0,2,2
84347,3,1,295526,295526,295527,0,1,1
84348,6,1,295532,295532,295533,0,1,5
84349,1,3,295533,295533,295536,0,3,0
84350,1,2,295534,295536,295538,2,4,0
84351,5,2,295539,295539,295541,0,2,1
84352,1,1,295540,295541,295542,1,2,0
84353,1,3,295541,295542,295545,1,4,0
84354,4,2,295545,295545,295547,0,2,0
84355,1,1,295546,295547,295548,1,2,0
84356,1,2,295547,295548,295550,1,3,0
84357,2,1,295549,295550,295551,1,2,0
84358,3,2,295552,295552,295554,0,2,1
84359,2,3,295554,295554,295557,0,3,0
84360,1,1,295555,295557,295558,2,3,0
84361,5,3,295560,295560,295563,0,3,2
84362,2,1,295562,295563,295564,1,2,0
84363,6,1,295568,295568,295569,0,1,4
84364,6,1,295574,295574,295575,0,1,5
84365,6,2,295580,295580,295582,0,2,5
84366,1,3,295581,295582,295585,1,4,0
84367,3,1,295584,295585,295586,1,2,0
84368,5,3,295589,295589,295592,0,3,3
84369,3,3,295592,295592,295595,0,3,0
84370,5,3,295597,295597,295600,0,3,2
84371,1,2,295598,295600,295602,2,4,0
84372,1,1,295599,295602,295603,3,4,0
84373,2,1,295601,295603,295604,2,3,0
84374,5,1,295606,295606,295607,0,1,2
84375,3,1,295609,295609,295610,0,1,2
84376,1,2,295610,295610,295612,0,2,0
84377,5,3,295615,295615,295618,0,3,3
84378,1,3,295616,295618,295621,2,5,0
84379,6,2,295622,295622,295624,0,2,1
84380,2,2,295624,295624,295626,0,2,0
84381,5,3,295629,295629,295632,0,3,3
84382,3,1,295632,295632,295633,0,1,0
84383,5,1,295637,295637,295638,0,1,4
84384,3,1,295640,295640,295641,0,1,2
84385,3,2,295643,295643,295645,0,2,2
84386,2,1,295645,295645,295646,0,1,0
84387,1,3,295646,295646,295649,0,3,0
84388,1,1,295647,295649,295650,2,3,0
84389,2,1,295649,295650,295651,1,2,0
84390,5,3,295654,295654,295657,0,3,3
84391,6,3,295660,295660,295663,0,3,3
84392,3,3,295663,295663,295666,0,3,0
84393,2,2,295665,295666,295668,1,3,0
84394,1,3,295666,295668,295671,2,5,0
84395,4,1,295670,295671,295672,1,2,0
84396,5,2,295675,295675,295677,0,2,3
84397,1,1,295676,295677,295678,1,2,0
84398,6,3,295682,295682,295685,0,3,4
84399,6,3,295688,295688,295691,0,3,3
84400,1,2,295689,295691,295693,2,4,0
84401,2,3,295691,295693,295696,2,5,0
84402,5,3,295696,295696,295699,0,3,0
84403,6,1,295702,295702,295703,0,1,3
84404,5,2,295707,295707,295709,0,2,4
84405,3,3,295710,295710,295713,0,3,1
84406,1,2,295711,295713,295715,2,4,0
84407,6,3,295717,295717,295720,0,3,2
84408,5,1,295722,295722,295723,0,1,2
84409,1,3,295723,295723,295726,0,3,0
84410,1,2,295724,295726,295728,2,4,0
84411,6,3,295730,295730,295733,0,3,2
84412,3,1,295733,295733,295734,0,1,0
84413,2,1,295735,295735,295736,0,1,1
84414,3,3,295738,295738,295741,0,3,2
84415,1,3,295739,295741,295744,2,5,0
84416,5,1,295744,295744,295745,0,1,0
84417,6,2,295750,295750,295752,0,2,5
84418,5,1,295755,295755,295756,0,1,3
84419,2,2,295757,295757,295759,0,2,1
84420,6,3,295763,295763,295766,0,3,4
84421,2,1,295765,295766,295767,1,2,0
84422,2,3,295767,295767,295770,0,3,0
84423,3,1,295770,295770,295771,0,1,0
84424,3,2,295773,295773,295775,0,2,2
84425,4,3,295777,295777,295780,0,3,2
84426,5,3,295782,295782,295785,0,3,2
84427,6,2,295788,295788,295790,0,2,3
84428,5,2,295793,295793,295795,0,2,3
84429,4,3,295797,295797,295800,0,3,2
84430,3,3,295800,295800,295803,0,3,0
84431,3,2,295803,295803,295805,0,2,0
84432,1,1,295804,295805,295806,1,2,0
84433,3,1,295807,295807,295808,0,1,1
84434,1,2,295808,295808,295810,0,2,0
84435,4,3,295812,295812,295815,0,3,2
84436,2,3,295814,295815,295818,1,4,0
84437,3,3,295817,295818,295821,1,4,0
84438,4,3,295821,295821,295824,0,3,0
84439,1,3,295822,295824,295827,2,5,0
84440,2,1,295824,295827,295828,3,4,0
84441,6,3,295830,295830,295833,0,3,2
84442,2,3,295832,295833,295836,1,4,0
84443,5,2,295837,295837,295839,0,2,1
84444,5,2,295842,295842,295844,0,2,3
84445,4,2,295846,295846,295848,0,2,2
84446,2,2,295848,295848,295850,0,2,0
84447,6,1,295854,295854,295855,0,1,4
84448,4,1,295858,295858,295859,0,1,3
84449,4,2,295862,295862,295864,0,2,3
84450,2,3,295864,295864,295867,0,3,0
84451,3,3,295867,295867,295870,0,3,0
84452,1,1,295868,295870,295871,2,3,0
84453,3,3,295871,295871,295874,0,3,0
84454,5,1,295876,295876,295877,0,1,2
84455,3,2,295879,295879,295881,0,2,2
84456,1,3,295880,295881,295884,1,4,0
84457,1,2,295881,295884,295886,3,5,0
84458,3,3,295884,295886,295889,2,5,0
84459,4,3,295888,295889,295892,1,4,0
84460,4,2,295892,295892,295894,0,2,0
84461,1,3,295893,295894,295897,1,4,0
84462,5,2,295898,295898,295900,0,2,1
84463,1,3,295899,295900,295903,1,4,0
84464,1,2,295900,295903,295905,3,5,0
84465,6,1,295906,295906,295907,0,1,1
84466,1,3,295907,295907,295910,0,3,0
84467,5,1,295912,295912,295913,0,1,2
84468,3,1,295915,295915,295916,0,1,2
84469,2,1,295917,295917,295918,0,1,1
84470,5,2,295922,295922,295924,0,2,4
84471,1,1,295923,295924,295925,1,2,0
84472,4,1,295927,295927,295928,0,1,2
84473,4,1,295931,295931,295932,0,1,3
84474,6,1,295937,295937,295938,0,1,5
84475,6,2,295943,295943,295945,0,2,5
84476,5,1,295948,295948,295949,0,1,3
84477,1,1,295949,295949,295950,0,1,0
84478,6,1,295955,295955,295956,0,1,5
84479,6,2,295961,295961,295963,0,2,5
84480,6,2,295967,295967,295969,0,2,4
84481,1,2,295968,295969,295971,1,3,0
84482,3,3,295971,295971,295974,0,3,0
84483,1,3,295972,295974,295977,2,5,0
84484,5,1,295977,295977,295978,0,1,0
84485,1,2,295978,295978,295980,0,2,0
84486,4,2,295982,295982,295984,0,2,2
84487,4,2,295986,295986,295988,0,2,2
84488,2,2,295988,295988,295990,0,2,0
84489,1,1,295989,295990,295991,1,2,0
84490,5,3,295994,295994,295997,0,3,3
84491,5,2,295999,295999,296001,0,2,2
84492,4,3,296003,296003,296006,0,3,2
84493,5,2,296008,296008,296010,0,2,2
84494,5,2,296013,296013,296015,0,2,3
84495,2,2,296015,296015,296017,0,2,0
84496,5,1,296020,296020,296021,0,1,3
84497,2,2,296022,296022,296024,0,2,1
84498,1,3,296023,296024,296027,1,4,0
84499,1,2,296024,296027,296029,3,5,0
84500,4,3,296028,296029,296032,1,4,0
84501,1,3,296029,296032,296035,3,6,0
84502,1,3,296030,296035,296038,5,8,0
84503,4,1,296034,296038,296039,4,5,0
84504,3,1,296037,296039,296040,2,3,0
84505,3,3,296040,296040,296043,0,3,0
84506,3,3,296043,296043,296046,0,3,0
84507,2,1,296045,296046,296047,1,2,0
84508,6,1,296051,296051,296052,0,1,4
84509,2,3,296053,296053,296056,0,3,1
84510,1,2,296054,296056,296058,2,4,0
84511,4,3,296058,296058,296061,0,3,0
84512,6,1,296064,296064,296065,0,1,3
84513,3,1,296067,296067,296068,0,1,2
84514,3,3,296070,296070,296073,0,3,2
84515,6,1,296076,296076,296077,0,1,3
84516,3,1,296079,296079,296080,0,1,2
84517,1,1,296080,296080,296081,0,1,0
84518,3,1,296083,296083,296084,0,1,2
84519,5,2,296088,296088,296090,0,2,4
84520,1,1,296089,296090,296091,1,2,0
84521,4,1,296093,296093,296094,0,1,2
84522,4,2,296097,296097,296099,0,2,3
84523,3,1,296100,296100,296101,0,1,1
84524,1,1,296101,296101,296102,0,1,0
84525,2,3,296103,296103,296106,0,3,1
84526,2,2,296105,296106,296108,1,3,0
84527,6,3,296111,296111,296114,0,3,3
84528,4,2,296115,296115,296117,0,2,1
84529,2,3,296117,296117,296120,0,3,0
84530,4,2,296121,296121,296123,0,2,1
84531,2,1,296123,296123,296124,0,1,0
84532,4,2,296127,296127,296129,0,2,3
84533,6,3,296133,296133,296136,0,3,4
84534,6,2,296139,296139,296141,0,2,3
84535,3,2,296142,296142,296144,0,2,1
84536,1,3,296143,296144,296147,1,4,0
84537,5,1,296148,296148,296149,0,1,1
84538,6,3,296154,296154,296157,0,3,5
84539,3,2,296157,296157,296159,0,2,0
84540,2,2,296159,296159,296161,0,2,0
84541,6,3,296165,296165,296168,0,3,4
84542,6,3,296171,296171,296174,0,3,3
84543,1,1,296172,296174,296175,2,3,0
84544,5,2,296177,296177,296179,0,2,2
84545,2,3,296179,296179,296182,0,3,0
84546,3,2,296182,296182,296184,0,2,0
84547,6,3,296188,296188,296191,0,3,4
84548,2,2,296190,296191,296193,1,3,0
84549,5,3,296195,296195,296198,0,3,2
84550,1,3,296196,296198,296201,2,5,0
84551,4,2,296200,296201,296203,1,3,0
84552,5,3,296205,296205,296208,0,3,2
84553,5,3,296210,296210,296213,0,3,2
84554,2,1,296212,296213,296214,1,2,0
84555,3,2,296215,296215,296217,0,2,1
84556,4,2,296219,296219,296221,0,2,2
84557,5,1,296224,296224,296225,0,1,3
84558,2,1,296226,296226,296227,0,1,1
84559,1,2,296227,296227,296229,0,2,0
84560,2,3,296229,296229,296232,0,3,0
84561,6,3,296235,296235,296238,0,3,3
84562,2,3,296237,296238,296241,1,4,0
84563,6,2,296243,296243,296245,0,2,2
84564,3,2,296246,296246,296248,0,2,1
84565,4,3,296250,296250,296253,0,3,2
84566,6,1,296256,296256,296257,0,1,3
84567,5,3,296261,296261,296264,0,3,4
84568,6,2,296267,296267,296269,0,2,3
84569,2,1,296269,296269,296270,0,1,0
84570,6,2,296275,296275,296277,0,2,5
84571,3,1,296278,296278,296279,0,1,1
84572,6,3,296284,296284,296287,0,3,5
84573,6,1,296290,296290,296291,0,1,3
84574,6,1,296296,296296,296297,0,1,5
84575,6,1,296302,296302,296303,0,1,5
84576,4,1,296306,296306,296307,0,1,3
84577,6,1,296312,296312,296313,0,1,5
84578,5,1,296317,296317,296318,0,1,4
84579,4,2,296321,296321,296323,0,2,3
84580,3,3,296324,296324,296327,0,3,1
84581,5,3,296329,296329,296332,0,3,2
84582,4,3,296333,296333,296336,0,3,1
84583,2,1,296335,296336,296337,1,2,0
84584,6,1,296341,296341,296342,0,1,4
84585,4,3,296345,296345,296348,0,3,3
84586,4,2,296349,296349,296351,0,2,1
84587,2,2,296351,296351,296353,0,2,0
84588,4,3,296355,296355,296358,0,3,2
84589,1,3,296356,296358,296361,2,5,0
84590,2,1,296358,296361,296362,3,4,0
84591,3,3,296361,296362,296365,1,4,0
84592,5,1,296366,296366,296367,0,1,1
84593,6,3,296372,296372,296375,0,3,5
84594,2,1,296374,296375,296376,1,2,0
84595,1,3,296375,296376,296379,1,4,0
84596,4,1,296379,296379,296380,0,1,0
84597,4,3,296383,296383,296386,0,3,3
84598,3,2,296386,296386,296388,0,2,0
84599,4,1,296390,296390,296391,0,1,2
84600,3,2,296393,296393,296395,0,2,2
84601,6,1,296399,296399,296400,0,1,4
84602,6,2,296405,296405,296407,0,2,5
84603,6,2,296411,296411,296413,0,2,4
84604,4,1,296415,296415,296416,0,1,2
84605,6,2,296421,296421,296423,0,2,5
84606,5,1,296426,296426,296427,0,1,3
84607,5,3,296431,296431,296434,0,3,4
84608,3,1,296434,296434,296435,0,1,0
84609,6,1,296440,296440,296441,0,1,5
84610,4,2,296444,296444,296446,0,2,3
84611,4,3,296448,296448,296451,0,3,2
84612,6,2,296454,296454,296456,0,2,3
84613,6,3,296460,296460,296463,0,3,4
84614,6,1,296466,296466,296467,0,1,3
84615,5,3,296471,296471,296474,0,3,4
84616,6,1,296477,296477,296478,0,1,3
84617,3,3,296480,296480,296483,0,3,2
84618,6,3,296486,296486,296489,0,3,3
84619,2,2,296488,296489,296491,1,3,0
84620,6,1,296494,296494,296495,0,1,3
84621,1,2,296495,296495,296497,0,2,0
84622,5,2,296500,296500,296502,0,2,3
84623,5,1,296505,296505,296506,0,1,3
84624,4,3,296509,296509,296512,0,3,3
84625,5,2,296514,296514,296516,0,2,2
84626,5,2,296519,296519,296521,0,2,3
84627,6,3,296525,296525,296528,0,3,4
84628,3,2,296528,296528,296530,0,2,0
84629,1,1,296529,296530,296531,1,2,0
84630,2,1,296531,296531,296532,0,1,0
84631,5,3,296536,296536,296539,0,3,4
84632,1,1,296537,296539,296540,2,3,0
84633,4,1,296541,296541,296542,0,1,1
84634,3,1,296544,296544,296545,0,1,2
84635,5,3,296549,296549,296552,0,3,4
84636,3,3,296552,296552,296555,0,3,0
84637,2,2,296554,296555,296557,1,3,0
84638,3,1,296557,296557,296558,0,1,0
84639,6,3,296563,296563,296566,0,3,5
84640,3,3,296566,296566,296569,0,3,0
84641,1,1,296567,296569,296570,2,3,0
84642,4,3,296571,296571,296574,0,3,1
84643,5,2,296576,296576,296578,0,2,2
84644,5,3,296581,296581,296584,0,3,3
84645,2,2,296583,296584,296586,1,3,0
84646,6,3,296589,296589,296592,0,3,3
84647,6,2,296595,296595,296597,0,2,3
84648,1,3,296596,296597,296600,1,4,0
84649,3,1,296599,296600,296601,1,2,0
84650,3,2,296602,296602,296604,0,2,1
84651,3,2,296605,296605,296607,0,2,1
84652,6,3,296611,296611,296614,0,3,4
84653,6,2,296617,296617,296619,0,2,3
84654,4,2,296621,296621,296623,0,2,2
84655,4,1,296625,296625,296626,0,1,2
84656,4,1,296629,296629,296630,0,1,3
84657,2,2,296631,296631,296633,0,2,1
84658,4,3,296635,296635,296638,0,3,2
84659,4,2,296639,296639,296641,0,2,1
84660,1,3,296640,296641,296644,1,4,0
84661,5,2,296645,296645,296647,0,2,1
84662,1,2,296646,296647,296649,1,3,0
84663,1,2,296647,296649,296651,2,4,0
84664,3,1,296650,296651,296652,1,2,0
84665,3,1,296653,296653,296654,0,1,1
84666,4,1,296657,296657,296658,0,1,3
84667,2,3,296659,296659,296662,0,3,1
84668,1,2,296660,296662,296664,2,4,0
84669,5,3,296665,296665,296668,0,3,1
84670,6,1,296671,296671,296672,0,1,3
84671,2,3,296673,296673,296676,0,3,1
84672,1,1,296674,296676,296677,2,3,0
84673,6,3,296680,296680,296683,0,3,3
84674,5,2,296685,296685,296687,0,2,2
84675,6,2,296691,296691,296693,0,2,4
84676,2,3,296693,296693,296696,0,3,0
84677,4,2,296697,296697,296699,0,2,1
84678,3,2,296700,296700,296702,0,2,1
84679,2,2,296702,296702,296704,0,2,0
84680,5,3,296707,296707,296710,0,3,3
84681,3,3,296710,296710,296713,0,3,0
84682,1,2,296711,296713,296715,2,4,0
84683,2,3,296713,296715,296718,2,5,0
84684,2,1,296715,296718,296719,3,4,0
84685,5,2,296720,296720,296722,0,2,1
84686,2,3,296722,296722,296725,0,3,0
84687,2,2,296724,296725,296727,1,3,0
84688,3,1,296727,296727,296728,0,1,0
84689,1,3,296728,296728,296731,0,3,0
84690,6,3,296734,296734,296737,0,3,3
84691,5,3,296739,296739,296742,0,3,2
84692,6,1,296745,296745,296746,0,1,3
84693,6,2,296751,296751,296753,0,2,5
84694,6,3,296757,296757,296760,0,3,4
84695,5,3,296762,296762,296765,0,3,2
84696,5,1,296767,296767,296768,0,1,2
84697,2,1,296769,296769,296770,0,1,1
84698,5,1,296774,296774,296775,0,1,4
84699,2,3,296776,296776,296779,0,3,1
84700,4,3,296780,296780,296783,0,3,1
84701,5,2,296785,296785,296787,0,2,2
84702,2,3,296787,296787,296790,0,3,0
84703,4,2,296791,296791,296793,0,2,1
84704,5,2,296796,296796,296798,0,2,3
84705,3,3,296799,296799,296802,0,3,1
84706,3,2,296802,296802,296804,0,2,0
84707,4,3,296806,296806,296809,0,3,2
84708,3,1,296809,296809,296810,0,1,0
84709,1,1,296810,296810,296811,0,1,0
84710,2,2,296812,296812,296814,0,2,1
84711,6,1,296818,296818,296819,0,1,4
84712,1,2,296819,296819,296821,0,2,0
84713,6,3,296825,296825,296828,0,3,4
84714,5,3,296830,296830,296833,0,3,2
84715,5,2,296835,296835,296837,0,2,2
84716,2,2,296837,296837,296839,0,2,0
84717,6,1,296843,296843,296844,0,1,4
84718,5,1,296848,296848,296849,0,1,4
84719,4,3,296852,296852,296855,0,3,3
84720,3,3,296855,296855,296858,0,3,0
84721,3,1,296858,296858,296859,0,1,0
84722,4,1,296862,296862,296863,0,1,3
84723,5,3,296867,296867,296870,0,3,4
84724,6,3,296873,296873,296876,0,3,3
84725,3,1,296876,296876,296877,0,1,0
84726,1,2,296877,296877,296879,0,2,0
84727,4,3,296881,296881,296884,0,3,2
84728,3,2,296884,296884,296886,0,2,0
84729,4,2,296888,296888,296890,0,2,2
84730,3,2,296891,296891,296893,0,2,1
84731,3,2,296894,296894,296896,0,2,1
84732,1,1,296895,296896,296897,1,2,0
84733,2,1,296897,296897,296898,0,1,0
84734,1,3,296898,296898,296901,0,3,0
84735,4,2,296902,296902,296904,0,2,1
84736,4,1,296906,296906,296907,0,1,2
84737,3,3,296909,296909,296912,0,3,2
84738,5,3,296914,296914,296917,0,3,2
84739,2,3,296916,296917,296920,1,4,0
84740,4,3,296920,296920,296923,0,3,0
84741,6,3,296926,296926,296929,0,3,3
84742,1,2,296927,296929,296931,2,4,0
84743,3,1,296930,296931,296932,1,2,0
84744,5,2,296935,296935,296937,0,2,3
84745,2,1,296937,296937,296938,0,1,0
84746,2,3,296939,296939,296942,0,3,1
84747,3,2,296942,296942,296944,0,2,0
84748,1,2,296943,296944,296946,1,3,0
84749,5,1,296948,296948,296949,0,1,2
84750,1,1,296949,296949,296950,0,1,0
84751,5,2,296954,296954,296956,0,2,4
84752,4,3,296958,296958,296961,0,3,2
84753,4,2,296962,296962,296964,0,2,1
84754,1,3,296963,296964,296967,1,4,0
84755,5,1,296968,296968,296969,0,1,1
84756,4,3,296972,296972,296975,0,3,3
84757,3,3,296975,296975,296978,0,3,0
84758,4,1,296979,296979,296980,0,1,1
84759,4,1,296983,296983,296984,0,1,3
84760,5,1,296988,296988,296989,0,1,4
84761,2,1,296990,296990,296991,0,1,1
84762,5,2,296995,296995,296997,0,2,4
84763,4,2,296999,296999,297001,0,2,2
84764,6,2,297005,297005,297007,0,2,4
84765,6,2,297011,297011,297013,0,2,4
84766,2,2,297013,297013,297015,0,2,0
84767,6,1,297019,297019,297020,0,1,4
84768,1,1,297020,297020,297021,0,1,0
84769,1,2,297021,297021,297023,0,2,0
84770,3,3,297024,297024,297027,0,3,1
84771,1,1,297025,297027,297028,2,3,0
84772,6,2,297031,297031,297033,0,2,3
84773,3,2,297034,297034,297036,0,2,1
84774,1,2,297035,297036,297038,1,3,0
84775,4,3,297039,297039,297042,0,3,1
84776,4,1,297043,297043,297044,0,1,1
84777,1,3,297044,297044,297047,0,3,0
84778,3,1,297047,297047,297048,0,1,0
84779,5,1,297052,297052,297053,0,1,4
84780,6,2,297058,297058,297060,0,2,5
84781,2,2,297060,297060,297062,0,2,0
84782,5,3,297065,297065,297068,0,3,3
84783,1,3,297066,297068,297071,2,5,0
84784,3,1,297069,297071,297072,2,3,0
84785,5,1,297074,297074,297075,0,1,2
84786,1,1,297075,297075,297076,0,1,0
84787,4,1,297079,297079,297080,0,1,3
84788,5,3,297084,297084,297087,0,3,4
84789,4,3,297088,297088,297091,0,3,1
84790,4,3,297092,297092,297095,0,3,1
84791,1,3,297093,297095,297098,2,5,0
84792,3,2,297096,297098,297100,2,4,0
84793,3,3,297099,297100,297103,1,4,0
84794,3,3,297102,297103,297106,1,4,0
84795,2,2,297104,297106,297108,2,4,0
84796,6,3,297110,297110,297113,0,3,2
84797,1,2,297111,297113,297115,2,4,0
84798,6,3,297117,297117,297120,0,3,2
84799,6,1,297123,297123,297124,0,1,3
84800,4,2,297127,297127,297129,0,2,3
84801,5,1,297132,297132,297133,0,1,3
84802,3,1,297135,297135,297136,0,1,2
84803,4,3,297139,297139,297142,0,3,3
84804,1,1,297140,297142,297143,2,3,0
84805,3,3,297143,297143,297146,0,3,0
84806,3,1,297146,297146,297147,0,1,0
84807,2,1,297148,297148,297149,0,1,1
84808,2,1,297150,297150,297151,0,1,1
84809,4,1,297154,297154,297155,0,1,3
84810,2,2,297156,297156,297158,0,2,1
84811,2,3,297158,297158,297161,0,3,0
84812,3,3,297161,297161,297164,0,3,0
84813,4,2,297165,297165,297167,0,2,1
84814,1,1,297166,297167,297168,1,2,0
84815,4,1,297170,297170,297171,0,1,2
84816,3,2,297173,297173,297175,0,2,2
84817,5,3,297178,297178,297181,0,3,3
84818,1,3,297179,297181,297184,2,5,0
84819,3,2,297182,297184,297186,2,4,0
84820,5,1,297187,297187,297188,0,1,1
84821,3,1,297190,297190,297191,0,1,2
84822,3,2,297193,297193,297195,0,2,2
84823,4,3,297197,297197,297200,0,3,2
84824,6,2,297203,297203,297205,0,2,3
84825,4,3,297207,297207,297210,0,3,2
84826,2,2,297209,297210,297212,1,3,0
84827,6,2,297215,297215,297217,0,2,3
84828,6,1,297221,297221,297222,0,1,4
84829,6,3,297227,297227,297230,0,3,5
84830,2,3,297229,297230,297233,1,4,0
84831,4,2,297233,297233,297235,0,2,0
84832,3,2,297236,297236,297238,0,2,1
84833,6,3,297242,297242,297245,0,3,4
84834,4,3,297246,297246,297249,0,3,1
84835,4,2,297250,297250,297252,0,2,1
84836,4,1,297254,297254,297255,0,1,2
84837,4,2,297258,297258,297260,0,2,3
84838,3,2,297261,297261,297263,0,2,1
84839,1,1,297262,297263,297264,1,2,0
84840,2,1,297264,297264,297265,0,1,0
84841,1,3,297265,297265,297268,0,3,0
84842,3,1,297268,297268,297269,0,1,0
84843,3,3,297271,297271,297274,0,3,2
84844,5,2,297276,297276,297278,0,2,2
84845,4,3,297280,297280,297283,0,3,2
84846,4,2,297284,297284,297286,0,2,1
84847,4,2,297288,297288,297290,0,2,2
84848,3,2,297291,297291,297293,0,2,1
84849,2,2,297293,297293,297295,0,2,0
84850,4,3,297297,297297,297300,0,3,2
84851,6,2,297303,297303,297305,0,2,3
84852,5,3,297308,297308,297311,0,3,3
84853,5,2,297313,297313,297315,0,2,2
84854,4,3,297317,297317,297320,0,3,2
84855,3,3,297320,297320,297323,0,3,0
84856,6,2,297326,297326,297328,0,2,3
84857,5,1,297331,297331,297332,0,1,3
84858,4,2,297335,297335,297337,0,2,3
84859,4,3,297339,297339,297342,0,3,2
84860,4,2,297343,297343,297345,0,2,1
84861,3,2,297346,297346,297348,0,2,1
84862,1,1,297347,297348,297349,1,2,0
84863,4,1,297351,297351,297352,0,1,2
84864,6,1,297357,297357,297358,0,1,5
84865,3,3,297360,297360,297363,0,3,2
84866,2,3,297362,297363,297366,1,4,0
84867,5,2,297367,297367,297369,0,2,1
84868,4,2,297371,297371,297373,0,2,2
84869,1,2,297372,297373,297375,1,3,0
84870,3,1,297375,297375,297376,0,1,0
84871,1,3,297376,297376,297379,0,3,0
84872,6,1,297382,297382,297383,0,1,3
84873,4,1,297386,297386,297387,0,1,3
84874,2,1,297388,297388,297389,0,1,1
84875,5,1,297393,297393,297394,0,1,4
84876,3,1,297396,297396,297397,0,1,2
84877,1,2,297397,297397,297399,0,2,0
84878,3,1,297400,297400,297401,0,1,1
84879,5,3,297405,297405,297408,0,3,4
84880,2,2,297407,297408,297410,1,3,0
84881,3,2,297410,297410,297412,0,2,0
84882,1,1,297411,297412,297413,1,2,0
84883,1,3,297412,297413,297416,1,4,0
84884,1,1,297413,297416,297417,3,4,0
84885,2,3,297415,297417,297420,2,5,0
84886,2,2,297417,297420,297422,3,5,0
84887,2,3,297419,297422,297425,3,6,0
84888,5,1,297424,297425,297426,1,2,0
84889,1,2,297425,297426,297428,1,3,0
84890,6,3,297431,297431,297434,0,3,3
84891,1,1,297432,297434,297435,2,3,0
84892,1,3,297433,297435,297438,2,5,0
84893,5,2,297438,297438,297440,0,2,0
84894,3,1,297441,297441,297442,0,1,1
84895,4,2,297445,297445,297447,0,2,3
84896,6,3,297451,297451,297454,0,3,4
84897,5,2,297456,297456,297458,0,2,2
84898,2,2,297458,297458,297460,0,2,0
84899,6,2,297464,297464,297466,0,2,4
84900,6,1,297470,297470,297471,0,1,4
84901,6,2,297476,297476,297478,0,2,5
84902,3,2,297479,297479,297481,0,2,1
84903,5,3,297484,297484,297487,0,3,3
84904,6,3,297490,297490,297493,0,3,3
84905,4,2,297494,297494,297496,0,2,1
84906,4,3,297498,297498,297501,0,3,2
84907,4,1,297502,297502,297503,0,1,1
84908,1,2,297503,297503,297505,0,2,0
84909,6,3,297509,297509,297512,0,3,4
84910,5,2,297514,297514,297516,0,2,2
84911,1,1,297515,297516,297517,1,2,0
84912,4,3,297519,297519,297522,0,3,2
84913,6,3,297525,297525,297528,0,3,3
84914,4,3,297529,297529,297532,0,3,1
84915,3,2,297532,297532,297534,0,2,0
84916,5,2,297537,297537,297539,0,2,3
84917,4,1,297541,297541,297542,0,1,2
84918,3,2,297544,297544,297546,0,2,2
84919,4,3,297548,297548,297551,0,3,2
84920,6,1,297554,297554,297555,0,1,3
84921,1,1,297555,297555,297556,0,1,0
84922,2,2,297557,297557,297559,0,2,1
84923,1,1,297558,297559,297560,1,2,0
84924,2,2,297560,297560,297562,0,2,0
84925,6,3,297566,297566,297569,0,3,4
84926,3,2,297569,297569,297571,0,2,0
84927,2,3,297571,297571,297574,0,3,0
84928,4,1,297575,297575,297576,0,1,1
84929,6,1,297581,297581,297582,0,1,5
84930,2,2,297583,297583,297585,0,2,1
84931,6,2,297589,297589,297591,0,2,4
84932,2,2,297591,297591,297593,0,2,0
84933,5,1,297596,297596,297597,0,1,3
84934,3,2,297599,297599,297601,0,2,2
84935,5,1,297604,297604,297605,0,1,3
84936,6,3,297610,297610,297613,0,3,5
84937,6,2,297616,297616,297618,0,2,3
84938,3,2,297619,297619,297621,0,2,1
84939,6,3,297625,297625,297628,0,3,4
84940,2,1,297627,297628,297629,1,2,0
84941,2,1,297629,297629,297630,0,1,0
84942,4,2,297633,297633,297635,0,2,3
84943,2,3,297635,297635,297638,0,3,0
84944,1,2,297636,297638,297640,2,4,0
84945,3,2,297639,297640,297642,1,3,0
84946,2,3,297641,297642,297645,1,4,0
84947,6,2,297647,297647,297649,0,2,2
84948,6,3,297653,297653,297656,0,3,4
84949,2,3,297655,297656,297659,1,4,0
84950,5,3,297660,297660,297663,0,3,1
84951,6,2,297666,297666,297668,0,2,3
84952,4,3,297670,297670,297673,0,3,2
84953,6,1,297676,297676,297677,0,1,3
84954,6,3,297682,297682,297685,0,3,5
84955,6,1,297688,297688,297689,0,1,3
84956,4,1,297692,297692,297693,0,1,3
84957,2,3,297694,297694,297697,0,3,1
84958,3,2,297697,297697,297699,0,2,0
84959,4,3,297701,297701,297704,0,3,2
84960,6,1,297707,297707,297708,0,1,3
84961,1,3,297708,297708,297711,0,3,0
84962,5,1,297713,297713,297714,0,1,2
84963,6,3,297719,297719,297722,0,3,5
84964,2,3,297721,297722,297725,1,4,0
84965,5,1,297726,297726,297727,0,1,1
84966,2,2,297728,297728,297730,0,2,1
84967,4,3,297732,297732,297735,0,3,2
84968,4,3,297736,297736,297739,0,3,1
84969,4,2,297740,297740,297742,0,2,1
84970,6,3,297746,297746,297749,0,3,4
84971,3,1,297749,297749,297750,0,1,0
84972,2,2,297751,297751,297753,0,2,1
84973,5,2,297756,297756,297758,0,2,3
84974,4,3,297760,297760,297763,0,3,2
84975,3,2,297763,297763,297765,0,2,0
84976,4,2,297767,297767,297769,0,2,2
84977,1,2,297768,297769,297771,1,3,0
84978,6,2,297774,297774,297776,0,2,3
84979,4,3,297778,297778,297781,0,3,2
84980,3,1,297781,297781,297782,0,1,0
84981,4,3,297785,297785,297788,0,3,3
84982,3,3,297788,297788,297791,0,3,0
84983,5,1,297793,297793,297794,0,1,2
84984,4,2,297797,297797,297799,0,2,3
84985,5,3,297802,297802,297805,0,3,3
84986,4,2,297806,297806,297808,0,2,1
84987,5,3,297811,297811,297814,0,3,3
84988,2,1,297813,297814,297815,1,2,0
84989,5,2,297818,297818,297820,0,2,3
84990,5,2,297823,297823,297825,0,2,3
84991,2,2,297825,297825,297827,0,2,0
84992,6,2,297831,297831,297833,0,2,4
84993,1,1,297832,297833,297834,1,2,0
84994,2,3,297834,297834,297837,0,3,0
84995,1,1,297835,297837,297838,2,3,0
84996,1,3,297836,297838,297841,2,5,0
84997,3,3,297839,297841,297844,2,5,0
84998,3,2,297842,297844,297846,2,4,0
84999,5,2,297847,297847,297849,0,2,1
85000,6,3,297853,297853,297856,0,3,4
85001,1,3,297854,297856,297859,2,5,0
85002,1,2,297855,297859,297861,4,6,0
85003,4,2,297859,297861,297863,2,4,0
85004,1,2,297860,297863,297865,3,5,0
85005,5,2,297865,297865,297867,0,2,0
85006,3,1,297868,297868,297869,0,1,1
85007,4,2,297872,297872,297874,0,2,3
85008,1,1,297873,297874,297875,1,2,0
85009,2,3,297875,297875,297878,0,3,0
85010,3,2,297878,297878,297880,0,2,0
85011,4,2,297882,297882,297884,0,2,2
85012,2,2,297884,297884,297886,0,2,0
85013,5,2,297889,297889,297891,0,2,3
85014,2,1,297891,297891,297892,0,1,0
85015,2,1,297893,297893,297894,0,1,1
85016,2,1,297895,297895,297896,0,1,1
85017,3,1,297898,297898,297899,0,1,2
85018,3,3,297901,297901,297904,0,3,2
85019,1,3,297902,297904,297907,2,5,0
85020,2,2,297904,297907,297909,3,5,0
85021,1,1,297905,297909,297910,4,5,0
85022,6,2,297911,297911,297913,0,2,1
85023,5,1,297916,297916,297917,0,1,3
85024,5,3,297921,297921,297924,0,3,4
85025,4,1,297925,297925,297926,0,1,1
85026,5,2,297930,297930,297932,0,2,4
85027,6,1,297936,297936,297937,0,1,4
85028,6,1,297942,297942,297943,0,1,5
85029,5,2,297947,297947,297949,0,2,4
85030,6,1,297953,297953,297954,0,1,4
85031,2,1,297955,297955,297956,0,1,1
85032,6,3,297961,297961,297964,0,3,5
85033,5,1,297966,297966,297967,0,1,2
85034,6,2,297972,297972,297974,0,2,5
85035,1,1,297973,297974,297975,1,2,0
85036,5,2,297978,297978,297980,0,2,3
85037,3,3,297981,297981,297984,0,3,1
85038,3,3,297984,297984,297987,0,3,0
85039,1,3,297985,297987,297990,2,5,0
85040,1,3,297986,297990,297993,4,7,0
85041,3,1,297989,297993,297994,4,5,0
85042,3,3,297992,297994,297997,2,5,0
85043,4,3,297996,297997,298000,1,4,0
85044,6,3,298002,298002,298005,0,3,2
85045,4,3,298006,298006,298009,0,3,1
85046,4,1,298010,298010,298011,0,1,1
85047,4,2,298014,298014,298016,0,2,3
85048,3,3,298017,298017,298020,0,3,1
85049,4,2,298021,298021,298023,0,2,1
85050,6,2,298027,298027,298029,0,2,4
85051,1,2,298028,298029,298031,1,3,0
85052,2,1,298030,298031,298032,1,2,0
85053,1,3,298031,298032,298035,1,4,0
85054,2,1,298033,298035,298036,2,3,0
85055,1,2,298034,298036,298038,2,4,0
85056,4,2,298038,298038,298040,0,2,0
85057,1,1,298039,298040,298041,1,2,0
85058,3,2,298042,298042,298044,0,2,1
85059,2,1,298044,298044,298045,0,1,0
85060,1,2,298045,298045,298047,0,2,0
85061,6,2,298051,298051,298053,0,2,4
85062,3,2,298054,298054,298056,0,2,1
85063,3,2,298057,298057,298059,0,2,1
85064,1,1,298058,298059,298060,1,2,0
85065,1,1,298059,298060,298061,1,2,0
85066,2,3,298061,298061,298064,0,3,0
85067,5,3,298066,298066,298069,0,3,2
85068,3,1,298069,298069,298070,0,1,0
85069,4,2,298073,298073,298075,0,2,3
85070,1,3,298074,298075,298078,1,4,0
85071,5,1,298079,298079,298080,0,1,1
85072,6,2,298085,298085,298087,0,2,5
85073,6,2,298091,298091,298093,0,2,4
85074,6,2,298097,298097,298099,0,2,4
85075,4,2,298101,298101,298103,0,2,2
85076,5,1,298106,298106,298107,0,1,3
85077,4,3,298110,298110,298113,0,3,3
85078,4,1,298114,298114,298115,0,1,1
85079,1,2,298115,298115,298117,0,2,0
85080,4,3,298119,298119,298122,0,3,2
85081,2,1,298121,298122,298123,1,2,0
85082,3,3,298124,298124,298127,0,3,1
85083,1,2,298125,298127,298129,2,4,0
85084,2,3,298127,298129,298132,2,5,0
85085,4,2,298131,298132,298134,1,3,0
85086,3,2,298134,298134,298136,0,2,0
85087,6,1,298140,298140,298141,0,1,4
85088,5,2,298145,298145,298147,0,2,4
85089,2,1,298147,298147,298148,0,1,0
85090,5,1,298152,298152,298153,0,1,4
85091,1,2,298153,298153,298155,0,2,0
85092,1,2,298154,298155,298157,1,3,0
85093,2,2,298156,298157,298159,1,3,0
85094,1,3,298157,298159,298162,2,5,0
85095,6,3,298163,298163,298166,0,3,1
85096,5,3,298168,298168,298171,0,3,2
85097,4,1,298172,298172,298173,0,1,1
85098,2,2,298174,298174,298176,0,2,1
85099,1,1,298175,298176,298177,1,2,0
85100,2,3,298177,298177,298180,0,3,0
85101,5,3,298182,298182,298185,0,3,2
85102,1,1,298183,298185,298186,2,3,0
85103,6,2,298189,298189,298191,0,2,3
85104,1,2,298190,298191,298193,1,3,0
85105,3,2,298193,298193,298195,0,2,0
85106,5,1,298198,298198,298199,0,1,3
85107,3,2,298201,298201,298203,0,2,2
85108,3,1,298204,298204,298205,0,1,1
85109,6,3,298210,298210,298213,0,3,5
85110,1,3,298211,298213,298216,2,5,0
85111,1,3,298212,298216,298219,4,7,0
85112,2,2,298214,298219,298221,5,7,0
85113,5,3,298219,298221,298224,2,5,0
85114,3,3,298222,298224,298227,2,5,0
85115,3,3,298225,298227,298230,2,5,0
85116,5,1,298230,298230,298231,0,1,0
85117,5,2,298235,298235,298237,0,2,4
85118,5,3,298240,298240,298243,0,3,3
85119,2,3,298242,298243,298246,1,4,0
85120,2,3,298244,298246,298249,2,5,0
85121,4,3,298248,298249,298252,1,4,0
85122,6,1,298254,298254,298255,0,1,2
85123,1,3,298255,298255,298258,0,3,0
85124,5,2,298260,298260,298262,0,2,2
85125,3,3,298263,298263,298266,0,3,1
85126,6,2,298269,298269,298271,0,2,3
85127,5,1,298274,298274,298275,0,1,3
85128,1,1,298275,298275,298276,0,1,0
85129,1,2,298276,298276,298278,0,2,0
85130,3,3,298279,298279,298282,0,3,1
85131,3,1,298282,298282,298283,0,1,0
85132,1,3,298283,298283,298286,0,3,0
85133,1,3,298284,298286,298289,2,5,0
85134,5,2,298289,298289,298291,0,2,0
85135,4,3,298293,298293,298296,0,3,2
85136,3,3,298296,298296,298299,0,3,0
85137,4,3,298300,298300,298303,0,3,1
85138,3,2,298303,298303,298305,0,2,0
85139,3,3,298306,298306,298309,0,3,1
85140,4,1,298310,298310,298311,0,1,1
85141,4,3,298314,298314,298317,0,3,3
85142,1,2,298315,298317,298319,2,4,0
85143,4,3,298319,298319,298322,0,3,0
85144,3,1,298322,298322,298323,0,1,0
85145,2,2,298324,298324,298326,0,2,1
85146,6,1,298330,298330,298331,0,1,4
85147,2,2,298332,298332,298334,0,2,1
85148,3,3,298335,298335,298338,0,3,1
85149,3,2,298338,298338,298340,0,2,0
85150,6,1,298344,298344,298345,0,1,4
85151,5,3,298349,298349,298352,0,3,4
85152,6,2,298355,298355,298357,0,2,3
85153,6,1,298361,298361,298362,0,1,4
85154,5,1,298366,298366,298367,0,1,4
85155,4,1,298370,298370,298371,0,1,3
85156,6,1,298376,298376,298377,0,1,5
85157,5,2,298381,298381,298383,0,2,4
85158,4,3,298385,298385,298388,0,3,2
85159,1,3,298386,298388,298391,2,5,0
85160,3,3,298389,298391,298394,2,5,0
85161,4,3,298393,298394,298397,1,4,0
85162,2,3,298395,298397,298400,2,5,0
85163,3,1,298398,298400,298401,2,3,0
85164,3,2,298401,298401,298403,0,2,0
85165,6,3,298407,298407,298410,0,3,4
85166,4,1,298411,298411,298412,0,1,1
85167,1,3,298412,298412,298415,0,3,0
85168,1,2,298413,298415,298417,2,4,0
85169,6,2,298419,298419,298421,0,2,2
85170,2,3,298421,298421,298424,0,3,0
85171,6,1,298427,298427,298428,0,1,3
85172,4,3,298431,298431,298434,0,3,3
85173,2,2,298433,298434,298436,1,3,0
85174,6,1,298439,298439,298440,0,1,3
85175,5,1,298444,298444,298445,0,1,4
85176,4,1,298448,298448,298449,0,1,3
85177,5,1,298453,298453,298454,0,1,4
85178,3,2,298456,298456,298458,0,2,2
85179,4,3,298460,298460,298463,0,3,2
85180,1,3,298461,298463,298466,2,5,0
85181,2,1,298463,298466,298467,3,4,0
85182,6,2,298469,298469,298471,0,2,2
85183,5,1,298474,298474,298475,0,1,3
85184,1,3,298475,298475,298478,0,3,0
85185,5,3,298480,298480,298483,0,3,2
85186,5,3,298485,298485,298488,0,3,2
85187,4,1,298489,298489,298490,0,1,1
85188,2,2,298491,298491,298493,0,2,1
85189,4,2,298495,298495,298497,0,2,2
85190,1,3,298496,298497,298500,1,4,0
85191,2,3,298498,298500,298503,2,5,0
85192,1,3,298499,298503,298506,4,7,0
85193,4,3,298503,298506,298509,3,6,0
85194,3,3,298506,298509,298512,3,6,0
85195,4,2,298510,298512,298514,2,4,0
85196,2,3,298512,298514,298517,2,5,0
85197,1,2,298513,298517,298519,4,6,0
85198,2,3,298515,298519,298522,4,7,0
85199,3,1,298518,298522,298523,4,5,0
85200,1,1,298519,298523,298524,4,5,0
85201,3,1,298522,298524,298525,2,3,0
85202,5,3,298527,298527,298530,0,3,2
85203,6,1,298533,298533,298534,0,1,3
85204,5,3,298538,298538,298541,0,3,4
85205,2,2,298540,298541,298543,1,3,0
85206,4,3,298544,298544,298547,0,3,1
85207,1,2,298545,298547,298549,2,4,0
85208,3,3,298548,298549,298552,1,4,0
85209,2,2,298550,298552,298554,2,4,0
85210,5,2,298555,298555,298557,0,2,1
85211,5,2,298560,298560,298562,0,2,3
85212,4,1,298564,298564,298565,0,1,2
85213,1,3,298565,298565,298568,0,3,0
85214,5,1,298570,298570,298571,0,1,2
85215,1,1,298571,298571,298572,0,1,0
85216,1,2,298572,298572,298574,0,2,0
85217,6,1,298578,298578,298579,0,1,4
85218,6,3,298584,298584,298587,0,3,5
85219,6,3,298590,298590,298593,0,3,3
85220,1,1,298591,298593,298594,2,3,0
85221,1,2,298592,298594,298596,2,4,0
85222,5,2,298597,298597,298599,0,2,1
85223,1,2,298598,298599,298601,1,3,0
85224,6,3,298604,298604,298607,0,3,3
85225,6,1,298610,298610,298611,0,1,3
85226,4,2,298614,298614,298616,0,2,3
85227,3,3,298617,298617,298620,0,3,1
85228,4,2,298621,298621,298623,0,2,1
85229,2,3,298623,298623,298626,0,3,0
85230,5,3,298628,298628,298631,0,3,2
85231,4,3,298632,298632,298635,0,3,1
85232,2,1,298634,298635,298636,1,2,0
85233,2,1,298636,298636,298637,0,1,0
85234,3,3,298639,298639,298642,0,3,2
85235,6,1,298645,298645,298646,0,1,3
85236,3,3,298648,298648,298651,0,3,2
85237,5,1,298653,298653,298654,0,1,2
85238,1,1,298654,298654,298655,0,1,0
85239,5,2,298659,298659,298661,0,2,4
85240,3,1,298662,298662,298663,0,1,1
85241,2,3,298664,298664,298667,0,3,1
85242,1,3,298665,298667,298670,2,5,0
85243,3,2,298668,298670,298672,2,4,0
85244,1,1,298669,298672,298673,3,4,0
85245,1,3,298670,298673,298676,3,6,0
85246,1,2,298671,298676,298678,5,7,0
85247,4,1,298675,298678,298679,3,4,0
85248,4,2,298679,298679,298681,0,2,0
85249,5,2,298684,298684,298686,0,2,3
85250,6,3,298690,298690,298693,0,3,4
85251,5,2,298695,298695,298697,0,2,2
85252,1,1,298696,298697,298698,1,2,0
85253,4,2,298700,298700,298702,0,2,2
85254,6,2,298706,298706,298708,0,2,4
85255,5,3,298711,298711,298714,0,3,3
85256,5,2,298716,298716,298718,0,2,2
85257,3,2,298719,298719,298721,0,2,1
85258,5,1,298724,298724,298725,0,1,3
85259,6,3,298730,298730,298733,0,3,5
85260,2,2,298732,298733,298735,1,3,0
85261,3,1,298735,298735,298736,0,1,0
85262,2,1,298737,298737,298738,0,1,1
85263,1,3,298738,298738,298741,0,3,0
85264,1,2,298739,298741,298743,2,4,0
85265,2,1,298741,298743,298744,2,3,0
85266,6,2,298747,298747,298749,0,2,3
85267,5,3,298752,298752,298755,0,3,3
85268,2,3,298754,298755,298758,1,4,0
85269,3,1,298757,298758,298759,1,2,0
85270,6,2,298763,298763,298765,0,2,4
85271,3,2,298766,298766,298768,0,2,1
85272,3,2,298769,298769,298771,0,2,1
85273,2,2,298771,298771,298773,0,2,0
85274,3,1,298774,298774,298775,0,1,1
85275,2,2,298776,298776,298778,0,2,1
85276,5,2,298781,298781,298783,0,2,3
85277,5,3,298786,298786,298789,0,3,3
85278,4,1,298790,298790,298791,0,1,1
85279,2,2,298792,298792,298794,0,2,1
85280,2,1,298794,298794,298795,0,1,0
85281,5,1,298799,298799,298800,0,1,4
85282,2,3,298801,298801,298804,0,3,1
85283,1,1,298802,298804,298805,2,3,0
85284,2,2,298804,298805,298807,1,3,0
85285,4,2,298808,298808,298810,0,2,1
85286,4,1,298812,298812,298813,0,1,2
85287,1,2,298813,298813,298815,0,2,0
85288,6,2,298819,298819,298821,0,2,4
85289,1,1,298820,298821,298822,1,2,0
85290,2,1,298822,298822,298823,0,1,0
85291,6,3,298828,298828,298831,0,3,5
85292,3,2,298831,298831,298833,0,2,0
85293,6,2,298837,298837,298839,0,2,4
85294,4,1,298841,298841,298842,0,1,2
85295,3,1,298844,298844,298845,0,1,2
85296,1,2,298845,298845,298847,0,2,0
85297,4,1,298849,298849,298850,0,1,2
85298,5,1,298854,298854,298855,0,1,4
85299,5,1,298859,298859,298860,0,1,4
85300,3,3,298862,298862,298865,0,3,2
85301,6,3,298868,298868,298871,0,3,3
85302,4,3,298872,298872,298875,0,3,1
85303,4,1,298876,298876,298877,0,1,1
85304,6,2,298882,298882,298884,0,2,5
85305,6,3,298888,298888,298891,0,3,4
85306,6,3,298894,298894,298897,0,3,3
85307,6,1,298900,298900,298901,0,1,3
85308,2,3,298902,298902,298905,0,3,1
85309,6,3,298908,298908,298911,0,3,3
85310,3,2,298911,298911,298913,0,2,0
85311,1,1,298912,298913,298914,1,2,0
85312,5,1,298917,298917,298918,0,1,3
85313,2,2,298919,298919,298921,0,2,1
85314,5,1,298924,298924,298925,0,1,3
85315,5,2,298929,298929,298931,0,2,4
85316,4,2,298933,298933,298935,0,2,2
85317,3,2,298936,298936,298938,0,2,1
85318,2,2,298938,298938,298940,0,2,0
85319,2,3,298940,298940,298943,0,3,0
85320,4,3,298944,298944,298947,0,3,1
85321,1,2,298945,298947,298949,2,4,0
85322,1,3,298946,298949,298952,3,6,0
85323,1,3,298947,298952,298955,5,8,0
85324,5,1,298952,298955,298956,3,4,0
85325,3,1,298955,298956,298957,1,2,0
85326,5,2,298960,298960,298962,0,2,3
85327,4,2,298964,298964,298966,0,2,2
85328,2,2,298966,298966,298968,0,2,0
85329,4,2,298970,298970,298972,0,2,2
85330,1,1,298971,298972,298973,1,2,0
85331,5,2,298976,298976,298978,0,2,3
85332,3,2,298979,298979,298981,0,2,1
85333,5,2,298984,298984,298986,0,2,3
85334,6,2,298990,298990,298992,0,2,4
85335,3,2,298993,298993,298995,0,2,1
85336,3,2,298996,298996,298998,0,2,1
85337,4,2,299000,299000,299002,0,2,2
85338,4,3,299004,299004,299007,0,3,2
85339,2,1,299006,299007,299008,1,2,0
85340,4,3,299010,299010,299013,0,3,2
85341,6,1,299016,299016,299017,0,1,3
85342,1,3,299017,299017,299020,0,3,0
85343,1,3,299018,299020,299023,2,5,0
85344,4,1,299022,299023,299024,1,2,0
85345,2,3,299024,299024,299027,0,3,0
85346,5,2,299029,299029,299031,0,2,2
85347,4,2,299033,299033,299035,0,2,2
85348,4,2,299037,299037,299039,0,2,2
85349,3,3,299040,299040,299043,0,3,1
85350,4,2,299044,299044,299046,0,2,1
85351,6,1,299050,299050,299051,0,1,4
85352,4,1,299054,299054,299055,0,1,3
85353,5,1,299059,299059,299060,0,1,4
85354,3,3,299062,299062,299065,0,3,2
85355,2,3,299064,299065,299068,1,4,0
85356,4,2,299068,299068,299070,0,2,0
85357,5,3,299073,299073,299076,0,3,3
85358,5,1,299078,299078,299079,0,1,2
85359,2,3,299080,299080,299083,0,3,1
85360,4,3,299084,299084,299087,0,3,1
85361,4,2,299088,299088,299090,0,2,1
85362,1,3,299089,299090,299093,1,4,0
85363,3,3,299092,299093,299096,1,4,0
85364,5,1,299097,299097,299098,0,1,1
85365,5,3,299102,299102,299105,0,3,4
85366,1,1,299103,299105,299106,2,3,0
85367,6,1,299109,299109,299110,0,1,3
85368,4,2,299113,299113,299115,0,2,3
85369,1,3,299114,299115,299118,1,4,0
85370,1,2,299115,299118,299120,3,5,0
85371,3,3,299118,299120,299123,2,5,0
85372,4,3,299122,299123,299126,1,4,0
85373,1,1,299123,299126,299127,3,4,0
85374,6,3,299129,299129,299132,0,3,2
85375,3,3,299132,299132,299135,0,3,0
85376,1,1,299133,299135,299136,2,3,0
85377,1,3,299134,299136,299139,2,5,0
85378,5,3,299139,299139,299142,0,3,0
85379,2,3,299141,299142,299145,1,4,0
85380,2,3,299143,299145,299148,2,5,0
85381,2,2,299145,299148,299150,3,5,0
85382,4,1,299149,299150,299151,1,2,0
85383,2,1,299151,299151,299152,0,1,0
85384,2,1,299153,299153,299154,0,1,1
85385,6,2,299159,299159,299161,0,2,5
85386,6,2,299165,299165,299167,0,2,4
85387,1,3,299166,299167,299170,1,4,0
85388,4,3,299170,299170,299173,0,3,0
85389,5,1,299175,299175,299176,0,1,2
85390,2,3,299177,299177,299180,0,3,1
85391,6,2,299183,299183,299185,0,2,3
85392,5,3,299188,299188,299191,0,3,3
85393,2,2,299190,299191,299193,1,3,0
85394,5,1,299195,299195,299196,0,1,2
85395,3,1,299198,299198,299199,0,1,2
85396,5,3,299203,299203,299206,0,3,4
85397,4,1,299207,299207,299208,0,1,1
85398,3,3,299210,299210,299213,0,3,2
85399,5,1,299215,299215,299216,0,1,2
85400,6,3,299221,299221,299224,0,3,5
85401,1,2,299222,299224,299226,2,4,0
85402,4,1,299226,299226,299227,0,1,0
85403,2,3,299228,299228,299231,0,3,1
85404,2,3,299230,299231,299234,1,4,0
85405,3,1,299233,299234,299235,1,2,0
85406,3,1,299236,299236,299237,0,1,1
85407,4,2,299240,299240,299242,0,2,3
85408,3,1,299243,299243,299244,0,1,1
85409,3,2,299246,299246,299248,0,2,2
85410,6,3,299252,299252,299255,0,3,4
85411,5,2,299257,299257,299259,0,2,2
85412,2,2,299259,299259,299261,0,2,0
85413,4,1,299263,299263,299264,0,1,2
85414,4,3,299267,299267,299270,0,3,3
85415,6,1,299273,299273,299274,0,1,3
85416,2,3,299275,299275,299278,0,3,1
85417,4,3,299279,299279,299282,0,3,1
85418,1,2,299280,299282,299284,2,4,0
85419,1,1,299281,299284,299285,3,4,0
85420,4,3,299285,299285,299288,0,3,0
85421,2,2,299287,299288,299290,1,3,0
85422,5,2,299292,299292,299294,0,2,2
85423,3,2,299295,299295,299297,0,2,1
85424,3,1,299298,299298,299299,0,1,1
85425,1,2,299299,299299,299301,0,2,0
85426,4,3,299303,299303,299306,0,3,2
85427,4,1,299307,299307,299308,0,1,1
85428,1,2,299308,299308,299310,0,2,0
85429,4,1,299312,299312,299313,0,1,2
85430,4,2,299316,299316,299318,0,2,3
85431,3,2,299319,299319,299321,0,2,1
85432,4,1,299323,299323,299324,0,1,2
85433,3,2,299326,299326,299328,0,2,2
85434,4,1,299330,299330,299331,0,1,2
85435,3,3,299333,299333,299336,0,3,2
85436,2,2,299335,299336,299338,1,3,0
85437,4,1,299339,299339,299340,0,1,1
85438,6,2,299345,299345,299347,0,2,5
85439,6,1,299351,299351,299352,0,1,4
85440,5,2,299356,299356,299358,0,2,4
85441,1,3,299357,299358,299361,1,4,0
85442,5,3,299362,299362,299365,0,3,1
85443,6,2,299368,299368,299370,0,2,3
85444,4,3,299372,299372,299375,0,3,2
85445,2,3,299374,299375,299378,1,4,0
85446,5,1,299379,299379,299380,0,1,1
85447,2,3,299381,299381,299384,0,3,1
85448,3,2,299384,299384,299386,0,2,0
85449,4,1,299388,299388,299389,0,1,2
85450,2,2,299390,299390,299392,0,2,1
85451,5,2,299395,299395,299397,0,2,3
85452,6,2,299401,299401,299403,0,2,4
85453,1,3,299402,299403,299406,1,4,0
85454,6,2,299408,299408,299410,0,2,2
85455,1,3,299409,299410,299413,1,4,0
85456,2,3,299411,299413,299416,2,5,0
85457,6,2,299417,299417,299419,0,2,1
85458,5,1,299422,299422,299423,0,1,3
85459,2,1,299424,299424,299425,0,1,1
85460,6,3,299430,299430,299433,0,3,5
85461,2,3,299432,299433,299436,1,4,0
85462,2,2,299434,299436,299438,2,4,0
85463,5,2,299439,299439,299441,0,2,1
85464,3,2,299442,299442,299444,0,2,1
85465,1,3,299443,299444,299447,1,4,0
85466,1,2,299444,299447,299449,3,5,0
85467,3,1,299447,299449,299450,2,3,0
85468,1,2,299448,299450,299452,2,4,0
85469,6,3,299454,299454,299457,0,3,2
85470,6,2,299460,299460,299462,0,2,3
85471,2,1,299462,299462,299463,0,1,0
85472,1,3,299463,299463,299466,0,3,0
85473,4,3,299467,299467,299470,0,3,1
85474,5,1,299472,299472,299473,0,1,2
85475,5,3,299477,299477,299480,0,3,4
85476,3,1,299480,299480,299481,0,1,0
85477,6,3,299486,299486,299489,0,3,5
85478,1,3,299487,299489,299492,2,5,0
85479,1,1,299488,299492,299493,4,5,0
85480,2,3,299490,299493,299496,3,6,0
85481,5,3,299495,299496,299499,1,4,0
85482,3,2,299498,299499,299501,1,3,0
85483,2,3,299500,299501,299504,1,4,0
85484,3,1,299503,299504,299505,1,2,0
85485,6,2,299509,299509,299511,0,2,4
85486,2,1,299511,299511,299512,0,1,0
85487,3,1,299514,299514,299515,0,1,2
85488,2,1,299516,299516,299517,0,1,1
85489,2,2,299518,299518,299520,0,2,1
85490,2,1,299520,299520,299521,0,1,0
85491,4,2,299524,299524,299526,0,2,3
85492,5,2,299529,299529,299531,0,2,3
85493,2,1,299531,299531,299532,0,1,0
85494,1,3,299532,299532,299535,0,3,0
85495,5,3,299537,299537,299540,0,3,2
85496,2,3,299539,299540,299543,1,4,0
85497,4,2,299543,299543,299545,0,2,0
85498,3,1,299546,299546,299547,0,1,1
85499,1,3,299547,299547,299550,0,3,0
85500,5,2,299552,299552,299554,0,2,2
85501,1,1,299553,299554,299555,1,2,0
85502,1,3,299554,299555,299558,1,4,0
85503,2,3,299556,299558,299561,2,5,0
85504,1,1,299557,299561,299562,4,5,0
85505,5,3,299562,299562,299565,0,3,0
85506,3,2,299565,299565,299567,0,2,0
85507,2,3,299567,299567,299570,0,3,0
85508,6,2,299573,299573,299575,0,2,3
85509,5,1,299578,299578,299579,0,1,3
85510,5,2,299583,299583,299585,0,2,4
85511,5,3,299588,299588,299591,0,3,3
85512,2,1,299590,299591,299592,1,2,0
85513,5,2,299595,299595,299597,0,2,3
85514,4,3,299599,299599,299602,0,3,2
85515,5,3,299604,299604,299607,0,3,2
85516,1,1,299605,299607,299608,2,3,0
85517,2,1,299607,299608,299609,1,2,0
85518,1,2,299608,299609,299611,1,3,0
85519,4,3,299612,299612,299615,0,3,1
85520,3,2,299615,299615,299617,0,2,0
85521,3,2,299618,299618,299620,0,2,1
85522,5,2,299623,299623,299625,0,2,3
85523,4,1,299627,299627,299628,0,1,2
85524,5,2,299632,299632,299634,0,2,4
85525,6,2,299638,299638,299640,0,2,4
85526,5,1,299643,299643,299644,0,1,3
85527,1,2,299644,299644,299646,0,2,0
85528,1,3,299645,299646,299649,1,4,0
85529,2,2,299647,299649,299651,2,4,0
85530,4,1,299651,299651,299652,0,1,0
85531,4,3,299655,299655,299658,0,3,3
85532,1,3,299656,299658,299661,2,5,0
85533,2,3,299658,299661,299664,3,6,0
85534,4,2,299662,299664,299666,2,4,0
85535,4,1,299666,299666,299667,0,1,0
85536,5,2,299671,299671,299673,0,2,4
85537,4,2,299675,299675,299677,0,2,2
85538,2,1,299677,299677,299678,0,1,0
85539,5,2,299682,299682,299684,0,2,4
85540,2,2,299684,299684,299686,0,2,0
85541,1,2,299685,299686,299688,1,3,0
85542,6,2,299691,299691,299693,0,2,3
85543,3,1,299694,299694,299695,0,1,1
85544,6,3,299700,299700,299703,0,3,5
85545,6,1,299706,299706,299707,0,1,3
85546,2,1,299708,299708,299709,0,1,1
85547,2,2,299710,299710,299712,0,2,1
85548,3,3,299713,299713,299716,0,3,1
85549,5,1,299718,299718,299719,0,1,2
85550,6,2,299724,299724,299726,0,2,5
85551,6,1,299730,299730,299731,0,1,4
85552,6,1,299736,299736,299737,0,1,5
85553,4,2,299740,299740,299742,0,2,3
85554,6,3,299746,299746,299749,0,3,4
85555,6,3,299752,299752,299755,0,3,3
85556,3,1,299755,299755,299756,0,1,0
85557,6,1,299761,299761,299762,0,1,5
85558,6,2,299767,299767,299769,0,2,5
85559,6,1,299773,299773,299774,0,1,4
85560,4,1,299777,299777,299778,0,1,3
85561,1,2,299778,299778,299780,0,2,0
85562,5,2,299783,299783,299785,0,2,3
85563,1,3,299784,299785,299788,1,4,0
85564,2,2,299786,299788,299790,2,4,0
85565,6,2,299792,299792,299794,0,2,2
85566,1,1,299793,299794,299795,1,2,0
85567,3,1,299796,299796,299797,0,1,1
85568,4,2,299800,299800,299802,0,2,3
85569,4,1,299804,299804,299805,0,1,2
85570,4,2,299808,299808,299810,0,2,3
85571,1,2,299809,299810,299812,1,3,0
85572,5,3,299814,299814,299817,0,3,2
85573,6,2,299820,299820,299822,0,2,3
85574,3,2,299823,299823,299825,0,2,1
85575,4,3,299827,299827,299830,0,3,2
85576,5,2,299832,299832,299834,0,2,2
85577,2,2,299834,299834,299836,0,2,0
85578,1,1,299835,299836,299837,1,2,0
85579,3,1,299838,299838,299839,0,1,1
85580,2,1,299840,299840,299841,0,1,1
85581,1,1,299841,299841,299842,0,1,0
85582,4,3,299845,299845,299848,0,3,3
85583,1,1,299846,299848,299849,2,3,0
85584,6,3,299852,299852,299855,0,3,3
85585,1,1,299853,299855,299856,2,3,0
85586,2,3,299855,299856,299859,1,4,0
85587,4,2,299859,299859,299861,0,2,0
85588,6,1,299865,299865,299866,0,1,4
85589,4,1,299869,299869,299870,0,1,3
85590,6,2,299875,299875,299877,0,2,5
85591,3,3,299878,299878,299881,0,3,1
85592,6,3,299884,299884,299887,0,3,3
85593,5,3,299889,299889,299892,0,3,2
85594,5,2,299894,299894,299896,0,2,2
85595,6,2,299900,299900,299902,0,2,4
85596,4,1,299904,299904,299905,0,1,2
85597,3,2,299907,299907,299909,0,2,2
85598,4,2,299911,299911,299913,0,2,2
85599,1,1,299912,299913,299914,1,2,0
85600,1,2,299913,299914,299916,1,3,0
85601,5,2,299918,299918,299920,0,2,2
85602,1,2,299919,299920,299922,1,3,0
85603,4,3,299923,299923,299926,0,3,1
85604,1,3,299924,299926,299929,2,5,0
85605,1,1,299925,299929,299930,4,5,0
85606,4,2,299929,299930,299932,1,3,0
85607,5,1,299934,299934,299935,0,1,2
85608,1,1,299935,299935,299936,0,1,0
85609,5,2,299940,299940,299942,0,2,4
85610,6,3,299946,299946,299949,0,3,4
85611,4,2,299950,299950,299952,0,2,1
85612,4,2,299954,299954,299956,0,2,2
85613,5,3,299959,299959,299962,0,3,3
85614,6,3,299965,299965,299968,0,3,3
85615,3,3,299968,299968,299971,0,3,0
85616,6,2,299974,299974,299976,0,2,3
85617,4,3,299978,299978,299981,0,3,2
85618,3,2,299981,299981,299983,0,2,0
85619,1,2,299982,299983,299985,1,3,0
85620,2,1,299984,299985,299986,1,2,0
85621,1,2,299985,299986,299988,1,3,0
85622,3,2,299988,299988,299990,0,2,0
85623,5,1,299993,299993,299994,0,1,3
85624,3,1,299996,299996,299997,0,1,2
85625,5,2,300001,300001,300003,0,2,4
85626,4,1,300005,300005,300006,0,1,2
85627,4,2,300009,300009,300011,0,2,3
85628,5,1,300014,300014,300015,0,1,3
85629,5,1,300019,300019,300020,0,1,4
85630,5,1,300024,300024,300025,0,1,4
85631,2,2,300026,300026,300028,0,2,1
85632,2,2,300028,300028,300030,0,2,0
85633,2,1,300030,300030,300031,0,1,0
85634,2,3,300032,300032,300035,0,3,1
85635,1,3,300033,300035,300038,2,5,0
85636,6,2,300039,300039,300041,0,2,1
85637,2,3,300041,300041,300044,0,3,0
85638,4,1,300045,300045,300046,0,1,1
85639,1,3,300046,300046,300049,0,3,0
85640,3,3,300049,300049,300052,0,3,0
85641,3,2,300052,300052,300054,0,2,0
85642,2,3,300054,300054,300057,0,3,0
85643,1,3,300055,300057,300060,2,5,0
85644,2,1,300057,300060,300061,3,4,0
85645,5,3,300062,300062,300065,0,3,1
85646,3,2,300065,300065,300067,0,2,0
85647,4,1,300069,300069,300070,0,1,2
85648,3,3,300072,300072,300075,0,3,2
85649,1,3,300073,300075,300078,2,5,0
85650,4,1,300077,300078,300079,1,2,0
85651,6,3,300083,300083,300086,0,3,4
85652,2,3,300085,300086,300089,1,4,0
85653,2,2,300087,300089,300091,2,4,0
85654,5,3,300092,300092,300095,0,3,1
85655,2,2,300094,300095,300097,1,3,0
85656,5,3,300099,300099,300102,0,3,2
85657,2,2,300101,300102,300104,1,3,0
85658,4,3,300105,300105,300108,0,3,1
85659,1,1,300106,300108,300109,2,3,0
85660,4,1,300110,300110,300111,0,1,1
85661,1,2,300111,300111,300113,0,2,0
85662,4,2,300115,300115,300117,0,2,2
85663,2,3,300117,300117,300120,0,3,0
85664,4,3,300121,300121,300124,0,3,1
85665,3,1,300124,300124,300125,0,1,0
85666,4,3,300128,300128,300131,0,3,3
85667,3,2,300131,300131,300133,0,2,0
85668,5,3,300136,300136,300139,0,3,3
85669,3,3,300139,300139,300142,0,3,0
85670,3,1,300142,300142,300143,0,1,0
85671,5,1,300147,300147,300148,0,1,4
85672,6,1,300153,300153,300154,0,1,5
85673,1,1,300154,300154,300155,0,1,0
85674,5,3,300159,300159,300162,0,3,4
85675,5,1,300164,300164,300165,0,1,2
85676,1,1,300165,300165,300166,0,1,0
85677,1,3,300166,300166,300169,0,3,0
85678,2,1,300168,300169,300170,1,2,0
85679,3,2,300171,300171,300173,0,2,1
85680,5,1,300176,300176,300177,0,1,3
85681,2,1,300178,300178,300179,0,1,1
85682,3,3,300181,300181,300184,0,3,2
85683,1,1,300182,300184,300185,2,3,0
85684,1,2,300183,300185,300187,2,4,0
85685,4,1,300187,300187,300188,0,1,0
85686,4,2,300191,300191,300193,0,2,3
85687,1,2,300192,300193,300195,1,3,0
85688,2,2,300194,300195,300197,1,3,0
85689,6,3,300200,300200,300203,0,3,3
85690,3,3,300203,300203,300206,0,3,0
85691,2,2,300205,300206,300208,1,3,0
85692,3,3,300208,300208,300211,0,3,0
85693,2,3,300210,300211,300214,1,4,0
85694,2,1,300212,300214,300215,2,3,0
85695,5,3,300217,300217,300220,0,3,2
85696,6,1,300223,300223,300224,0,1,3
85697,4,3,300227,300227,300230,0,3,3
85698,6,2,300233,300233,300235,0,2,3
85699,4,1,300237,300237,300238,0,1,2
85700,2,3,300239,300239,300242,0,3,1
85701,6,3,300245,300245,300248,0,3,3
85702,4,1,300249,300249,300250,0,1,1
85703,1,2,300250,300250,300252,0,2,0
85704,2,2,300252,300252,300254,0,2,0
85705,2,3,300254,300254,300257,0,3,0
85706,6,2,300260,300260,300262,0,2,3
85707,5,3,300265,300265,300268,0,3,3
85708,2,2,300267,300268,300270,1,3,0
85709,3,2,300270,300270,300272,0,2,0
85710,3,1,300273,300273,300274,0,1,1
85711,4,2,300277,300277,300279,0,2,3
85712,3,1,300280,300280,300281,0,1,1
85713,1,1,300281,300281,300282,0,1,0
85714,4,1,300285,300285,300286,0,1,3
85715,4,3,300289,300289,300292,0,3,3
85716,2,3,300291,300292,300295,1,4,0
85717,4,2,300295,300295,300297,0,2,0
85718,4,3,300299,300299,300302,0,3,2
85719,6,1,300305,300305,300306,0,1,3
85720,4,2,300309,300309,300311,0,2,3
85721,5,3,300314,300314,300317,0,3,3
85722,2,3,300316,300317,300320,1,4,0
85723,3,1,300319,300320,300321,1,2,0
85724,6,2,300325,300325,300327,0,2,4
85725,2,1,300327,300327,300328,0,1,0
85726,6,2,300333,300333,300335,0,2,5
85727,6,1,300339,300339,300340,0,1,4
85728,1,2,300340,300340,300342,0,2,0
85729,4,3,300344,300344,300347,0,3,2
85730,4,2,300348,300348,300350,0,2,1
85731,5,3,300353,300353,300356,0,3,3
85732,1,3,300354,300356,300359,2,5,0
85733,3,2,300357,300359,300361,2,4,0
85734,6,3,300363,300363,300366,0,3,2
85735,6,3,300369,300369,300372,0,3,3
85736,3,2,300372,300372,300374,0,2,0
85737,5,2,300377,300377,300379,0,2,3
85738,5,2,300382,300382,300384,0,2,3
85739,4,2,300386,300386,300388,0,2,2
85740,5,3,300391,300391,300394,0,3,3
85741,2,1,300393,300394,300395,1,2,0
85742,6,1,300399,300399,300400,0,1,4
85743,6,2,300405,300405,300407,0,2,5
85744,5,1,300410,300410,300411,0,1,3
85745,6,2,300416,300416,300418,0,2,5
85746,4,1,300420,300420,300421,0,1,2
85747,4,3,300424,300424,300427,0,3,3
85748,5,2,300429,300429,300431,0,2,2
85749,5,2,300434,300434,300436,0,2,3
85750,2,3,300436,300436,300439,0,3,0
85751,2,2,300438,300439,300441,1,3,0
85752,2,3,300440,300441,300444,1,4,0
85753,3,2,300443,300444,300446,1,3,0
85754,2,3,300445,300446,300449,1,4,0
85755,2,1,300447,300449,300450,2,3,0
85756,5,3,300452,300452,300455,0,3,2
85757,5,2,300457,300457,300459,0,2,2
85758,2,3,300459,300459,300462,0,3,0
85759,5,2,300464,300464,300466,0,2,2
85760,1,3,300465,300466,300469,1,4,0
85761,3,2,300468,300469,300471,1,3,0
85762,1,1,300469,300471,300472,2,3,0
85763,1,1,300470,300472,300473,2,3,0
85764,3,3,300473,300473,300476,0,3,0
85765,2,2,300475,300476,300478,1,3,0
85766,6,1,300481,300481,300482,0,1,3
85767,6,3,300487,300487,300490,0,3,5
85768,1,3,300488,300490,300493,2,5,0
85769,2,3,300490,300493,300496,3,6,0
85770,3,3,300493,300496,300499,3,6,0
85771,4,3,300497,300499,300502,2,5,0
85772,1,3,300498,300502,300505,4,7,0
85773,1,3,300499,300505,300508,6,9,0
85774,6,3,300505,300508,300511,3,6,0
85775,3,1,300508,300511,300512,3,4,0
85776,6,3,300514,300514,300517,0,3,2
85777,4,1,300518,300518,300519,0,1,1
85778,1,1,300519,300519,300520,0,1,0
85779,4,1,300523,300523,300524,0,1,3
85780,6,1,300529,300529,300530,0,1,5
85781,3,3,300532,300532,300535,0,3,2
85782,6,3,300538,300538,300541,0,3,3
85783,3,2,300541,300541,300543,0,2,0
85784,5,2,300546,300546,300548,0,2,3
85785,4,3,300550,300550,300553,0,3,2
85786,5,1,300555,300555,300556,0,1,2
85787,3,3,300558,300558,300561,0,3,2
85788,4,3,300562,300562,300565,0,3,1
85789,5,3,300567,300567,300570,0,3,2
85790,4,3,300571,300571,300574,0,3,1
85791,3,3,300574,300574,300577,0,3,0
85792,6,1,300580,300580,300581,0,1,3
85793,2,1,300582,300582,300583,0,1,1
85794,5,3,300587,300587,300590,0,3,4
85795,2,2,300589,300590,300592,1,3,0
85796,3,2,300592,300592,300594,0,2,0
85797,1,1,300593,300594,300595,1,2,0
85798,3,1,300596,300596,300597,0,1,1
85799,2,3,300598,300598,300601,0,3,1
85800,4,3,300602,300602,300605,0,3,1
85801,1,3,300603,300605,300608,2,5,0
85802,4,1,300607,300608,300609,1,2,0
85803,1,1,300608,300609,300610,1,2,0
85804,1,2,300609,300610,300612,1,3,0
85805,5,3,300614,300614,300617,0,3,2
85806,3,3,300617,300617,300620,0,3,0
85807,5,1,300622,300622,300623,0,1,2
85808,4,1,300626,300626,300627,0,1,3
85809,4,1,300630,300630,300631,0,1,3
85810,4,2,300634,300634,300636,0,2,3
85811,6,1,300640,300640,300641,0,1,4
85812,2,1,300642,300642,300643,0,1,1
85813,2,1,300644,300644,300645,0,1,1
85814,6,1,300650,300650,300651,0,1,5
85815,2,1,300652,300652,300653,0,1,1
85816,2,2,300654,300654,300656,0,2,1
85817,2,2,300656,300656,300658,0,2,0
85818,5,3,300661,300661,300664,0,3,3
85819,6,2,300667,300667,300669,0,2,3
85820,5,1,300672,300672,300673,0,1,3
85821,3,3,300675,300675,300678,0,3,2
85822,6,2,300681,300681,300683,0,2,3
85823,6,1,300687,300687,300688,0,1,4
85824,2,2,300689,300689,300691,0,2,1
85825,2,1,300691,300691,300692,0,1,0
85826,1,1,300692,300692,300693,0,1,0
85827,4,3,300696,300696,300699,0,3,3
85828,1,1,300697,300699,300700,2,3,0
85829,2,2,300699,300700,300702,1,3,0
85830,1,3,300700,300702,300705,2,5,0
85831,1,1,300701,300705,300706,4,5,0
85832,2,2,300703,300706,300708,3,5,0
85833,6,3,300709,300709,300712,0,3,1
85834,5,3,300714,300714,300717,0,3,2
85835,2,1,300716,300717,300718,1,2,0
85836,1,3,300717,300718,300721,1,4,0
85837,1,3,300718,300721,300724,3,6,0
85838,5,2,300723,300724,300726,1,3,0
85839,6,2,300729,300729,300731,0,2,3
85840,4,2,300733,300733,300735,0,2,2
85841,5,3,300738,300738,300741,0,3,3
85842,6,3,300744,300744,300747,0,3,3
85843,6,2,300750,300750,300752,0,2,3
85844,4,2,300754,300754,300756,0,2,2
85845,1,3,300755,300756,300759,1,4,0
85846,5,3,300760,300760,300763,0,3,1
85847,5,1,300765,300765,300766,0,1,2
85848,2,1,300767,300767,300768,0,1,1
85849,6,2,300773,300773,300775,0,2,5
85850,6,2,300779,300779,300781,0,2,4
85851,6,1,300785,300785,300786,0,1,4
85852,4,2,300789,300789,300791,0,2,3
85853,5,1,300794,300794,300795,0,1,3
85854,5,3,300799,300799,300802,0,3,4
85855,2,2,300801,300802,300804,1,3,0
85856,1,1,300802,300804,300805,2,3,0
85857,4,3,300806,300806,300809,0,3,1
85858,3,1,300809,300809,300810,0,1,0
85859,2,3,300811,300811,300814,0,3,1
85860,3,2,300814,300814,300816,0,2,0
85861,4,1,300818,300818,300819,0,1,2
85862,3,3,300821,300821,300824,0,3,2
85863,2,3,300823,300824,300827,1,4,0
85864,6,3,300829,300829,300832,0,3,2
85865,4,2,300833,300833,300835,0,2,1
85866,4,3,300837,300837,300840,0,3,2
85867,3,2,300840,300840,300842,0,2,0
85868,3,1,300843,300843,300844,0,1,1
85869,6,2,300849,300849,300851,0,2,5
85870,6,3,300855,300855,300858,0,3,4
85871,4,1,300859,300859,300860,0,1,1
85872,2,2,300861,300861,300863,0,2,1
85873,6,1,300867,300867,300868,0,1,4
85874,1,3,300868,300868,300871,0,3,0
85875,4,3,300872,300872,300875,0,3,1
85876,6,1,300878,300878,300879,0,1,3
85877,2,3,300880,300880,300883,0,3,1
85878,1,1,300881,300883,300884,2,3,0
85879,1,2,300882,300884,300886,2,4,0
85880,4,1,300886,300886,300887,0,1,0
85881,6,1,300892,300892,300893,0,1,5
85882,5,3,300897,300897,300900,0,3,4
85883,1,3,300898,300900,300903,2,5,0
85884,6,2,300904,300904,300906,0,2,1
85885,6,2,300910,300910,300912,0,2,4
85886,2,2,300912,300912,300914,0,2,0
85887,6,3,300918,300918,300921,0,3,4
85888,6,1,300924,300924,300925,0,1,3
85889,1,2,300925,300925,300927,0,2,0
85890,6,2,300931,300931,300933,0,2,4
85891,2,3,300933,300933,300936,0,3,0
85892,5,2,300938,300938,300940,0,2,2
85893,5,1,300943,300943,300944,0,1,3
85894,5,1,300948,300948,300949,0,1,4
85895,2,1,300950,300950,300951,0,1,1
85896,5,1,300955,300955,300956,0,1,4
85897,4,3,300959,300959,300962,0,3,3
85898,6,2,300965,300965,300967,0,2,3
85899,6,1,300971,300971,300972,0,1,4
85900,6,3,300977,300977,300980,0,3,5
85901,3,2,300980,300980,300982,0,2,0
85902,3,3,300983,300983,300986,0,3,1
85903,6,3,300989,300989,300992,0,3,3
85904,5,1,300994,300994,300995,0,1,2
85905,3,1,300997,300997,300998,0,1,2
85906,5,2,301002,301002,301004,0,2,4
85907,6,1,301008,301008,301009,0,1,4
85908,1,3,301009,301009,301012,0,3,0
85909,5,2,301014,301014,301016,0,2,2
85910,2,1,301016,301016,301017,0,1,0
85911,1,2,301017,301017,301019,0,2,0
85912,5,3,301022,301022,301025,0,3,3
85913,3,2,301025,301025,301027,0,2,0
85914,2,2,301027,301027,301029,0,2,0
85915,1,3,301028,301029,301032,1,4,0
85916,4,2,301032,301032,301034,0,2,0
85917,1,1,301033,301034,301035,1,2,0
85918,2,2,301035,301035,301037,0,2,0
85919,1,1,301036,301037,301038,1,2,0
85920,5,3,301041,301041,301044,0,3,3
85921,4,2,301045,301045,301047,0,2,1
85922,3,1,301048,301048,301049,0,1,1
85923,6,1,301054,301054,301055,0,1,5
85924,3,2,301057,301057,301059,0,2,2
85925,4,1,301061,301061,301062,0,1,2
85926,1,3,301062,301062,301065,0,3,0
85927,4,2,301066,301066,301068,0,2,1
85928,6,2,301072,301072,301074,0,2,4
85929,4,2,301076,301076,301078,0,2,2
85930,3,3,301079,301079,301082,0,3,1
85931,2,2,301081,301082,301084,1,3,0
85932,5,2,301086,301086,301088,0,2,2
85933,1,1,301087,301088,301089,1,2,0
85934,5,1,301092,301092,301093,0,1,3
85935,2,1,301094,301094,301095,0,1,1
85936,4,3,301098,301098,301101,0,3,3
85937,3,1,301101,301101,301102,0,1,0
85938,1,3,301102,301102,301105,0,3,0
85939,6,1,301108,301108,301109,0,1,3
85940,5,1,301113,301113,301114,0,1,4
85941,3,3,301116,301116,301119,0,3,2
85942,2,3,301118,301119,301122,1,4,0
85943,2,3,301120,301122,301125,2,5,0
85944,6,3,301126,301126,301129,0,3,1
85945,4,1,301130,301130,301131,0,1,1
85946,4,3,301134,301134,301137,0,3,3
85947,6,1,301140,301140,301141,0,1,3
85948,4,2,301144,301144,301146,0,2,3
85949,4,1,301148,301148,301149,0,1,2
85950,6,2,301154,301154,301156,0,2,5
85951,6,2,301160,301160,301162,0,2,4
85952,2,2,301162,301162,301164,0,2,0
85953,2,1,301164,301164,301165,0,1,0
85954,1,2,301165,301165,301167,0,2,0
85955,2,1,301167,301167,301168,0,1,0
85956,1,1,301168,301168,301169,0,1,0
85957,5,2,301173,301173,301175,0,2,4
85958,2,3,301175,301175,301178,0,3,0
85959,4,3,301179,301179,301182,0,3,1
85960,4,2,301183,301183,301185,0,2,1
85961,5,1,301188,301188,301189,0,1,3
85962,3,1,301191,301191,301192,0,1,2
85963,3,3,301194,301194,301197,0,3,2
85964,3,3,301197,301197,301200,0,3,0
85965,4,1,301201,301201,301202,0,1,1
85966,3,3,301204,301204,301207,0,3,2
85967,4,1,301208,301208,301209,0,1,1
85968,6,1,301214,301214,301215,0,1,5
85969,1,3,301215,301215,301218,0,3,0
85970,2,3,301217,301218,301221,1,4,0
85971,6,3,301223,301223,301226,0,3,2
85972,1,3,301224,301226,301229,2,5,0
85973,4,1,301228,301229,301230,1,2,0
85974,6,1,301234,301234,301235,0,1,4
85975,1,2,301235,301235,301237,0,2,0
85976,3,3,301238,301238,301241,0,3,1
85977,5,1,301243,301243,301244,0,1,2
85978,3,1,301246,301246,301247,0,1,2
85979,3,2,301249,301249,301251,0,2,2
85980,4,1,301253,301253,301254,0,1,2
85981,3,1,301256,301256,301257,0,1,2
85982,5,2,301261,301261,301263,0,2,4
85983,2,2,301263,301263,301265,0,2,0
85984,2,1,301265,301265,301266,0,1,0
85985,5,2,301270,301270,301272,0,2,4
85986,1,2,301271,301272,301274,1,3,0
85987,4,3,301275,301275,301278,0,3,1
85988,2,1,301277,301278,301279,1,2,0
85989,4,1,301281,301281,301282,0,1,2
85990,6,3,301287,301287,301290,0,3,5
85991,1,3,301288,301290,301293,2,5,0
85992,2,2,301290,301293,301295,3,5,0
85993,2,2,301292,301295,301297,3,5,0
85994,5,1,301297,301297,301298,0,1,0
85995,2,3,301299,301299,301302,0,3,1
85996,2,2,301301,301302,301304,1,3,0
85997,5,1,301306,301306,301307,0,1,2
85998,5,2,301311,301311,301313,0,2,4
85999,3,1,301314,301314,301315,0,1,1
86000,4,1,301318,301318,301319,0,1,3
86001,4,2,301322,301322,301324,0,2,3
86002,3,1,301325,301325,301326,0,1,1
86003,2,1,301327,301327,301328,0,1,1
86004,1,3,301328,301328,301331,0,3,0
86005,2,1,301330,301331,301332,1,2,0
86006,2,1,301332,301332,301333,0,1,0
86007,5,1,301337,301337,301338,0,1,4
86008,5,1,301342,301342,301343,0,1,4
86009,2,3,301344,301344,301347,0,3,1
86010,6,3,301350,301350,301353,0,3,3
86011,6,2,301356,301356,301358,0,2,3
86012,4,1,301360,301360,301361,0,1,2
86013,4,3,301364,301364,301367,0,3,3
86014,6,2,301370,301370,301372,0,2,3
86015,5,2,301375,301375,301377,0,2,3
86016,5,1,301380,301380,301381,0,1,3
86017,3,1,301383,301383,301384,0,1,2
86018,2,1,301385,301385,301386,0,1,1
86019,3,1,301388,301388,301389,0,1,2
86020,6,2,301394,301394,301396,0,2,5
86021,6,3,301400,301400,301403,0,3,4
86022,1,2,301401,301403,301405,2,4,0
86023,4,3,301405,301405,301408,0,3,0
86024,2,1,301407,301408,301409,1,2,0
86025,5,3,301412,301412,301415,0,3,3
86026,6,2,301418,301418,301420,0,2,3
86027,4,2,301422,301422,301424,0,2,2
86028,2,1,301424,301424,301425,0,1,0
86029,6,3,301430,301430,301433,0,3,5
86030,4,2,301434,301434,301436,0,2,1
86031,3,3,301437,301437,301440,0,3,1
86032,3,3,301440,301440,301443,0,3,0
86033,4,2,301444,301444,301446,0,2,1
86034,4,1,301448,301448,301449,0,1,2
86035,6,1,301454,301454,301455,0,1,5
86036,4,2,301458,301458,301460,0,2,3
86037,1,3,301459,301460,301463,1,4,0
86038,3,2,301462,301463,301465,1,3,0
86039,1,2,301463,301465,301467,2,4,0
86040,2,2,301465,301467,301469,2,4,0
86041,3,1,301468,301469,301470,1,2,0
86042,1,1,301469,301470,301471,1,2,0
86043,2,2,301471,301471,301473,0,2,0
86044,1,3,301472,301473,301476,1,4,0
86045,6,1,301478,301478,301479,0,1,2
86046,2,1,301480,301480,301481,0,1,1
86047,3,3,301483,301483,301486,0,3,2
86048,4,1,301487,301487,301488,0,1,1
86049,2,3,301489,301489,301492,0,3,1
86050,3,1,301492,301492,301493,0,1,0
86051,3,1,301495,301495,301496,0,1,2
86052,1,1,301496,301496,301497,0,1,0
86053,1,2,301497,301497,301499,0,2,0
86054,5,2,301502,301502,301504,0,2,3
86055,6,1,301508,301508,301509,0,1,4
86056,4,2,301512,301512,301514,0,2,3
86057,6,2,301518,301518,301520,0,2,4
86058,3,3,301521,301521,301524,0,3,1
86059,3,1,301524,301524,301525,0,1,0
86060,4,3,301528,301528,301531,0,3,3
86061,6,1,301534,301534,301535,0,1,3
86062,3,3,301537,301537,301540,0,3,2
86063,2,3,301539,301540,301543,1,4,0
86064,5,2,301544,301544,301546,0,2,1
86065,6,2,301550,301550,301552,0,2,4
86066,3,2,301553,301553,301555,0,2,1
86067,3,2,301556,301556,301558,0,2,1
86068,2,3,301558,301558,301561,0,3,0
86069,2,1,301560,301561,301562,1,2,0
86070,2,2,301562,301562,301564,0,2,0
86071,5,3,301567,301567,301570,0,3,3
86072,6,3,301573,301573,301576,0,3,3
86073,2,2,301575,301576,301578,1,3,0
86074,6,3,301581,301581,301584,0,3,3
86075,3,2,301584,301584,301586,0,2,0
86076,2,1,301586,301586,301587,0,1,0
86077,4,3,301590,301590,301593,0,3,3
86078,2,1,301592,301593,301594,1,2,0
86079,4,3,301596,301596,301599,0,3,2
86080,1,3,301597,301599,301602,2,5,0
86081,3,1,301600,301602,301603,2,3,0
86082,3,3,301603,301603,301606,0,3,0
86083,1,2,301604,301606,301608,2,4,0
86084,5,2,301609,301609,301611,0,2,1
86085,4,2,301613,301613,301615,0,2,2
86086,4,3,301617,301617,301620,0,3,2
86087,1,2,301618,301620,301622,2,4,0
86088,5,1,301623,301623,301624,0,1,1
86089,2,2,301625,301625,301627,0,2,1
86090,3,1,301628,301628,301629,0,1,1
86091,6,2,301634,301634,301636,0,2,5
86092,6,2,301640,301640,301642,0,2,4
86093,3,3,301643,301643,301646,0,3,1
86094,2,1,301645,301646,301647,1,2,0
86095,4,1,301649,301649,301650,0,1,2
86096,6,3,301655,301655,301658,0,3,5
86097,1,1,301656,301658,301659,2,3,0
86098,4,1,301660,301660,301661,0,1,1
86099,2,3,301662,301662,301665,0,3,1
86100,6,2,301668,301668,301670,0,2,3
86101,4,1,301672,301672,301673,0,1,2
86102,5,3,301677,301677,301680,0,3,4
86103,2,3,301679,301680,301683,1,4,0
86104,6,2,301685,301685,301687,0,2,2
86105,4,3,301689,301689,301692,0,3,2
86106,1,2,301690,301692,301694,2,4,0
86107,4,3,301694,301694,301697,0,3,0
86108,2,1,301696,301697,301698,1,2,0
86109,4,2,301700,301700,301702,0,2,2
86110,6,3,301706,301706,301709,0,3,4
86111,2,3,301708,301709,301712,1,4,0
86112,2,2,301710,301712,301714,2,4,0
86113,1,1,301711,301714,301715,3,4,0
86114,6,1,301717,301717,301718,0,1,2
86115,6,2,301723,301723,301725,0,2,5
86116,1,1,301724,301725,301726,1,2,0
86117,4,3,301728,301728,301731,0,3,2
86118,5,3,301733,301733,301736,0,3,2
86119,6,3,301739,301739,301742,0,3,3
86120,1,2,301740,301742,301744,2,4,0
86121,2,3,301742,301744,301747,2,5,0
86122,6,1,301748,301748,301749,0,1,1
86123,2,1,301750,301750,301751,0,1,1
86124,1,2,301751,301751,301753,0,2,0
86125,6,1,301757,301757,301758,0,1,4
86126,4,3,301761,301761,301764,0,3,3
86127,6,2,301767,301767,301769,0,2,3
86128,1,1,301768,301769,301770,1,2,0
86129,4,3,301772,301772,301775,0,3,2
86130,4,2,301776,301776,301778,0,2,1
86131,5,2,301781,301781,301783,0,2,3
86132,6,3,301787,301787,301790,0,3,4
86133,6,3,301793,301793,301796,0,3,3
86134,5,3,301798,301798,301801,0,3,2
86135,3,1,301801,301801,301802,0,1,0
86136,1,2,301802,301802,301804,0,2,0
86137,3,1,301805,301805,301806,0,1,1
86138,5,2,301810,301810,301812,0,2,4
86139,5,3,301815,301815,301818,0,3,3
86140,1,2,301816,301818,301820,2,4,0
86141,5,2,301821,301821,301823,0,2,1
86142,6,2,301827,301827,301829,0,2,4
86143,4,2,301831,301831,301833,0,2,2
86144,6,3,301837,301837,301840,0,3,4
86145,5,1,301842,301842,301843,0,1,2
86146,3,1,301845,301845,301846,0,1,2
86147,3,2,301848,301848,301850,0,2,2
86148,4,2,301852,301852,301854,0,2,2
86149,4,1,301856,301856,301857,0,1,2
86150,5,3,301861,301861,301864,0,3,4
86151,2,2,301863,301864,301866,1,3,0
86152,4,1,301867,301867,301868,0,1,1
86153,3,1,301870,301870,301871,0,1,2
86154,6,1,301876,301876,301877,0,1,5
86155,4,3,301880,301880,301883,0,3,3
86156,5,2,301885,301885,301887,0,2,2
86157,6,1,301891,301891,301892,0,1,4
86158,6,3,301897,301897,301900,0,3,5
86159,2,2,301899,301900,301902,1,3,0
86160,3,3,301902,301902,301905,0,3,0
86161,2,3,301904,301905,301908,1,4,0
86162,5,1,301909,301909,301910,0,1,1
86163,5,3,301914,301914,301917,0,3,4
86164,6,2,301920,301920,301922,0,2,3
86165,5,3,301925,301925,301928,0,3,3
86166,1,2,301926,301928,301930,2,4,0
86167,5,2,301931,301931,301933,0,2,1
86168,3,1,301934,301934,301935,0,1,1
86169,4,2,301938,301938,301940,0,2,3
86170,5,2,301943,301943,301945,0,2,3
86171,6,1,301949,301949,301950,0,1,4
86172,1,1,301950,301950,301951,0,1,0
86173,6,3,301956,301956,301959,0,3,5
86174,5,3,301961,301961,301964,0,3,2
86175,6,3,301967,301967,301970,0,3,3
86176,3,1,301970,301970,301971,0,1,0
86177,1,2,301971,301971,301973,0,2,0
86178,2,3,301973,301973,301976,0,3,0
86179,5,3,301978,301978,301981,0,3,2
86180,4,3,301982,301982,301985,0,3,1
86181,6,2,301988,301988,301990,0,2,3
86182,3,3,301991,301991,301994,0,3,1
86183,6,2,301997,301997,301999,0,2,3
86184,1,1,301998,301999,302000,1,2,0
86185,5,3,302003,302003,302006,0,3,3
86186,3,2,302006,302006,302008,0,2,0
86187,1,3,302007,302008,302011,1,4,0
86188,2,1,302009,302011,302012,2,3,0
86189,2,3,302011,302012,302015,1,4,0
86190,1,2,302012,302015,302017,3,5,0
86191,5,3,302017,302017,302020,0,3,0
86192,4,1,302021,302021,302022,0,1,1
86193,6,2,302027,302027,302029,0,2,5
86194,3,1,302030,302030,302031,0,1,1
86195,6,1,302036,302036,302037,0,1,5
86196,4,2,302040,302040,302042,0,2,3
86197,4,3,302044,302044,302047,0,3,2
86198,5,3,302049,302049,302052,0,3,2
86199,2,2,302051,302052,302054,1,3,0
86200,4,2,302055,302055,302057,0,2,1
86201,5,1,302060,302060,302061,0,1,3
86202,4,2,302064,302064,302066,0,2,3
86203,1,3,302065,302066,302069,1,4,0
86204,1,3,302066,302069,302072,3,6,0
86205,4,1,302070,302072,302073,2,3,0
86206,4,1,302074,302074,302075,0,1,1
86207,2,1,302076,302076,302077,0,1,1
86208,6,2,302082,302082,302084,0,2,5
86209,5,2,302087,302087,302089,0,2,3
86210,4,2,302091,302091,302093,0,2,2
86211,2,2,302093,302093,302095,0,2,0
86212,4,1,302097,302097,302098,0,1,2
86213,2,2,302099,302099,302101,0,2,1
86214,1,3,302100,302101,302104,1,4,0
86215,6,2,302106,302106,302108,0,2,2
86216,4,3,302110,302110,302113,0,3,2
86217,6,3,302116,302116,302119,0,3,3
86218,5,1,302121,302121,302122,0,1,2
86219,6,1,302127,302127,302128,0,1,5
86220,5,2,302132,302132,302134,0,2,4
86221,5,1,302137,302137,302138,0,1,3
86222,6,2,302143,302143,302145,0,2,5
86223,1,3,302144,302145,302148,1,4,0
86224,4,1,302148,302148,302149,0,1,0
86225,1,2,302149,302149,302151,0,2,0
86226,4,2,302153,302153,302155,0,2,2
86227,1,3,302154,302155,302158,1,4,0
86228,1,2,302155,302158,302160,3,5,0
86229,5,2,302160,302160,302162,0,2,0
86230,2,2,302162,302162,302164,0,2,0
86231,1,1,302163,302164,302165,1,2,0
86232,6,1,302169,302169,302170,0,1,4
86233,1,2,302170,302170,302172,0,2,0
86234,1,3,302171,302172,302175,1,4,0
86235,1,2,302172,302175,302177,3,5,0
86236,4,1,302176,302177,302178,1,2,0
86237,4,3,302180,302180,302183,0,3,2
86238,3,2,302183,302183,302185,0,2,0
86239,4,1,302187,302187,302188,0,1,2
86240,4,3,302191,302191,302194,0,3,3
86241,4,3,302195,302195,302198,0,3,1
86242,1,2,302196,302198,302200,2,4,0
86243,4,3,302200,302200,302203,0,3,0
86244,5,1,302205,302205,302206,0,1,2
86245,5,3,302210,302210,302213,0,3,4
86246,4,2,302214,302214,302216,0,2,1
86247,3,3,302217,302217,302220,0,3,1
86248,1,2,302218,302220,302222,2,4,0
86249,2,3,302220,302222,302225,2,5,0
86250,3,1,302223,302225,302226,2,3,0
86251,5,2,302228,302228,302230,0,2,2
86252,2,1,302230,302230,302231,0,1,0
86253,1,3,302231,302231,302234,0,3,0
86254,2,3,302233,302234,302237,1,4,0
86255,4,1,302237,302237,302238,0,1,0
86256,2,1,302239,302239,302240,0,1,1
86257,6,2,302245,302245,302247,0,2,5
86258,4,1,302249,302249,302250,0,1,2
86259,2,3,302251,302251,302254,0,3,1
86260,5,1,302256,302256,302257,0,1,2
86261,4,1,302260,302260,302261,0,1,3
86262,6,2,302266,302266,302268,0,2,5
86263,1,2,302267,302268,302270,1,3,0
86264,6,2,302273,302273,302275,0,2,3
86265,5,2,302278,302278,302280,0,2,3
86266,5,1,302283,302283,302284,0,1,3
86267,6,3,302289,302289,302292,0,3,5
86268,6,1,302295,302295,302296,0,1,3
86269,3,1,302298,302298,302299,0,1,2
86270,6,1,302304,302304,302305,0,1,5
86271,2,2,302306,302306,302308,0,2,1
86272,6,1,302312,302312,302313,0,1,4
86273,4,3,302316,302316,302319,0,3,3
86274,2,1,302318,302319,302320,1,2,0
86275,4,2,302322,302322,302324,0,2,2
86276,3,2,302325,302325,302327,0,2,1
86277,3,3,302328,302328,302331,0,3,1
86278,3,2,302331,302331,302333,0,2,0
86279,6,3,302337,302337,302340,0,3,4
86280,2,3,302339,302340,302343,1,4,0
86281,4,1,302343,302343,302344,0,1,0
86282,6,1,302349,302349,302350,0,1,5
86283,1,2,302350,302350,302352,0,2,0
86284,4,1,302354,302354,302355,0,1,2
86285,6,2,302360,302360,302362,0,2,5
86286,1,1,302361,302362,302363,1,2,0
86287,6,2,302367,302367,302369,0,2,4
86288,3,3,302370,302370,302373,0,3,1
86289,1,2,302371,302373,302375,2,4,0
86290,5,2,302376,302376,302378,0,2,1
86291,6,1,302382,302382,302383,0,1,4
86292,2,2,302384,302384,302386,0,2,1
86293,2,2,302386,302386,302388,0,2,0
86294,3,1,302389,302389,302390,0,1,1
86295,5,2,302394,302394,302396,0,2,4
86296,4,1,302398,302398,302399,0,1,2
86297,3,3,302401,302401,302404,0,3,2
86298,4,3,302405,302405,302408,0,3,1
86299,2,3,302407,302408,302411,1,4,0
86300,5,3,302412,302412,302415,0,3,1
86301,2,2,302414,302415,302417,1,3,0
86302,4,1,302418,302418,302419,0,1,1
86303,4,3,302422,302422,302425,0,3,3
86304,4,1,302426,302426,302427,0,1,1
86305,3,3,302429,302429,302432,0,3,2
86306,2,1,302431,302432,302433,1,2,0
86307,5,1,302436,302436,302437,0,1,3
86308,5,2,302441,302441,302443,0,2,4
86309,4,2,302445,302445,302447,0,2,2
86310,6,1,302451,302451,302452,0,1,4
86311,3,2,302454,302454,302456,0,2,2
86312,5,1,302459,302459,302460,0,1,3
86313,5,2,302464,302464,302466,0,2,4
86314,2,1,302466,302466,302467,0,1,0
86315,1,1,302467,302467,302468,0,1,0
86316,2,2,302469,302469,302471,0,2,1
86317,4,1,302473,302473,302474,0,1,2
86318,3,3,302476,302476,302479,0,3,2
86319,1,2,302477,302479,302481,2,4,0
86320,3,1,302480,302481,302482,1,2,0
86321,4,2,302484,302484,302486,0,2,2
86322,6,1,302490,302490,302491,0,1,4
86323,4,2,302494,302494,302496,0,2,3
86324,4,1,302498,302498,302499,0,1,2
86325,2,3,302500,302500,302503,0,3,1
86326,6,2,302506,302506,302508,0,2,3
86327,3,2,302509,302509,302511,0,2,1
86328,5,1,302514,302514,302515,0,1,3
86329,4,2,302518,302518,302520,0,2,3
86330,4,2,302522,302522,302524,0,2,2
86331,5,3,302527,302527,302530,0,3,3
86332,5,1,302532,302532,302533,0,1,2
86333,4,2,302536,302536,302538,0,2,3
86334,5,3,302541,302541,302544,0,3,3
86335,5,3,302546,302546,302549,0,3,2
86336,4,3,302550,302550,302553,0,3,1
86337,4,3,302554,302554,302557,0,3,1
86338,3,1,302557,302557,302558,0,1,0
86339,4,1,302561,302561,302562,0,1,3
86340,5,3,302566,302566,302569,0,3,4
86341,6,2,302572,302572,302574,0,2,3
86342,6,2,302578,302578,302580,0,2,4
86343,5,2,302583,302583,302585,0,2,3
86344,2,1,302585,302585,302586,0,1,0
86345,6,1,302591,302591,302592,0,1,5
86346,2,1,302593,302593,302594,0,1,1
86347,5,2,302598,302598,302600,0,2,4
86348,3,1,302601,302601,302602,0,1,1
86349,3,2,302604,302604,302606,0,2,2
86350,1,3,302605,302606,302609,1,4,0
86351,3,3,302608,302609,302612,1,4,0
86352,1,3,302609,302612,302615,3,6,0
86353,3,1,302612,302615,302616,3,4,0
86354,2,2,302614,302616,302618,2,4,0
86355,3,2,302617,302618,302620,1,3,0
86356,3,1,302620,302620,302621,0,1,0
86357,5,1,302625,302625,302626,0,1,4
86358,3,2,302628,302628,302630,0,2,2
86359,4,3,302632,302632,302635,0,3,2
86360,5,1,302637,302637,302638,0,1,2
86361,2,3,302639,302639,302642,0,3,1
86362,2,2,302641,302642,302644,1,3,0
86363,3,2,302644,302644,302646,0,2,0
86364,1,1,302645,302646,302647,1,2,0
86365,6,1,302651,302651,302652,0,1,4
86366,6,1,302657,302657,302658,0,1,5
86367,2,2,302659,302659,302661,0,2,1
86368,3,2,302662,302662,302664,0,2,1
86369,3,3,302665,302665,302668,0,3,1
86370,2,3,302667,302668,302671,1,4,0
86371,5,2,302672,302672,302674,0,2,1
86372,6,1,302678,302678,302679,0,1,4
86373,4,1,302682,302682,302683,0,1,3
86374,5,2,302687,302687,302689,0,2,4
86375,5,3,302692,302692,302695,0,3,3
86376,1,1,302693,302695,302696,2,3,0
86377,2,3,302695,302696,302699,1,4,0
86378,6,1,302701,302701,302702,0,1,2
86379,4,2,302705,302705,302707,0,2,3
86380,4,3,302709,302709,302712,0,3,2
86381,6,3,302715,302715,302718,0,3,3
86382,1,3,302716,302718,302721,2,5,0
86383,5,1,302721,302721,302722,0,1,0
86384,3,2,302724,302724,302726,0,2,2
86385,4,3,302728,302728,302731,0,3,2
86386,1,1,302729,302731,302732,2,3,0
86387,4,2,302733,302733,302735,0,2,1
86388,5,2,302738,302738,302740,0,2,3
86389,1,1,302739,302740,302741,1,2,0
86390,4,2,302743,302743,302745,0,2,2
86391,2,3,302745,302745,302748,0,3,0
86392,4,3,302749,302749,302752,0,3,1
86393,1,2,302750,302752,302754,2,4,0
86394,3,2,302753,302754,302756,1,3,0
86395,2,3,302755,302756,302759,1,4,0
86396,6,2,302761,302761,302763,0,2,2
86397,6,3,302767,302767,302770,0,3,4
86398,3,2,302770,302770,302772,0,2,0
86399,4,2,302774,302774,302776,0,2,2
86400,4,3,302778,302778,302781,0,3,2
86401,3,2,302781,302781,302783,0,2,0
86402,6,2,302787,302787,302789,0,2,4
86403,2,3,302789,302789,302792,0,3,0
86404,1,1,302790,302792,302793,2,3,0
86405,2,2,302792,302793,302795,1,3,0
86406,2,1,302794,302795,302796,1,2,0
86407,5,2,302799,302799,302801,0,2,3
86408,5,1,302804,302804,302805,0,1,3
86409,4,3,302808,302808,302811,0,3,3
86410,4,3,302812,302812,302815,0,3,1
86411,3,3,302815,302815,302818,0,3,0
86412,1,3,302816,302818,302821,2,5,0
86413,6,3,302822,302822,302825,0,3,1
86414,1,3,302823,302825,302828,2,5,0
86415,5,2,302828,302828,302830,0,2,0
86416,1,3,302829,302830,302833,1,4,0
86417,6,1,302835,302835,302836,0,1,2
86418,3,1,302838,302838,302839,0,1,2
86419,6,3,302844,302844,302847,0,3,5
86420,3,3,302847,302847,302850,0,3,0
86421,1,1,302848,302850,302851,2,3,0
86422,5,2,302853,302853,302855,0,2,2
86423,5,3,302858,302858,302861,0,3,3
86424,4,2,302862,302862,302864,0,2,1
86425,2,1,302864,302864,302865,0,1,0
86426,6,2,302870,302870,302872,0,2,5
86427,6,1,302876,302876,302877,0,1,4
86428,4,2,302880,302880,302882,0,2,3
86429,6,3,302886,302886,302889,0,3,4
86430,1,1,302887,302889,302890,2,3,0
86431,5,3,302892,302892,302895,0,3,2
86432,4,1,302896,302896,302897,0,1,1
86433,6,1,302902,302902,302903,0,1,5
86434,6,1,302908,302908,302909,0,1,5
86435,4,1,302912,302912,302913,0,1,3
86436,6,2,302918,302918,302920,0,2,5
86437,4,2,302922,302922,302924,0,2,2
86438,3,2,302925,302925,302927,0,2,1
86439,1,1,302926,302927,302928,1,2,0
86440,3,2,302929,302929,302931,0,2,1
86441,5,1,302934,302934,302935,0,1,3
86442,2,1,302936,302936,302937,0,1,1
86443,1,1,302937,302937,302938,0,1,0
86444,4,3,302941,302941,302944,0,3,3
86445,2,2,302943,302944,302946,1,3,0
86446,1,2,302944,302946,302948,2,4,0
86447,3,2,302947,302948,302950,1,3,0
86448,4,2,302951,302951,302953,0,2,1
86449,1,3,302952,302953,302956,1,4,0
86450,4,1,302956,302956,302957,0,1,0
86451,1,3,302957,302957,302960,0,3,0
86452,4,2,302961,302961,302963,0,2,1
86453,4,3,302965,302965,302968,0,3,2
86454,1,3,302966,302968,302971,2,5,0
86455,5,3,302971,302971,302974,0,3,0
86456,4,2,302975,302975,302977,0,2,1
86457,4,2,302979,302979,302981,0,2,2
86458,4,3,302983,302983,302986,0,3,2
86459,1,2,302984,302986,302988,2,4,0
86460,6,3,302990,302990,302993,0,3,2
86461,2,2,302992,302993,302995,1,3,0
86462,1,1,302993,302995,302996,2,3,0
86463,1,2,302994,302996,302998,2,4,0
86464,5,2,302999,302999,303001,0,2,1
86465,3,2,303002,303002,303004,0,2,1
86466,2,3,303004,303004,303007,0,3,0
86467,5,2,303009,303009,303011,0,2,2
86468,1,1,303010,303011,303012,1,2,0
86469,6,2,303016,303016,303018,0,2,4
86470,3,1,303019,303019,303020,0,1,1
86471,3,3,303022,303022,303025,0,3,2
86472,4,2,303026,303026,303028,0,2,1
86473,3,1,303029,303029,303030,0,1,1
86474,1,1,303030,303030,303031,0,1,0
86475,1,1,303031,303031,303032,0,1,0
86476,4,3,303035,303035,303038,0,3,3
86477,1,1,303036,303038,303039,2,3,0
86478,6,1,303042,303042,303043,0,1,3
86479,3,1,303045,303045,303046,0,1,2
86480,3,1,303048,303048,303049,0,1,2
86481,3,1,303051,303051,303052,0,1,2
86482,3,3,303054,303054,303057,0,3,2
86483,5,2,303059,303059,303061,0,2,2
86484,3,1,303062,303062,303063,0,1,1
86485,5,1,303067,303067,303068,0,1,4
86486,5,1,303072,303072,303073,0,1,4
86487,1,2,303073,303073,303075,0,2,0
86488,4,3,303077,303077,303080,0,3,2
86489,1,2,303078,303080,303082,2,4,0
86490,2,2,303080,303082,303084,2,4,0
86491,2,1,303082,303084,303085,2,3,0
86492,6,1,303088,303088,303089,0,1,3
86493,6,2,303094,303094,303096,0,2,5
86494,3,3,303097,303097,303100,0,3,1
86495,3,3,303100,303100,303103,0,3,0
86496,6,3,303106,303106,303109,0,3,3
86497,2,3,303108,303109,303112,1,4,0
86498,2,1,303110,303112,303113,2,3,0
86499,2,3,303112,303113,303116,1,4,0
86500,6,3,303118,303118,303121,0,3,2
86501,3,3,303121,303121,303124,0,3,0
86502,4,2,303125,303125,303127,0,2,1
86503,4,2,303129,303129,303131,0,2,2
86504,2,3,303131,303131,303134,0,3,0
86505,1,2,303132,303134,303136,2,4,0
86506,1,2,303133,303136,303138,3,5,0
86507,5,2,303138,303138,303140,0,2,0
86508,5,1,303143,303143,303144,0,1,3
86509,1,1,303144,303144,303145,0,1,0
86510,6,1,303150,303150,303151,0,1,5
86511,2,2,303152,303152,303154,0,2,1
86512,3,3,303155,303155,303158,0,3,1
86513,3,3,303158,303158,303161,0,3,0
86514,6,2,303164,303164,303166,0,2,3
86515,3,3,303167,303167,303170,0,3,1
86516,1,1,303168,303170,303171,2,3,0
86517,1,3,303169,303171,303174,2,5,0
86518,6,1,303175,303175,303176,0,1,1
86519,2,1,303177,303177,303178,0,1,1
86520,6,2,303183,303183,303185,0,2,5
86521,4,3,303187,303187,303190,0,3,2
86522,1,1,303188,303190,303191,2,3,0
86523,2,1,303190,303191,303192,1,2,0
86524,2,2,303192,303192,303194,0,2,0
86525,3,2,303195,303195,303197,0,2,1
86526,4,1,303199,303199,303200,0,1,2
86527,5,2,303204,303204,303206,0,2,4
86528,5,2,303209,303209,303211,0,2,3
86529,2,2,303211,303211,303213,0,2,0
86530,5,2,303216,303216,303218,0,2,3
86531,4,3,303220,303220,303223,0,3,2
86532,5,3,303225,303225,303228,0,3,2
86533,1,1,303226,303228,303229,2,3,0
86534,5,2,303231,303231,303233,0,2,2
86535,5,2,303236,303236,303238,0,2,3
86536,3,1,303239,303239,303240,0,1,1
86537,6,3,303245,303245,303248,0,3,5
86538,3,2,303248,303248,303250,0,2,0
86539,4,1,303252,303252,303253,0,1,2
86540,6,1,303258,303258,303259,0,1,5
86541,3,2,303261,303261,303263,0,2,2
86542,3,1,303264,303264,303265,0,1,1
86543,1,1,303265,303265,303266,0,1,0
86544,2,3,303267,303267,303270,0,3,1
86545,6,1,303273,303273,303274,0,1,3
86546,2,3,303275,303275,303278,0,3,1
86547,3,3,303278,303278,303281,0,3,0
86548,2,1,303280,303281,303282,1,2,0
86549,6,1,303286,303286,303287,0,1,4
86550,5,2,303291,303291,303293,0,2,4
86551,4,2,303295,303295,303297,0,2,2
86552,5,2,303300,303300,303302,0,2,3
86553,1,1,303301,303302,303303,1,2,0
86554,1,3,303302,303303,303306,1,4,0
86555,4,2,303306,303306,303308,0,2,0
86556,5,3,303311,303311,303314,0,3,3
86557,3,1,303314,303314,303315,0,1,0
86558,5,2,303319,303319,303321,0,2,4
86559,3,2,303322,303322,303324,0,2,1
86560,2,2,303324,303324,303326,0,2,0
86561,5,1,303329,303329,303330,0,1,3
86562,4,3,303333,303333,303336,0,3,3
86563,6,2,303339,303339,303341,0,2,3
86564,1,1,303340,303341,303342,1,2,0
86565,2,3,303342,303342,303345,0,3,0
86566,2,2,303344,303345,303347,1,3,0
86567,3,2,303347,303347,303349,0,2,0
86568,2,1,303349,303349,303350,0,1,0
86569,1,3,303350,303350,303353,0,3,0
86570,6,1,303356,303356,303357,0,1,3
86571,5,1,303361,303361,303362,0,1,4
86572,1,3,303362,303362,303365,0,3,0
86573,3,3,303365,303365,303368,0,3,0
86574,6,2,303371,303371,303373,0,2,3
86575,3,3,303374,303374,303377,0,3,1
86576,5,3,303379,303379,303382,0,3,2
86577,2,3,303381,303382,303385,1,4,0
86578,3,3,303384,303385,303388,1,4,0
86579,3,2,303387,303388,303390,1,3,0
86580,1,1,303388,303390,303391,2,3,0
86581,6,2,303394,303394,303396,0,2,3
86582,6,1,303400,303400,303401,0,1,4
86583,1,3,303401,303401,303404,0,3,0
86584,1,1,303402,303404,303405,2,3,0
86585,6,3,303408,303408,303411,0,3,3
86586,1,3,303409,303411,303414,2,5,0
86587,5,3,303414,303414,303417,0,3,0
86588,5,1,303419,303419,303420,0,1,2
86589,2,2,303421,303421,303423,0,2,1
86590,1,1,303422,303423,303424,1,2,0
86591,6,1,303428,303428,303429,0,1,4
86592,4,1,303432,303432,303433,0,1,3
86593,6,3,303438,303438,303441,0,3,5
86594,5,2,303443,303443,303445,0,2,2
86595,3,3,303446,303446,303449,0,3,1
86596,6,1,303452,303452,303453,0,1,3
86597,2,3,303454,303454,303457,0,3,1
86598,4,2,303458,303458,303460,0,2,1
86599,3,1,303461,303461,303462,0,1,1
86600,1,1,303462,303462,303463,0,1,0
86601,5,2,303467,303467,303469,0,2,4
86602,4,1,303471,303471,303472,0,1,2
86603,4,2,303475,303475,303477,0,2,3
86604,2,1,303477,303477,303478,0,1,0
86605,6,2,303483,303483,303485,0,2,5
86606,5,2,303488,303488,303490,0,2,3
86607,5,3,303493,303493,303496,0,3,3
86608,1,2,303494,303496,303498,2,4,0
86609,2,3,303496,303498,303501,2,5,0
86610,2,3,303498,303501,303504,3,6,0
86611,5,2,303503,303504,303506,1,3,0
86612,2,1,303505,303506,303507,1,2,0
86613,3,2,303508,303508,303510,0,2,1
86614,3,2,303511,303511,303513,0,2,1
86615,6,1,303517,303517,303518,0,1,4
86616,2,1,303519,303519,303520,0,1,1
86617,6,3,303525,303525,303528,0,3,5
86618,2,3,303527,303528,303531,1,4,0
86619,6,2,303533,303533,303535,0,2,2
86620,5,2,303538,303538,303540,0,2,3
86621,3,3,303541,303541,303544,0,3,1
86622,3,1,303544,303544,303545,0,1,0
86623,2,1,303546,303546,303547,0,1,1
86624,4,1,303550,303550,303551,0,1,3
86625,2,2,303552,303552,303554,0,2,1
86626,3,3,303555,303555,303558,0,3,1
86627,3,3,303558,303558,303561,0,3,0
86628,4,2,303562,303562,303564,0,2,1
86629,6,3,303568,303568,303571,0,3,4
86630,1,3,303569,303571,303574,2,5,0
86631,5,1,303574,303574,303575,0,1,0
86632,3,3,303577,303577,303580,0,3,2
86633,5,3,303582,303582,303585,0,3,2
86634,6,2,303588,303588,303590,0,2,3
86635,2,1,303590,303590,303591,0,1,0
86636,6,3,303596,303596,303599,0,3,5
86637,3,1,303599,303599,303600,0,1,0
86638,3,3,303602,303602,303605,0,3,2
86639,5,2,303607,303607,303609,0,2,2
86640,3,3,303610,303610,303613,0,3,1
86641,1,3,303611,303613,303616,2,5,0
86642,1,1,303612,303616,303617,4,5,0
86643,2,1,303614,303617,303618,3,4,0
86644,2,1,303616,303618,303619,2,3,0
86645,5,3,303621,303621,303624,0,3,2
86646,5,1,303626,303626,303627,0,1,2
86647,5,2,303631,303631,303633,0,2,4
86648,5,2,303636,303636,303638,0,2,3
86649,1,1,303637,303638,303639,1,2,0
86650,6,3,303643,303643,303646,0,3,4
86651,1,1,303644,303646,303647,2,3,0
86652,5,2,303649,303649,303651,0,2,2
86653,1,2,303650,303651,303653,1,3,0
86654,3,1,303653,303653,303654,0,1,0
86655,2,1,303655,303655,303656,0,1,1
86656,6,3,303661,303661,303664,0,3,5
86657,5,1,303666,303666,303667,0,1,2
86658,5,3,303671,303671,303674,0,3,4
86659,1,1,303672,303674,303675,2,3,0
86660,5,1,303677,303677,303678,0,1,2
86661,4,3,303681,303681,303684,0,3,3
86662,3,3,303684,303684,303687,0,3,0
86663,5,3,303689,303689,303692,0,3,2
86664,6,3,303695,303695,303698,0,3,3
86665,2,3,303697,303698,303701,1,4,0
86666,2,3,303699,303701,303704,2,5,0
86667,1,2,303700,303704,303706,4,6,0
86668,3,3,303703,303706,303709,3,6,0
86669,2,3,303705,303709,303712,4,7,0
86670,5,2,303710,303712,303714,2,4,0
86671,5,3,303715,303715,303718,0,3,1
86672,4,2,303719,303719,303721,0,2,1
86673,6,2,303725,303725,303727,0,2,4
86674,6,3,303731,303731,303734,0,3,4
86675,5,3,303736,303736,303739,0,3,2
86676,3,3,303739,303739,303742,0,3,0
86677,3,1,303742,303742,303743,0,1,0
86678,3,3,303745,303745,303748,0,3,2
86679,5,3,303750,303750,303753,0,3,2
86680,4,2,303754,303754,303756,0,2,1
86681,6,1,303760,303760,303761,0,1,4
86682,3,2,303763,303763,303765,0,2,2
86683,6,3,303769,303769,303772,0,3,4
86684,1,1,303770,303772,303773,2,3,0
86685,6,1,303776,303776,303777,0,1,3
86686,4,3,303780,303780,303783,0,3,3
86687,6,1,303786,303786,303787,0,1,3
86688,3,3,303789,303789,303792,0,3,2
86689,3,3,303792,303792,303795,0,3,0
86690,3,1,303795,303795,303796,0,1,0
86691,3,2,303798,303798,303800,0,2,2
86692,5,3,303803,303803,303806,0,3,3
86693,1,2,303804,303806,303808,2,4,0
86694,1,1,303805,303808,303809,3,4,0
86695,2,2,303807,303809,303811,2,4,0
86696,4,3,303811,303811,303814,0,3,0
86697,4,3,303815,303815,303818,0,3,1
86698,3,2,303818,303818,303820,0,2,0
86699,3,3,303821,303821,303824,0,3,1
86700,5,3,303826,303826,303829,0,3,2
86701,2,3,303828,303829,303832,1,4,0
86702,3,2,303831,303832,303834,1,3,0
86703,4,1,303835,303835,303836,0,1,1
86704,4,1,303839,303839,303840,0,1,3
86705,1,3,303840,303840,303843,0,3,0
86706,6,2,303846,303846,303848,0,2,3
86707,4,1,303850,303850,303851,0,1,2
86708,5,2,303855,303855,303857,0,2,4
86709,1,2,303856,303857,303859,1,3,0
86710,2,2,303858,303859,303861,1,3,0
86711,3,2,303861,303861,303863,0,2,0
86712,4,3,303865,303865,303868,0,3,2
86713,5,3,303870,303870,303873,0,3,2
86714,4,1,303874,303874,303875,0,1,1
86715,6,1,303880,303880,303881,0,1,5
86716,2,2,303882,303882,303884,0,2,1
86717,4,3,303886,303886,303889,0,3,2
86718,3,3,303889,303889,303892,0,3,0
86719,3,2,303892,303892,303894,0,2,0
86720,3,1,303895,303895,303896,0,1,1
86721,6,2,303901,303901,303903,0,2,5
86722,1,2,303902,303903,303905,1,3,0
86723,4,2,303906,303906,303908,0,2,1
86724,5,1,303911,303911,303912,0,1,3
86725,3,3,303914,303914,303917,0,3,2
86726,3,1,303917,303917,303918,0,1,0
86727,4,2,303921,303921,303923,0,2,3
86728,6,3,303927,303927,303930,0,3,4
86729,2,2,303929,303930,303932,1,3,0
86730,1,3,303930,303932,303935,2,5,0
86731,3,1,303933,303935,303936,2,3,0
86732,2,3,303935,303936,303939,1,4,0
86733,6,1,303941,303941,303942,0,1,2
86734,6,3,303947,303947,303950,0,3,5
86735,4,1,303951,303951,303952,0,1,1
86736,5,2,303956,303956,303958,0,2,4
86737,6,3,303962,303962,303965,0,3,4
86738,4,1,303966,303966,303967,0,1,1
86739,4,3,303970,303970,303973,0,3,3
86740,3,1,303973,303973,303974,0,1,0
86741,1,2,303974,303974,303976,0,2,0
86742,4,1,303978,303978,303979,0,1,2
86743,6,3,303984,303984,303987,0,3,5
86744,5,3,303989,303989,303992,0,3,2
86745,1,2,303990,303992,303994,2,4,0
86746,3,3,303993,303994,303997,1,4,0
86747,3,1,303996,303997,303998,1,2,0
86748,3,3,303999,303999,304002,0,3,1
86749,1,1,304000,304002,304003,2,3,0
86750,5,1,304005,304005,304006,0,1,2
86751,4,2,304009,304009,304011,0,2,3
86752,4,3,304013,304013,304016,0,3,2
86753,1,1,304014,304016,304017,2,3,0
86754,1,2,304015,304017,304019,2,4,0
86755,3,1,304018,304019,304020,1,2,0
86756,3,1,304021,304021,304022,0,1,1
86757,2,3,304023,304023,304026,0,3,1
86758,2,2,304025,304026,304028,1,3,0
86759,5,2,304030,304030,304032,0,2,2
86760,3,3,304033,304033,304036,0,3,1
86761,1,3,304034,304036,304039,2,5,0
86762,1,3,304035,304039,304042,4,7,0
86763,5,1,304040,304042,304043,2,3,0
86764,1,2,304041,304043,304045,2,4,0
86765,5,1,304046,304046,304047,0,1,1
86766,1,1,304047,304047,304048,0,1,0
86767,4,3,304051,304051,304054,0,3,3
86768,2,2,304053,304054,304056,1,3,0
86769,2,1,304055,304056,304057,1,2,0
86770,2,3,304057,304057,304060,0,3,0
86771,4,2,304061,304061,304063,0,2,1
86772,3,1,304064,304064,304065,0,1,1
86773,6,2,304070,304070,304072,0,2,5
86774,1,1,304071,304072,304073,1,2,0
86775,6,3,304077,304077,304080,0,3,4
86776,4,2,304081,304081,304083,0,2,1
86777,1,1,304082,304083,304084,1,2,0
86778,1,1,304083,304084,304085,1,2,0
86779,4,3,304087,304087,304090,0,3,2
86780,4,1,304091,304091,304092,0,1,1
86781,2,1,304093,304093,304094,0,1,1
86782,4,2,304097,304097,304099,0,2,3
86783,1,1,304098,304099,304100,1,2,0
86784,4,3,304102,304102,304105,0,3,2
86785,3,1,304105,304105,304106,0,1,0
86786,1,3,304106,304106,304109,0,3,0
86787,3,3,304109,304109,304112,0,3,0
86788,1,3,304110,304112,304115,2,5,0
86789,4,1,304114,304115,304116,1,2,0
86790,2,1,304116,304116,304117,0,1,0
86791,4,3,304120,304120,304123,0,3,3
86792,2,3,304122,304123,304126,1,4,0
86793,4,2,304126,304126,304128,0,2,0
86794,4,1,304130,304130,304131,0,1,2
86795,5,2,304135,304135,304137,0,2,4
86796,3,1,304138,304138,304139,0,1,1
86797,3,3,304141,304141,304144,0,3,2
86798,5,3,304146,304146,304149,0,3,2
86799,6,2,304152,304152,304154,0,2,3
86800,2,1,304154,304154,304155,0,1,0
86801,6,3,304160,304160,304163,0,3,5
86802,6,3,304166,304166,304169,0,3,3
86803,6,3,304172,304172,304175,0,3,3
86804,2,2,304174,304175,304177,1,3,0
86805,4,3,304178,304178,304181,0,3,1
86806,1,2,304179,304181,304183,2,4,0
86807,4,2,304183,304183,304185,0,2,0
86808,3,1,304186,304186,304187,0,1,1
86809,6,2,304192,304192,304194,0,2,5
86810,4,1,304196,304196,304197,0,1,2
86811,2,3,304198,304198,304201,0,3,1
86812,3,3,304201,304201,304204,0,3,0
86813,3,2,304204,304204,304206,0,2,0
86814,2,1,304206,304206,304207,0,1,0
86815,2,3,304208,304208,304211,0,3,1
86816,3,1,304211,304211,304212,0,1,0
86817,5,1,304216,304216,304217,0,1,4
86818,6,3,304222,304222,304225,0,3,5
86819,3,1,304225,304225,304226,0,1,0
86820,2,2,304227,304227,304229,0,2,1
86821,1,2,304228,304229,304231,1,3,0
86822,4,3,304232,304232,304235,0,3,1
86823,1,3,304233,304235,304238,2,5,0
86824,1,1,304234,304238,304239,4,5,0
86825,3,3,304237,304239,304242,2,5,0
86826,6,3,304243,304243,304246,0,3,1
86827,2,1,304245,304246,304247,1,2,0
86828,1,2,304246,304247,304249,1,3,0
86829,5,3,304251,304251,304254,0,3,2
86830,5,3,304256,304256,304259,0,3,2
86831,4,1,304260,304260,304261,0,1,1
86832,2,3,304262,304262,304265,0,3,1
86833,4,1,304266,304266,304267,0,1,1
86834,2,2,304268,304268,304270,0,2,1
86835,1,2,304269,304270,304272,1,3,0
86836,5,1,304274,304274,304275,0,1,2
86837,1,1,304275,304275,304276,0,1,0
86838,1,2,304276,304276,304278,0,2,0
86839,4,2,304280,304280,304282,0,2,2
86840,1,1,304281,304282,304283,1,2,0
86841,6,2,304287,304287,304289,0,2,4
86842,4,1,304291,304291,304292,0,1,2
86843,5,1,304296,304296,304297,0,1,4
86844,1,1,304297,304297,304298,0,1,0
86845,5,3,304302,304302,304305,0,3,4
86846,3,1,304305,304305,304306,0,1,0
86847,4,1,304309,304309,304310,0,1,3
86848,2,2,304311,304311,304313,0,2,1
86849,2,2,304313,304313,304315,0,2,0
86850,2,1,304315,304315,304316,0,1,0
86851,2,3,304317,304317,304320,0,3,1
86852,5,2,304322,304322,304324,0,2,2
86853,3,2,304325,304325,304327,0,2,1
86854,1,1,304326,304327,304328,1,2,0
86855,6,1,304332,304332,304333,0,1,4
86856,4,1,304336,304336,304337,0,1,3
86857,5,2,304341,304341,304343,0,2,4
86858,1,2,304342,304343,304345,1,3,0
86859,6,3,304348,304348,304351,0,3,3
86860,2,3,304350,304351,304354,1,4,0
86861,5,2,304355,304355,304357,0,2,1
86862,1,3,304356,304357,304360,1,4,0
86863,2,1,304358,304360,304361,2,3,0
86864,6,3,304364,304364,304367,0,3,3
86865,1,2,304365,304367,304369,2,4,0
86866,2,3,304367,304369,304372,2,5,0
86867,4,3,304371,304372,304375,1,4,0
86868,1,1,304372,304375,304376,3,4,0
86869,5,3,304377,304377,304380,0,3,1
86870,1,1,304378,304380,304381,2,3,0
86871,3,2,304381,304381,304383,0,2,0
86872,2,1,304383,304383,304384,0,1,0
86873,6,3,304389,304389,304392,0,3,5
86874,3,3,304392,304392,304395,0,3,0
86875,4,3,304396,304396,304399,0,3,1
86876,1,2,304397,304399,304401,2,4,0
86877,1,2,304398,304401,304403,3,5,0
86878,1,3,304399,304403,304406,4,7,0
86879,2,1,304401,304406,304407,5,6,0
86880,6,3,304407,304407,304410,0,3,0
86881,5,1,304412,304412,304413,0,1,2
86882,6,3,304418,304418,304421,0,3,5
86883,6,3,304424,304424,304427,0,3,3
86884,1,1,304425,304427,304428,2,3,0
86885,3,2,304428,304428,304430,0,2,0
86886,1,2,304429,304430,304432,1,3,0
86887,2,3,304431,304432,304435,1,4,0
86888,6,1,304437,304437,304438,0,1,2
86889,3,3,304440,304440,304443,0,3,2
86890,1,3,304441,304443,304446,2,5,0
86891,5,3,304446,304446,304449,0,3,0
86892,6,1,304452,304452,304453,0,1,3
86893,5,2,304457,304457,304459,0,2,4
86894,6,3,304463,304463,304466,0,3,4
86895,1,2,304464,304466,304468,2,4,0
86896,6,2,304470,304470,304472,0,2,2
86897,4,3,304474,304474,304477,0,3,2
86898,1,2,304475,304477,304479,2,4,0
86899,2,3,304477,304479,304482,2,5,0
86900,5,3,304482,304482,304485,0,3,0
86901,4,3,304486,304486,304489,0,3,1
86902,1,1,304487,304489,304490,2,3,0
86903,2,3,304489,304490,304493,1,4,0
86904,1,3,304490,304493,304496,3,6,0
86905,2,3,304492,304496,304499,4,7,0
86906,3,3,304495,304499,304502,4,7,0
86907,2,2,304497,304502,304504,5,7,0
86908,5,1,304502,304504,304505,2,3,0
86909,1,3,304503,304505,304508,2,5,0
86910,5,2,304508,304508,304510,0,2,0
86911,2,1,304510,304510,304511,0,1,0
86912,6,3,304516,304516,304519,0,3,5
86913,1,1,304517,304519,304520,2,3,0
86914,5,2,304522,304522,304524,0,2,2
86915,3,1,304525,304525,304526,0,1,1
86916,5,2,304530,304530,304532,0,2,4
86917,6,2,304536,304536,304538,0,2,4
86918,1,1,304537,304538,304539,1,2,0
86919,1,3,304538,304539,304542,1,4,0
86920,2,1,304540,304542,304543,2,3,0
86921,5,1,304545,304545,304546,0,1,2
86922,4,3,304549,304549,304552,0,3,3
86923,2,3,304551,304552,304555,1,4,0
86924,5,1,304556,304556,304557,0,1,1
86925,3,1,304559,304559,304560,0,1,2
86926,6,2,304565,304565,304567,0,2,5
86927,2,1,304567,304567,304568,0,1,0
86928,2,3,304569,304569,304572,0,3,1
86929,5,3,304574,304574,304577,0,3,2
86930,3,3,304577,304577,304580,0,3,0
86931,1,2,304578,304580,304582,2,4,0
86932,2,1,304580,304582,304583,2,3,0
86933,4,2,304584,304584,304586,0,2,1
86934,1,1,304585,304586,304587,1,2,0
86935,3,1,304588,304588,304589,0,1,1
86936,2,1,304590,304590,304591,0,1,1
86937,2,3,304592,304592,304595,0,3,1
86938,6,1,304598,304598,304599,0,1,3
86939,5,1,304603,304603,304604,0,1,4
86940,5,1,304608,304608,304609,0,1,4
86941,1,2,304609,304609,304611,0,2,0
86942,1,3,304610,304611,304614,1,4,0
86943,6,3,304616,304616,304619,0,3,2
86944,1,1,304617,304619,304620,2,3,0
86945,5,3,304622,304622,304625,0,3,2
86946,1,1,304623,304625,304626,2,3,0
86947,3,1,304626,304626,304627,0,1,0
86948,6,1,304632,304632,304633,0,1,5
86949,6,3,304638,304638,304641,0,3,5
86950,6,1,304644,304644,304645,0,1,3
86951,2,3,304646,304646,304649,0,3,1
86952,5,3,304651,304651,304654,0,3,2
86953,5,2,304656,304656,304658,0,2,2
86954,3,3,304659,304659,304662,0,3,1
86955,6,2,304665,304665,304667,0,2,3
86956,5,3,304670,304670,304673,0,3,3
86957,5,1,304675,304675,304676,0,1,2
86958,3,3,304678,304678,304681,0,3,2
86959,1,3,304679,304681,304684,2,5,0
86960,1,1,304680,304684,304685,4,5,0
86961,6,3,304686,304686,304689,0,3,1
86962,1,1,304687,304689,304690,2,3,0
86963,5,1,304692,304692,304693,0,1,2
86964,6,2,304698,304698,304700,0,2,5
86965,4,1,304702,304702,304703,0,1,2
86966,5,3,304707,304707,304710,0,3,4
86967,2,2,304709,304710,304712,1,3,0
86968,4,3,304713,304713,304716,0,3,1
86969,2,2,304715,304716,304718,1,3,0
86970,1,1,304716,304718,304719,2,3,0
86971,5,2,304721,304721,304723,0,2,2
86972,1,2,304722,304723,304725,1,3,0
86973,4,2,304726,304726,304728,0,2,1
86974,4,1,304730,304730,304731,0,1,2
86975,5,1,304735,304735,304736,0,1,4
86976,6,3,304741,304741,304744,0,3,5
86977,3,3,304744,304744,304747,0,3,0
86978,2,1,304746,304747,304748,1,2,0
86979,2,2,304748,304748,304750,0,2,0
86980,2,3,304750,304750,304753,0,3,0
86981,5,3,304755,304755,304758,0,3,2
86982,3,1,304758,304758,304759,0,1,0
86983,2,3,304760,304760,304763,0,3,1
86984,1,1,304761,304763,304764,2,3,0
86985,1,2,304762,304764,304766,2,4,0
86986,4,3,304766,304766,304769,0,3,0
86987,4,2,304770,304770,304772,0,2,1
86988,2,1,304772,304772,304773,0,1,0
86989,6,1,304778,304778,304779,0,1,5
86990,4,3,304782,304782,304785,0,3,3
86991,1,3,304783,304785,304788,2,5,0
86992,4,2,304787,304788,304790,1,3,0
86993,1,2,304788,304790,304792,2,4,0
86994,4,1,304792,304792,304793,0,1,0
86995,5,3,304797,304797,304800,0,3,4
86996,2,2,304799,304800,304802,1,3,0
86997,3,1,304802,304802,304803,0,1,0
86998,2,3,304804,304804,304807,0,3,1
86999,6,3,304810,304810,304813,0,3,3
87000,3,3,304813,304813,304816,0,3,0
87001,5,3,304818,304818,304821,0,3,2
87002,1,1,304819,304821,304822,2,3,0
87003,6,2,304825,304825,304827,0,2,3
87004,5,2,304830,304830,304832,0,2,3
87005,2,1,304832,304832,304833,0,1,0
87006,6,3,304838,304838,304841,0,3,5
87007,4,1,304842,304842,304843,0,1,1
87008,3,2,304845,304845,304847,0,2,2
87009,1,2,304846,304847,304849,1,3,0
87010,1,2,304847,304849,304851,2,4,0
87011,4,3,304851,304851,304854,0,3,0
87012,6,3,304857,304857,304860,0,3,3
87013,6,2,304863,304863,304865,0,2,3
87014,1,2,304864,304865,304867,1,3,0
87015,6,3,304870,304870,304873,0,3,3
87016,3,3,304873,304873,304876,0,3,0
87017,2,3,304875,304876,304879,1,4,0
87018,1,3,304876,304879,304882,3,6,0
87019,2,1,304878,304882,304883,4,5,0
87020,6,2,304884,304884,304886,0,2,1
87021,5,2,304889,304889,304891,0,2,3
87022,1,2,304890,304891,304893,1,3,0
87023,1,2,304891,304893,304895,2,4,0
87024,6,2,304897,304897,304899,0,2,2
87025,1,2,304898,304899,304901,1,3,0
87026,6,3,304904,304904,304907,0,3,3
87027,5,3,304909,304909,304912,0,3,2
87028,5,1,304914,304914,304915,0,1,2
87029,1,2,304915,304915,304917,0,2,0
87030,1,3,304916,304917,304920,1,4,0
87031,6,1,304922,304922,304923,0,1,2
87032,3,3,304925,304925,304928,0,3,2
87033,1,2,304926,304928,304930,2,4,0
87034,1,2,304927,304930,304932,3,5,0
87035,5,1,304932,304932,304933,0,1,0
87036,1,1,304933,304933,304934,0,1,0
87037,4,3,304937,304937,304940,0,3,3
87038,5,3,304942,304942,304945,0,3,2
87039,3,2,304945,304945,304947,0,2,0
87040,6,2,304951,304951,304953,0,2,4
87041,1,1,304952,304953,304954,1,2,0
87042,1,3,304953,304954,304957,1,4,0
87043,5,1,304958,304958,304959,0,1,1
87044,1,1,304959,304959,304960,0,1,0
87045,3,3,304962,304962,304965,0,3,2
87046,4,2,304966,304966,304968,0,2,1
87047,3,2,304969,304969,304971,0,2,1
87048,4,1,304973,304973,304974,0,1,2
87049,2,2,304975,304975,304977,0,2,1
87050,1,1,304976,304977,304978,1,2,0
87051,3,2,304979,304979,304981,0,2,1
87052,6,1,304985,304985,304986,0,1,4
87053,1,2,304986,304986,304988,0,2,0
87054,2,2,304988,304988,304990,0,2,0
87055,3,3,304991,304991,304994,0,3,1
87056,6,2,304997,304997,304999,0,2,3
87057,4,3,305001,305001,305004,0,3,2
87058,1,2,305002,305004,305006,2,4,0
87059,6,1,305008,305008,305009,0,1,2
87060,3,2,305011,305011,305013,0,2,2
87061,4,2,305015,305015,305017,0,2,2
87062,4,1,305019,305019,305020,0,1,2
87063,3,1,305022,305022,305023,0,1,2
87064,1,3,305023,305023,305026,0,3,0
87065,6,2,305029,305029,305031,0,2,3
87066,1,2,305030,305031,305033,1,3,0
87067,2,1,305032,305033,305034,1,2,0
87068,2,2,305034,305034,305036,0,2,0
87069,1,2,305035,305036,305038,1,3,0
87070,2,2,305037,305038,305040,1,3,0
87071,6,2,305043,305043,305045,0,2,3
87072,4,2,305047,305047,305049,0,2,2
87073,5,3,305052,305052,305055,0,3,3
87074,2,3,305054,305055,305058,1,4,0
87075,5,1,305059,305059,305060,0,1,1
87076,6,2,305065,305065,305067,0,2,5
87077,3,2,305068,305068,305070,0,2,1
87078,6,2,305074,305074,305076,0,2,4
87079,6,1,305080,305080,305081,0,1,4
87080,6,1,305086,305086,305087,0,1,5
87081,3,2,305089,305089,305091,0,2,2
87082,2,1,305091,305091,305092,0,1,0
87083,4,1,305095,305095,305096,0,1,3
87084,5,1,305100,305100,305101,0,1,4
87085,6,2,305106,305106,305108,0,2,5
87086,2,2,305108,305108,305110,0,2,0
87087,3,3,305111,305111,305114,0,3,1
87088,2,1,305113,305114,305115,1,2,0
87089,5,1,305118,305118,305119,0,1,3
87090,2,2,305120,305120,305122,0,2,1
87091,2,1,305122,305122,305123,0,1,0
87092,4,1,305126,305126,305127,0,1,3
87093,5,1,305131,305131,305132,0,1,4
87094,4,1,305135,305135,305136,0,1,3
87095,2,3,305137,305137,305140,0,3,1
87096,3,3,305140,305140,305143,0,3,0
87097,4,1,305144,305144,305145,0,1,1
87098,1,1,305145,305145,305146,0,1,0
87099,3,1,305148,305148,305149,0,1,2
87100,4,2,305152,305152,305154,0,2,3
87101,5,1,305157,305157,305158,0,1,3
87102,5,2,305162,305162,305164,0,2,4
87103,1,3,305163,305164,305167,1,4,0
87104,3,3,305166,305167,305170,1,4,0
87105,6,3,305172,305172,305175,0,3,2
87106,4,2,305176,305176,305178,0,2,1
87107,4,3,305180,305180,305183,0,3,2
87108,5,3,305185,305185,305188,0,3,2
87109,5,1,305190,305190,305191,0,1,2
87110,4,1,305194,305194,305195,0,1,3
87111,6,2,305200,305200,305202,0,2,5
87112,3,1,305203,305203,305204,0,1,1
87113,6,2,305209,305209,305211,0,2,5
87114,5,2,305214,305214,305216,0,2,3
87115,4,2,305218,305218,305220,0,2,2
87116,2,2,305220,305220,305222,0,2,0
87117,6,1,305226,305226,305227,0,1,4
87118,6,1,305232,305232,305233,0,1,5
87119,6,1,305238,305238,305239,0,1,5
87120,3,1,305241,305241,305242,0,1,2
87121,5,1,305246,305246,305247,0,1,4
87122,3,1,305249,305249,305250,0,1,2
87123,1,2,305250,305250,305252,0,2,0
87124,3,3,305253,305253,305256,0,3,1
87125,1,1,305254,305256,305257,2,3,0
87126,2,3,305256,305257,305260,1,4,0
87127,6,1,305262,305262,305263,0,1,2
87128,6,2,305268,305268,305270,0,2,5
87129,2,3,305270,305270,305273,0,3,0
87130,6,1,305276,305276,305277,0,1,3
87131,1,2,305277,305277,305279,0,2,0
87132,2,1,305279,305279,305280,0,1,0
87133,1,3,305280,305280,305283,0,3,0
87134,5,3,305285,305285,305288,0,3,2
87135,2,3,305287,305288,305291,1,4,0
87136,5,3,305292,305292,305295,0,3,1
87137,4,3,305296,305296,305299,0,3,1
87138,2,1,305298,305299,305300,1,2,0
87139,2,1,305300,305300,305301,0,1,0
87140,1,1,305301,305301,305302,0,1,0
87141,5,1,305306,305306,305307,0,1,4
87142,3,2,305309,305309,305311,0,2,2
87143,6,3,305315,305315,305318,0,3,4
87144,1,2,305316,305318,305320,2,4,0
87145,5,3,305321,305321,305324,0,3,1
87146,1,1,305322,305324,305325,2,3,0
87147,5,2,305327,305327,305329,0,2,2
87148,2,3,305329,305329,305332,0,3,0
87149,1,3,305330,305332,305335,2,5,0
87150,3,2,305333,305335,305337,2,4,0
87151,1,3,305334,305337,305340,3,6,0
87152,4,3,305338,305340,305343,2,5,0
87153,1,3,305339,305343,305346,4,7,0
87154,1,2,305340,305346,305348,6,8,0
87155,4,2,305344,305348,305350,4,6,0
87156,5,3,305349,305350,305353,1,4,0
87157,2,1,305351,305353,305354,2,3,0
87158,3,1,305354,305354,305355,0,1,0
87159,5,2,305359,305359,305361,0,2,4
87160,4,1,305363,305363,305364,0,1,2
87161,5,2,305368,305368,305370,0,2,4
87162,6,3,305374,305374,305377,0,3,4
87163,5,1,305379,305379,305380,0,1,2
87164,2,3,305381,305381,305384,0,3,1
87165,4,1,305385,305385,305386,0,1,1
87166,5,2,305390,305390,305392,0,2,4
87167,3,3,305393,305393,305396,0,3,1
87168,2,1,305395,305396,305397,1,2,0
87169,2,3,305397,305397,305400,0,3,0
87170,6,3,305403,305403,305406,0,3,3
87171,4,2,305407,305407,305409,0,2,1
87172,1,3,305408,305409,305412,1,4,0
87173,3,1,305411,305412,305413,1,2,0
87174,2,2,305413,305413,305415,0,2,0
87175,4,2,305417,305417,305419,0,2,2
87176,4,3,305421,305421,305424,0,3,2
87177,6,1,305427,305427,305428,0,1,3
87178,4,1,305431,305431,305432,0,1,3
87179,3,3,305434,305434,305437,0,3,2
87180,3,1,305437,305437,305438,0,1,0
87181,3,2,305440,305440,305442,0,2,2
87182,3,1,305443,305443,305444,0,1,1
87183,5,2,305448,305448,305450,0,2,4
87184,2,1,305450,305450,305451,0,1,0
87185,1,2,305451,305451,305453,0,2,0
87186,5,1,305456,305456,305457,0,1,3
87187,4,1,305460,305460,305461,0,1,3
87188,6,3,305466,305466,305469,0,3,5
87189,4,2,305470,305470,305472,0,2,1
87190,3,2,305473,305473,305475,0,2,1
87191,3,2,305476,305476,305478,0,2,1
87192,6,3,305482,305482,305485,0,3,4
87193,1,3,305483,305485,305488,2,5,0
87194,5,3,305488,305488,305491,0,3,0
87195,4,3,305492,305492,305495,0,3,1
87196,6,3,305498,305498,305501,0,3,3
87197,6,3,305504,305504,305507,0,3,3
87198,2,1,305506,305507,305508,1,2,0
87199,2,3,305508,305508,305511,0,3,0
87200,6,2,305514,305514,305516,0,2,3
87201,1,3,305515,305516,305519,1,4,0
87202,3,1,305518,305519,305520,1,2,0
87203,2,2,305520,305520,305522,0,2,0
87204,5,1,305525,305525,305526,0,1,3
87205,1,1,305526,305526,305527,0,1,0
87206,4,2,305530,305530,305532,0,2,3
87207,5,1,305535,305535,305536,0,1,3
87208,2,2,305537,305537,305539,0,2,1
87209,2,3,305539,305539,305542,0,3,0
87210,6,2,305545,305545,305547,0,2,3
87211,3,1,305548,305548,305549,0,1,1
87212,6,3,305554,305554,305557,0,3,5
87213,4,1,305558,305558,305559,0,1,1
87214,4,2,305562,305562,305564,0,2,3
87215,4,3,305566,305566,305569,0,3,2
87216,4,3,305570,305570,305573,0,3,1
87217,6,2,305576,305576,305578,0,2,3
87218,6,1,305582,305582,305583,0,1,4
87219,6,1,305588,305588,305589,0,1,5
87220,3,2,305591,305591,305593,0,2,2
87221,1,3,305592,305593,305596,1,4,0
87222,6,1,305598,305598,305599,0,1,2
87223,3,2,305601,305601,305603,0,2,2
87224,4,3,305605,305605,305608,0,3,2
87225,1,2,305606,305608,305610,2,4,0
87226,3,2,305609,305610,305612,1,3,0
87227,5,1,305614,305614,305615,0,1,2
87228,2,2,305616,305616,305618,0,2,1
87229,1,2,305617,305618,305620,1,3,0
87230,5,2,305622,305622,305624,0,2,2
87231,1,3,305623,305624,305627,1,4,0
87232,5,2,305628,305628,305630,0,2,1
87233,5,1,305633,305633,305634,0,1,3
87234,4,3,305637,305637,305640,0,3,3
87235,1,1,305638,305640,305641,2,3,0
87236,2,2,305640,305641,305643,1,3,0
87237,6,1,305646,305646,305647,0,1,3
87238,1,1,305647,305647,305648,0,1,0
87239,4,1,305651,305651,305652,0,1,3
87240,3,3,305654,305654,305657,0,3,2
87241,5,3,305659,305659,305662,0,3,2
87242,2,3,305661,305662,305665,1,4,0
87243,5,3,305666,305666,305669,0,3,1
87244,6,2,305672,305672,305674,0,2,3
87245,4,3,305676,305676,305679,0,3,2
87246,1,1,305677,305679,305680,2,3,0
87247,6,3,305683,305683,305686,0,3,3
87248,1,1,305684,305686,305687,2,3,0
87249,3,3,305687,305687,305690,0,3,0
87250,1,3,305688,305690,305693,2,5,0
87251,2,2,305690,305693,305695,3,5,0
87252,4,2,305694,305695,305697,1,3,0
87253,3,1,305697,305697,305698,0,1,0
87254,1,2,305698,305698,305700,0,2,0
87255,1,3,305699,305700,305703,1,4,0
87256,1,2,305700,305703,305705,3,5,0
87257,5,3,305705,305705,305708,0,3,0
87258,3,3,305708,305708,305711,0,3,0
87259,1,1,305709,305711,305712,2,3,0
87260,3,1,305712,305712,305713,0,1,0
87261,1,3,305713,305713,305716,0,3,0
87262,2,3,305715,305716,305719,1,4,0
87263,5,3,305720,305720,305723,0,3,1
87264,4,1,305724,305724,305725,0,1,1
87265,2,3,305726,305726,305729,0,3,1
87266,4,3,305730,305730,305733,0,3,1
87267,4,1,305734,305734,305735,0,1,1
87268,3,2,305737,305737,305739,0,2,2
87269,2,2,305739,305739,305741,0,2,0
87270,2,3,305741,305741,305744,0,3,0
87271,1,2,305742,305744,305746,2,4,0
87272,1,2,305743,305746,305748,3,5,0
87273,4,2,305747,305748,305750,1,3,0
87274,2,1,305749,305750,305751,1,2,0
87275,2,3,305751,305751,305754,0,3,0
87276,2,1,305753,305754,305755,1,2,0
87277,2,3,305755,305755,305758,0,3,0
87278,5,2,305760,305760,305762,0,2,2
87279,1,3,305761,305762,305765,1,4,0
87280,5,3,305766,305766,305769,0,3,1
87281,2,1,305768,305769,305770,1,2,0
87282,6,2,305774,305774,305776,0,2,4
87283,5,1,305779,305779,305780,0,1,3
87284,4,3,305783,305783,305786,0,3,3
87285,1,3,305784,305786,305789,2,5,0
87286,4,1,305788,305789,305790,1,2,0
87287,6,1,305794,305794,305795,0,1,4
87288,4,3,305798,305798,305801,0,3,3
87289,4,3,305802,305802,305805,0,3,1
87290,2,1,305804,305805,305806,1,2,0
87291,5,3,305809,305809,305812,0,3,3
87292,2,3,305811,305812,305815,1,4,0
87293,4,3,305815,305815,305818,0,3,0
87294,3,1,305818,305818,305819,0,1,0
87295,2,3,305820,305820,305823,0,3,1
87296,5,2,305825,305825,305827,0,2,2
87297,2,2,305827,305827,305829,0,2,0
87298,2,1,305829,305829,305830,0,1,0
87299,2,2,305831,305831,305833,0,2,1
87300,6,2,305837,305837,305839,0,2,4
87301,1,1,305838,305839,305840,1,2,0
87302,3,1,305841,305841,305842,0,1,1
87303,6,2,305847,305847,305849,0,2,5
87304,4,2,305851,305851,305853,0,2,2
87305,2,1,305853,305853,305854,0,1,0
87306,2,1,305855,305855,305856,0,1,1
87307,4,1,305859,305859,305860,0,1,3
87308,5,1,305864,305864,305865,0,1,4
87309,6,2,305870,305870,305872,0,2,5
87310,1,1,305871,305872,305873,1,2,0
87311,1,2,305872,305873,305875,1,3,0
87312,5,1,305877,305877,305878,0,1,2
87313,2,3,305879,305879,305882,0,3,1
87314,1,1,305880,305882,305883,2,3,0
87315,5,3,305885,305885,305888,0,3,2
87316,5,3,305890,305890,305893,0,3,2
87317,2,2,305892,305893,305895,1,3,0
87318,2,1,305894,305895,305896,1,2,0
87319,6,2,305900,305900,305902,0,2,4
87320,2,3,305902,305902,305905,0,3,0
87321,6,1,305908,305908,305909,0,1,3
87322,5,2,305913,305913,305915,0,2,4
87323,1,1,305914,305915,305916,1,2,0
87324,3,3,305917,305917,305920,0,3,1
87325,5,2,305922,305922,305924,0,2,2
87326,2,1,305924,305924,305925,0,1,0
87327,5,1,305929,305929,305930,0,1,4
87328,1,3,305930,305930,305933,0,3,0
87329,3,3,305933,305933,305936,0,3,0
87330,4,1,305937,305937,305938,0,1,1
87331,1,3,305938,305938,305941,0,3,0
87332,2,1,305940,305941,305942,1,2,0
87333,5,3,305945,305945,305948,0,3,3
87334,6,2,305951,305951,305953,0,2,3
87335,6,3,305957,305957,305960,0,3,4
87336,3,3,305960,305960,305963,0,3,0
87337,3,2,305963,305963,305965,0,2,0
87338,2,3,305965,305965,305968,0,3,0
87339,1,3,305966,305968,305971,2,5,0
87340,3,1,305969,305971,305972,2,3,0
87341,5,1,305974,305974,305975,0,1,2
87342,5,3,305979,305979,305982,0,3,4
87343,4,2,305983,305983,305985,0,2,1
87344,5,1,305988,305988,305989,0,1,3
87345,5,2,305993,305993,305995,0,2,4
87346,5,1,305998,305998,305999,0,1,3
87347,5,2,306003,306003,306005,0,2,4
87348,1,2,306004,306005,306007,1,3,0
87349,6,2,306010,306010,306012,0,2,3
87350,3,1,306013,306013,306014,0,1,1
87351,3,1,306016,306016,306017,0,1,2
87352,1,3,306017,306017,306020,0,3,0
87353,3,3,306020,306020,306023,0,3,0
87354,4,3,306024,306024,306027,0,3,1
87355,5,3,306029,306029,306032,0,3,2
87356,4,1,306033,306033,306034,0,1,1
87357,3,1,306036,306036,306037,0,1,2
87358,4,3,306040,306040,306043,0,3,3
87359,4,1,306044,306044,306045,0,1,1
87360,1,3,306045,306045,306048,0,3,0
87361,2,1,306047,306048,306049,1,2,0
87362,4,1,306051,306051,306052,0,1,2
87363,6,1,306057,306057,306058,0,1,5
87364,1,3,306058,306058,306061,0,3,0
87365,6,1,306064,306064,306065,0,1,3
87366,3,2,306067,306067,306069,0,2,2
87367,4,3,306071,306071,306074,0,3,2
87368,3,1,306074,306074,306075,0,1,0
87369,1,1,306075,306075,306076,0,1,0
87370,2,3,306077,306077,306080,0,3,1
87371,5,2,306082,306082,306084,0,2,2
87372,5,1,306087,306087,306088,0,1,3
87373,3,2,306090,306090,306092,0,2,2
87374,1,2,306091,306092,306094,1,3,0
87375,4,2,306095,306095,306097,0,2,1
87376,5,3,306100,306100,306103,0,3,3
87377,3,2,306103,306103,306105,0,2,0
87378,5,3,306108,306108,306111,0,3,3
87379,4,1,306112,306112,306113,0,1,1
87380,3,2,306115,306115,306117,0,2,2
87381,2,1,306117,306117,306118,0,1,0
87382,6,1,306123,306123,306124,0,1,5
87383,5,1,306128,306128,306129,0,1,4
87384,2,1,306130,306130,306131,0,1,1
87385,1,1,306131,306131,306132,0,1,0
87386,3,3,306134,306134,306137,0,3,2
87387,3,2,306137,306137,306139,0,2,0
87388,3,1,306140,306140,306141,0,1,1
87389,2,3,306142,306142,306145,0,3,1
87390,3,3,306145,306145,306148,0,3,0
87391,5,1,306150,306150,306151,0,1,2
87392,3,3,306153,306153,306156,0,3,2
87393,6,1,306159,306159,306160,0,1,3
87394,6,3,306165,306165,306168,0,3,5
87395,1,2,306166,306168,306170,2,4,0
87396,6,1,306172,306172,306173,0,1,2
87397,6,3,306178,306178,306181,0,3,5
87398,3,1,306181,306181,306182,0,1,0
87399,4,3,306185,306185,306188,0,3,3
87400,4,2,306189,306189,306191,0,2,1
87401,2,3,306191,306191,306194,0,3,0
87402,6,3,306197,306197,306200,0,3,3
87403,2,2,306199,306200,306202,1,3,0
87404,5,2,306204,306204,306206,0,2,2
87405,5,2,306209,306209,306211,0,2,3
87406,2,1,306211,306211,306212,0,1,0
87407,4,2,306215,306215,306217,0,2,3
87408,4,2,306219,306219,306221,0,2,2
87409,4,1,306223,306223,306224,0,1,2
87410,1,3,306224,306224,306227,0,3,0
87411,2,3,306226,306227,306230,1,4,0
87412,6,1,306232,306232,306233,0,1,2
87413,1,3,306233,306233,306236,0,3,0
87414,3,3,306236,306236,306239,0,3,0
87415,1,3,306237,306239,306242,2,5,0
87416,1,3,306238,306242,306245,4,7,0
87417,5,1,306243,306245,306246,2,3,0
87418,2,2,306245,306246,306248,1,3,0
87419,1,1,306246,306248,306249,2,3,0
87420,3,3,306249,306249,306252,0,3,0
87421,6,1,306255,306255,306256,0,1,3
87422,1,1,306256,306256,306257,0,1,0
87423,3,3,306259,306259,306262,0,3,2
87424,6,3,306265,306265,306268,0,3,3
87425,3,1,306268,306268,306269,0,1,0
87426,2,3,306270,306270,306273,0,3,1
87427,2,2,306272,306273,306275,1,3,0
87428,4,2,306276,306276,306278,0,2,1
87429,5,2,306281,306281,306283,0,2,3
87430,4,3,306285,306285,306288,0,3,2
87431,4,2,306289,306289,306291,0,2,1
87432,6,1,306295,306295,306296,0,1,4
87433,5,3,306300,306300,306303,0,3,4
87434,4,1,306304,306304,306305,0,1,1
87435,6,3,306310,306310,306313,0,3,5
87436,1,2,306311,306313,306315,2,4,0
87437,5,2,306316,306316,306318,0,2,1
87438,2,3,306318,306318,306321,0,3,0
87439,5,2,306323,306323,306325,0,2,2
87440,2,2,306325,306325,306327,0,2,0
87441,1,1,306326,306327,306328,1,2,0
87442,4,2,306330,306330,306332,0,2,2
87443,1,2,306331,306332,306334,1,3,0
87444,1,1,306332,306334,306335,2,3,0
87445,4,2,306336,306336,306338,0,2,1
87446,4,3,306340,306340,306343,0,3,2
87447,4,1,306344,306344,306345,0,1,1
87448,1,2,306345,306345,306347,0,2,0
87449,5,3,306350,306350,306353,0,3,3
87450,6,1,306356,306356,306357,0,1,3
87451,4,1,306360,306360,306361,0,1,3
87452,2,2,306362,306362,306364,0,2,1
87453,1,1,306363,306364,306365,1,2,0
87454,3,2,306366,306366,306368,0,2,1
87455,3,2,306369,306369,306371,0,2,1
87456,1,3,306370,306371,306374,1,4,0
87457,5,3,306375,306375,306378,0,3,1
87458,1,2,306376,306378,306380,2,4,0
87459,3,2,306379,306380,306382,1,3,0
87460,2,1,306381,306382,306383,1,2,0
87461,5,2,306386,306386,306388,0,2,3
87462,5,1,306391,306391,306392,0,1,3
87463,6,3,306397,306397,306400,0,3,5
87464,3,3,306400,306400,306403,0,3,0
87465,3,3,306403,306403,306406,0,3,0
87466,2,2,306405,306406,306408,1,3,0
87467,4,2,306409,306409,306411,0,2,1
87468,4,3,306413,306413,306416,0,3,2
87469,6,3,306419,306419,306422,0,3,3
87470,3,3,306422,306422,306425,0,3,0
87471,1,2,306423,306425,306427,2,4,0
87472,2,2,306425,306427,306429,2,4,0
87473,6,3,306431,306431,306434,0,3,2
87474,1,1,306432,306434,306435,2,3,0
87475,2,1,306434,306435,306436,1,2,0
87476,1,1,306435,306436,306437,1,2,0
87477,1,1,306436,306437,306438,1,2,0
87478,1,2,306437,306438,306440,1,3,0
87479,5,2,306442,306442,306444,0,2,2
87480,2,1,306444,306444,306445,0,1,0
87481,1,1,306445,306445,306446,0,1,0
87482,2,1,306447,306447,306448,0,1,1
87483,1,3,306448,306448,306451,0,3,0
87484,2,1,306450,306451,306452,1,2,0
87485,4,1,306454,306454,306455,0,1,2
87486,5,3,306459,306459,306462,0,3,4
87487,3,3,306462,306462,306465,0,3,0
87488,2,3,306464,306465,306468,1,4,0
87489,6,3,306470,306470,306473,0,3,2
87490,2,1,306472,306473,306474,1,2,0
87491,5,3,306477,306477,306480,0,3,3
87492,5,3,306482,306482,306485,0,3,2
87493,3,1,306485,306485,306486,0,1,0
87494,4,2,306489,306489,306491,0,2,3
87495,3,3,306492,306492,306495,0,3,1
87496,5,3,306497,306497,306500,0,3,2
87497,5,1,306502,306502,306503,0,1,2
87498,1,1,306503,306503,306504,0,1,0
87499,3,3,306506,306506,306509,0,3,2
87500,5,2,306511,306511,306513,0,2,2
87501,6,2,306517,306517,306519,0,2,4
87502,1,3,306518,306519,306522,1,4,0
87503,1,3,306519,306522,306525,3,6,0
87504,4,3,306523,306525,306528,2,5,0
87505,3,1,306526,306528,306529,2,3,0
87506,4,3,306530,306530,306533,0,3,1
87507,4,3,306534,306534,306537,0,3,1
87508,2,1,306536,306537,306538,1,2,0
87509,6,1,306542,306542,306543,0,1,4
87510,4,3,306546,306546,306549,0,3,3
87511,4,2,306550,306550,306552,0,2,1
87512,6,2,306556,306556,306558,0,2,4
87513,5,3,306561,306561,306564,0,3,3
87514,1,1,306562,306564,306565,2,3,0
87515,1,2,306563,306565,306567,2,4,0
87516,2,2,306565,306567,306569,2,4,0
87517,5,2,306570,306570,306572,0,2,1
87518,1,1,306571,306572,306573,1,2,0
87519,5,1,306576,306576,306577,0,1,3
87520,1,1,306577,306577,306578,0,1,0
87521,2,2,306579,306579,306581,0,2,1
87522,1,1,306580,306581,306582,1,2,0
87523,4,1,306584,306584,306585,0,1,2
87524,2,3,306586,306586,306589,0,3,1
87525,3,2,306589,306589,306591,0,2,0
87526,6,1,306595,306595,306596,0,1,4
87527,2,3,306597,306597,306600,0,3,1
87528,5,3,306602,306602,306605,0,3,2
87529,3,1,306605,306605,306606,0,1,0
87530,3,3,306608,306608,306611,0,3,2
87531,6,2,306614,306614,306616,0,2,3
87532,6,3,306620,306620,306623,0,3,4
87533,2,1,306622,306623,306624,1,2,0
87534,2,2,306624,306624,306626,0,2,0
87535,1,3,306625,306626,306629,1,4,0
87536,3,2,306628,306629,306631,1,3,0
87537,2,3,306630,306631,306634,1,4,0
87538,4,3,306634,306634,306637,0,3,0
87539,1,3,306635,306637,306640,2,5,0
87540,2,3,306637,306640,306643,3,6,0
87541,4,1,306641,306643,306644,2,3,0
87542,6,3,306647,306647,306650,0,3,3
87543,6,2,306653,306653,306655,0,2,3
87544,6,1,306659,306659,306660,0,1,4
87545,5,2,306664,306664,306666,0,2,4
87546,5,3,306669,306669,306672,0,3,3
87547,3,2,306672,306672,306674,0,2,0
87548,3,3,306675,306675,306678,0,3,1
87549,2,3,306677,306678,306681,1,4,0
87550,1,3,306678,306681,306684,3,6,0
87551,3,1,306681,306684,306685,3,4,0
87552,3,2,306684,306685,306687,1,3,0
87553,3,3,306687,306687,306690,0,3,0
87554,6,1,306693,306693,306694,0,1,3
87555,4,3,306697,306697,306700,0,3,3
87556,1,2,306698,306700,306702,2,4,0
87557,1,2,306699,306702,306704,3,5,0
87558,2,3,306701,306704,306707,3,6,0
87559,6,1,306707,306707,306708,0,1,0
87560,2,1,306709,306709,306710,0,1,1
87561,3,3,306712,306712,306715,0,3,2
87562,4,1,306716,306716,306717,0,1,1
87563,6,1,306722,306722,306723,0,1,5
87564,4,2,306726,306726,306728,0,2,3
87565,2,2,306728,306728,306730,0,2,0
87566,6,3,306734,306734,306737,0,3,4
87567,3,2,306737,306737,306739,0,2,0
87568,5,2,306742,306742,306744,0,2,3
87569,1,1,306743,306744,306745,1,2,0
87570,3,1,306746,306746,306747,0,1,1
87571,4,2,306750,306750,306752,0,2,3
87572,1,1,306751,306752,306753,1,2,0
87573,4,2,306755,306755,306757,0,2,2
87574,2,2,306757,306757,306759,0,2,0
87575,1,1,306758,306759,306760,1,2,0
87576,2,1,306760,306760,306761,0,1,0
87577,1,1,306761,306761,306762,0,1,0
87578,1,3,306762,306762,306765,0,3,0
87579,1,3,306763,306765,306768,2,5,0
87580,1,3,306764,306768,306771,4,7,0
87581,1,2,306765,306771,306773,6,8,0
87582,4,2,306769,306773,306775,4,6,0
87583,5,2,306774,306775,306777,1,3,0
87584,5,3,306779,306779,306782,0,3,2
87585,6,1,306785,306785,306786,0,1,3
87586,5,3,306790,306790,306793,0,3,4
87587,5,2,306795,306795,306797,0,2,2
87588,5,2,306800,306800,306802,0,2,3
87589,5,2,306805,306805,306807,0,2,3
87590,3,3,306808,306808,306811,0,3,1
87591,6,3,306814,306814,306817,0,3,3
87592,2,2,306816,306817,306819,1,3,0
87593,2,3,306818,306819,306822,1,4,0
87594,6,1,306824,306824,306825,0,1,2
87595,2,1,306826,306826,306827,0,1,1
87596,1,2,306827,306827,306829,0,2,0
87597,6,3,306833,306833,306836,0,3,4
87598,5,2,306838,306838,306840,0,2,2
87599,6,2,306844,306844,306846,0,2,4
87600,2,2,306846,306846,306848,0,2,0
87601,5,3,306851,306851,306854,0,3,3
87602,5,2,306856,306856,306858,0,2,2
87603,3,2,306859,306859,306861,0,2,1
87604,5,2,306864,306864,306866,0,2,3
87605,3,2,306867,306867,306869,0,2,1
87606,5,2,306872,306872,306874,0,2,3
87607,6,1,306878,306878,306879,0,1,4
87608,1,3,306879,306879,306882,0,3,0
87609,6,1,306885,306885,306886,0,1,3
87610,4,3,306889,306889,306892,0,3,3
87611,3,1,306892,306892,306893,0,1,0
87612,6,1,306898,306898,306899,0,1,5
87613,2,3,306900,306900,306903,0,3,1
87614,1,3,306901,306903,306906,2,5,0
87615,1,3,306902,306906,306909,4,7,0
87616,3,1,306905,306909,306910,4,5,0
87617,1,3,306906,306910,306913,4,7,0
87618,4,2,306910,306913,306915,3,5,0
87619,1,3,306911,306915,306918,4,7,0
87620,4,3,306915,306918,306921,3,6,0
87621,3,3,306918,306921,306924,3,6,0
87622,2,1,306920,306924,306925,4,5,0
87623,4,3,306924,306925,306928,1,4,0
87624,2,1,306926,306928,306929,2,3,0
87625,2,3,306928,306929,306932,1,4,0
87626,5,2,306933,306933,306935,0,2,1
87627,6,2,306939,306939,306941,0,2,4
87628,3,3,306942,306942,306945,0,3,1
87629,5,2,306947,306947,306949,0,2,2
87630,3,1,306950,306950,306951,0,1,1
87631,4,2,306954,306954,306956,0,2,3
87632,5,1,306959,306959,306960,0,1,3
87633,2,2,306961,306961,306963,0,2,1
87634,2,2,306963,306963,306965,0,2,0
87635,6,3,306969,306969,306972,0,3,4
87636,1,2,306970,306972,306974,2,4,0
87637,4,3,306974,306974,306977,0,3,0
87638,6,2,306980,306980,306982,0,2,3
87639,4,3,306984,306984,306987,0,3,2
87640,6,3,306990,306990,306993,0,3,3
87641,6,3,306996,306996,306999,0,3,3
87642,3,3,306999,306999,307002,0,3,0
87643,2,2,307001,307002,307004,1,3,0
87644,5,3,307006,307006,307009,0,3,2
87645,6,2,307012,307012,307014,0,2,3
87646,3,2,307015,307015,307017,0,2,1
87647,6,2,307021,307021,307023,0,2,4
87648,1,2,307022,307023,307025,1,3,0
87649,1,1,307023,307025,307026,2,3,0
87650,5,2,307028,307028,307030,0,2,2
87651,3,1,307031,307031,307032,0,1,1
87652,4,1,307035,307035,307036,0,1,3
87653,5,1,307040,307040,307041,0,1,4
87654,3,3,307043,307043,307046,0,3,2
87655,6,1,307049,307049,307050,0,1,3
87656,3,1,307052,307052,307053,0,1,2
87657,5,1,307057,307057,307058,0,1,4
87658,5,2,307062,307062,307064,0,2,4
87659,3,1,307065,307065,307066,0,1,1
87660,6,3,307071,307071,307074,0,3,5
87661,3,1,307074,307074,307075,0,1,0
87662,2,2,307076,307076,307078,0,2,1
87663,3,3,307079,307079,307082,0,3,1
87664,5,2,307084,307084,307086,0,2,2
87665,1,1,307085,307086,307087,1,2,0
87666,5,3,307090,307090,307093,0,3,3
87667,2,2,307092,307093,307095,1,3,0
87668,5,2,307097,307097,307099,0,2,2
87669,6,1,307103,307103,307104,0,1,4
87670,3,3,307106,307106,307109,0,3,2
87671,5,2,307111,307111,307113,0,2,2
87672,4,3,307115,307115,307118,0,3,2
87673,4,2,307119,307119,307121,0,2,1
87674,3,1,307122,307122,307123,0,1,1
87675,1,1,307123,307123,307124,0,1,0
87676,6,2,307129,307129,307131,0,2,5
87677,4,1,307133,307133,307134,0,1,2
87678,3,1,307136,307136,307137,0,1,2
87679,3,3,307139,307139,307142,0,3,2
87680,5,1,307144,307144,307145,0,1,2
87681,2,2,307146,307146,307148,0,2,1
87682,6,3,307152,307152,307155,0,3,4
87683,1,1,307153,307155,307156,2,3,0
87684,2,3,307155,307156,307159,1,4,0
87685,6,2,307161,307161,307163,0,2,2
87686,1,3,307162,307163,307166,1,4,0
87687,5,3,307167,307167,307170,0,3,1
87688,3,1,307170,307170,307171,0,1,0
87689,1,1,307171,307171,307172,0,1,0
87690,6,2,307177,307177,307179,0,2,5
87691,1,1,307178,307179,307180,1,2,0
87692,2,1,307180,307180,307181,0,1,0
87693,3,3,307183,307183,307186,0,3,2
87694,6,1,307189,307189,307190,0,1,3
87695,1,1,307190,307190,307191,0,1,0
87696,6,2,307196,307196,307198,0,2,5
87697,1,2,307197,307198,307200,1,3,0
87698,6,2,307203,307203,307205,0,2,3
87699,2,2,307205,307205,307207,0,2,0
87700,5,3,307210,307210,307213,0,3,3
87701,6,1,307216,307216,307217,0,1,3
87702,3,1,307219,307219,307220,0,1,2
87703,4,1,307223,307223,307224,0,1,3
87704,5,3,307228,307228,307231,0,3,4
87705,1,1,307229,307231,307232,2,3,0
87706,3,2,307232,307232,307234,0,2,0
87707,5,1,307237,307237,307238,0,1,3
87708,3,2,307240,307240,307242,0,2,2
87709,3,1,307243,307243,307244,0,1,1
87710,6,1,307249,307249,307250,0,1,5
87711,1,1,307250,307250,307251,0,1,0
87712,3,3,307253,307253,307256,0,3,2
87713,6,1,307259,307259,307260,0,1,3
87714,5,1,307264,307264,307265,0,1,4
87715,6,1,307270,307270,307271,0,1,5
87716,3,2,307273,307273,307275,0,2,2
87717,4,2,307277,307277,307279,0,2,2
87718,4,3,307281,307281,307284,0,3,2
87719,6,1,307287,307287,307288,0,1,3
87720,4,3,307291,307291,307294,0,3,3
87721,1,3,307292,307294,307297,2,5,0
87722,6,3,307298,307298,307301,0,3,1
87723,2,2,307300,307301,307303,1,3,0
87724,3,1,307303,307303,307304,0,1,0
87725,2,2,307305,307305,307307,0,2,1
87726,2,1,307307,307307,307308,0,1,0
87727,3,2,307310,307310,307312,0,2,2
87728,5,2,307315,307315,307317,0,2,3
87729,1,1,307316,307317,307318,1,2,0
87730,1,3,307317,307318,307321,1,4,0
87731,4,2,307321,307321,307323,0,2,0
87732,5,3,307326,307326,307329,0,3,3
87733,3,3,307329,307329,307332,0,3,0
87734,4,1,307333,307333,307334,0,1,1
87735,2,1,307335,307335,307336,0,1,1
87736,4,2,307339,307339,307341,0,2,3
87737,1,3,307340,307341,307344,1,4,0
87738,1,2,307341,307344,307346,3,5,0
87739,5,3,307346,307346,307349,0,3,0
87740,2,1,307348,307349,307350,1,2,0
87741,4,1,307352,307352,307353,0,1,2
87742,1,2,307353,307353,307355,0,2,0
87743,5,1,307358,307358,307359,0,1,3
87744,2,2,307360,307360,307362,0,2,1
87745,2,3,307362,307362,307365,0,3,0
87746,6,3,307368,307368,307371,0,3,3
87747,1,3,307369,307371,307374,2,5,0
87748,3,3,307372,307374,307377,2,5,0
87749,2,1,307374,307377,307378,3,4,0
87750,4,2,307378,307378,307380,0,2,0
87751,2,2,307380,307380,307382,0,2,0
87752,5,2,307385,307385,307387,0,2,3
87753,4,1,307389,307389,307390,0,1,2
87754,5,1,307394,307394,307395,0,1,4
87755,2,2,307396,307396,307398,0,2,1
87756,2,1,307398,307398,307399,0,1,0
87757,6,1,307404,307404,307405,0,1,5
87758,6,2,307410,307410,307412,0,2,5
87759,3,2,307413,307413,307415,0,2,1
87760,6,2,307419,307419,307421,0,2,4
87761,4,2,307423,307423,307425,0,2,2
87762,4,1,307427,307427,307428,0,1,2
87763,1,2,307428,307428,307430,0,2,0
87764,2,2,307430,307430,307432,0,2,0
87765,3,2,307433,307433,307435,0,2,1
87766,2,3,307435,307435,307438,0,3,0
87767,4,2,307439,307439,307441,0,2,1
87768,5,3,307444,307444,307447,0,3,3
87769,2,2,307446,307447,307449,1,3,0
87770,5,3,307451,307451,307454,0,3,2
87771,2,2,307453,307454,307456,1,3,0
87772,3,1,307456,307456,307457,0,1,0
87773,5,1,307461,307461,307462,0,1,4
87774,1,3,307462,307462,307465,0,3,0
87775,2,2,307464,307465,307467,1,3,0
87776,1,3,307465,307467,307470,2,5,0
87777,6,2,307471,307471,307473,0,2,1
87778,6,3,307477,307477,307480,0,3,4
87779,3,2,307480,307480,307482,0,2,0
87780,4,2,307484,307484,307486,0,2,2
87781,3,1,307487,307487,307488,0,1,1
87782,5,1,307492,307492,307493,0,1,4
87783,1,1,307493,307493,307494,0,1,0
87784,1,3,307494,307494,307497,0,3,0
87785,3,1,307497,307497,307498,0,1,0
87786,4,3,307501,307501,307504,0,3,3
87787,4,1,307505,307505,307506,0,1,1
87788,3,3,307508,307508,307511,0,3,2
87789,6,1,307514,307514,307515,0,1,3
87790,1,2,307515,307515,307517,0,2,0
87791,6,1,307521,307521,307522,0,1,4
87792,2,3,307523,307523,307526,0,3,1
87793,2,3,307525,307526,307529,1,4,0
87794,5,2,307530,307530,307532,0,2,1
87795,3,3,307533,307533,307536,0,3,1
87796,5,3,307538,307538,307541,0,3,2
87797,5,2,307543,307543,307545,0,2,2
87798,6,3,307549,307549,307552,0,3,4
87799,6,2,307555,307555,307557,0,2,3
87800,1,2,307556,307557,307559,1,3,0
87801,4,1,307560,307560,307561,0,1,1
87802,1,2,307561,307561,307563,0,2,0
87803,6,2,307567,307567,307569,0,2,4
87804,3,2,307570,307570,307572,0,2,1
87805,4,3,307574,307574,307577,0,3,2
87806,5,2,307579,307579,307581,0,2,2
87807,5,3,307584,307584,307587,0,3,3
87808,3,3,307587,307587,307590,0,3,0
87809,1,2,307588,307590,307592,2,4,0
87810,1,3,307589,307592,307595,3,6,0
87811,1,3,307590,307595,307598,5,8,0
87812,6,2,307596,307598,307600,2,4,0
87813,3,1,307599,307600,307601,1,2,0
87814,2,1,307601,307601,307602,0,1,0
87815,3,3,307604,307604,307607,0,3,2
87816,4,2,307608,307608,307610,0,2,1
87817,5,2,307613,307613,307615,0,2,3
87818,3,2,307616,307616,307618,0,2,1
87819,5,3,307621,307621,307624,0,3,3
87820,4,1,307625,307625,307626,0,1,1
87821,6,1,307631,307631,307632,0,1,5
87822,1,2,307632,307632,307634,0,2,0
87823,2,3,307634,307634,307637,0,3,0
87824,1,1,307635,307637,307638,2,3,0
87825,5,1,307640,307640,307641,0,1,2
87826,1,3,307641,307641,307644,0,3,0
87827,3,3,307644,307644,307647,0,3,0
87828,4,3,307648,307648,307651,0,3,1
87829,1,3,307649,307651,307654,2,5,0
87830,1,1,307650,307654,307655,4,5,0
87831,2,1,307652,307655,307656,3,4,0
87832,2,2,307654,307656,307658,2,4,0
87833,1,1,307655,307658,307659,3,4,0
87834,4,3,307659,307659,307662,0,3,0
87835,1,3,307660,307662,307665,2,5,0
87836,5,2,307665,307665,307667,0,2,0
87837,1,3,307666,307667,307670,1,4,0
87838,6,1,307672,307672,307673,0,1,2
87839,6,3,307678,307678,307681,0,3,5
87840,5,1,307683,307683,307684,0,1,2
87841,3,3,307686,307686,307689,0,3,2
87842,6,3,307692,307692,307695,0,3,3
87843,2,3,307694,307695,307698,1,4,0
87844,5,1,307699,307699,307700,0,1,1
87845,1,1,307700,307700,307701,0,1,0
87846,3,2,307703,307703,307705,0,2,2
87847,2,2,307705,307705,307707,0,2,0
87848,4,1,307709,307709,307710,0,1,2
87849,2,3,307711,307711,307714,0,3,1
87850,3,1,307714,307714,307715,0,1,0
87851,4,2,307718,307718,307720,0,2,3
87852,5,2,307723,307723,307725,0,2,3
87853,5,2,307728,307728,307730,0,2,3
87854,2,2,307730,307730,307732,0,2,0
87855,6,3,307736,307736,307739,0,3,4
87856,5,2,307741,307741,307743,0,2,2
87857,4,3,307745,307745,307748,0,3,2
87858,2,2,307747,307748,307750,1,3,0
87859,5,3,307752,307752,307755,0,3,2
87860,4,2,307756,307756,307758,0,2,1
87861,6,3,307762,307762,307765,0,3,4
87862,2,2,307764,307765,307767,1,3,0
87863,5,1,307769,307769,307770,0,1,2
87864,2,2,307771,307771,307773,0,2,1
87865,1,1,307772,307773,307774,1,2,0
87866,1,1,307773,307774,307775,1,2,0
87867,4,1,307777,307777,307778,0,1,2
87868,6,1,307783,307783,307784,0,1,5
87869,1,3,307784,307784,307787,0,3,0
87870,1,1,307785,307787,307788,2,3,0
87871,1,1,307786,307788,307789,2,3,0
87872,1,3,307787,307789,307792,2,5,0
87873,6,3,307793,307793,307796,0,3,1
87874,1,2,307794,307796,307798,2,4,0
87875,1,3,307795,307798,307801,3,6,0
87876,4,2,307799,307801,307803,2,4,0
87877,1,3,307800,307803,307806,3,6,0
87878,4,1,307804,307806,307807,2,3,0
87879,5,1,307809,307809,307810,0,1,2
87880,1,2,307810,307810,307812,0,2,0
87881,1,2,307811,307812,307814,1,3,0
87882,1,2,307812,307814,307816,2,4,0
87883,6,1,307818,307818,307819,0,1,2
87884,4,3,307822,307822,307825,0,3,3
87885,3,3,307825,307825,307828,0,3,0
87886,3,3,307828,307828,307831,0,3,0
87887,3,3,307831,307831,307834,0,3,0
87888,6,3,307837,307837,307840,0,3,3
87889,6,1,307843,307843,307844,0,1,3
87890,1,3,307844,307844,307847,0,3,0
87891,1,2,307845,307847,307849,2,4,0
87892,4,1,307849,307849,307850,0,1,0
87893,4,3,307853,307853,307856,0,3,3
87894,1,2,307854,307856,307858,2,4,0
87895,4,1,307858,307858,307859,0,1,0
87896,5,1,307863,307863,307864,0,1,4
87897,6,1,307869,307869,307870,0,1,5
87898,2,3,307871,307871,307874,0,3,1
87899,1,3,307872,307874,307877,2,5,0
87900,6,3,307878,307878,307881,0,3,1
87901,3,3,307881,307881,307884,0,3,0
87902,4,1,307885,307885,307886,0,1,1
87903,3,3,307888,307888,307891,0,3,2
87904,6,3,307894,307894,307897,0,3,3
87905,5,2,307899,307899,307901,0,2,2
87906,4,1,307903,307903,307904,0,1,2
87907,6,1,307909,307909,307910,0,1,5
87908,1,2,307910,307910,307912,0,2,0
87909,3,2,307913,307913,307915,0,2,1
87910,4,3,307917,307917,307920,0,3,2
87911,5,1,307922,307922,307923,0,1,2
87912,1,3,307923,307923,307926,0,3,0
87913,5,3,307928,307928,307931,0,3,2
87914,2,2,307930,307931,307933,1,3,0
87915,3,1,307933,307933,307934,0,1,0
87916,3,3,307936,307936,307939,0,3,2
87917,5,2,307941,307941,307943,0,2,2
87918,4,1,307945,307945,307946,0,1,2
87919,2,1,307947,307947,307948,0,1,1
87920,1,1,307948,307948,307949,0,1,0
87921,5,1,307953,307953,307954,0,1,4
87922,1,1,307954,307954,307955,0,1,0
87923,5,1,307959,307959,307960,0,1,4
87924,1,3,307960,307960,307963,0,3,0
87925,2,1,307962,307963,307964,1,2,0
87926,3,2,307965,307965,307967,0,2,1
87927,5,2,307970,307970,307972,0,2,3
87928,3,2,307973,307973,307975,0,2,1
87929,4,1,307977,307977,307978,0,1,2
87930,3,1,307980,307980,307981,0,1,2
87931,2,1,307982,307982,307983,0,1,1
87932,5,3,307987,307987,307990,0,3,4
87933,4,3,307991,307991,307994,0,3,1
87934,6,2,307997,307997,307999,0,2,3
87935,5,3,308002,308002,308005,0,3,3
87936,6,1,308008,308008,308009,0,1,3
87937,4,1,308012,308012,308013,0,1,3
87938,2,1,308014,308014,308015,0,1,1
87939,2,3,308016,308016,308019,0,3,1
87940,6,2,308022,308022,308024,0,2,3
87941,6,1,308028,308028,308029,0,1,4
87942,3,1,308031,308031,308032,0,1,2
87943,3,3,308034,308034,308037,0,3,2
87944,1,2,308035,308037,308039,2,4,0
87945,2,2,308037,308039,308041,2,4,0
87946,6,1,308043,308043,308044,0,1,2
87947,5,3,308048,308048,308051,0,3,4
87948,3,1,308051,308051,308052,0,1,0
87949,4,2,308055,308055,308057,0,2,3
87950,5,2,308060,308060,308062,0,2,3
87951,2,3,308062,308062,308065,0,3,0
87952,3,3,308065,308065,308068,0,3,0
87953,3,1,308068,308068,308069,0,1,0
87954,4,1,308072,308072,308073,0,1,3
87955,5,1,308077,308077,308078,0,1,4
87956,3,1,308080,308080,308081,0,1,2
87957,5,1,308085,308085,308086,0,1,4
87958,6,1,308091,308091,308092,0,1,5
87959,1,1,308092,308092,308093,0,1,0
87960,6,1,308098,308098,308099,0,1,5
87961,3,3,308101,308101,308104,0,3,2
87962,3,3,308104,308104,308107,0,3,0
87963,4,1,308108,308108,308109,0,1,1
87964,4,2,308112,308112,308114,0,2,3
87965,6,1,308118,308118,308119,0,1,4
87966,1,1,308119,308119,308120,0,1,0
87967,2,2,308121,308121,308123,0,2,1
87968,6,1,308127,308127,308128,0,1,4
87969,2,3,308129,308129,308132,0,3,1
87970,3,1,308132,308132,308133,0,1,0
87971,5,1,308137,308137,308138,0,1,4
87972,6,2,308143,308143,308145,0,2,5
87973,6,2,308149,308149,308151,0,2,4
87974,5,1,308154,308154,308155,0,1,3
87975,2,2,308156,308156,308158,0,2,1
87976,1,3,308157,308158,308161,1,4,0
87977,3,3,308160,308161,308164,1,4,0
87978,6,3,308166,308166,308169,0,3,2
87979,1,2,308167,308169,308171,2,4,0
87980,6,1,308173,308173,308174,0,1,2
87981,6,3,308179,308179,308182,0,3,5
87982,6,1,308185,308185,308186,0,1,3
87983,5,2,308190,308190,308192,0,2,4
87984,4,2,308194,308194,308196,0,2,2
87985,4,3,308198,308198,308201,0,3,2
87986,4,3,308202,308202,308205,0,3,1
87987,6,1,308208,308208,308209,0,1,3
87988,6,1,308214,308214,308215,0,1,5
87989,3,1,308217,308217,308218,0,1,2
87990,4,3,308221,308221,308224,0,3,3
87991,4,2,308225,308225,308227,0,2,1
87992,2,3,308227,308227,308230,0,3,0
87993,6,3,308233,308233,308236,0,3,3
87994,4,2,308237,308237,308239,0,2,1
87995,2,2,308239,308239,308241,0,2,0
87996,3,2,308242,308242,308244,0,2,1
87997,6,1,308248,308248,308249,0,1,4
87998,2,1,308250,308250,308251,0,1,1
87999,3,2,308253,308253,308255,0,2,2
88000,3,3,308256,308256,308259,0,3,1
88001,5,3,308261,308261,308264,0,3,2
88002,3,1,308264,308264,308265,0,1,0
88003,2,1,308266,308266,308267,0,1,1
88004,4,1,308270,308270,308271,0,1,3
88005,4,3,308274,308274,308277,0,3,3
88006,5,3,308279,308279,308282,0,3,2
88007,6,3,308285,308285,308288,0,3,3
88008,6,1,308291,308291,308292,0,1,3
88009,1,3,308292,308292,308295,0,3,0
88010,6,1,308298,308298,308299,0,1,3
88011,5,3,308303,308303,308306,0,3,4
88012,3,1,308306,308306,308307,0,1,0
88013,3,2,308309,308309,308311,0,2,2
88014,6,1,308315,308315,308316,0,1,4
88015,3,1,308318,308318,308319,0,1,2
88016,3,2,308321,308321,308323,0,2,2
88017,3,1,308324,308324,308325,0,1,1
88018,3,3,308327,308327,308330,0,3,2
88019,1,1,308328,308330,308331,2,3,0
88020,6,2,308334,308334,308336,0,2,3
88021,1,3,308335,308336,308339,1,4,0
88022,4,3,308339,308339,308342,0,3,0
88023,2,2,308341,308342,308344,1,3,0
88024,5,2,308346,308346,308348,0,2,2
88025,6,1,308352,308352,308353,0,1,4
88026,6,1,308358,308358,308359,0,1,5
88027,4,2,308362,308362,308364,0,2,3
88028,3,2,308365,308365,308367,0,2,1
88029,2,1,308367,308367,308368,0,1,0
88030,3,2,308370,308370,308372,0,2,2
88031,5,3,308375,308375,308378,0,3,3
88032,1,3,308376,308378,308381,2,5,0
88033,6,1,308382,308382,308383,0,1,1
88034,2,3,308384,308384,308387,0,3,1
88035,2,1,308386,308387,308388,1,2,0
88036,3,2,308389,308389,308391,0,2,1
88037,1,3,308390,308391,308394,1,4,0
88038,6,3,308396,308396,308399,0,3,2
88039,4,1,308400,308400,308401,0,1,1
88040,6,2,308406,308406,308408,0,2,5
88041,2,1,308408,308408,308409,0,1,0
88042,4,1,308412,308412,308413,0,1,3
88043,1,1,308413,308413,308414,0,1,0
88044,4,2,308417,308417,308419,0,2,3
88045,1,3,308418,308419,308422,1,4,0
88046,4,3,308422,308422,308425,0,3,0
88047,4,2,308426,308426,308428,0,2,1
88048,4,3,308430,308430,308433,0,3,2
88049,2,1,308432,308433,308434,1,2,0
88050,1,2,308433,308434,308436,1,3,0
88051,4,1,308437,308437,308438,0,1,1
88052,1,3,308438,308438,308441,0,3,0
88053,6,2,308444,308444,308446,0,2,3
88054,2,2,308446,308446,308448,0,2,0
88055,2,3,308448,308448,308451,0,3,0
88056,3,2,308451,308451,308453,0,2,0
88057,6,2,308457,308457,308459,0,2,4
88058,5,1,308462,308462,308463,0,1,3
88059,1,3,308463,308463,308466,0,3,0
88060,5,3,308468,308468,308471,0,3,2
88061,1,3,308469,308471,308474,2,5,0
88062,6,3,308475,308475,308478,0,3,1
88063,2,2,308477,308478,308480,1,3,0
88064,5,3,308482,308482,308485,0,3,2
88065,1,1,308483,308485,308486,2,3,0
88066,4,1,308487,308487,308488,0,1,1
88067,1,3,308488,308488,308491,0,3,0
88068,1,1,308489,308491,308492,2,3,0
88069,5,3,308494,308494,308497,0,3,2
88070,5,1,308499,308499,308500,0,1,2
88071,5,2,308504,308504,308506,0,2,4
88072,3,3,308507,308507,308510,0,3,1
88073,4,2,308511,308511,308513,0,2,1
88074,4,2,308515,308515,308517,0,2,2
88075,3,1,308518,308518,308519,0,1,1
88076,6,3,308524,308524,308527,0,3,5
88077,5,1,308529,308529,308530,0,1,2
88078,5,1,308534,308534,308535,0,1,4
88079,6,2,308540,308540,308542,0,2,5
88080,5,1,308545,308545,308546,0,1,3
88081,3,2,308548,308548,308550,0,2,2
88082,2,1,308550,308550,308551,0,1,0
88083,3,3,308553,308553,308556,0,3,2
88084,3,1,308556,308556,308557,0,1,0
88085,1,3,308557,308557,308560,0,3,0
88086,5,2,308562,308562,308564,0,2,2
88087,4,1,308566,308566,308567,0,1,2
88088,3,1,308569,308569,308570,0,1,2
88089,5,1,308574,308574,308575,0,1,4
88090,2,2,308576,308576,308578,0,2,1
88091,4,1,308580,308580,308581,0,1,2
88092,2,2,308582,308582,308584,0,2,1
88093,6,2,308588,308588,308590,0,2,4
88094,3,2,308591,308591,308593,0,2,1
88095,5,1,308596,308596,308597,0,1,3
88096,2,1,308598,308598,308599,0,1,1
88097,4,1,308602,308602,308603,0,1,3
88098,4,2,308606,308606,308608,0,2,3
88099,2,1,308608,308608,308609,0,1,0
88100,4,2,308612,308612,308614,0,2,3
88101,1,1,308613,308614,308615,1,2,0
88102,6,2,308619,308619,308621,0,2,4
88103,3,1,308622,308622,308623,0,1,1
88104,1,3,308623,308623,308626,0,3,0
88105,4,1,308627,308627,308628,0,1,1
88106,1,2,308628,308628,308630,0,2,0
88107,2,1,308630,308630,308631,0,1,0
88108,6,2,308636,308636,308638,0,2,5
88109,5,1,308641,308641,308642,0,1,3
88110,6,2,308647,308647,308649,0,2,5
88111,2,3,308649,308649,308652,0,3,0
88112,1,1,308650,308652,308653,2,3,0
88113,4,2,308654,308654,308656,0,2,1
88114,5,1,308659,308659,308660,0,1,3
88115,4,3,308663,308663,308666,0,3,3
88116,1,1,308664,308666,308667,2,3,0
88117,4,3,308668,308668,308671,0,3,1
88118,2,1,308670,308671,308672,1,2,0
88119,2,3,308672,308672,308675,0,3,0
88120,1,2,308673,308675,308677,2,4,0
88121,2,1,308675,308677,308678,2,3,0
88122,6,1,308681,308681,308682,0,1,3
88123,6,2,308687,308687,308689,0,2,5
88124,4,1,308691,308691,308692,0,1,2
88125,3,2,308694,308694,308696,0,2,2
88126,2,1,308696,308696,308697,0,1,0
88127,4,2,308700,308700,308702,0,2,3
88128,1,2,308701,308702,308704,1,3,0
88129,2,1,308703,308704,308705,1,2,0
88130,2,2,308705,308705,308707,0,2,0
88131,5,2,308710,308710,308712,0,2,3
88132,2,1,308712,308712,308713,0,1,0
88133,2,1,308714,308714,308715,0,1,1
88134,5,2,308719,308719,308721,0,2,4
88135,4,1,308723,308723,308724,0,1,2
88136,3,3,308726,308726,308729,0,3,2
88137,6,2,308732,308732,308734,0,2,3
88138,3,1,308735,308735,308736,0,1,1
88139,5,3,308740,308740,308743,0,3,4
88140,3,2,308743,308743,308745,0,2,0
88141,4,3,308747,308747,308750,0,3,2
88142,6,3,308753,308753,308756,0,3,3
88143,3,2,308756,308756,308758,0,2,0
88144,4,2,308760,308760,308762,0,2,2
88145,3,1,308763,308763,308764,0,1,1
88146,5,2,308768,308768,308770,0,2,4
88147,2,2,308770,308770,308772,0,2,0
88148,2,1,308772,308772,308773,0,1,0
88149,6,2,308778,308778,308780,0,2,5
88150,6,2,308784,308784,308786,0,2,4
88151,2,2,308786,308786,308788,0,2,0
88152,5,1,308791,308791,308792,0,1,3
88153,6,2,308797,308797,308799,0,2,5
88154,4,2,308801,308801,308803,0,2,2
88155,6,1,308807,308807,308808,0,1,4
88156,5,3,308812,308812,308815,0,3,4
88157,3,2,308815,308815,308817,0,2,0
88158,3,2,308818,308818,308820,0,2,1
88159,4,3,308822,308822,308825,0,3,2
88160,2,3,308824,308825,308828,1,4,0
88161,1,2,308825,308828,308830,3,5,0
88162,6,1,308831,308831,308832,0,1,1
88163,2,3,308833,308833,308836,0,3,1
88164,1,1,308834,308836,308837,2,3,0
88165,6,3,308840,308840,308843,0,3,3
88166,3,2,308843,308843,308845,0,2,0
88167,5,2,308848,308848,308850,0,2,3
88168,6,2,308854,308854,308856,0,2,4
88169,3,1,308857,308857,308858,0,1,1
88170,4,2,308861,308861,308863,0,2,3
88171,3,2,308864,308864,308866,0,2,1
88172,5,3,308869,308869,308872,0,3,3
88173,4,2,308873,308873,308875,0,2,1
88174,2,2,308875,308875,308877,0,2,0
88175,5,1,308880,308880,308881,0,1,3
88176,3,1,308883,308883,308884,0,1,2
88177,3,3,308886,308886,308889,0,3,2
88178,3,1,308889,308889,308890,0,1,0
88179,3,1,308892,308892,308893,0,1,2
88180,5,2,308897,308897,308899,0,2,4
88181,6,2,308903,308903,308905,0,2,4
88182,5,1,308908,308908,308909,0,1,3
88183,3,3,308911,308911,308914,0,3,2
88184,2,3,308913,308914,308917,1,4,0
88185,5,1,308918,308918,308919,0,1,1
88186,2,3,308920,308920,308923,0,3,1
88187,1,3,308921,308923,308926,2,5,0
88188,2,2,308923,308926,308928,3,5,0
88189,6,1,308929,308929,308930,0,1,1
88190,2,2,308931,308931,308933,0,2,1
88191,5,1,308936,308936,308937,0,1,3
88192,1,3,308937,308937,308940,0,3,0
88193,2,2,308939,308940,308942,1,3,0
88194,4,2,308943,308943,308945,0,2,1
88195,6,3,308949,308949,308952,0,3,4
88196,2,3,308951,308952,308955,1,4,0
88197,5,2,308956,308956,308958,0,2,1
88198,2,1,308958,308958,308959,0,1,0
88199,2,3,308960,308960,308963,0,3,1
88200,2,3,308962,308963,308966,1,4,0
88201,2,1,308964,308966,308967,2,3,0
88202,4,1,308968,308968,308969,0,1,1
88203,3,3,308971,308971,308974,0,3,2
88204,6,2,308977,308977,308979,0,2,3
88205,4,1,308981,308981,308982,0,1,2
88206,4,2,308985,308985,308987,0,2,3
88207,6,1,308991,308991,308992,0,1,4
88208,2,1,308993,308993,308994,0,1,1
88209,1,1,308994,308994,308995,0,1,0
88210,5,3,308999,308999,309002,0,3,4
88211,4,1,309003,309003,309004,0,1,1
88212,5,3,309008,309008,309011,0,3,4
88213,3,2,309011,309011,309013,0,2,0
88214,4,2,309015,309015,309017,0,2,2
88215,2,2,309017,309017,309019,0,2,0
88216,2,3,309019,309019,309022,0,3,0
88217,6,3,309025,309025,309028,0,3,3
88218,2,2,309027,309028,309030,1,3,0
88219,6,3,309033,309033,309036,0,3,3
88220,6,1,309039,309039,309040,0,1,3
88221,1,3,309040,309040,309043,0,3,0
88222,4,1,309044,309044,309045,0,1,1
88223,4,2,309048,309048,309050,0,2,3
88224,2,2,309050,309050,309052,0,2,0
88225,3,1,309053,309053,309054,0,1,1
88226,4,2,309057,309057,309059,0,2,3
88227,3,2,309060,309060,309062,0,2,1
88228,1,2,309061,309062,309064,1,3,0
88229,6,3,309067,309067,309070,0,3,3
88230,3,2,309070,309070,309072,0,2,0
88231,6,1,309076,309076,309077,0,1,4
88232,4,3,309080,309080,309083,0,3,3
88233,3,1,309083,309083,309084,0,1,0
88234,6,3,309089,309089,309092,0,3,5
88235,2,3,309091,309092,309095,1,4,0
88236,5,1,309096,309096,309097,0,1,1
88237,1,2,309097,309097,309099,0,2,0
88238,4,1,309101,309101,309102,0,1,2
88239,2,1,309103,309103,309104,0,1,1
88240,6,1,309109,309109,309110,0,1,5
88241,1,1,309110,309110,309111,0,1,0
88242,6,2,309116,309116,309118,0,2,5
88243,2,3,309118,309118,309121,0,3,0
88244,4,3,309122,309122,309125,0,3,1
88245,2,1,309124,309125,309126,1,2,0
88246,2,1,309126,309126,309127,0,1,0
88247,3,2,309129,309129,309131,0,2,2
88248,1,2,309130,309131,309133,1,3,0
88249,6,1,309136,309136,309137,0,1,3
88250,5,2,309141,309141,309143,0,2,4
88251,1,3,309142,309143,309146,1,4,0
88252,6,2,309148,309148,309150,0,2,2
88253,1,3,309149,309150,309153,1,4,0
88254,2,2,309151,309153,309155,2,4,0
88255,3,2,309154,309155,309157,1,3,0
88256,1,1,309155,309157,309158,2,3,0
88257,5,2,309160,309160,309162,0,2,2
88258,3,2,309163,309163,309165,0,2,1
88259,5,2,309168,309168,309170,0,2,3
88260,6,3,309174,309174,309177,0,3,4
88261,2,1,309176,309177,309178,1,2,0
88262,6,1,309182,309182,309183,0,1,4
88263,2,2,309184,309184,309186,0,2,1
88264,4,2,309188,309188,309190,0,2,2
88265,1,1,309189,309190,309191,1,2,0
88266,4,2,309193,309193,309195,0,2,2
88267,4,2,309197,309197,309199,0,2,2
88268,1,3,309198,309199,309202,1,4,0
88269,3,1,309201,309202,309203,1,2,0
88270,2,1,309203,309203,309204,0,1,0
88271,4,2,309207,309207,309209,0,2,3
88272,6,2,309213,309213,309215,0,2,4
88273,5,2,309218,309218,309220,0,2,3
88274,1,2,309219,309220,309222,1,3,0
88275,4,3,309223,309223,309226,0,3,1
88276,5,3,309228,309228,309231,0,3,2
88277,4,3,309232,309232,309235,0,3,1
88278,5,3,309237,309237,309240,0,3,2
88279,2,2,309239,309240,309242,1,3,0
88280,4,1,309243,309243,309244,0,1,1
88281,2,2,309245,309245,309247,0,2,1
88282,5,2,309250,309250,309252,0,2,3
88283,3,2,309253,309253,309255,0,2,1
88284,4,1,309257,309257,309258,0,1,2
88285,2,2,309259,309259,309261,0,2,1
88286,4,1,309263,309263,309264,0,1,2
88287,1,2,309264,309264,309266,0,2,0
88288,5,2,309269,309269,309271,0,2,3
88289,2,3,309271,309271,309274,0,3,0
88290,1,2,309272,309274,309276,2,4,0
88291,4,1,309276,309276,309277,0,1,0
88292,6,1,309282,309282,309283,0,1,5
88293,4,1,309286,309286,309287,0,1,3
88294,6,3,309292,309292,309295,0,3,5
88295,2,2,309294,309295,309297,1,3,0
88296,4,1,309298,309298,309299,0,1,1
88297,5,2,309303,309303,309305,0,2,4
88298,6,2,309309,309309,309311,0,2,4
88299,4,2,309313,309313,309315,0,2,2
88300,5,3,309318,309318,309321,0,3,3
88301,3,1,309321,309321,309322,0,1,0
88302,6,3,309327,309327,309330,0,3,5
88303,5,2,309332,309332,309334,0,2,2
88304,1,2,309333,309334,309336,1,3,0
88305,6,2,309339,309339,309341,0,2,3
88306,4,3,309343,309343,309346,0,3,2
88307,2,3,309345,309346,309349,1,4,0
88308,5,2,309350,309350,309352,0,2,1
88309,5,2,309355,309355,309357,0,2,3
88310,2,2,309357,309357,309359,0,2,0
88311,1,1,309358,309359,309360,1,2,0
88312,3,1,309361,309361,309362,0,1,1
88313,6,3,309367,309367,309370,0,3,5
88314,4,1,309371,309371,309372,0,1,1
88315,3,3,309374,309374,309377,0,3,2
88316,3,2,309377,309377,309379,0,2,0
88317,6,2,309383,309383,309385,0,2,4
88318,2,1,309385,309385,309386,0,1,0
88319,3,3,309388,309388,309391,0,3,2
88320,1,2,309389,309391,309393,2,4,0
88321,4,3,309393,309393,309396,0,3,0
88322,4,3,309397,309397,309400,0,3,1
88323,6,3,309403,309403,309406,0,3,3
88324,5,3,309408,309408,309411,0,3,2
88325,2,2,309410,309411,309413,1,3,0
88326,2,1,309412,309413,309414,1,2,0
88327,1,2,309413,309414,309416,1,3,0
88328,3,1,309416,309416,309417,0,1,0
88329,3,3,309419,309419,309422,0,3,2
88330,4,3,309423,309423,309426,0,3,1
88331,4,3,309427,309427,309430,0,3,1
88332,5,1,309432,309432,309433,0,1,2
88333,4,2,309436,309436,309438,0,2,3
88334,4,1,309440,309440,309441,0,1,2
88335,4,3,309444,309444,309447,0,3,3
88336,4,1,309448,309448,309449,0,1,1
88337,5,2,309453,309453,309455,0,2,4
88338,1,1,309454,309455,309456,1,2,0
88339,1,2,309455,309456,309458,1,3,0
88340,3,3,309458,309458,309461,0,3,0
88341,3,1,309461,309461,309462,0,1,0
88342,3,1,309464,309464,309465,0,1,2
88343,3,3,309467,309467,309470,0,3,2
88344,1,2,309468,309470,309472,2,4,0
88345,6,3,309474,309474,309477,0,3,2
88346,5,2,309479,309479,309481,0,2,2
88347,6,3,309485,309485,309488,0,3,4
88348,3,1,309488,309488,309489,0,1,0
88349,5,3,309493,309493,309496,0,3,4
88350,4,1,309497,309497,309498,0,1,1
88351,2,3,309499,309499,309502,0,3,1
88352,1,2,309500,309502,309504,2,4,0
88353,6,2,309506,309506,309508,0,2,2
88354,3,2,309509,309509,309511,0,2,1
88355,5,1,309514,309514,309515,0,1,3
88356,1,2,309515,309515,309517,0,2,0
88357,5,1,309520,309520,309521,0,1,3
88358,1,2,309521,309521,309523,0,2,0
88359,2,1,309523,309523,309524,0,1,0
88360,4,1,309527,309527,309528,0,1,3
88361,5,2,309532,309532,309534,0,2,4
88362,3,3,309535,309535,309538,0,3,1
88363,4,2,309539,309539,309541,0,2,1
88364,3,1,309542,309542,309543,0,1,1
88365,6,2,309548,309548,309550,0,2,5
88366,6,1,309554,309554,309555,0,1,4
88367,1,1,309555,309555,309556,0,1,0
88368,1,2,309556,309556,309558,0,2,0
88369,6,1,309562,309562,309563,0,1,4
88370,4,3,309566,309566,309569,0,3,3
88371,4,3,309570,309570,309573,0,3,1
88372,4,3,309574,309574,309577,0,3,1
88373,6,2,309580,309580,309582,0,2,3
88374,2,3,309582,309582,309585,0,3,0
88375,5,3,309587,309587,309590,0,3,2
88376,2,1,309589,309590,309591,1,2,0
88377,2,3,309591,309591,309594,0,3,0
88378,6,2,309597,309597,309599,0,2,3
88379,3,3,309600,309600,309603,0,3,1
88380,4,2,309604,309604,309606,0,2,1
88381,1,1,309605,309606,309607,1,2,0
88382,2,2,309607,309607,309609,0,2,0
88383,5,1,309612,309612,309613,0,1,3
88384,1,2,309613,309613,309615,0,2,0
88385,2,1,309615,309615,309616,0,1,0
88386,1,3,309616,309616,309619,0,3,0
88387,3,2,309619,309619,309621,0,2,0
88388,6,2,309625,309625,309627,0,2,4
88389,3,2,309628,309628,309630,0,2,1
88390,5,2,309633,309633,309635,0,2,3
88391,3,3,309636,309636,309639,0,3,1
88392,2,3,309638,309639,309642,1,4,0
88393,3,3,309641,309642,309645,1,4,0
88394,1,3,309642,309645,309648,3,6,0
88395,4,2,309646,309648,309650,2,4,0
88396,1,2,309647,309650,309652,3,5,0
88397,6,2,309653,309653,309655,0,2,1
88398,3,3,309656,309656,309659,0,3,1
88399,4,2,309660,309660,309662,0,2,1
88400,1,3,309661,309662,309665,1,4,0
88401,2,2,309663,309665,309667,2,4,0
88402,6,3,309669,309669,309672,0,3,2
88403,5,2,309674,309674,309676,0,2,2
88404,4,3,309678,309678,309681,0,3,2
88405,6,2,309684,309684,309686,0,2,3
88406,3,3,309687,309687,309690,0,3,1
88407,6,2,309693,309693,309695,0,2,3
88408,5,3,309698,309698,309701,0,3,3
88409,3,3,309701,309701,309704,0,3,0
88410,3,3,309704,309704,309707,0,3,0
88411,3,2,309707,309707,309709,0,2,0
88412,4,2,309711,309711,309713,0,2,2
88413,2,3,309713,309713,309716,0,3,0
88414,5,3,309718,309718,309721,0,3,2
88415,6,1,309724,309724,309725,0,1,3
88416,5,1,309729,309729,309730,0,1,4
88417,5,1,309734,309734,309735,0,1,4
88418,4,2,309738,309738,309740,0,2,3
88419,3,2,309741,309741,309743,0,2,1
88420,6,3,309747,309747,309750,0,3,4
88421,4,2,309751,309751,309753,0,2,1
88422,1,1,309752,309753,309754,1,2,0
88423,1,3,309753,309754,309757,1,4,0
88424,6,2,309759,309759,309761,0,2,2
88425,1,2,309760,309761,309763,1,3,0
88426,3,3,309763,309763,309766,0,3,0
88427,4,1,309767,309767,309768,0,1,1
88428,5,1,309772,309772,309773,0,1,4
88429,4,1,309776,309776,309777,0,1,3
88430,3,1,309779,309779,309780,0,1,2
88431,1,3,309780,309780,309783,0,3,0
88432,4,3,309784,309784,309787,0,3,1
88433,4,2,309788,309788,309790,0,2,1
88434,6,3,309794,309794,309797,0,3,4
88435,1,3,309795,309797,309800,2,5,0
88436,4,3,309799,309800,309803,1,4,0
88437,6,2,309805,309805,309807,0,2,2
88438,5,1,309810,309810,309811,0,1,3
88439,3,3,309813,309813,309816,0,3,2
88440,2,2,309815,309816,309818,1,3,0
88441,2,3,309817,309818,309821,1,4,0
88442,1,1,309818,309821,309822,3,4,0
88443,2,2,309820,309822,309824,2,4,0
88444,6,2,309826,309826,309828,0,2,2
88445,5,2,309831,309831,309833,0,2,3
88446,1,2,309832,309833,309835,1,3,0
88447,1,1,309833,309835,309836,2,3,0
88448,5,3,309838,309838,309841,0,3,2
88449,1,2,309839,309841,309843,2,4,0
88450,6,1,309845,309845,309846,0,1,2
88451,2,2,309847,309847,309849,0,2,1
88452,5,3,309852,309852,309855,0,3,3
88453,6,3,309858,309858,309861,0,3,3
88454,2,3,309860,309861,309864,1,4,0
88455,4,3,309864,309864,309867,0,3,0
88456,1,3,309865,309867,309870,2,5,0
88457,3,1,309868,309870,309871,2,3,0
88458,3,3,309871,309871,309874,0,3,0
88459,2,2,309873,309874,309876,1,3,0
88460,5,1,309878,309878,309879,0,1,2
88461,5,1,309883,309883,309884,0,1,4
88462,2,2,309885,309885,309887,0,2,1
88463,1,2,309886,309887,309889,1,3,0
88464,4,3,309890,309890,309893,0,3,1
88465,3,2,309893,309893,309895,0,2,0
88466,6,2,309899,309899,309901,0,2,4
88467,1,3,309900,309901,309904,1,4,0
88468,1,2,309901,309904,309906,3,5,0
88469,5,1,309906,309906,309907,0,1,0
88470,5,2,309911,309911,309913,0,2,4
88471,3,3,309914,309914,309917,0,3,1
88472,1,1,309915,309917,309918,2,3,0
88473,3,3,309918,309918,309921,0,3,0
88474,3,1,309921,309921,309922,0,1,0
88475,2,2,309923,309923,309925,0,2,1
88476,2,1,309925,309925,309926,0,1,0
88477,6,3,309931,309931,309934,0,3,5
88478,6,3,309937,309937,309940,0,3,3
88479,3,3,309940,309940,309943,0,3,0
88480,4,3,309944,309944,309947,0,3,1
88481,1,2,309945,309947,309949,2,4,0
88482,4,3,309949,309949,309952,0,3,0
88483,4,1,309953,309953,309954,0,1,1
88484,1,3,309954,309954,309957,0,3,0
88485,4,1,309958,309958,309959,0,1,1
88486,5,1,309963,309963,309964,0,1,4
88487,4,3,309967,309967,309970,0,3,3
88488,5,3,309972,309972,309975,0,3,2
88489,5,3,309977,309977,309980,0,3,2
88490,4,1,309981,309981,309982,0,1,1
88491,5,3,309986,309986,309989,0,3,4
88492,4,2,309990,309990,309992,0,2,1
88493,1,2,309991,309992,309994,1,3,0
88494,6,3,309997,309997,310000,0,3,3
88495,5,1,310002,310002,310003,0,1,2
88496,5,3,310007,310007,310010,0,3,4
88497,6,3,310013,310013,310016,0,3,3
88498,5,3,310018,310018,310021,0,3,2
88499,2,3,310020,310021,310024,1,4,0
88500,4,2,310024,310024,310026,0,2,0
88501,6,3,310030,310030,310033,0,3,4
88502,1,2,310031,310033,310035,2,4,0
88503,6,1,310037,310037,310038,0,1,2
88504,4,1,310041,310041,310042,0,1,3
88505,6,2,310047,310047,310049,0,2,5
88506,6,2,310053,310053,310055,0,2,4
88507,3,1,310056,310056,310057,0,1,1
88508,4,1,310060,310060,310061,0,1,3
88509,6,2,310066,310066,310068,0,2,5
88510,3,1,310069,310069,310070,0,1,1
88511,2,1,310071,310071,310072,0,1,1
88512,1,1,310072,310072,310073,0,1,0
88513,2,3,310074,310074,310077,0,3,1
88514,2,3,310076,310077,310080,1,4,0
88515,6,2,310082,310082,310084,0,2,2
88516,3,3,310085,310085,310088,0,3,1
88517,3,3,310088,310088,310091,0,3,0
88518,5,3,310093,310093,310096,0,3,2
88519,1,1,310094,310096,310097,2,3,0
88520,2,3,310096,310097,310100,1,4,0
88521,2,3,310098,310100,310103,2,5,0
88522,2,3,310100,310103,310106,3,6,0
88523,6,1,310106,310106,310107,0,1,0
88524,3,2,310109,310109,310111,0,2,2
88525,4,1,310113,310113,310114,0,1,2
88526,2,3,310115,310115,310118,0,3,1
88527,3,3,310118,310118,310121,0,3,0
88528,1,1,310119,310121,310122,2,3,0
88529,6,2,310125,310125,310127,0,2,3
88530,2,2,310127,310127,310129,0,2,0
88531,3,3,310130,310130,310133,0,3,1
88532,4,1,310134,310134,310135,0,1,1
88533,6,1,310140,310140,310141,0,1,5
88534,5,1,310145,310145,310146,0,1,4
88535,2,1,310147,310147,310148,0,1,1
88536,2,1,310149,310149,310150,0,1,1
88537,2,2,310151,310151,310153,0,2,1
88538,6,2,310157,310157,310159,0,2,4
88539,4,3,310161,310161,310164,0,3,2
88540,2,1,310163,310164,310165,1,2,0
88541,1,1,310164,310165,310166,1,2,0
88542,2,3,310166,310166,310169,0,3,0
88543,1,3,310167,310169,310172,2,5,0
88544,6,1,310173,310173,310174,0,1,1
88545,5,3,310178,310178,310181,0,3,4
88546,6,2,310184,310184,310186,0,2,3
88547,6,2,310190,310190,310192,0,2,4
88548,2,3,310192,310192,310195,0,3,0
88549,1,2,310193,310195,310197,2,4,0
88550,3,2,310196,310197,310199,1,3,0
88551,6,3,310202,310202,310205,0,3,3
88552,2,3,310204,310205,310208,1,4,0
88553,4,2,310208,310208,310210,0,2,0
88554,3,3,310211,310211,310214,0,3,1
88555,2,3,310213,310214,310217,1,4,0
88556,4,1,310217,310217,310218,0,1,0
88557,2,1,310219,310219,310220,0,1,1
88558,1,1,310220,310220,310221,0,1,0
88559,5,2,310225,310225,310227,0,2,4
88560,6,3,310231,310231,310234,0,3,4
88561,6,3,310237,310237,310240,0,3,3
88562,5,1,310242,310242,310243,0,1,2
88563,4,2,310246,310246,310248,0,2,3
88564,1,3,310247,310248,310251,1,4,0
88565,3,1,310250,310251,310252,1,2,0
88566,5,3,310255,310255,310258,0,3,3
88567,6,2,310261,310261,310263,0,2,3
88568,6,3,310267,310267,310270,0,3,4
88569,5,1,310272,310272,310273,0,1,2
88570,1,3,310273,310273,310276,0,3,0
88571,5,3,310278,310278,310281,0,3,2
88572,6,3,310284,310284,310287,0,3,3
88573,4,3,310288,310288,310291,0,3,1
88574,1,1,310289,310291,310292,2,3,0
88575,2,1,310291,310292,310293,1,2,0
88576,5,3,310296,310296,310299,0,3,3
88577,3,1,310299,310299,310300,0,1,0
88578,1,3,310300,310300,310303,0,3,0
88579,1,1,310301,310303,310304,2,3,0
88580,3,3,310304,310304,310307,0,3,0
88581,6,3,310310,310310,310313,0,3,3
88582,6,3,310316,310316,310319,0,3,3
88583,6,2,310322,310322,310324,0,2,3
88584,4,2,310326,310326,310328,0,2,2
88585,5,3,310331,310331,310334,0,3,3
88586,3,1,310334,310334,310335,0,1,0
88587,1,1,310335,310335,310336,0,1,0
88588,3,1,310338,310338,310339,0,1,2
88589,3,1,310341,310341,310342,0,1,2
88590,3,3,310344,310344,310347,0,3,2
88591,3,3,310347,310347,310350,0,3,0
88592,3,2,310350,310350,310352,0,2,0
88593,6,3,310356,310356,310359,0,3,4
88594,2,2,310358,310359,310361,1,3,0
88595,2,3,310360,310361,310364,1,4,0
88596,5,2,310365,310365,310367,0,2,1
88597,2,3,310367,310367,310370,0,3,0
88598,3,2,310370,310370,310372,0,2,0
88599,2,3,310372,310372,310375,0,3,0
88600,5,3,310377,310377,310380,0,3,2
88601,4,3,310381,310381,310384,0,3,1
88602,3,3,310384,310384,310387,0,3,0
88603,1,2,310385,310387,310389,2,4,0
88604,1,2,310386,310389,310391,3,5,0
88605,5,3,310391,310391,310394,0,3,0
88606,5,1,310396,310396,310397,0,1,2
88607,5,1,310401,310401,310402,0,1,4
88608,1,1,310402,310402,310403,0,1,0
88609,2,1,310404,310404,310405,0,1,1
88610,1,2,310405,310405,310407,0,2,0
88611,5,3,310410,310410,310413,0,3,3
88612,4,1,310414,310414,310415,0,1,1
88613,4,2,310418,310418,310420,0,2,3
88614,2,2,310420,310420,310422,0,2,0
88615,6,3,310426,310426,310429,0,3,4
88616,3,2,310429,310429,310431,0,2,0
88617,3,2,310432,310432,310434,0,2,1
88618,4,2,310436,310436,310438,0,2,2
88619,2,1,310438,310438,310439,0,1,0
88620,5,2,310443,310443,310445,0,2,4
88621,6,1,310449,310449,310450,0,1,4
88622,5,2,310454,310454,310456,0,2,4
88623,1,1,310455,310456,310457,1,2,0
88624,5,3,310460,310460,310463,0,3,3
88625,3,1,310463,310463,310464,0,1,0
88626,3,2,310466,310466,310468,0,2,2
88627,6,1,310472,310472,310473,0,1,4
88628,6,2,310478,310478,310480,0,2,5
88629,5,2,310483,310483,310485,0,2,3
88630,3,1,310486,310486,310487,0,1,1
88631,3,3,310489,310489,310492,0,3,2
88632,2,1,310491,310492,310493,1,2,0
88633,3,1,310494,310494,310495,0,1,1
88634,4,1,310498,310498,310499,0,1,3
88635,4,1,310502,310502,310503,0,1,3
88636,6,2,310508,310508,310510,0,2,5
88637,5,1,310513,310513,310514,0,1,3
88638,3,1,310516,310516,310517,0,1,2
88639,3,2,310519,310519,310521,0,2,2
88640,4,3,310523,310523,310526,0,3,2
88641,2,1,310525,310526,310527,1,2,0
88642,1,1,310526,310527,310528,1,2,0
88643,6,1,310532,310532,310533,0,1,4
88644,2,3,310534,310534,310537,0,3,1
88645,5,1,310539,310539,310540,0,1,2
88646,3,1,310542,310542,310543,0,1,2
88647,3,2,310545,310545,310547,0,2,2
88648,2,3,310547,310547,310550,0,3,0
88649,3,3,310550,310550,310553,0,3,0
88650,2,2,310552,310553,310555,1,3,0
88651,2,2,310554,310555,310557,1,3,0
88652,3,2,310557,310557,310559,0,2,0
88653,2,3,310559,310559,310562,0,3,0
88654,5,2,310564,310564,310566,0,2,2
88655,3,1,310567,310567,310568,0,1,1
88656,1,3,310568,310568,310571,0,3,0
88657,1,2,310569,310571,310573,2,4,0
88658,2,3,310571,310573,310576,2,5,0
88659,5,3,310576,310576,310579,0,3,0
88660,5,1,310581,310581,310582,0,1,2
88661,4,1,310585,310585,310586,0,1,3
88662,3,1,310588,310588,310589,0,1,2
88663,2,1,310590,310590,310591,0,1,1
88664,5,1,310595,310595,310596,0,1,4
88665,3,1,310598,310598,310599,0,1,2
88666,5,3,310603,310603,310606,0,3,4
88667,3,1,310606,310606,310607,0,1,0
88668,3,2,310609,310609,310611,0,2,2
88669,4,3,310613,310613,310616,0,3,2
88670,3,3,310616,310616,310619,0,3,0
88671,2,3,310618,310619,310622,1,4,0
88672,6,2,310624,310624,310626,0,2,2
88673,3,1,310627,310627,310628,0,1,1
88674,5,1,310632,310632,310633,0,1,4
88675,3,3,310635,310635,310638,0,3,2
88676,6,3,310641,310641,310644,0,3,3
88677,3,2,310644,310644,310646,0,2,0
88678,6,2,310650,310650,310652,0,2,4
88679,5,1,310655,310655,310656,0,1,3
88680,6,2,310661,310661,310663,0,2,5
88681,2,3,310663,310663,310666,0,3,0
88682,2,3,310665,310666,310669,1,4,0
88683,5,2,310670,310670,310672,0,2,1
88684,6,1,310676,310676,310677,0,1,4
88685,3,2,310679,310679,310681,0,2,2
88686,1,3,310680,310681,310684,1,4,0
88687,5,3,310685,310685,310688,0,3,1
88688,5,3,310690,310690,310693,0,3,2
88689,2,2,310692,310693,310695,1,3,0
88690,2,1,310694,310695,310696,1,2,0
88691,1,1,310695,310696,310697,1,2,0
88692,6,3,310701,310701,310704,0,3,4
88693,1,2,310702,310704,310706,2,4,0
88694,4,1,310706,310706,310707,0,1,0
88695,6,3,310712,310712,310715,0,3,5
88696,2,1,310714,310715,310716,1,2,0
88697,3,3,310717,310717,310720,0,3,1
88698,1,1,310718,310720,310721,2,3,0
88699,2,2,310720,310721,310723,1,3,0
88700,5,1,310725,310725,310726,0,1,2
88701,3,2,310728,310728,310730,0,2,2
88702,6,2,310734,310734,310736,0,2,4
88703,5,2,310739,310739,310741,0,2,3
88704,5,1,310744,310744,310745,0,1,3
88705,4,3,310748,310748,310751,0,3,3
88706,5,2,310753,310753,310755,0,2,2
88707,6,3,310759,310759,310762,0,3,4
88708,1,2,310760,310762,310764,2,4,0
88709,3,1,310763,310764,310765,1,2,0
88710,1,3,310764,310765,310768,1,4,0
88711,5,1,310769,310769,310770,0,1,1
88712,6,1,310775,310775,310776,0,1,5
88713,3,2,310778,310778,310780,0,2,2
88714,1,2,310779,310780,310782,1,3,0
88715,2,2,310781,310782,310784,1,3,0
88716,1,3,310782,310784,310787,2,5,0
88717,1,2,310783,310787,310789,4,6,0
88718,1,3,310784,310789,310792,5,8,0
88719,6,2,310790,310792,310794,2,4,0
88720,5,1,310795,310795,310796,0,1,1
88721,6,2,310801,310801,310803,0,2,5
88722,2,3,310803,310803,310806,0,3,0
88723,6,2,310809,310809,310811,0,2,3
88724,4,3,310813,310813,310816,0,3,2
88725,5,3,310818,310818,310821,0,3,2
88726,1,3,310819,310821,310824,2,5,0
88727,5,1,310824,310824,310825,0,1,0
88728,6,2,310830,310830,310832,0,2,5
88729,6,2,310836,310836,310838,0,2,4
88730,4,1,310840,310840,310841,0,1,2
88731,2,3,310842,310842,310845,0,3,1
88732,6,1,310848,310848,310849,0,1,3
88733,6,2,310854,310854,310856,0,2,5
88734,5,3,310859,310859,310862,0,3,3
88735,5,1,310864,310864,310865,0,1,2
88736,6,1,310870,310870,310871,0,1,5
88737,5,2,310875,310875,310877,0,2,4
88738,5,1,310880,310880,310881,0,1,3
88739,6,1,310886,310886,310887,0,1,5
88740,5,2,310891,310891,310893,0,2,4
88741,3,2,310894,310894,310896,0,2,1
88742,1,1,310895,310896,310897,1,2,0
88743,3,3,310898,310898,310901,0,3,1
88744,1,1,310899,310901,310902,2,3,0
88745,4,2,310903,310903,310905,0,2,1
88746,1,2,310904,310905,310907,1,3,0
88747,3,3,310907,310907,310910,0,3,0
88748,3,3,310910,310910,310913,0,3,0
88749,3,2,310913,310913,310915,0,2,0
88750,4,3,310917,310917,310920,0,3,2
88751,5,3,310922,310922,310925,0,3,2
88752,5,2,310927,310927,310929,0,2,2
88753,6,1,310933,310933,310934,0,1,4
88754,5,2,310938,310938,310940,0,2,4
88755,1,3,310939,310940,310943,1,4,0
88756,5,3,310944,310944,310947,0,3,1
88757,4,1,310948,310948,310949,0,1,1
88758,1,1,310949,310949,310950,0,1,0
88759,2,2,310951,310951,310953,0,2,1
88760,2,1,310953,310953,310954,0,1,0
88761,3,2,310956,310956,310958,0,2,2
88762,6,3,310962,310962,310965,0,3,4
88763,3,1,310965,310965,310966,0,1,0
88764,5,2,310970,310970,310972,0,2,4
88765,3,1,310973,310973,310974,0,1,1
88766,6,3,310979,310979,310982,0,3,5
88767,6,2,310985,310985,310987,0,2,3
88768,1,1,310986,310987,310988,1,2,0
88769,2,2,310988,310988,310990,0,2,0
88770,5,1,310993,310993,310994,0,1,3
88771,2,2,310995,310995,310997,0,2,1
88772,5,3,311000,311000,311003,0,3,3
88773,6,1,311006,311006,311007,0,1,3
88774,5,1,311011,311011,311012,0,1,4
88775,2,2,311013,311013,311015,0,2,1
88776,2,1,311015,311015,311016,0,1,0
88777,6,3,311021,311021,311024,0,3,5
88778,6,3,311027,311027,311030,0,3,3
88779,4,3,311031,311031,311034,0,3,1
88780,5,3,311036,311036,311039,0,3,2
88781,3,3,311039,311039,311042,0,3,0
88782,6,3,311045,311045,311048,0,3,3
88783,1,1,311046,311048,311049,2,3,0
88784,4,1,311050,311050,311051,0,1,1
88785,3,2,311053,311053,311055,0,2,2
88786,6,3,311059,311059,311062,0,3,4
88787,3,1,311062,311062,311063,0,1,0
88788,5,2,311067,311067,311069,0,2,4
88789,6,3,311073,311073,311076,0,3,4
88790,4,1,311077,311077,311078,0,1,1
88791,1,1,311078,311078,311079,0,1,0
88792,6,1,311084,311084,311085,0,1,5
88793,5,1,311089,311089,311090,0,1,4
88794,4,1,311093,311093,311094,0,1,3
88795,6,1,311099,311099,311100,0,1,5
88796,6,2,311105,311105,311107,0,2,5
88797,5,2,311110,311110,311112,0,2,3
88798,4,1,311114,311114,311115,0,1,2
88799,4,3,311118,311118,311121,0,3,3
88800,4,2,311122,311122,311124,0,2,1
88801,5,1,311127,311127,311128,0,1,3
88802,2,3,311129,311129,311132,0,3,1
88803,5,3,311134,311134,311137,0,3,2
88804,5,2,311139,311139,311141,0,2,2
88805,3,1,311142,311142,311143,0,1,1
88806,4,1,311146,311146,311147,0,1,3
88807,5,1,311151,311151,311152,0,1,4
88808,3,2,311154,311154,311156,0,2,2
88809,6,1,311160,311160,311161,0,1,4
88810,1,1,311161,311161,311162,0,1,0
88811,4,3,311165,311165,311168,0,3,3
88812,3,1,311168,311168,311169,0,1,0
88813,4,2,311172,311172,311174,0,2,3
88814,1,3,311173,311174,311177,1,4,0
88815,2,1,311175,311177,311178,2,3,0
88816,4,3,311179,311179,311182,0,3,1
88817,2,1,311181,311182,311183,1,2,0
88818,5,1,311186,311186,311187,0,1,3
88819,2,3,311188,311188,311191,0,3,1
88820,2,2,311190,311191,311193,1,3,0
88821,6,3,311196,311196,311199,0,3,3
88822,5,3,311201,311201,311204,0,3,2
88823,6,2,311207,311207,311209,0,2,3
88824,2,3,311209,311209,311212,0,3,0
88825,6,1,311215,311215,311216,0,1,3
88826,3,2,311218,311218,311220,0,2,2
88827,4,1,311222,311222,311223,0,1,2
88828,4,3,311226,311226,311229,0,3,3
88829,2,2,311228,311229,311231,1,3,0
88830,5,2,311233,311233,311235,0,2,2
88831,4,1,311237,311237,311238,0,1,2
88832,5,2,311242,311242,311244,0,2,4
88833,6,2,311248,311248,311250,0,2,4
88834,4,3,311252,311252,311255,0,3,2
88835,5,3,311257,311257,311260,0,3,2
88836,4,1,311261,311261,311262,0,1,1
88837,5,2,311266,311266,311268,0,2,4
88838,2,3,311268,311268,311271,0,3,0
88839,1,2,311269,311271,311273,2,4,0
88840,2,3,311271,311273,311276,2,5,0
88841,3,2,311274,311276,311278,2,4,0
88842,1,3,311275,311278,311281,3,6,0
88843,6,2,311281,311281,311283,0,2,0
88844,4,3,311285,311285,311288,0,3,2
88845,1,1,311286,311288,311289,2,3,0
88846,3,2,311289,311289,311291,0,2,0
88847,3,2,311292,311292,311294,0,2,1
88848,5,3,311297,311297,311300,0,3,3
88849,5,2,311302,311302,311304,0,2,2
88850,4,2,311306,311306,311308,0,2,2
88851,2,2,311308,311308,311310,0,2,0
88852,3,2,311311,311311,311313,0,2,1
88853,1,1,311312,311313,311314,1,2,0
88854,6,2,311318,311318,311320,0,2,4
88855,4,2,311322,311322,311324,0,2,2
88856,3,1,311325,311325,311326,0,1,1
88857,4,1,311329,311329,311330,0,1,3
88858,5,2,311334,311334,311336,0,2,4
88859,4,1,311338,311338,311339,0,1,2
88860,1,1,311339,311339,311340,0,1,0
88861,3,1,311342,311342,311343,0,1,2
88862,3,3,311345,311345,311348,0,3,2
88863,4,2,311349,311349,311351,0,2,1
88864,1,2,311350,311351,311353,1,3,0
88865,3,3,311353,311353,311356,0,3,0
88866,3,1,311356,311356,311357,0,1,0
88867,4,2,311360,311360,311362,0,2,3
88868,1,3,311361,311362,311365,1,4,0
88869,3,2,311364,311365,311367,1,3,0
88870,6,2,311370,311370,311372,0,2,3
88871,3,1,311373,311373,311374,0,1,1
88872,3,1,311376,311376,311377,0,1,2
88873,2,2,311378,311378,311380,0,2,1
88874,3,1,311381,311381,311382,0,1,1
88875,1,2,311382,311382,311384,0,2,0
88876,6,3,311388,311388,311391,0,3,4
88877,2,3,311390,311391,311394,1,4,0
88878,2,3,311392,311394,311397,2,5,0
88879,1,1,311393,311397,311398,4,5,0
88880,4,1,311397,311398,311399,1,2,0
88881,6,1,311403,311403,311404,0,1,4
88882,1,3,311404,311404,311407,0,3,0
88883,6,1,311410,311410,311411,0,1,3
88884,1,2,311411,311411,311413,0,2,0
88885,1,3,311412,311413,311416,1,4,0
88886,3,3,311415,311416,311419,1,4,0
88887,6,3,311421,311421,311424,0,3,2
88888,2,2,311423,311424,311426,1,3,0
88889,3,3,311426,311426,311429,0,3,0
88890,3,2,311429,311429,311431,0,2,0
88891,4,1,311433,311433,311434,0,1,2
88892,1,3,311434,311434,311437,0,3,0
88893,2,3,311436,311437,311440,1,4,0
88894,1,1,311437,311440,311441,3,4,0
88895,6,1,311443,311443,311444,0,1,2
88896,1,3,311444,311444,311447,0,3,0
88897,5,3,311449,311449,311452,0,3,2
88898,6,2,311455,311455,311457,0,2,3
88899,2,1,311457,311457,311458,0,1,0
88900,2,1,311459,311459,311460,0,1,1
88901,3,3,311462,311462,311465,0,3,2
88902,3,2,311465,311465,311467,0,2,0
88903,1,2,311466,311467,311469,1,3,0
88904,2,1,311468,311469,311470,1,2,0
88905,2,3,311470,311470,311473,0,3,0
88906,6,3,311476,311476,311479,0,3,3
88907,3,2,311479,311479,311481,0,2,0
88908,6,3,311485,311485,311488,0,3,4
88909,1,1,311486,311488,311489,2,3,0
88910,3,2,311489,311489,311491,0,2,0
88911,3,1,311492,311492,311493,0,1,1
88912,6,2,311498,311498,311500,0,2,5
88913,2,3,311500,311500,311503,0,3,0
88914,1,2,311501,311503,311505,2,4,0
88915,5,1,311506,311506,311507,0,1,1
88916,1,1,311507,311507,311508,0,1,0
88917,6,2,311513,311513,311515,0,2,5
88918,1,1,311514,311515,311516,1,2,0
88919,5,1,311519,311519,311520,0,1,3
88920,1,3,311520,311520,311523,0,3,0
88921,3,3,311523,311523,311526,0,3,0
88922,5,1,311528,311528,311529,0,1,2
88923,5,3,311533,311533,311536,0,3,4
88924,2,3,311535,311536,311539,1,4,0
88925,6,3,311541,311541,311544,0,3,2
88926,2,2,311543,311544,311546,1,3,0
88927,4,2,311547,311547,311549,0,2,1
88928,2,1,311549,311549,311550,0,1,0
88929,2,1,311551,311551,311552,0,1,1
88930,2,2,311553,311553,311555,0,2,1
88931,6,1,311559,311559,311560,0,1,4
88932,5,1,311564,311564,311565,0,1,4
88933,4,3,311568,311568,311571,0,3,3
88934,4,3,311572,311572,311575,0,3,1
88935,6,3,311578,311578,311581,0,3,3
88936,5,3,311583,311583,311586,0,3,2
88937,6,3,311589,311589,311592,0,3,3
88938,4,3,311593,311593,311596,0,3,1
88939,3,3,311596,311596,311599,0,3,0
88940,6,2,311602,311602,311604,0,2,3
88941,2,1,311604,311604,311605,0,1,0
88942,4,1,311608,311608,311609,0,1,3
88943,1,2,311609,311609,311611,0,2,0
88944,5,3,311614,311614,311617,0,3,3
88945,4,3,311618,311618,311621,0,3,1
88946,3,3,311621,311621,311624,0,3,0
88947,2,3,311623,311624,311627,1,4,0
88948,1,1,311624,311627,311628,3,4,0
88949,1,1,311625,311628,311629,3,4,0
88950,6,1,311631,311631,311632,0,1,2
88951,2,2,311633,311633,311635,0,2,1
88952,6,3,311639,311639,311642,0,3,4
88953,2,3,311641,311642,311645,1,4,0
88954,5,1,311646,311646,311647,0,1,1
88955,4,1,311650,311650,311651,0,1,3
88956,6,2,311656,311656,311658,0,2,5
88957,6,3,311662,311662,311665,0,3,4
88958,3,2,311665,311665,311667,0,2,0
88959,5,2,311670,311670,311672,0,2,3
88960,3,2,311673,311673,311675,0,2,1
88961,5,1,311678,311678,311679,0,1,3
88962,4,1,311682,311682,311683,0,1,3
88963,5,2,311687,311687,311689,0,2,4
88964,3,2,311690,311690,311692,0,2,1
88965,1,3,311691,311692,311695,1,4,0
88966,5,3,311696,311696,311699,0,3,1
88967,4,2,311700,311700,311702,0,2,1
88968,3,1,311703,311703,311704,0,1,1
88969,6,2,311709,311709,311711,0,2,5
88970,2,3,311711,311711,311714,0,3,0
88971,3,2,311714,311714,311716,0,2,0
88972,6,3,311720,311720,311723,0,3,4
88973,2,1,311722,311723,311724,1,2,0
88974,5,3,311727,311727,311730,0,3,3
88975,5,1,311732,311732,311733,0,1,2
88976,1,2,311733,311733,311735,0,2,0
88977,2,2,311735,311735,311737,0,2,0
88978,3,1,311738,311738,311739,0,1,1
88979,4,1,311742,311742,311743,0,1,3
88980,4,2,311746,311746,311748,0,2,3
88981,2,2,311748,311748,311750,0,2,0
88982,5,2,311753,311753,311755,0,2,3
88983,6,1,311759,311759,311760,0,1,4
88984,2,1,311761,311761,311762,0,1,1
88985,2,2,311763,311763,311765,0,2,1
88986,1,3,311764,311765,311768,1,4,0
88987,1,1,311765,311768,311769,3,4,0
88988,3,1,311768,311769,311770,1,2,0
88989,4,2,311772,311772,311774,0,2,2
88990,6,3,311778,311778,311781,0,3,4
88991,4,3,311782,311782,311785,0,3,1
88992,3,1,311785,311785,311786,0,1,0
88993,4,2,311789,311789,311791,0,2,3
88994,3,1,311792,311792,311793,0,1,1
88995,6,1,311798,311798,311799,0,1,5
88996,4,1,311802,311802,311803,0,1,3
88997,6,1,311808,311808,311809,0,1,5
88998,4,3,311812,311812,311815,0,3,3
88999,3,3,311815,311815,311818,0,3,0
89000,6,2,311821,311821,311823,0,2,3
89001,1,2,311822,311823,311825,1,3,0
89002,5,2,311827,311827,311829,0,2,2
89003,1,1,311828,311829,311830,1,2,0
89004,5,1,311833,311833,311834,0,1,3
89005,2,2,311835,311835,311837,0,2,1
89006,4,3,311839,311839,311842,0,3,2
89007,3,2,311842,311842,311844,0,2,0
89008,6,1,311848,311848,311849,0,1,4
89009,3,2,311851,311851,311853,0,2,2
89010,6,1,311857,311857,311858,0,1,4
89011,6,2,311863,311863,311865,0,2,5
89012,6,3,311869,311869,311872,0,3,4
89013,1,3,311870,311872,311875,2,5,0
89014,3,1,311873,311875,311876,2,3,0
89015,2,3,311875,311876,311879,1,4,0
89016,1,3,311876,311879,311882,3,6,0
89017,3,2,311879,311882,311884,3,5,0
89018,3,3,311882,311884,311887,2,5,0
89019,5,3,311887,311887,311890,0,3,0
89020,5,2,311892,311892,311894,0,2,2
89021,2,3,311894,311894,311897,0,3,0
89022,6,2,311900,311900,311902,0,2,3
89023,6,1,311906,311906,311907,0,1,4
89024,3,3,311909,311909,311912,0,3,2
89025,4,1,311913,311913,311914,0,1,1
89026,1,3,311914,311914,311917,0,3,0
89027,4,1,311918,311918,311919,0,1,1
89028,1,2,311919,311919,311921,0,2,0
89029,1,3,311920,311921,311924,1,4,0
89030,2,2,311922,311924,311926,2,4,0
89031,3,3,311925,311926,311929,1,4,0
89032,6,1,311931,311931,311932,0,1,2
89033,1,2,311932,311932,311934,0,2,0
89034,4,3,311936,311936,311939,0,3,2
89035,6,3,311942,311942,311945,0,3,3
89036,6,3,311948,311948,311951,0,3,3
89037,2,2,311950,311951,311953,1,3,0
89038,6,2,311956,311956,311958,0,2,3
89039,1,1,311957,311958,311959,1,2,0
89040,2,2,311959,311959,311961,0,2,0
89041,6,3,311965,311965,311968,0,3,4
89042,4,1,311969,311969,311970,0,1,1
89043,2,2,311971,311971,311973,0,2,1
89044,2,2,311973,311973,311975,0,2,0
89045,2,1,311975,311975,311976,0,1,0
89046,2,2,311977,311977,311979,0,2,1
89047,3,2,311980,311980,311982,0,2,1
89048,2,1,311982,311982,311983,0,1,0
89049,6,1,311988,311988,311989,0,1,5
89050,3,2,311991,311991,311993,0,2,2
89051,2,3,311993,311993,311996,0,3,0
89052,3,1,311996,311996,311997,0,1,0
89053,6,3,312002,312002,312005,0,3,5
89054,1,2,312003,312005,312007,2,4,0
89055,6,3,312009,312009,312012,0,3,2
89056,6,1,312015,312015,312016,0,1,3
89057,4,1,312019,312019,312020,0,1,3
89058,5,2,312024,312024,312026,0,2,4
89059,4,1,312028,312028,312029,0,1,2
89060,6,1,312034,312034,312035,0,1,5
89061,5,3,312039,312039,312042,0,3,4
89062,1,1,312040,312042,312043,2,3,0
89063,2,1,312042,312043,312044,1,2,0
89064,2,2,312044,312044,312046,0,2,0
89065,5,1,312049,312049,312050,0,1,3
89066,4,3,312053,312053,312056,0,3,3
89067,6,3,312059,312059,312062,0,3,3
89068,2,3,312061,312062,312065,1,4,0
89069,6,1,312067,312067,312068,0,1,2
89070,4,2,312071,312071,312073,0,2,3
89071,2,3,312073,312073,312076,0,3,0
89072,5,2,312078,312078,312080,0,2,2
89073,4,1,312082,312082,312083,0,1,2
89074,1,1,312083,312083,312084,0,1,0
89075,3,2,312086,312086,312088,0,2,2
89076,2,1,312088,312088,312089,0,1,0
89077,2,3,312090,312090,312093,0,3,1
89078,3,3,312093,312093,312096,0,3,0
89079,1,3,312094,312096,312099,2,5,0
89080,6,2,312100,312100,312102,0,2,1
89081,6,3,312106,312106,312109,0,3,4
89082,4,3,312110,312110,312113,0,3,1
89083,6,3,312116,312116,312119,0,3,3
89084,5,2,312121,312121,312123,0,2,2
89085,3,3,312124,312124,312127,0,3,1
89086,2,1,312126,312127,312128,1,2,0
89087,5,1,312131,312131,312132,0,1,3
89088,5,1,312136,312136,312137,0,1,4
89089,1,1,312137,312137,312138,0,1,0
89090,2,2,312139,312139,312141,0,2,1
89091,2,1,312141,312141,312142,0,1,0
89092,5,2,312146,312146,312148,0,2,4
89093,2,3,312148,312148,312151,0,3,0
89094,6,3,312154,312154,312157,0,3,3
89095,6,1,312160,312160,312161,0,1,3
89096,1,1,312161,312161,312162,0,1,0
89097,2,3,312163,312163,312166,0,3,1
89098,4,1,312167,312167,312168,0,1,1
89099,5,3,312172,312172,312175,0,3,4
89100,2,1,312174,312175,312176,1,2,0
89101,5,3,312179,312179,312182,0,3,3
89102,4,1,312183,312183,312184,0,1,1
89103,2,3,312185,312185,312188,0,3,1
89104,1,1,312186,312188,312189,2,3,0
89105,3,1,312189,312189,312190,0,1,0
89106,4,1,312193,312193,312194,0,1,3
89107,6,2,312199,312199,312201,0,2,5
89108,1,1,312200,312201,312202,1,2,0
89109,4,3,312204,312204,312207,0,3,2
89110,1,1,312205,312207,312208,2,3,0
89111,3,3,312208,312208,312211,0,3,0
89112,1,1,312209,312211,312212,2,3,0
89113,4,1,312213,312213,312214,0,1,1
89114,3,1,312216,312216,312217,0,1,2
89115,6,2,312222,312222,312224,0,2,5
89116,5,1,312227,312227,312228,0,1,3
89117,5,3,312232,312232,312235,0,3,4
89118,2,2,312234,312235,312237,1,3,0
89119,4,1,312238,312238,312239,0,1,1
89120,6,3,312244,312244,312247,0,3,5
89121,4,2,312248,312248,312250,0,2,1
89122,2,1,312250,312250,312251,0,1,0
89123,1,1,312251,312251,312252,0,1,0
89124,1,1,312252,312252,312253,0,1,0
89125,2,2,312254,312254,312256,0,2,1
89126,4,3,312258,312258,312261,0,3,2
89127,1,2,312259,312261,312263,2,4,0
89128,1,1,312260,312263,312264,3,4,0
89129,2,1,312262,312264,312265,2,3,0
89130,1,2,312263,312265,312267,2,4,0
89131,1,2,312264,312267,312269,3,5,0
89132,1,2,312265,312269,312271,4,6,0
89133,2,1,312267,312271,312272,4,5,0
89134,5,3,312272,312272,312275,0,3,0
89135,6,3,312278,312278,312281,0,3,3
89136,2,1,312280,312281,312282,1,2,0
89137,3,2,312283,312283,312285,0,2,1
89138,4,2,312287,312287,312289,0,2,2
89139,2,1,312289,312289,312290,0,1,0
89140,1,3,312290,312290,312293,0,3,0
89141,5,3,312295,312295,312298,0,3,2
89142,4,2,312299,312299,312301,0,2,1
89143,3,1,312302,312302,312303,0,1,1
89144,4,1,312306,312306,312307,0,1,3
89145,5,2,312311,312311,312313,0,2,4
89146,5,3,312316,312316,312319,0,3,3
89147,6,2,312322,312322,312324,0,2,3
89148,5,2,312327,312327,312329,0,2,3
89149,6,1,312333,312333,312334,0,1,4
89150,6,1,312339,312339,312340,0,1,5
89151,6,1,312345,312345,312346,0,1,5
89152,5,3,312350,312350,312353,0,3,4
89153,3,2,312353,312353,312355,0,2,0
89154,1,3,312354,312355,312358,1,4,0
89155,4,3,312358,312358,312361,0,3,0
89156,3,3,312361,312361,312364,0,3,0
89157,4,2,312365,312365,312367,0,2,1
89158,1,3,312366,312367,312370,1,4,0
89159,1,2,312367,312370,312372,3,5,0
89160,3,3,312370,312372,312375,2,5,0
89161,5,3,312375,312375,312378,0,3,0
89162,3,2,312378,312378,312380,0,2,0
89163,6,3,312384,312384,312387,0,3,4
89164,5,3,312389,312389,312392,0,3,2
89165,3,1,312392,312392,312393,0,1,0
89166,2,3,312394,312394,312397,0,3,1
89167,5,1,312399,312399,312400,0,1,2
89168,4,1,312403,312403,312404,0,1,3
89169,3,2,312406,312406,312408,0,2,2
89170,4,2,312410,312410,312412,0,2,2
89171,4,2,312414,312414,312416,0,2,2
89172,1,1,312415,312416,312417,1,2,0
89173,5,3,312420,312420,312423,0,3,3
89174,5,3,312425,312425,312428,0,3,2
89175,2,1,312427,312428,312429,1,2,0
89176,6,2,312433,312433,312435,0,2,4
89177,5,1,312438,312438,312439,0,1,3
89178,3,1,312441,312441,312442,0,1,2
89179,5,3,312446,312446,312449,0,3,4
89180,5,3,312451,312451,312454,0,3,2
89181,5,2,312456,312456,312458,0,2,2
89182,5,3,312461,312461,312464,0,3,3
89183,2,1,312463,312464,312465,1,2,0
89184,2,3,312465,312465,312468,0,3,0
89185,3,1,312468,312468,312469,0,1,0
89186,4,2,312472,312472,312474,0,2,3
89187,5,3,312477,312477,312480,0,3,3
89188,4,2,312481,312481,312483,0,2,1
89189,3,3,312484,312484,312487,0,3,1
89190,3,1,312487,312487,312488,0,1,0
89191,2,2,312489,312489,312491,0,2,1
89192,1,3,312490,312491,312494,1,4,0
89193,1,3,312491,312494,312497,3,6,0
89194,4,3,312495,312497,312500,2,5,0
89195,1,1,312496,312500,312501,4,5,0
89196,2,3,312498,312501,312504,3,6,0
89197,6,1,312504,312504,312505,0,1,0
89198,6,2,312510,312510,312512,0,2,5
89199,1,2,312511,312512,312514,1,3,0
89200,2,3,312513,312514,312517,1,4,0
89201,1,1,312514,312517,312518,3,4,0
89202,1,3,312515,312518,312521,3,6,0
89203,4,1,312519,312521,312522,2,3,0
89204,6,3,312525,312525,312528,0,3,3
89205,6,2,312531,312531,312533,0,2,3
89206,2,1,312533,312533,312534,0,1,0
89207,2,1,312535,312535,312536,0,1,1
89208,5,2,312540,312540,312542,0,2,4
89209,3,2,312543,312543,312545,0,2,1
89210,3,2,312546,312546,312548,0,2,1
89211,6,2,312552,312552,312554,0,2,4
89212,5,1,312557,312557,312558,0,1,3
89213,3,3,312560,312560,312563,0,3,2
89214,5,3,312565,312565,312568,0,3,2
89215,4,2,312569,312569,312571,0,2,1
89216,4,3,312573,312573,312576,0,3,2
89217,2,3,312575,312576,312579,1,4,0
89218,1,1,312576,312579,312580,3,4,0
89219,5,2,312581,312581,312583,0,2,1
89220,3,2,312584,312584,312586,0,2,1
89221,4,3,312588,312588,312591,0,3,2
89222,2,1,312590,312591,312592,1,2,0
89223,6,3,312596,312596,312599,0,3,4
89224,3,3,312599,312599,312602,0,3,0
89225,5,3,312604,312604,312607,0,3,2
89226,3,3,312607,312607,312610,0,3,0
89227,5,3,312612,312612,312615,0,3,2
89228,3,2,312615,312615,312617,0,2,0
89229,2,2,312617,312617,312619,0,2,0
89230,2,3,312619,312619,312622,0,3,0
89231,5,1,312624,312624,312625,0,1,2
89232,6,1,312630,312630,312631,0,1,5
89233,4,3,312634,312634,312637,0,3,3
89234,4,1,312638,312638,312639,0,1,1
89235,1,3,312639,312639,312642,0,3,0
89236,6,3,312645,312645,312648,0,3,3
89237,6,2,312651,312651,312653,0,2,3
89238,6,1,312657,312657,312658,0,1,4
89239,5,3,312662,312662,312665,0,3,4
89240,5,2,312667,312667,312669,0,2,2
89241,1,3,312668,312669,312672,1,4,0
89242,3,2,312671,312672,312674,1,3,0
89243,4,3,312675,312675,312678,0,3,1
89244,2,1,312677,312678,312679,1,2,0
89245,4,1,312681,312681,312682,0,1,2
89246,1,2,312682,312682,312684,0,2,0
89247,1,2,312683,312684,312686,1,3,0
89248,6,2,312689,312689,312691,0,2,3
89249,3,1,312692,312692,312693,0,1,1
89250,3,3,312695,312695,312698,0,3,2
89251,4,1,312699,312699,312700,0,1,1
89252,4,1,312703,312703,312704,0,1,3
89253,4,3,312707,312707,312710,0,3,3
89254,3,3,312710,312710,312713,0,3,0
89255,4,1,312714,312714,312715,0,1,1
89256,5,2,312719,312719,312721,0,2,4
89257,5,1,312724,312724,312725,0,1,3
89258,6,2,312730,312730,312732,0,2,5
89259,6,2,312736,312736,312738,0,2,4
89260,1,2,312737,312738,312740,1,3,0
89261,1,2,312738,312740,312742,2,4,0
89262,4,2,312742,312742,312744,0,2,0
89263,5,2,312747,312747,312749,0,2,3
89264,5,1,312752,312752,312753,0,1,3
89265,1,3,312753,312753,312756,0,3,0
89266,1,3,312754,312756,312759,2,5,0
89267,3,2,312757,312759,312761,2,4,0
89268,1,2,312758,312761,312763,3,5,0
89269,3,1,312761,312763,312764,2,3,0
89270,5,3,312766,312766,312769,0,3,2
89271,6,1,312772,312772,312773,0,1,3
89272,2,1,312774,312774,312775,0,1,1
89273,5,1,312779,312779,312780,0,1,4
89274,6,2,312785,312785,312787,0,2,5
89275,2,1,312787,312787,312788,0,1,0
89276,5,2,312792,312792,312794,0,2,4
89277,2,2,312794,312794,312796,0,2,0
89278,5,1,312799,312799,312800,0,1,3
89279,4,2,312803,312803,312805,0,2,3
89280,4,1,312807,312807,312808,0,1,2
89281,3,1,312810,312810,312811,0,1,2
89282,5,1,312815,312815,312816,0,1,4
89283,1,2,312816,312816,312818,0,2,0
89284,5,2,312821,312821,312823,0,2,3
89285,4,1,312825,312825,312826,0,1,2
89286,4,1,312829,312829,312830,0,1,3
89287,5,1,312834,312834,312835,0,1,4
89288,4,3,312838,312838,312841,0,3,3
89289,4,1,312842,312842,312843,0,1,1
89290,6,3,312848,312848,312851,0,3,5
89291,4,1,312852,312852,312853,0,1,1
89292,2,1,312854,312854,312855,0,1,1
89293,5,2,312859,312859,312861,0,2,4
89294,6,3,312865,312865,312868,0,3,4
89295,6,1,312871,312871,312872,0,1,3
89296,3,2,312874,312874,312876,0,2,2
89297,1,2,312875,312876,312878,1,3,0
89298,5,1,312880,312880,312881,0,1,2
89299,3,1,312883,312883,312884,0,1,2
89300,5,3,312888,312888,312891,0,3,4
89301,5,3,312893,312893,312896,0,3,2
89302,4,3,312897,312897,312900,0,3,1
89303,2,1,312899,312900,312901,1,2,0
89304,4,2,312903,312903,312905,0,2,2
89305,1,3,312904,312905,312908,1,4,0
89306,3,1,312907,312908,312909,1,2,0
89307,6,3,312913,312913,312916,0,3,4
89308,4,1,312917,312917,312918,0,1,1
89309,3,1,312920,312920,312921,0,1,2
89310,3,2,312923,312923,312925,0,2,2
89311,6,1,312929,312929,312930,0,1,4
89312,2,2,312931,312931,312933,0,2,1
89313,5,1,312936,312936,312937,0,1,3
89314,3,1,312939,312939,312940,0,1,2
89315,2,3,312941,312941,312944,0,3,1
89316,6,2,312947,312947,312949,0,2,3
89317,6,3,312953,312953,312956,0,3,4
89318,3,3,312956,312956,312959,0,3,0
89319,6,1,312962,312962,312963,0,1,3
89320,1,3,312963,312963,312966,0,3,0
89321,6,1,312969,312969,312970,0,1,3
89322,4,3,312973,312973,312976,0,3,3
89323,5,1,312978,312978,312979,0,1,2
89324,5,2,312983,312983,312985,0,2,4
89325,4,2,312987,312987,312989,0,2,2
89326,1,3,312988,312989,312992,1,4,0
89327,1,1,312989,312992,312993,3,4,0
89328,5,2,312994,312994,312996,0,2,1
89329,2,2,312996,312996,312998,0,2,0
89330,4,3,313000,313000,313003,0,3,2
89331,5,2,313005,313005,313007,0,2,2
89332,6,3,313011,313011,313014,0,3,4
89333,4,2,313015,313015,313017,0,2,1
89334,5,2,313020,313020,313022,0,2,3
89335,4,1,313024,313024,313025,0,1,2
89336,4,2,313028,313028,313030,0,2,3
89337,6,3,313034,313034,313037,0,3,4
89338,3,2,313037,313037,313039,0,2,0
89339,2,3,313039,313039,313042,0,3,0
89340,3,1,313042,313042,313043,0,1,0
89341,4,3,313046,313046,313049,0,3,3
89342,2,1,313048,313049,313050,1,2,0
89343,1,1,313049,313050,313051,1,2,0
89344,1,2,313050,313051,313053,1,3,0
89345,4,3,313054,313054,313057,0,3,1
89346,3,3,313057,313057,313060,0,3,0
89347,1,3,313058,313060,313063,2,5,0
89348,3,1,313061,313063,313064,2,3,0
89349,6,3,313067,313067,313070,0,3,3
89350,1,1,313068,313070,313071,2,3,0
89351,5,3,313073,313073,313076,0,3,2
89352,3,2,313076,313076,313078,0,2,0
89353,6,3,313082,313082,313085,0,3,4
89354,1,2,313083,313085,313087,2,4,0
89355,5,3,313088,313088,313091,0,3,1
89356,4,3,313092,313092,313095,0,3,1
89357,1,1,313093,313095,313096,2,3,0
89358,6,2,313099,313099,313101,0,2,3
89359,4,1,313103,313103,313104,0,1,2
89360,3,1,313106,313106,313107,0,1,2
89361,2,3,313108,313108,313111,0,3,1
89362,2,3,313110,313111,313114,1,4,0
89363,6,2,313116,313116,313118,0,2,2
89364,3,2,313119,313119,313121,0,2,1
89365,6,2,313125,313125,313127,0,2,4
89366,4,1,313129,313129,313130,0,1,2
89367,5,1,313134,313134,313135,0,1,4
89368,6,2,313140,313140,313142,0,2,5
89369,5,2,313145,313145,313147,0,2,3
89370,2,1,313147,313147,313148,0,1,0
89371,5,2,313152,313152,313154,0,2,4
89372,4,1,313156,313156,313157,0,1,2
89373,6,1,313162,313162,313163,0,1,5
89374,3,1,313165,313165,313166,0,1,2
89375,4,3,313169,313169,313172,0,3,3
89376,2,3,313171,313172,313175,1,4,0
89377,2,2,313173,313175,313177,2,4,0
89378,6,2,313179,313179,313181,0,2,2
89379,4,1,313183,313183,313184,0,1,2
89380,6,1,313189,313189,313190,0,1,5
89381,1,2,313190,313190,313192,0,2,0
89382,5,1,313195,313195,313196,0,1,3
89383,3,3,313198,313198,313201,0,3,2
89384,4,1,313202,313202,313203,0,1,1
89385,3,1,313205,313205,313206,0,1,2
89386,2,1,313207,313207,313208,0,1,1
89387,4,2,313211,313211,313213,0,2,3
89388,2,1,313213,313213,313214,0,1,0
89389,1,1,313214,313214,313215,0,1,0
89390,6,3,313220,313220,313223,0,3,5
89391,4,3,313224,313224,313227,0,3,1
89392,4,1,313228,313228,313229,0,1,1
89393,5,1,313233,313233,313234,0,1,4
89394,6,1,313239,313239,313240,0,1,5
89395,3,2,313242,313242,313244,0,2,2
89396,1,3,313243,313244,313247,1,4,0
89397,3,2,313246,313247,313249,1,3,0
89398,5,2,313251,313251,313253,0,2,2
89399,4,3,313255,313255,313258,0,3,2
89400,6,3,313261,313261,313264,0,3,3
89401,6,1,313267,313267,313268,0,1,3
89402,4,2,313271,313271,313273,0,2,3
89403,2,1,313273,313273,313274,0,1,0
89404,2,2,313275,313275,313277,0,2,1
89405,5,1,313280,313280,313281,0,1,3
89406,1,3,313281,313281,313284,0,3,0
89407,6,2,313287,313287,313289,0,2,3
89408,1,1,313288,313289,313290,1,2,0
89409,5,2,313293,313293,313295,0,2,3
89410,2,2,313295,313295,313297,0,2,0
89411,4,3,313299,313299,313302,0,3,2
89412,5,2,313304,313304,313306,0,2,2
89413,1,3,313305,313306,313309,1,4,0
89414,3,1,313308,313309,313310,1,2,0
89415,4,1,313312,313312,313313,0,1,2
89416,1,1,313313,313313,313314,0,1,0
89417,6,3,313319,313319,313322,0,3,5
89418,4,1,313323,313323,313324,0,1,1
89419,5,3,313328,313328,313331,0,3,4
89420,1,2,313329,313331,313333,2,4,0
89421,6,1,313335,313335,313336,0,1,2
89422,4,3,313339,313339,313342,0,3,3
89423,1,2,313340,313342,313344,2,4,0
89424,2,3,313342,313344,313347,2,5,0
89425,3,2,313345,313347,313349,2,4,0
89426,6,3,313351,313351,313354,0,3,2
89427,5,3,313356,313356,313359,0,3,2
89428,4,1,313360,313360,313361,0,1,1
89429,5,1,313365,313365,313366,0,1,4
89430,1,1,313366,313366,313367,0,1,0
89431,1,2,313367,313367,313369,0,2,0
89432,4,2,313371,313371,313373,0,2,2
89433,4,1,313375,313375,313376,0,1,2
89434,6,3,313381,313381,313384,0,3,5
89435,1,2,313382,313384,313386,2,4,0
89436,3,1,313385,313386,313387,1,2,0
89437,1,2,313386,313387,313389,1,3,0
89438,1,2,313387,313389,313391,2,4,0
89439,3,1,313390,313391,313392,1,2,0
89440,4,1,313394,313394,313395,0,1,2
89441,6,3,313400,313400,313403,0,3,5
89442,4,1,313404,313404,313405,0,1,1
89443,3,2,313407,313407,313409,0,2,2
89444,4,3,313411,313411,313414,0,3,2
89445,1,1,313412,313414,313415,2,3,0
89446,1,1,313413,313415,313416,2,3,0
89447,1,3,313414,313416,313419,2,5,0
89448,3,1,313417,313419,313420,2,3,0
89449,1,1,313418,313420,313421,2,3,0
89450,5,3,313423,313423,313426,0,3,2
89451,4,1,313427,313427,313428,0,1,1
89452,3,2,313430,313430,313432,0,2,2
89453,4,1,313434,313434,313435,0,1,2
89454,1,2,313435,313435,313437,0,2,0
89455,2,2,313437,313437,313439,0,2,0
89456,5,3,313442,313442,313445,0,3,3
89457,3,1,313445,313445,313446,0,1,0
89458,1,1,313446,313446,313447,0,1,0
89459,6,2,313452,313452,313454,0,2,5
89460,5,1,313457,313457,313458,0,1,3
89461,2,1,313459,313459,313460,0,1,1
89462,4,2,313463,313463,313465,0,2,3
89463,1,3,313464,313465,313468,1,4,0
89464,2,3,313466,313468,313471,2,5,0
89465,2,2,313468,313471,313473,3,5,0
89466,6,3,313474,313474,313477,0,3,1
89467,2,2,313476,313477,313479,1,3,0
89468,1,1,313477,313479,313480,2,3,0
89469,6,2,313483,313483,313485,0,2,3
89470,4,3,313487,313487,313490,0,3,2
89471,6,3,313493,313493,313496,0,3,3
89472,2,1,313495,313496,313497,1,2,0
89473,1,1,313496,313497,313498,1,2,0
89474,3,2,313499,313499,313501,0,2,1
89475,4,2,313503,313503,313505,0,2,2
89476,6,3,313509,313509,313512,0,3,4
89477,5,3,313514,313514,313517,0,3,2
89478,2,1,313516,313517,313518,1,2,0
89479,6,3,313522,313522,313525,0,3,4
89480,2,1,313524,313525,313526,1,2,0
89481,6,1,313530,313530,313531,0,1,4
89482,5,3,313535,313535,313538,0,3,4
89483,4,2,313539,313539,313541,0,2,1
89484,5,3,313544,313544,313547,0,3,3
89485,5,1,313549,313549,313550,0,1,2
89486,6,1,313555,313555,313556,0,1,5
89487,1,1,313556,313556,313557,0,1,0
89488,3,1,313559,313559,313560,0,1,2
89489,2,3,313561,313561,313564,0,3,1
89490,3,2,313564,313564,313566,0,2,0
89491,1,3,313565,313566,313569,1,4,0
89492,2,1,313567,313569,313570,2,3,0
89493,6,2,313573,313573,313575,0,2,3
89494,1,1,313574,313575,313576,1,2,0
89495,3,1,313577,313577,313578,0,1,1
89496,5,2,313582,313582,313584,0,2,4
89497,2,3,313584,313584,313587,0,3,0
89498,6,3,313590,313590,313593,0,3,3
89499,3,1,313593,313593,313594,0,1,0
89500,1,3,313594,313594,313597,0,3,0
89501,4,2,313598,313598,313600,0,2,1
89502,1,2,313599,313600,313602,1,3,0
89503,1,1,313600,313602,313603,2,3,0
89504,3,3,313603,313603,313606,0,3,0
89505,6,3,313609,313609,313612,0,3,3
89506,1,3,313610,313612,313615,2,5,0
89507,4,1,313614,313615,313616,1,2,0
89508,6,3,313620,313620,313623,0,3,4
89509,4,1,313624,313624,313625,0,1,1
89510,2,1,313626,313626,313627,0,1,1
89511,5,2,313631,313631,313633,0,2,4
89512,6,2,313637,313637,313639,0,2,4
89513,1,2,313638,313639,313641,1,3,0
89514,1,2,313639,313641,313643,2,4,0
89515,1,3,313640,313643,313646,3,6,0
89516,6,3,313646,313646,313649,0,3,0
89517,1,3,313647,313649,313652,2,5,0
89518,5,1,313652,313652,313653,0,1,0
89519,1,2,313653,313653,313655,0,2,0
89520,5,2,313658,313658,313660,0,2,3
89521,1,2,313659,313660,313662,1,3,0
89522,6,2,313665,313665,313667,0,2,3
89523,4,3,313669,313669,313672,0,3,2
89524,4,1,313673,313673,313674,0,1,1
89525,4,1,313677,313677,313678,0,1,3
89526,1,3,313678,313678,313681,0,3,0
89527,6,2,313684,313684,313686,0,2,3
89528,1,3,313685,313686,313689,1,4,0
89529,1,3,313686,313689,313692,3,6,0
89530,3,2,313689,313692,313694,3,5,0
89531,6,3,313695,313695,313698,0,3,1
89532,2,3,313697,313698,313701,1,4,0
89533,3,3,313700,313701,313704,1,4,0
89534,6,2,313706,313706,313708,0,2,2
89535,3,2,313709,313709,313711,0,2,1
89536,2,3,313711,313711,313714,0,3,0
89537,1,3,313712,313714,313717,2,5,0
89538,2,3,313714,313717,313720,3,6,0
89539,4,1,313718,313720,313721,2,3,0
89540,2,2,313720,313721,313723,1,3,0
89541,3,3,313723,313723,313726,0,3,0
89542,4,2,313727,313727,313729,0,2,1
89543,5,2,313732,313732,313734,0,2,3
89544,2,1,313734,313734,313735,0,1,0
89545,3,3,313737,313737,313740,0,3,2
89546,3,3,313740,313740,313743,0,3,0
89547,2,1,313742,313743,313744,1,2,0
89548,6,1,313748,313748,313749,0,1,4
89549,4,1,313752,313752,313753,0,1,3
89550,2,1,313754,313754,313755,0,1,1
89551,2,1,313756,313756,313757,0,1,1
89552,1,1,313757,313757,313758,0,1,0
89553,3,1,313760,313760,313761,0,1,2
89554,6,3,313766,313766,313769,0,3,5
89555,3,3,313769,313769,313772,0,3,0
89556,3,1,313772,313772,313773,0,1,0
89557,1,1,313773,313773,313774,0,1,0
89558,3,2,313776,313776,313778,0,2,2
89559,2,1,313778,313778,313779,0,1,0
89560,4,2,313782,313782,313784,0,2,3
89561,5,1,313787,313787,313788,0,1,3
89562,4,2,313791,313791,313793,0,2,3
89563,2,3,313793,313793,313796,0,3,0
89564,6,3,313799,313799,313802,0,3,3
89565,2,1,313801,313802,313803,1,2,0
89566,5,2,313806,313806,313808,0,2,3
89567,1,1,313807,313808,313809,1,2,0
89568,5,1,313812,313812,313813,0,1,3
89569,2,3,313814,313814,313817,0,3,1
89570,6,1,313820,313820,313821,0,1,3
89571,1,1,313821,313821,313822,0,1,0
89572,6,3,313827,313827,313830,0,3,5
89573,4,2,313831,313831,313833,0,2,1
89574,2,3,313833,313833,313836,0,3,0
89575,3,1,313836,313836,313837,0,1,0
89576,4,3,313840,313840,313843,0,3,3
89577,1,1,313841,313843,313844,2,3,0
89578,6,2,313847,313847,313849,0,2,3
89579,5,1,313852,313852,313853,0,1,3
89580,6,3,313858,313858,313861,0,3,5
89581,6,2,313864,313864,313866,0,2,3
89582,1,3,313865,313866,313869,1,4,0
89583,2,2,313867,313869,313871,2,4,0
89584,2,3,313869,313871,313874,2,5,0
89585,3,3,313872,313874,313877,2,5,0
89586,3,2,313875,313877,313879,2,4,0
89587,3,2,313878,313879,313881,1,3,0
89588,6,3,313884,313884,313887,0,3,3
89589,1,2,313885,313887,313889,2,4,0
89590,4,2,313889,313889,313891,0,2,0
89591,2,3,313891,313891,313894,0,3,0
89592,1,3,313892,313894,313897,2,5,0
89593,3,2,313895,313897,313899,2,4,0
89594,4,1,313899,313899,313900,0,1,0
89595,1,2,313900,313900,313902,0,2,0
89596,1,2,313901,313902,313904,1,3,0
89597,5,1,313906,313906,313907,0,1,2
89598,3,3,313909,313909,313912,0,3,2
89599,2,3,313911,313912,313915,1,4,0
89600,2,2,313913,313915,313917,2,4,0
89601,6,2,313919,313919,313921,0,2,2
89602,2,3,313921,313921,313924,0,3,0
89603,1,1,313922,313924,313925,2,3,0
89604,3,1,313925,313925,313926,0,1,0
89605,3,1,313928,313928,313929,0,1,2
89606,4,1,313932,313932,313933,0,1,3
89607,4,2,313936,313936,313938,0,2,3
89608,5,3,313941,313941,313944,0,3,3
89609,6,3,313947,313947,313950,0,3,3
89610,1,2,313948,313950,313952,2,4,0
89611,2,3,313950,313952,313955,2,5,0
89612,6,3,313956,313956,313959,0,3,1
89613,3,2,313959,313959,313961,0,2,0
89614,1,1,313960,313961,313962,1,2,0
89615,1,1,313961,313962,313963,1,2,0
89616,2,1,313963,313963,313964,0,1,0
89617,5,2,313968,313968,313970,0,2,4
89618,3,2,313971,313971,313973,0,2,1
89619,3,3,313974,313974,313977,0,3,1
89620,5,2,313979,313979,313981,0,2,2
89621,3,1,313982,313982,313983,0,1,1
89622,4,1,313986,313986,313987,0,1,3
89623,1,3,313987,313987,313990,0,3,0
89624,5,1,313992,313992,313993,0,1,2
89625,4,1,313996,313996,313997,0,1,3
89626,5,1,314001,314001,314002,0,1,4
89627,1,2,314002,314002,314004,0,2,0
89628,5,3,314007,314007,314010,0,3,3
89629,1,3,314008,314010,314013,2,5,0
89630,4,2,314012,314013,314015,1,3,0
89631,6,1,314018,314018,314019,0,1,3
89632,3,2,314021,314021,314023,0,2,2
89633,1,3,314022,314023,314026,1,4,0
89634,6,3,314028,314028,314031,0,3,2
89635,5,1,314033,314033,314034,0,1,2
89636,2,1,314035,314035,314036,0,1,1
89637,5,2,314040,314040,314042,0,2,4
89638,6,3,314046,314046,314049,0,3,4
89639,2,3,314048,314049,314052,1,4,0
89640,5,2,314053,314053,314055,0,2,1
89641,4,2,314057,314057,314059,0,2,2
89642,6,1,314063,314063,314064,0,1,4
89643,3,1,314066,314066,314067,0,1,2
89644,2,1,314068,314068,314069,0,1,1
89645,6,1,314074,314074,314075,0,1,5
89646,4,3,314078,314078,314081,0,3,3
89647,3,3,314081,314081,314084,0,3,0
89648,1,2,314082,314084,314086,2,4,0
89649,6,1,314088,314088,314089,0,1,2
89650,4,1,314092,314092,314093,0,1,3
89651,4,1,314096,314096,314097,0,1,3
89652,4,3,314100,314100,314103,0,3,3
89653,4,3,314104,314104,314107,0,3,1
89654,2,1,314106,314107,314108,1,2,0
89655,6,1,314112,314112,314113,0,1,4
89656,1,1,314113,314113,314114,0,1,0
89657,1,1,314114,314114,314115,0,1,0
89658,4,2,314118,314118,314120,0,2,3
89659,2,1,314120,314120,314121,0,1,0
89660,3,3,314123,314123,314126,0,3,2
89661,2,2,314125,314126,314128,1,3,0
89662,5,1,314130,314130,314131,0,1,2
89663,1,2,314131,314131,314133,0,2,0
89664,2,3,314133,314133,314136,0,3,0
89665,3,2,314136,314136,314138,0,2,0
89666,5,2,314141,314141,314143,0,2,3
89667,2,3,314143,314143,314146,0,3,0
89668,3,2,314146,314146,314148,0,2,0
89669,1,3,314147,314148,314151,1,4,0
89670,2,3,314149,314151,314154,2,5,0
89671,3,3,314152,314154,314157,2,5,0
89672,3,2,314155,314157,314159,2,4,0
89673,2,2,314157,314159,314161,2,4,0
89674,5,2,314162,314162,314164,0,2,1
89675,5,3,314167,314167,314170,0,3,3
89676,3,1,314170,314170,314171,0,1,0
89677,6,1,314176,314176,314177,0,1,5
89678,5,3,314181,314181,314184,0,3,4
89679,2,3,314183,314184,314187,1,4,0
89680,1,2,314184,314187,314189,3,5,0
89681,6,1,314190,314190,314191,0,1,1
89682,1,3,314191,314191,314194,0,3,0
89683,6,1,314197,314197,314198,0,1,3
89684,4,3,314201,314201,314204,0,3,3
89685,2,2,314203,314204,314206,1,3,0
89686,6,1,314209,314209,314210,0,1,3
89687,2,3,314211,314211,314214,0,3,1
89688,5,3,314216,314216,314219,0,3,2
89689,2,3,314218,314219,314222,1,4,0
89690,1,3,314219,314222,314225,3,6,0
89691,2,3,314221,314225,314228,4,7,0
89692,4,1,314225,314228,314229,3,4,0
89693,6,1,314231,314231,314232,0,1,2
89694,2,2,314233,314233,314235,0,2,1
89695,3,3,314236,314236,314239,0,3,1
89696,4,1,314240,314240,314241,0,1,1
89697,4,1,314244,314244,314245,0,1,3
89698,1,1,314245,314245,314246,0,1,0
89699,5,1,314250,314250,314251,0,1,4
89700,2,3,314252,314252,314255,0,3,1
89701,3,2,314255,314255,314257,0,2,0
89702,1,2,314256,314257,314259,1,3,0
89703,5,3,314261,314261,314264,0,3,2
89704,5,1,314266,314266,314267,0,1,2
89705,4,1,314270,314270,314271,0,1,3
89706,2,1,314272,314272,314273,0,1,1
89707,3,1,314275,314275,314276,0,1,2
89708,3,2,314278,314278,314280,0,2,2
89709,5,3,314283,314283,314286,0,3,3
89710,4,2,314287,314287,314289,0,2,1
89711,5,3,314292,314292,314295,0,3,3
89712,2,3,314294,314295,314298,1,4,0
89713,6,2,314300,314300,314302,0,2,2
89714,1,1,314301,314302,314303,1,2,0
89715,4,1,314305,314305,314306,0,1,2
89716,4,2,314309,314309,314311,0,2,3
89717,1,3,314310,314311,314314,1,4,0
89718,4,2,314314,314314,314316,0,2,0
89719,3,1,314317,314317,314318,0,1,1
89720,4,1,314321,314321,314322,0,1,3
89721,1,1,314322,314322,314323,0,1,0
89722,3,1,314325,314325,314326,0,1,2
89723,3,3,314328,314328,314331,0,3,2
89724,4,2,314332,314332,314334,0,2,1
89725,2,1,314334,314334,314335,0,1,0
89726,5,2,314339,314339,314341,0,2,4
89727,4,3,314343,314343,314346,0,3,2
89728,3,1,314346,314346,314347,0,1,0
89729,3,1,314349,314349,314350,0,1,2
89730,3,2,314352,314352,314354,0,2,2
89731,2,3,314354,314354,314357,0,3,0
89732,1,2,314355,314357,314359,2,4,0
89733,6,1,314361,314361,314362,0,1,2
89734,3,2,314364,314364,314366,0,2,2
89735,4,1,314368,314368,314369,0,1,2
89736,1,3,314369,314369,314372,0,3,0
89737,5,3,314374,314374,314377,0,3,2
89738,5,2,314379,314379,314381,0,2,2
89739,6,2,314385,314385,314387,0,2,4
89740,4,1,314389,314389,314390,0,1,2
89741,5,2,314394,314394,314396,0,2,4
89742,5,3,314399,314399,314402,0,3,3
89743,4,1,314403,314403,314404,0,1,1
89744,5,3,314408,314408,314411,0,3,4
89745,3,2,314411,314411,314413,0,2,0
89746,5,1,314416,314416,314417,0,1,3
89747,3,3,314419,314419,314422,0,3,2
89748,2,1,314421,314422,314423,1,2,0
89749,1,3,314422,314423,314426,1,4,0
89750,2,2,314424,314426,314428,2,4,0
89751,2,1,314426,314428,314429,2,3,0
89752,6,3,314432,314432,314435,0,3,3
89753,5,3,314437,314437,314440,0,3,2
89754,4,3,314441,314441,314444,0,3,1
89755,4,3,314445,314445,314448,0,3,1
89756,3,2,314448,314448,314450,0,2,0
89757,3,1,314451,314451,314452,0,1,1
89758,4,1,314455,314455,314456,0,1,3
89759,1,1,314456,314456,314457,0,1,0
89760,4,3,314460,314460,314463,0,3,3
89761,2,2,314462,314463,314465,1,3,0
89762,3,1,314465,314465,314466,0,1,0
89763,5,3,314470,314470,314473,0,3,4
89764,4,2,314474,314474,314476,0,2,1
89765,6,1,314480,314480,314481,0,1,4
89766,5,1,314485,314485,314486,0,1,4
89767,3,1,314488,314488,314489,0,1,2
89768,1,1,314489,314489,314490,0,1,0
89769,2,3,314491,314491,314494,0,3,1
89770,1,1,314492,314494,314495,2,3,0
89771,5,3,314497,314497,314500,0,3,2
89772,5,2,314502,314502,314504,0,2,2
89773,6,3,314508,314508,314511,0,3,4
89774,2,2,314510,314511,314513,1,3,0
89775,2,3,314512,314513,314516,1,4,0
89776,3,3,314515,314516,314519,1,4,0
89777,1,2,314516,314519,314521,3,5,0
89778,3,1,314519,314521,314522,2,3,0
89779,5,3,314524,314524,314527,0,3,2
89780,3,1,314527,314527,314528,0,1,0
89781,5,3,314532,314532,314535,0,3,4
89782,2,1,314534,314535,314536,1,2,0
89783,2,3,314536,314536,314539,0,3,0
89784,5,1,314541,314541,314542,0,1,2
89785,5,1,314546,314546,314547,0,1,4
89786,6,2,314552,314552,314554,0,2,5
89787,3,1,314555,314555,314556,0,1,1
89788,3,1,314558,314558,314559,0,1,2
89789,4,3,314562,314562,314565,0,3,3
89790,6,3,314568,314568,314571,0,3,3
89791,5,1,314573,314573,314574,0,1,2
89792,5,1,314578,314578,314579,0,1,4
89793,1,2,314579,314579,314581,0,2,0
89794,5,1,314584,314584,314585,0,1,3
89795,2,3,314586,314586,314589,0,3,1
89796,3,3,314589,314589,314592,0,3,0
89797,1,1,314590,314592,314593,2,3,0
89798,6,2,314596,314596,314598,0,2,3
89799,1,3,314597,314598,314601,1,4,0
89800,1,2,314598,314601,314603,3,5,0
89801,2,3,314600,314603,314606,3,6,0
89802,5,3,314605,314606,314609,1,4,0
89803,6,1,314611,314611,314612,0,1,2
89804,6,1,314617,314617,314618,0,1,5
89805,2,3,314619,314619,314622,0,3,1
89806,2,3,314621,314622,314625,1,4,0
89807,6,3,314627,314627,314630,0,3,2
89808,3,3,314630,314630,314633,0,3,0
89809,1,1,314631,314633,314634,2,3,0
89810,6,2,314637,314637,314639,0,2,3
89811,1,2,314638,314639,314641,1,3,0
89812,1,3,314639,314641,314644,2,5,0
89813,3,3,314642,314644,314647,2,5,0
89814,2,2,314644,314647,314649,3,5,0
89815,2,1,314646,314649,314650,3,4,0
89816,4,1,314650,314650,314651,0,1,0
89817,5,3,314655,314655,314658,0,3,4
89818,4,1,314659,314659,314660,0,1,1
89819,1,3,314660,314660,314663,0,3,0
89820,4,3,314664,314664,314667,0,3,1
89821,2,1,314666,314667,314668,1,2,0
89822,5,3,314671,314671,314674,0,3,3
89823,4,1,314675,314675,314676,0,1,1
89824,4,2,314679,314679,314681,0,2,3
89825,5,2,314684,314684,314686,0,2,3
89826,4,3,314688,314688,314691,0,3,2
89827,6,2,314694,314694,314696,0,2,3
89828,1,1,314695,314696,314697,1,2,0
89829,2,2,314697,314697,314699,0,2,0
89830,2,1,314699,314699,314700,0,1,0
89831,4,2,314703,314703,314705,0,2,3
89832,5,1,314708,314708,314709,0,1,3
89833,4,3,314712,314712,314715,0,3,3
89834,6,3,314718,314718,314721,0,3,3
89835,3,1,314721,314721,314722,0,1,0
89836,1,3,314722,314722,314725,0,3,0
89837,3,2,314725,314725,314727,0,2,0
89838,5,3,314730,314730,314733,0,3,3
89839,2,3,314732,314733,314736,1,4,0
89840,1,1,314733,314736,314737,3,4,0
89841,1,3,314734,314737,314740,3,6,0
89842,5,1,314739,314740,314741,1,2,0
89843,1,1,314740,314741,314742,1,2,0
89844,3,2,314743,314743,314745,0,2,1
89845,2,2,314745,314745,314747,0,2,0
89846,3,2,314748,314748,314750,0,2,1
89847,2,3,314750,314750,314753,0,3,0
89848,5,2,314755,314755,314757,0,2,2
89849,2,1,314757,314757,314758,0,1,0
89850,3,2,314760,314760,314762,0,2,2
89851,6,2,314766,314766,314768,0,2,4
89852,4,2,314770,314770,314772,0,2,2
89853,6,1,314776,314776,314777,0,1,4
89854,1,3,314777,314777,314780,0,3,0
89855,1,3,314778,314780,314783,2,5,0
89856,3,2,314781,314783,314785,2,4,0
89857,1,2,314782,314785,314787,3,5,0
89858,3,1,314785,314787,314788,2,3,0
89859,6,1,314791,314791,314792,0,1,3
89860,4,3,314795,314795,314798,0,3,3
89861,6,3,314801,314801,314804,0,3,3
89862,3,2,314804,314804,314806,0,2,0
89863,2,2,314806,314806,314808,0,2,0
89864,5,3,314811,314811,314814,0,3,3
89865,2,2,314813,314814,314816,1,3,0
89866,3,1,314816,314816,314817,0,1,0
89867,5,3,314821,314821,314824,0,3,4
89868,5,1,314826,314826,314827,0,1,2
89869,6,2,314832,314832,314834,0,2,5
89870,1,2,314833,314834,314836,1,3,0
89871,5,3,314838,314838,314841,0,3,2
89872,1,1,314839,314841,314842,2,3,0
89873,2,3,314841,314842,314845,1,4,0
89874,3,1,314844,314845,314846,1,2,0
89875,3,2,314847,314847,314849,0,2,1
89876,2,2,314849,314849,314851,0,2,0
89877,6,2,314855,314855,314857,0,2,4
89878,6,3,314861,314861,314864,0,3,4
89879,3,3,314864,314864,314867,0,3,0
89880,5,3,314869,314869,314872,0,3,2
89881,2,2,314871,314872,314874,1,3,0
89882,6,3,314877,314877,314880,0,3,3
89883,1,3,314878,314880,314883,2,5,0
89884,4,2,314882,314883,314885,1,3,0
89885,1,3,314883,314885,314888,2,5,0
89886,3,3,314886,314888,314891,2,5,0
89887,5,2,314891,314891,314893,0,2,0
89888,6,1,314897,314897,314898,0,1,4
89889,1,2,314898,314898,314900,0,2,0
89890,4,2,314902,314902,314904,0,2,2
89891,3,3,314905,314905,314908,0,3,1
89892,5,3,314910,314910,314913,0,3,2
89893,4,3,314914,314914,314917,0,3,1
89894,2,1,314916,314917,314918,1,2,0
89895,3,2,314919,314919,314921,0,2,1
89896,2,2,314921,314921,314923,0,2,0
89897,1,1,314922,314923,314924,1,2,0
89898,6,1,314928,314928,314929,0,1,4
89899,3,3,314931,314931,314934,0,3,2
89900,4,3,314935,314935,314938,0,3,1
89901,3,1,314938,314938,314939,0,1,0
89902,2,1,314940,314940,314941,0,1,1
89903,3,3,314943,314943,314946,0,3,2
89904,5,3,314948,314948,314951,0,3,2
89905,1,1,314949,314951,314952,2,3,0
89906,5,3,314954,314954,314957,0,3,2
89907,2,3,314956,314957,314960,1,4,0
89908,5,2,314961,314961,314963,0,2,1
89909,3,1,314964,314964,314965,0,1,1
89910,3,3,314967,314967,314970,0,3,2
89911,2,2,314969,314970,314972,1,3,0
89912,4,2,314973,314973,314975,0,2,1
89913,1,1,314974,314975,314976,1,2,0
89914,6,3,314980,314980,314983,0,3,4
89915,1,1,314981,314983,314984,2,3,0
89916,2,3,314983,314984,314987,1,4,0
89917,3,2,314986,314987,314989,1,3,0
89918,3,1,314989,314989,314990,0,1,0
89919,2,2,314991,314991,314993,0,2,1
89920,4,1,314995,314995,314996,0,1,2
89921,2,3,314997,314997,315000,0,3,1
89922,5,2,315002,315002,315004,0,2,2
89923,2,2,315004,315004,315006,0,2,0
89924,5,1,315009,315009,315010,0,1,3
89925,1,3,315010,315010,315013,0,3,0
89926,2,3,315012,315013,315016,1,4,0
89927,5,1,315017,315017,315018,0,1,1
89928,6,1,315023,315023,315024,0,1,5
89929,5,2,315028,315028,315030,0,2,4
89930,4,2,315032,315032,315034,0,2,2
89931,4,2,315036,315036,315038,0,2,2
89932,6,1,315042,315042,315043,0,1,4
89933,3,1,315045,315045,315046,0,1,2
89934,3,1,315048,315048,315049,0,1,2
89935,2,2,315050,315050,315052,0,2,1
89936,3,2,315053,315053,315055,0,2,1
89937,5,1,315058,315058,315059,0,1,3
89938,4,1,315062,315062,315063,0,1,3
89939,1,1,315063,315063,315064,0,1,0
89940,1,1,315064,315064,315065,0,1,0
89941,2,2,315066,315066,315068,0,2,1
89942,6,1,315072,315072,315073,0,1,4
89943,5,2,315077,315077,315079,0,2,4
89944,5,3,315082,315082,315085,0,3,3
89945,3,1,315085,315085,315086,0,1,0
89946,1,1,315086,315086,315087,0,1,0
89947,6,2,315092,315092,315094,0,2,5
89948,1,1,315093,315094,315095,1,2,0
89949,3,3,315096,315096,315099,0,3,1
89950,4,1,315100,315100,315101,0,1,1
89951,3,2,315103,315103,315105,0,2,2
89952,1,1,315104,315105,315106,1,2,0
89953,4,3,315108,315108,315111,0,3,2
89954,2,1,315110,315111,315112,1,2,0
89955,6,3,315116,315116,315119,0,3,4
89956,4,2,315120,315120,315122,0,2,1
89957,4,2,315124,315124,315126,0,2,2
89958,4,3,315128,315128,315131,0,3,2
89959,1,2,315129,315131,315133,2,4,0
89960,4,2,315133,315133,315135,0,2,0
89961,3,1,315136,315136,315137,0,1,1
89962,3,1,315139,315139,315140,0,1,2
89963,6,2,315145,315145,315147,0,2,5
89964,2,1,315147,315147,315148,0,1,0
89965,5,1,315152,315152,315153,0,1,4
89966,5,3,315157,315157,315160,0,3,4
89967,5,3,315162,315162,315165,0,3,2
89968,6,1,315168,315168,315169,0,1,3
89969,6,2,315174,315174,315176,0,2,5
89970,2,2,315176,315176,315178,0,2,0
89971,2,3,315178,315178,315181,0,3,0
89972,4,2,315182,315182,315184,0,2,1
89973,6,2,315188,315188,315190,0,2,4
89974,2,1,315190,315190,315191,0,1,0
89975,1,2,315191,315191,315193,0,2,0
89976,2,1,315193,315193,315194,0,1,0
89977,6,2,315199,315199,315201,0,2,5
89978,2,3,315201,315201,315204,0,3,0
89979,5,3,315206,315206,315209,0,3,2
89980,1,1,315207,315209,315210,2,3,0
89981,3,3,315210,315210,315213,0,3,0
89982,6,1,315216,315216,315217,0,1,3
89983,3,1,315219,315219,315220,0,1,2
89984,4,3,315223,315223,315226,0,3,3
89985,5,2,315228,315228,315230,0,2,2
89986,3,3,315231,315231,315234,0,3,1
89987,1,2,315232,315234,315236,2,4,0
89988,1,2,315233,315236,315238,3,5,0
89989,2,2,315235,315238,315240,3,5,0
89990,4,3,315239,315240,315243,1,4,0
89991,3,2,315242,315243,315245,1,3,0
89992,4,3,315246,315246,315249,0,3,1
89993,5,1,315251,315251,315252,0,1,2
89994,5,2,315256,315256,315258,0,2,4
89995,2,3,315258,315258,315261,0,3,0
89996,5,2,315263,315263,315265,0,2,2
89997,6,3,315269,315269,315272,0,3,4
89998,5,2,315274,315274,315276,0,2,2
89999,1,1,315275,315276,315277,1,2,0
90000,4,3,315279,315279,315282,0,3,2
90001,1,2,315280,315282,315284,2,4,0
90002,6,2,315286,315286,315288,0,2,2
90003,2,2,315288,315288,315290,0,2,0
90004,4,1,315292,315292,315293,0,1,2
90005,1,2,315293,315293,315295,0,2,0
90006,4,3,315297,315297,315300,0,3,2
90007,2,2,315299,315300,315302,1,3,0
90008,2,1,315301,315302,315303,1,2,0
90009,3,1,315304,315304,315305,0,1,1
90010,2,2,315306,315306,315308,0,2,1
90011,5,2,315311,315311,315313,0,2,3
90012,5,3,315316,315316,315319,0,3,3
90013,2,1,315318,315319,315320,1,2,0
90014,2,2,315320,315320,315322,0,2,0
90015,4,2,315324,315324,315326,0,2,2
90016,1,3,315325,315326,315329,1,4,0
90017,6,2,315331,315331,315333,0,2,2
90018,1,3,315332,315333,315336,1,4,0
90019,6,1,315338,315338,315339,0,1,2
90020,4,1,315342,315342,315343,0,1,3
90021,1,3,315343,315343,315346,0,3,0
90022,6,1,315349,315349,315350,0,1,3
90023,6,2,315355,315355,315357,0,2,5
90024,1,3,315356,315357,315360,1,4,0
90025,2,2,315358,315360,315362,2,4,0
90026,2,2,315360,315362,315364,2,4,0
90027,3,1,315363,315364,315365,1,2,0
90028,1,3,315364,315365,315368,1,4,0
90029,6,2,315370,315370,315372,0,2,2
90030,6,3,315376,315376,315379,0,3,4
90031,6,2,315382,315382,315384,0,2,3
90032,2,3,315384,315384,315387,0,3,0
90033,4,3,315388,315388,315391,0,3,1
90034,4,3,315392,315392,315395,0,3,1
90035,5,1,315397,315397,315398,0,1,2
90036,1,1,315398,315398,315399,0,1,0
90037,6,2,315404,315404,315406,0,2,5
90038,3,1,315407,315407,315408,0,1,1
90039,1,1,315408,315408,315409,0,1,0
90040,1,2,315409,315409,315411,0,2,0
90041,6,1,315415,315415,315416,0,1,4
90042,3,1,315418,315418,315419,0,1,2
90043,6,3,315424,315424,315427,0,3,5
90044,4,2,315428,315428,315430,0,2,1
90045,5,2,315433,315433,315435,0,2,3
90046,1,3,315434,315435,315438,1,4,0
90047,4,1,315438,315438,315439,0,1,0
90048,6,1,315444,315444,315445,0,1,5
90049,4,1,315448,315448,315449,0,1,3
90050,2,1,315450,315450,315451,0,1,1
90051,4,3,315454,315454,315457,0,3,3
90052,4,2,315458,315458,315460,0,2,1
90053,2,3,315460,315460,315463,0,3,0
90054,5,2,315465,315465,315467,0,2,2
90055,6,1,315471,315471,315472,0,1,4
90056,3,3,315474,315474,315477,0,3,2
90057,6,3,315480,315480,315483,0,3,3
90058,5,2,315485,315485,315487,0,2,2
90059,4,2,315489,315489,315491,0,2,2
90060,2,2,315491,315491,315493,0,2,0
90061,6,2,315497,315497,315499,0,2,4
90062,4,1,315501,315501,315502,0,1,2
90063,6,2,315507,315507,315509,0,2,5
90064,5,3,315512,315512,315515,0,3,3
90065,4,3,315516,315516,315519,0,3,1
90066,5,3,315521,315521,315524,0,3,2
90067,6,3,315527,315527,315530,0,3,3
90068,4,1,315531,315531,315532,0,1,1
90069,6,3,315537,315537,315540,0,3,5
90070,5,2,315542,315542,315544,0,2,2
90071,2,1,315544,315544,315545,0,1,0
90072,4,2,315548,315548,315550,0,2,3
90073,3,2,315551,315551,315553,0,2,1
90074,4,2,315555,315555,315557,0,2,2
90075,4,2,315559,315559,315561,0,2,2
90076,5,1,315564,315564,315565,0,1,3
90077,5,3,315569,315569,315572,0,3,4
90078,4,1,315573,315573,315574,0,1,1
90079,1,1,315574,315574,315575,0,1,0
90080,3,3,315577,315577,315580,0,3,2
90081,2,2,315579,315580,315582,1,3,0
90082,3,1,315582,315582,315583,0,1,0
90083,4,1,315586,315586,315587,0,1,3
90084,1,1,315587,315587,315588,0,1,0
90085,3,1,315590,315590,315591,0,1,2
90086,1,1,315591,315591,315592,0,1,0
90087,6,3,315597,315597,315600,0,3,5
90088,6,3,315603,315603,315606,0,3,3
90089,1,3,315604,315606,315609,2,5,0
90090,2,3,315606,315609,315612,3,6,0
90091,5,2,315611,315612,315614,1,3,0
90092,4,2,315615,315615,315617,0,2,1
90093,3,1,315618,315618,315619,0,1,1
90094,4,2,315622,315622,315624,0,2,3
90095,2,2,315624,315624,315626,0,2,0
90096,1,2,315625,315626,315628,1,3,0
90097,4,1,315629,315629,315630,0,1,1
90098,1,2,315630,315630,315632,0,2,0
90099,2,2,315632,315632,315634,0,2,0
90100,4,1,315636,315636,315637,0,1,2
90101,4,1,315640,315640,315641,0,1,3
90102,5,2,315645,315645,315647,0,2,4
90103,6,1,315651,315651,315652,0,1,4
90104,5,1,315656,315656,315657,0,1,4
90105,2,2,315658,315658,315660,0,2,1
90106,6,1,315664,315664,315665,0,1,4
90107,3,1,315667,315667,315668,0,1,2
90108,3,3,315670,315670,315673,0,3,2
90109,4,2,315674,315674,315676,0,2,1
90110,5,2,315679,315679,315681,0,2,3
90111,4,1,315683,315683,315684,0,1,2
90112,6,2,315689,315689,315691,0,2,5
90113,4,3,315693,315693,315696,0,3,2
90114,6,3,315699,315699,315702,0,3,3
90115,6,3,315705,315705,315708,0,3,3
90116,4,3,315709,315709,315712,0,3,1
90117,2,3,315711,315712,315715,1,4,0
90118,2,3,315713,315715,315718,2,5,0
90119,6,3,315719,315719,315722,0,3,1
90120,2,3,315721,315722,315725,1,4,0
90121,5,1,315726,315726,315727,0,1,1
90122,3,2,315729,315729,315731,0,2,2
90123,2,2,315731,315731,315733,0,2,0
90124,1,3,315732,315733,315736,1,4,0
90125,5,2,315737,315737,315739,0,2,1
90126,5,2,315742,315742,315744,0,2,3
90127,2,2,315744,315744,315746,0,2,0
90128,5,1,315749,315749,315750,0,1,3
90129,4,1,315753,315753,315754,0,1,3
90130,6,1,315759,315759,315760,0,1,5
90131,3,2,315762,315762,315764,0,2,2
90132,4,2,315766,315766,315768,0,2,2
90133,1,1,315767,315768,315769,1,2,0
90134,3,3,315770,315770,315773,0,3,1
90135,1,3,315771,315773,315776,2,5,0
90136,6,3,315777,315777,315780,0,3,1
90137,2,2,315779,315780,315782,1,3,0
90138,5,2,315784,315784,315786,0,2,2
90139,6,3,315790,315790,315793,0,3,4
90140,1,2,315791,315793,315795,2,4,0
90141,1,2,315792,315795,315797,3,5,0
90142,2,3,315794,315797,315800,3,6,0
90143,1,2,315795,315800,315802,5,7,0
90144,2,1,315797,315802,315803,5,6,0
90145,5,3,315802,315803,315806,1,4,0
90146,5,1,315807,315807,315808,0,1,1
90147,4,3,315811,315811,315814,0,3,3
90148,5,1,315816,315816,315817,0,1,2
90149,4,1,315820,315820,315821,0,1,3
90150,1,1,315821,315821,315822,0,1,0
90151,5,2,315826,315826,315828,0,2,4
90152,2,2,315828,315828,315830,0,2,0
90153,6,3,315834,315834,315837,0,3,4
90154,5,3,315839,315839,315842,0,3,2
90155,4,2,315843,315843,315845,0,2,1
90156,6,3,315849,315849,315852,0,3,4
90157,6,3,315855,315855,315858,0,3,3
90158,5,2,315860,315860,315862,0,2,2
90159,4,3,315864,315864,315867,0,3,2
90160,5,3,315869,315869,315872,0,3,2
90161,6,3,315875,315875,315878,0,3,3
90162,3,3,315878,315878,315881,0,3,0
90163,1,3,315879,315881,315884,2,5,0
90164,4,1,315883,315884,315885,1,2,0
90165,2,2,315885,315885,315887,0,2,0
90166,1,2,315886,315887,315889,1,3,0
90167,5,3,315891,315891,315894,0,3,2
90168,5,3,315896,315896,315899,0,3,2
90169,5,3,315901,315901,315904,0,3,2
90170,3,3,315904,315904,315907,0,3,0
90171,6,1,315910,315910,315911,0,1,3
90172,1,3,315911,315911,315914,0,3,0
90173,1,2,315912,315914,315916,2,4,0
90174,4,2,315916,315916,315918,0,2,0
90175,2,2,315918,315918,315920,0,2,0
90176,5,3,315923,315923,315926,0,3,3
90177,1,2,315924,315926,315928,2,4,0
90178,5,2,315929,315929,315931,0,2,1
90179,3,2,315932,315932,315934,0,2,1
90180,6,1,315938,315938,315939,0,1,4
90181,1,2,315939,315939,315941,0,2,0
90182,5,1,315944,315944,315945,0,1,3
90183,4,1,315948,315948,315949,0,1,3
90184,6,2,315954,315954,315956,0,2,5
90185,2,3,315956,315956,315959,0,3,0
90186,2,2,315958,315959,315961,1,3,0
90187,2,2,315960,315961,315963,1,3,0
90188,3,2,315963,315963,315965,0,2,0
90189,6,1,315969,315969,315970,0,1,4
90190,3,3,315972,315972,315975,0,3,2
90191,2,2,315974,315975,315977,1,3,0
90192,6,3,315980,315980,315983,0,3,3
90193,4,1,315984,315984,315985,0,1,1
90194,6,3,315990,315990,315993,0,3,5
90195,2,3,315992,315993,315996,1,4,0
90196,3,2,315995,315996,315998,1,3,0
90197,1,2,315996,315998,316000,2,4,0
90198,4,2,316000,316000,316002,0,2,0
90199,1,3,316001,316002,316005,1,4,0
90200,5,2,316006,316006,316008,0,2,1
90201,3,2,316009,316009,316011,0,2,1
90202,4,3,316013,316013,316016,0,3,2
90203,5,2,316018,316018,316020,0,2,2
90204,3,2,316021,316021,316023,0,2,1
90205,4,2,316025,316025,316027,0,2,2
90206,6,1,316031,316031,316032,0,1,4
90207,3,2,316034,316034,316036,0,2,2
90208,2,1,316036,316036,316037,0,1,0
90209,1,2,316037,316037,316039,0,2,0
90210,6,1,316043,316043,316044,0,1,4
90211,2,1,316045,316045,316046,0,1,1
90212,6,1,316051,316051,316052,0,1,5
90213,2,2,316053,316053,316055,0,2,1
90214,5,3,316058,316058,316061,0,3,3
90215,5,1,316063,316063,316064,0,1,2
90216,3,2,316066,316066,316068,0,2,2
90217,2,1,316068,316068,316069,0,1,0
90218,2,1,316070,316070,316071,0,1,1
90219,4,3,316074,316074,316077,0,3,3
90220,5,3,316079,316079,316082,0,3,2
90221,2,3,316081,316082,316085,1,4,0
90222,6,3,316087,316087,316090,0,3,2
90223,6,1,316093,316093,316094,0,1,3
90224,4,3,316097,316097,316100,0,3,3
90225,4,1,316101,316101,316102,0,1,1
90226,6,1,316107,316107,316108,0,1,5
90227,4,3,316111,316111,316114,0,3,3
90228,6,1,316117,316117,316118,0,1,3
90229,3,1,316120,316120,316121,0,1,2
90230,4,3,316124,316124,316127,0,3,3
90231,1,1,316125,316127,316128,2,3,0
90232,2,2,316127,316128,316130,1,3,0
90233,6,1,316133,316133,316134,0,1,3
90234,4,1,316137,316137,316138,0,1,3
90235,6,3,316143,316143,316146,0,3,5
90236,6,2,316149,316149,316151,0,2,3
90237,2,2,316151,316151,316153,0,2,0
90238,1,3,316152,316153,316156,1,4,0
90239,5,2,316157,316157,316159,0,2,1
90240,3,2,316160,316160,316162,0,2,1
90241,2,2,316162,316162,316164,0,2,0
90242,5,3,316167,316167,316170,0,3,3
90243,5,1,316172,316172,316173,0,1,2
90244,5,1,316177,316177,316178,0,1,4
90245,2,3,316179,316179,316182,0,3,1
90246,2,2,316181,316182,316184,1,3,0
90247,1,1,316182,316184,316185,2,3,0
90248,2,3,316184,316185,316188,1,4,0
90249,4,3,316188,316188,316191,0,3,0
90250,3,2,316191,316191,316193,0,2,0
90251,3,3,316194,316194,316197,0,3,1
90252,3,2,316197,316197,316199,0,2,0
90253,3,3,316200,316200,316203,0,3,1
90254,6,3,316206,316206,316209,0,3,3
90255,1,1,316207,316209,316210,2,3,0
90256,1,3,316208,316210,316213,2,5,0
90257,2,1,316210,316213,316214,3,4,0
90258,2,3,316212,316214,316217,2,5,0
90259,5,3,316217,316217,316220,0,3,0
90260,3,3,316220,316220,316223,0,3,0
90261,2,2,316222,316223,316225,1,3,0
90262,5,1,316227,316227,316228,0,1,2
90263,1,3,316228,316228,316231,0,3,0
90264,2,3,316230,316231,316234,1,4,0
90265,4,3,316234,316234,316237,0,3,0
90266,5,2,316239,316239,316241,0,2,2
90267,6,2,316245,316245,316247,0,2,4
90268,3,3,316248,316248,316251,0,3,1
90269,5,2,316253,316253,316255,0,2,2
90270,6,3,316259,316259,316262,0,3,4
90271,5,1,316264,316264,316265,0,1,2
90272,6,1,316270,316270,316271,0,1,5
90273,1,3,316271,316271,316274,0,3,0
90274,1,2,316272,316274,316276,2,4,0
90275,1,2,316273,316276,316278,3,5,0
90276,6,3,316279,316279,316282,0,3,1
90277,4,3,316283,316283,316286,0,3,1
90278,6,1,316289,316289,316290,0,1,3
90279,2,3,316291,316291,316294,0,3,1
90280,3,1,316294,316294,316295,0,1,0
90281,3,2,316297,316297,316299,0,2,2
90282,4,3,316301,316301,316304,0,3,2
90283,2,3,316303,316304,316307,1,4,0
90284,1,1,316304,316307,316308,3,4,0
90285,3,1,316307,316308,316309,1,2,0
90286,1,3,316308,316309,316312,1,4,0
90287,6,1,316314,316314,316315,0,1,2
90288,6,3,316320,316320,316323,0,3,5
90289,1,3,316321,316323,316326,2,5,0
90290,3,2,316324,316326,316328,2,4,0
90291,1,2,316325,316328,316330,3,5,0
90292,4,1,316329,316330,316331,1,2,0
90293,3,1,316332,316332,316333,0,1,1
90294,2,2,316334,316334,316336,0,2,1
90295,3,3,316337,316337,316340,0,3,1
90296,5,2,316342,316342,316344,0,2,2
90297,1,3,316343,316344,316347,1,4,0
90298,3,1,316346,316347,316348,1,2,0
90299,4,2,316350,316350,316352,0,2,2
90300,5,1,316355,316355,316356,0,1,3
90301,6,1,316361,316361,316362,0,1,5
90302,3,1,316364,316364,316365,0,1,2
90303,6,1,316370,316370,316371,0,1,5
90304,6,1,316376,316376,316377,0,1,5
90305,4,3,316380,316380,316383,0,3,3
90306,5,2,316385,316385,316387,0,2,2
90307,6,2,316391,316391,316393,0,2,4
90308,1,3,316392,316393,316396,1,4,0
90309,4,2,316396,316396,316398,0,2,0
90310,2,1,316398,316398,316399,0,1,0
90311,1,2,316399,316399,316401,0,2,0
90312,3,1,316402,316402,316403,0,1,1
90313,2,1,316404,316404,316405,0,1,1
90314,5,2,316409,316409,316411,0,2,4
90315,3,2,316412,316412,316414,0,2,1
90316,3,1,316415,316415,316416,0,1,1
90317,1,1,316416,316416,316417,0,1,0
90318,4,3,316420,316420,316423,0,3,3
90319,4,3,316424,316424,316427,0,3,1
90320,1,2,316425,316427,316429,2,4,0
90321,5,3,316430,316430,316433,0,3,1
90322,3,2,316433,316433,316435,0,2,0
90323,4,1,316437,316437,316438,0,1,2
90324,5,3,316442,316442,316445,0,3,4
90325,5,3,316447,316447,316450,0,3,2
90326,5,3,316452,316452,316455,0,3,2
90327,6,2,316458,316458,316460,0,2,3
90328,6,2,316464,316464,316466,0,2,4
90329,2,3,316466,316466,316469,0,3,0
90330,4,1,316470,316470,316471,0,1,1
90331,3,1,316473,316473,316474,0,1,2
90332,5,1,316478,316478,316479,0,1,4
90333,2,3,316480,316480,316483,0,3,1
90334,4,3,316484,316484,316487,0,3,1
90335,5,2,316489,316489,316491,0,2,2
90336,3,2,316492,316492,316494,0,2,1
90337,5,2,316497,316497,316499,0,2,3
90338,2,1,316499,316499,316500,0,1,0
90339,6,2,316505,316505,316507,0,2,5
90340,1,2,316506,316507,316509,1,3,0
90341,1,3,316507,316509,316512,2,5,0
90342,1,2,316508,316512,316514,4,6,0
90343,5,3,316513,316514,316517,1,4,0
90344,1,1,316514,316517,316518,3,4,0
90345,2,2,316516,316518,316520,2,4,0
90346,4,3,316520,316520,316523,0,3,0
90347,2,1,316522,316523,316524,1,2,0
90348,6,2,316528,316528,316530,0,2,4
90349,3,3,316531,316531,316534,0,3,1
90350,4,3,316535,316535,316538,0,3,1
90351,4,2,316539,316539,316541,0,2,1
90352,2,2,316541,316541,316543,0,2,0
90353,6,1,316547,316547,316548,0,1,4
90354,4,3,316551,316551,316554,0,3,3
90355,3,3,316554,316554,316557,0,3,0
90356,4,2,316558,316558,316560,0,2,1
90357,2,3,316560,316560,316563,0,3,0
90358,6,3,316566,316566,316569,0,3,3
90359,2,2,316568,316569,316571,1,3,0
90360,6,3,316574,316574,316577,0,3,3
90361,5,1,316579,316579,316580,0,1,2
90362,6,3,316585,316585,316588,0,3,5
90363,5,2,316590,316590,316592,0,2,2
90364,5,3,316595,316595,316598,0,3,3
90365,2,1,316597,316598,316599,1,2,0
90366,2,2,316599,316599,316601,0,2,0
90367,6,3,316605,316605,316608,0,3,4
90368,1,2,316606,316608,316610,2,4,0
90369,5,1,316611,316611,316612,0,1,1
90370,4,1,316615,316615,316616,0,1,3
90371,1,2,316616,316616,316618,0,2,0
90372,6,1,316622,316622,316623,0,1,4
90373,6,3,316628,316628,316631,0,3,5
90374,5,3,316633,316633,316636,0,3,2
90375,1,2,316634,316636,316638,2,4,0
90376,5,1,316639,316639,316640,0,1,1
90377,3,2,316642,316642,316644,0,2,2
90378,1,3,316643,316644,316647,1,4,0
90379,5,2,316648,316648,316650,0,2,1
90380,5,2,316653,316653,316655,0,2,3
90381,5,3,316658,316658,316661,0,3,3
90382,3,1,316661,316661,316662,0,1,0
90383,3,2,316664,316664,316666,0,2,2
90384,5,1,316669,316669,316670,0,1,3
90385,5,2,316674,316674,316676,0,2,4
90386,1,2,316675,316676,316678,1,3,0
90387,2,3,316677,316678,316681,1,4,0
90388,6,3,316683,316683,316686,0,3,2
90389,3,2,316686,316686,316688,0,2,0
90390,6,1,316692,316692,316693,0,1,4
90391,1,3,316693,316693,316696,0,3,0
90392,5,1,316698,316698,316699,0,1,2
90393,3,2,316701,316701,316703,0,2,2
90394,2,2,316703,316703,316705,0,2,0
90395,5,3,316708,316708,316711,0,3,3
90396,6,2,316714,316714,316716,0,2,3
90397,3,3,316717,316717,316720,0,3,1
90398,4,3,316721,316721,316724,0,3,1
90399,4,1,316725,316725,316726,0,1,1
90400,4,1,316729,316729,316730,0,1,3
90401,3,1,316732,316732,316733,0,1,2
90402,2,2,316734,316734,316736,0,2,1
90403,4,2,316738,316738,316740,0,2,2
90404,5,3,316743,316743,316746,0,3,3
90405,4,1,316747,316747,316748,0,1,1
90406,4,3,316751,316751,316754,0,3,3
90407,4,1,316755,316755,316756,0,1,1
90408,5,2,316760,316760,316762,0,2,4
90409,4,1,316764,316764,316765,0,1,2
90410,6,3,316770,316770,316773,0,3,5
90411,3,3,316773,316773,316776,0,3,0
90412,5,1,316778,316778,316779,0,1,2
90413,5,2,316783,316783,316785,0,2,4
90414,2,3,316785,316785,316788,0,3,0
90415,4,1,316789,316789,316790,0,1,1
90416,5,2,316794,316794,316796,0,2,4
90417,3,3,316797,316797,316800,0,3,1
90418,2,1,316799,316800,316801,1,2,0
90419,2,2,316801,316801,316803,0,2,0
90420,3,2,316804,316804,316806,0,2,1
90421,4,2,316808,316808,316810,0,2,2
90422,6,2,316814,316814,316816,0,2,4
90423,2,2,316816,316816,316818,0,2,0
90424,3,1,316819,316819,316820,0,1,1
90425,6,1,316825,316825,316826,0,1,5
90426,6,1,316831,316831,316832,0,1,5
90427,6,2,316837,316837,316839,0,2,5
90428,4,3,316841,316841,316844,0,3,2
90429,6,2,316847,316847,316849,0,2,3
90430,6,2,316853,316853,316855,0,2,4
90431,4,2,316857,316857,316859,0,2,2
90432,1,2,316858,316859,316861,1,3,0
90433,3,1,316861,316861,316862,0,1,0
90434,5,1,316866,316866,316867,0,1,4
90435,2,2,316868,316868,316870,0,2,1
90436,1,1,316869,316870,316871,1,2,0
90437,5,2,316874,316874,316876,0,2,3
90438,4,2,316878,316878,316880,0,2,2
90439,3,1,316881,316881,316882,0,1,1
90440,4,2,316885,316885,316887,0,2,3
90441,6,3,316891,316891,316894,0,3,4
90442,4,3,316895,316895,316898,0,3,1
90443,1,1,316896,316898,316899,2,3,0
90444,6,3,316902,316902,316905,0,3,3
90445,6,1,316908,316908,316909,0,1,3
90446,5,2,316913,316913,316915,0,2,4
90447,4,3,316917,316917,316920,0,3,2
90448,4,2,316921,316921,316923,0,2,1
90449,6,2,316927,316927,316929,0,2,4
90450,3,1,316930,316930,316931,0,1,1
90451,1,1,316931,316931,316932,0,1,0
90452,2,1,316933,316933,316934,0,1,1
90453,5,3,316938,316938,316941,0,3,4
90454,3,2,316941,316941,316943,0,2,0
90455,2,1,316943,316943,316944,0,1,0
90456,1,3,316944,316944,316947,0,3,0
90457,2,3,316946,316947,316950,1,4,0
90458,4,1,316950,316950,316951,0,1,0
90459,1,2,316951,316951,316953,0,2,0
90460,5,1,316956,316956,316957,0,1,3
90461,6,3,316962,316962,316965,0,3,5
90462,2,1,316964,316965,316966,1,2,0
90463,4,2,316968,316968,316970,0,2,2
90464,4,3,316972,316972,316975,0,3,2
90465,4,1,316976,316976,316977,0,1,1
90466,2,2,316978,316978,316980,0,2,1
90467,1,2,316979,316980,316982,1,3,0
90468,4,1,316983,316983,316984,0,1,1
90469,2,2,316985,316985,316987,0,2,1
90470,1,3,316986,316987,316990,1,4,0
90471,5,1,316991,316991,316992,0,1,1
90472,3,3,316994,316994,316997,0,3,2
90473,4,2,316998,316998,317000,0,2,1
90474,1,1,316999,317000,317001,1,2,0
90475,1,1,317000,317001,317002,1,2,0
90476,3,3,317003,317003,317006,0,3,1
90477,2,2,317005,317006,317008,1,3,0
90478,1,2,317006,317008,317010,2,4,0
90479,3,1,317009,317010,317011,1,2,0
90480,1,3,317010,317011,317014,1,4,0
90481,4,1,317014,317014,317015,0,1,0
90482,5,1,317019,317019,317020,0,1,4
90483,4,3,317023,317023,317026,0,3,3
90484,5,2,317028,317028,317030,0,2,2
90485,3,3,317031,317031,317034,0,3,1
90486,2,1,317033,317034,317035,1,2,0
90487,5,2,317038,317038,317040,0,2,3
90488,6,1,317044,317044,317045,0,1,4
90489,1,1,317045,317045,317046,0,1,0
90490,5,2,317050,317050,317052,0,2,4
90491,6,3,317056,317056,317059,0,3,4
90492,2,1,317058,317059,317060,1,2,0
90493,5,1,317063,317063,317064,0,1,3
90494,6,1,317069,317069,317070,0,1,5
90495,5,2,317074,317074,317076,0,2,4
90496,1,2,317075,317076,317078,1,3,0
90497,5,1,317080,317080,317081,0,1,2
90498,5,3,317085,317085,317088,0,3,4
90499,1,3,317086,317088,317091,2,5,0
90500,2,1,317088,317091,317092,3,4,0
90501,6,3,317094,317094,317097,0,3,2
90502,5,2,317099,317099,317101,0,2,2
90503,6,3,317105,317105,317108,0,3,4
90504,1,3,317106,317108,317111,2,5,0
90505,2,1,317108,317111,317112,3,4,0
90506,3,1,317111,317112,317113,1,2,0
90507,1,3,317112,317113,317116,1,4,0
90508,2,1,317114,317116,317117,2,3,0
90509,2,2,317116,317117,317119,1,3,0
90510,4,1,317120,317120,317121,0,1,1
90511,1,3,317121,317121,317124,0,3,0
90512,2,3,317123,317124,317127,1,4,0
90513,5,1,317128,317128,317129,0,1,1
90514,2,3,317130,317130,317133,0,3,1
90515,4,1,317134,317134,317135,0,1,1
90516,6,2,317140,317140,317142,0,2,5
90517,6,2,317146,317146,317148,0,2,4
90518,2,2,317148,317148,317150,0,2,0
90519,4,2,317152,317152,317154,0,2,2
90520,2,2,317154,317154,317156,0,2,0
90521,5,3,317159,317159,317162,0,3,3
90522,5,3,317164,317164,317167,0,3,2
90523,2,3,317166,317167,317170,1,4,0
90524,2,3,317168,317170,317173,2,5,0
90525,1,3,317169,317173,317176,4,7,0
90526,5,1,317174,317176,317177,2,3,0
90527,3,3,317177,317177,317180,0,3,0
90528,2,2,317179,317180,317182,1,3,0
90529,3,2,317182,317182,317184,0,2,0
90530,1,3,317183,317184,317187,1,4,0
90531,1,3,317184,317187,317190,3,6,0
90532,6,2,317190,317190,317192,0,2,0
90533,6,1,317196,317196,317197,0,1,4
90534,1,3,317197,317197,317200,0,3,0
90535,1,1,317198,317200,317201,2,3,0
90536,6,3,317204,317204,317207,0,3,3
90537,1,2,317205,317207,317209,2,4,0
90538,3,1,317208,317209,317210,1,2,0
90539,3,2,317211,317211,317213,0,2,1
90540,5,2,317216,317216,317218,0,2,3
90541,1,1,317217,317218,317219,1,2,0
90542,4,1,317221,317221,317222,0,1,2
90543,3,2,317224,317224,317226,0,2,2
90544,5,2,317229,317229,317231,0,2,3
90545,3,1,317232,317232,317233,0,1,1
90546,5,3,317237,317237,317240,0,3,4
90547,1,2,317238,317240,317242,2,4,0
90548,4,1,317242,317242,317243,0,1,0
90549,5,1,317247,317247,317248,0,1,4
90550,5,1,317252,317252,317253,0,1,4
90551,2,2,317254,317254,317256,0,2,1
90552,2,2,317256,317256,317258,0,2,0
90553,6,1,317262,317262,317263,0,1,4
90554,6,3,317268,317268,317271,0,3,5
90555,5,1,317273,317273,317274,0,1,2
90556,1,3,317274,317274,317277,0,3,0
90557,2,3,317276,317277,317280,1,4,0
90558,4,3,317280,317280,317283,0,3,0
90559,3,1,317283,317283,317284,0,1,0
90560,6,1,317289,317289,317290,0,1,5
90561,5,1,317294,317294,317295,0,1,4
90562,2,2,317296,317296,317298,0,2,1
90563,3,2,317299,317299,317301,0,2,1
90564,5,2,317304,317304,317306,0,2,3
90565,5,3,317309,317309,317312,0,3,3
90566,2,1,317311,317312,317313,1,2,0
90567,1,3,317312,317313,317316,1,4,0
90568,5,1,317317,317317,317318,0,1,1
90569,3,2,317320,317320,317322,0,2,2
90570,4,3,317324,317324,317327,0,3,2
90571,1,2,317325,317327,317329,2,4,0
90572,2,2,317327,317329,317331,2,4,0
90573,6,3,317333,317333,317336,0,3,2
90574,5,1,317338,317338,317339,0,1,2
90575,5,1,317343,317343,317344,0,1,4
90576,5,1,317348,317348,317349,0,1,4
90577,2,3,317350,317350,317353,0,3,1
90578,6,3,317356,317356,317359,0,3,3
90579,3,2,317359,317359,317361,0,2,0
90580,5,1,317364,317364,317365,0,1,3
90581,6,2,317370,317370,317372,0,2,5
90582,6,1,317376,317376,317377,0,1,4
90583,2,3,317378,317378,317381,0,3,1
90584,6,1,317384,317384,317385,0,1,3
90585,4,1,317388,317388,317389,0,1,3
90586,1,1,317389,317389,317390,0,1,0
90587,6,1,317395,317395,317396,0,1,5
90588,1,3,317396,317396,317399,0,3,0
90589,6,3,317402,317402,317405,0,3,3
90590,4,3,317406,317406,317409,0,3,1
90591,1,1,317407,317409,317410,2,3,0
90592,2,2,317409,317410,317412,1,3,0
90593,3,1,317412,317412,317413,0,1,0
90594,6,2,317418,317418,317420,0,2,5
90595,3,3,317421,317421,317424,0,3,1
90596,2,1,317423,317424,317425,1,2,0
90597,6,3,317429,317429,317432,0,3,4
90598,3,1,317432,317432,317433,0,1,0
90599,2,2,317434,317434,317436,0,2,1
90600,6,3,317440,317440,317443,0,3,4
90601,2,2,317442,317443,317445,1,3,0
90602,5,3,317447,317447,317450,0,3,2
90603,1,2,317448,317450,317452,2,4,0
90604,2,3,317450,317452,317455,2,5,0
90605,6,1,317456,317456,317457,0,1,1
90606,1,2,317457,317457,317459,0,2,0
90607,2,3,317459,317459,317462,0,3,0
90608,6,3,317465,317465,317468,0,3,3
90609,5,2,317470,317470,317472,0,2,2
90610,1,3,317471,317472,317475,1,4,0
90611,5,3,317476,317476,317479,0,3,1
90612,5,1,317481,317481,317482,0,1,2
90613,2,1,317483,317483,317484,0,1,1
90614,1,1,317484,317484,317485,0,1,0
90615,4,2,317488,317488,317490,0,2,3
90616,3,3,317491,317491,317494,0,3,1
90617,6,2,317497,317497,317499,0,2,3
90618,4,3,317501,317501,317504,0,3,2
90619,3,1,317504,317504,317505,0,1,0
90620,2,3,317506,317506,317509,0,3,1
90621,6,2,317512,317512,317514,0,2,3
90622,4,2,317516,317516,317518,0,2,2
90623,5,1,317521,317521,317522,0,1,3
90624,6,3,317527,317527,317530,0,3,5
90625,2,1,317529,317530,317531,1,2,0
90626,6,2,317535,317535,317537,0,2,4
90627,1,2,317536,317537,317539,1,3,0
90628,4,3,317540,317540,317543,0,3,1
90629,1,1,317541,317543,317544,2,3,0
90630,1,3,317542,317544,317547,2,5,0
90631,4,1,317546,317547,317548,1,2,0
90632,4,1,317550,317550,317551,0,1,2
90633,4,2,317554,317554,317556,0,2,3
90634,4,1,317558,317558,317559,0,1,2
90635,6,2,317564,317564,317566,0,2,5
90636,2,3,317566,317566,317569,0,3,0
90637,2,3,317568,317569,317572,1,4,0
90638,4,3,317572,317572,317575,0,3,0
90639,5,2,317577,317577,317579,0,2,2
90640,6,2,317583,317583,317585,0,2,4
90641,2,3,317585,317585,317588,0,3,0
90642,2,3,317587,317588,317591,1,4,0
90643,2,1,317589,317591,317592,2,3,0
90644,3,2,317592,317592,317594,0,2,0
90645,2,1,317594,317594,317595,0,1,0
90646,3,3,317597,317597,317600,0,3,2
90647,2,1,317599,317600,317601,1,2,0
90648,2,2,317601,317601,317603,0,2,0
90649,3,2,317604,317604,317606,0,2,1
90650,3,2,317607,317607,317609,0,2,1
90651,2,1,317609,317609,317610,0,1,0
90652,4,2,317613,317613,317615,0,2,3
90653,3,3,317616,317616,317619,0,3,1
90654,5,3,317621,317621,317624,0,3,2
90655,5,3,317626,317626,317629,0,3,2
90656,2,1,317628,317629,317630,1,2,0
90657,6,3,317634,317634,317637,0,3,4
90658,5,3,317639,317639,317642,0,3,2
90659,6,3,317645,317645,317648,0,3,3
90660,4,2,317649,317649,317651,0,2,1
90661,5,1,317654,317654,317655,0,1,3
90662,3,2,317657,317657,317659,0,2,2
90663,1,3,317658,317659,317662,1,4,0
90664,1,3,317659,317662,317665,3,6,0
90665,5,2,317664,317665,317667,1,3,0
90666,6,2,317670,317670,317672,0,2,3
90667,4,3,317674,317674,317677,0,3,2
90668,4,3,317678,317678,317681,0,3,1
90669,3,3,317681,317681,317684,0,3,0
90670,3,1,317684,317684,317685,0,1,0
90671,1,2,317685,317685,317687,0,2,0
90672,3,2,317688,317688,317690,0,2,1
90673,1,3,317689,317690,317693,1,4,0
90674,4,3,317693,317693,317696,0,3,0
90675,3,1,317696,317696,317697,0,1,0
90676,4,1,317700,317700,317701,0,1,3
90677,6,2,317706,317706,317708,0,2,5
90678,1,3,317707,317708,317711,1,4,0
90679,3,2,317710,317711,317713,1,3,0
90680,2,2,317712,317713,317715,1,3,0
90681,4,2,317716,317716,317718,0,2,1
90682,4,1,317720,317720,317721,0,1,2
90683,4,1,317724,317724,317725,0,1,3
90684,6,1,317730,317730,317731,0,1,5
90685,5,3,317735,317735,317738,0,3,4
90686,1,1,317736,317738,317739,2,3,0
90687,2,1,317738,317739,317740,1,2,0
90688,4,1,317742,317742,317743,0,1,2
90689,1,3,317743,317743,317746,0,3,0
90690,2,2,317745,317746,317748,1,3,0
90691,5,3,317750,317750,317753,0,3,2
90692,1,1,317751,317753,317754,2,3,0
90693,2,3,317753,317754,317757,1,4,0
90694,4,3,317757,317757,317760,0,3,0
90695,6,2,317763,317763,317765,0,2,3
90696,6,2,317769,317769,317771,0,2,4
90697,6,3,317775,317775,317778,0,3,4
90698,3,3,317778,317778,317781,0,3,0
90699,3,2,317781,317781,317783,0,2,0
90700,1,3,317782,317783,317786,1,4,0
90701,3,3,317785,317786,317789,1,4,0
90702,2,2,317787,317789,317791,2,4,0
90703,2,2,317789,317791,317793,2,4,0
90704,2,3,317791,317793,317796,2,5,0
90705,5,3,317796,317796,317799,0,3,0
90706,3,1,317799,317799,317800,0,1,0
90707,6,1,317805,317805,317806,0,1,5
90708,3,2,317808,317808,317810,0,2,2
90709,6,2,317814,317814,317816,0,2,4
90710,6,1,317820,317820,317821,0,1,4
90711,4,1,317824,317824,317825,0,1,3
90712,2,2,317826,317826,317828,0,2,1
90713,6,2,317832,317832,317834,0,2,4
90714,5,2,317837,317837,317839,0,2,3
90715,6,2,317843,317843,317845,0,2,4
90716,1,2,317844,317845,317847,1,3,0
90717,3,2,317847,317847,317849,0,2,0
90718,2,1,317849,317849,317850,0,1,0
90719,4,2,317853,317853,317855,0,2,3
90720,2,1,317855,317855,317856,0,1,0
90721,6,1,317861,317861,317862,0,1,5
90722,6,2,317867,317867,317869,0,2,5
90723,5,3,317872,317872,317875,0,3,3
90724,5,2,317877,317877,317879,0,2,2
90725,6,1,317883,317883,317884,0,1,4
90726,4,3,317887,317887,317890,0,3,3
90727,3,3,317890,317890,317893,0,3,0
90728,4,1,317894,317894,317895,0,1,1
90729,2,3,317896,317896,317899,0,3,1
90730,6,2,317902,317902,317904,0,2,3
90731,5,2,317907,317907,317909,0,2,3
90732,1,3,317908,317909,317912,1,4,0
90733,6,1,317914,317914,317915,0,1,2
90734,2,2,317916,317916,317918,0,2,1
90735,3,3,317919,317919,317922,0,3,1
90736,4,2,317923,317923,317925,0,2,1
90737,6,3,317929,317929,317932,0,3,4
90738,1,2,317930,317932,317934,2,4,0
90739,1,3,317931,317934,317937,3,6,0
90740,4,3,317935,317937,317940,2,5,0
90741,4,1,317939,317940,317941,1,2,0
90742,5,2,317944,317944,317946,0,2,3
90743,2,2,317946,317946,317948,0,2,0
90744,1,3,317947,317948,317951,1,4,0
90745,5,1,317952,317952,317953,0,1,1
90746,5,3,317957,317957,317960,0,3,4
90747,4,3,317961,317961,317964,0,3,1
90748,5,3,317966,317966,317969,0,3,2
90749,4,1,317970,317970,317971,0,1,1
90750,4,1,317974,317974,317975,0,1,3
90751,1,3,317975,317975,317978,0,3,0
90752,6,3,317981,317981,317984,0,3,3
90753,3,2,317984,317984,317986,0,2,0
90754,5,1,317989,317989,317990,0,1,3
90755,1,1,317990,317990,317991,0,1,0
90756,5,2,317995,317995,317997,0,2,4
90757,5,2,318000,318000,318002,0,2,3
90758,1,3,318001,318002,318005,1,4,0
90759,4,1,318005,318005,318006,0,1,0
90760,3,2,318008,318008,318010,0,2,2
90761,4,3,318012,318012,318015,0,3,2
90762,2,2,318014,318015,318017,1,3,0
90763,4,3,318018,318018,318021,0,3,1
90764,6,1,318024,318024,318025,0,1,3
90765,6,1,318030,318030,318031,0,1,5
90766,5,1,318035,318035,318036,0,1,4
90767,3,1,318038,318038,318039,0,1,2
90768,6,2,318044,318044,318046,0,2,5
90769,3,1,318047,318047,318048,0,1,1
90770,6,2,318053,318053,318055,0,2,5
90771,2,3,318055,318055,318058,0,3,0
90772,6,1,318061,318061,318062,0,1,3
90773,4,2,318065,318065,318067,0,2,3
90774,2,1,318067,318067,318068,0,1,0
90775,2,1,318069,318069,318070,0,1,1
90776,2,2,318071,318071,318073,0,2,1
90777,1,1,318072,318073,318074,1,2,0
90778,2,3,318074,318074,318077,0,3,0
90779,4,1,318078,318078,318079,0,1,1
90780,2,1,318080,318080,318081,0,1,1
90781,6,3,318086,318086,318089,0,3,5
90782,5,1,318091,318091,318092,0,1,2
90783,3,2,318094,318094,318096,0,2,2
90784,4,1,318098,318098,318099,0,1,2
90785,4,2,318102,318102,318104,0,2,3
90786,3,3,318105,318105,318108,0,3,1
90787,5,3,318110,318110,318113,0,3,2
90788,6,1,318116,318116,318117,0,1,3
90789,4,1,318120,318120,318121,0,1,3
90790,6,3,318126,318126,318129,0,3,5
90791,2,2,318128,318129,318131,1,3,0
90792,6,3,318134,318134,318137,0,3,3
90793,2,2,318136,318137,318139,1,3,0
90794,4,2,318140,318140,318142,0,2,1
90795,3,1,318143,318143,318144,0,1,1
90796,1,2,318144,318144,318146,0,2,0
90797,5,3,318149,318149,318152,0,3,3
90798,6,2,318155,318155,318157,0,2,3
90799,4,3,318159,318159,318162,0,3,2
90800,4,3,318163,318163,318166,0,3,1
90801,5,2,318168,318168,318170,0,2,2
90802,5,1,318173,318173,318174,0,1,3
90803,4,1,318177,318177,318178,0,1,3
90804,6,3,318183,318183,318186,0,3,5
90805,4,3,318187,318187,318190,0,3,1
90806,2,1,318189,318190,318191,1,2,0
90807,2,1,318191,318191,318192,0,1,0
90808,3,3,318194,318194,318197,0,3,2
90809,5,2,318199,318199,318201,0,2,2
90810,6,1,318205,318205,318206,0,1,4
90811,6,2,318211,318211,318213,0,2,5
90812,3,1,318214,318214,318215,0,1,1
90813,2,2,318216,318216,318218,0,2,1
90814,1,1,318217,318218,318219,1,2,0
90815,5,3,318222,318222,318225,0,3,3
90816,5,1,318227,318227,318228,0,1,2
90817,2,2,318229,318229,318231,0,2,1
90818,2,2,318231,318231,318233,0,2,0
90819,3,2,318234,318234,318236,0,2,1
90820,3,2,318237,318237,318239,0,2,1
90821,4,2,318241,318241,318243,0,2,2
90822,6,3,318247,318247,318250,0,3,4
90823,1,1,318248,318250,318251,2,3,0
90824,5,2,318253,318253,318255,0,2,2
90825,6,1,318259,318259,318260,0,1,4
90826,6,2,318265,318265,318267,0,2,5
90827,4,2,318269,318269,318271,0,2,2
90828,6,1,318275,318275,318276,0,1,4
90829,2,1,318277,318277,318278,0,1,1
90830,1,3,318278,318278,318281,0,3,0
90831,1,2,318279,318281,318283,2,4,0
90832,4,2,318283,318283,318285,0,2,0
90833,6,3,318289,318289,318292,0,3,4
90834,3,1,318292,318292,318293,0,1,0
90835,6,2,318298,318298,318300,0,2,5
90836,6,1,318304,318304,318305,0,1,4
90837,3,3,318307,318307,318310,0,3,2
90838,5,1,318312,318312,318313,0,1,2
90839,5,3,318317,318317,318320,0,3,4
90840,3,1,318320,318320,318321,0,1,0
90841,6,1,318326,318326,318327,0,1,5
90842,2,2,318328,318328,318330,0,2,1
90843,1,2,318329,318330,318332,1,3,0
90844,5,3,318334,318334,318337,0,3,2
90845,5,3,318339,318339,318342,0,3,2
90846,3,2,318342,318342,318344,0,2,0
90847,3,3,318345,318345,318348,0,3,1
90848,1,2,318346,318348,318350,2,4,0
90849,6,3,318352,318352,318355,0,3,2
90850,2,2,318354,318355,318357,1,3,0
90851,3,2,318357,318357,318359,0,2,0
90852,1,1,318358,318359,318360,1,2,0
90853,2,2,318360,318360,318362,0,2,0
90854,3,2,318363,318363,318365,0,2,1
90855,1,2,318364,318365,318367,1,3,0
90856,2,1,318366,318367,318368,1,2,0
90857,6,3,318372,318372,318375,0,3,4
90858,3,2,318375,318375,318377,0,2,0
90859,1,2,318376,318377,318379,1,3,0
90860,1,1,318377,318379,318380,2,3,0
90861,4,1,318381,318381,318382,0,1,1
90862,5,3,318386,318386,318389,0,3,4
90863,3,2,318389,318389,318391,0,2,0
90864,4,1,318393,318393,318394,0,1,2
90865,3,3,318396,318396,318399,0,3,2
90866,6,2,318402,318402,318404,0,2,3
90867,2,1,318404,318404,318405,0,1,0
90868,4,2,318408,318408,318410,0,2,3
90869,4,2,318412,318412,318414,0,2,2
90870,5,2,318417,318417,318419,0,2,3
90871,6,2,318423,318423,318425,0,2,4
90872,3,1,318426,318426,318427,0,1,1
90873,2,1,318428,318428,318429,0,1,1
90874,5,2,318433,318433,318435,0,2,4
90875,6,2,318439,318439,318441,0,2,4
90876,4,1,318443,318443,318444,0,1,2
90877,3,1,318446,318446,318447,0,1,2
90878,5,3,318451,318451,318454,0,3,4
90879,2,2,318453,318454,318456,1,3,0
90880,3,3,318456,318456,318459,0,3,0
90881,6,3,318462,318462,318465,0,3,3
90882,2,1,318464,318465,318466,1,2,0
90883,5,2,318469,318469,318471,0,2,3
90884,4,1,318473,318473,318474,0,1,2
90885,3,2,318476,318476,318478,0,2,2
90886,6,1,318482,318482,318483,0,1,4
90887,1,1,318483,318483,318484,0,1,0
90888,3,3,318486,318486,318489,0,3,2
90889,6,2,318492,318492,318494,0,2,3
90890,1,1,318493,318494,318495,1,2,0
90891,1,1,318494,318495,318496,1,2,0
90892,4,3,318498,318498,318501,0,3,2
90893,3,3,318501,318501,318504,0,3,0
90894,3,2,318504,318504,318506,0,2,0
90895,6,1,318510,318510,318511,0,1,4
90896,1,2,318511,318511,318513,0,2,0
90897,3,3,318514,318514,318517,0,3,1
90898,3,3,318517,318517,318520,0,3,0
90899,4,3,318521,318521,318524,0,3,1
90900,6,1,318527,318527,318528,0,1,3
90901,5,3,318532,318532,318535,0,3,4
90902,1,1,318533,318535,318536,2,3,0
90903,1,1,318534,318536,318537,2,3,0
90904,5,2,318539,318539,318541,0,2,2
90905,2,2,318541,318541,318543,0,2,0
90906,5,1,318546,318546,318547,0,1,3
90907,3,2,318549,318549,318551,0,2,2
90908,3,2,318552,318552,318554,0,2,1
90909,6,3,318558,318558,318561,0,3,4
90910,4,1,318562,318562,318563,0,1,1
90911,4,3,318566,318566,318569,0,3,3
90912,6,1,318572,318572,318573,0,1,3
90913,3,1,318575,318575,318576,0,1,2
90914,3,1,318578,318578,318579,0,1,2
90915,4,3,318582,318582,318585,0,3,3
90916,3,1,318585,318585,318586,0,1,0
90917,2,3,318587,318587,318590,0,3,1
90918,2,3,318589,318590,318593,1,4,0
90919,5,2,318594,318594,318596,0,2,1
90920,3,2,318597,318597,318599,0,2,1
90921,2,3,318599,318599,318602,0,3,0
90922,6,1,318605,318605,318606,0,1,3
90923,1,1,318606,318606,318607,0,1,0
90924,3,3,318609,318609,318612,0,3,2
90925,1,2,318610,318612,318614,2,4,0
90926,4,3,318614,318614,318617,0,3,0
90927,4,1,318618,318618,318619,0,1,1
90928,6,3,318624,318624,318627,0,3,5
90929,2,1,318626,318627,318628,1,2,0
90930,5,1,318631,318631,318632,0,1,3
90931,3,3,318634,318634,318637,0,3,2
90932,5,3,318639,318639,318642,0,3,2
90933,5,1,318644,318644,318645,0,1,2
90934,4,3,318648,318648,318651,0,3,3
90935,1,2,318649,318651,318653,2,4,0
90936,4,1,318653,318653,318654,0,1,0
90937,2,1,318655,318655,318656,0,1,1
90938,6,3,318661,318661,318664,0,3,5
90939,5,3,318666,318666,318669,0,3,2
90940,2,2,318668,318669,318671,1,3,0
90941,4,3,318672,318672,318675,0,3,1
90942,5,2,318677,318677,318679,0,2,2
90943,6,2,318683,318683,318685,0,2,4
90944,2,3,318685,318685,318688,0,3,0
90945,3,3,318688,318688,318691,0,3,0
90946,2,3,318690,318691,318694,1,4,0
90947,6,1,318696,318696,318697,0,1,2
90948,3,1,318699,318699,318700,0,1,2
90949,6,1,318705,318705,318706,0,1,5
90950,4,2,318709,318709,318711,0,2,3
90951,2,2,318711,318711,318713,0,2,0
90952,3,3,318714,318714,318717,0,3,1
90953,3,1,318717,318717,318718,0,1,0
90954,4,3,318721,318721,318724,0,3,3
90955,2,2,318723,318724,318726,1,3,0
90956,3,2,318726,318726,318728,0,2,0
90957,5,2,318731,318731,318733,0,2,3
90958,3,2,318734,318734,318736,0,2,1
90959,4,3,318738,318738,318741,0,3,2
90960,5,3,318743,318743,318746,0,3,2
90961,1,1,318744,318746,318747,2,3,0
90962,3,3,318747,318747,318750,0,3,0
90963,2,2,318749,318750,318752,1,3,0
90964,4,1,318753,318753,318754,0,1,1
90965,1,1,318754,318754,318755,0,1,0
90966,3,3,318757,318757,318760,0,3,2
90967,6,3,318763,318763,318766,0,3,3
90968,1,2,318764,318766,318768,2,4,0
90969,6,2,318770,318770,318772,0,2,2
90970,2,3,318772,318772,318775,0,3,0
90971,1,3,318773,318775,318778,2,5,0
90972,4,3,318777,318778,318781,1,4,0
90973,4,3,318781,318781,318784,0,3,0
90974,5,3,318786,318786,318789,0,3,2
90975,1,1,318787,318789,318790,2,3,0
90976,5,1,318792,318792,318793,0,1,2
90977,6,2,318798,318798,318800,0,2,5
90978,4,3,318802,318802,318805,0,3,2
90979,1,3,318803,318805,318808,2,5,0
90980,5,1,318808,318808,318809,0,1,0
90981,1,3,318809,318809,318812,0,3,0
90982,1,2,318810,318812,318814,2,4,0
90983,6,3,318816,318816,318819,0,3,2
90984,3,1,318819,318819,318820,0,1,0
90985,1,3,318820,318820,318823,0,3,0
90986,6,2,318826,318826,318828,0,2,3
90987,3,2,318829,318829,318831,0,2,1
90988,5,2,318834,318834,318836,0,2,3
90989,4,3,318838,318838,318841,0,3,2
90990,3,3,318841,318841,318844,0,3,0
90991,1,2,318842,318844,318846,2,4,0
90992,4,3,318846,318846,318849,0,3,0
90993,3,1,318849,318849,318850,0,1,0
90994,4,2,318853,318853,318855,0,2,3
90995,6,3,318859,318859,318862,0,3,4
90996,1,1,318860,318862,318863,2,3,0
90997,4,3,318864,318864,318867,0,3,1
90998,1,3,318865,318867,318870,2,5,0
90999,4,1,318869,318870,318871,1,2,0
91000,2,3,318871,318871,318874,0,3,0
91001,2,2,318873,318874,318876,1,3,0
91002,6,1,318879,318879,318880,0,1,3
91003,5,1,318884,318884,318885,0,1,4
91004,5,1,318889,318889,318890,0,1,4
91005,5,2,318894,318894,318896,0,2,4
91006,3,1,318897,318897,318898,0,1,1
91007,2,3,318899,318899,318902,0,3,1
91008,1,3,318900,318902,318905,2,5,0
91009,1,3,318901,318905,318908,4,7,0
91010,5,1,318906,318908,318909,2,3,0
91011,5,1,318911,318911,318912,0,1,2
91012,3,2,318914,318914,318916,0,2,2
91013,2,3,318916,318916,318919,0,3,0
91014,4,1,318920,318920,318921,0,1,1
91015,4,2,318924,318924,318926,0,2,3
91016,6,1,318930,318930,318931,0,1,4
91017,2,1,318932,318932,318933,0,1,1
91018,1,2,318933,318933,318935,0,2,0
91019,2,3,318935,318935,318938,0,3,0
91020,1,1,318936,318938,318939,2,3,0
91021,3,1,318939,318939,318940,0,1,0
91022,6,3,318945,318945,318948,0,3,5
91023,5,1,318950,318950,318951,0,1,2
91024,6,2,318956,318956,318958,0,2,5
91025,3,1,318959,318959,318960,0,1,1
91026,5,3,318964,318964,318967,0,3,4
91027,2,1,318966,318967,318968,1,2,0
91028,5,2,318971,318971,318973,0,2,3
91029,6,2,318977,318977,318979,0,2,4
91030,5,3,318982,318982,318985,0,3,3
91031,2,2,318984,318985,318987,1,3,0
91032,2,2,318986,318987,318989,1,3,0
91033,6,2,318992,318992,318994,0,2,3
91034,4,3,318996,318996,318999,0,3,2
91035,3,2,318999,318999,319001,0,2,0
91036,6,3,319005,319005,319008,0,3,4
91037,3,2,319008,319008,319010,0,2,0
91038,5,2,319013,319013,319015,0,2,3
91039,2,1,319015,319015,319016,0,1,0
91040,1,1,319016,319016,319017,0,1,0
91041,2,3,319018,319018,319021,0,3,1
91042,5,1,319023,319023,319024,0,1,2
91043,1,2,319024,319024,319026,0,2,0
91044,6,2,319030,319030,319032,0,2,4
91045,5,2,319035,319035,319037,0,2,3
91046,1,1,319036,319037,319038,1,2,0
91047,3,1,319039,319039,319040,0,1,1
91048,5,2,319044,319044,319046,0,2,4
91049,1,1,319045,319046,319047,1,2,0
91050,6,2,319051,319051,319053,0,2,4
91051,3,1,319054,319054,319055,0,1,1
91052,3,1,319057,319057,319058,0,1,2
91053,6,3,319063,319063,319066,0,3,5
91054,4,1,319067,319067,319068,0,1,1
91055,3,1,319070,319070,319071,0,1,2
91056,3,1,319073,319073,319074,0,1,2
91057,1,1,319074,319074,319075,0,1,0
91058,4,1,319078,319078,319079,0,1,3
91059,4,2,319082,319082,319084,0,2,3
91060,6,2,319088,319088,319090,0,2,4
91061,1,3,319089,319090,319093,1,4,0
91062,5,2,319094,319094,319096,0,2,1
91063,5,2,319099,319099,319101,0,2,3
91064,3,1,319102,319102,319103,0,1,1
91065,2,2,319104,319104,319106,0,2,1
91066,4,3,319108,319108,319111,0,3,2
91067,2,2,319110,319111,319113,1,3,0
91068,1,2,319111,319113,319115,2,4,0
91069,2,3,319113,319115,319118,2,5,0
91070,4,3,319117,319118,319121,1,4,0
91071,6,1,319123,319123,319124,0,1,2
91072,1,2,319124,319124,319126,0,2,0
91073,4,3,319128,319128,319131,0,3,2
91074,1,2,319129,319131,319133,2,4,0
91075,3,1,319132,319133,319134,1,2,0
91076,2,1,319134,319134,319135,0,1,0
91077,6,1,319140,319140,319141,0,1,5
91078,1,3,319141,319141,319144,0,3,0
91079,1,3,319142,319144,319147,2,5,0
91080,3,1,319145,319147,319148,2,3,0
91081,1,2,319146,319148,319150,2,4,0
91082,5,2,319151,319151,319153,0,2,1
91083,3,1,319154,319154,319155,0,1,1
91084,4,2,319158,319158,319160,0,2,3
91085,5,2,319163,319163,319165,0,2,3
91086,4,1,319167,319167,319168,0,1,2
91087,3,2,319170,319170,319172,0,2,2
91088,6,1,319176,319176,319177,0,1,4
91089,6,3,319182,319182,319185,0,3,5
91090,1,3,319183,319185,319188,2,5,0
91091,4,1,319187,319188,319189,1,2,0
91092,3,2,319190,319190,319192,0,2,1
91093,3,2,319193,319193,319195,0,2,1
91094,3,1,319196,319196,319197,0,1,1
91095,1,1,319197,319197,319198,0,1,0
91096,1,1,319198,319198,319199,0,1,0
91097,6,1,319204,319204,319205,0,1,5
91098,6,2,319210,319210,319212,0,2,5
91099,3,1,319213,319213,319214,0,1,1
91100,3,2,319216,319216,319218,0,2,2
91101,4,2,319220,319220,319222,0,2,2
91102,1,3,319221,319222,319225,1,4,0
91103,5,3,319226,319226,319229,0,3,1
91104,5,1,319231,319231,319232,0,1,2
91105,4,2,319235,319235,319237,0,2,3
91106,3,1,319238,319238,319239,0,1,1
91107,1,1,319239,319239,319240,0,1,0
91108,2,1,319241,319241,319242,0,1,1
91109,1,2,319242,319242,319244,0,2,0
91110,6,1,319248,319248,319249,0,1,4
91111,1,2,319249,319249,319251,0,2,0
91112,3,2,319252,319252,319254,0,2,1
91113,6,3,319258,319258,319261,0,3,4
91114,2,1,319260,319261,319262,1,2,0
91115,6,1,319266,319266,319267,0,1,4
91116,4,1,319270,319270,319271,0,1,3
91117,4,3,319274,319274,319277,0,3,3
91118,3,2,319277,319277,319279,0,2,0
91119,5,3,319282,319282,319285,0,3,3
91120,3,1,319285,319285,319286,0,1,0
91121,2,1,319287,319287,319288,0,1,1
91122,1,1,319288,319288,319289,0,1,0
91123,2,3,319290,319290,319293,0,3,1
91124,6,1,319296,319296,319297,0,1,3
91125,1,2,319297,319297,319299,0,2,0
91126,4,3,319301,319301,319304,0,3,2
91127,4,2,319305,319305,319307,0,2,1
91128,6,2,319311,319311,319313,0,2,4
91129,6,1,319317,319317,319318,0,1,4
91130,5,2,319322,319322,319324,0,2,4
91131,4,1,319326,319326,319327,0,1,2
91132,2,1,319328,319328,319329,0,1,1
91133,6,3,319334,319334,319337,0,3,5
91134,5,3,319339,319339,319342,0,3,2
91135,5,1,319344,319344,319345,0,1,2
91136,1,3,319345,319345,319348,0,3,0
91137,1,1,319346,319348,319349,2,3,0
91138,1,3,319347,319349,319352,2,5,0
91139,5,3,319352,319352,319355,0,3,0
91140,6,1,319358,319358,319359,0,1,3
91141,4,2,319362,319362,319364,0,2,3
91142,2,3,319364,319364,319367,0,3,0
91143,6,2,319370,319370,319372,0,2,3
91144,5,3,319375,319375,319378,0,3,3
91145,3,2,319378,319378,319380,0,2,0
91146,3,1,319381,319381,319382,0,1,1
91147,6,3,319387,319387,319390,0,3,5
91148,1,1,319388,319390,319391,2,3,0
91149,2,3,319390,319391,319394,1,4,0
91150,5,2,319395,319395,319397,0,2,1
91151,5,1,319400,319400,319401,0,1,3
91152,6,3,319406,319406,319409,0,3,5
91153,2,1,319408,319409,319410,1,2,0
91154,3,3,319411,319411,319414,0,3,1
91155,2,3,319413,319414,319417,1,4,0
91156,2,3,319415,319417,319420,2,5,0
91157,1,1,319416,319420,319421,4,5,0
91158,1,3,319417,319421,319424,4,7,0
91159,6,3,319423,319424,319427,1,4,0
91160,6,2,319429,319429,319431,0,2,2
91161,4,1,319433,319433,319434,0,1,2
91162,1,1,319434,319434,319435,0,1,0
91163,6,1,319440,319440,319441,0,1,5
91164,5,1,319445,319445,319446,0,1,4
91165,2,2,319447,319447,319449,0,2,1
91166,3,1,319450,319450,319451,0,1,1
91167,1,1,319451,319451,319452,0,1,0
91168,1,1,319452,319452,319453,0,1,0
91169,6,1,319458,319458,319459,0,1,5
91170,5,1,319463,319463,319464,0,1,4
91171,4,1,319467,319467,319468,0,1,3
91172,5,1,319472,319472,319473,0,1,4
91173,4,3,319476,319476,319479,0,3,3
91174,1,2,319477,319479,319481,2,4,0
91175,6,1,319483,319483,319484,0,1,2
91176,2,1,319485,319485,319486,0,1,1
91177,4,3,319489,319489,319492,0,3,3
91178,1,2,319490,319492,319494,2,4,0
91179,5,1,319495,319495,319496,0,1,1
91180,6,3,319501,319501,319504,0,3,5
91181,5,1,319506,319506,319507,0,1,2
91182,5,3,319511,319511,319514,0,3,4
91183,3,2,319514,319514,319516,0,2,0
91184,4,3,319518,319518,319521,0,3,2
91185,1,1,319519,319521,319522,2,3,0
91186,2,2,319521,319522,319524,1,3,0
91187,1,2,319522,319524,319526,2,4,0
91188,4,2,319526,319526,319528,0,2,0
91189,3,1,319529,319529,319530,0,1,1
91190,1,1,319530,319530,319531,0,1,0
91191,2,3,319532,319532,319535,0,3,1
91192,3,2,319535,319535,319537,0,2,0
91193,1,3,319536,319537,319540,1,4,0
91194,2,1,319538,319540,319541,2,3,0
91195,3,2,319541,319541,319543,0,2,0
91196,2,3,319543,319543,319546,0,3,0
91197,6,3,319549,319549,319552,0,3,3
91198,3,2,319552,319552,319554,0,2,0
91199,3,2,319555,319555,319557,0,2,1
91200,1,1,319556,319557,319558,1,2,0
91201,4,1,319560,319560,319561,0,1,2
91202,1,3,319561,319561,319564,0,3,0
91203,3,1,319564,319564,319565,0,1,0
91204,6,3,319570,319570,319573,0,3,5
91205,4,2,319574,319574,319576,0,2,1
91206,6,1,319580,319580,319581,0,1,4
91207,3,3,319583,319583,319586,0,3,2
91208,5,1,319588,319588,319589,0,1,2
91209,3,3,319591,319591,319594,0,3,2
91210,5,2,319596,319596,319598,0,2,2
91211,5,3,319601,319601,319604,0,3,3
91212,5,2,319606,319606,319608,0,2,2
91213,5,2,319611,319611,319613,0,2,3
91214,6,2,319617,319617,319619,0,2,4
91215,3,2,319620,319620,319622,0,2,1
91216,2,3,319622,319622,319625,0,3,0
91217,5,3,319627,319627,319630,0,3,2
91218,3,1,319630,319630,319631,0,1,0
91219,5,2,319635,319635,319637,0,2,4
91220,2,3,319637,319637,319640,0,3,0
91221,5,3,319642,319642,319645,0,3,2
91222,3,1,319645,319645,319646,0,1,0
91223,5,1,319650,319650,319651,0,1,4
91224,3,1,319653,319653,319654,0,1,2
91225,4,1,319657,319657,319658,0,1,3
91226,1,2,319658,319658,319660,0,2,0
91227,2,1,319660,319660,319661,0,1,0
91228,3,1,319663,319663,319664,0,1,2
91229,4,1,319667,319667,319668,0,1,3
91230,4,1,319671,319671,319672,0,1,3
91231,3,1,319674,319674,319675,0,1,2
91232,5,2,319679,319679,319681,0,2,4
91233,6,3,319685,319685,319688,0,3,4
91234,4,3,319689,319689,319692,0,3,1
91235,1,3,319690,319692,319695,2,5,0
91236,3,1,319693,319695,319696,2,3,0
91237,6,1,319699,319699,319700,0,1,3
91238,4,2,319703,319703,319705,0,2,3
91239,3,3,319706,319706,319709,0,3,1
91240,6,3,319712,319712,319715,0,3,3
91241,6,2,319718,319718,319720,0,2,3
91242,3,2,319721,319721,319723,0,2,1
91243,5,3,319726,319726,319729,0,3,3
91244,1,3,319727,319729,319732,2,5,0
91245,5,3,319732,319732,319735,0,3,0
91246,2,2,319734,319735,319737,1,3,0
91247,4,3,319738,319738,319741,0,3,1
91248,2,1,319740,319741,319742,1,2,0
91249,5,2,319745,319745,319747,0,2,3
91250,4,1,319749,319749,319750,0,1,2
91251,4,2,319753,319753,319755,0,2,3
91252,2,2,319755,319755,319757,0,2,0
91253,4,2,319759,319759,319761,0,2,2
91254,2,2,319761,319761,319763,0,2,0
91255,3,3,319764,319764,319767,0,3,1
91256,1,2,319765,319767,319769,2,4,0
91257,4,2,319769,319769,319771,0,2,0
91258,5,3,319774,319774,319777,0,3,3
91259,1,2,319775,319777,319779,2,4,0
91260,6,2,319781,319781,319783,0,2,2
91261,2,2,319783,319783,319785,0,2,0
91262,2,1,319785,319785,319786,0,1,0
91263,2,3,319787,319787,319790,0,3,1
91264,5,2,319792,319792,319794,0,2,2
91265,3,3,319795,319795,319798,0,3,1
91266,3,2,319798,319798,319800,0,2,0
91267,1,2,319799,319800,319802,1,3,0
91268,2,3,319801,319802,319805,1,4,0
91269,4,1,319805,319805,319806,0,1,0
91270,1,2,319806,319806,319808,0,2,0
91271,6,1,319812,319812,319813,0,1,4
91272,1,3,319813,319813,319816,0,3,0
91273,6,2,319819,319819,319821,0,2,3
91274,2,3,319821,319821,319824,0,3,0
91275,5,3,319826,319826,319829,0,3,2
91276,3,3,319829,319829,319832,0,3,0
91277,5,2,319834,319834,319836,0,2,2
91278,6,3,319840,319840,319843,0,3,4
91279,1,2,319841,319843,319845,2,4,0
91280,3,3,319844,319845,319848,1,4,0
91281,4,1,319848,319848,319849,0,1,0
91282,4,2,319852,319852,319854,0,2,3
91283,3,3,319855,319855,319858,0,3,1
91284,1,3,319856,319858,319861,2,5,0
91285,3,1,319859,319861,319862,2,3,0
91286,2,1,319861,319862,319863,1,2,0
91287,5,3,319866,319866,319869,0,3,3
91288,4,1,319870,319870,319871,0,1,1
91289,3,3,319873,319873,319876,0,3,2
91290,5,2,319878,319878,319880,0,2,2
91291,5,3,319883,319883,319886,0,3,3
91292,4,2,319887,319887,319889,0,2,1
91293,3,2,319890,319890,319892,0,2,1
91294,6,3,319896,319896,319899,0,3,4
91295,1,3,319897,319899,319902,2,5,0
91296,5,1,319902,319902,319903,0,1,0
91297,1,1,319903,319903,319904,0,1,0
91298,3,1,319906,319906,319907,0,1,2
91299,6,2,319912,319912,319914,0,2,5
91300,1,2,319913,319914,319916,1,3,0
91301,3,1,319916,319916,319917,0,1,0
91302,1,2,319917,319917,319919,0,2,0
91303,1,2,319918,319919,319921,1,3,0
91304,1,1,319919,319921,319922,2,3,0
91305,1,2,319920,319922,319924,2,4,0
91306,3,1,319923,319924,319925,1,2,0
91307,4,2,319927,319927,319929,0,2,2
91308,2,3,319929,319929,319932,0,3,0
91309,4,1,319933,319933,319934,0,1,1
91310,4,2,319937,319937,319939,0,2,3
91311,4,3,319941,319941,319944,0,3,2
91312,6,1,319947,319947,319948,0,1,3
91313,1,1,319948,319948,319949,0,1,0
91314,4,2,319952,319952,319954,0,2,3
91315,4,3,319956,319956,319959,0,3,2
91316,6,3,319962,319962,319965,0,3,3
91317,5,3,319967,319967,319970,0,3,2
91318,6,3,319973,319973,319976,0,3,3
91319,4,3,319977,319977,319980,0,3,1
91320,3,3,319980,319980,319983,0,3,0
91321,5,3,319985,319985,319988,0,3,2
91322,5,1,319990,319990,319991,0,1,2
91323,3,2,319993,319993,319995,0,2,2
91324,4,2,319997,319997,319999,0,2,2
91325,5,3,320002,320002,320005,0,3,3
91326,5,3,320007,320007,320010,0,3,2
91327,3,2,320010,320010,320012,0,2,0
91328,6,1,320016,320016,320017,0,1,4
91329,6,2,320022,320022,320024,0,2,5
91330,2,2,320024,320024,320026,0,2,0
91331,5,3,320029,320029,320032,0,3,3
91332,2,2,320031,320032,320034,1,3,0
91333,4,3,320035,320035,320038,0,3,1
91334,6,1,320041,320041,320042,0,1,3
91335,6,1,320047,320047,320048,0,1,5
91336,4,1,320051,320051,320052,0,1,3
91337,6,3,320057,320057,320060,0,3,5
91338,1,1,320058,320060,320061,2,3,0
91339,2,1,320060,320061,320062,1,2,0
91340,1,1,320061,320062,320063,1,2,0
91341,5,3,320066,320066,320069,0,3,3
91342,1,1,320067,320069,320070,2,3,0
91343,1,3,320068,320070,320073,2,5,0
91344,4,3,320072,320073,320076,1,4,0
91345,5,2,320077,320077,320079,0,2,1
91346,1,1,320078,320079,320080,1,2,0
91347,5,2,320083,320083,320085,0,2,3
91348,2,1,320085,320085,320086,0,1,0
91349,5,1,320090,320090,320091,0,1,4
91350,6,3,320096,320096,320099,0,3,5
91351,6,2,320102,320102,320104,0,2,3
91352,1,2,320103,320104,320106,1,3,0
91353,1,2,320104,320106,320108,2,4,0
91354,4,1,320108,320108,320109,0,1,0
91355,1,1,320109,320109,320110,0,1,0
91356,5,1,320114,320114,320115,0,1,4
91357,2,2,320116,320116,320118,0,2,1
91358,3,3,320119,320119,320122,0,3,1
91359,2,1,320121,320122,320123,1,2,0
91360,5,3,320126,320126,320129,0,3,3
91361,6,2,320132,320132,320134,0,2,3
91362,4,2,320136,320136,320138,0,2,2
91363,1,3,320137,320138,320141,1,4,0
91364,1,3,320138,320141,320144,3,6,0
91365,2,1,320140,320144,320145,4,5,0
91366,1,3,320141,320145,320148,4,7,0
91367,2,3,320143,320148,320151,5,8,0
91368,5,2,320148,320151,320153,3,5,0
91369,5,3,320153,320153,320156,0,3,0
91370,4,1,320157,320157,320158,0,1,1
91371,4,2,320161,320161,320163,0,2,3
91372,3,2,320164,320164,320166,0,2,1
91373,4,2,320168,320168,320170,0,2,2
91374,5,2,320173,320173,320175,0,2,3
91375,1,3,320174,320175,320178,1,4,0
91376,4,2,320178,320178,320180,0,2,0
91377,2,1,320180,320180,320181,0,1,0
91378,5,1,320185,320185,320186,0,1,4
91379,3,1,320188,320188,320189,0,1,2
91380,4,3,320192,320192,320195,0,3,3
91381,3,3,320195,320195,320198,0,3,0
91382,2,3,320197,320198,320201,1,4,0
91383,2,1,320199,320201,320202,2,3,0
91384,3,2,320202,320202,320204,0,2,0
91385,5,3,320207,320207,320210,0,3,3
91386,2,1,320209,320210,320211,1,2,0
91387,3,3,320212,320212,320215,0,3,1
91388,2,1,320214,320215,320216,1,2,0
91389,3,3,320217,320217,320220,0,3,1
91390,5,1,320222,320222,320223,0,1,2
91391,2,3,320224,320224,320227,0,3,1
91392,1,3,320225,320227,320230,2,5,0
91393,4,1,320229,320230,320231,1,2,0
91394,1,1,320230,320231,320232,1,2,0
91395,2,1,320232,320232,320233,0,1,0
91396,4,3,320236,320236,320239,0,3,3
91397,4,2,320240,320240,320242,0,2,1
91398,3,3,320243,320243,320246,0,3,1
91399,6,1,320249,320249,320250,0,1,3
91400,5,3,320254,320254,320257,0,3,4
91401,1,1,320255,320257,320258,2,3,0
91402,2,2,320257,320258,320260,1,3,0
91403,5,2,320262,320262,320264,0,2,2
91404,6,3,320268,320268,320271,0,3,4
91405,5,1,320273,320273,320274,0,1,2
91406,1,3,320274,320274,320277,0,3,0
91407,2,1,320276,320277,320278,1,2,0
91408,2,1,320278,320278,320279,0,1,0
91409,3,3,320281,320281,320284,0,3,2
91410,2,3,320283,320284,320287,1,4,0
91411,5,1,320288,320288,320289,0,1,1
91412,1,1,320289,320289,320290,0,1,0
91413,4,1,320293,320293,320294,0,1,3
91414,1,3,320294,320294,320297,0,3,0
91415,2,3,320296,320297,320300,1,4,0
91416,6,3,320302,320302,320305,0,3,2
91417,2,1,320304,320305,320306,1,2,0
91418,4,1,320308,320308,320309,0,1,2
91419,4,3,320312,320312,320315,0,3,3
91420,6,3,320318,320318,320321,0,3,3
91421,6,3,320324,320324,320327,0,3,3
91422,5,2,320329,320329,320331,0,2,2
91423,3,3,320332,320332,320335,0,3,1
91424,1,3,320333,320335,320338,2,5,0
91425,3,3,320336,320338,320341,2,5,0
91426,3,3,320339,320341,320344,2,5,0
91427,5,2,320344,320344,320346,0,2,0
91428,2,1,320346,320346,320347,0,1,0
91429,4,1,320350,320350,320351,0,1,3
91430,3,2,320353,320353,320355,0,2,2
91431,6,2,320359,320359,320361,0,2,4
91432,5,2,320364,320364,320366,0,2,3
91433,6,2,320370,320370,320372,0,2,4
91434,5,1,320375,320375,320376,0,1,3
91435,4,2,320379,320379,320381,0,2,3
91436,3,2,320382,320382,320384,0,2,1
91437,3,2,320385,320385,320387,0,2,1
91438,3,3,320388,320388,320391,0,3,1
91439,2,1,320390,320391,320392,1,2,0
91440,2,3,320392,320392,320395,0,3,0
91441,1,1,320393,320395,320396,2,3,0
91442,3,2,320396,320396,320398,0,2,0
91443,1,3,320397,320398,320401,1,4,0
91444,1,1,320398,320401,320402,3,4,0
91445,2,3,320400,320402,320405,2,5,0
91446,5,1,320405,320405,320406,0,1,0
91447,4,2,320409,320409,320411,0,2,3
91448,6,3,320415,320415,320418,0,3,4
91449,4,3,320419,320419,320422,0,3,1
91450,5,1,320424,320424,320425,0,1,2
91451,4,1,320428,320428,320429,0,1,3
91452,2,1,320430,320430,320431,0,1,1
91453,3,3,320433,320433,320436,0,3,2
91454,6,2,320439,320439,320441,0,2,3
91455,2,3,320441,320441,320444,0,3,0
91456,6,2,320447,320447,320449,0,2,3
91457,6,1,320453,320453,320454,0,1,4
91458,6,1,320459,320459,320460,0,1,5
91459,6,3,320465,320465,320468,0,3,5
91460,5,2,320470,320470,320472,0,2,2
91461,3,1,320473,320473,320474,0,1,1
91462,5,2,320478,320478,320480,0,2,4
91463,6,3,320484,320484,320487,0,3,4
91464,2,3,320486,320487,320490,1,4,0
91465,5,1,320491,320491,320492,0,1,1
91466,1,1,320492,320492,320493,0,1,0
91467,1,1,320493,320493,320494,0,1,0
91468,1,1,320494,320494,320495,0,1,0
91469,2,2,320496,320496,320498,0,2,1
91470,5,3,320501,320501,320504,0,3,3
91471,1,3,320502,320504,320507,2,5,0
91472,3,1,320505,320507,320508,2,3,0
91473,1,1,320506,320508,320509,2,3,0
91474,3,2,320509,320509,320511,0,2,0
91475,6,3,320515,320515,320518,0,3,4
91476,4,2,320519,320519,320521,0,2,1
91477,2,2,320521,320521,320523,0,2,0
91478,5,3,320526,320526,320529,0,3,3
91479,1,1,320527,320529,320530,2,3,0
91480,6,1,320533,320533,320534,0,1,3
91481,3,2,320536,320536,320538,0,2,2
91482,2,2,320538,320538,320540,0,2,0
91483,4,2,320542,320542,320544,0,2,2
91484,3,3,320545,320545,320548,0,3,1
91485,1,1,320546,320548,320549,2,3,0
91486,1,1,320547,320549,320550,2,3,0
91487,1,2,320548,320550,320552,2,4,0
91488,5,2,320553,320553,320555,0,2,1
91489,5,1,320558,320558,320559,0,1,3
91490,5,3,320563,320563,320566,0,3,4
91491,1,2,320564,320566,320568,2,4,0
91492,4,2,320568,320568,320570,0,2,0
91493,4,3,320572,320572,320575,0,3,2
91494,1,3,320573,320575,320578,2,5,0
91495,2,3,320575,320578,320581,3,6,0
91496,2,3,320577,320581,320584,4,7,0
91497,4,3,320581,320584,320587,3,6,0
91498,3,1,320584,320587,320588,3,4,0
91499,3,3,320587,320588,320591,1,4,0
91500,5,3,320592,320592,320595,0,3,1
91501,1,1,320593,320595,320596,2,3,0
91502,5,1,320598,320598,320599,0,1,2
91503,5,1,320603,320603,320604,0,1,4
91504,4,1,320607,320607,320608,0,1,3
91505,5,2,320612,320612,320614,0,2,4
91506,6,2,320618,320618,320620,0,2,4
91507,1,2,320619,320620,320622,1,3,0
91508,6,3,320625,320625,320628,0,3,3
91509,5,2,320630,320630,320632,0,2,2
91510,4,2,320634,320634,320636,0,2,2
91511,3,3,320637,320637,320640,0,3,1
91512,4,3,320641,320641,320644,0,3,1
91513,6,2,320647,320647,320649,0,2,3
91514,2,3,320649,320649,320652,0,3,0
91515,4,2,320653,320653,320655,0,2,1
91516,5,1,320658,320658,320659,0,1,3
91517,2,1,320660,320660,320661,0,1,1
91518,3,2,320663,320663,320665,0,2,2
91519,6,3,320669,320669,320672,0,3,4
91520,1,2,320670,320672,320674,2,4,0
91521,6,3,320676,320676,320679,0,3,2
91522,5,3,320681,320681,320684,0,3,2
91523,6,3,320687,320687,320690,0,3,3
91524,5,2,320692,320692,320694,0,2,2
91525,2,1,320694,320694,320695,0,1,0
91526,6,3,320700,320700,320703,0,3,5
91527,2,1,320702,320703,320704,1,2,0
91528,3,1,320705,320705,320706,0,1,1
91529,3,3,320708,320708,320711,0,3,2
91530,5,2,320713,320713,320715,0,2,2
91531,2,1,320715,320715,320716,0,1,0
91532,2,3,320717,320717,320720,0,3,1
91533,1,3,320718,320720,320723,2,5,0
91534,3,2,320721,320723,320725,2,4,0
91535,5,3,320726,320726,320729,0,3,1
91536,4,1,320730,320730,320731,0,1,1
91537,1,1,320731,320731,320732,0,1,0
91538,5,3,320736,320736,320739,0,3,4
91539,3,3,320739,320739,320742,0,3,0
91540,1,3,320740,320742,320745,2,5,0
91541,6,1,320746,320746,320747,0,1,1
91542,2,3,320748,320748,320751,0,3,1
91543,4,1,320752,320752,320753,0,1,1
91544,3,2,320755,320755,320757,0,2,2
91545,2,2,320757,320757,320759,0,2,0
91546,3,1,320760,320760,320761,0,1,1
91547,3,1,320763,320763,320764,0,1,2
91548,6,1,320769,320769,320770,0,1,5
91549,3,2,320772,320772,320774,0,2,2
91550,1,3,320773,320774,320777,1,4,0
91551,4,2,320777,320777,320779,0,2,0
91552,6,3,320783,320783,320786,0,3,4
91553,4,3,320787,320787,320790,0,3,1
91554,2,1,320789,320790,320791,1,2,0
91555,2,3,320791,320791,320794,0,3,0
91556,5,3,320796,320796,320799,0,3,2
91557,5,1,320801,320801,320802,0,1,2
91558,6,3,320807,320807,320810,0,3,5
91559,1,1,320808,320810,320811,2,3,0
91560,3,2,320811,320811,320813,0,2,0
91561,4,3,320815,320815,320818,0,3,2
91562,6,3,320821,320821,320824,0,3,3
91563,2,3,320823,320824,320827,1,4,0
91564,4,2,320827,320827,320829,0,2,0
91565,4,2,320831,320831,320833,0,2,2
91566,1,2,320832,320833,320835,1,3,0
91567,2,1,320834,320835,320836,1,2,0
91568,5,3,320839,320839,320842,0,3,3
91569,5,3,320844,320844,320847,0,3,2
91570,6,3,320850,320850,320853,0,3,3
91571,1,1,320851,320853,320854,2,3,0
91572,6,2,320857,320857,320859,0,2,3
91573,4,2,320861,320861,320863,0,2,2
91574,3,1,320864,320864,320865,0,1,1
91575,1,1,320865,320865,320866,0,1,0
91576,2,1,320867,320867,320868,0,1,1
91577,4,2,320871,320871,320873,0,2,3
91578,5,2,320876,320876,320878,0,2,3
91579,3,3,320879,320879,320882,0,3,1
91580,3,3,320882,320882,320885,0,3,0
91581,2,2,320884,320885,320887,1,3,0
91582,5,2,320889,320889,320891,0,2,2
91583,5,1,320894,320894,320895,0,1,3
91584,3,2,320897,320897,320899,0,2,2
91585,3,1,320900,320900,320901,0,1,1
91586,3,3,320903,320903,320906,0,3,2
91587,3,2,320906,320906,320908,0,2,0
91588,6,2,320912,320912,320914,0,2,4
91589,6,2,320918,320918,320920,0,2,4
91590,3,3,320921,320921,320924,0,3,1
91591,4,3,320925,320925,320928,0,3,1
91592,4,1,320929,320929,320930,0,1,1
91593,5,1,320934,320934,320935,0,1,4
91594,4,3,320938,320938,320941,0,3,3
91595,1,1,320939,320941,320942,2,3,0
91596,4,1,320943,320943,320944,0,1,1
91597,2,2,320945,320945,320947,0,2,1
91598,4,2,320949,320949,320951,0,2,2
91599,5,1,320954,320954,320955,0,1,3
91600,4,3,320958,320958,320961,0,3,3
91601,3,1,320961,320961,320962,0,1,0
91602,4,2,320965,320965,320967,0,2,3
91603,2,3,320967,320967,320970,0,3,0
91604,5,2,320972,320972,320974,0,2,2
91605,4,2,320976,320976,320978,0,2,2
91606,2,1,320978,320978,320979,0,1,0
91607,5,3,320983,320983,320986,0,3,4
91608,3,2,320986,320986,320988,0,2,0
91609,2,1,320988,320988,320989,0,1,0
91610,6,3,320994,320994,320997,0,3,5
91611,1,1,320995,320997,320998,2,3,0
91612,6,2,321001,321001,321003,0,2,3
91613,4,3,321005,321005,321008,0,3,2
91614,6,3,321011,321011,321014,0,3,3
91615,5,1,321016,321016,321017,0,1,2
91616,3,1,321019,321019,321020,0,1,2
91617,6,3,321025,321025,321028,0,3,5
91618,1,2,321026,321028,321030,2,4,0
91619,3,3,321029,321030,321033,1,4,0
91620,6,1,321035,321035,321036,0,1,2
91621,6,2,321041,321041,321043,0,2,5
91622,2,1,321043,321043,321044,0,1,0
91623,3,2,321046,321046,321048,0,2,2
91624,4,1,321050,321050,321051,0,1,2
91625,4,2,321054,321054,321056,0,2,3
91626,5,2,321059,321059,321061,0,2,3
91627,1,1,321060,321061,321062,1,2,0
91628,2,3,321062,321062,321065,0,3,0
91629,3,2,321065,321065,321067,0,2,0
91630,3,1,321068,321068,321069,0,1,1
91631,5,2,321073,321073,321075,0,2,4
91632,3,1,321076,321076,321077,0,1,1
91633,5,2,321081,321081,321083,0,2,4
91634,1,3,321082,321083,321086,1,4,0
91635,2,1,321084,321086,321087,2,3,0
91636,5,2,321089,321089,321091,0,2,2
91637,2,3,321091,321091,321094,0,3,0
91638,2,3,321093,321094,321097,1,4,0
91639,5,2,321098,321098,321100,0,2,1
91640,2,2,321100,321100,321102,0,2,0
91641,5,1,321105,321105,321106,0,1,3
91642,6,2,321111,321111,321113,0,2,5
91643,4,1,321115,321115,321116,0,1,2
91644,3,1,321118,321118,321119,0,1,2
91645,1,2,321119,321119,321121,0,2,0
91646,6,3,321125,321125,321128,0,3,4
91647,6,3,321131,321131,321134,0,3,3
91648,5,1,321136,321136,321137,0,1,2
91649,3,3,321139,321139,321142,0,3,2
91650,5,1,321144,321144,321145,0,1,2
91651,1,2,321145,321145,321147,0,2,0
91652,1,3,321146,321147,321150,1,4,0
91653,3,1,321149,321150,321151,1,2,0
91654,6,3,321155,321155,321158,0,3,4
91655,1,2,321156,321158,321160,2,4,0
91656,3,1,321159,321160,321161,1,2,0
91657,6,3,321165,321165,321168,0,3,4
91658,4,2,321169,321169,321171,0,2,1
91659,5,1,321174,321174,321175,0,1,3
91660,2,1,321176,321176,321177,0,1,1
91661,6,1,321182,321182,321183,0,1,5
91662,6,3,321188,321188,321191,0,3,5
91663,5,2,321193,321193,321195,0,2,2
91664,5,2,321198,321198,321200,0,2,3
91665,6,3,321204,321204,321207,0,3,4
91666,5,2,321209,321209,321211,0,2,2
91667,6,1,321215,321215,321216,0,1,4
91668,4,1,321219,321219,321220,0,1,3
91669,3,2,321222,321222,321224,0,2,2
91670,6,1,321228,321228,321229,0,1,4
91671,5,3,321233,321233,321236,0,3,4
91672,1,2,321234,321236,321238,2,4,0
91673,5,2,321239,321239,321241,0,2,1
91674,2,3,321241,321241,321244,0,3,0
91675,2,1,321243,321244,321245,1,2,0
91676,4,1,321247,321247,321248,0,1,2
91677,6,3,321253,321253,321256,0,3,5
91678,4,3,321257,321257,321260,0,3,1
91679,5,3,321262,321262,321265,0,3,2
91680,4,1,321266,321266,321267,0,1,1
91681,5,1,321271,321271,321272,0,1,4
91682,1,3,321272,321272,321275,0,3,0
91683,2,2,321274,321275,321277,1,3,0
91684,6,1,321280,321280,321281,0,1,3
91685,5,3,321285,321285,321288,0,3,4
91686,6,1,321291,321291,321292,0,1,3
91687,4,3,321295,321295,321298,0,3,3
91688,4,1,321299,321299,321300,0,1,1
91689,5,3,321304,321304,321307,0,3,4
91690,5,3,321309,321309,321312,0,3,2
91691,3,1,321312,321312,321313,0,1,0
91692,6,2,321318,321318,321320,0,2,5
91693,2,1,321320,321320,321321,0,1,0
91694,1,3,321321,321321,321324,0,3,0
91695,1,3,321322,321324,321327,2,5,0
91696,5,1,321327,321327,321328,0,1,0
91697,6,2,321333,321333,321335,0,2,5
91698,4,3,321337,321337,321340,0,3,2
91699,3,3,321340,321340,321343,0,3,0
91700,2,3,321342,321343,321346,1,4,0
91701,3,3,321345,321346,321349,1,4,0
91702,1,2,321346,321349,321351,3,5,0
91703,3,3,321349,321351,321354,2,5,0
91704,6,3,321355,321355,321358,0,3,1
91705,3,3,321358,321358,321361,0,3,0
91706,5,1,321363,321363,321364,0,1,2
91707,6,3,321369,321369,321372,0,3,5
91708,1,2,321370,321372,321374,2,4,0
91709,3,2,321373,321374,321376,1,3,0
91710,5,2,321378,321378,321380,0,2,2
91711,1,1,321379,321380,321381,1,2,0
91712,1,2,321380,321381,321383,1,3,0
91713,4,3,321384,321384,321387,0,3,1
91714,1,1,321385,321387,321388,2,3,0
91715,3,2,321388,321388,321390,0,2,0
91716,6,2,321394,321394,321396,0,2,4
91717,5,2,321399,321399,321401,0,2,3
91718,5,1,321404,321404,321405,0,1,3
91719,1,3,321405,321405,321408,0,3,0
91720,5,1,321410,321410,321411,0,1,2
91721,2,3,321412,321412,321415,0,3,1
91722,5,3,321417,321417,321420,0,3,2
91723,2,1,321419,321420,321421,1,2,0
91724,4,2,321423,321423,321425,0,2,2
91725,5,3,321428,321428,321431,0,3,3
91726,1,2,321429,321431,321433,2,4,0
91727,4,3,321433,321433,321436,0,3,0
91728,6,3,321439,321439,321442,0,3,3
91729,4,2,321443,321443,321445,0,2,1
91730,5,1,321448,321448,321449,0,1,3
91731,5,2,321453,321453,321455,0,2,4
91732,2,2,321455,321455,321457,0,2,0
91733,3,3,321458,321458,321461,0,3,1
91734,1,1,321459,321461,321462,2,3,0
91735,6,1,321465,321465,321466,0,1,3
91736,3,1,321468,321468,321469,0,1,2
91737,4,1,321472,321472,321473,0,1,3
91738,3,2,321475,321475,321477,0,2,2
91739,3,3,321478,321478,321481,0,3,1
91740,3,1,321481,321481,321482,0,1,0
91741,6,3,321487,321487,321490,0,3,5
91742,6,2,321493,321493,321495,0,2,3
91743,3,3,321496,321496,321499,0,3,1
91744,6,1,321502,321502,321503,0,1,3
91745,2,2,321504,321504,321506,0,2,1
91746,1,1,321505,321506,321507,1,2,0
91747,6,2,321511,321511,321513,0,2,4
91748,1,3,321512,321513,321516,1,4,0
91749,2,2,321514,321516,321518,2,4,0
91750,2,2,321516,321518,321520,2,4,0
91751,6,3,321522,321522,321525,0,3,2
91752,4,3,321526,321526,321529,0,3,1
91753,1,2,321527,321529,321531,2,4,0
91754,5,1,321532,321532,321533,0,1,1
91755,1,1,321533,321533,321534,0,1,0
91756,4,3,321537,321537,321540,0,3,3
91757,5,2,321542,321542,321544,0,2,2
91758,1,3,321543,321544,321547,1,4,0
91759,1,3,321544,321547,321550,3,6,0
91760,1,3,321545,321550,321553,5,8,0
91761,3,3,321548,321553,321556,5,8,0
91762,6,1,321554,321556,321557,2,3,0
91763,4,2,321558,321558,321560,0,2,1
91764,4,2,321562,321562,321564,0,2,2
91765,3,1,321565,321565,321566,0,1,1
91766,1,3,321566,321566,321569,0,3,0
91767,4,3,321570,321570,321573,0,3,1
91768,2,1,321572,321573,321574,1,2,0
91769,3,3,321575,321575,321578,0,3,1
91770,6,3,321581,321581,321584,0,3,3
91771,6,3,321587,321587,321590,0,3,3
91772,4,1,321591,321591,321592,0,1,1
91773,6,2,321597,321597,321599,0,2,5
91774,2,3,321599,321599,321602,0,3,0
91775,1,2,321600,321602,321604,2,4,0
91776,5,1,321605,321605,321606,0,1,1
91777,5,3,321610,321610,321613,0,3,4
91778,5,1,321615,321615,321616,0,1,2
91779,2,1,321617,321617,321618,0,1,1
91780,4,2,321621,321621,321623,0,2,3
91781,6,2,321627,321627,321629,0,2,4
91782,5,1,321632,321632,321633,0,1,3
91783,6,2,321638,321638,321640,0,2,5
91784,4,2,321642,321642,321644,0,2,2
91785,1,1,321643,321644,321645,1,2,0
91786,6,3,321649,321649,321652,0,3,4
91787,3,1,321652,321652,321653,0,1,0
91788,2,1,321654,321654,321655,0,1,1
91789,1,3,321655,321655,321658,0,3,0
91790,4,2,321659,321659,321661,0,2,1
91791,2,1,321661,321661,321662,0,1,0
91792,3,2,321664,321664,321666,0,2,2
91793,2,3,321666,321666,321669,0,3,0
91794,1,3,321667,321669,321672,2,5,0
91795,3,2,321670,321672,321674,2,4,0
91796,2,1,321672,321674,321675,2,3,0
91797,2,2,321674,321675,321677,1,3,0
91798,2,3,321676,321677,321680,1,4,0
91799,4,3,321680,321680,321683,0,3,0
91800,3,1,321683,321683,321684,0,1,0
91801,3,2,321686,321686,321688,0,2,2
91802,3,1,321689,321689,321690,0,1,1
91803,6,3,321695,321695,321698,0,3,5
91804,5,1,321700,321700,321701,0,1,2
91805,6,1,321706,321706,321707,0,1,5
91806,6,2,321712,321712,321714,0,2,5
91807,6,1,321718,321718,321719,0,1,4
91808,2,3,321720,321720,321723,0,3,1
91809,3,3,321723,321723,321726,0,3,0
91810,3,2,321726,321726,321728,0,2,0
91811,2,1,321728,321728,321729,0,1,0
91812,5,2,321733,321733,321735,0,2,4
91813,6,3,321739,321739,321742,0,3,4
91814,5,1,321744,321744,321745,0,1,2
91815,5,1,321749,321749,321750,0,1,4
91816,3,1,321752,321752,321753,0,1,2
91817,5,2,321757,321757,321759,0,2,4
91818,6,1,321763,321763,321764,0,1,4
91819,3,2,321766,321766,321768,0,2,2
91820,5,3,321771,321771,321774,0,3,3
91821,2,3,321773,321774,321777,1,4,0
91822,1,2,321774,321777,321779,3,5,0
91823,4,2,321778,321779,321781,1,3,0
91824,1,3,321779,321781,321784,2,5,0
91825,2,1,321781,321784,321785,3,4,0
91826,6,3,321787,321787,321790,0,3,2
91827,2,2,321789,321790,321792,1,3,0
91828,5,1,321794,321794,321795,0,1,2
91829,6,1,321800,321800,321801,0,1,5
91830,1,2,321801,321801,321803,0,2,0
91831,3,1,321804,321804,321805,0,1,1
91832,5,3,321809,321809,321812,0,3,4
91833,2,2,321811,321812,321814,1,3,0
91834,6,2,321817,321817,321819,0,2,3
91835,2,2,321819,321819,321821,0,2,0
91836,1,2,321820,321821,321823,1,3,0
91837,5,1,321825,321825,321826,0,1,2
91838,3,3,321828,321828,321831,0,3,2
91839,5,3,321833,321833,321836,0,3,2
91840,6,1,321839,321839,321840,0,1,3
91841,2,3,321841,321841,321844,0,3,1
91842,6,1,321847,321847,321848,0,1,3
91843,1,2,321848,321848,321850,0,2,0
91844,6,1,321854,321854,321855,0,1,4
91845,4,2,321858,321858,321860,0,2,3
91846,3,2,321861,321861,321863,0,2,1
91847,4,3,321865,321865,321868,0,3,2
91848,4,2,321869,321869,321871,0,2,1
91849,2,2,321871,321871,321873,0,2,0
91850,3,3,321874,321874,321877,0,3,1
91851,5,1,321879,321879,321880,0,1,2
91852,2,2,321881,321881,321883,0,2,1
91853,2,1,321883,321883,321884,0,1,0
91854,3,3,321886,321886,321889,0,3,2
91855,4,2,321890,321890,321892,0,2,1
91856,4,1,321894,321894,321895,0,1,2
91857,1,2,321895,321895,321897,0,2,0
91858,3,3,321898,321898,321901,0,3,1
91859,4,1,321902,321902,321903,0,1,1
91860,1,3,321903,321903,321906,0,3,0
91861,4,1,321907,321907,321908,0,1,1
91862,4,2,321911,321911,321913,0,2,3
91863,3,3,321914,321914,321917,0,3,1
91864,1,2,321915,321917,321919,2,4,0
91865,1,1,321916,321919,321920,3,4,0
91866,5,2,321921,321921,321923,0,2,1
91867,1,2,321922,321923,321925,1,3,0
91868,6,1,321928,321928,321929,0,1,3
91869,4,1,321932,321932,321933,0,1,3
91870,2,3,321934,321934,321937,0,3,1
91871,3,1,321937,321937,321938,0,1,0
91872,1,1,321938,321938,321939,0,1,0
91873,1,1,321939,321939,321940,0,1,0
91874,5,3,321944,321944,321947,0,3,4
91875,3,3,321947,321947,321950,0,3,0
91876,2,1,321949,321950,321951,1,2,0
91877,4,2,321953,321953,321955,0,2,2
91878,5,1,321958,321958,321959,0,1,3
91879,4,2,321962,321962,321964,0,2,3
91880,2,2,321964,321964,321966,0,2,0
91881,4,2,321968,321968,321970,0,2,2
91882,5,3,321973,321973,321976,0,3,3
91883,4,2,321977,321977,321979,0,2,1
91884,5,3,321982,321982,321985,0,3,3
91885,4,1,321986,321986,321987,0,1,1
91886,3,1,321989,321989,321990,0,1,2
91887,3,1,321992,321992,321993,0,1,2
91888,2,1,321994,321994,321995,0,1,1
91889,5,3,321999,321999,322002,0,3,4
91890,3,2,322002,322002,322004,0,2,0
91891,1,1,322003,322004,322005,1,2,0
91892,6,3,322009,322009,322012,0,3,4
91893,5,3,322014,322014,322017,0,3,2
91894,2,3,322016,322017,322020,1,4,0
91895,6,3,322022,322022,322025,0,3,2
91896,3,3,322025,322025,322028,0,3,0
91897,3,1,322028,322028,322029,0,1,0
91898,2,3,322030,322030,322033,0,3,1
91899,4,1,322034,322034,322035,0,1,1
91900,5,1,322039,322039,322040,0,1,4
91901,6,2,322045,322045,322047,0,2,5
91902,3,2,322048,322048,322050,0,2,1
91903,2,1,322050,322050,322051,0,1,0
91904,3,3,322053,322053,322056,0,3,2
91905,3,3,322056,322056,322059,0,3,0
91906,6,1,322062,322062,322063,0,1,3
91907,2,1,322064,322064,322065,0,1,1
91908,6,2,322070,322070,322072,0,2,5
91909,2,3,322072,322072,322075,0,3,0
91910,4,1,322076,322076,322077,0,1,1
91911,6,2,322082,322082,322084,0,2,5
91912,6,2,322088,322088,322090,0,2,4
91913,5,3,322093,322093,322096,0,3,3
91914,2,2,322095,322096,322098,1,3,0
91915,6,2,322101,322101,322103,0,2,3
91916,4,1,322105,322105,322106,0,1,2
91917,1,2,322106,322106,322108,0,2,0
91918,1,2,322107,322108,322110,1,3,0
91919,2,3,322109,322110,322113,1,4,0
91920,5,2,322114,322114,322116,0,2,1
91921,2,3,322116,322116,322119,0,3,0
91922,3,1,322119,322119,322120,0,1,0
91923,3,3,322122,322122,322125,0,3,2
91924,2,1,322124,322125,322126,1,2,0
91925,1,2,322125,322126,322128,1,3,0
91926,1,3,322126,322128,322131,2,5,0
91927,5,1,322131,322131,322132,0,1,0
91928,4,3,322135,322135,322138,0,3,3
91929,5,3,322140,322140,322143,0,3,2
91930,6,1,322146,322146,322147,0,1,3
91931,3,3,322149,322149,322152,0,3,2
91932,5,2,322154,322154,322156,0,2,2
91933,2,1,322156,322156,322157,0,1,0
91934,5,3,322161,322161,322164,0,3,4
91935,1,1,322162,322164,322165,2,3,0
91936,4,1,322166,322166,322167,0,1,1
91937,3,2,322169,322169,322171,0,2,2
91938,4,1,322173,322173,322174,0,1,2
91939,3,1,322176,322176,322177,0,1,2
91940,4,1,322180,322180,322181,0,1,3
91941,2,3,322182,322182,322185,0,3,1
91942,6,2,322188,322188,322190,0,2,3
91943,3,2,322191,322191,322193,0,2,1
91944,5,2,322196,322196,322198,0,2,3
91945,2,2,322198,322198,322200,0,2,0
91946,5,3,322203,322203,322206,0,3,3
91947,3,1,322206,322206,322207,0,1,0
91948,3,2,322209,322209,322211,0,2,2
91949,4,3,322213,322213,322216,0,3,2
91950,3,2,322216,322216,322218,0,2,0
91951,1,3,322217,322218,322221,1,4,0
91952,5,3,322222,322222,322225,0,3,1
91953,1,3,322223,322225,322228,2,5,0
91954,5,3,322228,322228,322231,0,3,0
91955,2,1,322230,322231,322232,1,2,0
91956,3,2,322233,322233,322235,0,2,1
91957,2,3,322235,322235,322238,0,3,0
91958,1,1,322236,322238,322239,2,3,0
91959,6,1,322242,322242,322243,0,1,3
91960,6,3,322248,322248,322251,0,3,5
91961,2,2,322250,322251,322253,1,3,0
91962,2,3,322252,322253,322256,1,4,0
91963,5,3,322257,322257,322260,0,3,1
91964,5,1,322262,322262,322263,0,1,2
91965,3,1,322265,322265,322266,0,1,2
91966,4,2,322269,322269,322271,0,2,3
91967,2,3,322271,322271,322274,0,3,0
91968,4,1,322275,322275,322276,0,1,1
91969,3,2,322278,322278,322280,0,2,2
91970,3,1,322281,322281,322282,0,1,1
91971,1,3,322282,322282,322285,0,3,0
91972,3,2,322285,322285,322287,0,2,0
91973,5,1,322290,322290,322291,0,1,3
91974,2,3,322292,322292,322295,0,3,1
91975,2,1,322294,322295,322296,1,2,0
91976,5,3,322299,322299,322302,0,3,3
91977,5,2,322304,322304,322306,0,2,2
91978,1,1,322305,322306,322307,1,2,0
91979,5,2,322310,322310,322312,0,2,3
91980,2,1,322312,322312,322313,0,1,0
91981,2,3,322314,322314,322317,0,3,1
91982,5,3,322319,322319,322322,0,3,2
91983,3,2,322322,322322,322324,0,2,0
91984,1,3,322323,322324,322327,1,4,0
91985,2,2,322325,322327,322329,2,4,0
91986,5,2,322330,322330,322332,0,2,1
91987,5,3,322335,322335,322338,0,3,3
91988,5,1,322340,322340,322341,0,1,2
91989,1,1,322341,322341,322342,0,1,0
91990,4,3,322345,322345,322348,0,3,3
91991,3,1,322348,322348,322349,0,1,0
91992,2,2,322350,322350,322352,0,2,1
91993,2,3,322352,322352,322355,0,3,0
91994,6,1,322358,322358,322359,0,1,3
91995,1,1,322359,322359,322360,0,1,0
91996,4,3,322363,322363,322366,0,3,3
91997,6,2,322369,322369,322371,0,2,3
91998,6,1,322375,322375,322376,0,1,4
91999,5,2,322380,322380,322382,0,2,4
92000,3,2,322383,322383,322385,0,2,1
92001,1,2,322384,322385,322387,1,3,0
92002,1,3,322385,322387,322390,2,5,0
92003,1,3,322386,322390,322393,4,7,0
92004,5,2,322391,322393,322395,2,4,0
92005,6,1,322397,322397,322398,0,1,2
92006,5,1,322402,322402,322403,0,1,4
92007,1,1,322403,322403,322404,0,1,0
92008,3,1,322406,322406,322407,0,1,2
92009,5,3,322411,322411,322414,0,3,4
92010,2,2,322413,322414,322416,1,3,0
92011,4,3,322417,322417,322420,0,3,1
92012,3,1,322420,322420,322421,0,1,0
92013,6,1,322426,322426,322427,0,1,5
92014,4,1,322430,322430,322431,0,1,3
92015,6,2,322436,322436,322438,0,2,5
92016,4,2,322440,322440,322442,0,2,2
92017,1,3,322441,322442,322445,1,4,0
92018,6,1,322447,322447,322448,0,1,2
92019,6,1,322453,322453,322454,0,1,5
92020,5,1,322458,322458,322459,0,1,4
92021,2,1,322460,322460,322461,0,1,1
92022,1,1,322461,322461,322462,0,1,0
92023,4,1,322465,322465,322466,0,1,3
92024,2,2,322467,322467,322469,0,2,1
92025,2,1,322469,322469,322470,0,1,0
92026,4,2,322473,322473,322475,0,2,3
92027,5,1,322478,322478,322479,0,1,3
92028,3,3,322481,322481,322484,0,3,2
92029,1,3,322482,322484,322487,2,5,0
92030,2,3,322484,322487,322490,3,6,0
92031,2,2,322486,322490,322492,4,6,0
92032,2,2,322488,322492,322494,4,6,0
92033,1,3,322489,322494,322497,5,8,0
92034,6,3,322495,322497,322500,2,5,0
92035,3,3,322498,322500,322503,2,5,0
92036,2,3,322500,322503,322506,3,6,0
92037,5,2,322505,322506,322508,1,3,0
92038,5,3,322510,322510,322513,0,3,2
92039,6,1,322516,322516,322517,0,1,3
92040,2,2,322518,322518,322520,0,2,1
92041,3,3,322521,322521,322524,0,3,1
92042,5,2,322526,322526,322528,0,2,2
92043,6,3,322532,322532,322535,0,3,4
92044,5,1,322537,322537,322538,0,1,2
92045,4,2,322541,322541,322543,0,2,3
92046,3,1,322544,322544,322545,0,1,1
92047,4,2,322548,322548,322550,0,2,3
92048,5,3,322553,322553,322556,0,3,3
92049,1,2,322554,322556,322558,2,4,0
92050,2,3,322556,322558,322561,2,5,0
92051,2,2,322558,322561,322563,3,5,0
92052,2,1,322560,322563,322564,3,4,0
92053,4,2,322564,322564,322566,0,2,0
92054,2,2,322566,322566,322568,0,2,0
92055,2,3,322568,322568,322571,0,3,0
92056,6,2,322574,322574,322576,0,2,3
92057,3,3,322577,322577,322580,0,3,1
92058,3,2,322580,322580,322582,0,2,0
92059,3,3,322583,322583,322586,0,3,1
92060,6,1,322589,322589,322590,0,1,3
92061,6,3,322595,322595,322598,0,3,5
92062,3,3,322598,322598,322601,0,3,0
92063,1,3,322599,322601,322604,2,5,0
92064,6,3,322605,322605,322608,0,3,1
92065,4,3,322609,322609,322612,0,3,1
92066,6,2,322615,322615,322617,0,2,3
92067,3,2,322618,322618,322620,0,2,1
92068,6,1,322624,322624,322625,0,1,4
92069,2,1,322626,322626,322627,0,1,1
92070,2,3,322628,322628,322631,0,3,1
92071,3,1,322631,322631,322632,0,1,0
92072,2,1,322633,322633,322634,0,1,1
92073,3,2,322636,322636,322638,0,2,2
92074,5,2,322641,322641,322643,0,2,3
92075,6,3,322647,322647,322650,0,3,4
92076,1,3,322648,322650,322653,2,5,0
92077,2,1,322650,322653,322654,3,4,0
92078,6,3,322656,322656,322659,0,3,2
92079,2,1,322658,322659,322660,1,2,0
92080,2,2,322660,322660,322662,0,2,0
92081,4,1,322664,322664,322665,0,1,2
92082,3,2,322667,322667,322669,0,2,2
92083,2,1,322669,322669,322670,0,1,0
92084,6,3,322675,322675,322678,0,3,5
92085,3,1,322678,322678,322679,0,1,0
92086,4,1,322682,322682,322683,0,1,3
92087,3,1,322685,322685,322686,0,1,2
92088,5,1,322690,322690,322691,0,1,4
92089,2,3,322692,322692,322695,0,3,1
92090,1,1,322693,322695,322696,2,3,0
92091,6,2,322699,322699,322701,0,2,3
92092,6,1,322705,322705,322706,0,1,4
92093,4,3,322709,322709,322712,0,3,3
92094,1,3,322710,322712,322715,2,5,0
92095,3,2,322713,322715,322717,2,4,0
92096,6,3,322719,322719,322722,0,3,2
92097,2,1,322721,322722,322723,1,2,0
92098,6,3,322727,322727,322730,0,3,4
92099,3,1,322730,322730,322731,0,1,0
92100,2,3,322732,322732,322735,0,3,1
92101,2,1,322734,322735,322736,1,2,0
92102,3,1,322737,322737,322738,0,1,1
92103,2,1,322739,322739,322740,0,1,1
92104,2,1,322741,322741,322742,0,1,1
92105,4,2,322745,322745,322747,0,2,3
92106,1,1,322746,322747,322748,1,2,0
92107,2,2,322748,322748,322750,0,2,0
92108,2,2,322750,322750,322752,0,2,0
92109,1,3,322751,322752,322755,1,4,0
92110,1,2,322752,322755,322757,3,5,0
92111,4,3,322756,322757,322760,1,4,0
92112,1,2,322757,322760,322762,3,5,0
92113,5,1,322762,322762,322763,0,1,0
92114,2,3,322764,322764,322767,0,3,1
92115,1,1,322765,322767,322768,2,3,0
92116,4,2,322769,322769,322771,0,2,1
92117,5,3,322774,322774,322777,0,3,3
92118,4,1,322778,322778,322779,0,1,1
92119,1,3,322779,322779,322782,0,3,0
92120,5,1,322784,322784,322785,0,1,2
92121,2,2,322786,322786,322788,0,2,1
92122,1,1,322787,322788,322789,1,2,0
92123,4,1,322791,322791,322792,0,1,2
92124,2,2,322793,322793,322795,0,2,1
92125,4,3,322797,322797,322800,0,3,2
92126,6,3,322803,322803,322806,0,3,3
92127,5,2,322808,322808,322810,0,2,2
92128,3,2,322811,322811,322813,0,2,1
92129,1,3,322812,322813,322816,1,4,0
92130,4,1,322816,322816,322817,0,1,0
92131,1,3,322817,322817,322820,0,3,0
92132,4,1,322821,322821,322822,0,1,1
92133,5,2,322826,322826,322828,0,2,4
92134,5,2,322831,322831,322833,0,2,3
92135,1,1,322832,322833,322834,1,2,0
92136,5,2,322837,322837,322839,0,2,3
92137,5,3,322842,322842,322845,0,3,3
92138,2,3,322844,322845,322848,1,4,0
92139,2,3,322846,322848,322851,2,5,0
92140,5,2,322851,322851,322853,0,2,0
92141,4,2,322855,322855,322857,0,2,2
92142,2,3,322857,322857,322860,0,3,0
92143,5,1,322862,322862,322863,0,1,2
92144,4,1,322866,322866,322867,0,1,3
92145,4,3,322870,322870,322873,0,3,3
92146,2,3,322872,322873,322876,1,4,0
92147,4,3,322876,322876,322879,0,3,0
92148,5,2,322881,322881,322883,0,2,2
92149,6,2,322887,322887,322889,0,2,4
92150,5,1,322892,322892,322893,0,1,3
92151,3,3,322895,322895,322898,0,3,2
92152,5,1,322900,322900,322901,0,1,2
92153,2,2,322902,322902,322904,0,2,1
92154,4,3,322906,322906,322909,0,3,2
92155,1,3,322907,322909,322912,2,5,0
92156,1,1,322908,322912,322913,4,5,0
92157,6,2,322914,322914,322916,0,2,1
92158,2,1,322916,322916,322917,0,1,0
92159,3,1,322919,322919,322920,0,1,2
92160,5,2,322924,322924,322926,0,2,4
92161,1,1,322925,322926,322927,1,2,0
92162,5,3,322930,322930,322933,0,3,3
92163,3,1,322933,322933,322934,0,1,0
92164,1,2,322934,322934,322936,0,2,0
92165,5,1,322939,322939,322940,0,1,3
92166,3,2,322942,322942,322944,0,2,2
92167,4,2,322946,322946,322948,0,2,2
92168,5,2,322951,322951,322953,0,2,3
92169,6,3,322957,322957,322960,0,3,4
92170,6,3,322963,322963,322966,0,3,3
92171,5,3,322968,322968,322971,0,3,2
92172,5,3,322973,322973,322976,0,3,2
92173,1,1,322974,322976,322977,2,3,0
92174,6,3,322980,322980,322983,0,3,3
92175,1,1,322981,322983,322984,2,3,0
92176,4,1,322985,322985,322986,0,1,1
92177,1,1,322986,322986,322987,0,1,0
92178,4,1,322990,322990,322991,0,1,3
92179,5,3,322995,322995,322998,0,3,4
92180,1,2,322996,322998,323000,2,4,0
92181,5,2,323001,323001,323003,0,2,1
92182,3,1,323004,323004,323005,0,1,1
92183,6,3,323010,323010,323013,0,3,5
92184,2,1,323012,323013,323014,1,2,0
92185,5,3,323017,323017,323020,0,3,3
92186,4,3,323021,323021,323024,0,3,1
92187,1,1,323022,323024,323025,2,3,0
92188,1,1,323023,323025,323026,2,3,0
92189,6,2,323029,323029,323031,0,2,3
92190,2,2,323031,323031,323033,0,2,0
92191,2,3,323033,323033,323036,0,3,0
92192,6,2,323039,323039,323041,0,2,3
92193,3,3,323042,323042,323045,0,3,1
92194,2,1,323044,323045,323046,1,2,0
92195,4,2,323048,323048,323050,0,2,2
92196,3,3,323051,323051,323054,0,3,1
92197,1,2,323052,323054,323056,2,4,0
92198,1,3,323053,323056,323059,3,6,0
92199,4,3,323057,323059,323062,2,5,0
92200,2,2,323059,323062,323064,3,5,0
92201,5,2,323064,323064,323066,0,2,0
92202,5,3,323069,323069,323072,0,3,3
92203,4,2,323073,323073,323075,0,2,1
92204,1,3,323074,323075,323078,1,4,0
92205,2,2,323076,323078,323080,2,4,0
92206,4,3,323080,323080,323083,0,3,0
92207,2,2,323082,323083,323085,1,3,0
92208,2,1,323084,323085,323086,1,2,0
92209,4,3,323088,323088,323091,0,3,2
92210,5,3,323093,323093,323096,0,3,2
92211,5,3,323098,323098,323101,0,3,2
92212,2,3,323100,323101,323104,1,4,0
92213,1,2,323101,323104,323106,3,5,0
92214,2,1,323103,323106,323107,3,4,0
92215,6,2,323109,323109,323111,0,2,2
92216,1,3,323110,323111,323114,1,4,0
92217,4,2,323114,323114,323116,0,2,0
92218,5,1,323119,323119,323120,0,1,3
92219,4,1,323123,323123,323124,0,1,3
92220,4,1,323127,323127,323128,0,1,3
92221,4,3,323131,323131,323134,0,3,3
92222,1,1,323132,323134,323135,2,3,0
92223,2,2,323134,323135,323137,1,3,0
92224,2,1,323136,323137,323138,1,2,0
92225,3,2,323139,323139,323141,0,2,1
92226,6,3,323145,323145,323148,0,3,4
92227,5,1,323150,323150,323151,0,1,2
92228,1,3,323151,323151,323154,0,3,0
92229,1,1,323152,323154,323155,2,3,0
92230,5,1,323157,323157,323158,0,1,2
92231,4,3,323161,323161,323164,0,3,3
92232,6,3,323167,323167,323170,0,3,3
92233,1,2,323168,323170,323172,2,4,0
92234,3,2,323171,323172,323174,1,3,0
92235,1,2,323172,323174,323176,2,4,0
92236,1,2,323173,323176,323178,3,5,0
92237,4,2,323177,323178,323180,1,3,0
92238,6,1,323183,323183,323184,0,1,3
92239,1,2,323184,323184,323186,0,2,0
92240,4,3,323188,323188,323191,0,3,2
92241,6,1,323194,323194,323195,0,1,3
92242,5,1,323199,323199,323200,0,1,4
92243,6,2,323205,323205,323207,0,2,5
92244,6,1,323211,323211,323212,0,1,4
92245,3,1,323214,323214,323215,0,1,2
92246,3,3,323217,323217,323220,0,3,2
92247,4,3,323221,323221,323224,0,3,1
92248,2,3,323223,323224,323227,1,4,0
92249,2,1,323225,323227,323228,2,3,0
92250,6,3,323231,323231,323234,0,3,3
92251,6,3,323237,323237,323240,0,3,3
92252,4,1,323241,323241,323242,0,1,1
92253,3,3,323244,323244,323247,0,3,2
92254,4,2,323248,323248,323250,0,2,1
92255,3,3,323251,323251,323254,0,3,1
92256,4,2,323255,323255,323257,0,2,1
92257,4,2,323259,323259,323261,0,2,2
92258,5,2,323264,323264,323266,0,2,3
92259,3,1,323267,323267,323268,0,1,1
92260,1,3,323268,323268,323271,0,3,0
92261,6,1,323274,323274,323275,0,1,3
92262,5,1,323279,323279,323280,0,1,4
92263,2,1,323281,323281,323282,0,1,1
92264,2,2,323283,323283,323285,0,2,1
92265,3,1,323286,323286,323287,0,1,1
92266,4,2,323290,323290,323292,0,2,3
92267,3,3,323293,323293,323296,0,3,1
92268,4,3,323297,323297,323300,0,3,1
92269,4,3,323301,323301,323304,0,3,1
92270,3,2,323304,323304,323306,0,2,0
92271,5,1,323309,323309,323310,0,1,3
92272,4,3,323313,323313,323316,0,3,3
92273,1,2,323314,323316,323318,2,4,0
92274,1,3,323315,323318,323321,3,6,0
92275,6,3,323321,323321,323324,0,3,0
92276,2,2,323323,323324,323326,1,3,0
92277,2,1,323325,323326,323327,1,2,0
92278,3,1,323328,323328,323329,0,1,1
92279,6,1,323334,323334,323335,0,1,5
92280,6,1,323340,323340,323341,0,1,5
92281,4,1,323344,323344,323345,0,1,3
92282,6,3,323350,323350,323353,0,3,5
92283,1,3,323351,323353,323356,2,5,0
92284,3,1,323354,323356,323357,2,3,0
92285,1,1,323355,323357,323358,2,3,0
92286,1,3,323356,323358,323361,2,5,0
92287,5,1,323361,323361,323362,0,1,0
92288,1,2,323362,323362,323364,0,2,0
92289,1,3,323363,323364,323367,1,4,0
92290,5,1,323368,323368,323369,0,1,1
92291,1,3,323369,323369,323372,0,3,0
92292,2,3,323371,323372,323375,1,4,0
92293,3,1,323374,323375,323376,1,2,0
92294,5,2,323379,323379,323381,0,2,3
92295,2,2,323381,323381,323383,0,2,0
92296,1,2,323382,323383,323385,1,3,0
92297,3,1,323385,323385,323386,0,1,0
92298,6,2,323391,323391,323393,0,2,5
92299,4,2,323395,323395,323397,0,2,2
92300,3,1,323398,323398,323399,0,1,1
92301,6,1,323404,323404,323405,0,1,5
92302,3,2,323407,323407,323409,0,2,2
92303,2,1,323409,323409,323410,0,1,0
92304,2,1,323411,323411,323412,0,1,1
92305,6,1,323417,323417,323418,0,1,5
92306,1,1,323418,323418,323419,0,1,0
92307,2,2,323420,323420,323422,0,2,1
92308,5,2,323425,323425,323427,0,2,3
92309,4,3,323429,323429,323432,0,3,2
92310,4,2,323433,323433,323435,0,2,1
92311,2,1,323435,323435,323436,0,1,0
92312,2,3,323437,323437,323440,0,3,1
92313,6,2,323443,323443,323445,0,2,3
92314,3,1,323446,323446,323447,0,1,1
92315,2,3,323448,323448,323451,0,3,1
92316,2,3,323450,323451,323454,1,4,0
92317,1,2,323451,323454,323456,3,5,0
92318,3,3,323454,323456,323459,2,5,0
92319,5,3,323459,323459,323462,0,3,0
92320,3,1,323462,323462,323463,0,1,0
92321,5,2,323467,323467,323469,0,2,4
92322,5,3,323472,323472,323475,0,3,3
92323,2,1,323474,323475,323476,1,2,0
92324,6,2,323480,323480,323482,0,2,4
92325,5,3,323485,323485,323488,0,3,3
92326,4,2,323489,323489,323491,0,2,1
92327,6,1,323495,323495,323496,0,1,4
92328,6,1,323501,323501,323502,0,1,5
92329,2,2,323503,323503,323505,0,2,1
92330,4,1,323507,323507,323508,0,1,2
92331,4,2,323511,323511,323513,0,2,3
92332,3,3,323514,323514,323517,0,3,1
92333,6,2,323520,323520,323522,0,2,3
92334,6,1,323526,323526,323527,0,1,4
92335,5,3,323531,323531,323534,0,3,4
92336,2,3,323533,323534,323537,1,4,0
92337,5,1,323538,323538,323539,0,1,1
92338,4,3,323542,323542,323545,0,3,3
92339,5,2,323547,323547,323549,0,2,2
92340,2,2,323549,323549,323551,0,2,0
92341,4,3,323553,323553,323556,0,3,2
92342,6,3,323559,323559,323562,0,3,3
92343,3,1,323562,323562,323563,0,1,0
92344,2,2,323564,323564,323566,0,2,1
92345,3,2,323567,323567,323569,0,2,1
92346,2,3,323569,323569,323572,0,3,0
92347,1,1,323570,323572,323573,2,3,0
92348,3,2,323573,323573,323575,0,2,0
92349,2,1,323575,323575,323576,0,1,0
92350,3,3,323578,323578,323581,0,3,2
92351,3,2,323581,323581,323583,0,2,0
92352,4,1,323585,323585,323586,0,1,2
92353,5,1,323590,323590,323591,0,1,4
92354,6,3,323596,323596,323599,0,3,5
92355,2,3,323598,323599,323602,1,4,0
92356,6,1,323604,323604,323605,0,1,2
92357,5,2,323609,323609,323611,0,2,4
92358,5,3,323614,323614,323617,0,3,3
92359,4,2,323618,323618,323620,0,2,1
92360,6,3,323624,323624,323627,0,3,4
92361,1,2,323625,323627,323629,2,4,0
92362,3,1,323628,323629,323630,1,2,0
92363,3,3,323631,323631,323634,0,3,1
92364,5,2,323636,323636,323638,0,2,2
92365,3,2,323639,323639,323641,0,2,1
92366,6,2,323645,323645,323647,0,2,4
92367,1,3,323646,323647,323650,1,4,0
92368,2,3,323648,323650,323653,2,5,0
92369,3,3,323651,323653,323656,2,5,0
92370,5,2,323656,323656,323658,0,2,0
92371,5,2,323661,323661,323663,0,2,3
92372,5,2,323666,323666,323668,0,2,3
92373,5,2,323671,323671,323673,0,2,3
92374,6,2,323677,323677,323679,0,2,4
92375,6,2,323683,323683,323685,0,2,4
92376,6,2,323689,323689,323691,0,2,4
92377,1,3,323690,323691,323694,1,4,0
92378,2,3,323692,323694,323697,2,5,0
92379,1,2,323693,323697,323699,4,6,0
92380,4,2,323697,323699,323701,2,4,0
92381,5,3,323702,323702,323705,0,3,1
92382,1,2,323703,323705,323707,2,4,0
92383,2,1,323705,323707,323708,2,3,0
92384,5,3,323710,323710,323713,0,3,2
92385,5,2,323715,323715,323717,0,2,2
92386,5,1,323720,323720,323721,0,1,3
92387,2,2,323722,323722,323724,0,2,1
92388,4,3,323726,323726,323729,0,3,2
92389,5,2,323731,323731,323733,0,2,2
92390,2,1,323733,323733,323734,0,1,0
92391,5,1,323738,323738,323739,0,1,4
92392,6,1,323744,323744,323745,0,1,5
92393,2,1,323746,323746,323747,0,1,1
92394,3,3,323749,323749,323752,0,3,2
92395,5,1,323754,323754,323755,0,1,2
92396,2,2,323756,323756,323758,0,2,1
92397,6,1,323762,323762,323763,0,1,4
92398,1,2,323763,323763,323765,0,2,0
92399,3,1,323766,323766,323767,0,1,1
92400,2,3,323768,323768,323771,0,3,1
92401,2,1,323770,323771,323772,1,2,0
92402,1,2,323771,323772,323774,1,3,0
92403,4,1,323775,323775,323776,0,1,1
92404,3,3,323778,323778,323781,0,3,2
92405,2,2,323780,323781,323783,1,3,0
92406,4,3,323784,323784,323787,0,3,1
92407,1,1,323785,323787,323788,2,3,0
92408,5,2,323790,323790,323792,0,2,2
92409,4,1,323794,323794,323795,0,1,2
92410,6,1,323800,323800,323801,0,1,5
92411,6,2,323806,323806,323808,0,2,5
92412,2,3,323808,323808,323811,0,3,0
92413,3,1,323811,323811,323812,0,1,0
92414,6,3,323817,323817,323820,0,3,5
92415,3,1,323820,323820,323821,0,1,0
92416,2,3,323822,323822,323825,0,3,1
92417,2,2,323824,323825,323827,1,3,0
92418,2,2,323826,323827,323829,1,3,0
92419,4,1,323830,323830,323831,0,1,1
92420,6,3,323836,323836,323839,0,3,5
92421,2,3,323838,323839,323842,1,4,0
92422,6,1,323844,323844,323845,0,1,2
92423,3,2,323847,323847,323849,0,2,2
92424,3,1,323850,323850,323851,0,1,1
92425,5,3,323855,323855,323858,0,3,4
92426,1,1,323856,323858,323859,2,3,0
92427,3,1,323859,323859,323860,0,1,0
92428,6,1,323865,323865,323866,0,1,5
92429,2,1,323867,323867,323868,0,1,1
92430,2,1,323869,323869,323870,0,1,1
92431,3,1,323872,323872,323873,0,1,2
92432,5,1,323877,323877,323878,0,1,4
92433,6,1,323883,323883,323884,0,1,5
92434,6,2,323889,323889,323891,0,2,5
92435,5,1,323894,323894,323895,0,1,3
92436,3,2,323897,323897,323899,0,2,2
92437,1,2,323898,323899,323901,1,3,0
92438,1,1,323899,323901,323902,2,3,0
92439,3,1,323902,323902,323903,0,1,0
92440,2,2,323904,323904,323906,0,2,1
92441,4,2,323908,323908,323910,0,2,2
92442,5,2,323913,323913,323915,0,2,3
92443,4,1,323917,323917,323918,0,1,2
92444,4,1,323921,323921,323922,0,1,3
92445,2,3,323923,323923,323926,0,3,1
92446,1,2,323924,323926,323928,2,4,0
92447,5,2,323929,323929,323931,0,2,1
92448,5,3,323934,323934,323937,0,3,3
92449,1,3,323935,323937,323940,2,5,0
92450,2,1,323937,323940,323941,3,4,0
92451,2,3,323939,323941,323944,2,5,0
92452,6,1,323945,323945,323946,0,1,1
92453,4,2,323949,323949,323951,0,2,3
92454,2,3,323951,323951,323954,0,3,0
92455,4,3,323955,323955,323958,0,3,1
92456,6,1,323961,323961,323962,0,1,3
92457,6,1,323967,323967,323968,0,1,5
92458,1,3,323968,323968,323971,0,3,0
92459,3,2,323971,323971,323973,0,2,0
92460,5,2,323976,323976,323978,0,2,3
92461,6,3,323982,323982,323985,0,3,4
92462,1,2,323983,323985,323987,2,4,0
92463,1,2,323984,323987,323989,3,5,0
92464,5,1,323989,323989,323990,0,1,0
92465,4,2,323993,323993,323995,0,2,3
92466,1,3,323994,323995,323998,1,4,0
92467,2,3,323996,323998,324001,2,5,0
92468,4,1,324000,324001,324002,1,2,0
92469,4,1,324004,324004,324005,0,1,2
92470,3,1,324007,324007,324008,0,1,2
92471,5,3,324012,324012,324015,0,3,4
92472,5,3,324017,324017,324020,0,3,2
92473,6,1,324023,324023,324024,0,1,3
92474,4,3,324027,324027,324030,0,3,3
92475,3,2,324030,324030,324032,0,2,0
92476,6,3,324036,324036,324039,0,3,4
92477,5,2,324041,324041,324043,0,2,2
92478,5,3,324046,324046,324049,0,3,3
92479,3,3,324049,324049,324052,0,3,0
92480,4,3,324053,324053,324056,0,3,1
92481,4,3,324057,324057,324060,0,3,1
92482,6,3,324063,324063,324066,0,3,3
92483,1,2,324064,324066,324068,2,4,0
92484,1,3,324065,324068,324071,3,6,0
92485,1,2,324066,324071,324073,5,7,0
92486,5,1,324071,324073,324074,2,3,0
92487,4,1,324075,324075,324076,0,1,1
92488,4,3,324079,324079,324082,0,3,3
92489,1,2,324080,324082,324084,2,4,0
92490,5,3,324085,324085,324088,0,3,1
92491,6,3,324091,324091,324094,0,3,3
92492,5,3,324096,324096,324099,0,3,2
92493,6,1,324102,324102,324103,0,1,3
92494,5,2,324107,324107,324109,0,2,4
92495,5,2,324112,324112,324114,0,2,3
92496,3,2,324115,324115,324117,0,2,1
92497,6,3,324121,324121,324124,0,3,4
92498,1,2,324122,324124,324126,2,4,0
92499,6,2,324128,324128,324130,0,2,2
92500,2,1,324130,324130,324131,0,1,0
92501,4,2,324134,324134,324136,0,2,3
92502,5,3,324139,324139,324142,0,3,3
92503,5,3,324144,324144,324147,0,3,2
92504,6,3,324150,324150,324153,0,3,3
92505,6,2,324156,324156,324158,0,2,3
92506,1,3,324157,324158,324161,1,4,0
92507,2,3,324159,324161,324164,2,5,0
92508,1,2,324160,324164,324166,4,6,0
92509,3,1,324163,324166,324167,3,4,0
92510,5,1,324168,324168,324169,0,1,1
92511,1,1,324169,324169,324170,0,1,0
92512,1,2,324170,324170,324172,0,2,0
92513,3,2,324173,324173,324175,0,2,1
92514,5,3,324178,324178,324181,0,3,3
92515,1,2,324179,324181,324183,2,4,0
92516,1,1,324180,324183,324184,3,4,0
92517,2,1,324182,324184,324185,2,3,0
92518,4,1,324186,324186,324187,0,1,1
92519,6,3,324192,324192,324195,0,3,5
92520,6,3,324198,324198,324201,0,3,3
92521,5,2,324203,324203,324205,0,2,2
92522,2,3,324205,324205,324208,0,3,0
92523,6,2,324211,324211,324213,0,2,3
92524,1,2,324212,324213,324215,1,3,0
92525,4,2,324216,324216,324218,0,2,1
92526,5,2,324221,324221,324223,0,2,3
92527,3,1,324224,324224,324225,0,1,1
92528,6,1,324230,324230,324231,0,1,5
92529,2,2,324232,324232,324234,0,2,1
92530,6,2,324238,324238,324240,0,2,4
92531,6,2,324244,324244,324246,0,2,4
92532,6,1,324250,324250,324251,0,1,4
92533,5,1,324255,324255,324256,0,1,4
92534,2,2,324257,324257,324259,0,2,1
92535,1,3,324258,324259,324262,1,4,0
92536,5,3,324263,324263,324266,0,3,1
92537,3,1,324266,324266,324267,0,1,0
92538,3,3,324269,324269,324272,0,3,2
92539,5,3,324274,324274,324277,0,3,2
92540,1,1,324275,324277,324278,2,3,0
92541,5,1,324280,324280,324281,0,1,2
92542,6,1,324286,324286,324287,0,1,5
92543,6,3,324292,324292,324295,0,3,5
92544,2,3,324294,324295,324298,1,4,0
92545,3,3,324297,324298,324301,1,4,0
92546,1,1,324298,324301,324302,3,4,0
92547,5,1,324303,324303,324304,0,1,1
92548,6,1,324309,324309,324310,0,1,5
92549,2,1,324311,324311,324312,0,1,1
92550,6,1,324317,324317,324318,0,1,5
92551,6,3,324323,324323,324326,0,3,5
92552,3,3,324326,324326,324329,0,3,0
92553,4,3,324330,324330,324333,0,3,1
92554,1,1,324331,324333,324334,2,3,0
92555,3,3,324334,324334,324337,0,3,0
92556,2,2,324336,324337,324339,1,3,0
92557,2,2,324338,324339,324341,1,3,0
92558,5,2,324343,324343,324345,0,2,2
92559,3,2,324346,324346,324348,0,2,1
92560,1,3,324347,324348,324351,1,4,0
92561,6,2,324353,324353,324355,0,2,2
92562,1,3,324354,324355,324358,1,4,0
92563,4,2,324358,324358,324360,0,2,0
92564,2,1,324360,324360,324361,0,1,0
92565,2,1,324362,324362,324363,0,1,1
92566,4,1,324366,324366,324367,0,1,3
92567,1,3,324367,324367,324370,0,3,0
92568,1,3,324368,324370,324373,2,5,0
92569,4,3,324372,324373,324376,1,4,0
92570,4,2,324376,324376,324378,0,2,0
92571,6,1,324382,324382,324383,0,1,4
92572,5,3,324387,324387,324390,0,3,4
92573,2,1,324389,324390,324391,1,2,0
92574,1,3,324390,324391,324394,1,4,0
92575,5,1,324395,324395,324396,0,1,1
92576,6,2,324401,324401,324403,0,2,5
92577,5,1,324406,324406,324407,0,1,3
92578,2,2,324408,324408,324410,0,2,1
92579,3,1,324411,324411,324412,0,1,1
92580,6,3,324417,324417,324420,0,3,5
92581,4,3,324421,324421,324424,0,3,1
92582,2,3,324423,324424,324427,1,4,0
92583,2,3,324425,324427,324430,2,5,0
92584,1,2,324426,324430,324432,4,6,0
92585,6,2,324432,324432,324434,0,2,0
92586,5,1,324437,324437,324438,0,1,3
92587,2,3,324439,324439,324442,0,3,1
92588,3,3,324442,324442,324445,0,3,0
92589,6,1,324448,324448,324449,0,1,3
92590,6,1,324454,324454,324455,0,1,5
92591,2,2,324456,324456,324458,0,2,1
92592,3,2,324459,324459,324461,0,2,1
92593,6,1,324465,324465,324466,0,1,4
92594,5,2,324470,324470,324472,0,2,4
92595,5,2,324475,324475,324477,0,2,3
92596,5,1,324480,324480,324481,0,1,3
92597,2,1,324482,324482,324483,0,1,1
92598,6,3,324488,324488,324491,0,3,5
92599,6,3,324494,324494,324497,0,3,3
92600,2,3,324496,324497,324500,1,4,0
92601,4,1,324500,324500,324501,0,1,0
92602,2,3,324502,324502,324505,0,3,1
92603,5,2,324507,324507,324509,0,2,2
92604,5,2,324512,324512,324514,0,2,3
92605,2,1,324514,324514,324515,0,1,0
92606,1,3,324515,324515,324518,0,3,0
92607,3,1,324518,324518,324519,0,1,0
92608,2,1,324520,324520,324521,0,1,1
92609,3,1,324523,324523,324524,0,1,2
92610,5,1,324528,324528,324529,0,1,4
92611,6,1,324534,324534,324535,0,1,5
92612,4,3,324538,324538,324541,0,3,3
92613,2,2,324540,324541,324543,1,3,0
92614,5,1,324545,324545,324546,0,1,2
92615,2,3,324547,324547,324550,0,3,1
92616,5,3,324552,324552,324555,0,3,2
92617,2,1,324554,324555,324556,1,2,0
92618,4,1,324558,324558,324559,0,1,2
92619,6,3,324564,324564,324567,0,3,5
92620,4,3,324568,324568,324571,0,3,1
92621,2,1,324570,324571,324572,1,2,0
92622,4,2,324574,324574,324576,0,2,2
92623,4,1,324578,324578,324579,0,1,2
92624,2,2,324580,324580,324582,0,2,1
92625,2,3,324582,324582,324585,0,3,0
92626,4,1,324586,324586,324587,0,1,1
92627,1,2,324587,324587,324589,0,2,0
92628,4,1,324591,324591,324592,0,1,2
92629,6,2,324597,324597,324599,0,2,5
92630,2,3,324599,324599,324602,0,3,0
92631,3,1,324602,324602,324603,0,1,0
92632,2,2,324604,324604,324606,0,2,1
92633,6,1,324610,324610,324611,0,1,4
92634,6,3,324616,324616,324619,0,3,5
92635,1,2,324617,324619,324621,2,4,0
92636,4,3,324621,324621,324624,0,3,0
92637,4,2,324625,324625,324627,0,2,1
92638,2,1,324627,324627,324628,0,1,0
92639,1,3,324628,324628,324631,0,3,0
92640,1,2,324629,324631,324633,2,4,0
92641,1,1,324630,324633,324634,3,4,0
92642,1,3,324631,324634,324637,3,6,0
92643,2,1,324633,324637,324638,4,5,0
92644,1,1,324634,324638,324639,4,5,0
92645,6,1,324640,324640,324641,0,1,1
92646,3,2,324643,324643,324645,0,2,2
92647,6,2,324649,324649,324651,0,2,4
92648,2,1,324651,324651,324652,0,1,0
92649,2,3,324653,324653,324656,0,3,1
92650,1,3,324654,324656,324659,2,5,0
92651,5,3,324659,324659,324662,0,3,0
92652,2,1,324661,324662,324663,1,2,0
92653,4,3,324665,324665,324668,0,3,2
92654,4,3,324669,324669,324672,0,3,1
92655,5,3,324674,324674,324677,0,3,2
92656,2,1,324676,324677,324678,1,2,0
92657,5,1,324681,324681,324682,0,1,3
92658,6,2,324687,324687,324689,0,2,5
92659,6,2,324693,324693,324695,0,2,4
92660,3,2,324696,324696,324698,0,2,1
92661,2,3,324698,324698,324701,0,3,0
92662,5,1,324703,324703,324704,0,1,2
92663,2,3,324705,324705,324708,0,3,1
92664,4,2,324709,324709,324711,0,2,1
92665,4,3,324713,324713,324716,0,3,2
92666,1,3,324714,324716,324719,2,5,0
92667,1,2,324715,324719,324721,4,6,0
92668,4,1,324719,324721,324722,2,3,0
92669,2,1,324721,324722,324723,1,2,0
92670,1,2,324722,324723,324725,1,3,0
92671,4,3,324726,324726,324729,0,3,1
92672,5,2,324731,324731,324733,0,2,2
92673,1,2,324732,324733,324735,1,3,0
92674,6,1,324738,324738,324739,0,1,3
92675,2,2,324740,324740,324742,0,2,1
92676,5,1,324745,324745,324746,0,1,3
92677,2,2,324747,324747,324749,0,2,1
92678,6,3,324753,324753,324756,0,3,4
92679,6,3,324759,324759,324762,0,3,3
92680,2,2,324761,324762,324764,1,3,0
92681,6,2,324767,324767,324769,0,2,3
92682,1,3,324768,324769,324772,1,4,0
92683,3,2,324771,324772,324774,1,3,0
92684,2,3,324773,324774,324777,1,4,0
92685,5,3,324778,324778,324781,0,3,1
92686,1,2,324779,324781,324783,2,4,0
92687,1,3,324780,324783,324786,3,6,0
92688,2,1,324782,324786,324787,4,5,0
92689,4,3,324786,324787,324790,1,4,0
92690,1,2,324787,324790,324792,3,5,0
92691,5,3,324792,324792,324795,0,3,0
92692,3,1,324795,324795,324796,0,1,0
92693,5,1,324800,324800,324801,0,1,4
92694,6,2,324806,324806,324808,0,2,5
92695,6,2,324812,324812,324814,0,2,4
92696,2,2,324814,324814,324816,0,2,0
92697,5,3,324819,324819,324822,0,3,3
92698,2,3,324821,324822,324825,1,4,0
92699,1,2,324822,324825,324827,3,5,0
92700,3,3,324825,324827,324830,2,5,0
92701,2,1,324827,324830,324831,3,4,0
92702,6,2,324833,324833,324835,0,2,2
92703,3,1,324836,324836,324837,0,1,1
92704,1,3,324837,324837,324840,0,3,0
92705,1,2,324838,324840,324842,2,4,0
92706,5,1,324843,324843,324844,0,1,1
92707,5,2,324848,324848,324850,0,2,4
92708,4,2,324852,324852,324854,0,2,2
92709,1,1,324853,324854,324855,1,2,0
92710,4,2,324857,324857,324859,0,2,2
92711,1,2,324858,324859,324861,1,3,0
92712,1,2,324859,324861,324863,2,4,0
92713,5,1,324864,324864,324865,0,1,1
92714,2,3,324866,324866,324869,0,3,1
92715,5,2,324871,324871,324873,0,2,2
92716,2,2,324873,324873,324875,0,2,0
92717,6,3,324879,324879,324882,0,3,4
92718,2,3,324881,324882,324885,1,4,0
92719,1,3,324882,324885,324888,3,6,0
92720,1,2,324883,324888,324890,5,7,0
92721,5,2,324888,324890,324892,2,4,0
92722,3,2,324891,324892,324894,1,3,0
92723,2,3,324893,324894,324897,1,4,0
92724,3,1,324896,324897,324898,1,2,0
92725,3,3,324899,324899,324902,0,3,1
92726,6,3,324905,324905,324908,0,3,3
92727,6,3,324911,324911,324914,0,3,3
92728,1,1,324912,324914,324915,2,3,0
92729,6,3,324918,324918,324921,0,3,3
92730,4,1,324922,324922,324923,0,1,1
92731,1,1,324923,324923,324924,0,1,0
92732,6,1,324929,324929,324930,0,1,5
92733,3,1,324932,324932,324933,0,1,2
92734,2,1,324934,324934,324935,0,1,1
92735,2,3,324936,324936,324939,0,3,1
92736,3,3,324939,324939,324942,0,3,0
92737,2,3,324941,324942,324945,1,4,0
92738,2,1,324943,324945,324946,2,3,0
92739,2,1,324945,324946,324947,1,2,0
92740,2,3,324947,324947,324950,0,3,0
92741,4,2,324951,324951,324953,0,2,1
92742,6,1,324957,324957,324958,0,1,4
92743,5,3,324962,324962,324965,0,3,4
92744,1,1,324963,324965,324966,2,3,0
92745,4,2,324967,324967,324969,0,2,1
92746,4,3,324971,324971,324974,0,3,2
92747,4,2,324975,324975,324977,0,2,1
92748,1,1,324976,324977,324978,1,2,0
92749,4,3,324980,324980,324983,0,3,2
92750,4,2,324984,324984,324986,0,2,1
92751,3,2,324987,324987,324989,0,2,1
92752,6,1,324993,324993,324994,0,1,4
92753,1,1,324994,324994,324995,0,1,0
92754,2,3,324996,324996,324999,0,3,1
92755,5,2,325001,325001,325003,0,2,2
92756,2,3,325003,325003,325006,0,3,0
92757,6,2,325009,325009,325011,0,2,3
92758,2,2,325011,325011,325013,0,2,0
92759,6,3,325017,325017,325020,0,3,4
92760,3,1,325020,325020,325021,0,1,0
92761,4,3,325024,325024,325027,0,3,3
92762,2,3,325026,325027,325030,1,4,0
92763,5,2,325031,325031,325033,0,2,1
92764,5,1,325036,325036,325037,0,1,3
92765,1,1,325037,325037,325038,0,1,0
92766,4,3,325041,325041,325044,0,3,3
92767,3,3,325044,325044,325047,0,3,0
92768,1,2,325045,325047,325049,2,4,0
92769,4,1,325049,325049,325050,0,1,0
92770,2,1,325051,325051,325052,0,1,1
92771,1,2,325052,325052,325054,0,2,0
92772,4,3,325056,325056,325059,0,3,2
92773,2,2,325058,325059,325061,1,3,0
92774,3,3,325061,325061,325064,0,3,0
92775,5,2,325066,325066,325068,0,2,2
92776,1,3,325067,325068,325071,1,4,0
92777,4,3,325071,325071,325074,0,3,0
92778,4,2,325075,325075,325077,0,2,1
92779,1,1,325076,325077,325078,1,2,0
92780,3,1,325079,325079,325080,0,1,1
92781,4,3,325083,325083,325086,0,3,3
92782,4,3,325087,325087,325090,0,3,1
92783,4,1,325091,325091,325092,0,1,1
92784,2,2,325093,325093,325095,0,2,1
92785,2,1,325095,325095,325096,0,1,0
92786,3,1,325098,325098,325099,0,1,2
92787,3,1,325101,325101,325102,0,1,2
92788,5,2,325106,325106,325108,0,2,4
92789,2,3,325108,325108,325111,0,3,0
92790,4,3,325112,325112,325115,0,3,1
92791,2,2,325114,325115,325117,1,3,0
92792,2,1,325116,325117,325118,1,2,0
92793,2,3,325118,325118,325121,0,3,0
92794,1,2,325119,325121,325123,2,4,0
92795,3,1,325122,325123,325124,1,2,0
92796,1,3,325123,325124,325127,1,4,0
92797,2,1,325125,325127,325128,2,3,0
92798,2,1,325127,325128,325129,1,2,0
92799,2,3,325129,325129,325132,0,3,0
92800,3,1,325132,325132,325133,0,1,0
92801,6,2,325138,325138,325140,0,2,5
92802,5,1,325143,325143,325144,0,1,3
92803,4,3,325147,325147,325150,0,3,3
92804,1,1,325148,325150,325151,2,3,0
92805,3,2,325151,325151,325153,0,2,0
92806,6,3,325157,325157,325160,0,3,4
92807,6,1,325163,325163,325164,0,1,3
92808,1,3,325164,325164,325167,0,3,0
92809,2,1,325166,325167,325168,1,2,0
92810,2,1,325168,325168,325169,0,1,0
92811,5,3,325173,325173,325176,0,3,4
92812,4,3,325177,325177,325180,0,3,1
92813,6,3,325183,325183,325186,0,3,3
92814,3,3,325186,325186,325189,0,3,0
92815,6,3,325192,325192,325195,0,3,3
92816,6,2,325198,325198,325200,0,2,3
92817,4,2,325202,325202,325204,0,2,2
92818,2,2,325204,325204,325206,0,2,0
92819,1,3,325205,325206,325209,1,4,0
92820,6,1,325211,325211,325212,0,1,2
92821,2,2,325213,325213,325215,0,2,1
92822,6,3,325219,325219,325222,0,3,4
92823,5,3,325224,325224,325227,0,3,2
92824,4,2,325228,325228,325230,0,2,1
92825,2,2,325230,325230,325232,0,2,0
92826,2,1,325232,325232,325233,0,1,0
92827,4,2,325236,325236,325238,0,2,3
92828,6,2,325242,325242,325244,0,2,4
92829,1,1,325243,325244,325245,1,2,0
92830,1,1,325244,325245,325246,1,2,0
92831,2,1,325246,325246,325247,0,1,0
92832,6,3,325252,325252,325255,0,3,5
92833,4,1,325256,325256,325257,0,1,1
92834,5,2,325261,325261,325263,0,2,4
92835,1,2,325262,325263,325265,1,3,0
92836,3,1,325265,325265,325266,0,1,0
92837,1,3,325266,325266,325269,0,3,0
92838,2,1,325268,325269,325270,1,2,0
92839,2,1,325270,325270,325271,0,1,0
92840,3,2,325273,325273,325275,0,2,2
92841,1,1,325274,325275,325276,1,2,0
92842,6,3,325280,325280,325283,0,3,4
92843,6,3,325286,325286,325289,0,3,3
92844,5,1,325291,325291,325292,0,1,2
92845,6,2,325297,325297,325299,0,2,5
92846,6,2,325303,325303,325305,0,2,4
92847,5,3,325308,325308,325311,0,3,3
92848,1,3,325309,325311,325314,2,5,0
92849,3,3,325312,325314,325317,2,5,0
92850,5,1,325317,325317,325318,0,1,0
92851,1,1,325318,325318,325319,0,1,0
92852,1,2,325319,325319,325321,0,2,0
92853,3,3,325322,325322,325325,0,3,1
92854,1,1,325323,325325,325326,2,3,0
92855,1,1,325324,325326,325327,2,3,0
92856,6,3,325330,325330,325333,0,3,3
92857,5,2,325335,325335,325337,0,2,2
92858,5,1,325340,325340,325341,0,1,3
92859,4,2,325344,325344,325346,0,2,3
92860,4,3,325348,325348,325351,0,3,2
92861,1,2,325349,325351,325353,2,4,0
92862,6,1,325355,325355,325356,0,1,2
92863,1,1,325356,325356,325357,0,1,0
92864,4,1,325360,325360,325361,0,1,3
92865,1,3,325361,325361,325364,0,3,0
92866,3,2,325364,325364,325366,0,2,0
92867,3,2,325367,325367,325369,0,2,1
92868,1,3,325368,325369,325372,1,4,0
92869,5,3,325373,325373,325376,0,3,1
92870,1,2,325374,325376,325378,2,4,0
92871,1,2,325375,325378,325380,3,5,0
92872,6,1,325381,325381,325382,0,1,1
92873,4,2,325385,325385,325387,0,2,3
92874,6,3,325391,325391,325394,0,3,4
92875,1,3,325392,325394,325397,2,5,0
92876,1,3,325393,325397,325400,4,7,0
92877,3,2,325396,325400,325402,4,6,0
92878,5,2,325401,325402,325404,1,3,0
92879,2,1,325403,325404,325405,1,2,0
92880,2,1,325405,325405,325406,0,1,0
92881,4,2,325409,325409,325411,0,2,3
92882,4,1,325413,325413,325414,0,1,2
92883,2,2,325415,325415,325417,0,2,1
92884,1,1,325416,325417,325418,1,2,0
92885,6,1,325422,325422,325423,0,1,4
92886,6,3,325428,325428,325431,0,3,5
92887,3,2,325431,325431,325433,0,2,0
92888,6,1,325437,325437,325438,0,1,4
92889,4,1,325441,325441,325442,0,1,3
92890,4,1,325445,325445,325446,0,1,3
92891,5,2,325450,325450,325452,0,2,4
92892,4,2,325454,325454,325456,0,2,2
92893,5,2,325459,325459,325461,0,2,3
92894,5,3,325464,325464,325467,0,3,3
92895,4,1,325468,325468,325469,0,1,1
92896,5,2,325473,325473,325475,0,2,4
92897,3,3,325476,325476,325479,0,3,1
92898,1,1,325477,325479,325480,2,3,0
92899,3,1,325480,325480,325481,0,1,0
92900,2,2,325482,325482,325484,0,2,1
92901,5,3,325487,325487,325490,0,3,3
92902,2,2,325489,325490,325492,1,3,0
92903,6,3,325495,325495,325498,0,3,3
92904,6,2,325501,325501,325503,0,2,3
92905,4,3,325505,325505,325508,0,3,2
92906,5,2,325510,325510,325512,0,2,2
92907,6,2,325516,325516,325518,0,2,4
92908,4,3,325520,325520,325523,0,3,2
92909,2,1,325522,325523,325524,1,2,0
92910,6,3,325528,325528,325531,0,3,4
92911,4,3,325532,325532,325535,0,3,1
92912,1,2,325533,325535,325537,2,4,0
92913,2,2,325535,325537,325539,2,4,0
92914,3,2,325538,325539,325541,1,3,0
92915,1,3,325539,325541,325544,2,5,0
92916,2,2,325541,325544,325546,3,5,0
92917,1,2,325542,325546,325548,4,6,0
92918,6,2,325548,325548,325550,0,2,0
92919,5,2,325553,325553,325555,0,2,3
92920,6,3,325559,325559,325562,0,3,4
92921,2,2,325561,325562,325564,1,3,0
92922,1,3,325562,325564,325567,2,5,0
92923,5,1,325567,325567,325568,0,1,0
92924,2,1,325569,325569,325570,0,1,1
92925,1,2,325570,325570,325572,0,2,0
92926,5,3,325575,325575,325578,0,3,3
92927,3,1,325578,325578,325579,0,1,0
92928,6,1,325584,325584,325585,0,1,5
92929,6,3,325590,325590,325593,0,3,5
92930,4,3,325594,325594,325597,0,3,1
92931,2,1,325596,325597,325598,1,2,0
92932,2,3,325598,325598,325601,0,3,0
92933,1,1,325599,325601,325602,2,3,0
92934,6,1,325605,325605,325606,0,1,3
92935,5,2,325610,325610,325612,0,2,4
92936,4,1,325614,325614,325615,0,1,2
92937,6,3,325620,325620,325623,0,3,5
92938,2,2,325622,325623,325625,1,3,0
92939,2,1,325624,325625,325626,1,2,0
92940,3,2,325627,325627,325629,0,2,1
92941,4,2,325631,325631,325633,0,2,2
92942,1,1,325632,325633,325634,1,2,0
92943,6,3,325638,325638,325641,0,3,4
92944,3,1,325641,325641,325642,0,1,0
92945,3,2,325644,325644,325646,0,2,2
92946,4,2,325648,325648,325650,0,2,2
92947,3,1,325651,325651,325652,0,1,1
92948,1,2,325652,325652,325654,0,2,0
92949,3,3,325655,325655,325658,0,3,1
92950,5,1,325660,325660,325661,0,1,2
92951,6,2,325666,325666,325668,0,2,5
92952,2,3,325668,325668,325671,0,3,0
92953,2,2,325670,325671,325673,1,3,0
92954,2,2,325672,325673,325675,1,3,0
92955,4,1,325676,325676,325677,0,1,1
92956,4,2,325680,325680,325682,0,2,3
92957,1,2,325681,325682,325684,1,3,0
92958,1,1,325682,325684,325685,2,3,0
92959,1,2,325683,325685,325687,2,4,0
92960,5,2,325688,325688,325690,0,2,1
92961,3,2,325691,325691,325693,0,2,1
92962,4,2,325695,325695,325697,0,2,2
92963,6,2,325701,325701,325703,0,2,4
92964,4,3,325705,325705,325708,0,3,2
92965,5,2,325710,325710,325712,0,2,2
92966,4,1,325714,325714,325715,0,1,2
92967,4,3,325718,325718,325721,0,3,3
92968,1,3,325719,325721,325724,2,5,0
92969,6,2,325725,325725,325727,0,2,1
92970,1,1,325726,325727,325728,1,2,0
92971,6,2,325732,325732,325734,0,2,4
92972,5,3,325737,325737,325740,0,3,3
92973,6,1,325743,325743,325744,0,1,3
92974,2,2,325745,325745,325747,0,2,1
92975,1,1,325746,325747,325748,1,2,0
92976,3,3,325749,325749,325752,0,3,1
92977,5,3,325754,325754,325757,0,3,2
92978,1,3,325755,325757,325760,2,5,0
92979,3,2,325758,325760,325762,2,4,0
92980,4,3,325762,325762,325765,0,3,0
92981,6,3,325768,325768,325771,0,3,3
92982,2,1,325770,325771,325772,1,2,0
92983,5,2,325775,325775,325777,0,2,3
92984,2,1,325777,325777,325778,0,1,0
92985,4,3,325781,325781,325784,0,3,3
92986,1,2,325782,325784,325786,2,4,0
92987,1,3,325783,325786,325789,3,6,0
92988,6,2,325789,325789,325791,0,2,0
92989,5,2,325794,325794,325796,0,2,3
92990,3,3,325797,325797,325800,0,3,1
92991,6,3,325803,325803,325806,0,3,3
92992,1,1,325804,325806,325807,2,3,0
92993,3,1,325807,325807,325808,0,1,0
92994,3,2,325810,325810,325812,0,2,2
92995,2,3,325812,325812,325815,0,3,0
92996,1,3,325813,325815,325818,2,5,0
92997,5,1,325818,325818,325819,0,1,0
92998,4,2,325822,325822,325824,0,2,3
92999,1,3,325823,325824,325827,1,4,0
93000,1,3,325824,325827,325830,3,6,0
93001,2,1,325826,325830,325831,4,5,0
93002,6,3,325832,325832,325835,0,3,1
93003,2,1,325834,325835,325836,1,2,0
93004,5,3,325839,325839,325842,0,3,3
93005,4,2,325843,325843,325845,0,2,1
93006,1,3,325844,325845,325848,1,4,0
93007,3,1,325847,325848,325849,1,2,0
93008,3,3,325850,325850,325853,0,3,1
93009,1,2,325851,325853,325855,2,4,0
93010,3,1,325854,325855,325856,1,2,0
93011,4,3,325858,325858,325861,0,3,2
93012,4,3,325862,325862,325865,0,3,1
93013,2,2,325864,325865,325867,1,3,0
93014,5,2,325869,325869,325871,0,2,2
93015,2,3,325871,325871,325874,0,3,0
93016,5,1,325876,325876,325877,0,1,2
93017,6,2,325882,325882,325884,0,2,5
93018,4,1,325886,325886,325887,0,1,2
93019,1,2,325887,325887,325889,0,2,0
93020,1,3,325888,325889,325892,1,4,0
93021,6,2,325894,325894,325896,0,2,2
93022,1,1,325895,325896,325897,1,2,0
93023,5,1,325900,325900,325901,0,1,3
93024,1,1,325901,325901,325902,0,1,0
93025,4,1,325905,325905,325906,0,1,3
93026,3,1,325908,325908,325909,0,1,2
93027,1,2,325909,325909,325911,0,2,0
93028,6,2,325915,325915,325917,0,2,4
93029,3,1,325918,325918,325919,0,1,1
93030,3,3,325921,325921,325924,0,3,2
93031,3,2,325924,325924,325926,0,2,0
93032,5,3,325929,325929,325932,0,3,3
93033,6,2,325935,325935,325937,0,2,3
93034,6,1,325941,325941,325942,0,1,4
93035,5,2,325946,325946,325948,0,2,4
93036,1,2,325947,325948,325950,1,3,0
93037,6,1,325953,325953,325954,0,1,3
93038,6,2,325959,325959,325961,0,2,5
93039,6,1,325965,325965,325966,0,1,4
93040,2,2,325967,325967,325969,0,2,1
93041,2,2,325969,325969,325971,0,2,0
93042,3,3,325972,325972,325975,0,3,1
93043,4,2,325976,325976,325978,0,2,1
93044,6,1,325982,325982,325983,0,1,4
93045,2,1,325984,325984,325985,0,1,1
93046,2,3,325986,325986,325989,0,3,1
93047,6,2,325992,325992,325994,0,2,3
93048,6,2,325998,325998,326000,0,2,4
93049,2,3,326000,326000,326003,0,3,0
93050,1,2,326001,326003,326005,2,4,0
93051,3,1,326004,326005,326006,1,2,0
93052,1,1,326005,326006,326007,1,2,0
93053,1,1,326006,326007,326008,1,2,0
93054,1,2,326007,326008,326010,1,3,0
93055,4,1,326011,326011,326012,0,1,1
93056,3,1,326014,326014,326015,0,1,2
93057,2,1,326016,326016,326017,0,1,1
93058,5,2,326021,326021,326023,0,2,4
93059,6,3,326027,326027,326030,0,3,4
93060,3,3,326030,326030,326033,0,3,0
93061,5,2,326035,326035,326037,0,2,2
93062,2,3,326037,326037,326040,0,3,0
93063,4,1,326041,326041,326042,0,1,1
93064,3,3,326044,326044,326047,0,3,2
93065,3,2,326047,326047,326049,0,2,0
93066,3,2,326050,326050,326052,0,2,1
93067,1,1,326051,326052,326053,1,2,0
93068,4,3,326055,326055,326058,0,3,2
93069,6,1,326061,326061,326062,0,1,3
93070,6,1,326067,326067,326068,0,1,5
93071,2,2,326069,326069,326071,0,2,1
93072,4,1,326073,326073,326074,0,1,2
93073,2,1,326075,326075,326076,0,1,1
93074,2,3,326077,326077,326080,0,3,1
93075,3,2,326080,326080,326082,0,2,0
93076,6,3,326086,326086,326089,0,3,4
93077,5,3,326091,326091,326094,0,3,2
93078,4,2,326095,326095,326097,0,2,1
93079,3,2,326098,326098,326100,0,2,1
93080,6,3,326104,326104,326107,0,3,4
93081,5,1,326109,326109,326110,0,1,2
93082,4,1,326113,326113,326114,0,1,3
93083,2,3,326115,326115,326118,0,3,1
93084,6,1,326121,326121,326122,0,1,3
93085,5,3,326126,326126,326129,0,3,4
93086,4,1,326130,326130,326131,0,1,1
93087,4,1,326134,326134,326135,0,1,3
93088,2,2,326136,326136,326138,0,2,1
93089,4,2,326140,326140,326142,0,2,2
93090,2,2,326142,326142,326144,0,2,0
93091,2,2,326144,326144,326146,0,2,0
93092,2,2,326146,326146,326148,0,2,0
93093,2,2,326148,326148,326150,0,2,0
93094,5,1,326153,326153,326154,0,1,3
93095,3,2,326156,326156,326158,0,2,2
93096,3,1,326159,326159,326160,0,1,1
93097,1,1,326160,326160,326161,0,1,0
93098,2,1,326162,326162,326163,0,1,1
93099,4,1,326166,326166,326167,0,1,3
93100,2,3,326168,326168,326171,0,3,1
93101,6,1,326174,326174,326175,0,1,3
93102,2,1,326176,326176,326177,0,1,1
93103,6,2,326182,326182,326184,0,2,5
93104,3,3,326185,326185,326188,0,3,1
93105,2,2,326187,326188,326190,1,3,0
93106,1,2,326188,326190,326192,2,4,0
93107,5,2,326193,326193,326195,0,2,1
93108,1,2,326194,326195,326197,1,3,0
93109,4,2,326198,326198,326200,0,2,1
93110,3,1,326201,326201,326202,0,1,1
93111,3,1,326204,326204,326205,0,1,2
93112,3,2,326207,326207,326209,0,2,2
93113,2,3,326209,326209,326212,0,3,0
93114,6,3,326215,326215,326218,0,3,3
93115,3,1,326218,326218,326219,0,1,0
93116,2,3,326220,326220,326223,0,3,1
93117,2,3,326222,326223,326226,1,4,0
93118,1,3,326223,326226,326229,3,6,0
93119,1,2,326224,326229,326231,5,7,0
93120,6,1,326230,326231,326232,1,2,0
93121,1,1,326231,326232,326233,1,2,0
93122,1,3,326232,326233,326236,1,4,0
93123,3,2,326235,326236,326238,1,3,0
93124,2,3,326237,326238,326241,1,4,0
93125,2,2,326239,326241,326243,2,4,0
93126,4,3,326243,326243,326246,0,3,0
93127,5,2,326248,326248,326250,0,2,2
93128,1,2,326249,326250,326252,1,3,0
93129,4,1,326253,326253,326254,0,1,1
93130,2,2,326255,326255,326257,0,2,1
93131,2,3,326257,326257,326260,0,3,0
93132,5,3,326262,326262,326265,0,3,2
93133,3,3,326265,326265,326268,0,3,0
93134,5,2,326270,326270,326272,0,2,2
93135,1,2,326271,326272,326274,1,3,0
93136,3,2,326274,326274,326276,0,2,0
93137,4,1,326278,326278,326279,0,1,2
93138,4,3,326282,326282,326285,0,3,3
93139,2,3,326284,326285,326288,1,4,0
93140,3,3,326287,326288,326291,1,4,0
93141,5,3,326292,326292,326295,0,3,1
93142,2,1,326294,326295,326296,1,2,0
93143,5,2,326299,326299,326301,0,2,3
93144,2,3,326301,326301,326304,0,3,0
93145,5,1,326306,326306,326307,0,1,2
93146,3,3,326309,326309,326312,0,3,2
93147,3,3,326312,326312,326315,0,3,0
93148,2,3,326314,326315,326318,1,4,0
93149,1,2,326315,326318,326320,3,5,0
93150,5,3,326320,326320,326323,0,3,0
93151,5,3,326325,326325,326328,0,3,2
93152,2,1,326327,326328,326329,1,2,0
93153,1,1,326328,326329,326330,1,2,0
93154,4,2,326332,326332,326334,0,2,2
93155,5,1,326337,326337,326338,0,1,3
93156,6,1,326343,326343,326344,0,1,5
93157,3,2,326346,326346,326348,0,2,2
93158,4,2,326350,326350,326352,0,2,2
93159,5,1,326355,326355,326356,0,1,3
93160,3,2,326358,326358,326360,0,2,2
93161,5,2,326363,326363,326365,0,2,3
93162,3,1,326366,326366,326367,0,1,1
93163,4,2,326370,326370,326372,0,2,3
93164,6,2,326376,326376,326378,0,2,4
93165,4,3,326380,326380,326383,0,3,2
93166,3,1,326383,326383,326384,0,1,0
93167,2,3,326385,326385,326388,0,3,1
93168,3,3,326388,326388,326391,0,3,0
93169,2,2,326390,326391,326393,1,3,0
93170,1,3,326391,326393,326396,2,5,0
93171,4,2,326395,326396,326398,1,3,0
93172,2,2,326397,326398,326400,1,3,0
93173,2,3,326399,326400,326403,1,4,0
93174,1,3,326400,326403,326406,3,6,0
93175,4,3,326404,326406,326409,2,5,0
93176,5,3,326409,326409,326412,0,3,0
93177,3,3,326412,326412,326415,0,3,0
93178,2,2,326414,326415,326417,1,3,0
93179,1,1,326415,326417,326418,2,3,0
93180,2,2,326417,326418,326420,1,3,0
93181,1,2,326418,326420,326422,2,4,0
93182,3,3,326421,326422,326425,1,4,0
93183,5,1,326426,326426,326427,0,1,1
93184,5,2,326431,326431,326433,0,2,4
93185,1,2,326432,326433,326435,1,3,0
93186,6,3,326438,326438,326441,0,3,3
93187,1,2,326439,326441,326443,2,4,0
93188,6,2,326445,326445,326447,0,2,2
93189,2,1,326447,326447,326448,0,1,0
93190,1,3,326448,326448,326451,0,3,0
93191,2,1,326450,326451,326452,1,2,0
93192,6,2,326456,326456,326458,0,2,4
93193,1,1,326457,326458,326459,1,2,0
93194,3,2,326460,326460,326462,0,2,1
93195,1,3,326461,326462,326465,1,4,0
93196,1,2,326462,326465,326467,3,5,0
93197,2,1,326464,326467,326468,3,4,0
93198,2,3,326466,326468,326471,2,5,0
93199,6,1,326472,326472,326473,0,1,1
93200,5,3,326477,326477,326480,0,3,4
93201,4,2,326481,326481,326483,0,2,1
93202,2,1,326483,326483,326484,0,1,0
93203,4,3,326487,326487,326490,0,3,3
93204,5,3,326492,326492,326495,0,3,2
93205,4,2,326496,326496,326498,0,2,1
93206,4,2,326500,326500,326502,0,2,2
93207,5,2,326505,326505,326507,0,2,3
93208,4,3,326509,326509,326512,0,3,2
93209,4,1,326513,326513,326514,0,1,1
93210,6,2,326519,326519,326521,0,2,5
93211,3,1,326522,326522,326523,0,1,1
93212,4,2,326526,326526,326528,0,2,3
93213,1,3,326527,326528,326531,1,4,0
93214,2,1,326529,326531,326532,2,3,0
93215,1,2,326530,326532,326534,2,4,0
93216,6,1,326536,326536,326537,0,1,2
93217,5,3,326541,326541,326544,0,3,4
93218,3,3,326544,326544,326547,0,3,0
93219,1,2,326545,326547,326549,2,4,0
93220,1,3,326546,326549,326552,3,6,0
93221,6,2,326552,326552,326554,0,2,0
93222,2,1,326554,326554,326555,0,1,0
93223,1,2,326555,326555,326557,0,2,0
93224,2,1,326557,326557,326558,0,1,0
93225,6,2,326563,326563,326565,0,2,5
93226,3,3,326566,326566,326569,0,3,1
93227,3,1,326569,326569,326570,0,1,0
93228,1,3,326570,326570,326573,0,3,0
93229,1,2,326571,326573,326575,2,4,0
93230,1,1,326572,326575,326576,3,4,0
93231,4,1,326576,326576,326577,0,1,0
93232,1,3,326577,326577,326580,0,3,0
93233,4,3,326581,326581,326584,0,3,1
93234,5,3,326586,326586,326589,0,3,2
93235,5,3,326591,326591,326594,0,3,2
93236,6,1,326597,326597,326598,0,1,3
93237,1,3,326598,326598,326601,0,3,0
93238,4,1,326602,326602,326603,0,1,1
93239,3,3,326605,326605,326608,0,3,2
93240,4,1,326609,326609,326610,0,1,1
93241,5,3,326614,326614,326617,0,3,4
93242,3,3,326617,326617,326620,0,3,0
93243,6,1,326623,326623,326624,0,1,3
93244,2,1,326625,326625,326626,0,1,1
93245,6,3,326631,326631,326634,0,3,5
93246,6,3,326637,326637,326640,0,3,3
93247,3,3,326640,326640,326643,0,3,0
93248,1,3,326641,326643,326646,2,5,0
93249,2,3,326643,326646,326649,3,6,0
93250,4,1,326647,326649,326650,2,3,0
93251,4,3,326651,326651,326654,0,3,1
93252,2,1,326653,326654,326655,1,2,0
93253,1,2,326654,326655,326657,1,3,0
93254,4,3,326658,326658,326661,0,3,1
93255,2,1,326660,326661,326662,1,2,0
93256,1,3,326661,326662,326665,1,4,0
93257,5,3,326666,326666,326669,0,3,1
93258,2,1,326668,326669,326670,1,2,0
93259,6,3,326674,326674,326677,0,3,4
93260,4,3,326678,326678,326681,0,3,1
93261,5,1,326683,326683,326684,0,1,2
93262,6,1,326689,326689,326690,0,1,5
93263,3,3,326692,326692,326695,0,3,2
93264,5,2,326697,326697,326699,0,2,2
93265,2,1,326699,326699,326700,0,1,0
93266,2,1,326701,326701,326702,0,1,1
93267,1,3,326702,326702,326705,0,3,0
93268,3,2,326705,326705,326707,0,2,0
93269,1,2,326706,326707,326709,1,3,0
93270,3,3,326709,326709,326712,0,3,0
93271,2,1,326711,326712,326713,1,2,0
93272,1,1,326712,326713,326714,1,2,0
93273,2,3,326714,326714,326717,0,3,0
93274,6,2,326720,326720,326722,0,2,3
93275,4,2,326724,326724,326726,0,2,2
93276,6,3,326730,326730,326733,0,3,4
93277,1,3,326731,326733,326736,2,5,0
93278,3,1,326734,326736,326737,2,3,0
93279,1,2,326735,326737,326739,2,4,0
93280,4,3,326739,326739,326742,0,3,0
93281,5,1,326744,326744,326745,0,1,2
93282,6,1,326750,326750,326751,0,1,5
93283,5,3,326755,326755,326758,0,3,4
93284,4,3,326759,326759,326762,0,3,1
93285,6,1,326765,326765,326766,0,1,3
93286,5,2,326770,326770,326772,0,2,4
93287,2,2,326772,326772,326774,0,2,0
93288,4,3,326776,326776,326779,0,3,2
93289,1,3,326777,326779,326782,2,5,0
93290,5,1,326782,326782,326783,0,1,0
93291,2,2,326784,326784,326786,0,2,1
93292,4,1,326788,326788,326789,0,1,2
93293,6,3,326794,326794,326797,0,3,5
93294,2,3,326796,326797,326800,1,4,0
93295,2,1,326798,326800,326801,2,3,0
93296,5,2,326803,326803,326805,0,2,2
93297,2,3,326805,326805,326808,0,3,0
93298,4,2,326809,326809,326811,0,2,1
93299,5,3,326814,326814,326817,0,3,3
93300,3,2,326817,326817,326819,0,2,0
93301,6,3,326823,326823,326826,0,3,4
93302,4,1,326827,326827,326828,0,1,1
93303,6,1,326833,326833,326834,0,1,5
93304,6,3,326839,326839,326842,0,3,5
93305,1,1,326840,326842,326843,2,3,0
93306,4,3,326844,326844,326847,0,3,1
93307,6,3,326850,326850,326853,0,3,3
93308,5,2,326855,326855,326857,0,2,2
93309,3,3,326858,326858,326861,0,3,1
93310,5,1,326863,326863,326864,0,1,2
93311,3,3,326866,326866,326869,0,3,2
93312,2,1,326868,326869,326870,1,2,0
93313,5,1,326873,326873,326874,0,1,3
93314,1,2,326874,326874,326876,0,2,0
93315,3,3,326877,326877,326880,0,3,1
93316,2,1,326879,326880,326881,1,2,0
93317,6,2,326885,326885,326887,0,2,4
93318,2,1,326887,326887,326888,0,1,0
93319,4,1,326891,326891,326892,0,1,3
93320,1,1,326892,326892,326893,0,1,0
93321,1,3,326893,326893,326896,0,3,0
93322,2,2,326895,326896,326898,1,3,0
93323,6,2,326901,326901,326903,0,2,3
93324,1,1,326902,326903,326904,1,2,0
93325,4,1,326906,326906,326907,0,1,2
93326,4,2,326910,326910,326912,0,2,3
93327,1,3,326911,326912,326915,1,4,0
93328,5,3,326916,326916,326919,0,3,1
93329,3,2,326919,326919,326921,0,2,0
93330,2,1,326921,326921,326922,0,1,0
93331,6,3,326927,326927,326930,0,3,5
93332,2,2,326929,326930,326932,1,3,0
93333,5,3,326934,326934,326937,0,3,2
93334,5,3,326939,326939,326942,0,3,2
93335,3,3,326942,326942,326945,0,3,0
93336,1,1,326943,326945,326946,2,3,0
93337,4,3,326947,326947,326950,0,3,1
93338,5,3,326952,326952,326955,0,3,2
93339,5,1,326957,326957,326958,0,1,2
93340,4,3,326961,326961,326964,0,3,3
93341,5,3,326966,326966,326969,0,3,2
93342,6,2,326972,326972,326974,0,2,3
93343,3,2,326975,326975,326977,0,2,1
93344,6,2,326981,326981,326983,0,2,4
93345,2,2,326983,326983,326985,0,2,0
93346,4,2,326987,326987,326989,0,2,2
93347,6,3,326993,326993,326996,0,3,4
93348,2,1,326995,326996,326997,1,2,0
93349,5,3,327000,327000,327003,0,3,3
93350,3,3,327003,327003,327006,0,3,0
93351,1,2,327004,327006,327008,2,4,0
93352,5,3,327009,327009,327012,0,3,1
93353,3,3,327012,327012,327015,0,3,0
93354,5,2,327017,327017,327019,0,2,2
93355,3,2,327020,327020,327022,0,2,1
93356,2,3,327022,327022,327025,0,3,0
93357,2,1,327024,327025,327026,1,2,0
93358,6,1,327030,327030,327031,0,1,4
93359,3,2,327033,327033,327035,0,2,2
93360,1,1,327034,327035,327036,1,2,0
93361,3,3,327037,327037,327040,0,3,1
93362,4,3,327041,327041,327044,0,3,1
93363,6,2,327047,327047,327049,0,2,3
93364,6,2,327053,327053,327055,0,2,4
93365,5,2,327058,327058,327060,0,2,3
93366,2,1,327060,327060,327061,0,1,0
93367,4,1,327064,327064,327065,0,1,3
93368,4,2,327068,327068,327070,0,2,3
93369,2,2,327070,327070,327072,0,2,0
93370,2,2,327072,327072,327074,0,2,0
93371,2,1,327074,327074,327075,0,1,0
93372,3,2,327077,327077,327079,0,2,2
93373,6,3,327083,327083,327086,0,3,4
93374,4,2,327087,327087,327089,0,2,1
93375,4,3,327091,327091,327094,0,3,2
93376,2,3,327093,327094,327097,1,4,0
93377,6,2,327099,327099,327101,0,2,2
93378,2,2,327101,327101,327103,0,2,0
93379,6,3,327107,327107,327110,0,3,4
93380,2,2,327109,327110,327112,1,3,0
93381,3,2,327112,327112,327114,0,2,0
93382,4,1,327116,327116,327117,0,1,2
93383,3,3,327119,327119,327122,0,3,2
93384,3,1,327122,327122,327123,0,1,0
93385,6,1,327128,327128,327129,0,1,5
93386,6,3,327134,327134,327137,0,3,5
93387,2,2,327136,327137,327139,1,3,0
93388,5,3,327141,327141,327144,0,3,2
93389,1,1,327142,327144,327145,2,3,0
93390,6,2,327148,327148,327150,0,2,3
93391,6,2,327154,327154,327156,0,2,4
93392,4,3,327158,327158,327161,0,3,2
93393,2,1,327160,327161,327162,1,2,0
93394,3,2,327163,327163,327165,0,2,1
93395,5,3,327168,327168,327171,0,3,3
93396,3,1,327171,327171,327172,0,1,0
93397,2,2,327173,327173,327175,0,2,1
93398,1,2,327174,327175,327177,1,3,0
93399,6,1,327180,327180,327181,0,1,3
93400,4,1,327184,327184,327185,0,1,3
93401,2,1,327186,327186,327187,0,1,1
93402,3,3,327189,327189,327192,0,3,2
93403,3,1,327192,327192,327193,0,1,0
93404,1,3,327193,327193,327196,0,3,0
93405,5,2,327198,327198,327200,0,2,2
93406,2,1,327200,327200,327201,0,1,0
93407,1,1,327201,327201,327202,0,1,0
93408,3,2,327204,327204,327206,0,2,2
93409,1,2,327205,327206,327208,1,3,0
93410,4,1,327209,327209,327210,0,1,1
93411,5,3,327214,327214,327217,0,3,4
93412,4,2,327218,327218,327220,0,2,1
93413,3,3,327221,327221,327224,0,3,1
93414,3,2,327224,327224,327226,0,2,0
93415,3,2,327227,327227,327229,0,2,1
93416,6,2,327233,327233,327235,0,2,4
93417,6,3,327239,327239,327242,0,3,4
93418,6,1,327245,327245,327246,0,1,3
93419,1,2,327246,327246,327248,0,2,0
93420,3,2,327249,327249,327251,0,2,1
93421,5,2,327254,327254,327256,0,2,3
93422,6,1,327260,327260,327261,0,1,4
93423,4,1,327264,327264,327265,0,1,3
93424,2,1,327266,327266,327267,0,1,1
93425,2,3,327268,327268,327271,0,3,1
93426,3,1,327271,327271,327272,0,1,0
93427,5,3,327276,327276,327279,0,3,4
93428,2,2,327278,327279,327281,1,3,0
93429,3,2,327281,327281,327283,0,2,0
93430,4,2,327285,327285,327287,0,2,2
93431,4,2,327289,327289,327291,0,2,2
93432,2,3,327291,327291,327294,0,3,0
93433,5,2,327296,327296,327298,0,2,2
93434,5,1,327301,327301,327302,0,1,3
93435,1,3,327302,327302,327305,0,3,0
93436,2,1,327304,327305,327306,1,2,0
93437,4,2,327308,327308,327310,0,2,2
93438,3,3,327311,327311,327314,0,3,1
93439,3,3,327314,327314,327317,0,3,0
93440,3,1,327317,327317,327318,0,1,0
93441,1,3,327318,327318,327321,0,3,0
93442,2,3,327320,327321,327324,1,4,0
93443,1,2,327321,327324,327326,3,5,0
93444,2,2,327323,327326,327328,3,5,0
93445,1,3,327324,327328,327331,4,7,0
93446,5,2,327329,327331,327333,2,4,0
93447,3,3,327332,327333,327336,1,4,0
93448,5,2,327337,327337,327339,0,2,1
93449,4,1,327341,327341,327342,0,1,2
93450,3,1,327344,327344,327345,0,1,2
93451,2,1,327346,327346,327347,0,1,1
93452,6,3,327352,327352,327355,0,3,5
93453,4,3,327356,327356,327359,0,3,1
93454,1,1,327357,327359,327360,2,3,0
93455,1,3,327358,327360,327363,2,5,0
93456,5,3,327363,327363,327366,0,3,0
93457,3,2,327366,327366,327368,0,2,0
93458,5,1,327371,327371,327372,0,1,3
93459,1,2,327372,327372,327374,0,2,0
93460,5,2,327377,327377,327379,0,2,3
93461,4,3,327381,327381,327384,0,3,2
93462,2,3,327383,327384,327387,1,4,0
93463,6,3,327389,327389,327392,0,3,2
93464,4,2,327393,327393,327395,0,2,1
93465,4,2,327397,327397,327399,0,2,2
93466,3,2,327400,327400,327402,0,2,1
93467,5,1,327405,327405,327406,0,1,3
93468,3,2,327408,327408,327410,0,2,2
93469,1,1,327409,327410,327411,1,2,0
93470,4,3,327413,327413,327416,0,3,2
93471,4,1,327417,327417,327418,0,1,1
93472,1,2,327418,327418,327420,0,2,0
93473,3,2,327421,327421,327423,0,2,1
93474,2,2,327423,327423,327425,0,2,0
93475,4,3,327427,327427,327430,0,3,2
93476,5,1,327432,327432,327433,0,1,2
93477,1,2,327433,327433,327435,0,2,0
93478,2,2,327435,327435,327437,0,2,0
93479,3,3,327438,327438,327441,0,3,1
93480,3,2,327441,327441,327443,0,2,0
93481,4,1,327445,327445,327446,0,1,2
93482,4,3,327449,327449,327452,0,3,3
93483,3,2,327452,327452,327454,0,2,0
93484,2,1,327454,327454,327455,0,1,0
93485,2,1,327456,327456,327457,0,1,1
93486,6,1,327462,327462,327463,0,1,5
93487,5,3,327467,327467,327470,0,3,4
93488,4,3,327471,327471,327474,0,3,1
93489,5,2,327476,327476,327478,0,2,2
93490,5,2,327481,327481,327483,0,2,3
93491,6,3,327487,327487,327490,0,3,4
93492,4,3,327491,327491,327494,0,3,1
93493,6,2,327497,327497,327499,0,2,3
93494,4,3,327501,327501,327504,0,3,2
93495,2,3,327503,327504,327507,1,4,0
93496,5,2,327508,327508,327510,0,2,1
93497,5,1,327513,327513,327514,0,1,3
93498,4,1,327517,327517,327518,0,1,3
93499,2,3,327519,327519,327522,0,3,1
93500,6,2,327525,327525,327527,0,2,3
93501,1,2,327526,327527,327529,1,3,0
93502,1,3,327527,327529,327532,2,5,0
93503,6,2,327533,327533,327535,0,2,1
93504,5,2,327538,327538,327540,0,2,3
93505,1,3,327539,327540,327543,1,4,0
93506,1,1,327540,327543,327544,3,4,0
93507,4,1,327544,327544,327545,0,1,0
93508,2,3,327546,327546,327549,0,3,1
93509,2,3,327548,327549,327552,1,4,0
93510,5,3,327553,327553,327556,0,3,1
93511,1,3,327554,327556,327559,2,5,0
93512,6,2,327560,327560,327562,0,2,1
93513,3,3,327563,327563,327566,0,3,1
93514,4,1,327567,327567,327568,0,1,1
93515,4,2,327571,327571,327573,0,2,3
93516,5,1,327576,327576,327577,0,1,3
93517,5,2,327581,327581,327583,0,2,4
93518,6,1,327587,327587,327588,0,1,4
93519,5,2,327592,327592,327594,0,2,4
93520,3,1,327595,327595,327596,0,1,1
93521,4,3,327599,327599,327602,0,3,3
93522,1,2,327600,327602,327604,2,4,0
93523,4,3,327604,327604,327607,0,3,0
93524,1,1,327605,327607,327608,2,3,0
93525,2,3,327607,327608,327611,1,4,0
93526,3,3,327610,327611,327614,1,4,0
93527,2,1,327612,327614,327615,2,3,0
93528,3,3,327615,327615,327618,0,3,0
93529,1,3,327616,327618,327621,2,5,0
93530,4,1,327620,327621,327622,1,2,0
93531,6,3,327626,327626,327629,0,3,4
93532,4,1,327630,327630,327631,0,1,1
93533,3,1,327633,327633,327634,0,1,2
93534,5,2,327638,327638,327640,0,2,4
93535,2,2,327640,327640,327642,0,2,0
93536,1,3,327641,327642,327645,1,4,0
93537,2,1,327643,327645,327646,2,3,0
93538,1,1,327644,327646,327647,2,3,0
93539,2,1,327646,327647,327648,1,2,0
93540,5,2,327651,327651,327653,0,2,3
93541,2,2,327653,327653,327655,0,2,0
93542,1,3,327654,327655,327658,1,4,0
93543,4,3,327658,327658,327661,0,3,0
93544,2,2,327660,327661,327663,1,3,0
93545,2,2,327662,327663,327665,1,3,0
93546,3,1,327665,327665,327666,0,1,0
93547,5,2,327670,327670,327672,0,2,4
93548,1,1,327671,327672,327673,1,2,0
93549,2,2,327673,327673,327675,0,2,0
93550,5,1,327678,327678,327679,0,1,3
93551,2,2,327680,327680,327682,0,2,1
93552,4,2,327684,327684,327686,0,2,2
93553,4,2,327688,327688,327690,0,2,2
93554,2,1,327690,327690,327691,0,1,0
93555,3,1,327693,327693,327694,0,1,2
93556,6,3,327699,327699,327702,0,3,5
93557,6,1,327705,327705,327706,0,1,3
93558,3,3,327708,327708,327711,0,3,2
93559,4,3,327712,327712,327715,0,3,1
93560,3,1,327715,327715,327716,0,1,0
93561,3,3,327718,327718,327721,0,3,2
93562,5,2,327723,327723,327725,0,2,2
93563,3,3,327726,327726,327729,0,3,1
93564,5,2,327731,327731,327733,0,2,2
93565,2,1,327733,327733,327734,0,1,0
93566,3,2,327736,327736,327738,0,2,2
93567,3,1,327739,327739,327740,0,1,1
93568,1,1,327740,327740,327741,0,1,0
93569,6,2,327746,327746,327748,0,2,5
93570,3,2,327749,327749,327751,0,2,1
93571,1,1,327750,327751,327752,1,2,0
93572,1,1,327751,327752,327753,1,2,0
93573,2,1,327753,327753,327754,0,1,0
93574,2,3,327755,327755,327758,0,3,1
93575,6,3,327761,327761,327764,0,3,3
93576,2,1,327763,327764,327765,1,2,0
93577,2,2,327765,327765,327767,0,2,0
93578,3,1,327768,327768,327769,0,1,1
93579,5,2,327773,327773,327775,0,2,4
93580,4,2,327777,327777,327779,0,2,2
93581,3,1,327780,327780,327781,0,1,1
93582,2,3,327782,327782,327785,0,3,1
93583,1,3,327783,327785,327788,2,5,0
93584,1,2,327784,327788,327790,4,6,0
93585,5,3,327789,327790,327793,1,4,0
93586,5,1,327794,327794,327795,0,1,1
93587,3,1,327797,327797,327798,0,1,2
93588,5,3,327802,327802,327805,0,3,4
93589,6,2,327808,327808,327810,0,2,3
93590,1,2,327809,327810,327812,1,3,0
93591,6,2,327815,327815,327817,0,2,3
93592,6,1,327821,327821,327822,0,1,4
93593,1,2,327822,327822,327824,0,2,0
93594,1,1,327823,327824,327825,1,2,0
93595,5,3,327828,327828,327831,0,3,3
93596,4,3,327832,327832,327835,0,3,1
93597,5,1,327837,327837,327838,0,1,2
93598,1,3,327838,327838,327841,0,3,0
93599,2,1,327840,327841,327842,1,2,0
93600,4,2,327844,327844,327846,0,2,2
93601,3,3,327847,327847,327850,0,3,1
93602,5,2,327852,327852,327854,0,2,2
93603,3,2,327855,327855,327857,0,2,1
93604,2,3,327857,327857,327860,0,3,0
93605,1,2,327858,327860,327862,2,4,0
93606,4,1,327862,327862,327863,0,1,0
93607,4,3,327866,327866,327869,0,3,3
93608,2,2,327868,327869,327871,1,3,0
93609,3,1,327871,327871,327872,0,1,0
93610,2,1,327873,327873,327874,0,1,1
93611,5,2,327878,327878,327880,0,2,4
93612,6,3,327884,327884,327887,0,3,4
93613,4,3,327888,327888,327891,0,3,1
93614,6,3,327894,327894,327897,0,3,3
93615,3,3,327897,327897,327900,0,3,0
93616,6,1,327903,327903,327904,0,1,3
93617,1,1,327904,327904,327905,0,1,0
93618,2,2,327906,327906,327908,0,2,1
93619,3,1,327909,327909,327910,0,1,1
93620,2,2,327911,327911,327913,0,2,1
93621,4,1,327915,327915,327916,0,1,2
93622,6,1,327921,327921,327922,0,1,5
93623,6,3,327927,327927,327930,0,3,5
93624,2,2,327929,327930,327932,1,3,0
93625,4,1,327933,327933,327934,0,1,1
93626,3,1,327936,327936,327937,0,1,2
93627,2,3,327938,327938,327941,0,3,1
93628,4,1,327942,327942,327943,0,1,1
93629,2,2,327944,327944,327946,0,2,1
93630,6,3,327950,327950,327953,0,3,4
93631,3,2,327953,327953,327955,0,2,0
93632,6,2,327959,327959,327961,0,2,4
93633,4,1,327963,327963,327964,0,1,2
93634,2,1,327965,327965,327966,0,1,1
93635,3,2,327968,327968,327970,0,2,2
93636,5,3,327973,327973,327976,0,3,3
93637,5,2,327978,327978,327980,0,2,2
93638,6,2,327984,327984,327986,0,2,4
93639,2,3,327986,327986,327989,0,3,0
93640,2,3,327988,327989,327992,1,4,0
93641,5,1,327993,327993,327994,0,1,1
93642,6,1,327999,327999,328000,0,1,5
93643,5,1,328004,328004,328005,0,1,4
93644,5,2,328009,328009,328011,0,2,4
93645,4,3,328013,328013,328016,0,3,2
93646,3,3,328016,328016,328019,0,3,0
93647,6,2,328022,328022,328024,0,2,3
93648,2,1,328024,328024,328025,0,1,0
93649,6,2,328030,328030,328032,0,2,5
93650,6,2,328036,328036,328038,0,2,4
93651,2,3,328038,328038,328041,0,3,0
93652,3,1,328041,328041,328042,0,1,0
93653,2,3,328043,328043,328046,0,3,1
93654,4,2,328047,328047,328049,0,2,1
93655,5,1,328052,328052,328053,0,1,3
93656,2,3,328054,328054,328057,0,3,1
93657,2,1,328056,328057,328058,1,2,0
93658,3,1,328059,328059,328060,0,1,1
93659,1,1,328060,328060,328061,0,1,0
93660,1,1,328061,328061,328062,0,1,0
93661,2,1,328063,328063,328064,0,1,1
93662,6,2,328069,328069,328071,0,2,5
93663,1,1,328070,328071,328072,1,2,0
93664,2,1,328072,328072,328073,0,1,0
93665,2,3,328074,328074,328077,0,3,1
93666,2,3,328076,328077,328080,1,4,0
93667,5,2,328081,328081,328083,0,2,1
93668,4,1,328085,328085,328086,0,1,2
93669,6,3,328091,328091,328094,0,3,5
93670,4,2,328095,328095,328097,0,2,1
93671,5,2,328100,328100,328102,0,2,3
93672,1,2,328101,328102,328104,1,3,0
93673,2,2,328103,328104,328106,1,3,0
93674,3,3,328106,328106,328109,0,3,0
93675,4,3,328110,328110,328113,0,3,1
93676,6,2,328116,328116,328118,0,2,3
93677,3,2,328119,328119,328121,0,2,1
93678,1,2,328120,328121,328123,1,3,0
93679,5,1,328125,328125,328126,0,1,2
93680,3,3,328128,328128,328131,0,3,2
93681,6,3,328134,328134,328137,0,3,3
93682,1,2,328135,328137,328139,2,4,0
93683,5,2,328140,328140,328142,0,2,1
93684,3,2,328143,328143,328145,0,2,1
93685,3,1,328146,328146,328147,0,1,1
93686,4,2,328150,328150,328152,0,2,3
93687,2,1,328152,328152,328153,0,1,0
93688,6,1,328158,328158,328159,0,1,5
93689,2,3,328160,328160,328163,0,3,1
93690,6,1,328166,328166,328167,0,1,3
93691,1,1,328167,328167,328168,0,1,0
93692,6,2,328173,328173,328175,0,2,5
93693,5,3,328178,328178,328181,0,3,3
93694,5,3,328183,328183,328186,0,3,2
93695,4,2,328187,328187,328189,0,2,1
93696,6,1,328193,328193,328194,0,1,4
93697,6,1,328199,328199,328200,0,1,5
93698,5,1,328204,328204,328205,0,1,4
93699,5,3,328209,328209,328212,0,3,4
93700,3,2,328212,328212,328214,0,2,0
93701,2,3,328214,328214,328217,0,3,0
93702,1,2,328215,328217,328219,2,4,0
93703,3,1,328218,328219,328220,1,2,0
93704,2,2,328220,328220,328222,0,2,0
93705,4,2,328224,328224,328226,0,2,2
93706,5,3,328229,328229,328232,0,3,3
93707,1,1,328230,328232,328233,2,3,0
93708,5,2,328235,328235,328237,0,2,2
93709,3,2,328238,328238,328240,0,2,1
93710,4,2,328242,328242,328244,0,2,2
93711,5,1,328247,328247,328248,0,1,3
93712,1,1,328248,328248,328249,0,1,0
93713,4,3,328252,328252,328255,0,3,3
93714,5,3,328257,328257,328260,0,3,2
93715,4,3,328261,328261,328264,0,3,1
93716,1,1,328262,328264,328265,2,3,0
93717,2,3,328264,328265,328268,1,4,0
93718,2,3,328266,328268,328271,2,5,0
93719,4,3,328270,328271,328274,1,4,0
93720,6,3,328276,328276,328279,0,3,2
93721,6,2,328282,328282,328284,0,2,3
93722,6,1,328288,328288,328289,0,1,4
93723,5,1,328293,328293,328294,0,1,4
93724,5,3,328298,328298,328301,0,3,4
93725,2,2,328300,328301,328303,1,3,0
93726,6,2,328306,328306,328308,0,2,3
93727,3,2,328309,328309,328311,0,2,1
93728,5,2,328314,328314,328316,0,2,3
93729,5,3,328319,328319,328322,0,3,3
93730,5,2,328324,328324,328326,0,2,2
93731,2,1,328326,328326,328327,0,1,0
93732,1,2,328327,328327,328329,0,2,0
93733,5,3,328332,328332,328335,0,3,3
93734,5,2,328337,328337,328339,0,2,2
93735,5,1,328342,328342,328343,0,1,3
93736,2,2,328344,328344,328346,0,2,1
93737,2,2,328346,328346,328348,0,2,0
93738,5,2,328351,328351,328353,0,2,3
93739,4,1,328355,328355,328356,0,1,2
93740,6,3,328361,328361,328364,0,3,5
93741,6,3,328367,328367,328370,0,3,3
93742,1,3,328368,328370,328373,2,5,0
93743,1,1,328369,328373,328374,4,5,0
93744,5,3,328374,328374,328377,0,3,0
93745,1,3,328375,328377,328380,2,5,0
93746,4,2,328379,328380,328382,1,3,0
93747,3,1,328382,328382,328383,0,1,0
93748,4,1,328386,328386,328387,0,1,3
93749,5,1,328391,328391,328392,0,1,4
93750,5,3,328396,328396,328399,0,3,4
93751,1,1,328397,328399,328400,2,3,0
93752,2,1,328399,328400,328401,1,2,0
93753,6,2,328405,328405,328407,0,2,4
93754,6,3,328411,328411,328414,0,3,4
93755,5,1,328416,328416,328417,0,1,2
93756,5,1,328421,328421,328422,0,1,4
93757,4,1,328425,328425,328426,0,1,3
93758,6,2,328431,328431,328433,0,2,5
93759,1,3,328432,328433,328436,1,4,0
93760,1,1,328433,328436,328437,3,4,0
93761,5,3,328438,328438,328441,0,3,1
93762,5,3,328443,328443,328446,0,3,2
93763,6,1,328449,328449,328450,0,1,3
93764,2,1,328451,328451,328452,0,1,1
93765,4,2,328455,328455,328457,0,2,3
93766,2,2,328457,328457,328459,0,2,0
93767,5,2,328462,328462,328464,0,2,3
93768,4,3,328466,328466,328469,0,3,2
93769,4,2,328470,328470,328472,0,2,1
93770,3,2,328473,328473,328475,0,2,1
93771,2,2,328475,328475,328477,0,2,0
93772,3,1,328478,328478,328479,0,1,1
93773,2,1,328480,328480,328481,0,1,1
93774,4,3,328484,328484,328487,0,3,3
93775,1,1,328485,328487,328488,2,3,0
93776,6,1,328491,328491,328492,0,1,3
93777,5,3,328496,328496,328499,0,3,4
93778,2,2,328498,328499,328501,1,3,0
93779,5,2,328503,328503,328505,0,2,2
93780,1,2,328504,328505,328507,1,3,0
93781,4,2,328508,328508,328510,0,2,1
93782,6,1,328514,328514,328515,0,1,4
93783,5,1,328519,328519,328520,0,1,4
93784,4,1,328523,328523,328524,0,1,3
93785,1,2,328524,328524,328526,0,2,0
93786,4,3,328528,328528,328531,0,3,2
93787,5,1,328533,328533,328534,0,1,2
93788,4,3,328537,328537,328540,0,3,3
93789,3,3,328540,328540,328543,0,3,0
93790,3,1,328543,328543,328544,0,1,0
93791,5,1,328548,328548,328549,0,1,4
93792,4,1,328552,328552,328553,0,1,3
93793,5,1,328557,328557,328558,0,1,4
93794,6,1,328563,328563,328564,0,1,5
93795,4,3,328567,328567,328570,0,3,3
93796,2,3,328569,328570,328573,1,4,0
93797,6,2,328575,328575,328577,0,2,2
93798,6,3,328581,328581,328584,0,3,4
93799,5,2,328586,328586,328588,0,2,2
93800,5,1,328591,328591,328592,0,1,3
93801,2,2,328593,328593,328595,0,2,1
93802,6,2,328599,328599,328601,0,2,4
93803,6,1,328605,328605,328606,0,1,4
93804,1,1,328606,328606,328607,0,1,0
93805,5,3,328611,328611,328614,0,3,4
93806,6,2,328617,328617,328619,0,2,3
93807,1,1,328618,328619,328620,1,2,0
93808,4,3,328622,328622,328625,0,3,2
93809,1,2,328623,328625,328627,2,4,0
93810,5,2,328628,328628,328630,0,2,1
93811,2,1,328630,328630,328631,0,1,0
93812,1,2,328631,328631,328633,0,2,0
93813,4,1,328635,328635,328636,0,1,2
93814,1,3,328636,328636,328639,0,3,0
93815,2,2,328638,328639,328641,1,3,0
93816,2,2,328640,328641,328643,1,3,0
93817,2,3,328642,328643,328646,1,4,0
93818,1,3,328643,328646,328649,3,6,0
93819,2,3,328645,328649,328652,4,7,0
93820,2,1,328647,328652,328653,5,6,0
93821,3,3,328650,328653,328656,3,6,0
93822,4,1,328654,328656,328657,2,3,0
93823,6,1,328660,328660,328661,0,1,3
93824,1,2,328661,328661,328663,0,2,0
93825,5,2,328666,328666,328668,0,2,3
93826,3,1,328669,328669,328670,0,1,1
93827,2,3,328671,328671,328674,0,3,1
93828,2,1,328673,328674,328675,1,2,0
93829,1,2,328674,328675,328677,1,3,0
93830,6,3,328680,328680,328683,0,3,3
93831,1,2,328681,328683,328685,2,4,0
93832,1,1,328682,328685,328686,3,4,0
93833,2,2,328684,328686,328688,2,4,0
93834,3,1,328687,328688,328689,1,2,0
93835,2,2,328689,328689,328691,0,2,0
93836,4,3,328693,328693,328696,0,3,2
93837,6,3,328699,328699,328702,0,3,3
93838,4,3,328703,328703,328706,0,3,1
93839,2,1,328705,328706,328707,1,2,0
93840,1,3,328706,328707,328710,1,4,0
93841,2,3,328708,328710,328713,2,5,0
93842,3,3,328711,328713,328716,2,5,0
93843,4,1,328715,328716,328717,1,2,0
93844,2,3,328717,328717,328720,0,3,0
93845,5,3,328722,328722,328725,0,3,2
93846,3,3,328725,328725,328728,0,3,0
93847,6,1,328731,328731,328732,0,1,3
93848,5,2,328736,328736,328738,0,2,4
93849,4,1,328740,328740,328741,0,1,2
93850,5,1,328745,328745,328746,0,1,4
93851,3,3,328748,328748,328751,0,3,2
93852,5,3,328753,328753,328756,0,3,2
93853,1,2,328754,328756,328758,2,4,0
93854,4,3,328758,328758,328761,0,3,0
93855,2,1,328760,328761,328762,1,2,0
93856,6,2,328766,328766,328768,0,2,4
93857,6,2,328772,328772,328774,0,2,4
93858,5,1,328777,328777,328778,0,1,3
93859,5,1,328782,328782,328783,0,1,4
93860,6,1,328788,328788,328789,0,1,5
93861,4,3,328792,328792,328795,0,3,3
93862,1,2,328793,328795,328797,2,4,0
93863,4,1,328797,328797,328798,0,1,0
93864,5,3,328802,328802,328805,0,3,4
93865,5,3,328807,328807,328810,0,3,2
93866,4,1,328811,328811,328812,0,1,1
93867,3,2,328814,328814,328816,0,2,2
93868,1,2,328815,328816,328818,1,3,0
93869,4,1,328819,328819,328820,0,1,1
93870,2,3,328821,328821,328824,0,3,1
93871,4,1,328825,328825,328826,0,1,1
93872,4,1,328829,328829,328830,0,1,3
93873,4,3,328833,328833,328836,0,3,3
93874,2,1,328835,328836,328837,1,2,0
93875,5,1,328840,328840,328841,0,1,3
93876,6,1,328846,328846,328847,0,1,5
93877,2,1,328848,328848,328849,0,1,1
93878,3,3,328851,328851,328854,0,3,2
93879,3,3,328854,328854,328857,0,3,0
93880,3,1,328857,328857,328858,0,1,0
93881,4,1,328861,328861,328862,0,1,3
93882,4,2,328865,328865,328867,0,2,3
93883,6,3,328871,328871,328874,0,3,4
93884,1,3,328872,328874,328877,2,5,0
93885,6,2,328878,328878,328880,0,2,1
93886,4,3,328882,328882,328885,0,3,2
93887,2,2,328884,328885,328887,1,3,0
93888,2,3,328886,328887,328890,1,4,0
93889,2,2,328888,328890,328892,2,4,0
93890,5,3,328893,328893,328896,0,3,1
93891,3,2,328896,328896,328898,0,2,0
93892,3,2,328899,328899,328901,0,2,1
93893,6,2,328905,328905,328907,0,2,4
93894,5,3,328910,328910,328913,0,3,3
93895,4,1,328914,328914,328915,0,1,1
93896,6,2,328920,328920,328922,0,2,5
93897,3,2,328923,328923,328925,0,2,1
93898,6,2,328929,328929,328931,0,2,4
93899,2,2,328931,328931,328933,0,2,0
93900,2,1,328933,328933,328934,0,1,0
93901,4,2,328937,328937,328939,0,2,3
93902,5,2,328942,328942,328944,0,2,3
93903,5,1,328947,328947,328948,0,1,3
93904,5,1,328952,328952,328953,0,1,4
93905,3,1,328955,328955,328956,0,1,2
93906,2,1,328957,328957,328958,0,1,1
93907,2,2,328959,328959,328961,0,2,1
93908,6,3,328965,328965,328968,0,3,4
93909,4,2,328969,328969,328971,0,2,1
93910,3,2,328972,328972,328974,0,2,1
93911,6,2,328978,328978,328980,0,2,4
93912,3,2,328981,328981,328983,0,2,1
93913,1,3,328982,328983,328986,1,4,0
93914,4,3,328986,328986,328989,0,3,0
93915,1,1,328987,328989,328990,2,3,0
93916,5,1,328992,328992,328993,0,1,2
93917,5,1,328997,328997,328998,0,1,4
93918,5,1,329002,329002,329003,0,1,4
93919,4,3,329006,329006,329009,0,3,3
93920,5,1,329011,329011,329012,0,1,2
93921,2,3,329013,329013,329016,0,3,1
93922,5,3,329018,329018,329021,0,3,2
93923,5,2,329023,329023,329025,0,2,2
93924,6,1,329029,329029,329030,0,1,4
93925,2,1,329031,329031,329032,0,1,1
93926,2,3,329033,329033,329036,0,3,1
93927,6,3,329039,329039,329042,0,3,3
93928,6,2,329045,329045,329047,0,2,3
93929,6,2,329051,329051,329053,0,2,4
93930,2,1,329053,329053,329054,0,1,0
93931,4,2,329057,329057,329059,0,2,3
93932,1,1,329058,329059,329060,1,2,0
93933,3,3,329061,329061,329064,0,3,1
93934,6,3,329067,329067,329070,0,3,3
93935,1,1,329068,329070,329071,2,3,0
93936,4,1,329072,329072,329073,0,1,1
93937,3,3,329075,329075,329078,0,3,2
93938,4,3,329079,329079,329082,0,3,1
93939,5,3,329084,329084,329087,0,3,2
93940,6,3,329090,329090,329093,0,3,3
93941,6,2,329096,329096,329098,0,2,3
93942,1,3,329097,329098,329101,1,4,0
93943,4,1,329101,329101,329102,0,1,0
93944,4,3,329105,329105,329108,0,3,3
93945,3,2,329108,329108,329110,0,2,0
93946,2,2,329110,329110,329112,0,2,0
93947,1,3,329111,329112,329115,1,4,0
93948,1,1,329112,329115,329116,3,4,0
93949,4,1,329116,329116,329117,0,1,0
93950,1,1,329117,329117,329118,0,1,0
93951,5,3,329122,329122,329125,0,3,4
93952,2,2,329124,329125,329127,1,3,0
93953,3,2,329127,329127,329129,0,2,0
93954,1,2,329128,329129,329131,1,3,0
93955,5,2,329133,329133,329135,0,2,2
93956,1,1,329134,329135,329136,1,2,0
93957,4,2,329138,329138,329140,0,2,2
93958,6,1,329144,329144,329145,0,1,4
93959,3,2,329147,329147,329149,0,2,2
93960,2,3,329149,329149,329152,0,3,0
93961,3,2,329152,329152,329154,0,2,0
93962,1,2,329153,329154,329156,1,3,0
93963,3,1,329156,329156,329157,0,1,0
93964,5,2,329161,329161,329163,0,2,4
93965,1,3,329162,329163,329166,1,4,0
93966,2,1,329164,329166,329167,2,3,0
93967,4,1,329168,329168,329169,0,1,1
93968,2,3,329170,329170,329173,0,3,1
93969,2,1,329172,329173,329174,1,2,0
93970,4,3,329176,329176,329179,0,3,2
93971,1,2,329177,329179,329181,2,4,0
93972,6,3,329183,329183,329186,0,3,2
93973,3,1,329186,329186,329187,0,1,0
93974,6,3,329192,329192,329195,0,3,5
93975,2,3,329194,329195,329198,1,4,0
93976,5,1,329199,329199,329200,0,1,1
93977,3,1,329202,329202,329203,0,1,2
93978,4,1,329206,329206,329207,0,1,3
93979,1,1,329207,329207,329208,0,1,0
93980,6,1,329213,329213,329214,0,1,5
93981,3,3,329216,329216,329219,0,3,2
93982,6,3,329222,329222,329225,0,3,3
93983,2,1,329224,329225,329226,1,2,0
93984,3,1,329227,329227,329228,0,1,1
93985,2,1,329229,329229,329230,0,1,1
93986,4,1,329233,329233,329234,0,1,3
93987,2,3,329235,329235,329238,0,3,1
93988,4,1,329239,329239,329240,0,1,1
93989,2,1,329241,329241,329242,0,1,1
93990,1,2,329242,329242,329244,0,2,0
93991,5,2,329247,329247,329249,0,2,3
93992,6,3,329253,329253,329256,0,3,4
93993,5,3,329258,329258,329261,0,3,2
93994,3,2,329261,329261,329263,0,2,0
93995,6,2,329267,329267,329269,0,2,4
93996,6,1,329273,329273,329274,0,1,4
93997,3,2,329276,329276,329278,0,2,2
93998,6,1,329282,329282,329283,0,1,4
93999,3,2,329285,329285,329287,0,2,2
94000,2,2,329287,329287,329289,0,2,0
94001,6,3,329293,329293,329296,0,3,4
94002,6,2,329299,329299,329301,0,2,3
94003,2,3,329301,329301,329304,0,3,0
94004,6,1,329307,329307,329308,0,1,3
94005,4,2,329311,329311,329313,0,2,3
94006,6,1,329317,329317,329318,0,1,4
94007,1,1,329318,329318,329319,0,1,0
94008,3,2,329321,329321,329323,0,2,2
94009,1,3,329322,329323,329326,1,4,0
94010,1,3,329323,329326,329329,3,6,0
94011,2,1,329325,329329,329330,4,5,0
94012,6,2,329331,329331,329333,0,2,1
94013,2,2,329333,329333,329335,0,2,0
94014,6,1,329339,329339,329340,0,1,4
94015,4,2,329343,329343,329345,0,2,3
94016,1,1,329344,329345,329346,1,2,0
94017,2,3,329346,329346,329349,0,3,0
94018,6,2,329352,329352,329354,0,2,3
94019,5,2,329357,329357,329359,0,2,3
94020,3,1,329360,329360,329361,0,1,1
94021,1,2,329361,329361,329363,0,2,0
94022,3,1,329364,329364,329365,0,1,1
94023,3,1,329367,329367,329368,0,1,2
94024,2,1,329369,329369,329370,0,1,1
94025,2,1,329371,329371,329372,0,1,1
94026,4,2,329375,329375,329377,0,2,3
94027,4,1,329379,329379,329380,0,1,2
94028,3,3,329382,329382,329385,0,3,2
94029,5,3,329387,329387,329390,0,3,2
94030,3,3,329390,329390,329393,0,3,0
94031,2,2,329392,329393,329395,1,3,0
94032,3,1,329395,329395,329396,0,1,0
94033,2,2,329397,329397,329399,0,2,1
94034,2,1,329399,329399,329400,0,1,0
94035,4,3,329403,329403,329406,0,3,3
94036,5,3,329408,329408,329411,0,3,2
94037,4,3,329412,329412,329415,0,3,1
94038,3,1,329415,329415,329416,0,1,0
94039,4,2,329419,329419,329421,0,2,3
94040,6,2,329425,329425,329427,0,2,4
94041,4,2,329429,329429,329431,0,2,2
94042,6,3,329435,329435,329438,0,3,4
94043,2,3,329437,329438,329441,1,4,0
94044,4,3,329441,329441,329444,0,3,0
94045,1,3,329442,329444,329447,2,5,0
94046,3,2,329445,329447,329449,2,4,0
94047,3,3,329448,329449,329452,1,4,0
94048,5,2,329453,329453,329455,0,2,1
94049,4,2,329457,329457,329459,0,2,2
94050,6,2,329463,329463,329465,0,2,4
94051,2,1,329465,329465,329466,0,1,0
94052,2,3,329467,329467,329470,0,3,1
94053,4,1,329471,329471,329472,0,1,1
94054,5,2,329476,329476,329478,0,2,4
94055,1,3,329477,329478,329481,1,4,0
94056,3,2,329480,329481,329483,1,3,0
94057,2,2,329482,329483,329485,1,3,0
94058,4,1,329486,329486,329487,0,1,1
94059,4,2,329490,329490,329492,0,2,3
94060,4,2,329494,329494,329496,0,2,2
94061,6,2,329500,329500,329502,0,2,4
94062,1,3,329501,329502,329505,1,4,0
94063,3,1,329504,329505,329506,1,2,0
94064,3,3,329507,329507,329510,0,3,1
94065,5,2,329512,329512,329514,0,2,2
94066,5,1,329517,329517,329518,0,1,3
94067,5,1,329522,329522,329523,0,1,4
94068,1,1,329523,329523,329524,0,1,0
94069,1,2,329524,329524,329526,0,2,0
94070,1,1,329525,329526,329527,1,2,0
94071,6,3,329531,329531,329534,0,3,4
94072,6,3,329537,329537,329540,0,3,3
94073,6,1,329543,329543,329544,0,1,3
94074,1,3,329544,329544,329547,0,3,0
94075,2,1,329546,329547,329548,1,2,0
94076,5,2,329551,329551,329553,0,2,3
94077,1,2,329552,329553,329555,1,3,0
94078,2,2,329554,329555,329557,1,3,0
94079,2,1,329556,329557,329558,1,2,0
94080,5,3,329561,329561,329564,0,3,3
94081,4,2,329565,329565,329567,0,2,1
94082,3,2,329568,329568,329570,0,2,1
94083,3,1,329571,329571,329572,0,1,1
94084,4,3,329575,329575,329578,0,3,3
94085,3,3,329578,329578,329581,0,3,0
94086,3,1,329581,329581,329582,0,1,0
94087,1,1,329582,329582,329583,0,1,0
94088,4,3,329586,329586,329589,0,3,3
94089,3,2,329589,329589,329591,0,2,0
94090,6,2,329595,329595,329597,0,2,4
94091,2,1,329597,329597,329598,0,1,0
94092,6,3,329603,329603,329606,0,3,5
94093,6,1,329609,329609,329610,0,1,3
94094,4,1,329613,329613,329614,0,1,3
94095,5,1,329618,329618,329619,0,1,4
94096,2,2,329620,329620,329622,0,2,1
94097,6,1,329626,329626,329627,0,1,4
94098,6,3,329632,329632,329635,0,3,5
94099,2,2,329634,329635,329637,1,3,0
94100,6,1,329640,329640,329641,0,1,3
94101,4,2,329644,329644,329646,0,2,3
94102,4,1,329648,329648,329649,0,1,2
94103,2,1,329650,329650,329651,0,1,1
94104,2,3,329652,329652,329655,0,3,1
94105,1,3,329653,329655,329658,2,5,0
94106,1,2,329654,329658,329660,4,6,0
94107,1,1,329655,329660,329661,5,6,0
94108,4,1,329659,329661,329662,2,3,0
94109,3,3,329662,329662,329665,0,3,0
94110,2,3,329664,329665,329668,1,4,0
94111,1,1,329665,329668,329669,3,4,0
94112,6,3,329671,329671,329674,0,3,2
94113,5,1,329676,329676,329677,0,1,2
94114,6,2,329682,329682,329684,0,2,5
94115,6,3,329688,329688,329691,0,3,4
94116,1,1,329689,329691,329692,2,3,0
94117,1,2,329690,329692,329694,2,4,0
94118,2,1,329692,329694,329695,2,3,0
94119,5,1,329697,329697,329698,0,1,2
94120,1,2,329698,329698,329700,0,2,0
94121,1,2,329699,329700,329702,1,3,0
94122,4,2,329703,329703,329705,0,2,1
94123,4,3,329707,329707,329710,0,3,2
94124,6,1,329713,329713,329714,0,1,3
94125,6,3,329719,329719,329722,0,3,5
94126,3,2,329722,329722,329724,0,2,0
94127,2,2,329724,329724,329726,0,2,0
94128,4,3,329728,329728,329731,0,3,2
94129,1,2,329729,329731,329733,2,4,0
94130,3,2,329732,329733,329735,1,3,0
94131,3,2,329735,329735,329737,0,2,0
94132,5,3,329740,329740,329743,0,3,3
94133,6,1,329746,329746,329747,0,1,3
94134,3,3,329749,329749,329752,0,3,2
94135,2,1,329751,329752,329753,1,2,0
94136,2,1,329753,329753,329754,0,1,0
94137,3,2,329756,329756,329758,0,2,2
94138,4,1,329760,329760,329761,0,1,2
94139,3,1,329763,329763,329764,0,1,2
94140,2,3,329765,329765,329768,0,3,1
94141,4,1,329769,329769,329770,0,1,1
94142,6,2,329775,329775,329777,0,2,5
94143,6,2,329781,329781,329783,0,2,4
94144,1,1,329782,329783,329784,1,2,0
94145,2,1,329784,329784,329785,0,1,0
94146,4,3,329788,329788,329791,0,3,3
94147,4,3,329792,329792,329795,0,3,1
94148,4,1,329796,329796,329797,0,1,1
94149,3,3,329799,329799,329802,0,3,2
94150,4,3,329803,329803,329806,0,3,1
94151,3,1,329806,329806,329807,0,1,0
94152,1,2,329807,329807,329809,0,2,0
94153,2,1,329809,329809,329810,0,1,0
94154,5,2,329814,329814,329816,0,2,4
94155,3,2,329817,329817,329819,0,2,1
94156,1,1,329818,329819,329820,1,2,0
94157,3,2,329821,329821,329823,0,2,1
94158,6,2,329827,329827,329829,0,2,4
94159,4,1,329831,329831,329832,0,1,2
94160,2,2,329833,329833,329835,0,2,1
94161,3,3,329836,329836,329839,0,3,1
94162,6,3,329842,329842,329845,0,3,3
94163,3,2,329845,329845,329847,0,2,0
94164,5,3,329850,329850,329853,0,3,3
94165,3,3,329853,329853,329856,0,3,0
94166,1,3,329854,329856,329859,2,5,0
94167,6,3,329860,329860,329863,0,3,1
94168,5,2,329865,329865,329867,0,2,2
94169,3,2,329868,329868,329870,0,2,1
94170,6,1,329874,329874,329875,0,1,4
94171,3,2,329877,329877,329879,0,2,2
94172,6,3,329883,329883,329886,0,3,4
94173,2,2,329885,329886,329888,1,3,0
94174,3,2,329888,329888,329890,0,2,0
94175,4,3,329892,329892,329895,0,3,2
94176,1,2,329893,329895,329897,2,4,0
94177,1,1,329894,329897,329898,3,4,0
94178,3,3,329897,329898,329901,1,4,0
94179,3,2,329900,329901,329903,1,3,0
94180,1,2,329901,329903,329905,2,4,0
94181,5,2,329906,329906,329908,0,2,1
94182,4,2,329910,329910,329912,0,2,2
94183,4,3,329914,329914,329917,0,3,2
94184,2,1,329916,329917,329918,1,2,0
94185,5,3,329921,329921,329924,0,3,3
94186,1,3,329922,329924,329927,2,5,0
94187,5,1,329927,329927,329928,0,1,0
94188,5,3,329932,329932,329935,0,3,4
94189,5,3,329937,329937,329940,0,3,2
94190,4,3,329941,329941,329944,0,3,1
94191,3,1,329944,329944,329945,0,1,0
94192,4,2,329948,329948,329950,0,2,3
94193,1,3,329949,329950,329953,1,4,0
94194,4,2,329953,329953,329955,0,2,0
94195,5,3,329958,329958,329961,0,3,3
94196,6,2,329964,329964,329966,0,2,3
94197,2,2,329966,329966,329968,0,2,0
94198,3,2,329969,329969,329971,0,2,1
94199,6,2,329975,329975,329977,0,2,4
94200,3,2,329978,329978,329980,0,2,1
94201,2,3,329980,329980,329983,0,3,0
94202,3,2,329983,329983,329985,0,2,0
94203,6,2,329989,329989,329991,0,2,4
94204,2,2,329991,329991,329993,0,2,0
94205,3,3,329994,329994,329997,0,3,1
94206,2,3,329996,329997,330000,1,4,0
94207,2,2,329998,330000,330002,2,4,0
94208,3,1,330001,330002,330003,1,2,0
94209,5,3,330006,330006,330009,0,3,3
94210,4,3,330010,330010,330013,0,3,1
94211,6,3,330016,330016,330019,0,3,3
94212,6,1,330022,330022,330023,0,1,3
94213,6,1,330028,330028,330029,0,1,5
94214,6,2,330034,330034,330036,0,2,5
94215,1,2,330035,330036,330038,1,3,0
94216,4,2,330039,330039,330041,0,2,1
94217,3,2,330042,330042,330044,0,2,1
94218,5,1,330047,330047,330048,0,1,3
94219,1,3,330048,330048,330051,0,3,0
94220,1,1,330049,330051,330052,2,3,0
94221,1,2,330050,330052,330054,2,4,0
94222,1,2,330051,330054,330056,3,5,0
94223,6,1,330057,330057,330058,0,1,1
94224,5,3,330062,330062,330065,0,3,4
94225,4,2,330066,330066,330068,0,2,1
94226,5,1,330071,330071,330072,0,1,3
94227,1,3,330072,330072,330075,0,3,0
94228,6,2,330078,330078,330080,0,2,3
94229,5,1,330083,330083,330084,0,1,3
94230,6,2,330089,330089,330091,0,2,5
94231,4,1,330093,330093,330094,0,1,2
94232,1,3,330094,330094,330097,0,3,0
94233,2,3,330096,330097,330100,1,4,0
94234,1,3,330097,330100,330103,3,6,0
94235,6,3,330103,330103,330106,0,3,0
94236,2,3,330105,330106,330109,1,4,0
94237,2,3,330107,330109,330112,2,5,0
94238,2,1,330109,330112,330113,3,4,0
94239,6,3,330115,330115,330118,0,3,2
94240,3,1,330118,330118,330119,0,1,0
94241,1,3,330119,330119,330122,0,3,0
94242,2,3,330121,330122,330125,1,4,0
94243,2,1,330123,330125,330126,2,3,0
94244,3,2,330126,330126,330128,0,2,0
94245,2,2,330128,330128,330130,0,2,0
94246,5,2,330133,330133,330135,0,2,3
94247,4,1,330137,330137,330138,0,1,2
94248,4,2,330141,330141,330143,0,2,3
94249,5,2,330146,330146,330148,0,2,3
94250,2,2,330148,330148,330150,0,2,0
94251,3,2,330151,330151,330153,0,2,1
94252,1,3,330152,330153,330156,1,4,0
94253,1,2,330153,330156,330158,3,5,0
94254,3,2,330156,330158,330160,2,4,0
94255,6,3,330162,330162,330165,0,3,2
94256,6,3,330168,330168,330171,0,3,3
94257,3,1,330171,330171,330172,0,1,0
94258,4,2,330175,330175,330177,0,2,3
94259,2,2,330177,330177,330179,0,2,0
94260,6,3,330183,330183,330186,0,3,4
94261,1,1,330184,330186,330187,2,3,0
94262,6,2,330190,330190,330192,0,2,3
94263,4,2,330194,330194,330196,0,2,2
94264,5,1,330199,330199,330200,0,1,3
94265,3,1,330202,330202,330203,0,1,2
94266,5,1,330207,330207,330208,0,1,4
94267,4,2,330211,330211,330213,0,2,3
94268,2,2,330213,330213,330215,0,2,0
94269,4,1,330217,330217,330218,0,1,2
94270,4,2,330221,330221,330223,0,2,3
94271,5,2,330226,330226,330228,0,2,3
94272,5,2,330231,330231,330233,0,2,3
94273,1,1,330232,330233,330234,1,2,0
94274,1,3,330233,330234,330237,1,4,0
94275,1,1,330234,330237,330238,3,4,0
94276,5,1,330239,330239,330240,0,1,1
94277,6,2,330245,330245,330247,0,2,5
94278,2,1,330247,330247,330248,0,1,0
94279,6,1,330253,330253,330254,0,1,5
94280,1,3,330254,330254,330257,0,3,0
94281,2,3,330256,330257,330260,1,4,0
94282,6,2,330262,330262,330264,0,2,2
94283,5,3,330267,330267,330270,0,3,3
94284,2,2,330269,330270,330272,1,3,0
94285,1,2,330270,330272,330274,2,4,0
94286,5,2,330275,330275,330277,0,2,1
94287,6,1,330281,330281,330282,0,1,4
94288,4,2,330285,330285,330287,0,2,3
94289,4,1,330289,330289,330290,0,1,2
94290,1,2,330290,330290,330292,0,2,0
94291,5,1,330295,330295,330296,0,1,3
94292,6,3,330301,330301,330304,0,3,5
94293,3,2,330304,330304,330306,0,2,0
94294,2,3,330306,330306,330309,0,3,0
94295,1,2,330307,330309,330311,2,4,0
94296,6,2,330313,330313,330315,0,2,2
94297,2,1,330315,330315,330316,0,1,0
94298,5,3,330320,330320,330323,0,3,4
94299,6,1,330326,330326,330327,0,1,3
94300,4,3,330330,330330,330333,0,3,3
94301,1,3,330331,330333,330336,2,5,0
94302,6,3,330337,330337,330340,0,3,1
94303,5,2,330342,330342,330344,0,2,2
94304,6,2,330348,330348,330350,0,2,4
94305,3,1,330351,330351,330352,0,1,1
94306,3,2,330354,330354,330356,0,2,2
94307,5,1,330359,330359,330360,0,1,3
94308,1,1,330360,330360,330361,0,1,0
94309,6,3,330366,330366,330369,0,3,5
94310,2,1,330368,330369,330370,1,2,0
94311,4,1,330372,330372,330373,0,1,2
94312,2,2,330374,330374,330376,0,2,1
94313,2,3,330376,330376,330379,0,3,0
94314,6,2,330382,330382,330384,0,2,3
94315,2,2,330384,330384,330386,0,2,0
94316,6,1,330390,330390,330391,0,1,4
94317,4,1,330394,330394,330395,0,1,3
94318,6,1,330400,330400,330401,0,1,5
94319,5,1,330405,330405,330406,0,1,4
94320,2,3,330407,330407,330410,0,3,1
94321,6,1,330413,330413,330414,0,1,3
94322,6,1,330419,330419,330420,0,1,5
94323,1,2,330420,330420,330422,0,2,0
94324,3,2,330423,330423,330425,0,2,1
94325,4,3,330427,330427,330430,0,3,2
94326,1,2,330428,330430,330432,2,4,0
94327,6,2,330434,330434,330436,0,2,2
94328,3,3,330437,330437,330440,0,3,1
94329,6,2,330443,330443,330445,0,2,3
94330,3,3,330446,330446,330449,0,3,1
94331,1,1,330447,330449,330450,2,3,0
94332,2,3,330449,330450,330453,1,4,0
94333,1,1,330450,330453,330454,3,4,0
94334,5,2,330455,330455,330457,0,2,1
94335,4,3,330459,330459,330462,0,3,2
94336,5,2,330464,330464,330466,0,2,2
94337,3,3,330467,330467,330470,0,3,1
94338,2,3,330469,330470,330473,1,4,0
94339,1,2,330470,330473,330475,3,5,0
94340,5,2,330475,330475,330477,0,2,0
94341,4,1,330479,330479,330480,0,1,2
94342,6,3,330485,330485,330488,0,3,5
94343,1,3,330486,330488,330491,2,5,0
94344,1,3,330487,330491,330494,4,7,0
94345,6,1,330493,330494,330495,1,2,0
94346,1,2,330494,330495,330497,1,3,0
94347,4,1,330498,330498,330499,0,1,1
94348,6,2,330504,330504,330506,0,2,5
94349,6,2,330510,330510,330512,0,2,4
94350,6,1,330516,330516,330517,0,1,4
94351,4,1,330520,330520,330521,0,1,3
94352,1,3,330521,330521,330524,0,3,0
94353,3,2,330524,330524,330526,0,2,0
94354,4,1,330528,330528,330529,0,1,2
94355,5,3,330533,330533,330536,0,3,4
94356,6,2,330539,330539,330541,0,2,3
94357,3,3,330542,330542,330545,0,3,1
94358,1,3,330543,330545,330548,2,5,0
94359,3,1,330546,330548,330549,2,3,0
94360,4,2,330550,330550,330552,0,2,1
94361,1,2,330551,330552,330554,1,3,0
94362,6,3,330557,330557,330560,0,3,3
94363,5,1,330562,330562,330563,0,1,2
94364,4,3,330566,330566,330569,0,3,3
94365,5,2,330571,330571,330573,0,2,2
94366,3,1,330574,330574,330575,0,1,1
94367,2,3,330576,330576,330579,0,3,1
94368,3,2,330579,330579,330581,0,2,0
94369,1,1,330580,330581,330582,1,2,0
94370,6,3,330586,330586,330589,0,3,4
94371,2,1,330588,330589,330590,1,2,0
94372,6,1,330594,330594,330595,0,1,4
94373,2,3,330596,330596,330599,0,3,1
94374,2,3,330598,330599,330602,1,4,0
94375,6,1,330604,330604,330605,0,1,2
94376,2,1,330606,330606,330607,0,1,1
94377,6,2,330612,330612,330614,0,2,5
94378,6,1,330618,330618,330619,0,1,4
94379,6,3,330624,330624,330627,0,3,5
94380,2,2,330626,330627,330629,1,3,0
94381,2,2,330628,330629,330631,1,3,0
94382,5,2,330633,330633,330635,0,2,2
94383,2,3,330635,330635,330638,0,3,0
94384,1,2,330636,330638,330640,2,4,0
94385,3,3,330639,330640,330643,1,4,0
94386,4,3,330643,330643,330646,0,3,0
94387,6,1,330649,330649,330650,0,1,3
94388,2,1,330651,330651,330652,0,1,1
94389,4,2,330655,330655,330657,0,2,3
94390,5,3,330660,330660,330663,0,3,3
94391,4,2,330664,330664,330666,0,2,1
94392,2,1,330666,330666,330667,0,1,0
94393,3,1,330669,330669,330670,0,1,2
94394,5,2,330674,330674,330676,0,2,4
94395,3,1,330677,330677,330678,0,1,1
94396,5,2,330682,330682,330684,0,2,4
94397,6,2,330688,330688,330690,0,2,4
94398,6,3,330694,330694,330697,0,3,4
94399,1,3,330695,330697,330700,2,5,0
94400,5,3,330700,330700,330703,0,3,0
94401,2,3,330702,330703,330706,1,4,0
94402,4,2,330706,330706,330708,0,2,0
94403,4,3,330710,330710,330713,0,3,2
94404,2,1,330712,330713,330714,1,2,0
94405,2,3,330714,330714,330717,0,3,0
94406,5,2,330719,330719,330721,0,2,2
94407,1,3,330720,330721,330724,1,4,0
94408,2,3,330722,330724,330727,2,5,0
94409,3,2,330725,330727,330729,2,4,0
94410,4,3,330729,330729,330732,0,3,0
94411,2,1,330731,330732,330733,1,2,0
94412,1,3,330732,330733,330736,1,4,0
94413,5,1,330737,330737,330738,0,1,1
94414,3,2,330740,330740,330742,0,2,2
94415,6,1,330746,330746,330747,0,1,4
94416,6,1,330752,330752,330753,0,1,5
94417,3,3,330755,330755,330758,0,3,2
94418,2,2,330757,330758,330760,1,3,0
94419,1,3,330758,330760,330763,2,5,0
94420,6,2,330764,330764,330766,0,2,1
94421,3,1,330767,330767,330768,0,1,1
94422,4,1,330771,330771,330772,0,1,3
94423,6,1,330777,330777,330778,0,1,5
94424,5,3,330782,330782,330785,0,3,4
94425,2,3,330784,330785,330788,1,4,0
94426,5,1,330789,330789,330790,0,1,1
94427,5,2,330794,330794,330796,0,2,4
94428,4,1,330798,330798,330799,0,1,2
94429,2,3,330800,330800,330803,0,3,1
94430,1,3,330801,330803,330806,2,5,0
94431,2,2,330803,330806,330808,3,5,0
94432,1,2,330804,330808,330810,4,6,0
94433,2,1,330806,330810,330811,4,5,0
94434,6,3,330812,330812,330815,0,3,1
94435,3,2,330815,330815,330817,0,2,0
94436,4,2,330819,330819,330821,0,2,2
94437,2,3,330821,330821,330824,0,3,0
94438,3,2,330824,330824,330826,0,2,0
94439,2,3,330826,330826,330829,0,3,0
94440,4,3,330830,330830,330833,0,3,1
94441,2,2,330832,330833,330835,1,3,0
94442,5,3,330837,330837,330840,0,3,2
94443,5,2,330842,330842,330844,0,2,2
94444,5,1,330847,330847,330848,0,1,3
94445,6,1,330853,330853,330854,0,1,5
94446,6,1,330859,330859,330860,0,1,5
94447,5,1,330864,330864,330865,0,1,4
94448,2,1,330866,330866,330867,0,1,1
94449,6,2,330872,330872,330874,0,2,5
94450,5,3,330877,330877,330880,0,3,3
94451,3,3,330880,330880,330883,0,3,0
94452,2,3,330882,330883,330886,1,4,0
94453,4,1,330886,330886,330887,0,1,0
94454,6,1,330892,330892,330893,0,1,5
94455,5,1,330897,330897,330898,0,1,4
94456,1,3,330898,330898,330901,0,3,0
94457,3,2,330901,330901,330903,0,2,0
94458,2,1,330903,330903,330904,0,1,0
94459,3,2,330906,330906,330908,0,2,2
94460,6,3,330912,330912,330915,0,3,4
94461,5,3,330917,330917,330920,0,3,2
94462,3,3,330920,330920,330923,0,3,0
94463,2,3,330922,330923,330926,1,4,0
94464,2,1,330924,330926,330927,2,3,0
94465,4,2,330928,330928,330930,0,2,1
94466,1,1,330929,330930,330931,1,2,0
94467,1,1,330930,330931,330932,1,2,0
94468,1,3,330931,330932,330935,1,4,0
94469,3,1,330934,330935,330936,1,2,0
94470,3,3,330937,330937,330940,0,3,1
94471,6,3,330943,330943,330946,0,3,3
94472,3,1,330946,330946,330947,0,1,0
94473,1,2,330947,330947,330949,0,2,0
94474,5,3,330952,330952,330955,0,3,3
94475,3,2,330955,330955,330957,0,2,0
94476,2,2,330957,330957,330959,0,2,0
94477,1,3,330958,330959,330962,1,4,0
94478,6,1,330964,330964,330965,0,1,2
94479,6,1,330970,330970,330971,0,1,5
94480,6,3,330976,330976,330979,0,3,5
94481,5,2,330981,330981,330983,0,2,2
94482,1,2,330982,330983,330985,1,3,0
94483,5,2,330987,330987,330989,0,2,2
94484,4,3,330991,330991,330994,0,3,2
94485,5,1,330996,330996,330997,0,1,2
94486,4,1,331000,331000,331001,0,1,3
94487,3,3,331003,331003,331006,0,3,2
94488,2,3,331005,331006,331009,1,4,0
94489,1,2,331006,331009,331011,3,5,0
94490,6,3,331012,331012,331015,0,3,1
94491,6,3,331018,331018,331021,0,3,3
94492,6,1,331024,331024,331025,0,1,3
94493,6,3,331030,331030,331033,0,3,5
94494,6,1,331036,331036,331037,0,1,3
94495,1,2,331037,331037,331039,0,2,0
94496,4,3,331041,331041,331044,0,3,2
94497,6,1,331047,331047,331048,0,1,3
94498,5,3,331052,331052,331055,0,3,4
94499,4,1,331056,331056,331057,0,1,1
94500,2,3,331058,331058,331061,0,3,1
94501,1,1,331059,331061,331062,2,3,0
94502,4,1,331063,331063,331064,0,1,1
94503,4,1,331067,331067,331068,0,1,3
94504,6,1,331073,331073,331074,0,1,5
94505,2,2,331075,331075,331077,0,2,1
94506,1,1,331076,331077,331078,1,2,0
94507,5,1,331081,331081,331082,0,1,3
94508,1,2,331082,331082,331084,0,2,0
94509,3,1,331085,331085,331086,0,1,1
94510,5,1,331090,331090,331091,0,1,4
94511,6,2,331096,331096,331098,0,2,5
94512,3,2,331099,331099,331101,0,2,1
94513,4,2,331103,331103,331105,0,2,2
94514,4,2,331107,331107,331109,0,2,2
94515,1,3,331108,331109,331112,1,4,0
94516,4,2,331112,331112,331114,0,2,0
94517,4,1,331116,331116,331117,0,1,2
94518,5,2,331121,331121,331123,0,2,4
94519,2,1,331123,331123,331124,0,1,0
94520,4,1,331127,331127,331128,0,1,3
94521,3,2,331130,331130,331132,0,2,2
94522,5,1,331135,331135,331136,0,1,3
94523,3,2,331138,331138,331140,0,2,2
94524,4,3,331142,331142,331145,0,3,2
94525,3,1,331145,331145,331146,0,1,0
94526,3,3,331148,331148,331151,0,3,2
94527,4,1,331152,331152,331153,0,1,1
94528,5,2,331157,331157,331159,0,2,4
94529,1,3,331158,331159,331162,1,4,0
94530,3,1,331161,331162,331163,1,2,0
94531,5,2,331166,331166,331168,0,2,3
94532,3,1,331169,331169,331170,0,1,1
94533,1,2,331170,331170,331172,0,2,0
94534,3,3,331173,331173,331176,0,3,1
94535,2,2,331175,331176,331178,1,3,0
94536,1,3,331176,331178,331181,2,5,0
94537,6,2,331182,331182,331184,0,2,1
94538,3,1,331185,331185,331186,0,1,1
94539,4,1,331189,331189,331190,0,1,3
94540,1,2,331190,331190,331192,0,2,0
94541,4,1,331194,331194,331195,0,1,2
94542,2,3,331196,331196,331199,0,3,1
94543,1,2,331197,331199,331201,2,4,0
94544,1,3,331198,331201,331204,3,6,0
94545,4,2,331202,331204,331206,2,4,0
94546,2,1,331204,331206,331207,2,3,0
94547,6,1,331210,331210,331211,0,1,3
94548,5,1,331215,331215,331216,0,1,4
94549,2,1,331217,331217,331218,0,1,1
94550,6,3,331223,331223,331226,0,3,5
94551,6,3,331229,331229,331232,0,3,3
94552,3,2,331232,331232,331234,0,2,0
94553,5,1,331237,331237,331238,0,1,3
94554,6,3,331243,331243,331246,0,3,5
94555,2,3,331245,331246,331249,1,4,0
94556,1,1,331246,331249,331250,3,4,0
94557,4,1,331250,331250,331251,0,1,0
94558,6,3,331256,331256,331259,0,3,5
94559,2,2,331258,331259,331261,1,3,0
94560,3,1,331261,331261,331262,0,1,0
94561,3,3,331264,331264,331267,0,3,2
94562,1,3,331265,331267,331270,2,5,0
94563,6,3,331271,331271,331274,0,3,1
94564,1,3,331272,331274,331277,2,5,0
94565,1,3,331273,331277,331280,4,7,0
94566,3,2,331276,331280,331282,4,6,0
94567,5,1,331281,331282,331283,1,2,0
94568,4,1,331285,331285,331286,0,1,2
94569,4,1,331289,331289,331290,0,1,3
94570,3,1,331292,331292,331293,0,1,2
94571,3,3,331295,331295,331298,0,3,2
94572,3,2,331298,331298,331300,0,2,0
94573,1,2,331299,331300,331302,1,3,0
94574,2,2,331301,331302,331304,1,3,0
94575,4,1,331305,331305,331306,0,1,1
94576,5,1,331310,331310,331311,0,1,4
94577,5,2,331315,331315,331317,0,2,4
94578,1,2,331316,331317,331319,1,3,0
94579,6,2,331322,331322,331324,0,2,3
94580,5,3,331327,331327,331330,0,3,3
94581,1,2,331328,331330,331332,2,4,0
94582,6,1,331334,331334,331335,0,1,2
94583,6,3,331340,331340,331343,0,3,5
94584,2,3,331342,331343,331346,1,4,0
94585,2,3,331344,331346,331349,2,5,0
94586,6,3,331350,331350,331353,0,3,1
94587,2,2,331352,331353,331355,1,3,0
94588,5,3,331357,331357,331360,0,3,2
94589,3,1,331360,331360,331361,0,1,0
94590,6,1,331366,331366,331367,0,1,5
94591,4,3,331370,331370,331373,0,3,3
94592,3,1,331373,331373,331374,0,1,0
94593,1,2,331374,331374,331376,0,2,0
94594,4,2,331378,331378,331380,0,2,2
94595,2,2,331380,331380,331382,0,2,0
94596,6,2,331386,331386,331388,0,2,4
94597,3,1,331389,331389,331390,0,1,1
94598,1,3,331390,331390,331393,0,3,0
94599,1,2,331391,331393,331395,2,4,0
94600,6,2,331397,331397,331399,0,2,2
94601,4,3,331401,331401,331404,0,3,2
94602,4,1,331405,331405,331406,0,1,1
94603,5,1,331410,331410,331411,0,1,4
94604,3,3,331413,331413,331416,0,3,2
94605,6,1,331419,331419,331420,0,1,3
94606,1,2,331420,331420,331422,0,2,0
94607,2,2,331422,331422,331424,0,2,0
94608,1,3,331423,331424,331427,1,4,0
94609,6,3,331429,331429,331432,0,3,2
94610,3,2,331432,331432,331434,0,2,0
94611,3,3,331435,331435,331438,0,3,1
94612,1,2,331436,331438,331440,2,4,0
94613,4,2,331440,331440,331442,0,2,0
94614,5,3,331445,331445,331448,0,3,3
94615,3,3,331448,331448,331451,0,3,0
94616,1,1,331449,331451,331452,2,3,0
94617,4,3,331453,331453,331456,0,3,1
94618,2,2,331455,331456,331458,1,3,0
94619,2,2,331457,331458,331460,1,3,0
94620,3,3,331460,331460,331463,0,3,0
94621,6,1,331466,331466,331467,0,1,3
94622,4,1,331470,331470,331471,0,1,3
94623,5,1,331475,331475,331476,0,1,4
94624,4,1,331479,331479,331480,0,1,3
94625,1,1,331480,331480,331481,0,1,0
94626,1,1,331481,331481,331482,0,1,0
94627,6,2,331487,331487,331489,0,2,5
94628,4,3,331491,331491,331494,0,3,2
94629,6,3,331497,331497,331500,0,3,3
94630,1,3,331498,331500,331503,2,5,0
94631,2,3,331500,331503,331506,3,6,0
94632,2,3,331502,331506,331509,4,7,0
94633,6,3,331508,331509,331512,1,4,0
94634,3,3,331511,331512,331515,1,4,0
94635,6,1,331517,331517,331518,0,1,2
94636,2,2,331519,331519,331521,0,2,1
94637,1,2,331520,331521,331523,1,3,0
94638,4,2,331524,331524,331526,0,2,1
94639,5,2,331529,331529,331531,0,2,3
94640,3,2,331532,331532,331534,0,2,1
94641,3,2,331535,331535,331537,0,2,1
94642,1,1,331536,331537,331538,1,2,0
94643,6,3,331542,331542,331545,0,3,4
94644,2,1,331544,331545,331546,1,2,0
94645,2,3,331546,331546,331549,0,3,0
94646,2,1,331548,331549,331550,1,2,0
94647,2,2,331550,331550,331552,0,2,0
94648,6,1,331556,331556,331557,0,1,4
94649,4,3,331560,331560,331563,0,3,3
94650,4,1,331564,331564,331565,0,1,1
94651,4,2,331568,331568,331570,0,2,3
94652,5,3,331573,331573,331576,0,3,3
94653,4,1,331577,331577,331578,0,1,1
94654,6,1,331583,331583,331584,0,1,5
94655,3,3,331586,331586,331589,0,3,2
94656,1,2,331587,331589,331591,2,4,0
94657,1,1,331588,331591,331592,3,4,0
94658,1,1,331589,331592,331593,3,4,0
94659,5,2,331594,331594,331596,0,2,1
94660,1,1,331595,331596,331597,1,2,0
94661,5,1,331600,331600,331601,0,1,3
94662,6,1,331606,331606,331607,0,1,5
94663,6,3,331612,331612,331615,0,3,5
94664,6,2,331618,331618,331620,0,2,3
94665,4,1,331622,331622,331623,0,1,2
94666,1,1,331623,331623,331624,0,1,0
94667,3,3,331626,331626,331629,0,3,2
94668,6,3,331632,331632,331635,0,3,3
94669,4,1,331636,331636,331637,0,1,1
94670,5,2,331641,331641,331643,0,2,4
94671,2,3,331643,331643,331646,0,3,0
94672,1,3,331644,331646,331649,2,5,0
94673,2,2,331646,331649,331651,3,5,0
94674,2,3,331648,331651,331654,3,6,0
94675,1,1,331649,331654,331655,5,6,0
94676,5,1,331654,331655,331656,1,2,0
94677,4,1,331658,331658,331659,0,1,2
94678,6,1,331664,331664,331665,0,1,5
94679,5,3,331669,331669,331672,0,3,4
94680,5,3,331674,331674,331677,0,3,2
94681,5,1,331679,331679,331680,0,1,2
94682,3,2,331682,331682,331684,0,2,2
94683,6,1,331688,331688,331689,0,1,4
94684,1,2,331689,331689,331691,0,2,0
94685,1,1,331690,331691,331692,1,2,0
94686,6,1,331696,331696,331697,0,1,4
94687,5,3,331701,331701,331704,0,3,4
94688,2,1,331703,331704,331705,1,2,0
94689,5,3,331708,331708,331711,0,3,3
94690,3,1,331711,331711,331712,0,1,0
94691,3,1,331714,331714,331715,0,1,2
94692,4,1,331718,331718,331719,0,1,3
94693,1,3,331719,331719,331722,0,3,0
94694,4,1,331723,331723,331724,0,1,1
94695,2,2,331725,331725,331727,0,2,1
94696,3,2,331728,331728,331730,0,2,1
94697,1,2,331729,331730,331732,1,3,0
94698,5,3,331734,331734,331737,0,3,2
94699,6,2,331740,331740,331742,0,2,3
94700,5,3,331745,331745,331748,0,3,3
94701,1,2,331746,331748,331750,2,4,0
94702,2,3,331748,331750,331753,2,5,0
94703,6,1,331754,331754,331755,0,1,1
94704,2,3,331756,331756,331759,0,3,1
94705,5,2,331761,331761,331763,0,2,2
94706,4,3,331765,331765,331768,0,3,2
94707,4,1,331769,331769,331770,0,1,1
94708,1,2,331770,331770,331772,0,2,0
94709,5,1,331775,331775,331776,0,1,3
94710,1,1,331776,331776,331777,0,1,0
94711,5,1,331781,331781,331782,0,1,4
94712,5,3,331786,331786,331789,0,3,4
94713,3,1,331789,331789,331790,0,1,0
94714,6,3,331795,331795,331798,0,3,5
94715,3,3,331798,331798,331801,0,3,0
94716,4,2,331802,331802,331804,0,2,1
94717,3,2,331805,331805,331807,0,2,1
94718,6,3,331811,331811,331814,0,3,4
94719,2,1,331813,331814,331815,1,2,0
94720,1,3,331814,331815,331818,1,4,0
94721,3,3,331817,331818,331821,1,4,0
94722,5,2,331822,331822,331824,0,2,1
94723,2,3,331824,331824,331827,0,3,0
94724,5,1,331829,331829,331830,0,1,2
94725,4,2,331833,331833,331835,0,2,3
94726,1,3,331834,331835,331838,1,4,0
94727,2,3,331836,331838,331841,2,5,0
94728,3,3,331839,331841,331844,2,5,0
94729,5,2,331844,331844,331846,0,2,0
94730,4,3,331848,331848,331851,0,3,2
94731,5,2,331853,331853,331855,0,2,2
94732,4,2,331857,331857,331859,0,2,2
94733,3,2,331860,331860,331862,0,2,1
94734,3,1,331863,331863,331864,0,1,1
94735,4,1,331867,331867,331868,0,1,3
94736,5,1,331872,331872,331873,0,1,4
94737,3,2,331875,331875,331877,0,2,2
94738,3,3,331878,331878,331881,0,3,1
94739,2,1,331880,331881,331882,1,2,0
94740,4,2,331884,331884,331886,0,2,2
94741,3,3,331887,331887,331890,0,3,1
94742,4,2,331891,331891,331893,0,2,1
94743,6,1,331897,331897,331898,0,1,4
94744,1,2,331898,331898,331900,0,2,0
94745,3,2,331901,331901,331903,0,2,1
94746,6,2,331907,331907,331909,0,2,4
94747,2,2,331909,331909,331911,0,2,0
94748,6,3,331915,331915,331918,0,3,4
94749,6,3,331921,331921,331924,0,3,3
94750,1,1,331922,331924,331925,2,3,0
94751,6,3,331928,331928,331931,0,3,3
94752,4,3,331932,331932,331935,0,3,1
94753,2,2,331934,331935,331937,1,3,0
94754,3,1,331937,331937,331938,0,1,0
94755,2,2,331939,331939,331941,0,2,1
94756,4,3,331943,331943,331946,0,3,2
94757,2,2,331945,331946,331948,1,3,0
94758,4,3,331949,331949,331952,0,3,1
94759,3,1,331952,331952,331953,0,1,0
94760,2,2,331954,331954,331956,0,2,1
94761,4,1,331958,331958,331959,0,1,2
94762,5,3,331963,331963,331966,0,3,4
94763,2,3,331965,331966,331969,1,4,0
94764,6,2,331971,331971,331973,0,2,2
94765,5,3,331976,331976,331979,0,3,3
94766,1,2,331977,331979,331981,2,4,0
94767,1,2,331978,331981,331983,3,5,0
94768,4,2,331982,331983,331985,1,3,0
94769,2,2,331984,331985,331987,1,3,0
94770,3,2,331987,331987,331989,0,2,0
94771,6,3,331993,331993,331996,0,3,4
94772,5,2,331998,331998,332000,0,2,2
94773,3,2,332001,332001,332003,0,2,1
94774,4,1,332005,332005,332006,0,1,2
94775,1,3,332006,332006,332009,0,3,0
94776,4,1,332010,332010,332011,0,1,1
94777,2,1,332012,332012,332013,0,1,1
94778,2,2,332014,332014,332016,0,2,1
94779,2,1,332016,332016,332017,0,1,0
94780,6,1,332022,332022,332023,0,1,5
94781,4,1,332026,332026,332027,0,1,3
94782,3,2,332029,332029,332031,0,2,2
94783,4,2,332033,332033,332035,0,2,2
94784,1,1,332034,332035,332036,1,2,0
94785,3,2,332037,332037,332039,0,2,1
94786,2,3,332039,332039,332042,0,3,0
94787,6,1,332045,332045,332046,0,1,3
94788,4,3,332049,332049,332052,0,3,3
94789,6,3,332055,332055,332058,0,3,3
94790,3,2,332058,332058,332060,0,2,0
94791,2,1,332060,332060,332061,0,1,0
94792,4,3,332064,332064,332067,0,3,3
94793,5,2,332069,332069,332071,0,2,2
94794,1,1,332070,332071,332072,1,2,0
94795,5,2,332075,332075,332077,0,2,3
94796,5,3,332080,332080,332083,0,3,3
94797,2,1,332082,332083,332084,1,2,0
94798,2,3,332084,332084,332087,0,3,0
94799,5,1,332089,332089,332090,0,1,2
94800,3,2,332092,332092,332094,0,2,2
94801,4,1,332096,332096,332097,0,1,2
94802,6,1,332102,332102,332103,0,1,5
94803,1,2,332103,332103,332105,0,2,0
94804,5,2,332108,332108,332110,0,2,3
94805,1,1,332109,332110,332111,1,2,0
94806,4,3,332113,332113,332116,0,3,2
94807,2,3,332115,332116,332119,1,4,0
94808,5,1,332120,332120,332121,0,1,1
94809,5,2,332125,332125,332127,0,2,4
94810,6,3,332131,332131,332134,0,3,4
94811,1,2,332132,332134,332136,2,4,0
94812,3,1,332135,332136,332137,1,2,0
94813,1,1,332136,332137,332138,1,2,0
94814,6,3,332142,332142,332145,0,3,4
94815,3,1,332145,332145,332146,0,1,0
94816,1,3,332146,332146,332149,0,3,0
94817,4,3,332150,332150,332153,0,3,1
94818,1,2,332151,332153,332155,2,4,0
94819,6,2,332157,332157,332159,0,2,2
94820,3,1,332160,332160,332161,0,1,1
94821,6,1,332166,332166,332167,0,1,5
94822,4,3,332170,332170,332173,0,3,3
94823,3,2,332173,332173,332175,0,2,0
94824,1,3,332174,332175,332178,1,4,0
94825,5,1,332179,332179,332180,0,1,1
94826,1,3,332180,332180,332183,0,3,0
94827,1,2,332181,332183,332185,2,4,0
94828,4,3,332185,332185,332188,0,3,0
94829,1,3,332186,332188,332191,2,5,0
94830,2,3,332188,332191,332194,3,6,0
94831,2,1,332190,332194,332195,4,5,0
94832,5,1,332195,332195,332196,0,1,0
94833,6,1,332201,332201,332202,0,1,5
94834,5,2,332206,332206,332208,0,2,4
94835,2,2,332208,332208,332210,0,2,0
94836,4,1,332212,332212,332213,0,1,2
94837,2,2,332214,332214,332216,0,2,1
94838,3,1,332217,332217,332218,0,1,1
94839,6,1,332223,332223,332224,0,1,5
94840,2,2,332225,332225,332227,0,2,1
94841,5,2,332230,332230,332232,0,2,3
94842,1,3,332231,332232,332235,1,4,0
94843,6,2,332237,332237,332239,0,2,2
94844,5,1,332242,332242,332243,0,1,3
94845,6,1,332248,332248,332249,0,1,5
94846,6,1,332254,332254,332255,0,1,5
94847,5,3,332259,332259,332262,0,3,4
94848,5,2,332264,332264,332266,0,2,2
94849,6,2,332270,332270,332272,0,2,4
94850,4,3,332274,332274,332277,0,3,2
94851,3,2,332277,332277,332279,0,2,0
94852,4,1,332281,332281,332282,0,1,2
94853,5,2,332286,332286,332288,0,2,4
94854,5,2,332291,332291,332293,0,2,3
94855,1,2,332292,332293,332295,1,3,0
94856,6,1,332298,332298,332299,0,1,3
94857,4,3,332302,332302,332305,0,3,3
94858,5,1,332307,332307,332308,0,1,2
94859,6,1,332313,332313,332314,0,1,5
94860,1,2,332314,332314,332316,0,2,0
94861,1,2,332315,332316,332318,1,3,0
94862,3,2,332318,332318,332320,0,2,0
94863,4,1,332322,332322,332323,0,1,2
94864,2,1,332324,332324,332325,0,1,1
94865,1,2,332325,332325,332327,0,2,0
94866,5,2,332330,332330,332332,0,2,3
94867,3,2,332333,332333,332335,0,2,1
94868,3,3,332336,332336,332339,0,3,1
94869,4,2,332340,332340,332342,0,2,1
94870,3,1,332343,332343,332344,0,1,1
94871,3,2,332346,332346,332348,0,2,2
94872,1,2,332347,332348,332350,1,3,0
94873,6,3,332353,332353,332356,0,3,3
94874,4,2,332357,332357,332359,0,2,1
94875,4,2,332361,332361,332363,0,2,2
94876,1,3,332362,332363,332366,1,4,0
94877,3,1,332365,332366,332367,1,2,0
94878,6,3,332371,332371,332374,0,3,4
94879,6,3,332377,332377,332380,0,3,3
94880,2,1,332379,332380,332381,1,2,0
94881,5,3,332384,332384,332387,0,3,3
94882,5,1,332389,332389,332390,0,1,2
94883,4,2,332393,332393,332395,0,2,3
94884,2,1,332395,332395,332396,0,1,0
94885,1,3,332396,332396,332399,0,3,0
94886,2,2,332398,332399,332401,1,3,0
94887,5,1,332403,332403,332404,0,1,2
94888,5,3,332408,332408,332411,0,3,4
94889,6,2,332414,332414,332416,0,2,3
94890,6,1,332420,332420,332421,0,1,4
94891,3,3,332423,332423,332426,0,3,2
94892,6,2,332429,332429,332431,0,2,3
94893,5,1,332434,332434,332435,0,1,3
94894,2,3,332436,332436,332439,0,3,1
94895,4,1,332440,332440,332441,0,1,1
94896,2,2,332442,332442,332444,0,2,1
94897,6,1,332448,332448,332449,0,1,4
94898,4,1,332452,332452,332453,0,1,3
94899,1,2,332453,332453,332455,0,2,0
94900,6,2,332459,332459,332461,0,2,4
94901,6,2,332465,332465,332467,0,2,4
94902,2,2,332467,332467,332469,0,2,0
94903,3,3,332470,332470,332473,0,3,1
94904,1,3,332471,332473,332476,2,5,0
94905,3,2,332474,332476,332478,2,4,0
94906,3,3,332477,332478,332481,1,4,0
94907,5,2,332482,332482,332484,0,2,1
94908,2,2,332484,332484,332486,0,2,0
94909,1,3,332485,332486,332489,1,4,0
94910,5,2,332490,332490,332492,0,2,1
94911,6,2,332496,332496,332498,0,2,4
94912,6,2,332502,332502,332504,0,2,4
94913,2,1,332504,332504,332505,0,1,0
94914,1,3,332505,332505,332508,0,3,0
94915,5,3,332510,332510,332513,0,3,2
94916,1,2,332511,332513,332515,2,4,0
94917,4,2,332515,332515,332517,0,2,0
94918,3,3,332518,332518,332521,0,3,1
94919,2,3,332520,332521,332524,1,4,0
94920,2,3,332522,332524,332527,2,5,0
94921,5,2,332527,332527,332529,0,2,0
94922,3,2,332530,332530,332532,0,2,1
94923,3,2,332533,332533,332535,0,2,1
94924,1,2,332534,332535,332537,1,3,0
94925,4,3,332538,332538,332541,0,3,1
94926,3,2,332541,332541,332543,0,2,0
94927,6,1,332547,332547,332548,0,1,4
94928,4,3,332551,332551,332554,0,3,3
94929,3,1,332554,332554,332555,0,1,0
94930,5,2,332559,332559,332561,0,2,4
94931,4,1,332563,332563,332564,0,1,2
94932,1,2,332564,332564,332566,0,2,0
94933,6,1,332570,332570,332571,0,1,4
94934,1,2,332571,332571,332573,0,2,0
94935,5,3,332576,332576,332579,0,3,3
94936,1,1,332577,332579,332580,2,3,0
94937,6,1,332583,332583,332584,0,1,3
94938,6,1,332589,332589,332590,0,1,5
94939,3,1,332592,332592,332593,0,1,2
94940,4,3,332596,332596,332599,0,3,3
94941,1,2,332597,332599,332601,2,4,0
94942,2,3,332599,332601,332604,2,5,0
94943,4,1,332603,332604,332605,1,2,0
94944,2,1,332605,332605,332606,0,1,0
94945,2,1,332607,332607,332608,0,1,1
94946,4,1,332611,332611,332612,0,1,3
94947,1,1,332612,332612,332613,0,1,0
94948,1,3,332613,332613,332616,0,3,0
94949,2,2,332615,332616,332618,1,3,0
94950,5,3,332620,332620,332623,0,3,2
94951,3,3,332623,332623,332626,0,3,0
94952,2,3,332625,332626,332629,1,4,0
94953,5,2,332630,332630,332632,0,2,1
94954,4,1,332634,332634,332635,0,1,2
94955,4,2,332638,332638,332640,0,2,3
94956,2,1,332640,332640,332641,0,1,0
94957,1,3,332641,332641,332644,0,3,0
94958,5,1,332646,332646,332647,0,1,2
94959,3,2,332649,332649,332651,0,2,2
94960,2,1,332651,332651,332652,0,1,0
94961,2,3,332653,332653,332656,0,3,1
94962,4,1,332657,332657,332658,0,1,1
94963,3,1,332660,332660,332661,0,1,2
94964,6,2,332666,332666,332668,0,2,5
94965,6,3,332672,332672,332675,0,3,4
94966,4,2,332676,332676,332678,0,2,1
94967,6,3,332682,332682,332685,0,3,4
94968,6,2,332688,332688,332690,0,2,3
94969,3,1,332691,332691,332692,0,1,1
94970,4,1,332695,332695,332696,0,1,3
94971,2,1,332697,332697,332698,0,1,1
94972,3,2,332700,332700,332702,0,2,2
94973,1,1,332701,332702,332703,1,2,0
94974,2,3,332703,332703,332706,0,3,0
94975,3,1,332706,332706,332707,0,1,0
94976,2,1,332708,332708,332709,0,1,1
94977,5,3,332713,332713,332716,0,3,4
94978,5,1,332718,332718,332719,0,1,2
94979,2,3,332720,332720,332723,0,3,1
94980,6,2,332726,332726,332728,0,2,3
94981,4,1,332730,332730,332731,0,1,2
94982,5,3,332735,332735,332738,0,3,4
94983,4,3,332739,332739,332742,0,3,1
94984,1,2,332740,332742,332744,2,4,0
94985,2,3,332742,332744,332747,2,5,0
94986,6,2,332748,332748,332750,0,2,1
94987,3,1,332751,332751,332752,0,1,1
94988,2,2,332753,332753,332755,0,2,1
94989,4,2,332757,332757,332759,0,2,2
94990,1,1,332758,332759,332760,1,2,0
94991,2,3,332760,332760,332763,0,3,0
94992,3,1,332763,332763,332764,0,1,0
94993,2,1,332765,332765,332766,0,1,1
94994,4,2,332769,332769,332771,0,2,3
94995,5,1,332774,332774,332775,0,1,3
94996,3,2,332777,332777,332779,0,2,2
94997,4,2,332781,332781,332783,0,2,2
94998,4,2,332785,332785,332787,0,2,2
94999,5,1,332790,332790,332791,0,1,3
95000,1,1,332791,332791,332792,0,1,0
95001,4,3,332795,332795,332798,0,3,3
95002,3,2,332798,332798,332800,0,2,0
95003,6,3,332804,332804,332807,0,3,4
95004,4,3,332808,332808,332811,0,3,1
95005,1,2,332809,332811,332813,2,4,0
95006,3,3,332812,332813,332816,1,4,0
95007,5,1,332817,332817,332818,0,1,1
95008,6,3,332823,332823,332826,0,3,5
95009,4,1,332827,332827,332828,0,1,1
95010,1,1,332828,332828,332829,0,1,0
95011,3,2,332831,332831,332833,0,2,2
95012,5,3,332836,332836,332839,0,3,3
95013,1,1,332837,332839,332840,2,3,0
95014,3,2,332840,332840,332842,0,2,0
95015,3,1,332843,332843,332844,0,1,1
95016,2,2,332845,332845,332847,0,2,1
95017,2,3,332847,332847,332850,0,3,0
95018,3,2,332850,332850,332852,0,2,0
95019,1,1,332851,332852,332853,1,2,0
95020,2,2,332853,332853,332855,0,2,0
95021,5,2,332858,332858,332860,0,2,3
95022,2,3,332860,332860,332863,0,3,0
95023,6,1,332866,332866,332867,0,1,3
95024,3,3,332869,332869,332872,0,3,2
95025,2,3,332871,332872,332875,1,4,0
95026,3,1,332874,332875,332876,1,2,0
95027,5,1,332879,332879,332880,0,1,3
95028,6,3,332885,332885,332888,0,3,5
95029,4,3,332889,332889,332892,0,3,1
95030,4,1,332893,332893,332894,0,1,1
95031,5,1,332898,332898,332899,0,1,4
95032,6,3,332904,332904,332907,0,3,5
95033,2,2,332906,332907,332909,1,3,0
95034,6,3,332912,332912,332915,0,3,3
95035,3,2,332915,332915,332917,0,2,0
95036,2,1,332917,332917,332918,0,1,0
95037,5,1,332922,332922,332923,0,1,4
95038,6,3,332928,332928,332931,0,3,5
95039,6,2,332934,332934,332936,0,2,3
95040,6,2,332940,332940,332942,0,2,4
95041,4,3,332944,332944,332947,0,3,2
95042,6,2,332950,332950,332952,0,2,3
95043,5,2,332955,332955,332957,0,2,3
95044,5,1,332960,332960,332961,0,1,3
95045,4,1,332964,332964,332965,0,1,3
95046,4,2,332968,332968,332970,0,2,3
95047,1,2,332969,332970,332972,1,3,0
95048,1,2,332970,332972,332974,2,4,0
95049,1,3,332971,332974,332977,3,6,0
95050,4,2,332975,332977,332979,2,4,0
95051,3,1,332978,332979,332980,1,2,0
95052,1,3,332979,332980,332983,1,4,0
95053,1,2,332980,332983,332985,3,5,0
95054,4,3,332984,332985,332988,1,4,0
95055,2,1,332986,332988,332989,2,3,0
95056,2,3,332988,332989,332992,1,4,0
95057,5,2,332993,332993,332995,0,2,1
95058,2,1,332995,332995,332996,0,1,0
95059,4,2,332999,332999,333001,0,2,3
95060,3,1,333002,333002,333003,0,1,1
95061,4,2,333006,333006,333008,0,2,3
95062,3,2,333009,333009,333011,0,2,1
95063,6,1,333015,333015,333016,0,1,4
95064,4,2,333019,333019,333021,0,2,3
95065,4,1,333023,333023,333024,0,1,2
95066,6,3,333029,333029,333032,0,3,5
95067,1,2,333030,333032,333034,2,4,0
95068,1,2,333031,333034,333036,3,5,0
95069,6,1,333037,333037,333038,0,1,1
95070,2,3,333039,333039,333042,0,3,1
95071,2,2,333041,333042,333044,1,3,0
95072,5,2,333046,333046,333048,0,2,2
95073,4,1,333050,333050,333051,0,1,2
95074,3,3,333053,333053,333056,0,3,2
95075,4,3,333057,333057,333060,0,3,1
95076,4,2,333061,333061,333063,0,2,1
95077,1,3,333062,333063,333066,1,4,0
95078,2,2,333064,333066,333068,2,4,0
95079,5,3,333069,333069,333072,0,3,1
95080,3,2,333072,333072,333074,0,2,0
95081,6,1,333078,333078,333079,0,1,4
95082,1,3,333079,333079,333082,0,3,0
95083,3,3,333082,333082,333085,0,3,0
95084,1,3,333083,333085,333088,2,5,0
95085,2,1,333085,333088,333089,3,4,0
95086,4,3,333089,333089,333092,0,3,0
95087,6,1,333095,333095,333096,0,1,3
95088,5,1,333100,333100,333101,0,1,4
95089,4,3,333104,333104,333107,0,3,3
95090,4,2,333108,333108,333110,0,2,1
95091,6,2,333114,333114,333116,0,2,4
95092,5,1,333119,333119,333120,0,1,3
95093,6,3,333125,333125,333128,0,3,5
95094,4,3,333129,333129,333132,0,3,1
95095,4,3,333133,333133,333136,0,3,1
95096,4,1,333137,333137,333138,0,1,1
95097,5,3,333142,333142,333145,0,3,4
95098,2,2,333144,333145,333147,1,3,0
95099,4,1,333148,333148,333149,0,1,1
95100,6,3,333154,333154,333157,0,3,5
95101,2,2,333156,333157,333159,1,3,0
95102,3,3,333159,333159,333162,0,3,0
95103,5,1,333164,333164,333165,0,1,2
95104,4,3,333168,333168,333171,0,3,3
95105,4,2,333172,333172,333174,0,2,1
95106,2,1,333174,333174,333175,0,1,0
95107,2,3,333176,333176,333179,0,3,1
95108,4,3,333180,333180,333183,0,3,1
95109,6,3,333186,333186,333189,0,3,3
95110,6,2,333192,333192,333194,0,2,3
95111,4,1,333196,333196,333197,0,1,2
95112,3,1,333199,333199,333200,0,1,2
95113,3,2,333202,333202,333204,0,2,2
95114,1,3,333203,333204,333207,1,4,0
95115,3,2,333206,333207,333209,1,3,0
95116,2,3,333208,333209,333212,1,4,0
95117,6,2,333214,333214,333216,0,2,2
95118,4,1,333218,333218,333219,0,1,2
95119,4,3,333222,333222,333225,0,3,3
95120,2,3,333224,333225,333228,1,4,0
95121,3,1,333227,333228,333229,1,2,0
95122,2,3,333229,333229,333232,0,3,0
95123,6,2,333235,333235,333237,0,2,3
95124,6,2,333241,333241,333243,0,2,4
95125,1,2,333242,333243,333245,1,3,0
95126,4,3,333246,333246,333249,0,3,1
95127,2,1,333248,333249,333250,1,2,0
95128,4,2,333252,333252,333254,0,2,2
95129,5,2,333257,333257,333259,0,2,3
95130,5,2,333262,333262,333264,0,2,3
95131,1,1,333263,333264,333265,1,2,0
95132,1,2,333264,333265,333267,1,3,0
95133,1,1,333265,333267,333268,2,3,0
95134,3,3,333268,333268,333271,0,3,0
95135,4,2,333272,333272,333274,0,2,1
95136,1,2,333273,333274,333276,1,3,0
95137,5,3,333278,333278,333281,0,3,2
95138,5,2,333283,333283,333285,0,2,2
95139,2,2,333285,333285,333287,0,2,0
95140,6,1,333291,333291,333292,0,1,4
95141,5,2,333296,333296,333298,0,2,4
95142,2,3,333298,333298,333301,0,3,0
95143,1,2,333299,333301,333303,2,4,0
95144,3,3,333302,333303,333306,1,4,0
95145,3,3,333305,333306,333309,1,4,0
95146,2,3,333307,333309,333312,2,5,0
95147,1,3,333308,333312,333315,4,7,0
95148,3,1,333311,333315,333316,4,5,0
95149,2,1,333313,333316,333317,3,4,0
95150,3,2,333316,333317,333319,1,3,0
95151,2,3,333318,333319,333322,1,4,0
95152,6,2,333324,333324,333326,0,2,2
95153,4,1,333328,333328,333329,0,1,2
95154,5,1,333333,333333,333334,0,1,4
95155,2,2,333335,333335,333337,0,2,1
95156,5,2,333340,333340,333342,0,2,3
95157,1,2,333341,333342,333344,1,3,0
95158,5,1,333346,333346,333347,0,1,2
95159,3,2,333349,333349,333351,0,2,2
95160,2,1,333351,333351,333352,0,1,0
95161,3,2,333354,333354,333356,0,2,2
95162,5,3,333359,333359,333362,0,3,3
95163,4,1,333363,333363,333364,0,1,1
95164,1,1,333364,333364,333365,0,1,0
95165,2,3,333366,333366,333369,0,3,1
95166,1,1,333367,333369,333370,2,3,0
95167,4,3,333371,333371,333374,0,3,1
95168,2,2,333373,333374,333376,1,3,0
95169,4,2,333377,333377,333379,0,2,1
95170,4,2,333381,333381,333383,0,2,2
95171,2,2,333383,333383,333385,0,2,0
95172,4,3,333387,333387,333390,0,3,2
95173,3,2,333390,333390,333392,0,2,0
95174,2,1,333392,333392,333393,0,1,0
95175,6,2,333398,333398,333400,0,2,5
95176,1,1,333399,333400,333401,1,2,0
95177,5,1,333404,333404,333405,0,1,3
95178,1,2,333405,333405,333407,0,2,0
95179,6,2,333411,333411,333413,0,2,4
95180,3,3,333414,333414,333417,0,3,1
95181,3,2,333417,333417,333419,0,2,0
95182,6,3,333423,333423,333426,0,3,4
95183,5,2,333428,333428,333430,0,2,2
95184,6,3,333434,333434,333437,0,3,4
95185,2,3,333436,333437,333440,1,4,0
95186,4,1,333440,333440,333441,0,1,0
95187,6,3,333446,333446,333449,0,3,5
95188,5,2,333451,333451,333453,0,2,2
95189,6,2,333457,333457,333459,0,2,4
95190,6,2,333463,333463,333465,0,2,4
95191,1,3,333464,333465,333468,1,4,0
95192,2,2,333466,333468,333470,2,4,0
95193,2,3,333468,333470,333473,2,5,0
95194,4,1,333472,333473,333474,1,2,0
95195,2,1,333474,333474,333475,0,1,0
95196,2,2,333476,333476,333478,0,2,1
95197,1,1,333477,333478,333479,1,2,0
95198,2,3,333479,333479,333482,0,3,0
95199,5,1,333484,333484,333485,0,1,2
95200,5,1,333489,333489,333490,0,1,4
95201,3,3,333492,333492,333495,0,3,2
95202,3,3,333495,333495,333498,0,3,0
95203,3,3,333498,333498,333501,0,3,0
95204,3,3,333501,333501,333504,0,3,0
95205,1,2,333502,333504,333506,2,4,0
95206,4,3,333506,333506,333509,0,3,0
95207,6,1,333512,333512,333513,0,1,3
95208,1,3,333513,333513,333516,0,3,0
95209,4,3,333517,333517,333520,0,3,1
95210,3,3,333520,333520,333523,0,3,0
95211,1,1,333521,333523,333524,2,3,0
95212,2,2,333523,333524,333526,1,3,0
95213,2,1,333525,333526,333527,1,2,0
95214,2,3,333527,333527,333530,0,3,0
95215,4,1,333531,333531,333532,0,1,1
95216,3,2,333534,333534,333536,0,2,2
95217,4,1,333538,333538,333539,0,1,2
95218,3,2,333541,333541,333543,0,2,2
95219,1,3,333542,333543,333546,1,4,0
95220,5,3,333547,333547,333550,0,3,1
95221,6,3,333553,333553,333556,0,3,3
95222,3,2,333556,333556,333558,0,2,0
95223,2,3,333558,333558,333561,0,3,0
95224,4,3,333562,333562,333565,0,3,1
95225,4,2,333566,333566,333568,0,2,1
95226,2,1,333568,333568,333569,0,1,0
95227,5,1,333573,333573,333574,0,1,4
95228,3,2,333576,333576,333578,0,2,2
95229,4,2,333580,333580,333582,0,2,2
95230,6,1,333586,333586,333587,0,1,4
95231,5,1,333591,333591,333592,0,1,4
95232,4,3,333595,333595,333598,0,3,3
95233,3,1,333598,333598,333599,0,1,0
95234,5,1,333603,333603,333604,0,1,4
95235,1,3,333604,333604,333607,0,3,0
95236,4,3,333608,333608,333611,0,3,1
95237,5,3,333613,333613,333616,0,3,2
95238,6,1,333619,333619,333620,0,1,3
95239,5,1,333624,333624,333625,0,1,4
95240,6,2,333630,333630,333632,0,2,5
95241,2,1,333632,333632,333633,0,1,0
95242,6,1,333638,333638,333639,0,1,5
95243,4,3,333642,333642,333645,0,3,3
95244,2,1,333644,333645,333646,1,2,0
95245,1,1,333645,333646,333647,1,2,0
95246,3,2,333648,333648,333650,0,2,1
95247,5,2,333653,333653,333655,0,2,3
95248,4,2,333657,333657,333659,0,2,2
95249,5,2,333662,333662,333664,0,2,3
95250,2,2,333664,333664,333666,0,2,0
95251,3,1,333667,333667,333668,0,1,1
95252,4,3,333671,333671,333674,0,3,3
95253,4,1,333675,333675,333676,0,1,1
95254,6,1,333681,333681,333682,0,1,5
95255,2,1,333683,333683,333684,0,1,1
95256,1,2,333684,333684,333686,0,2,0
95257,5,1,333689,333689,333690,0,1,3
95258,4,2,333693,333693,333695,0,2,3
95259,5,1,333698,333698,333699,0,1,3
95260,6,1,333704,333704,333705,0,1,5
95261,4,3,333708,333708,333711,0,3,3
95262,5,2,333713,333713,333715,0,2,2
95263,1,2,333714,333715,333717,1,3,0
95264,1,3,333715,333717,333720,2,5,0
95265,5,1,333720,333720,333721,0,1,0
95266,4,2,333724,333724,333726,0,2,3
95267,3,3,333727,333727,333730,0,3,1
95268,5,1,333732,333732,333733,0,1,2
95269,1,2,333733,333733,333735,0,2,0
95270,1,1,333734,333735,333736,1,2,0
95271,3,2,333737,333737,333739,0,2,1
95272,3,2,333740,333740,333742,0,2,1
95273,5,2,333745,333745,333747,0,2,3
95274,6,1,333751,333751,333752,0,1,4
95275,1,3,333752,333752,333755,0,3,0
95276,1,1,333753,333755,333756,2,3,0
95277,5,1,333758,333758,333759,0,1,2
95278,1,2,333759,333759,333761,0,2,0
95279,3,1,333762,333762,333763,0,1,1
95280,3,1,333765,333765,333766,0,1,2
95281,4,3,333769,333769,333772,0,3,3
95282,4,2,333773,333773,333775,0,2,1
95283,6,1,333779,333779,333780,0,1,4
95284,2,1,333781,333781,333782,0,1,1
95285,5,1,333786,333786,333787,0,1,4
95286,1,2,333787,333787,333789,0,2,0
95287,1,2,333788,333789,333791,1,3,0
95288,5,3,333793,333793,333796,0,3,2
95289,5,3,333798,333798,333801,0,3,2
95290,4,1,333802,333802,333803,0,1,1
95291,4,2,333806,333806,333808,0,2,3
95292,1,3,333807,333808,333811,1,4,0
95293,1,2,333808,333811,333813,3,5,0
95294,1,2,333809,333813,333815,4,6,0
95295,6,3,333815,333815,333818,0,3,0
95296,4,3,333819,333819,333822,0,3,1
95297,1,1,333820,333822,333823,2,3,0
95298,5,2,333825,333825,333827,0,2,2
95299,5,3,333830,333830,333833,0,3,3
95300,4,1,333834,333834,333835,0,1,1
95301,5,1,333839,333839,333840,0,1,4
95302,6,1,333845,333845,333846,0,1,5
95303,4,3,333849,333849,333852,0,3,3
95304,6,3,333855,333855,333858,0,3,3
95305,4,1,333859,333859,333860,0,1,1
95306,3,2,333862,333862,333864,0,2,2
95307,3,3,333865,333865,333868,0,3,1
95308,4,2,333869,333869,333871,0,2,1
95309,5,1,333874,333874,333875,0,1,3
95310,3,3,333877,333877,333880,0,3,2
95311,5,1,333882,333882,333883,0,1,2
95312,2,3,333884,333884,333887,0,3,1
95313,4,1,333888,333888,333889,0,1,1
95314,5,2,333893,333893,333895,0,2,4
95315,2,2,333895,333895,333897,0,2,0
95316,5,3,333900,333900,333903,0,3,3
95317,1,2,333901,333903,333905,2,4,0
95318,6,3,333907,333907,333910,0,3,2
95319,2,1,333909,333910,333911,1,2,0
95320,2,1,333911,333911,333912,0,1,0
95321,2,3,333913,333913,333916,0,3,1
95322,4,1,333917,333917,333918,0,1,1
95323,6,2,333923,333923,333925,0,2,5
95324,4,3,333927,333927,333930,0,3,2
95325,4,3,333931,333931,333934,0,3,1
95326,2,2,333933,333934,333936,1,3,0
95327,6,3,333939,333939,333942,0,3,3
95328,1,2,333940,333942,333944,2,4,0
95329,6,2,333946,333946,333948,0,2,2
95330,2,1,333948,333948,333949,0,1,0
95331,5,3,333953,333953,333956,0,3,4
95332,1,1,333954,333956,333957,2,3,0
95333,4,2,333958,333958,333960,0,2,1
95334,4,2,333962,333962,333964,0,2,2
95335,2,1,333964,333964,333965,0,1,0
95336,4,1,333968,333968,333969,0,1,3
95337,5,2,333973,333973,333975,0,2,4
95338,1,3,333974,333975,333978,1,4,0
95339,4,2,333978,333978,333980,0,2,0
95340,5,1,333983,333983,333984,0,1,3
95341,2,3,333985,333985,333988,0,3,1
95342,1,1,333986,333988,333989,2,3,0
95343,5,1,333991,333991,333992,0,1,2
95344,1,2,333992,333992,333994,0,2,0
95345,3,2,333995,333995,333997,0,2,1
95346,5,2,334000,334000,334002,0,2,3
95347,3,1,334003,334003,334004,0,1,1
95348,5,2,334008,334008,334010,0,2,4
95349,3,3,334011,334011,334014,0,3,1
95350,2,1,334013,334014,334015,1,2,0
95351,6,3,334019,334019,334022,0,3,4
95352,2,2,334021,334022,334024,1,3,0
95353,6,1,334027,334027,334028,0,1,3
95354,4,2,334031,334031,334033,0,2,3
95355,2,3,334033,334033,334036,0,3,0
95356,1,2,334034,334036,334038,2,4,0
95357,4,3,334038,334038,334041,0,3,0
95358,5,2,334043,334043,334045,0,2,2
95359,1,1,334044,334045,334046,1,2,0
95360,3,3,334047,334047,334050,0,3,1
95361,3,3,334050,334050,334053,0,3,0
95362,4,1,334054,334054,334055,0,1,1
95363,4,1,334058,334058,334059,0,1,3
95364,5,3,334063,334063,334066,0,3,4
95365,5,2,334068,334068,334070,0,2,2
95366,1,3,334069,334070,334073,1,4,0
95367,6,1,334075,334075,334076,0,1,2
95368,1,2,334076,334076,334078,0,2,0
95369,3,3,334079,334079,334082,0,3,1
95370,1,2,334080,334082,334084,2,4,0
95371,3,2,334083,334084,334086,1,3,0
95372,3,2,334086,334086,334088,0,2,0
95373,4,2,334090,334090,334092,0,2,2
95374,3,1,334093,334093,334094,0,1,1
95375,2,1,334095,334095,334096,0,1,1
95376,5,3,334100,334100,334103,0,3,4
95377,4,2,334104,334104,334106,0,2,1
95378,4,1,334108,334108,334109,0,1,2
95379,1,3,334109,334109,334112,0,3,0
95380,2,1,334111,334112,334113,1,2,0
95381,2,1,334113,334113,334114,0,1,0
95382,2,2,334115,334115,334117,0,2,1
95383,3,2,334118,334118,334120,0,2,1
95384,3,2,334121,334121,334123,0,2,1
95385,5,2,334126,334126,334128,0,2,3
95386,2,3,334128,334128,334131,0,3,0
95387,2,1,334130,334131,334132,1,2,0
95388,4,1,334134,334134,334135,0,1,2
95389,6,1,334140,334140,334141,0,1,5
95390,5,1,334145,334145,334146,0,1,4
95391,4,2,334149,334149,334151,0,2,3
95392,1,2,334150,334151,334153,1,3,0
95393,4,1,334154,334154,334155,0,1,1
95394,3,2,334157,334157,334159,0,2,2
95395,3,1,334160,334160,334161,0,1,1
95396,1,1,334161,334161,334162,0,1,0
95397,1,3,334162,334162,334165,0,3,0
95398,6,3,334168,334168,334171,0,3,3
95399,1,1,334169,334171,334172,2,3,0
95400,2,1,334171,334172,334173,1,2,0
95401,5,3,334176,334176,334179,0,3,3
95402,2,1,334178,334179,334180,1,2,0
95403,5,2,334183,334183,334185,0,2,3
95404,1,2,334184,334185,334187,1,3,0
95405,4,3,334188,334188,334191,0,3,1
95406,1,1,334189,334191,334192,2,3,0
95407,2,1,334191,334192,334193,1,2,0
95408,6,2,334197,334197,334199,0,2,4
95409,4,3,334201,334201,334204,0,3,2
95410,4,3,334205,334205,334208,0,3,1
95411,2,3,334207,334208,334211,1,4,0
95412,4,2,334211,334211,334213,0,2,0
95413,1,1,334212,334213,334214,1,2,0
95414,4,1,334216,334216,334217,0,1,2
95415,5,2,334221,334221,334223,0,2,4
95416,4,2,334225,334225,334227,0,2,2
95417,4,3,334229,334229,334232,0,3,2
95418,4,2,334233,334233,334235,0,2,1
95419,3,2,334236,334236,334238,0,2,1
95420,3,1,334239,334239,334240,0,1,1
95421,4,1,334243,334243,334244,0,1,3
95422,3,3,334246,334246,334249,0,3,2
95423,2,2,334248,334249,334251,1,3,0
95424,4,3,334252,334252,334255,0,3,1
95425,5,3,334257,334257,334260,0,3,2
95426,4,2,334261,334261,334263,0,2,1
95427,2,2,334263,334263,334265,0,2,0
95428,5,1,334268,334268,334269,0,1,3
95429,1,3,334269,334269,334272,0,3,0
95430,5,3,334274,334274,334277,0,3,2
95431,5,2,334279,334279,334281,0,2,2
95432,4,2,334283,334283,334285,0,2,2
95433,6,2,334289,334289,334291,0,2,4
95434,6,2,334295,334295,334297,0,2,4
95435,3,2,334298,334298,334300,0,2,1
95436,1,3,334299,334300,334303,1,4,0
95437,3,1,334302,334303,334304,1,2,0
95438,3,1,334305,334305,334306,0,1,1
95439,6,2,334311,334311,334313,0,2,5
95440,4,3,334315,334315,334318,0,3,2
95441,4,3,334319,334319,334322,0,3,1
95442,6,3,334325,334325,334328,0,3,3
95443,4,2,334329,334329,334331,0,2,1
95444,6,1,334335,334335,334336,0,1,4
95445,1,3,334336,334336,334339,0,3,0
95446,4,3,334340,334340,334343,0,3,1
95447,2,3,334342,334343,334346,1,4,0
95448,1,1,334343,334346,334347,3,4,0
95449,1,3,334344,334347,334350,3,6,0
95450,5,3,334349,334350,334353,1,4,0
95451,1,3,334350,334353,334356,3,6,0
95452,5,3,334355,334356,334359,1,4,0
95453,3,1,334358,334359,334360,1,2,0
95454,6,3,334364,334364,334367,0,3,4
95455,5,1,334369,334369,334370,0,1,2
95456,3,1,334372,334372,334373,0,1,2
95457,2,1,334374,334374,334375,0,1,1
95458,3,1,334377,334377,334378,0,1,2
95459,4,3,334381,334381,334384,0,3,3
95460,1,2,334382,334384,334386,2,4,0
95461,6,1,334388,334388,334389,0,1,2
95462,1,1,334389,334389,334390,0,1,0
95463,5,3,334394,334394,334397,0,3,4
95464,1,3,334395,334397,334400,2,5,0
95465,5,3,334400,334400,334403,0,3,0
95466,4,3,334404,334404,334407,0,3,1
95467,1,1,334405,334407,334408,2,3,0
95468,6,1,334411,334411,334412,0,1,3
95469,1,3,334412,334412,334415,0,3,0
95470,1,1,334413,334415,334416,2,3,0
95471,5,3,334418,334418,334421,0,3,2
95472,5,3,334423,334423,334426,0,3,2
95473,6,3,334429,334429,334432,0,3,3
95474,5,2,334434,334434,334436,0,2,2
95475,2,2,334436,334436,334438,0,2,0
95476,5,1,334441,334441,334442,0,1,3
95477,6,1,334447,334447,334448,0,1,5
95478,2,3,334449,334449,334452,0,3,1
95479,2,1,334451,334452,334453,1,2,0
95480,3,3,334454,334454,334457,0,3,1
95481,2,1,334456,334457,334458,1,2,0
95482,3,1,334459,334459,334460,0,1,1
95483,6,2,334465,334465,334467,0,2,5
95484,3,1,334468,334468,334469,0,1,1
95485,2,3,334470,334470,334473,0,3,1
95486,1,2,334471,334473,334475,2,4,0
95487,2,2,334473,334475,334477,2,4,0
95488,2,1,334475,334477,334478,2,3,0
95489,4,2,334479,334479,334481,0,2,1
95490,2,2,334481,334481,334483,0,2,0
95491,4,1,334485,334485,334486,0,1,2
95492,1,1,334486,334486,334487,0,1,0
95493,6,3,334492,334492,334495,0,3,5
95494,1,3,334493,334495,334498,2,5,0
95495,6,1,334499,334499,334500,0,1,1
95496,3,1,334502,334502,334503,0,1,2
95497,3,1,334505,334505,334506,0,1,2
95498,2,3,334507,334507,334510,0,3,1
95499,4,1,334511,334511,334512,0,1,1
95500,4,2,334515,334515,334517,0,2,3
95501,5,1,334520,334520,334521,0,1,3
95502,4,2,334524,334524,334526,0,2,3
95503,6,2,334530,334530,334532,0,2,4
95504,1,3,334531,334532,334535,1,4,0
95505,4,1,334535,334535,334536,0,1,0
95506,4,1,334539,334539,334540,0,1,3
95507,3,1,334542,334542,334543,0,1,2
95508,5,3,334547,334547,334550,0,3,4
95509,1,1,334548,334550,334551,2,3,0
95510,5,2,334553,334553,334555,0,2,2
95511,1,3,334554,334555,334558,1,4,0
95512,6,2,334560,334560,334562,0,2,2
95513,2,3,334562,334562,334565,0,3,0
95514,3,3,334565,334565,334568,0,3,0
95515,1,3,334566,334568,334571,2,5,0
95516,3,1,334569,334571,334572,2,3,0
95517,4,1,334573,334573,334574,0,1,1
95518,1,2,334574,334574,334576,0,2,0
95519,4,3,334578,334578,334581,0,3,2
95520,4,1,334582,334582,334583,0,1,1
95521,4,2,334586,334586,334588,0,2,3
95522,2,3,334588,334588,334591,0,3,0
95523,1,1,334589,334591,334592,2,3,0
95524,5,2,334594,334594,334596,0,2,2
95525,6,2,334600,334600,334602,0,2,4
95526,5,2,334605,334605,334607,0,2,3
95527,6,3,334611,334611,334614,0,3,4
95528,3,3,334614,334614,334617,0,3,0
95529,5,2,334619,334619,334621,0,2,2
95530,6,1,334625,334625,334626,0,1,4
95531,6,2,334631,334631,334633,0,2,5
95532,5,3,334636,334636,334639,0,3,3
95533,3,1,334639,334639,334640,0,1,0
95534,2,3,334641,334641,334644,0,3,1
95535,5,2,334646,334646,334648,0,2,2
95536,4,1,334650,334650,334651,0,1,2
95537,1,3,334651,334651,334654,0,3,0
95538,1,1,334652,334654,334655,2,3,0
95539,6,3,334658,334658,334661,0,3,3
95540,6,2,334664,334664,334666,0,2,3
95541,6,2,334670,334670,334672,0,2,4
95542,6,2,334676,334676,334678,0,2,4
95543,5,2,334681,334681,334683,0,2,3
95544,1,1,334682,334683,334684,1,2,0
95545,6,2,334688,334688,334690,0,2,4
95546,3,3,334691,334691,334694,0,3,1
95547,5,3,334696,334696,334699,0,3,2
95548,5,2,334701,334701,334703,0,2,2
95549,6,1,334707,334707,334708,0,1,4
95550,2,2,334709,334709,334711,0,2,1
95551,4,3,334713,334713,334716,0,3,2
95552,4,2,334717,334717,334719,0,2,1
95553,6,2,334723,334723,334725,0,2,4
95554,4,2,334727,334727,334729,0,2,2
95555,2,2,334729,334729,334731,0,2,0
95556,1,3,334730,334731,334734,1,4,0
95557,4,1,334734,334734,334735,0,1,0
95558,3,2,334737,334737,334739,0,2,2
95559,5,2,334742,334742,334744,0,2,3
95560,4,2,334746,334746,334748,0,2,2
95561,1,1,334747,334748,334749,1,2,0
95562,1,2,334748,334749,334751,1,3,0
95563,2,3,334750,334751,334754,1,4,0
95564,1,2,334751,334754,334756,3,5,0
95565,4,2,334755,334756,334758,1,3,0
95566,4,3,334759,334759,334762,0,3,1
95567,3,1,334762,334762,334763,0,1,0
95568,3,1,334765,334765,334766,0,1,2
95569,5,1,334770,334770,334771,0,1,4
95570,6,2,334776,334776,334778,0,2,5
95571,1,1,334777,334778,334779,1,2,0
95572,2,1,334779,334779,334780,0,1,0
95573,2,3,334781,334781,334784,0,3,1
95574,3,3,334784,334784,334787,0,3,0
95575,6,3,334790,334790,334793,0,3,3
95576,1,3,334791,334793,334796,2,5,0
95577,2,3,334793,334796,334799,3,6,0
95578,5,2,334798,334799,334801,1,3,0
95579,2,1,334800,334801,334802,1,2,0
95580,3,1,334803,334803,334804,0,1,1
95581,1,1,334804,334804,334805,0,1,0
95582,4,1,334808,334808,334809,0,1,3
95583,1,1,334809,334809,334810,0,1,0
95584,6,1,334815,334815,334816,0,1,5
95585,1,2,334816,334816,334818,0,2,0
95586,5,2,334821,334821,334823,0,2,3
95587,5,2,334826,334826,334828,0,2,3
95588,4,3,334830,334830,334833,0,3,2
95589,1,3,334831,334833,334836,2,5,0
95590,6,3,334837,334837,334840,0,3,1
95591,5,1,334842,334842,334843,0,1,2
95592,4,3,334846,334846,334849,0,3,3
95593,5,2,334851,334851,334853,0,2,2
95594,1,2,334852,334853,334855,1,3,0
95595,3,1,334855,334855,334856,0,1,0
95596,4,3,334859,334859,334862,0,3,3
95597,5,1,334864,334864,334865,0,1,2
95598,3,2,334867,334867,334869,0,2,2
95599,5,2,334872,334872,334874,0,2,3
95600,2,1,334874,334874,334875,0,1,0
95601,3,1,334877,334877,334878,0,1,2
95602,4,3,334881,334881,334884,0,3,3
95603,1,1,334882,334884,334885,2,3,0
95604,4,1,334886,334886,334887,0,1,1
95605,5,2,334891,334891,334893,0,2,4
95606,4,2,334895,334895,334897,0,2,2
95607,5,2,334900,334900,334902,0,2,3
95608,3,1,334903,334903,334904,0,1,1
95609,2,3,334905,334905,334908,0,3,1
95610,2,1,334907,334908,334909,1,2,0
95611,6,2,334913,334913,334915,0,2,4
95612,1,3,334914,334915,334918,1,4,0
95613,5,1,334919,334919,334920,0,1,1
95614,2,2,334921,334921,334923,0,2,1
95615,6,3,334927,334927,334930,0,3,4
95616,6,1,334933,334933,334934,0,1,3
95617,4,2,334937,334937,334939,0,2,3
95618,4,2,334941,334941,334943,0,2,2
95619,6,3,334947,334947,334950,0,3,4
95620,4,2,334951,334951,334953,0,2,1
95621,6,3,334957,334957,334960,0,3,4
95622,6,1,334963,334963,334964,0,1,3
95623,4,3,334967,334967,334970,0,3,3
95624,4,1,334971,334971,334972,0,1,1
95625,1,3,334972,334972,334975,0,3,0
95626,5,2,334977,334977,334979,0,2,2
95627,4,2,334981,334981,334983,0,2,2
95628,4,1,334985,334985,334986,0,1,2
95629,3,2,334988,334988,334990,0,2,2
95630,1,1,334989,334990,334991,1,2,0
95631,1,1,334990,334991,334992,1,2,0
95632,4,3,334994,334994,334997,0,3,2
95633,1,3,334995,334997,335000,2,5,0
95634,2,1,334997,335000,335001,3,4,0
95635,6,1,335003,335003,335004,0,1,2
95636,3,3,335006,335006,335009,0,3,2
95637,5,3,335011,335011,335014,0,3,2
95638,2,1,335013,335014,335015,1,2,0
95639,3,2,335016,335016,335018,0,2,1
95640,3,3,335019,335019,335022,0,3,1
95641,1,3,335020,335022,335025,2,5,0
95642,3,1,335023,335025,335026,2,3,0
95643,1,2,335024,335026,335028,2,4,0
95644,1,1,335025,335028,335029,3,4,0
95645,3,3,335028,335029,335032,1,4,0
95646,1,3,335029,335032,335035,3,6,0
95647,1,1,335030,335035,335036,5,6,0
95648,1,2,335031,335036,335038,5,7,0
95649,1,3,335032,335038,335041,6,9,0
95650,3,3,335035,335041,335044,6,9,0
95651,2,1,335037,335044,335045,7,8,0
95652,2,2,335039,335045,335047,6,8,0
95653,6,1,335045,335047,335048,2,3,0
95654,2,2,335047,335048,335050,1,3,0
95655,3,3,335050,335050,335053,0,3,0
95656,6,2,335056,335056,335058,0,2,3
95657,4,2,335060,335060,335062,0,2,2
95658,6,1,335066,335066,335067,0,1,4
95659,5,3,335071,335071,335074,0,3,4
95660,2,2,335073,335074,335076,1,3,0
95661,6,1,335079,335079,335080,0,1,3
95662,5,2,335084,335084,335086,0,2,4
95663,5,3,335089,335089,335092,0,3,3
95664,3,2,335092,335092,335094,0,2,0
95665,3,2,335095,335095,335097,0,2,1
95666,4,2,335099,335099,335101,0,2,2
95667,3,1,335102,335102,335103,0,1,1
95668,4,3,335106,335106,335109,0,3,3
95669,1,3,335107,335109,335112,2,5,0
95670,2,1,335109,335112,335113,3,4,0
95671,5,1,335114,335114,335115,0,1,1
95672,3,1,335117,335117,335118,0,1,2
95673,3,2,335120,335120,335122,0,2,2
95674,6,2,335126,335126,335128,0,2,4
95675,2,1,335128,335128,335129,0,1,0
95676,1,3,335129,335129,335132,0,3,0
95677,3,1,335132,335132,335133,0,1,0
95678,6,1,335138,335138,335139,0,1,5
95679,6,1,335144,335144,335145,0,1,5
95680,2,2,335146,335146,335148,0,2,1
95681,5,1,335151,335151,335152,0,1,3
95682,6,3,335157,335157,335160,0,3,5
95683,2,1,335159,335160,335161,1,2,0
95684,6,2,335165,335165,335167,0,2,4
95685,2,2,335167,335167,335169,0,2,0
95686,2,1,335169,335169,335170,0,1,0
95687,4,3,335173,335173,335176,0,3,3
95688,5,3,335178,335178,335181,0,3,2
95689,2,1,335180,335181,335182,1,2,0
95690,1,2,335181,335182,335184,1,3,0
95691,4,1,335185,335185,335186,0,1,1
95692,3,2,335188,335188,335190,0,2,2
95693,5,2,335193,335193,335195,0,2,3
95694,3,1,335196,335196,335197,0,1,1
95695,3,1,335199,335199,335200,0,1,2
95696,5,1,335204,335204,335205,0,1,4
95697,5,2,335209,335209,335211,0,2,4
95698,3,3,335212,335212,335215,0,3,1
95699,3,3,335215,335215,335218,0,3,0
95700,1,1,335216,335218,335219,2,3,0
95701,2,1,335218,335219,335220,1,2,0
95702,2,2,335220,335220,335222,0,2,0
95703,1,2,335221,335222,335224,1,3,0
95704,2,1,335223,335224,335225,1,2,0
95705,5,2,335228,335228,335230,0,2,3
95706,1,3,335229,335230,335233,1,4,0
95707,2,1,335231,335233,335234,2,3,0
95708,4,3,335235,335235,335238,0,3,1
95709,1,3,335236,335238,335241,2,5,0
95710,6,3,335242,335242,335245,0,3,1
95711,1,2,335243,335245,335247,2,4,0
95712,4,1,335247,335247,335248,0,1,0
95713,1,1,335248,335248,335249,0,1,0
95714,3,2,335251,335251,335253,0,2,2
95715,3,2,335254,335254,335256,0,2,1
95716,1,3,335255,335256,335259,1,4,0
95717,2,2,335257,335259,335261,2,4,0
95718,2,3,335259,335261,335264,2,5,0
95719,5,3,335264,335264,335267,0,3,0
95720,2,3,335266,335267,335270,1,4,0
95721,1,3,335267,335270,335273,3,6,0
95722,5,2,335272,335273,335275,1,3,0
95723,6,2,335278,335278,335280,0,2,3
95724,1,1,335279,335280,335281,1,2,0
95725,4,2,335283,335283,335285,0,2,2
95726,1,1,335284,335285,335286,1,2,0
95727,1,2,335285,335286,335288,1,3,0
95728,4,1,335289,335289,335290,0,1,1
95729,5,3,335294,335294,335297,0,3,4
95730,3,1,335297,335297,335298,0,1,0
95731,1,2,335298,335298,335300,0,2,0
95732,2,1,335300,335300,335301,0,1,0
95733,3,3,335303,335303,335306,0,3,2
95734,2,3,335305,335306,335309,1,4,0
95735,1,2,335306,335309,335311,3,5,0
95736,5,3,335311,335311,335314,0,3,0
95737,6,2,335317,335317,335319,0,2,3
95738,6,3,335323,335323,335326,0,3,4
95739,4,2,335327,335327,335329,0,2,1
95740,3,2,335330,335330,335332,0,2,1
95741,5,1,335335,335335,335336,0,1,3
95742,5,1,335340,335340,335341,0,1,4
95743,6,3,335346,335346,335349,0,3,5
95744,1,1,335347,335349,335350,2,3,0
95745,6,1,335353,335353,335354,0,1,3
95746,6,3,335359,335359,335362,0,3,5
95747,4,2,335363,335363,335365,0,2,1
95748,2,2,335365,335365,335367,0,2,0
95749,4,3,335369,335369,335372,0,3,2
95750,1,1,335370,335372,335373,2,3,0
95751,6,2,335376,335376,335378,0,2,3
95752,2,1,335378,335378,335379,0,1,0
95753,4,2,335382,335382,335384,0,2,3
95754,6,2,335388,335388,335390,0,2,4
95755,3,3,335391,335391,335394,0,3,1
95756,6,2,335397,335397,335399,0,2,3
95757,4,3,335401,335401,335404,0,3,2
95758,4,1,335405,335405,335406,0,1,1
95759,4,3,335409,335409,335412,0,3,3
95760,1,1,335410,335412,335413,2,3,0
95761,3,1,335413,335413,335414,0,1,0
95762,2,1,335415,335415,335416,0,1,1
95763,2,3,335417,335417,335420,0,3,1
95764,3,3,335420,335420,335423,0,3,0
95765,5,2,335425,335425,335427,0,2,2
95766,2,1,335427,335427,335428,0,1,0
95767,2,1,335429,335429,335430,0,1,1
95768,5,1,335434,335434,335435,0,1,4
95769,4,2,335438,335438,335440,0,2,3
95770,3,1,335441,335441,335442,0,1,1
95771,3,2,335444,335444,335446,0,2,2
95772,1,3,335445,335446,335449,1,4,0
95773,6,1,335451,335451,335452,0,1,2
95774,1,3,335452,335452,335455,0,3,0
95775,5,2,335457,335457,335459,0,2,2
95776,1,2,335458,335459,335461,1,3,0
95777,1,1,335459,335461,335462,2,3,0
95778,3,1,335462,335462,335463,0,1,0
95779,1,1,335463,335463,335464,0,1,0
95780,4,3,335467,335467,335470,0,3,3
95781,1,2,335468,335470,335472,2,4,0
95782,3,3,335471,335472,335475,1,4,0
95783,2,1,335473,335475,335476,2,3,0
95784,6,3,335479,335479,335482,0,3,3
95785,2,3,335481,335482,335485,1,4,0
95786,3,2,335484,335485,335487,1,3,0
95787,4,3,335488,335488,335491,0,3,1
95788,3,1,335491,335491,335492,0,1,0
95789,5,3,335496,335496,335499,0,3,4
95790,3,3,335499,335499,335502,0,3,0
95791,3,3,335502,335502,335505,0,3,0
95792,4,3,335506,335506,335509,0,3,1
95793,6,3,335512,335512,335515,0,3,3
95794,6,2,335518,335518,335520,0,2,3
95795,5,1,335523,335523,335524,0,1,3
95796,1,2,335524,335524,335526,0,2,0
95797,2,1,335526,335526,335527,0,1,0
95798,5,3,335531,335531,335534,0,3,4
95799,6,3,335537,335537,335540,0,3,3
95800,3,1,335540,335540,335541,0,1,0
95801,5,3,335545,335545,335548,0,3,4
95802,2,1,335547,335548,335549,1,2,0
95803,4,2,335551,335551,335553,0,2,2
95804,3,3,335554,335554,335557,0,3,1
95805,3,2,335557,335557,335559,0,2,0
95806,3,3,335560,335560,335563,0,3,1
95807,6,1,335566,335566,335567,0,1,3
95808,1,2,335567,335567,335569,0,2,0
95809,4,1,335571,335571,335572,0,1,2
95810,6,3,335577,335577,335580,0,3,5
95811,2,3,335579,335580,335583,1,4,0
95812,6,3,335585,335585,335588,0,3,2
95813,3,1,335588,335588,335589,0,1,0
95814,3,3,335591,335591,335594,0,3,2
95815,6,1,335597,335597,335598,0,1,3
95816,5,1,335602,335602,335603,0,1,4
95817,6,2,335608,335608,335610,0,2,5
95818,3,1,335611,335611,335612,0,1,1
95819,3,2,335614,335614,335616,0,2,2
95820,6,3,335620,335620,335623,0,3,4
95821,3,1,335623,335623,335624,0,1,0
95822,4,3,335627,335627,335630,0,3,3
95823,2,1,335629,335630,335631,1,2,0
95824,1,1,335630,335631,335632,1,2,0
95825,6,3,335636,335636,335639,0,3,4
95826,2,2,335638,335639,335641,1,3,0
95827,1,3,335639,335641,335644,2,5,0
95828,2,2,335641,335644,335646,3,5,0
95829,2,1,335643,335646,335647,3,4,0
95830,6,1,335649,335649,335650,0,1,2
95831,4,2,335653,335653,335655,0,2,3
95832,5,2,335658,335658,335660,0,2,3
95833,2,3,335660,335660,335663,0,3,0
95834,1,3,335661,335663,335666,2,5,0
95835,2,2,335663,335666,335668,3,5,0
95836,5,1,335668,335668,335669,0,1,0
95837,5,2,335673,335673,335675,0,2,4
95838,3,3,335676,335676,335679,0,3,1
95839,5,1,335681,335681,335682,0,1,2
95840,2,1,335683,335683,335684,0,1,1
95841,4,2,335687,335687,335689,0,2,3
95842,5,2,335692,335692,335694,0,2,3
95843,6,1,335698,335698,335699,0,1,4
95844,4,3,335702,335702,335705,0,3,3
95845,5,2,335707,335707,335709,0,2,2
95846,4,2,335711,335711,335713,0,2,2
95847,6,2,335717,335717,335719,0,2,4
95848,4,3,335721,335721,335724,0,3,2
95849,4,2,335725,335725,335727,0,2,1
95850,2,2,335727,335727,335729,0,2,0
95851,2,1,335729,335729,335730,0,1,0
95852,4,2,335733,335733,335735,0,2,3
95853,3,1,335736,335736,335737,0,1,1
95854,5,2,335741,335741,335743,0,2,4
95855,4,1,335745,335745,335746,0,1,2
95856,1,3,335746,335746,335749,0,3,0
95857,4,1,335750,335750,335751,0,1,1
95858,6,1,335756,335756,335757,0,1,5
95859,6,1,335762,335762,335763,0,1,5
95860,5,1,335767,335767,335768,0,1,4
95861,5,2,335772,335772,335774,0,2,4
95862,4,2,335776,335776,335778,0,2,2
95863,1,2,335777,335778,335780,1,3,0
95864,4,2,335781,335781,335783,0,2,1
95865,3,2,335784,335784,335786,0,2,1
95866,3,2,335787,335787,335789,0,2,1
95867,4,3,335791,335791,335794,0,3,2
95868,3,1,335794,335794,335795,0,1,0
95869,6,1,335800,335800,335801,0,1,5
95870,1,2,335801,335801,335803,0,2,0
95871,2,1,335803,335803,335804,0,1,0
95872,1,2,335804,335804,335806,0,2,0
95873,2,1,335806,335806,335807,0,1,0
95874,6,2,335812,335812,335814,0,2,5
95875,6,3,335818,335818,335821,0,3,4
95876,2,2,335820,335821,335823,1,3,0
95877,5,1,335825,335825,335826,0,1,2
95878,3,2,335828,335828,335830,0,2,2
95879,1,2,335829,335830,335832,1,3,0
95880,1,3,335830,335832,335835,2,5,0
95881,3,3,335833,335835,335838,2,5,0
95882,3,3,335836,335838,335841,2,5,0
95883,3,1,335839,335841,335842,2,3,0
95884,1,1,335840,335842,335843,2,3,0
95885,4,2,335844,335844,335846,0,2,1
95886,4,2,335848,335848,335850,0,2,2
95887,3,3,335851,335851,335854,0,3,1
95888,3,1,335854,335854,335855,0,1,0
95889,2,1,335856,335856,335857,0,1,1
95890,5,3,335861,335861,335864,0,3,4
95891,4,2,335865,335865,335867,0,2,1
95892,2,3,335867,335867,335870,0,3,0
95893,3,3,335870,335870,335873,0,3,0
95894,3,1,335873,335873,335874,0,1,0
95895,3,3,335876,335876,335879,0,3,2
95896,2,1,335878,335879,335880,1,2,0
95897,6,1,335884,335884,335885,0,1,4
95898,5,2,335889,335889,335891,0,2,4
95899,6,2,335895,335895,335897,0,2,4
95900,3,3,335898,335898,335901,0,3,1
95901,2,2,335900,335901,335903,1,3,0
95902,6,2,335906,335906,335908,0,2,3
95903,3,3,335909,335909,335912,0,3,1
95904,3,2,335912,335912,335914,0,2,0
95905,3,2,335915,335915,335917,0,2,1
95906,5,1,335920,335920,335921,0,1,3
95907,6,2,335926,335926,335928,0,2,5
95908,1,3,335927,335928,335931,1,4,0
95909,1,2,335928,335931,335933,3,5,0
95910,1,2,335929,335933,335935,4,6,0
95911,4,3,335933,335935,335938,2,5,0
95912,1,2,335934,335938,335940,4,6,0
95913,5,2,335939,335940,335942,1,3,0
95914,1,2,335940,335942,335944,2,4,0
95915,6,3,335946,335946,335949,0,3,2
95916,6,1,335952,335952,335953,0,1,3
95917,1,2,335953,335953,335955,0,2,0
95918,6,3,335959,335959,335962,0,3,4
95919,3,2,335962,335962,335964,0,2,0
95920,1,3,335963,335964,335967,1,4,0
95921,4,2,335967,335967,335969,0,2,0
95922,1,1,335968,335969,335970,1,2,0
95923,4,3,335972,335972,335975,0,3,2
95924,6,1,335978,335978,335979,0,1,3
95925,2,2,335980,335980,335982,0,2,1
95926,3,1,335983,335983,335984,0,1,1
95927,4,3,335987,335987,335990,0,3,3
95928,6,1,335993,335993,335994,0,1,3
95929,2,1,335995,335995,335996,0,1,1
95930,6,2,336001,336001,336003,0,2,5
95931,1,1,336002,336003,336004,1,2,0
95932,4,2,336006,336006,336008,0,2,2
95933,1,3,336007,336008,336011,1,4,0
95934,5,3,336012,336012,336015,0,3,1
95935,3,2,336015,336015,336017,0,2,0
95936,5,1,336020,336020,336021,0,1,3
95937,1,2,336021,336021,336023,0,2,0
95938,3,3,336024,336024,336027,0,3,1
95939,4,1,336028,336028,336029,0,1,1
95940,5,1,336033,336033,336034,0,1,4
95941,5,3,336038,336038,336041,0,3,4
95942,4,1,336042,336042,336043,0,1,1
95943,3,2,336045,336045,336047,0,2,2
95944,1,1,336046,336047,336048,1,2,0
95945,5,2,336051,336051,336053,0,2,3
95946,4,1,336055,336055,336056,0,1,2
95947,1,3,336056,336056,336059,0,3,0
95948,4,2,336060,336060,336062,0,2,1
95949,4,3,336064,336064,336067,0,3,2
95950,3,2,336067,336067,336069,0,2,0
95951,3,1,336070,336070,336071,0,1,1
95952,2,1,336072,336072,336073,0,1,1
95953,2,3,336074,336074,336077,0,3,1
95954,4,3,336078,336078,336081,0,3,1
95955,5,2,336083,336083,336085,0,2,2
95956,3,3,336086,336086,336089,0,3,1
95957,5,1,336091,336091,336092,0,1,2
95958,4,1,336095,336095,336096,0,1,3
95959,2,1,336097,336097,336098,0,1,1
95960,3,3,336100,336100,336103,0,3,2
95961,6,1,336106,336106,336107,0,1,3
95962,3,1,336109,336109,336110,0,1,2
95963,2,2,336111,336111,336113,0,2,1
95964,4,2,336115,336115,336117,0,2,2
95965,4,1,336119,336119,336120,0,1,2
95966,3,1,336122,336122,336123,0,1,2
95967,3,2,336125,336125,336127,0,2,2
95968,3,2,336128,336128,336130,0,2,1
95969,3,1,336131,336131,336132,0,1,1
95970,1,3,336132,336132,336135,0,3,0
95971,3,3,336135,336135,336138,0,3,0
95972,2,2,336137,336138,336140,1,3,0
95973,2,2,336139,336140,336142,1,3,0
95974,2,1,336141,336142,336143,1,2,0
95975,3,1,336144,336144,336145,0,1,1
95976,2,3,336146,336146,336149,0,3,1
95977,5,1,336151,336151,336152,0,1,2
95978,1,1,336152,336152,336153,0,1,0
95979,6,2,336158,336158,336160,0,2,5
95980,1,3,336159,336160,336163,1,4,0
95981,6,2,336165,336165,336167,0,2,2
95982,3,2,336168,336168,336170,0,2,1
95983,2,1,336170,336170,336171,0,1,0
95984,6,3,336176,336176,336179,0,3,5
95985,3,3,336179,336179,336182,0,3,0
95986,3,1,336182,336182,336183,0,1,0
95987,5,1,336187,336187,336188,0,1,4
95988,3,1,336190,336190,336191,0,1,2
95989,4,3,336194,336194,336197,0,3,3
95990,1,1,336195,336197,336198,2,3,0
95991,6,1,336201,336201,336202,0,1,3
95992,2,1,336203,336203,336204,0,1,1
95993,1,3,336204,336204,336207,0,3,0
95994,4,2,336208,336208,336210,0,2,1
95995,1,3,336209,336210,336213,1,4,0
95996,6,3,336215,336215,336218,0,3,2
95997,1,2,336216,336218,336220,2,4,0
95998,1,1,336217,336220,336221,3,4,0
95999,3,2,336220,336221,336223,1,3,0
96000,2,3,336222,336223,336226,1,4,0
96001,4,3,336226,336226,336229,0,3,0
96002,6,1,336232,336232,336233,0,1,3
96003,6,3,336238,336238,336241,0,3,5
96004,4,3,336242,336242,336245,0,3,1
96005,4,1,336246,336246,336247,0,1,1
96006,1,1,336247,336247,336248,0,1,0
96007,1,3,336248,336248,336251,0,3,0
96008,1,3,336249,336251,336254,2,5,0
96009,4,2,336253,336254,336256,1,3,0
96010,5,1,336258,336258,336259,0,1,2
96011,4,2,336262,336262,336264,0,2,3
96012,5,3,336267,336267,336270,0,3,3
96013,5,2,336272,336272,336274,0,2,2
96014,6,3,336278,336278,336281,0,3,4
96015,6,1,336284,336284,336285,0,1,3
96016,1,1,336285,336285,336286,0,1,0
96017,4,2,336289,336289,336291,0,2,3
96018,6,1,336295,336295,336296,0,1,4
96019,6,3,336301,336301,336304,0,3,5
96020,3,3,336304,336304,336307,0,3,0
96021,3,1,336307,336307,336308,0,1,0
96022,3,2,336310,336310,336312,0,2,2
96023,1,1,336311,336312,336313,1,2,0
96024,2,2,336313,336313,336315,0,2,0
96025,5,1,336318,336318,336319,0,1,3
96026,5,1,336323,336323,336324,0,1,4
96027,3,3,336326,336326,336329,0,3,2
96028,2,3,336328,336329,336332,1,4,0
96029,1,1,336329,336332,336333,3,4,0
96030,5,2,336334,336334,336336,0,2,1
96031,2,2,336336,336336,336338,0,2,0
96032,4,3,336340,336340,336343,0,3,2
96033,6,1,336346,336346,336347,0,1,3
96034,1,1,336347,336347,336348,0,1,0
96035,4,2,336351,336351,336353,0,2,3
96036,5,3,336356,336356,336359,0,3,3
96037,6,2,336362,336362,336364,0,2,3
96038,1,2,336363,336364,336366,1,3,0
96039,1,1,336364,336366,336367,2,3,0
96040,4,1,336368,336368,336369,0,1,1
96041,4,1,336372,336372,336373,0,1,3
96042,2,3,336374,336374,336377,0,3,1
96043,1,2,336375,336377,336379,2,4,0
96044,4,2,336379,336379,336381,0,2,0
96045,2,2,336381,336381,336383,0,2,0
96046,2,3,336383,336383,336386,0,3,0
96047,4,2,336387,336387,336389,0,2,1
96048,1,1,336388,336389,336390,1,2,0
96049,2,3,336390,336390,336393,0,3,0
96050,1,3,336391,336393,336396,2,5,0
96051,1,2,336392,336396,336398,4,6,0
96052,6,1,336398,336398,336399,0,1,0
96053,6,1,336404,336404,336405,0,1,5
96054,2,3,336406,336406,336409,0,3,1
96055,5,1,336411,336411,336412,0,1,2
96056,3,1,336414,336414,336415,0,1,2
96057,3,3,336417,336417,336420,0,3,2
96058,4,2,336421,336421,336423,0,2,1
96059,3,1,336424,336424,336425,0,1,1
96060,1,3,336425,336425,336428,0,3,0
96061,6,1,336431,336431,336432,0,1,3
96062,6,2,336437,336437,336439,0,2,5
96063,5,3,336442,336442,336445,0,3,3
96064,1,1,336443,336445,336446,2,3,0
96065,4,1,336447,336447,336448,0,1,1
96066,3,1,336450,336450,336451,0,1,2
96067,1,2,336451,336451,336453,0,2,0
96068,2,2,336453,336453,336455,0,2,0
96069,4,1,336457,336457,336458,0,1,2
96070,4,1,336461,336461,336462,0,1,3
96071,6,2,336467,336467,336469,0,2,5
96072,5,1,336472,336472,336473,0,1,3
96073,2,1,336474,336474,336475,0,1,1
96074,6,1,336480,336480,336481,0,1,5
96075,4,3,336484,336484,336487,0,3,3
96076,3,2,336487,336487,336489,0,2,0
96077,4,2,336491,336491,336493,0,2,2
96078,3,1,336494,336494,336495,0,1,1
96079,4,2,336498,336498,336500,0,2,3
96080,6,1,336504,336504,336505,0,1,4
96081,6,1,336510,336510,336511,0,1,5
96082,5,2,336515,336515,336517,0,2,4
96083,3,3,336518,336518,336521,0,3,1
96084,4,2,336522,336522,336524,0,2,1
96085,5,2,336527,336527,336529,0,2,3
96086,3,2,336530,336530,336532,0,2,1
96087,4,3,336534,336534,336537,0,3,2
96088,4,3,336538,336538,336541,0,3,1
96089,1,2,336539,336541,336543,2,4,0
96090,2,2,336541,336543,336545,2,4,0
96091,4,2,336545,336545,336547,0,2,0
96092,4,1,336549,336549,336550,0,1,2
96093,1,3,336550,336550,336553,0,3,0
96094,1,1,336551,336553,336554,2,3,0
96095,3,3,336554,336554,336557,0,3,0
96096,4,3,336558,336558,336561,0,3,1
96097,2,3,336560,336561,336564,1,4,0
96098,1,1,336561,336564,336565,3,4,0
96099,2,1,336563,336565,336566,2,3,0
96100,5,3,336568,336568,336571,0,3,2
96101,2,1,336570,336571,336572,1,2,0
96102,1,1,336571,336572,336573,1,2,0
96103,2,3,336573,336573,336576,0,3,0
96104,4,3,336577,336577,336580,0,3,1
96105,5,3,336582,336582,336585,0,3,2
96106,1,1,336583,336585,336586,2,3,0
96107,1,3,336584,336586,336589,2,5,0
96108,2,3,336586,336589,336592,3,6,0
96109,4,2,336590,336592,336594,2,4,0
96110,2,2,336592,336594,336596,2,4,0
96111,5,2,336597,336597,336599,0,2,1
96112,5,1,336602,336602,336603,0,1,3
96113,3,1,336605,336605,336606,0,1,2
96114,6,1,336611,336611,336612,0,1,5
96115,4,2,336615,336615,336617,0,2,3
96116,1,3,336616,336617,336620,1,4,0
96117,5,3,336621,336621,336624,0,3,1
96118,3,3,336624,336624,336627,0,3,0
96119,2,3,336626,336627,336630,1,4,0
96120,6,1,336632,336632,336633,0,1,2
96121,4,3,336636,336636,336639,0,3,3
96122,4,2,336640,336640,336642,0,2,1
96123,2,2,336642,336642,336644,0,2,0
96124,6,3,336648,336648,336651,0,3,4
96125,2,1,336650,336651,336652,1,2,0
96126,1,1,336651,336652,336653,1,2,0
96127,5,2,336656,336656,336658,0,2,3
96128,2,2,336658,336658,336660,0,2,0
96129,5,3,336663,336663,336666,0,3,3
96130,2,2,336665,336666,336668,1,3,0
96131,1,2,336666,336668,336670,2,4,0
96132,5,3,336671,336671,336674,0,3,1
96133,3,1,336674,336674,336675,0,1,0
96134,4,2,336678,336678,336680,0,2,3
96135,6,1,336684,336684,336685,0,1,4
96136,5,3,336689,336689,336692,0,3,4
96137,5,3,336694,336694,336697,0,3,2
96138,6,3,336700,336700,336703,0,3,3
96139,4,1,336704,336704,336705,0,1,1
96140,4,3,336708,336708,336711,0,3,3
96141,4,1,336712,336712,336713,0,1,1
96142,3,2,336715,336715,336717,0,2,2
96143,4,3,336719,336719,336722,0,3,2
96144,4,3,336723,336723,336726,0,3,1
96145,5,1,336728,336728,336729,0,1,2
96146,5,1,336733,336733,336734,0,1,4
96147,3,3,336736,336736,336739,0,3,2
96148,5,1,336741,336741,336742,0,1,2
96149,6,2,336747,336747,336749,0,2,5
96150,6,3,336753,336753,336756,0,3,4
96151,6,2,336759,336759,336761,0,2,3
96152,2,2,336761,336761,336763,0,2,0
96153,5,3,336766,336766,336769,0,3,3
96154,2,2,336768,336769,336771,1,3,0
96155,3,2,336771,336771,336773,0,2,0
96156,3,3,336774,336774,336777,0,3,1
96157,1,3,336775,336777,336780,2,5,0
96158,6,3,336781,336781,336784,0,3,1
96159,1,3,336782,336784,336787,2,5,0
96160,2,1,336784,336787,336788,3,4,0
96161,6,1,336790,336790,336791,0,1,2
96162,5,2,336795,336795,336797,0,2,4
96163,3,1,336798,336798,336799,0,1,1
96164,4,1,336802,336802,336803,0,1,3
96165,1,3,336803,336803,336806,0,3,0
96166,5,2,336808,336808,336810,0,2,2
96167,1,3,336809,336810,336813,1,4,0
96168,4,2,336813,336813,336815,0,2,0
96169,6,1,336819,336819,336820,0,1,4
96170,2,1,336821,336821,336822,0,1,1
96171,3,1,336824,336824,336825,0,1,2
96172,3,2,336827,336827,336829,0,2,2
96173,2,3,336829,336829,336832,0,3,0
96174,6,2,336835,336835,336837,0,2,3
96175,2,3,336837,336837,336840,0,3,0
96176,1,1,336838,336840,336841,2,3,0
96177,5,3,336843,336843,336846,0,3,2
96178,4,1,336847,336847,336848,0,1,1
96179,6,1,336853,336853,336854,0,1,5
96180,1,2,336854,336854,336856,0,2,0
96181,2,1,336856,336856,336857,0,1,0
96182,6,3,336862,336862,336865,0,3,5
96183,3,1,336865,336865,336866,0,1,0
96184,2,3,336867,336867,336870,0,3,1
96185,4,2,336871,336871,336873,0,2,1
96186,3,1,336874,336874,336875,0,1,1
96187,4,3,336878,336878,336881,0,3,3
96188,4,3,336882,336882,336885,0,3,1
96189,3,2,336885,336885,336887,0,2,0
96190,4,2,336889,336889,336891,0,2,2
96191,4,2,336893,336893,336895,0,2,2
96192,3,3,336896,336896,336899,0,3,1
96193,4,3,336900,336900,336903,0,3,1
96194,4,2,336904,336904,336906,0,2,1
96195,2,2,336906,336906,336908,0,2,0
96196,1,2,336907,336908,336910,1,3,0
96197,3,1,336910,336910,336911,0,1,0
96198,1,3,336911,336911,336914,0,3,0
96199,3,2,336914,336914,336916,0,2,0
96200,3,2,336917,336917,336919,0,2,1
96201,4,1,336921,336921,336922,0,1,2
96202,4,3,336925,336925,336928,0,3,3
96203,4,1,336929,336929,336930,0,1,1
96204,4,1,336933,336933,336934,0,1,3
96205,5,3,336938,336938,336941,0,3,4
96206,1,3,336939,336941,336944,2,5,0
96207,2,1,336941,336944,336945,3,4,0
96208,1,3,336942,336945,336948,3,6,0
96209,1,1,336943,336948,336949,5,6,0
96210,5,2,336948,336949,336951,1,3,0
96211,6,2,336954,336954,336956,0,2,3
96212,6,1,336960,336960,336961,0,1,4
96213,4,1,336964,336964,336965,0,1,3
96214,5,1,336969,336969,336970,0,1,4
96215,4,2,336973,336973,336975,0,2,3
96216,5,3,336978,336978,336981,0,3,3
96217,5,1,336983,336983,336984,0,1,2
96218,6,2,336989,336989,336991,0,2,5
96219,2,1,336991,336991,336992,0,1,0
96220,1,2,336992,336992,336994,0,2,0
96221,2,1,336994,336994,336995,0,1,0
96222,5,2,336999,336999,337001,0,2,4
96223,6,2,337005,337005,337007,0,2,4
96224,5,2,337010,337010,337012,0,2,3
96225,1,1,337011,337012,337013,1,2,0
96226,4,1,337015,337015,337016,0,1,2
96227,6,2,337021,337021,337023,0,2,5
96228,4,1,337025,337025,337026,0,1,2
96229,5,3,337030,337030,337033,0,3,4
96230,2,1,337032,337033,337034,1,2,0
96231,1,3,337033,337034,337037,1,4,0
96232,1,2,337034,337037,337039,3,5,0
96233,2,1,337036,337039,337040,3,4,0
96234,2,1,337038,337040,337041,2,3,0
96235,6,1,337044,337044,337045,0,1,3
96236,3,2,337047,337047,337049,0,2,2
96237,4,2,337051,337051,337053,0,2,2
96238,3,1,337054,337054,337055,0,1,1
96239,5,3,337059,337059,337062,0,3,4
96240,2,1,337061,337062,337063,1,2,0
96241,5,3,337066,337066,337069,0,3,3
96242,1,3,337067,337069,337072,2,5,0
96243,5,1,337072,337072,337073,0,1,0
96244,4,3,337076,337076,337079,0,3,3
96245,1,1,337077,337079,337080,2,3,0
96246,4,3,337081,337081,337084,0,3,1
96247,3,1,337084,337084,337085,0,1,0
96248,6,2,337090,337090,337092,0,2,5
96249,4,2,337094,337094,337096,0,2,2
96250,6,1,337100,337100,337101,0,1,4
96251,4,1,337104,337104,337105,0,1,3
96252,3,2,337107,337107,337109,0,2,2
96253,6,1,337113,337113,337114,0,1,4
96254,5,3,337118,337118,337121,0,3,4
96255,1,1,337119,337121,337122,2,3,0
96256,2,2,337121,337122,337124,1,3,0
96257,6,3,337127,337127,337130,0,3,3
96258,2,1,337129,337130,337131,1,2,0
96259,6,2,337135,337135,337137,0,2,4
96260,5,2,337140,337140,337142,0,2,3
96261,1,2,337141,337142,337144,1,3,0
96262,2,2,337143,337144,337146,1,3,0
96263,1,3,337144,337146,337149,2,5,0
96264,1,3,337145,337149,337152,4,7,0
96265,4,1,337149,337152,337153,3,4,0
96266,2,2,337151,337153,337155,2,4,0
96267,2,2,337153,337155,337157,2,4,0
96268,6,3,337159,337159,337162,0,3,2
96269,6,1,337165,337165,337166,0,1,3
96270,3,1,337168,337168,337169,0,1,2
96271,2,2,337170,337170,337172,0,2,1
96272,5,1,337175,337175,337176,0,1,3
96273,1,2,337176,337176,337178,0,2,0
96274,2,2,337178,337178,337180,0,2,0
96275,1,1,337179,337180,337181,1,2,0
96276,6,2,337185,337185,337187,0,2,4
96277,4,2,337189,337189,337191,0,2,2
96278,6,2,337195,337195,337197,0,2,4
96279,5,1,337200,337200,337201,0,1,3
96280,2,3,337202,337202,337205,0,3,1
96281,3,3,337205,337205,337208,0,3,0
96282,2,3,337207,337208,337211,1,4,0
96283,3,2,337210,337211,337213,1,3,0
96284,1,1,337211,337213,337214,2,3,0
96285,4,1,337215,337215,337216,0,1,1
96286,6,1,337221,337221,337222,0,1,5
96287,4,3,337225,337225,337228,0,3,3
96288,3,3,337228,337228,337231,0,3,0
96289,6,3,337234,337234,337237,0,3,3
96290,3,3,337237,337237,337240,0,3,0
96291,5,2,337242,337242,337244,0,2,2
96292,5,1,337247,337247,337248,0,1,3
96293,6,3,337253,337253,337256,0,3,5
96294,3,2,337256,337256,337258,0,2,0
96295,3,1,337259,337259,337260,0,1,1
96296,6,1,337265,337265,337266,0,1,5
96297,1,3,337266,337266,337269,0,3,0
96298,3,2,337269,337269,337271,0,2,0
96299,2,3,337271,337271,337274,0,3,0
96300,6,3,337277,337277,337280,0,3,3
96301,5,1,337282,337282,337283,0,1,2
96302,4,2,337286,337286,337288,0,2,3
96303,3,2,337289,337289,337291,0,2,1
96304,5,1,337294,337294,337295,0,1,3
96305,5,1,337299,337299,337300,0,1,4
96306,1,2,337300,337300,337302,0,2,0
96307,1,3,337301,337302,337305,1,4,0
96308,4,2,337305,337305,337307,0,2,0
96309,2,1,337307,337307,337308,0,1,0
96310,3,1,337310,337310,337311,0,1,2
96311,2,3,337312,337312,337315,0,3,1
96312,4,2,337316,337316,337318,0,2,1
96313,3,3,337319,337319,337322,0,3,1
96314,1,2,337320,337322,337324,2,4,0
96315,5,3,337325,337325,337328,0,3,1
96316,3,2,337328,337328,337330,0,2,0
96317,4,2,337332,337332,337334,0,2,2
96318,4,2,337336,337336,337338,0,2,2
96319,2,3,337338,337338,337341,0,3,0
96320,6,1,337344,337344,337345,0,1,3
96321,6,2,337350,337350,337352,0,2,5
96322,5,2,337355,337355,337357,0,2,3
96323,1,2,337356,337357,337359,1,3,0
96324,1,2,337357,337359,337361,2,4,0
96325,1,2,337358,337361,337363,3,5,0
96326,1,2,337359,337363,337365,4,6,0
96327,2,3,337361,337365,337368,4,7,0
96328,3,3,337364,337368,337371,4,7,0
96329,1,3,337365,337371,337374,6,9,0
96330,5,2,337370,337374,337376,4,6,0
96331,4,1,337374,337376,337377,2,3,0
96332,6,2,337380,337380,337382,0,2,3
96333,1,2,337381,337382,337384,1,3,0
96334,5,1,337386,337386,337387,0,1,2
96335,4,1,337390,337390,337391,0,1,3
96336,4,2,337394,337394,337396,0,2,3
96337,1,2,337395,337396,337398,1,3,0
96338,3,2,337398,337398,337400,0,2,0
96339,2,1,337400,337400,337401,0,1,0
96340,1,3,337401,337401,337404,0,3,0
96341,2,1,337403,337404,337405,1,2,0
96342,4,3,337407,337407,337410,0,3,2
96343,5,3,337412,337412,337415,0,3,2
96344,3,3,337415,337415,337418,0,3,0
96345,1,2,337416,337418,337420,2,4,0
96346,3,3,337419,337420,337423,1,4,0
96347,6,3,337425,337425,337428,0,3,2
96348,5,3,337430,337430,337433,0,3,2
96349,3,1,337433,337433,337434,0,1,0
96350,3,2,337436,337436,337438,0,2,2
96351,4,3,337440,337440,337443,0,3,2
96352,2,1,337442,337443,337444,1,2,0
96353,5,3,337447,337447,337450,0,3,3
96354,1,2,337448,337450,337452,2,4,0
96355,2,2,337450,337452,337454,2,4,0
96356,2,3,337452,337454,337457,2,5,0
96357,2,1,337454,337457,337458,3,4,0
96358,3,2,337457,337458,337460,1,3,0
96359,1,2,337458,337460,337462,2,4,0
96360,3,3,337461,337462,337465,1,4,0
96361,3,2,337464,337465,337467,1,3,0
96362,3,1,337467,337467,337468,0,1,0
96363,6,2,337473,337473,337475,0,2,5
96364,2,1,337475,337475,337476,0,1,0
96365,3,1,337478,337478,337479,0,1,2
96366,3,1,337481,337481,337482,0,1,2
96367,2,3,337483,337483,337486,0,3,1
96368,5,1,337488,337488,337489,0,1,2
96369,6,3,337494,337494,337497,0,3,5
96370,2,2,337496,337497,337499,1,3,0
96371,2,3,337498,337499,337502,1,4,0
96372,1,2,337499,337502,337504,3,5,0
96373,1,2,337500,337504,337506,4,6,0
96374,4,1,337504,337506,337507,2,3,0
96375,2,3,337506,337507,337510,1,4,0
96376,2,1,337508,337510,337511,2,3,0
96377,4,1,337512,337512,337513,0,1,1
96378,6,1,337518,337518,337519,0,1,5
96379,4,3,337522,337522,337525,0,3,3
96380,3,2,337525,337525,337527,0,2,0
96381,2,3,337527,337527,337530,0,3,0
96382,3,1,337530,337530,337531,0,1,0
96383,2,2,337532,337532,337534,0,2,1
96384,5,1,337537,337537,337538,0,1,3
96385,1,2,337538,337538,337540,0,2,0
96386,1,2,337539,337540,337542,1,3,0
96387,2,1,337541,337542,337543,1,2,0
96388,2,2,337543,337543,337545,0,2,0
96389,5,1,337548,337548,337549,0,1,3
96390,3,1,337551,337551,337552,0,1,2
96391,1,1,337552,337552,337553,0,1,0
96392,5,3,337557,337557,337560,0,3,4
96393,6,1,337563,337563,337564,0,1,3
96394,2,1,337565,337565,337566,0,1,1
96395,4,3,337569,337569,337572,0,3,3
96396,4,2,337573,337573,337575,0,2,1
96397,1,1,337574,337575,337576,1,2,0
96398,6,3,337580,337580,337583,0,3,4
96399,2,2,337582,337583,337585,1,3,0
96400,1,2,337583,337585,337587,2,4,0
96401,2,1,337585,337587,337588,2,3,0
96402,4,1,337589,337589,337590,0,1,1
96403,1,1,337590,337590,337591,0,1,0
96404,4,2,337594,337594,337596,0,2,3
96405,6,1,337600,337600,337601,0,1,4
96406,2,3,337602,337602,337605,0,3,1
96407,3,3,337605,337605,337608,0,3,0
96408,5,1,337610,337610,337611,0,1,2
96409,4,3,337614,337614,337617,0,3,3
96410,6,2,337620,337620,337622,0,2,3
96411,5,3,337625,337625,337628,0,3,3
96412,1,1,337626,337628,337629,2,3,0
96413,6,2,337632,337632,337634,0,2,3
96414,3,3,337635,337635,337638,0,3,1
96415,2,2,337637,337638,337640,1,3,0
96416,1,1,337638,337640,337641,2,3,0
96417,4,1,337642,337642,337643,0,1,1
96418,5,2,337647,337647,337649,0,2,4
96419,1,2,337648,337649,337651,1,3,0
96420,4,3,337652,337652,337655,0,3,1
96421,4,2,337656,337656,337658,0,2,1
96422,6,1,337662,337662,337663,0,1,4
96423,6,2,337668,337668,337670,0,2,5
96424,2,3,337670,337670,337673,0,3,0
96425,3,3,337673,337673,337676,0,3,0
96426,6,2,337679,337679,337681,0,2,3
96427,1,2,337680,337681,337683,1,3,0
96428,1,2,337681,337683,337685,2,4,0
96429,3,1,337684,337685,337686,1,2,0
96430,2,3,337686,337686,337689,0,3,0
96431,4,2,337690,337690,337692,0,2,1
96432,3,1,337693,337693,337694,0,1,1
96433,2,1,337695,337695,337696,0,1,1
96434,2,2,337697,337697,337699,0,2,1
96435,1,2,337698,337699,337701,1,3,0
96436,5,2,337703,337703,337705,0,2,2
96437,1,3,337704,337705,337708,1,4,0
96438,6,3,337710,337710,337713,0,3,2
96439,6,3,337716,337716,337719,0,3,3
96440,5,2,337721,337721,337723,0,2,2
96441,1,3,337722,337723,337726,1,4,0
96442,4,2,337726,337726,337728,0,2,0
96443,4,2,337730,337730,337732,0,2,2
96444,2,3,337732,337732,337735,0,3,0
96445,5,2,337737,337737,337739,0,2,2
96446,2,3,337739,337739,337742,0,3,0
96447,2,1,337741,337742,337743,1,2,0
96448,6,2,337747,337747,337749,0,2,4
96449,2,1,337749,337749,337750,0,1,0
96450,3,2,337752,337752,337754,0,2,2
96451,5,1,337757,337757,337758,0,1,3
96452,4,1,337761,337761,337762,0,1,3
96453,1,2,337762,337762,337764,0,2,0
96454,2,2,337764,337764,337766,0,2,0
96455,1,3,337765,337766,337769,1,4,0
96456,6,1,337771,337771,337772,0,1,2
96457,1,2,337772,337772,337774,0,2,0
96458,5,1,337777,337777,337778,0,1,3
96459,6,2,337783,337783,337785,0,2,5
96460,4,2,337787,337787,337789,0,2,2
96461,5,3,337792,337792,337795,0,3,3
96462,6,3,337798,337798,337801,0,3,3
96463,1,2,337799,337801,337803,2,4,0
96464,5,1,337804,337804,337805,0,1,1
96465,5,2,337809,337809,337811,0,2,4
96466,6,1,337815,337815,337816,0,1,4
96467,3,2,337818,337818,337820,0,2,2
96468,1,2,337819,337820,337822,1,3,0
96469,4,1,337823,337823,337824,0,1,1
96470,3,1,337826,337826,337827,0,1,2
96471,6,2,337832,337832,337834,0,2,5
96472,1,1,337833,337834,337835,1,2,0
96473,3,2,337836,337836,337838,0,2,1
96474,2,1,337838,337838,337839,0,1,0
96475,6,2,337844,337844,337846,0,2,5
96476,4,2,337848,337848,337850,0,2,2
96477,2,2,337850,337850,337852,0,2,0
96478,3,1,337853,337853,337854,0,1,1
96479,2,2,337855,337855,337857,0,2,1
96480,3,1,337858,337858,337859,0,1,1
96481,2,1,337860,337860,337861,0,1,1
96482,3,1,337863,337863,337864,0,1,2
96483,2,2,337865,337865,337867,0,2,1
96484,2,3,337867,337867,337870,0,3,0
96485,4,1,337871,337871,337872,0,1,1
96486,6,3,337877,337877,337880,0,3,5
96487,6,3,337883,337883,337886,0,3,3
96488,5,1,337888,337888,337889,0,1,2
96489,4,1,337892,337892,337893,0,1,3
96490,2,1,337894,337894,337895,0,1,1
96491,6,1,337900,337900,337901,0,1,5
96492,5,3,337905,337905,337908,0,3,4
96493,6,2,337911,337911,337913,0,2,3
96494,1,1,337912,337913,337914,1,2,0
96495,4,1,337916,337916,337917,0,1,2
96496,2,2,337918,337918,337920,0,2,1
96497,3,1,337921,337921,337922,0,1,1
96498,3,3,337924,337924,337927,0,3,2
96499,4,1,337928,337928,337929,0,1,1
96500,4,1,337932,337932,337933,0,1,3
96501,4,2,337936,337936,337938,0,2,3
96502,4,1,337940,337940,337941,0,1,2
96503,3,3,337943,337943,337946,0,3,2
96504,5,1,337948,337948,337949,0,1,2
96505,2,1,337950,337950,337951,0,1,1
96506,5,1,337955,337955,337956,0,1,4
96507,1,1,337956,337956,337957,0,1,0
96508,3,1,337959,337959,337960,0,1,2
96509,1,1,337960,337960,337961,0,1,0
96510,2,3,337962,337962,337965,0,3,1
96511,4,1,337966,337966,337967,0,1,1
96512,5,3,337971,337971,337974,0,3,4
96513,1,3,337972,337974,337977,2,5,0
96514,3,1,337975,337977,337978,2,3,0
96515,3,2,337978,337978,337980,0,2,0
96516,4,3,337982,337982,337985,0,3,2
96517,2,2,337984,337985,337987,1,3,0
96518,3,2,337987,337987,337989,0,2,0
96519,4,1,337991,337991,337992,0,1,2
96520,2,1,337993,337993,337994,0,1,1
96521,3,2,337996,337996,337998,0,2,2
96522,2,2,337998,337998,338000,0,2,0
96523,6,2,338004,338004,338006,0,2,4
96524,6,3,338010,338010,338013,0,3,4
96525,3,3,338013,338013,338016,0,3,0
96526,1,3,338014,338016,338019,2,5,0
96527,3,2,338017,338019,338021,2,4,0
96528,1,1,338018,338021,338022,3,4,0
96529,4,2,338022,338022,338024,0,2,0
96530,1,1,338023,338024,338025,1,2,0
96531,6,2,338029,338029,338031,0,2,4
96532,1,3,338030,338031,338034,1,4,0
96533,4,1,338034,338034,338035,0,1,0
96534,4,1,338038,338038,338039,0,1,3
96535,1,1,338039,338039,338040,0,1,0
96536,1,2,338040,338040,338042,0,2,0
96537,5,3,338045,338045,338048,0,3,3
96538,4,2,338049,338049,338051,0,2,1
96539,2,2,338051,338051,338053,0,2,0
96540,4,2,338055,338055,338057,0,2,2
96541,6,2,338061,338061,338063,0,2,4
96542,3,1,338064,338064,338065,0,1,1
96543,1,1,338065,338065,338066,0,1,0
96544,6,2,338071,338071,338073,0,2,5
96545,3,3,338074,338074,338077,0,3,1
96546,6,1,338080,338080,338081,0,1,3
96547,5,1,338085,338085,338086,0,1,4
96548,1,1,338086,338086,338087,0,1,0
96549,4,3,338090,338090,338093,0,3,3
96550,6,1,338096,338096,338097,0,1,3
96551,2,1,338098,338098,338099,0,1,1
96552,5,1,338103,338103,338104,0,1,4
96553,3,3,338106,338106,338109,0,3,2
96554,4,1,338110,338110,338111,0,1,1
96555,5,3,338115,338115,338118,0,3,4
96556,3,1,338118,338118,338119,0,1,0
96557,3,2,338121,338121,338123,0,2,2
96558,2,2,338123,338123,338125,0,2,0
96559,5,3,338128,338128,338131,0,3,3
96560,3,1,338131,338131,338132,0,1,0
96561,5,2,338136,338136,338138,0,2,4
96562,3,2,338139,338139,338141,0,2,1
96563,4,3,338143,338143,338146,0,3,2
96564,4,1,338147,338147,338148,0,1,1
96565,1,3,338148,338148,338151,0,3,0
96566,5,2,338153,338153,338155,0,2,2
96567,2,2,338155,338155,338157,0,2,0
96568,6,1,338161,338161,338162,0,1,4
96569,4,3,338165,338165,338168,0,3,3
96570,6,2,338171,338171,338173,0,2,3
96571,5,1,338176,338176,338177,0,1,3
96572,1,2,338177,338177,338179,0,2,0
96573,4,2,338181,338181,338183,0,2,2
96574,4,2,338185,338185,338187,0,2,2
96575,6,2,338191,338191,338193,0,2,4
96576,6,3,338197,338197,338200,0,3,4
96577,1,3,338198,338200,338203,2,5,0
96578,5,3,338203,338203,338206,0,3,0
96579,4,3,338207,338207,338210,0,3,1
96580,3,3,338210,338210,338213,0,3,0
96581,4,1,338214,338214,338215,0,1,1
96582,2,1,338216,338216,338217,0,1,1
96583,3,1,338219,338219,338220,0,1,2
96584,6,1,338225,338225,338226,0,1,5
96585,1,2,338226,338226,338228,0,2,0
96586,6,2,338232,338232,338234,0,2,4
96587,1,3,338233,338234,338237,1,4,0
96588,2,2,338235,338237,338239,2,4,0
96589,2,1,338237,338239,338240,2,3,0
96590,6,1,338243,338243,338244,0,1,3
96591,2,1,338245,338245,338246,0,1,1
96592,4,3,338249,338249,338252,0,3,3
96593,5,2,338254,338254,338256,0,2,2
96594,3,1,338257,338257,338258,0,1,1
96595,1,2,338258,338258,338260,0,2,0
96596,4,1,338262,338262,338263,0,1,2
96597,4,3,338266,338266,338269,0,3,3
96598,2,3,338268,338269,338272,1,4,0
96599,5,1,338273,338273,338274,0,1,1
96600,4,3,338277,338277,338280,0,3,3
96601,4,3,338281,338281,338284,0,3,1
96602,2,2,338283,338284,338286,1,3,0
96603,6,2,338289,338289,338291,0,2,3
96604,4,1,338293,338293,338294,0,1,2
96605,1,1,338294,338294,338295,0,1,0
96606,3,1,338297,338297,338298,0,1,2
96607,2,2,338299,338299,338301,0,2,1
96608,6,3,338305,338305,338308,0,3,4
96609,3,3,338308,338308,338311,0,3,0
96610,2,2,338310,338311,338313,1,3,0
96611,4,1,338314,338314,338315,0,1,1
96612,5,1,338319,338319,338320,0,1,4
96613,5,1,338324,338324,338325,0,1,4
96614,1,2,338325,338325,338327,0,2,0
96615,6,2,338331,338331,338333,0,2,4
96616,4,3,338335,338335,338338,0,3,2
96617,6,3,338341,338341,338344,0,3,3
96618,2,1,338343,338344,338345,1,2,0
96619,4,2,338347,338347,338349,0,2,2
96620,1,2,338348,338349,338351,1,3,0
96621,6,2,338354,338354,338356,0,2,3
96622,3,3,338357,338357,338360,0,3,1
96623,5,3,338362,338362,338365,0,3,2
96624,3,3,338365,338365,338368,0,3,0
96625,4,1,338369,338369,338370,0,1,1
96626,6,3,338375,338375,338378,0,3,5
96627,2,3,338377,338378,338381,1,4,0
96628,4,3,338381,338381,338384,0,3,0
96629,6,2,338387,338387,338389,0,2,3
96630,4,3,338391,338391,338394,0,3,2
96631,2,1,338393,338394,338395,1,2,0
96632,5,1,338398,338398,338399,0,1,3
96633,1,1,338399,338399,338400,0,1,0
96634,6,2,338405,338405,338407,0,2,5
96635,2,3,338407,338407,338410,0,3,0
96636,3,3,338410,338410,338413,0,3,0
96637,1,2,338411,338413,338415,2,4,0
96638,4,3,338415,338415,338418,0,3,0
96639,4,1,338419,338419,338420,0,1,1
96640,3,2,338422,338422,338424,0,2,2
96641,1,3,338423,338424,338427,1,4,0
96642,5,2,338428,338428,338430,0,2,1
96643,2,3,338430,338430,338433,0,3,0
96644,2,1,338432,338433,338434,1,2,0
96645,4,2,338436,338436,338438,0,2,2
96646,5,1,338441,338441,338442,0,1,3
96647,3,3,338444,338444,338447,0,3,2
96648,1,1,338445,338447,338448,2,3,0
96649,3,1,338448,338448,338449,0,1,0
96650,4,3,338452,338452,338455,0,3,3
96651,5,2,338457,338457,338459,0,2,2
96652,6,3,338463,338463,338466,0,3,4
96653,1,2,338464,338466,338468,2,4,0
96654,3,2,338467,338468,338470,1,3,0
96655,6,2,338473,338473,338475,0,2,3
96656,4,3,338477,338477,338480,0,3,2
96657,2,2,338479,338480,338482,1,3,0
96658,5,3,338484,338484,338487,0,3,2
96659,6,3,338490,338490,338493,0,3,3
96660,5,2,338495,338495,338497,0,2,2
96661,3,3,338498,338498,338501,0,3,1
96662,5,2,338503,338503,338505,0,2,2
96663,3,2,338506,338506,338508,0,2,1
96664,4,2,338510,338510,338512,0,2,2
96665,5,1,338515,338515,338516,0,1,3
96666,6,3,338521,338521,338524,0,3,5
96667,2,3,338523,338524,338527,1,4,0
96668,4,3,338527,338527,338530,0,3,0
96669,4,1,338531,338531,338532,0,1,1
96670,5,1,338536,338536,338537,0,1,4
96671,2,3,338538,338538,338541,0,3,1
96672,4,2,338542,338542,338544,0,2,1
96673,1,1,338543,338544,338545,1,2,0
96674,4,3,338547,338547,338550,0,3,2
96675,3,3,338550,338550,338553,0,3,0
96676,6,3,338556,338556,338559,0,3,3
96677,3,3,338559,338559,338562,0,3,0
96678,3,2,338562,338562,338564,0,2,0
96679,1,1,338563,338564,338565,1,2,0
96680,2,2,338565,338565,338567,0,2,0
96681,3,2,338568,338568,338570,0,2,1
96682,2,3,338570,338570,338573,0,3,0
96683,2,2,338572,338573,338575,1,3,0
96684,3,1,338575,338575,338576,0,1,0
96685,1,2,338576,338576,338578,0,2,0
96686,1,3,338577,338578,338581,1,4,0
96687,6,1,338583,338583,338584,0,1,2
96688,2,3,338585,338585,338588,0,3,1
96689,3,1,338588,338588,338589,0,1,0
96690,5,2,338593,338593,338595,0,2,4
96691,3,1,338596,338596,338597,0,1,1
96692,3,2,338599,338599,338601,0,2,2
96693,2,1,338601,338601,338602,0,1,0
96694,2,1,338603,338603,338604,0,1,1
96695,5,2,338608,338608,338610,0,2,4
96696,3,1,338611,338611,338612,0,1,1
96697,4,3,338615,338615,338618,0,3,3
96698,3,1,338618,338618,338619,0,1,0
96699,5,1,338623,338623,338624,0,1,4
96700,5,3,338628,338628,338631,0,3,4
96701,3,1,338631,338631,338632,0,1,0
96702,4,3,338635,338635,338638,0,3,3
96703,3,1,338638,338638,338639,0,1,0
96704,2,2,338640,338640,338642,0,2,1
96705,1,2,338641,338642,338644,1,3,0
96706,6,2,338647,338647,338649,0,2,3
96707,3,1,338650,338650,338651,0,1,1
96708,4,1,338654,338654,338655,0,1,3
96709,6,2,338660,338660,338662,0,2,5
96710,2,3,338662,338662,338665,0,3,0
96711,6,3,338668,338668,338671,0,3,3
96712,1,2,338669,338671,338673,2,4,0
96713,2,1,338671,338673,338674,2,3,0
96714,2,1,338673,338674,338675,1,2,0
96715,1,2,338674,338675,338677,1,3,0
96716,3,1,338677,338677,338678,0,1,0
96717,3,2,338680,338680,338682,0,2,2
96718,1,2,338681,338682,338684,1,3,0
96719,1,3,338682,338684,338687,2,5,0
96720,4,2,338686,338687,338689,1,3,0
96721,1,3,338687,338689,338692,2,5,0
96722,6,1,338693,338693,338694,0,1,1
96723,5,2,338698,338698,338700,0,2,4
96724,1,1,338699,338700,338701,1,2,0
96725,1,2,338700,338701,338703,1,3,0
96726,1,1,338701,338703,338704,2,3,0
96727,2,2,338703,338704,338706,1,3,0
96728,5,2,338708,338708,338710,0,2,2
96729,3,2,338711,338711,338713,0,2,1
96730,2,2,338713,338713,338715,0,2,0
96731,3,1,338716,338716,338717,0,1,1
96732,4,3,338720,338720,338723,0,3,3
96733,2,1,338722,338723,338724,1,2,0
96734,2,3,338724,338724,338727,0,3,0
96735,6,2,338730,338730,338732,0,2,3
96736,3,2,338733,338733,338735,0,2,1
96737,4,1,338737,338737,338738,0,1,2
96738,1,3,338738,338738,338741,0,3,0
96739,6,2,338744,338744,338746,0,2,3
96740,1,2,338745,338746,338748,1,3,0
96741,5,2,338750,338750,338752,0,2,2
96742,4,3,338754,338754,338757,0,3,2
96743,2,3,338756,338757,338760,1,4,0
96744,1,1,338757,338760,338761,3,4,0
96745,3,1,338760,338761,338762,1,2,0
96746,6,2,338766,338766,338768,0,2,4
96747,6,2,338772,338772,338774,0,2,4
96748,3,1,338775,338775,338776,0,1,1
96749,2,3,338777,338777,338780,0,3,1
96750,6,2,338783,338783,338785,0,2,3
96751,2,2,338785,338785,338787,0,2,0
96752,3,1,338788,338788,338789,0,1,1
96753,1,1,338789,338789,338790,0,1,0
96754,1,2,338790,338790,338792,0,2,0
96755,5,1,338795,338795,338796,0,1,3
96756,5,1,338800,338800,338801,0,1,4
96757,2,1,338802,338802,338803,0,1,1
96758,3,2,338805,338805,338807,0,2,2
96759,1,1,338806,338807,338808,1,2,0
96760,5,1,338811,338811,338812,0,1,3
96761,1,3,338812,338812,338815,0,3,0
96762,6,3,338818,338818,338821,0,3,3
96763,5,1,338823,338823,338824,0,1,2
96764,1,1,338824,338824,338825,0,1,0
96765,3,3,338827,338827,338830,0,3,2
96766,3,3,338830,338830,338833,0,3,0
96767,2,3,338832,338833,338836,1,4,0
96768,5,3,338837,338837,338840,0,3,1
96769,5,1,338842,338842,338843,0,1,2
96770,2,1,338844,338844,338845,0,1,1
96771,5,2,338849,338849,338851,0,2,4
96772,6,3,338855,338855,338858,0,3,4
96773,5,2,338860,338860,338862,0,2,2
96774,5,3,338865,338865,338868,0,3,3
96775,1,1,338866,338868,338869,2,3,0
96776,6,1,338872,338872,338873,0,1,3
96777,1,3,338873,338873,338876,0,3,0
96778,4,3,338877,338877,338880,0,3,1
96779,6,1,338883,338883,338884,0,1,3
96780,4,1,338887,338887,338888,0,1,3
96781,3,1,338890,338890,338891,0,1,2
96782,4,3,338894,338894,338897,0,3,3
96783,1,2,338895,338897,338899,2,4,0
96784,5,3,338900,338900,338903,0,3,1
96785,2,1,338902,338903,338904,1,2,0
96786,6,3,338908,338908,338911,0,3,4
96787,6,2,338914,338914,338916,0,2,3
96788,3,3,338917,338917,338920,0,3,1
96789,4,2,338921,338921,338923,0,2,1
96790,3,3,338924,338924,338927,0,3,1
96791,5,3,338929,338929,338932,0,3,2
96792,2,2,338931,338932,338934,1,3,0
96793,2,3,338933,338934,338937,1,4,0
96794,2,2,338935,338937,338939,2,4,0
96795,4,2,338939,338939,338941,0,2,0
96796,5,2,338944,338944,338946,0,2,3
96797,5,2,338949,338949,338951,0,2,3
96798,1,3,338950,338951,338954,1,4,0
96799,2,2,338952,338954,338956,2,4,0
96800,4,3,338956,338956,338959,0,3,0
96801,4,3,338960,338960,338963,0,3,1
96802,2,1,338962,338963,338964,1,2,0
96803,3,2,338965,338965,338967,0,2,1
96804,3,3,338968,338968,338971,0,3,1
96805,4,1,338972,338972,338973,0,1,1
96806,4,2,338976,338976,338978,0,2,3
96807,4,1,338980,338980,338981,0,1,2
96808,3,2,338983,338983,338985,0,2,2
96809,6,1,338989,338989,338990,0,1,4
96810,3,1,338992,338992,338993,0,1,2
96811,6,1,338998,338998,338999,0,1,5
96812,4,2,339002,339002,339004,0,2,3
96813,3,3,339005,339005,339008,0,3,1
96814,2,3,339007,339008,339011,1,4,0
96815,1,1,339008,339011,339012,3,4,0
96816,6,1,339014,339014,339015,0,1,2
96817,5,1,339019,339019,339020,0,1,4
96818,1,1,339020,339020,339021,0,1,0
96819,5,3,339025,339025,339028,0,3,4
96820,1,3,339026,339028,339031,2,5,0
96821,2,3,339028,339031,339034,3,6,0
96822,5,1,339033,339034,339035,1,2,0
96823,6,1,339039,339039,339040,0,1,4
96824,4,1,339043,339043,339044,0,1,3
96825,4,2,339047,339047,339049,0,2,3
96826,5,3,339052,339052,339055,0,3,3
96827,6,3,339058,339058,339061,0,3,3
96828,1,3,339059,339061,339064,2,5,0
96829,3,1,339062,339064,339065,2,3,0
96830,4,2,339066,339066,339068,0,2,1
96831,3,3,339069,339069,339072,0,3,1
96832,4,2,339073,339073,339075,0,2,1
96833,1,2,339074,339075,339077,1,3,0
96834,1,2,339075,339077,339079,2,4,0
96835,5,3,339080,339080,339083,0,3,1
96836,2,3,339082,339083,339086,1,4,0
96837,1,1,339083,339086,339087,3,4,0
96838,2,1,339085,339087,339088,2,3,0
96839,2,3,339087,339088,339091,1,4,0
96840,1,1,339088,339091,339092,3,4,0
96841,4,1,339092,339092,339093,0,1,0
96842,5,3,339097,339097,339100,0,3,4
96843,1,1,339098,339100,339101,2,3,0
96844,6,1,339104,339104,339105,0,1,3
96845,3,1,339107,339107,339108,0,1,2
96846,3,3,339110,339110,339113,0,3,2
96847,1,1,339111,339113,339114,2,3,0
96848,5,3,339116,339116,339119,0,3,2
96849,4,1,339120,339120,339121,0,1,1
96850,1,1,339121,339121,339122,0,1,0
96851,1,3,339122,339122,339125,0,3,0
96852,4,2,339126,339126,339128,0,2,1
96853,1,2,339127,339128,339130,1,3,0
96854,4,1,339131,339131,339132,0,1,1
96855,5,1,339136,339136,339137,0,1,4
96856,5,1,339141,339141,339142,0,1,4
96857,1,3,339142,339142,339145,0,3,0
96858,5,3,339147,339147,339150,0,3,2
96859,3,2,339150,339150,339152,0,2,0
96860,5,3,339155,339155,339158,0,3,3
96861,4,2,339159,339159,339161,0,2,1
96862,3,3,339162,339162,339165,0,3,1
96863,5,1,339167,339167,339168,0,1,2
96864,1,3,339168,339168,339171,0,3,0
96865,1,2,339169,339171,339173,2,4,0
96866,2,1,339171,339173,339174,2,3,0
96867,5,3,339176,339176,339179,0,3,2
96868,4,3,339180,339180,339183,0,3,1
96869,3,3,339183,339183,339186,0,3,0
96870,4,3,339187,339187,339190,0,3,1
96871,2,1,339189,339190,339191,1,2,0
96872,6,3,339195,339195,339198,0,3,4
96873,4,1,339199,339199,339200,0,1,1
96874,4,2,339203,339203,339205,0,2,3
96875,5,3,339208,339208,339211,0,3,3
96876,3,3,339211,339211,339214,0,3,0
96877,6,2,339217,339217,339219,0,2,3
96878,3,1,339220,339220,339221,0,1,1
96879,4,2,339224,339224,339226,0,2,3
96880,4,3,339228,339228,339231,0,3,2
96881,4,2,339232,339232,339234,0,2,1
96882,6,2,339238,339238,339240,0,2,4
96883,6,3,339244,339244,339247,0,3,4
96884,6,3,339250,339250,339253,0,3,3
96885,5,2,339255,339255,339257,0,2,2
96886,6,2,339261,339261,339263,0,2,4
96887,6,1,339267,339267,339268,0,1,4
96888,1,3,339268,339268,339271,0,3,0
96889,2,3,339270,339271,339274,1,4,0
96890,6,3,339276,339276,339279,0,3,2
96891,3,2,339279,339279,339281,0,2,0
96892,4,3,339283,339283,339286,0,3,2
96893,3,2,339286,339286,339288,0,2,0
96894,4,2,339290,339290,339292,0,2,2
96895,6,1,339296,339296,339297,0,1,4
96896,2,1,339298,339298,339299,0,1,1
96897,3,3,339301,339301,339304,0,3,2
96898,6,1,339307,339307,339308,0,1,3
96899,3,2,339310,339310,339312,0,2,2
96900,5,1,339315,339315,339316,0,1,3
96901,3,3,339318,339318,339321,0,3,2
96902,3,2,339321,339321,339323,0,2,0
96903,2,1,339323,339323,339324,0,1,0
96904,1,2,339324,339324,339326,0,2,0
96905,5,1,339329,339329,339330,0,1,3
96906,5,1,339334,339334,339335,0,1,4
96907,2,3,339336,339336,339339,0,3,1
96908,6,2,339342,339342,339344,0,2,3
96909,6,3,339348,339348,339351,0,3,4
96910,1,2,339349,339351,339353,2,4,0
96911,1,3,339350,339353,339356,3,6,0
96912,4,2,339354,339356,339358,2,4,0
96913,5,3,339359,339359,339362,0,3,1
96914,4,2,339363,339363,339365,0,2,1
96915,2,2,339365,339365,339367,0,2,0
96916,1,2,339366,339367,339369,1,3,0
96917,4,1,339370,339370,339371,0,1,1
96918,6,3,339376,339376,339379,0,3,5
96919,5,1,339381,339381,339382,0,1,2
96920,1,2,339382,339382,339384,0,2,0
96921,2,2,339384,339384,339386,0,2,0
96922,3,3,339387,339387,339390,0,3,1
96923,1,1,339388,339390,339391,2,3,0
96924,3,1,339391,339391,339392,0,1,0
96925,6,1,339397,339397,339398,0,1,5
96926,2,3,339399,339399,339402,0,3,1
96927,6,2,339405,339405,339407,0,2,3
96928,6,2,339411,339411,339413,0,2,4
96929,2,3,339413,339413,339416,0,3,0
96930,6,1,339419,339419,339420,0,1,3
96931,4,1,339423,339423,339424,0,1,3
96932,1,2,339424,339424,339426,0,2,0
96933,6,3,339430,339430,339433,0,3,4
96934,1,3,339431,339433,339436,2,5,0
96935,1,1,339432,339436,339437,4,5,0
96936,2,3,339434,339437,339440,3,6,0
96937,2,2,339436,339440,339442,4,6,0
96938,3,2,339439,339442,339444,3,5,0
96939,6,3,339445,339445,339448,0,3,1
96940,5,2,339450,339450,339452,0,2,2
96941,4,3,339454,339454,339457,0,3,2
96942,5,2,339459,339459,339461,0,2,2
96943,5,1,339464,339464,339465,0,1,3
96944,4,1,339468,339468,339469,0,1,3
96945,3,3,339471,339471,339474,0,3,2
96946,2,1,339473,339474,339475,1,2,0
96947,4,3,339477,339477,339480,0,3,2
96948,1,2,339478,339480,339482,2,4,0
96949,2,3,339480,339482,339485,2,5,0
96950,2,2,339482,339485,339487,3,5,0
96951,5,1,339487,339487,339488,0,1,0
96952,6,3,339493,339493,339496,0,3,5
96953,3,1,339496,339496,339497,0,1,0
96954,6,3,339502,339502,339505,0,3,5
96955,3,3,339505,339505,339508,0,3,0
96956,4,3,339509,339509,339512,0,3,1
96957,6,2,339515,339515,339517,0,2,3
96958,2,3,339517,339517,339520,0,3,0
96959,1,1,339518,339520,339521,2,3,0
96960,6,1,339524,339524,339525,0,1,3
96961,2,3,339526,339526,339529,0,3,1
96962,4,1,339530,339530,339531,0,1,1
96963,3,3,339533,339533,339536,0,3,2
96964,6,1,339539,339539,339540,0,1,3
96965,1,2,339540,339540,339542,0,2,0
96966,3,1,339543,339543,339544,0,1,1
96967,5,1,339548,339548,339549,0,1,4
96968,3,1,339551,339551,339552,0,1,2
96969,1,1,339552,339552,339553,0,1,0
96970,4,3,339556,339556,339559,0,3,3
96971,6,1,339562,339562,339563,0,1,3
96972,4,2,339566,339566,339568,0,2,3
96973,5,2,339571,339571,339573,0,2,3
96974,2,3,339573,339573,339576,0,3,0
96975,5,3,339578,339578,339581,0,3,2
96976,4,2,339582,339582,339584,0,2,1
96977,6,1,339588,339588,339589,0,1,4
96978,3,1,339591,339591,339592,0,1,2
96979,2,1,339593,339593,339594,0,1,1
96980,4,2,339597,339597,339599,0,2,3
96981,2,3,339599,339599,339602,0,3,0
96982,2,3,339601,339602,339605,1,4,0
96983,3,1,339604,339605,339606,1,2,0
96984,6,1,339610,339610,339611,0,1,4
96985,3,3,339613,339613,339616,0,3,2
96986,4,2,339617,339617,339619,0,2,1
96987,5,3,339622,339622,339625,0,3,3
96988,4,2,339626,339626,339628,0,2,1
96989,6,3,339632,339632,339635,0,3,4
96990,1,3,339633,339635,339638,2,5,0
96991,1,3,339634,339638,339641,4,7,0
96992,2,3,339636,339641,339644,5,8,0
96993,4,2,339640,339644,339646,4,6,0
96994,3,1,339643,339646,339647,3,4,0
96995,1,3,339644,339647,339650,3,6,0
96996,3,1,339647,339650,339651,3,4,0
96997,1,3,339648,339651,339654,3,6,0
96998,6,1,339654,339654,339655,0,1,0
96999,6,2,339660,339660,339662,0,2,5
97000,5,2,339665,339665,339667,0,2,3
97001,5,1,339670,339670,339671,0,1,3
97002,5,1,339675,339675,339676,0,1,4
97003,6,2,339681,339681,339683,0,2,5
97004,3,1,339684,339684,339685,0,1,1
97005,6,3,339690,339690,339693,0,3,5
97006,6,3,339696,339696,339699,0,3,3
97007,5,1,339701,339701,339702,0,1,2
97008,5,2,339706,339706,339708,0,2,4
97009,6,2,339712,339712,339714,0,2,4
97010,2,1,339714,339714,339715,0,1,0
97011,6,3,339720,339720,339723,0,3,5
97012,4,2,339724,339724,339726,0,2,1
97013,3,3,339727,339727,339730,0,3,1
97014,1,2,339728,339730,339732,2,4,0
97015,5,2,339733,339733,339735,0,2,1
97016,2,2,339735,339735,339737,0,2,0
97017,3,2,339738,339738,339740,0,2,1
97018,3,2,339741,339741,339743,0,2,1
97019,4,2,339745,339745,339747,0,2,2
97020,4,2,339749,339749,339751,0,2,2
97021,3,1,339752,339752,339753,0,1,1
97022,2,1,339754,339754,339755,0,1,1
97023,2,2,339756,339756,339758,0,2,1
97024,2,1,339758,339758,339759,0,1,0
97025,6,2,339764,339764,339766,0,2,5
97026,2,1,339766,339766,339767,0,1,0
97027,2,1,339768,339768,339769,0,1,1
97028,5,3,339773,339773,339776,0,3,4
97029,4,3,339777,339777,339780,0,3,1
97030,1,1,339778,339780,339781,2,3,0
97031,5,2,339783,339783,339785,0,2,2
97032,4,2,339787,339787,339789,0,2,2
97033,1,2,339788,339789,339791,1,3,0
97034,3,2,339791,339791,339793,0,2,0
97035,2,3,339793,339793,339796,0,3,0
97036,5,1,339798,339798,339799,0,1,2
97037,1,2,339799,339799,339801,0,2,0
97038,1,3,339800,339801,339804,1,4,0
97039,1,2,339801,339804,339806,3,5,0
97040,3,1,339804,339806,339807,2,3,0
97041,1,2,339805,339807,339809,2,4,0
97042,6,3,339811,339811,339814,0,3,2
97043,1,1,339812,339814,339815,2,3,0
97044,5,2,339817,339817,339819,0,2,2
97045,2,2,339819,339819,339821,0,2,0
97046,1,2,339820,339821,339823,1,3,0
97047,1,2,339821,339823,339825,2,4,0
97048,6,1,339827,339827,339828,0,1,2
97049,4,1,339831,339831,339832,0,1,3
97050,1,2,339832,339832,339834,0,2,0
97051,2,2,339834,339834,339836,0,2,0
97052,6,1,339840,339840,339841,0,1,4
97053,6,3,339846,339846,339849,0,3,5
97054,4,2,339850,339850,339852,0,2,1
97055,6,3,339856,339856,339859,0,3,4
97056,5,2,339861,339861,339863,0,2,2
97057,2,1,339863,339863,339864,0,1,0
97058,3,2,339866,339866,339868,0,2,2
97059,6,2,339872,339872,339874,0,2,4
97060,3,1,339875,339875,339876,0,1,1
97061,5,2,339880,339880,339882,0,2,4
97062,6,2,339886,339886,339888,0,2,4
97063,5,3,339891,339891,339894,0,3,3
97064,5,2,339896,339896,339898,0,2,2
97065,1,3,339897,339898,339901,1,4,0
97066,6,2,339903,339903,339905,0,2,2
97067,3,1,339906,339906,339907,0,1,1
97068,3,1,339909,339909,339910,0,1,2
97069,1,3,339910,339910,339913,0,3,0
97070,6,2,339916,339916,339918,0,2,3
97071,3,2,339919,339919,339921,0,2,1
97072,3,2,339922,339922,339924,0,2,1
97073,2,2,339924,339924,339926,0,2,0
97074,2,1,339926,339926,339927,0,1,0
97075,5,3,339931,339931,339934,0,3,4
97076,6,3,339937,339937,339940,0,3,3
97077,4,2,339941,339941,339943,0,2,1
97078,2,1,339943,339943,339944,0,1,0
97079,5,2,339948,339948,339950,0,2,4
97080,1,2,339949,339950,339952,1,3,0
97081,6,2,339955,339955,339957,0,2,3
97082,2,3,339957,339957,339960,0,3,0
97083,6,1,339963,339963,339964,0,1,3
97084,5,2,339968,339968,339970,0,2,4
97085,3,3,339971,339971,339974,0,3,1
97086,4,1,339975,339975,339976,0,1,1
97087,6,1,339981,339981,339982,0,1,5
97088,2,3,339983,339983,339986,0,3,1
97089,1,1,339984,339986,339987,2,3,0
97090,6,3,339990,339990,339993,0,3,3
97091,2,2,339992,339993,339995,1,3,0
97092,2,3,339994,339995,339998,1,4,0
97093,2,1,339996,339998,339999,2,3,0
97094,3,3,339999,339999,340002,0,3,0
97095,2,2,340001,340002,340004,1,3,0
97096,2,2,340003,340004,340006,1,3,0
97097,2,2,340005,340006,340008,1,3,0
97098,6,2,340011,340011,340013,0,2,3
97099,4,3,340015,340015,340018,0,3,2
97100,2,2,340017,340018,340020,1,3,0
97101,4,1,340021,340021,340022,0,1,1
97102,6,1,340027,340027,340028,0,1,5
97103,3,2,340030,340030,340032,0,2,2
97104,2,1,340032,340032,340033,0,1,0
97105,1,2,340033,340033,340035,0,2,0
97106,4,2,340037,340037,340039,0,2,2
97107,2,1,340039,340039,340040,0,1,0
97108,6,2,340045,340045,340047,0,2,5
97109,4,3,340049,340049,340052,0,3,2
97110,5,3,340054,340054,340057,0,3,2
97111,5,2,340059,340059,340061,0,2,2
97112,6,2,340065,340065,340067,0,2,4
97113,2,3,340067,340067,340070,0,3,0
97114,6,1,340073,340073,340074,0,1,3
97115,5,2,340078,340078,340080,0,2,4
97116,6,2,340084,340084,340086,0,2,4
97117,4,3,340088,340088,340091,0,3,2
97118,5,2,340093,340093,340095,0,2,2
97119,4,3,340097,340097,340100,0,3,2
97120,5,2,340102,340102,340104,0,2,2
97121,4,1,340106,340106,340107,0,1,2
97122,1,1,340107,340107,340108,0,1,0
97123,1,3,340108,340108,340111,0,3,0
97124,5,3,340113,340113,340116,0,3,2
97125,4,1,340117,340117,340118,0,1,1
97126,4,2,340121,340121,340123,0,2,3
97127,4,2,340125,340125,340127,0,2,2
97128,5,2,340130,340130,340132,0,2,3
97129,4,2,340134,340134,340136,0,2,2
97130,2,1,340136,340136,340137,0,1,0
97131,6,3,340142,340142,340145,0,3,5
97132,1,1,340143,340145,340146,2,3,0
97133,1,1,340144,340146,340147,2,3,0
97134,2,2,340146,340147,340149,1,3,0
97135,2,3,340148,340149,340152,1,4,0
97136,1,2,340149,340152,340154,3,5,0
97137,3,3,340152,340154,340157,2,5,0
97138,5,1,340157,340157,340158,0,1,0
97139,1,2,340158,340158,340160,0,2,0
97140,3,1,340161,340161,340162,0,1,1
97141,1,2,340162,340162,340164,0,2,0
97142,3,3,340165,340165,340168,0,3,1
97143,5,3,340170,340170,340173,0,3,2
97144,6,1,340176,340176,340177,0,1,3
97145,3,3,340179,340179,340182,0,3,2
97146,2,1,340181,340182,340183,1,2,0
97147,3,1,340184,340184,340185,0,1,1
97148,4,3,340188,340188,340191,0,3,3
97149,3,3,340191,340191,340194,0,3,0
97150,6,2,340197,340197,340199,0,2,3
97151,2,3,340199,340199,340202,0,3,0
97152,1,2,340200,340202,340204,2,4,0
97153,5,2,340205,340205,340207,0,2,1
97154,1,3,340206,340207,340210,1,4,0
97155,3,1,340209,340210,340211,1,2,0
97156,3,1,340212,340212,340213,0,1,1
97157,5,3,340217,340217,340220,0,3,4
97158,1,2,340218,340220,340222,2,4,0
97159,4,1,340222,340222,340223,0,1,0
97160,3,2,340225,340225,340227,0,2,2
97161,6,2,340231,340231,340233,0,2,4
97162,3,3,340234,340234,340237,0,3,1
97163,4,3,340238,340238,340241,0,3,1
97164,3,1,340241,340241,340242,0,1,0
97165,2,1,340243,340243,340244,0,1,1
97166,5,1,340248,340248,340249,0,1,4
97167,3,2,340251,340251,340253,0,2,2
97168,3,1,340254,340254,340255,0,1,1
97169,1,1,340255,340255,340256,0,1,0
97170,4,2,340259,340259,340261,0,2,3
97171,1,2,340260,340261,340263,1,3,0
97172,1,2,340261,340263,340265,2,4,0
97173,5,1,340266,340266,340267,0,1,1
97174,6,2,340272,340272,340274,0,2,5
97175,1,1,340273,340274,340275,1,2,0
97176,4,3,340277,340277,340280,0,3,2
97177,4,1,340281,340281,340282,0,1,1
97178,5,1,340286,340286,340287,0,1,4
97179,6,1,340292,340292,340293,0,1,5
97180,5,3,340297,340297,340300,0,3,4
97181,6,2,340303,340303,340305,0,2,3
97182,2,3,340305,340305,340308,0,3,0
97183,6,1,340311,340311,340312,0,1,3
97184,6,3,340317,340317,340320,0,3,5
97185,3,3,340320,340320,340323,0,3,0
97186,3,3,340323,340323,340326,0,3,0
97187,3,2,340326,340326,340328,0,2,0
97188,1,3,340327,340328,340331,1,4,0
97189,3,1,340330,340331,340332,1,2,0
97190,6,1,340336,340336,340337,0,1,4
97191,5,3,340341,340341,340344,0,3,4
97192,4,1,340345,340345,340346,0,1,1
97193,2,1,340347,340347,340348,0,1,1
97194,5,2,340352,340352,340354,0,2,4
97195,6,3,340358,340358,340361,0,3,4
97196,4,2,340362,340362,340364,0,2,1
97197,2,2,340364,340364,340366,0,2,0
97198,1,2,340365,340366,340368,1,3,0
97199,5,1,340370,340370,340371,0,1,2
97200,2,1,340372,340372,340373,0,1,1
97201,2,3,340374,340374,340377,0,3,1
97202,3,1,340377,340377,340378,0,1,0
97203,5,1,340382,340382,340383,0,1,4
97204,3,2,340385,340385,340387,0,2,2
97205,4,1,340389,340389,340390,0,1,2
97206,2,3,340391,340391,340394,0,3,1
97207,4,1,340395,340395,340396,0,1,1
97208,5,3,340400,340400,340403,0,3,4
97209,2,3,340402,340403,340406,1,4,0
97210,2,2,340404,340406,340408,2,4,0
97211,1,3,340405,340408,340411,3,6,0
97212,4,3,340409,340411,340414,2,5,0
97213,4,2,340413,340414,340416,1,3,0
97214,5,1,340418,340418,340419,0,1,2
97215,5,3,340423,340423,340426,0,3,4
97216,2,1,340425,340426,340427,1,2,0
97217,2,1,340427,340427,340428,0,1,0
97218,1,2,340428,340428,340430,0,2,0
97219,3,2,340431,340431,340433,0,2,1
97220,4,2,340435,340435,340437,0,2,2
97221,1,3,340436,340437,340440,1,4,0
97222,5,3,340441,340441,340444,0,3,1
97223,3,3,340444,340444,340447,0,3,0
97224,3,2,340447,340447,340449,0,2,0
97225,4,2,340451,340451,340453,0,2,2
97226,5,2,340456,340456,340458,0,2,3
97227,1,3,340457,340458,340461,1,4,0
97228,4,3,340461,340461,340464,0,3,0
97229,2,2,340463,340464,340466,1,3,0
97230,6,1,340469,340469,340470,0,1,3
97231,1,1,340470,340470,340471,0,1,0
97232,4,3,340474,340474,340477,0,3,3
97233,3,2,340477,340477,340479,0,2,0
97234,1,1,340478,340479,340480,1,2,0
97235,2,1,340480,340480,340481,0,1,0
97236,5,3,340485,340485,340488,0,3,4
97237,2,3,340487,340488,340491,1,4,0
97238,5,1,340492,340492,340493,0,1,1
97239,6,3,340498,340498,340501,0,3,5
97240,4,2,340502,340502,340504,0,2,1
97241,2,3,340504,340504,340507,0,3,0
97242,2,2,340506,340507,340509,1,3,0
97243,2,1,340508,340509,340510,1,2,0
97244,4,2,340512,340512,340514,0,2,2
97245,5,3,340517,340517,340520,0,3,3
97246,5,2,340522,340522,340524,0,2,2
97247,1,3,340523,340524,340527,1,4,0
97248,1,3,340524,340527,340530,3,6,0
97249,5,3,340529,340530,340533,1,4,0
97250,6,3,340535,340535,340538,0,3,2
97251,3,3,340538,340538,340541,0,3,0
97252,6,1,340544,340544,340545,0,1,3
97253,3,3,340547,340547,340550,0,3,2
97254,5,3,340552,340552,340555,0,3,2
97255,6,2,340558,340558,340560,0,2,3
97256,6,1,340564,340564,340565,0,1,4
97257,3,1,340567,340567,340568,0,1,2
97258,4,1,340571,340571,340572,0,1,3
97259,1,2,340572,340572,340574,0,2,0
97260,4,1,340576,340576,340577,0,1,2
97261,3,1,340579,340579,340580,0,1,2
97262,6,2,340585,340585,340587,0,2,5
97263,4,3,340589,340589,340592,0,3,2
97264,4,2,340593,340593,340595,0,2,1
97265,6,3,340599,340599,340602,0,3,4
97266,3,1,340602,340602,340603,0,1,0
97267,5,2,340607,340607,340609,0,2,4
97268,6,2,340613,340613,340615,0,2,4
97269,6,1,340619,340619,340620,0,1,4
97270,6,1,340625,340625,340626,0,1,5
97271,5,3,340630,340630,340633,0,3,4
97272,3,1,340633,340633,340634,0,1,0
97273,2,3,340635,340635,340638,0,3,1
97274,5,2,340640,340640,340642,0,2,2
97275,3,2,340643,340643,340645,0,2,1
97276,5,3,340648,340648,340651,0,3,3
97277,2,3,340650,340651,340654,1,4,0
97278,2,2,340652,340654,340656,2,4,0
97279,1,1,340653,340656,340657,3,4,0
97280,1,3,340654,340657,340660,3,6,0
97281,6,1,340660,340660,340661,0,1,0
97282,2,3,340662,340662,340665,0,3,1
97283,6,2,340668,340668,340670,0,2,3
97284,5,1,340673,340673,340674,0,1,3
97285,6,3,340679,340679,340682,0,3,5
97286,6,3,340685,340685,340688,0,3,3
97287,5,2,340690,340690,340692,0,2,2
97288,1,1,340691,340692,340693,1,2,0
97289,2,3,340693,340693,340696,0,3,0
97290,2,3,340695,340696,340699,1,4,0
97291,1,3,340696,340699,340702,3,6,0
97292,1,3,340697,340702,340705,5,8,0
97293,1,3,340698,340705,340708,7,10,0
97294,1,1,340699,340708,340709,9,10,0
97295,3,2,340702,340709,340711,7,9,0
97296,5,2,340707,340711,340713,4,6,0
97297,3,2,340710,340713,340715,3,5,0
97298,2,3,340712,340715,340718,3,6,0
97299,4,2,340716,340718,340720,2,4,0
97300,2,1,340718,340720,340721,2,3,0
97301,1,2,340719,340721,340723,2,4,0
97302,1,1,340720,340723,340724,3,4,0
97303,6,2,340726,340726,340728,0,2,2
97304,2,1,340728,340728,340729,0,1,0
97305,3,2,340731,340731,340733,0,2,2
97306,4,1,340735,340735,340736,0,1,2
97307,3,1,340738,340738,340739,0,1,2
97308,6,1,340744,340744,340745,0,1,5
97309,2,2,340746,340746,340748,0,2,1
97310,6,2,340752,340752,340754,0,2,4
97311,3,3,340755,340755,340758,0,3,1
97312,4,3,340759,340759,340762,0,3,1
97313,2,2,340761,340762,340764,1,3,0
97314,1,3,340762,340764,340767,2,5,0
97315,4,2,340766,340767,340769,1,3,0
97316,2,2,340768,340769,340771,1,3,0
97317,4,3,340772,340772,340775,0,3,1
97318,2,2,340774,340775,340777,1,3,0
97319,3,3,340777,340777,340780,0,3,0
97320,3,1,340780,340780,340781,0,1,0
97321,5,1,340785,340785,340786,0,1,4
97322,2,3,340787,340787,340790,0,3,1
97323,6,1,340793,340793,340794,0,1,3
97324,3,1,340796,340796,340797,0,1,2
97325,3,1,340799,340799,340800,0,1,2
97326,4,2,340803,340803,340805,0,2,3
97327,2,2,340805,340805,340807,0,2,0
97328,6,3,340811,340811,340814,0,3,4
97329,4,1,340815,340815,340816,0,1,1
97330,2,2,340817,340817,340819,0,2,1
97331,3,1,340820,340820,340821,0,1,1
97332,3,2,340823,340823,340825,0,2,2
97333,1,1,340824,340825,340826,1,2,0
97334,4,3,340828,340828,340831,0,3,2
97335,1,2,340829,340831,340833,2,4,0
97336,1,3,340830,340833,340836,3,6,0
97337,5,1,340835,340836,340837,1,2,0
97338,5,3,340840,340840,340843,0,3,3
97339,5,3,340845,340845,340848,0,3,2
97340,4,3,340849,340849,340852,0,3,1
97341,6,3,340855,340855,340858,0,3,3
97342,5,1,340860,340860,340861,0,1,2
97343,5,3,340865,340865,340868,0,3,4
97344,4,1,340869,340869,340870,0,1,1
97345,3,1,340872,340872,340873,0,1,2
97346,4,1,340876,340876,340877,0,1,3
97347,6,3,340882,340882,340885,0,3,5
97348,5,2,340887,340887,340889,0,2,2
97349,3,1,340890,340890,340891,0,1,1
97350,4,1,340894,340894,340895,0,1,3
97351,2,2,340896,340896,340898,0,2,1
97352,6,2,340902,340902,340904,0,2,4
97353,4,2,340906,340906,340908,0,2,2
97354,6,1,340912,340912,340913,0,1,4
97355,2,3,340914,340914,340917,0,3,1
97356,4,3,340918,340918,340921,0,3,1
97357,4,2,340922,340922,340924,0,2,1
97358,5,3,340927,340927,340930,0,3,3
97359,1,2,340928,340930,340932,2,4,0
97360,1,2,340929,340932,340934,3,5,0
97361,2,1,340931,340934,340935,3,4,0
97362,5,3,340936,340936,340939,0,3,1
97363,1,2,340937,340939,340941,2,4,0
97364,3,2,340940,340941,340943,1,3,0
97365,4,2,340944,340944,340946,0,2,1
97366,6,2,340950,340950,340952,0,2,4
97367,3,3,340953,340953,340956,0,3,1
97368,3,1,340956,340956,340957,0,1,0
97369,2,1,340958,340958,340959,0,1,1
97370,5,1,340963,340963,340964,0,1,4
97371,2,2,340965,340965,340967,0,2,1
97372,2,3,340967,340967,340970,0,3,0
97373,5,2,340972,340972,340974,0,2,2
97374,6,3,340978,340978,340981,0,3,4
97375,6,3,340984,340984,340987,0,3,3
97376,3,3,340987,340987,340990,0,3,0
97377,5,2,340992,340992,340994,0,2,2
97378,5,2,340997,340997,340999,0,2,3
97379,4,1,341001,341001,341002,0,1,2
97380,6,2,341007,341007,341009,0,2,5
97381,4,3,341011,341011,341014,0,3,2
97382,3,1,341014,341014,341015,0,1,0
97383,5,1,341019,341019,341020,0,1,4
97384,3,1,341022,341022,341023,0,1,2
97385,4,3,341026,341026,341029,0,3,3
97386,1,3,341027,341029,341032,2,5,0
97387,1,3,341028,341032,341035,4,7,0
97388,6,2,341034,341035,341037,1,3,0
97389,1,2,341035,341037,341039,2,4,0
97390,1,2,341036,341039,341041,3,5,0
97391,3,3,341039,341041,341044,2,5,0
97392,1,3,341040,341044,341047,4,7,0
97393,3,3,341043,341047,341050,4,7,0
97394,6,1,341049,341050,341051,1,2,0
97395,6,3,341055,341055,341058,0,3,4
97396,1,3,341056,341058,341061,2,5,0
97397,1,3,341057,341061,341064,4,7,0
97398,5,2,341062,341064,341066,2,4,0
97399,2,2,341064,341066,341068,2,4,0
97400,5,1,341069,341069,341070,0,1,1
97401,4,2,341073,341073,341075,0,2,3
97402,1,1,341074,341075,341076,1,2,0
97403,5,1,341079,341079,341080,0,1,3
97404,1,1,341080,341080,341081,0,1,0
97405,3,3,341083,341083,341086,0,3,2
97406,6,2,341089,341089,341091,0,2,3
97407,4,3,341093,341093,341096,0,3,2
97408,4,3,341097,341097,341100,0,3,1
97409,2,1,341099,341100,341101,1,2,0
97410,2,2,341101,341101,341103,0,2,0
97411,1,1,341102,341103,341104,1,2,0
97412,5,1,341107,341107,341108,0,1,3
97413,2,2,341109,341109,341111,0,2,1
97414,5,3,341114,341114,341117,0,3,3
97415,5,3,341119,341119,341122,0,3,2
97416,4,3,341123,341123,341126,0,3,1
97417,1,3,341124,341126,341129,2,5,0
97418,2,3,341126,341129,341132,3,6,0
97419,3,1,341129,341132,341133,3,4,0
97420,1,3,341130,341133,341136,3,6,0
97421,2,3,341132,341136,341139,4,7,0
97422,3,2,341135,341139,341141,4,6,0
97423,4,2,341139,341141,341143,2,4,0
97424,1,1,341140,341143,341144,3,4,0
97425,4,2,341144,341144,341146,0,2,0
97426,6,2,341150,341150,341152,0,2,4
97427,2,2,341152,341152,341154,0,2,0
97428,5,3,341157,341157,341160,0,3,3
97429,5,2,341162,341162,341164,0,2,2
97430,1,1,341163,341164,341165,1,2,0
97431,1,1,341164,341165,341166,1,2,0
97432,4,2,341168,341168,341170,0,2,2
97433,3,1,341171,341171,341172,0,1,1
97434,4,3,341175,341175,341178,0,3,3
97435,4,3,341179,341179,341182,0,3,1
97436,4,1,341183,341183,341184,0,1,1
97437,1,2,341184,341184,341186,0,2,0
97438,4,3,341188,341188,341191,0,3,2
97439,1,2,341189,341191,341193,2,4,0
97440,3,1,341192,341193,341194,1,2,0
97441,1,1,341193,341194,341195,1,2,0
97442,6,1,341199,341199,341200,0,1,4
97443,2,2,341201,341201,341203,0,2,1
97444,1,2,341202,341203,341205,1,3,0
97445,5,3,341207,341207,341210,0,3,2
97446,2,3,341209,341210,341213,1,4,0
97447,4,2,341213,341213,341215,0,2,0
97448,5,1,341218,341218,341219,0,1,3
97449,2,3,341220,341220,341223,0,3,1
97450,3,1,341223,341223,341224,0,1,0
97451,6,2,341229,341229,341231,0,2,5
97452,6,2,341235,341235,341237,0,2,4
97453,5,1,341240,341240,341241,0,1,3
97454,6,3,341246,341246,341249,0,3,5
97455,6,3,341252,341252,341255,0,3,3
97456,2,1,341254,341255,341256,1,2,0
97457,5,2,341259,341259,341261,0,2,3
97458,5,1,341264,341264,341265,0,1,3
97459,5,1,341269,341269,341270,0,1,4
97460,2,3,341271,341271,341274,0,3,1
97461,2,3,341273,341274,341277,1,4,0
97462,3,3,341276,341277,341280,1,4,0
97463,6,1,341282,341282,341283,0,1,2
97464,6,1,341288,341288,341289,0,1,5
97465,4,1,341292,341292,341293,0,1,3
97466,3,1,341295,341295,341296,0,1,2
97467,5,3,341300,341300,341303,0,3,4
97468,6,1,341306,341306,341307,0,1,3
97469,6,1,341312,341312,341313,0,1,5
97470,2,1,341314,341314,341315,0,1,1
97471,6,2,341320,341320,341322,0,2,5
97472,1,2,341321,341322,341324,1,3,0
97473,3,3,341324,341324,341327,0,3,0
97474,6,2,341330,341330,341332,0,2,3
97475,1,2,341331,341332,341334,1,3,0
97476,5,3,341336,341336,341339,0,3,2
97477,1,1,341337,341339,341340,2,3,0
97478,2,3,341339,341340,341343,1,4,0
97479,6,2,341345,341345,341347,0,2,2
97480,2,1,341347,341347,341348,0,1,0
97481,2,2,341349,341349,341351,0,2,1
97482,5,1,341354,341354,341355,0,1,3
97483,4,2,341358,341358,341360,0,2,3
97484,6,3,341364,341364,341367,0,3,4
97485,1,1,341365,341367,341368,2,3,0
97486,2,2,341367,341368,341370,1,3,0
97487,3,2,341370,341370,341372,0,2,0
97488,6,1,341376,341376,341377,0,1,4
97489,4,1,341380,341380,341381,0,1,3
97490,6,1,341386,341386,341387,0,1,5
97491,4,3,341390,341390,341393,0,3,3
97492,6,2,341396,341396,341398,0,2,3
97493,2,1,341398,341398,341399,0,1,0
97494,3,3,341401,341401,341404,0,3,2
97495,6,3,341407,341407,341410,0,3,3
97496,2,1,341409,341410,341411,1,2,0
97497,3,3,341412,341412,341415,0,3,1
97498,3,1,341415,341415,341416,0,1,0
97499,1,3,341416,341416,341419,0,3,0
97500,6,1,341422,341422,341423,0,1,3
97501,2,2,341424,341424,341426,0,2,1
97502,2,3,341426,341426,341429,0,3,0
97503,6,2,341432,341432,341434,0,2,3
97504,1,2,341433,341434,341436,1,3,0
97505,1,2,341434,341436,341438,2,4,0
97506,4,3,341438,341438,341441,0,3,0
97507,3,2,341441,341441,341443,0,2,0
97508,2,3,341443,341443,341446,0,3,0
97509,3,1,341446,341446,341447,0,1,0
97510,2,3,341448,341448,341451,0,3,1
97511,6,1,341454,341454,341455,0,1,3
97512,3,3,341457,341457,341460,0,3,2
97513,1,1,341458,341460,341461,2,3,0
97514,2,3,341460,341461,341464,1,4,0
97515,2,2,341462,341464,341466,2,4,0
97516,3,1,341465,341466,341467,1,2,0
97517,1,2,341466,341467,341469,1,3,0
97518,1,3,341467,341469,341472,2,5,0
97519,6,2,341473,341473,341475,0,2,1
97520,4,3,341477,341477,341480,0,3,2
97521,4,3,341481,341481,341484,0,3,1
97522,1,2,341482,341484,341486,2,4,0
97523,6,1,341488,341488,341489,0,1,2
97524,4,1,341492,341492,341493,0,1,3
97525,2,3,341494,341494,341497,0,3,1
97526,5,1,341499,341499,341500,0,1,2
97527,3,3,341502,341502,341505,0,3,2
97528,5,1,341507,341507,341508,0,1,2
97529,1,3,341508,341508,341511,0,3,0
97530,5,1,341513,341513,341514,0,1,2
97531,3,2,341516,341516,341518,0,2,2
97532,5,3,341521,341521,341524,0,3,3
97533,3,2,341524,341524,341526,0,2,0
97534,1,1,341525,341526,341527,1,2,0
97535,5,3,341530,341530,341533,0,3,3
97536,2,2,341532,341533,341535,1,3,0
97537,6,3,341538,341538,341541,0,3,3
97538,3,2,341541,341541,341543,0,2,0
97539,5,1,341546,341546,341547,0,1,3
97540,6,3,341552,341552,341555,0,3,5
97541,3,1,341555,341555,341556,0,1,0
97542,3,2,341558,341558,341560,0,2,2
97543,2,2,341560,341560,341562,0,2,0
97544,3,1,341563,341563,341564,0,1,1
97545,6,2,341569,341569,341571,0,2,5
97546,6,1,341575,341575,341576,0,1,4
97547,5,1,341580,341580,341581,0,1,4
97548,4,2,341584,341584,341586,0,2,3
97549,5,1,341589,341589,341590,0,1,3
97550,1,3,341590,341590,341593,0,3,0
97551,1,2,341591,341593,341595,2,4,0
97552,3,1,341594,341595,341596,1,2,0
97553,5,3,341599,341599,341602,0,3,3
97554,1,3,341600,341602,341605,2,5,0
97555,2,1,341602,341605,341606,3,4,0
97556,1,2,341603,341606,341608,3,5,0
97557,1,3,341604,341608,341611,4,7,0
97558,4,2,341608,341611,341613,3,5,0
97559,4,1,341612,341613,341614,1,2,0
97560,5,3,341617,341617,341620,0,3,3
97561,1,2,341618,341620,341622,2,4,0
97562,1,1,341619,341622,341623,3,4,0
97563,3,2,341622,341623,341625,1,3,0
97564,1,2,341623,341625,341627,2,4,0
97565,3,1,341626,341627,341628,1,2,0
97566,1,3,341627,341628,341631,1,4,0
97567,2,2,341629,341631,341633,2,4,0
97568,4,1,341633,341633,341634,0,1,0
97569,4,2,341637,341637,341639,0,2,3
97570,6,2,341643,341643,341645,0,2,4
97571,1,3,341644,341645,341648,1,4,0
97572,1,1,341645,341648,341649,3,4,0
97573,6,2,341651,341651,341653,0,2,2
97574,5,3,341656,341656,341659,0,3,3
97575,5,3,341661,341661,341664,0,3,2
97576,1,3,341662,341664,341667,2,5,0
97577,6,1,341668,341668,341669,0,1,1
97578,6,2,341674,341674,341676,0,2,5
97579,6,3,341680,341680,341683,0,3,4
97580,2,2,341682,341683,341685,1,3,0
97581,5,3,341687,341687,341690,0,3,2
97582,2,2,341689,341690,341692,1,3,0
97583,1,1,341690,341692,341693,2,3,0
97584,4,3,341694,341694,341697,0,3,1
97585,2,3,341696,341697,341700,1,4,0
97586,1,1,341697,341700,341701,3,4,0
97587,1,2,341698,341701,341703,3,5,0
97588,2,1,341700,341703,341704,3,4,0
97589,3,3,341703,341704,341707,1,4,0
97590,4,3,341707,341707,341710,0,3,0
97591,3,1,341710,341710,341711,0,1,0
97592,3,1,341713,341713,341714,0,1,2
97593,5,2,341718,341718,341720,0,2,4
97594,3,3,341721,341721,341724,0,3,1
97595,2,3,341723,341724,341727,1,4,0
97596,5,3,341728,341728,341731,0,3,1
97597,5,2,341733,341733,341735,0,2,2
97598,1,1,341734,341735,341736,1,2,0
97599,6,1,341740,341740,341741,0,1,4
97600,5,2,341745,341745,341747,0,2,4
97601,3,3,341748,341748,341751,0,3,1
97602,3,2,341751,341751,341753,0,2,0
97603,4,1,341755,341755,341756,0,1,2
97604,6,1,341761,341761,341762,0,1,5
97605,6,2,341767,341767,341769,0,2,5
97606,1,3,341768,341769,341772,1,4,0
97607,6,3,341774,341774,341777,0,3,2
97608,6,1,341780,341780,341781,0,1,3
97609,5,3,341785,341785,341788,0,3,4
97610,4,1,341789,341789,341790,0,1,1
97611,6,2,341795,341795,341797,0,2,5
97612,1,3,341796,341797,341800,1,4,0
97613,2,2,341798,341800,341802,2,4,0
97614,5,2,341803,341803,341805,0,2,1
97615,3,3,341806,341806,341809,0,3,1
97616,1,1,341807,341809,341810,2,3,0
97617,2,2,341809,341810,341812,1,3,0
97618,6,1,341815,341815,341816,0,1,3
97619,6,2,341821,341821,341823,0,2,5
97620,5,1,341826,341826,341827,0,1,3
97621,1,1,341827,341827,341828,0,1,0
97622,3,2,341830,341830,341832,0,2,2
97623,6,2,341836,341836,341838,0,2,4
97624,2,2,341838,341838,341840,0,2,0
97625,3,2,341841,341841,341843,0,2,1
97626,2,2,341843,341843,341845,0,2,0
97627,4,2,341847,341847,341849,0,2,2
97628,2,3,341849,341849,341852,0,3,0
97629,5,2,341854,341854,341856,0,2,2
97630,2,1,341856,341856,341857,0,1,0
97631,3,2,341859,341859,341861,0,2,2
97632,5,1,341864,341864,341865,0,1,3
97633,1,1,341865,341865,341866,0,1,0
97634,6,3,341871,341871,341874,0,3,5
97635,1,3,341872,341874,341877,2,5,0
97636,4,2,341876,341877,341879,1,3,0
97637,4,1,341880,341880,341881,0,1,1
97638,1,1,341881,341881,341882,0,1,0
97639,4,2,341885,341885,341887,0,2,3
97640,2,3,341887,341887,341890,0,3,0
97641,2,1,341889,341890,341891,1,2,0
97642,6,3,341895,341895,341898,0,3,4
97643,6,1,341901,341901,341902,0,1,3
97644,4,1,341905,341905,341906,0,1,3
97645,4,3,341909,341909,341912,0,3,3
97646,2,2,341911,341912,341914,1,3,0
97647,1,1,341912,341914,341915,2,3,0
97648,4,2,341916,341916,341918,0,2,1
97649,6,2,341922,341922,341924,0,2,4
97650,3,3,341925,341925,341928,0,3,1
97651,2,3,341927,341928,341931,1,4,0
97652,3,3,341930,341931,341934,1,4,0
97653,5,3,341935,341935,341938,0,3,1
97654,3,3,341938,341938,341941,0,3,0
97655,2,1,341940,341941,341942,1,2,0
97656,1,1,341941,341942,341943,1,2,0
97657,1,3,341942,341943,341946,1,4,0
97658,1,2,341943,341946,341948,3,5,0
97659,6,2,341949,341949,341951,0,2,1
97660,6,1,341955,341955,341956,0,1,4
97661,5,3,341960,341960,341963,0,3,4
97662,1,1,341961,341963,341964,2,3,0
97663,5,1,341966,341966,341967,0,1,2
97664,6,2,341972,341972,341974,0,2,5
97665,5,1,341977,341977,341978,0,1,3
97666,1,3,341978,341978,341981,0,3,0
97667,2,2,341980,341981,341983,1,3,0
97668,3,3,341983,341983,341986,0,3,0
97669,6,2,341989,341989,341991,0,2,3
97670,3,3,341992,341992,341995,0,3,1
97671,4,2,341996,341996,341998,0,2,1
97672,4,1,342000,342000,342001,0,1,2
97673,6,3,342006,342006,342009,0,3,5
97674,5,3,342011,342011,342014,0,3,2
97675,1,1,342012,342014,342015,2,3,0
97676,6,1,342018,342018,342019,0,1,3
97677,6,3,342024,342024,342027,0,3,5
97678,6,3,342030,342030,342033,0,3,3
97679,5,2,342035,342035,342037,0,2,2
97680,5,3,342040,342040,342043,0,3,3
97681,2,2,342042,342043,342045,1,3,0
97682,2,3,342044,342045,342048,1,4,0
97683,2,1,342046,342048,342049,2,3,0
97684,1,3,342047,342049,342052,2,5,0
97685,2,1,342049,342052,342053,3,4,0
97686,2,1,342051,342053,342054,2,3,0
97687,2,1,342053,342054,342055,1,2,0
97688,4,2,342057,342057,342059,0,2,2
97689,2,2,342059,342059,342061,0,2,0
97690,5,1,342064,342064,342065,0,1,3
97691,1,3,342065,342065,342068,0,3,0
97692,6,3,342071,342071,342074,0,3,3
97693,5,2,342076,342076,342078,0,2,2
97694,1,3,342077,342078,342081,1,4,0
97695,5,3,342082,342082,342085,0,3,1
97696,3,1,342085,342085,342086,0,1,0
97697,1,3,342086,342086,342089,0,3,0
97698,1,3,342087,342089,342092,2,5,0
97699,3,1,342090,342092,342093,2,3,0
97700,4,2,342094,342094,342096,0,2,1
97701,2,2,342096,342096,342098,0,2,0
97702,1,2,342097,342098,342100,1,3,0
97703,1,1,342098,342100,342101,2,3,0
97704,3,2,342101,342101,342103,0,2,0
97705,2,2,342103,342103,342105,0,2,0
97706,1,1,342104,342105,342106,1,2,0
97707,3,2,342107,342107,342109,0,2,1
97708,3,1,342110,342110,342111,0,1,1
97709,1,1,342111,342111,342112,0,1,0
97710,5,2,342116,342116,342118,0,2,4
97711,2,3,342118,342118,342121,0,3,0
97712,5,1,342123,342123,342124,0,1,2
97713,3,2,342126,342126,342128,0,2,2
97714,4,2,342130,342130,342132,0,2,2
97715,2,3,342132,342132,342135,0,3,0
97716,1,1,342133,342135,342136,2,3,0
97717,2,3,342135,342136,342139,1,4,0
97718,4,2,342139,342139,342141,0,2,0
97719,3,3,342142,342142,342145,0,3,1
97720,1,3,342143,342145,342148,2,5,0
97721,4,3,342147,342148,342151,1,4,0
97722,6,3,342153,342153,342156,0,3,2
97723,3,3,342156,342156,342159,0,3,0
97724,6,2,342162,342162,342164,0,2,3
97725,6,2,342168,342168,342170,0,2,4
97726,1,2,342169,342170,342172,1,3,0
97727,4,3,342173,342173,342176,0,3,1
97728,5,2,342178,342178,342180,0,2,2
97729,4,2,342182,342182,342184,0,2,2
97730,3,2,342185,342185,342187,0,2,1
97731,1,1,342186,342187,342188,1,2,0
97732,4,1,342190,342190,342191,0,1,2
97733,1,3,342191,342191,342194,0,3,0
97734,6,2,342197,342197,342199,0,2,3
97735,3,2,342200,342200,342202,0,2,1
97736,2,1,342202,342202,342203,0,1,0
97737,1,3,342203,342203,342206,0,3,0
97738,6,3,342209,342209,342212,0,3,3
97739,3,3,342212,342212,342215,0,3,0
97740,3,1,342215,342215,342216,0,1,0
97741,5,3,342220,342220,342223,0,3,4
97742,4,2,342224,342224,342226,0,2,1
97743,1,3,342225,342226,342229,1,4,0
97744,1,3,342226,342229,342232,3,6,0
97745,4,3,342230,342232,342235,2,5,0
97746,5,3,342235,342235,342238,0,3,0
97747,6,1,342241,342241,342242,0,1,3
97748,2,3,342243,342243,342246,0,3,1
97749,5,3,342248,342248,342251,0,3,2
97750,3,2,342251,342251,342253,0,2,0
97751,2,3,342253,342253,342256,0,3,0
97752,1,1,342254,342256,342257,2,3,0
97753,6,1,342260,342260,342261,0,1,3
97754,4,2,342264,342264,342266,0,2,3
97755,5,2,342269,342269,342271,0,2,3
97756,5,3,342274,342274,342277,0,3,3
97757,4,2,342278,342278,342280,0,2,1
97758,1,2,342279,342280,342282,1,3,0
97759,3,3,342282,342282,342285,0,3,0
97760,4,2,342286,342286,342288,0,2,1
97761,2,1,342288,342288,342289,0,1,0
97762,4,3,342292,342292,342295,0,3,3
97763,6,2,342298,342298,342300,0,2,3
97764,3,3,342301,342301,342304,0,3,1
97765,2,2,342303,342304,342306,1,3,0
97766,5,3,342308,342308,342311,0,3,2
97767,5,1,342313,342313,342314,0,1,2
97768,6,2,342319,342319,342321,0,2,5
97769,2,3,342321,342321,342324,0,3,0
97770,2,2,342323,342324,342326,1,3,0
97771,4,1,342327,342327,342328,0,1,1
97772,6,1,342333,342333,342334,0,1,5
97773,1,1,342334,342334,342335,0,1,0
97774,3,3,342337,342337,342340,0,3,2
97775,6,2,342343,342343,342345,0,2,3
97776,4,2,342347,342347,342349,0,2,2
97777,4,1,342351,342351,342352,0,1,2
97778,4,3,342355,342355,342358,0,3,3
97779,3,1,342358,342358,342359,0,1,0
97780,4,2,342362,342362,342364,0,2,3
97781,6,3,342368,342368,342371,0,3,4
97782,1,3,342369,342371,342374,2,5,0
97783,5,3,342374,342374,342377,0,3,0
97784,3,1,342377,342377,342378,0,1,0
97785,4,1,342381,342381,342382,0,1,3
97786,1,3,342382,342382,342385,0,3,0
97787,2,2,342384,342385,342387,1,3,0
97788,5,2,342389,342389,342391,0,2,2
97789,3,1,342392,342392,342393,0,1,1
97790,4,1,342396,342396,342397,0,1,3
97791,1,3,342397,342397,342400,0,3,0
97792,5,2,342402,342402,342404,0,2,2
97793,3,2,342405,342405,342407,0,2,1
97794,1,3,342406,342407,342410,1,4,0
97795,4,2,342410,342410,342412,0,2,0
97796,6,3,342416,342416,342419,0,3,4
97797,2,2,342418,342419,342421,1,3,0
97798,5,3,342423,342423,342426,0,3,2
97799,1,2,342424,342426,342428,2,4,0
97800,5,1,342429,342429,342430,0,1,1
97801,5,3,342434,342434,342437,0,3,4
97802,5,2,342439,342439,342441,0,2,2
97803,3,2,342442,342442,342444,0,2,1
97804,6,3,342448,342448,342451,0,3,4
97805,3,1,342451,342451,342452,0,1,0
97806,2,2,342453,342453,342455,0,2,1
97807,3,3,342456,342456,342459,0,3,1
97808,2,2,342458,342459,342461,1,3,0
97809,5,1,342463,342463,342464,0,1,2
97810,4,3,342467,342467,342470,0,3,3
97811,3,3,342470,342470,342473,0,3,0
97812,2,3,342472,342473,342476,1,4,0
97813,5,2,342477,342477,342479,0,2,1
97814,6,1,342483,342483,342484,0,1,4
97815,1,2,342484,342484,342486,0,2,0
97816,4,2,342488,342488,342490,0,2,2
97817,4,1,342492,342492,342493,0,1,2
97818,6,2,342498,342498,342500,0,2,5
97819,4,1,342502,342502,342503,0,1,2
97820,2,3,342504,342504,342507,0,3,1
97821,6,3,342510,342510,342513,0,3,3
97822,5,1,342515,342515,342516,0,1,2
97823,5,1,342520,342520,342521,0,1,4
97824,6,2,342526,342526,342528,0,2,5
97825,2,2,342528,342528,342530,0,2,0
97826,2,2,342530,342530,342532,0,2,0
97827,3,3,342533,342533,342536,0,3,1
97828,5,1,342538,342538,342539,0,1,2
97829,5,2,342543,342543,342545,0,2,4
97830,2,2,342545,342545,342547,0,2,0
97831,5,2,342550,342550,342552,0,2,3
97832,5,3,342555,342555,342558,0,3,3
97833,6,3,342561,342561,342564,0,3,3
97834,4,1,342565,342565,342566,0,1,1
97835,1,2,342566,342566,342568,0,2,0
97836,2,1,342568,342568,342569,0,1,0
97837,3,1,342571,342571,342572,0,1,2
97838,2,1,342573,342573,342574,0,1,1
97839,6,1,342579,342579,342580,0,1,5
97840,1,2,342580,342580,342582,0,2,0
97841,4,1,342584,342584,342585,0,1,2
97842,6,1,342590,342590,342591,0,1,5
97843,5,1,342595,342595,342596,0,1,4
97844,2,2,342597,342597,342599,0,2,1
97845,5,2,342602,342602,342604,0,2,3
97846,5,3,342607,342607,342610,0,3,3
97847,1,2,342608,342610,342612,2,4,0
97848,5,3,342613,342613,342616,0,3,1
97849,1,3,342614,342616,342619,2,5,0
97850,6,1,342620,342620,342621,0,1,1
97851,1,3,342621,342621,342624,0,3,0
97852,4,2,342625,342625,342627,0,2,1
97853,3,1,342628,342628,342629,0,1,1
97854,2,1,342630,342630,342631,0,1,1
97855,1,2,342631,342631,342633,0,2,0
97856,4,1,342635,342635,342636,0,1,2
97857,4,1,342639,342639,342640,0,1,3
97858,4,1,342643,342643,342644,0,1,3
97859,5,2,342648,342648,342650,0,2,4
97860,6,2,342654,342654,342656,0,2,4
97861,5,1,342659,342659,342660,0,1,3
97862,1,1,342660,342660,342661,0,1,0
97863,5,2,342665,342665,342667,0,2,4
97864,1,3,342666,342667,342670,1,4,0
97865,6,1,342672,342672,342673,0,1,2
97866,5,2,342677,342677,342679,0,2,4
97867,1,3,342678,342679,342682,1,4,0
97868,5,1,342683,342683,342684,0,1,1
97869,1,2,342684,342684,342686,0,2,0
97870,3,3,342687,342687,342690,0,3,1
97871,4,2,342691,342691,342693,0,2,1
97872,2,1,342693,342693,342694,0,1,0
97873,1,1,342694,342694,342695,0,1,0
97874,5,1,342699,342699,342700,0,1,4
97875,3,2,342702,342702,342704,0,2,2
97876,3,2,342705,342705,342707,0,2,1
97877,2,2,342707,342707,342709,0,2,0
97878,6,1,342713,342713,342714,0,1,4
97879,4,1,342717,342717,342718,0,1,3
97880,3,2,342720,342720,342722,0,2,2
97881,6,1,342726,342726,342727,0,1,4
97882,2,2,342728,342728,342730,0,2,1
97883,3,1,342731,342731,342732,0,1,1
97884,4,2,342735,342735,342737,0,2,3
97885,5,3,342740,342740,342743,0,3,3
97886,3,3,342743,342743,342746,0,3,0
97887,6,2,342749,342749,342751,0,2,3
97888,2,3,342751,342751,342754,0,3,0
97889,5,2,342756,342756,342758,0,2,2
97890,2,2,342758,342758,342760,0,2,0
97891,3,1,342761,342761,342762,0,1,1
97892,1,3,342762,342762,342765,0,3,0
97893,2,3,342764,342765,342768,1,4,0
97894,1,2,342765,342768,342770,3,5,0
97895,6,1,342771,342771,342772,0,1,1
97896,1,3,342772,342772,342775,0,3,0
97897,1,1,342773,342775,342776,2,3,0
97898,4,2,342777,342777,342779,0,2,1
97899,1,3,342778,342779,342782,1,4,0
97900,5,1,342783,342783,342784,0,1,1
97901,4,3,342787,342787,342790,0,3,3
97902,1,1,342788,342790,342791,2,3,0
97903,6,1,342794,342794,342795,0,1,3
97904,1,3,342795,342795,342798,0,3,0
97905,4,3,342799,342799,342802,0,3,1
97906,1,3,342800,342802,342805,2,5,0
97907,3,3,342803,342805,342808,2,5,0
97908,2,3,342805,342808,342811,3,6,0
97909,2,3,342807,342811,342814,4,7,0
97910,6,2,342813,342814,342816,1,3,0
97911,3,2,342816,342816,342818,0,2,0
97912,1,3,342817,342818,342821,1,4,0
97913,4,1,342821,342821,342822,0,1,0
97914,1,3,342822,342822,342825,0,3,0
97915,2,2,342824,342825,342827,1,3,0
97916,1,2,342825,342827,342829,2,4,0
97917,3,3,342828,342829,342832,1,4,0
97918,4,1,342832,342832,342833,0,1,0
97919,3,2,342835,342835,342837,0,2,2
97920,6,1,342841,342841,342842,0,1,4
97921,3,1,342844,342844,342845,0,1,2
97922,4,2,342848,342848,342850,0,2,3
97923,1,3,342849,342850,342853,1,4,0
97924,2,3,342851,342853,342856,2,5,0
97925,4,1,342855,342856,342857,1,2,0
97926,6,1,342861,342861,342862,0,1,4
97927,6,1,342867,342867,342868,0,1,5
97928,1,2,342868,342868,342870,0,2,0
97929,1,3,342869,342870,342873,1,4,0
97930,3,1,342872,342873,342874,1,2,0
97931,2,2,342874,342874,342876,0,2,0
97932,3,1,342877,342877,342878,0,1,1
97933,6,2,342883,342883,342885,0,2,5
97934,3,1,342886,342886,342887,0,1,1
97935,1,2,342887,342887,342889,0,2,0
97936,3,3,342890,342890,342893,0,3,1
97937,2,3,342892,342893,342896,1,4,0
97938,3,1,342895,342896,342897,1,2,0
97939,5,3,342900,342900,342903,0,3,3
97940,2,1,342902,342903,342904,1,2,0
97941,6,3,342908,342908,342911,0,3,4
97942,1,2,342909,342911,342913,2,4,0
97943,5,1,342914,342914,342915,0,1,1
97944,5,3,342919,342919,342922,0,3,4
97945,2,2,342921,342922,342924,1,3,0
97946,4,2,342925,342925,342927,0,2,1
97947,4,3,342929,342929,342932,0,3,2
97948,1,3,342930,342932,342935,2,5,0
97949,3,1,342933,342935,342936,2,3,0
97950,2,2,342935,342936,342938,1,3,0
97951,5,3,342940,342940,342943,0,3,2
97952,6,3,342946,342946,342949,0,3,3
97953,5,2,342951,342951,342953,0,2,2
97954,1,2,342952,342953,342955,1,3,0
97955,1,1,342953,342955,342956,2,3,0
97956,4,3,342957,342957,342960,0,3,1
97957,4,3,342961,342961,342964,0,3,1
97958,6,3,342967,342967,342970,0,3,3
97959,3,1,342970,342970,342971,0,1,0
97960,3,2,342973,342973,342975,0,2,2
97961,2,1,342975,342975,342976,0,1,0
97962,3,2,342978,342978,342980,0,2,2
97963,2,2,342980,342980,342982,0,2,0
97964,3,1,342983,342983,342984,0,1,1
97965,3,3,342986,342986,342989,0,3,2
97966,3,2,342989,342989,342991,0,2,0
97967,2,1,342991,342991,342992,0,1,0
97968,4,2,342995,342995,342997,0,2,3
97969,4,2,342999,342999,343001,0,2,2
97970,4,2,343003,343003,343005,0,2,2
97971,1,3,343004,343005,343008,1,4,0
97972,3,1,343007,343008,343009,1,2,0
97973,4,3,343011,343011,343014,0,3,2
97974,3,1,343014,343014,343015,0,1,0
97975,5,2,343019,343019,343021,0,2,4
97976,1,2,343020,343021,343023,1,3,0
97977,6,3,343026,343026,343029,0,3,3
97978,3,3,343029,343029,343032,0,3,0
97979,5,3,343034,343034,343037,0,3,2
97980,2,2,343036,343037,343039,1,3,0
97981,3,1,343039,343039,343040,0,1,0
97982,2,1,343041,343041,343042,0,1,1
97983,1,2,343042,343042,343044,0,2,0
97984,2,1,343044,343044,343045,0,1,0
97985,2,1,343046,343046,343047,0,1,1
97986,2,2,343048,343048,343050,0,2,1
97987,2,2,343050,343050,343052,0,2,0
97988,2,2,343052,343052,343054,0,2,0
97989,6,1,343058,343058,343059,0,1,4
97990,2,3,343060,343060,343063,0,3,1
97991,3,3,343063,343063,343066,0,3,0
97992,1,3,343064,343066,343069,2,5,0
97993,3,1,343067,343069,343070,2,3,0
97994,4,2,343071,343071,343073,0,2,1
97995,6,1,343077,343077,343078,0,1,4
97996,2,2,343079,343079,343081,0,2,1
97997,6,2,343085,343085,343087,0,2,4
97998,4,3,343089,343089,343092,0,3,2
97999,2,2,343091,343092,343094,1,3,0
98000,3,1,343094,343094,343095,0,1,0
98001,2,2,343096,343096,343098,0,2,1
98002,6,2,343102,343102,343104,0,2,4
98003,3,1,343105,343105,343106,0,1,1
98004,6,2,343111,343111,343113,0,2,5
98005,6,2,343117,343117,343119,0,2,4
98006,2,3,343119,343119,343122,0,3,0
98007,1,1,343120,343122,343123,2,3,0
98008,6,3,343126,343126,343129,0,3,3
98009,4,1,343130,343130,343131,0,1,1
98010,2,1,343132,343132,343133,0,1,1
98011,2,2,343134,343134,343136,0,2,1
98012,3,3,343137,343137,343140,0,3,1
98013,1,3,343138,343140,343143,2,5,0
98014,3,3,343141,343143,343146,2,5,0
98015,6,1,343147,343147,343148,0,1,1
98016,3,3,343150,343150,343153,0,3,2
98017,5,3,343155,343155,343158,0,3,2
98018,3,3,343158,343158,343161,0,3,0
98019,6,1,343164,343164,343165,0,1,3
98020,5,2,343169,343169,343171,0,2,4
98021,6,3,343175,343175,343178,0,3,4
98022,3,3,343178,343178,343181,0,3,0
98023,2,3,343180,343181,343184,1,4,0
98024,3,2,343183,343184,343186,1,3,0
98025,4,3,343187,343187,343190,0,3,1
98026,6,1,343193,343193,343194,0,1,3
98027,1,1,343194,343194,343195,0,1,0
98028,4,3,343198,343198,343201,0,3,3
98029,3,2,343201,343201,343203,0,2,0
98030,2,1,343203,343203,343204,0,1,0
98031,4,1,343207,343207,343208,0,1,3
98032,2,1,343209,343209,343210,0,1,1
98033,1,1,343210,343210,343211,0,1,0
98034,3,1,343213,343213,343214,0,1,2
98035,3,1,343216,343216,343217,0,1,2
98036,1,3,343217,343217,343220,0,3,0
98037,2,2,343219,343220,343222,1,3,0
98038,2,2,343221,343222,343224,1,3,0
98039,4,2,343225,343225,343227,0,2,1
98040,4,2,343229,343229,343231,0,2,2
98041,4,1,343233,343233,343234,0,1,2
98042,2,2,343235,343235,343237,0,2,1
98043,1,1,343236,343237,343238,1,2,0
98044,2,1,343238,343238,343239,0,1,0
98045,5,3,343243,343243,343246,0,3,4
98046,2,1,343245,343246,343247,1,2,0
98047,5,1,343250,343250,343251,0,1,3
98048,4,3,343254,343254,343257,0,3,3
98049,1,3,343255,343257,343260,2,5,0
98050,5,2,343260,343260,343262,0,2,0
98051,6,1,343266,343266,343267,0,1,4
98052,2,2,343268,343268,343270,0,2,1
98053,5,3,343273,343273,343276,0,3,3
98054,1,3,343274,343276,343279,2,5,0
98055,6,3,343280,343280,343283,0,3,1
98056,5,3,343285,343285,343288,0,3,2
98057,6,3,343291,343291,343294,0,3,3
98058,6,3,343297,343297,343300,0,3,3
98059,4,3,343301,343301,343304,0,3,1
98060,2,2,343303,343304,343306,1,3,0
98061,2,3,343305,343306,343309,1,4,0
98062,5,2,343310,343310,343312,0,2,1
98063,5,2,343315,343315,343317,0,2,3
98064,4,1,343319,343319,343320,0,1,2
98065,4,1,343323,343323,343324,0,1,3
98066,2,3,343325,343325,343328,0,3,1
98067,1,1,343326,343328,343329,2,3,0
98068,1,3,343327,343329,343332,2,5,0
98069,1,2,343328,343332,343334,4,6,0
98070,2,2,343330,343334,343336,4,6,0
98071,4,2,343334,343336,343338,2,4,0
98072,6,3,343340,343340,343343,0,3,2
98073,3,1,343343,343343,343344,0,1,0
98074,3,1,343346,343346,343347,0,1,2
98075,1,1,343347,343347,343348,0,1,0
98076,6,1,343353,343353,343354,0,1,5
98077,3,2,343356,343356,343358,0,2,2
98078,1,2,343357,343358,343360,1,3,0
98079,6,1,343363,343363,343364,0,1,3
98080,2,3,343365,343365,343368,0,3,1
98081,5,1,343370,343370,343371,0,1,2
98082,3,1,343373,343373,343374,0,1,2
98083,3,2,343376,343376,343378,0,2,2
98084,1,2,343377,343378,343380,1,3,0
98085,6,2,343383,343383,343385,0,2,3
98086,2,3,343385,343385,343388,0,3,0
98087,5,3,343390,343390,343393,0,3,2
98088,5,2,343395,343395,343397,0,2,2
98089,2,3,343397,343397,343400,0,3,0
98090,3,1,343400,343400,343401,0,1,0
98091,3,3,343403,343403,343406,0,3,2
98092,5,2,343408,343408,343410,0,2,2
98093,6,1,343414,343414,343415,0,1,4
98094,6,2,343420,343420,343422,0,2,5
98095,4,1,343424,343424,343425,0,1,2
98096,4,1,343428,343428,343429,0,1,3
98097,4,1,343432,343432,343433,0,1,3
98098,5,3,343437,343437,343440,0,3,4
98099,5,3,343442,343442,343445,0,3,2
98100,4,3,343446,343446,343449,0,3,1
98101,2,2,343448,343449,343451,1,3,0
98102,2,3,343450,343451,343454,1,4,0
98103,3,2,343453,343454,343456,1,3,0
98104,1,1,343454,343456,343457,2,3,0
98105,6,2,343460,343460,343462,0,2,3
98106,6,2,343466,343466,343468,0,2,4
98107,1,3,343467,343468,343471,1,4,0
98108,5,3,343472,343472,343475,0,3,1
98109,4,2,343476,343476,343478,0,2,1
98110,2,3,343478,343478,343481,0,3,0
98111,4,1,343482,343482,343483,0,1,1
98112,6,1,343488,343488,343489,0,1,5
98113,3,2,343491,343491,343493,0,2,2
98114,1,3,343492,343493,343496,1,4,0
98115,2,3,343494,343496,343499,2,5,0
98116,5,3,343499,343499,343502,0,3,0
98117,5,2,343504,343504,343506,0,2,2
98118,3,2,343507,343507,343509,0,2,1
98119,4,3,343511,343511,343514,0,3,2
98120,1,2,343512,343514,343516,2,4,0
98121,2,1,343514,343516,343517,2,3,0
98122,5,3,343519,343519,343522,0,3,2
98123,3,3,343522,343522,343525,0,3,0
98124,3,3,343525,343525,343528,0,3,0
98125,5,2,343530,343530,343532,0,2,2
98126,6,2,343536,343536,343538,0,2,4
98127,5,3,343541,343541,343544,0,3,3
98128,5,2,343546,343546,343548,0,2,2
98129,6,3,343552,343552,343555,0,3,4
98130,6,3,343558,343558,343561,0,3,3
98131,3,3,343561,343561,343564,0,3,0
98132,3,3,343564,343564,343567,0,3,0
98133,3,1,343567,343567,343568,0,1,0
98134,2,1,343569,343569,343570,0,1,1
98135,6,2,343575,343575,343577,0,2,5
98136,1,1,343576,343577,343578,1,2,0
98137,3,3,343579,343579,343582,0,3,1
98138,5,2,343584,343584,343586,0,2,2
98139,6,1,343590,343590,343591,0,1,4
98140,2,2,343592,343592,343594,0,2,1
98141,4,2,343596,343596,343598,0,2,2
98142,5,1,343601,343601,343602,0,1,3
98143,5,1,343606,343606,343607,0,1,4
98144,1,3,343607,343607,343610,0,3,0
98145,6,3,343613,343613,343616,0,3,3
98146,3,1,343616,343616,343617,0,1,0
98147,3,3,343619,343619,343622,0,3,2
98148,5,1,343624,343624,343625,0,1,2
98149,5,1,343629,343629,343630,0,1,4
98150,5,3,343634,343634,343637,0,3,4
98151,1,3,343635,343637,343640,2,5,0
98152,1,2,343636,343640,343642,4,6,0
98153,4,3,343640,343642,343645,2,5,0
98154,6,2,343646,343646,343648,0,2,1
98155,1,2,343647,343648,343650,1,3,0
98156,3,3,343650,343650,343653,0,3,0
98157,3,1,343653,343653,343654,0,1,0
98158,2,1,343655,343655,343656,0,1,1
98159,4,1,343659,343659,343660,0,1,3
98160,5,3,343664,343664,343667,0,3,4
98161,1,3,343665,343667,343670,2,5,0
98162,6,2,343671,343671,343673,0,2,1
98163,3,3,343674,343674,343677,0,3,1
98164,2,2,343676,343677,343679,1,3,0
98165,5,3,343681,343681,343684,0,3,2
98166,6,2,343687,343687,343689,0,2,3
98167,3,1,343690,343690,343691,0,1,1
98168,1,1,343691,343691,343692,0,1,0
98169,4,2,343695,343695,343697,0,2,3
98170,4,3,343699,343699,343702,0,3,2
98171,2,2,343701,343702,343704,1,3,0
98172,2,3,343703,343704,343707,1,4,0
98173,2,3,343705,343707,343710,2,5,0
98174,6,2,343711,343711,343713,0,2,1
98175,5,1,343716,343716,343717,0,1,3
98176,3,2,343719,343719,343721,0,2,2
98177,1,2,343720,343721,343723,1,3,0
98178,5,3,343725,343725,343728,0,3,2
98179,5,1,343730,343730,343731,0,1,2
98180,3,3,343733,343733,343736,0,3,2
98181,6,2,343739,343739,343741,0,2,3
98182,5,3,343744,343744,343747,0,3,3
98183,6,2,343750,343750,343752,0,2,3
98184,6,1,343756,343756,343757,0,1,4
98185,3,1,343759,343759,343760,0,1,2
98186,1,3,343760,343760,343763,0,3,0
98187,1,1,343761,343763,343764,2,3,0
98188,3,1,343764,343764,343765,0,1,0
98189,3,1,343767,343767,343768,0,1,2
98190,6,2,343773,343773,343775,0,2,5
98191,4,2,343777,343777,343779,0,2,2
98192,3,2,343780,343780,343782,0,2,1
98193,2,1,343782,343782,343783,0,1,0
98194,6,1,343788,343788,343789,0,1,5
98195,3,1,343791,343791,343792,0,1,2
98196,2,2,343793,343793,343795,0,2,1
98197,5,2,343798,343798,343800,0,2,3
98198,3,2,343801,343801,343803,0,2,1
98199,4,3,343805,343805,343808,0,3,2
98200,3,2,343808,343808,343810,0,2,0
98201,6,2,343814,343814,343816,0,2,4
98202,3,1,343817,343817,343818,0,1,1
98203,5,2,343822,343822,343824,0,2,4
98204,3,3,343825,343825,343828,0,3,1
98205,6,1,343831,343831,343832,0,1,3
98206,2,1,343833,343833,343834,0,1,1
98207,6,3,343839,343839,343842,0,3,5
98208,1,3,343840,343842,343845,2,5,0
98209,2,3,343842,343845,343848,3,6,0
98210,6,2,343848,343848,343850,0,2,0
98211,6,3,343854,343854,343857,0,3,4
98212,4,1,343858,343858,343859,0,1,1
98213,4,1,343862,343862,343863,0,1,3
98214,5,3,343867,343867,343870,0,3,4
98215,4,3,343871,343871,343874,0,3,1
98216,4,2,343875,343875,343877,0,2,1
98217,3,3,343878,343878,343881,0,3,1
98218,4,1,343882,343882,343883,0,1,1
98219,3,1,343885,343885,343886,0,1,2
98220,6,1,343891,343891,343892,0,1,5
98221,4,3,343895,343895,343898,0,3,3
98222,1,2,343896,343898,343900,2,4,0
98223,4,2,343900,343900,343902,0,2,0
98224,5,3,343905,343905,343908,0,3,3
98225,4,2,343909,343909,343911,0,2,1
98226,3,2,343912,343912,343914,0,2,1
98227,5,3,343917,343917,343920,0,3,3
98228,2,3,343919,343920,343923,1,4,0
98229,6,1,343925,343925,343926,0,1,2
98230,2,2,343927,343927,343929,0,2,1
98231,3,1,343930,343930,343931,0,1,1
98232,4,2,343934,343934,343936,0,2,3
98233,1,1,343935,343936,343937,1,2,0
98234,2,2,343937,343937,343939,0,2,0
98235,4,1,343941,343941,343942,0,1,2
98236,5,1,343946,343946,343947,0,1,4
98237,3,2,343949,343949,343951,0,2,2
98238,6,1,343955,343955,343956,0,1,4
98239,2,3,343957,343957,343960,0,3,1
98240,3,3,343960,343960,343963,0,3,0
98241,1,1,343961,343963,343964,2,3,0
98242,6,3,343967,343967,343970,0,3,3
98243,1,2,343968,343970,343972,2,4,0
98244,3,2,343971,343972,343974,1,3,0
98245,2,2,343973,343974,343976,1,3,0
98246,4,1,343977,343977,343978,0,1,1
98247,5,1,343982,343982,343983,0,1,4
98248,2,1,343984,343984,343985,0,1,1
98249,6,1,343990,343990,343991,0,1,5
98250,2,3,343992,343992,343995,0,3,1
98251,4,1,343996,343996,343997,0,1,1
98252,5,2,344001,344001,344003,0,2,4
98253,3,1,344004,344004,344005,0,1,1
98254,3,2,344007,344007,344009,0,2,2
98255,1,3,344008,344009,344012,1,4,0
98256,1,2,344009,344012,344014,3,5,0
98257,4,3,344013,344014,344017,1,4,0
98258,4,2,344017,344017,344019,0,2,0
98259,1,1,344018,344019,344020,1,2,0
98260,2,1,344020,344020,344021,0,1,0
98261,5,2,344025,344025,344027,0,2,4
98262,5,2,344030,344030,344032,0,2,3
98263,6,2,344036,344036,344038,0,2,4
98264,2,3,344038,344038,344041,0,3,0
98265,5,2,344043,344043,344045,0,2,2
98266,1,1,344044,344045,344046,1,2,0
98267,2,1,344046,344046,344047,0,1,0
98268,5,3,344051,344051,344054,0,3,4
98269,3,2,344054,344054,344056,0,2,0
98270,2,1,344056,344056,344057,0,1,0
98271,1,1,344057,344057,344058,0,1,0
98272,2,3,344059,344059,344062,0,3,1
98273,3,2,344062,344062,344064,0,2,0
98274,1,1,344063,344064,344065,1,2,0
98275,6,2,344069,344069,344071,0,2,4
98276,6,3,344075,344075,344078,0,3,4
98277,5,3,344080,344080,344083,0,3,2
98278,1,3,344081,344083,344086,2,5,0
98279,3,3,344084,344086,344089,2,5,0
98280,2,3,344086,344089,344092,3,6,0
98281,4,1,344090,344092,344093,2,3,0
98282,3,2,344093,344093,344095,0,2,0
98283,3,3,344096,344096,344099,0,3,1
98284,2,3,344098,344099,344102,1,4,0
98285,3,1,344101,344102,344103,1,2,0
98286,1,1,344102,344103,344104,1,2,0
98287,3,1,344105,344105,344106,0,1,1
98288,6,3,344111,344111,344114,0,3,5
98289,6,2,344117,344117,344119,0,2,3
98290,1,1,344118,344119,344120,1,2,0
98291,1,3,344119,344120,344123,1,4,0
98292,1,1,344120,344123,344124,3,4,0
98293,3,1,344123,344124,344125,1,2,0
98294,3,3,344126,344126,344129,0,3,1
98295,1,1,344127,344129,344130,2,3,0
98296,4,2,344131,344131,344133,0,2,1
98297,5,1,344136,344136,344137,0,1,3
98298,3,2,344139,344139,344141,0,2,2
98299,5,1,344144,344144,344145,0,1,3
98300,1,1,344145,344145,344146,0,1,0
98301,5,2,344150,344150,344152,0,2,4
98302,4,2,344154,344154,344156,0,2,2
98303,6,2,344160,344160,344162,0,2,4
98304,1,2,344161,344162,344164,1,3,0
98305,4,3,344165,344165,344168,0,3,1
98306,4,1,344169,344169,344170,0,1,1
98307,2,2,344171,344171,344173,0,2,1
98308,2,1,344173,344173,344174,0,1,0
98309,5,1,344178,344178,344179,0,1,4
98310,5,2,344183,344183,344185,0,2,4
98311,1,2,344184,344185,344187,1,3,0
98312,6,3,344190,344190,344193,0,3,3
98313,2,1,344192,344193,344194,1,2,0
98314,6,1,344198,344198,344199,0,1,4
98315,6,1,344204,344204,344205,0,1,5
98316,1,3,344205,344205,344208,0,3,0
98317,5,2,344210,344210,344212,0,2,2
98318,3,1,344213,344213,344214,0,1,1
98319,4,3,344217,344217,344220,0,3,3
98320,4,1,344221,344221,344222,0,1,1
98321,2,3,344223,344223,344226,0,3,1
98322,1,2,344224,344226,344228,2,4,0
98323,6,2,344230,344230,344232,0,2,2
98324,2,1,344232,344232,344233,0,1,0
98325,1,2,344233,344233,344235,0,2,0
98326,1,3,344234,344235,344238,1,4,0
98327,1,2,344235,344238,344240,3,5,0
98328,3,2,344238,344240,344242,2,4,0
98329,5,1,344243,344243,344244,0,1,1
98330,5,1,344248,344248,344249,0,1,4
98331,6,3,344254,344254,344257,0,3,5
98332,5,3,344259,344259,344262,0,3,2
98333,2,3,344261,344262,344265,1,4,0
98334,2,1,344263,344265,344266,2,3,0
98335,6,2,344269,344269,344271,0,2,3
98336,6,2,344275,344275,344277,0,2,4
98337,3,2,344278,344278,344280,0,2,1
98338,2,1,344280,344280,344281,0,1,0
98339,3,3,344283,344283,344286,0,3,2
98340,2,3,344285,344286,344289,1,4,0
98341,4,3,344289,344289,344292,0,3,0
98342,3,1,344292,344292,344293,0,1,0
98343,2,1,344294,344294,344295,0,1,1
98344,4,1,344298,344298,344299,0,1,3
98345,1,3,344299,344299,344302,0,3,0
98346,6,3,344305,344305,344308,0,3,3
98347,6,3,344311,344311,344314,0,3,3
98348,2,2,344313,344314,344316,1,3,0
98349,4,2,344317,344317,344319,0,2,1
98350,4,1,344321,344321,344322,0,1,2
98351,5,1,344326,344326,344327,0,1,4
98352,3,2,344329,344329,344331,0,2,2
98353,4,3,344333,344333,344336,0,3,2
98354,1,3,344334,344336,344339,2,5,0
98355,5,3,344339,344339,344342,0,3,0
98356,3,1,344342,344342,344343,0,1,0
98357,3,1,344345,344345,344346,0,1,2
98358,4,1,344349,344349,344350,0,1,3
98359,5,1,344354,344354,344355,0,1,4
98360,2,3,344356,344356,344359,0,3,1
98361,4,2,344360,344360,344362,0,2,1
98362,5,3,344365,344365,344368,0,3,3
98363,5,3,344370,344370,344373,0,3,2
98364,1,3,344371,344373,344376,2,5,0
98365,4,2,344375,344376,344378,1,3,0
98366,1,1,344376,344378,344379,2,3,0
98367,2,1,344378,344379,344380,1,2,0
98368,2,3,344380,344380,344383,0,3,0
98369,6,1,344386,344386,344387,0,1,3
98370,6,3,344392,344392,344395,0,3,5
98371,5,1,344397,344397,344398,0,1,2
98372,1,1,344398,344398,344399,0,1,0
98373,1,3,344399,344399,344402,0,3,0
98374,2,1,344401,344402,344403,1,2,0
98375,3,3,344404,344404,344407,0,3,1
98376,2,2,344406,344407,344409,1,3,0
98377,5,1,344411,344411,344412,0,1,2
98378,2,3,344413,344413,344416,0,3,1
98379,5,3,344418,344418,344421,0,3,2
98380,6,2,344424,344424,344426,0,2,3
98381,2,1,344426,344426,344427,0,1,0
98382,1,3,344427,344427,344430,0,3,0
98383,4,2,344431,344431,344433,0,2,1
98384,4,2,344435,344435,344437,0,2,2
98385,1,3,344436,344437,344440,1,4,0
98386,6,2,344442,344442,344444,0,2,2
98387,5,2,344447,344447,344449,0,2,3
98388,2,3,344449,344449,344452,0,3,0
98389,2,3,344451,344452,344455,1,4,0
98390,1,3,344452,344455,344458,3,6,0
98391,6,3,344458,344458,344461,0,3,0
98392,5,1,344463,344463,344464,0,1,2
98393,5,1,344468,344468,344469,0,1,4
98394,5,2,344473,344473,344475,0,2,4
98395,2,3,344475,344475,344478,0,3,0
98396,6,1,344481,344481,344482,0,1,3
98397,3,2,344484,344484,344486,0,2,2
98398,1,2,344485,344486,344488,1,3,0
98399,5,2,344490,344490,344492,0,2,2
98400,6,1,344496,344496,344497,0,1,4
98401,1,1,344497,344497,344498,0,1,0
98402,4,2,344501,344501,344503,0,2,3
98403,3,2,344504,344504,344506,0,2,1
98404,5,3,344509,344509,344512,0,3,3
98405,4,3,344513,344513,344516,0,3,1
98406,2,3,344515,344516,344519,1,4,0
98407,4,3,344519,344519,344522,0,3,0
98408,4,2,344523,344523,344525,0,2,1
98409,1,3,344524,344525,344528,1,4,0
98410,2,3,344526,344528,344531,2,5,0
98411,2,3,344528,344531,344534,3,6,0
98412,4,2,344532,344534,344536,2,4,0
98413,5,1,344537,344537,344538,0,1,1
98414,2,2,344539,344539,344541,0,2,1
98415,1,3,344540,344541,344544,1,4,0
98416,2,1,344542,344544,344545,2,3,0
98417,3,2,344545,344545,344547,0,2,0
98418,5,3,344550,344550,344553,0,3,3
98419,4,2,344554,344554,344556,0,2,1
98420,6,2,344560,344560,344562,0,2,4
98421,6,3,344566,344566,344569,0,3,4
98422,1,2,344567,344569,344571,2,4,0
98423,5,1,344572,344572,344573,0,1,1
98424,3,3,344575,344575,344578,0,3,2
98425,5,3,344580,344580,344583,0,3,2
98426,2,1,344582,344583,344584,1,2,0
98427,3,1,344585,344585,344586,0,1,1
98428,4,3,344589,344589,344592,0,3,3
98429,5,1,344594,344594,344595,0,1,2
98430,3,3,344597,344597,344600,0,3,2
98431,1,1,344598,344600,344601,2,3,0
98432,4,3,344602,344602,344605,0,3,1
98433,6,1,344608,344608,344609,0,1,3
98434,2,2,344610,344610,344612,0,2,1
98435,2,2,344612,344612,344614,0,2,0
98436,2,1,344614,344614,344615,0,1,0
98437,2,1,344616,344616,344617,0,1,1
98438,4,3,344620,344620,344623,0,3,3
98439,5,3,344625,344625,344628,0,3,2
98440,2,1,344627,344628,344629,1,2,0
98441,2,3,344629,344629,344632,0,3,0
98442,4,2,344633,344633,344635,0,2,1
98443,2,2,344635,344635,344637,0,2,0
98444,1,3,344636,344637,344640,1,4,0
98445,4,2,344640,344640,344642,0,2,0
98446,6,2,344646,344646,344648,0,2,4
98447,6,3,344652,344652,344655,0,3,4
98448,5,3,344657,344657,344660,0,3,2
98449,6,2,344663,344663,344665,0,2,3
98450,1,3,344664,344665,344668,1,4,0
98451,4,2,344668,344668,344670,0,2,0
98452,3,2,344671,344671,344673,0,2,1
98453,1,1,344672,344673,344674,1,2,0
98454,6,1,344678,344678,344679,0,1,4
98455,5,3,344683,344683,344686,0,3,4
98456,2,1,344685,344686,344687,1,2,0
98457,5,3,344690,344690,344693,0,3,3
98458,4,1,344694,344694,344695,0,1,1
98459,5,1,344699,344699,344700,0,1,4
98460,6,1,344705,344705,344706,0,1,5
98461,3,1,344708,344708,344709,0,1,2
98462,1,1,344709,344709,344710,0,1,0
98463,3,2,344712,344712,344714,0,2,2
98464,3,1,344715,344715,344716,0,1,1
98465,5,3,344720,344720,344723,0,3,4
98466,1,1,344721,344723,344724,2,3,0
98467,5,2,344726,344726,344728,0,2,2
98468,5,1,344731,344731,344732,0,1,3
98469,1,3,344732,344732,344735,0,3,0
98470,1,1,344733,344735,344736,2,3,0
98471,1,1,344734,344736,344737,2,3,0
98472,4,1,344738,344738,344739,0,1,1
98473,5,3,344743,344743,344746,0,3,4
98474,1,1,344744,344746,344747,2,3,0
98475,2,1,344746,344747,344748,1,2,0
98476,5,2,344751,344751,344753,0,2,3
98477,4,1,344755,344755,344756,0,1,2
98478,4,3,344759,344759,344762,0,3,3
98479,6,3,344765,344765,344768,0,3,3
98480,4,2,344769,344769,344771,0,2,1
98481,5,1,344774,344774,344775,0,1,3
98482,1,3,344775,344775,344778,0,3,0
98483,3,2,344778,344778,344780,0,2,0
98484,6,3,344784,344784,344787,0,3,4
98485,5,1,344789,344789,344790,0,1,2
98486,1,1,344790,344790,344791,0,1,0
98487,2,2,344792,344792,344794,0,2,1
98488,6,3,344798,344798,344801,0,3,4
98489,5,1,344803,344803,344804,0,1,2
98490,5,2,344808,344808,344810,0,2,4
98491,5,2,344813,344813,344815,0,2,3
98492,1,1,344814,344815,344816,1,2,0
98493,4,2,344818,344818,344820,0,2,2
98494,4,2,344822,344822,344824,0,2,2
98495,6,1,344828,344828,344829,0,1,4
98496,3,1,344831,344831,344832,0,1,2
98497,5,2,344836,344836,344838,0,2,4
98498,5,2,344841,344841,344843,0,2,3
98499,3,1,344844,344844,344845,0,1,1
98500,1,3,344845,344845,344848,0,3,0
98501,6,2,344851,344851,344853,0,2,3
98502,3,2,344854,344854,344856,0,2,1
98503,6,1,344860,344860,344861,0,1,4
98504,6,1,344866,344866,344867,0,1,5
98505,2,1,344868,344868,344869,0,1,1
98506,5,1,344873,344873,344874,0,1,4
98507,3,1,344876,344876,344877,0,1,2
98508,2,2,344878,344878,344880,0,2,1
98509,4,3,344882,344882,344885,0,3,2
98510,5,2,344887,344887,344889,0,2,2
98511,3,2,344890,344890,344892,0,2,1
98512,5,2,344895,344895,344897,0,2,3
98513,6,2,344901,344901,344903,0,2,4
98514,3,1,344904,344904,344905,0,1,1
98515,1,1,344905,344905,344906,0,1,0
98516,1,2,344906,344906,344908,0,2,0
98517,6,2,344912,344912,344914,0,2,4
98518,6,2,344918,344918,344920,0,2,4
98519,6,1,344924,344924,344925,0,1,4
98520,3,3,344927,344927,344930,0,3,2
98521,2,2,344929,344930,344932,1,3,0
98522,1,1,344930,344932,344933,2,3,0
98523,1,2,344931,344933,344935,2,4,0
98524,3,1,344934,344935,344936,1,2,0
98525,3,1,344937,344937,344938,0,1,1
98526,2,1,344939,344939,344940,0,1,1
98527,2,1,344941,344941,344942,0,1,1
98528,5,1,344946,344946,344947,0,1,4
98529,5,2,344951,344951,344953,0,2,4
98530,6,1,344957,344957,344958,0,1,4
98531,3,1,344960,344960,344961,0,1,2
98532,6,1,344966,344966,344967,0,1,5
98533,2,2,344968,344968,344970,0,2,1
98534,5,1,344973,344973,344974,0,1,3
98535,6,1,344979,344979,344980,0,1,5
98536,5,3,344984,344984,344987,0,3,4
98537,5,2,344989,344989,344991,0,2,2
98538,3,1,344992,344992,344993,0,1,1
98539,6,1,344998,344998,344999,0,1,5
98540,1,1,344999,344999,345000,0,1,0
98541,5,3,345004,345004,345007,0,3,4
98542,6,2,345010,345010,345012,0,2,3
98543,2,2,345012,345012,345014,0,2,0
98544,5,2,345017,345017,345019,0,2,3
98545,5,2,345022,345022,345024,0,2,3
98546,3,3,345025,345025,345028,0,3,1
98547,6,2,345031,345031,345033,0,2,3
98548,6,1,345037,345037,345038,0,1,4
98549,6,3,345043,345043,345046,0,3,5
98550,3,1,345046,345046,345047,0,1,0
98551,6,2,345052,345052,345054,0,2,5
98552,3,3,345055,345055,345058,0,3,1
98553,4,3,345059,345059,345062,0,3,1
98554,2,3,345061,345062,345065,1,4,0
98555,6,2,345067,345067,345069,0,2,2
98556,6,3,345073,345073,345076,0,3,4
98557,2,2,345075,345076,345078,1,3,0
98558,4,2,345079,345079,345081,0,2,1
98559,4,3,345083,345083,345086,0,3,2
98560,6,3,345089,345089,345092,0,3,3
98561,3,2,345092,345092,345094,0,2,0
98562,3,3,345095,345095,345098,0,3,1
98563,2,2,345097,345098,345100,1,3,0
98564,2,1,345099,345100,345101,1,2,0
98565,2,1,345101,345101,345102,0,1,0
98566,6,3,345107,345107,345110,0,3,5
98567,3,1,345110,345110,345111,0,1,0
98568,5,1,345115,345115,345116,0,1,4
98569,4,2,345119,345119,345121,0,2,3
98570,1,1,345120,345121,345122,1,2,0
98571,6,3,345126,345126,345129,0,3,4
98572,5,3,345131,345131,345134,0,3,2
98573,1,2,345132,345134,345136,2,4,0
98574,1,1,345133,345136,345137,3,4,0
98575,3,2,345136,345137,345139,1,3,0
98576,3,3,345139,345139,345142,0,3,0
98577,2,3,345141,345142,345145,1,4,0
98578,1,3,345142,345145,345148,3,6,0
98579,3,2,345145,345148,345150,3,5,0
98580,2,3,345147,345150,345153,3,6,0
98581,5,2,345152,345153,345155,1,3,0
98582,4,2,345156,345156,345158,0,2,1
98583,5,2,345161,345161,345163,0,2,3
98584,3,1,345164,345164,345165,0,1,1
98585,6,2,345170,345170,345172,0,2,5
98586,3,3,345173,345173,345176,0,3,1
98587,5,2,345178,345178,345180,0,2,2
98588,4,2,345182,345182,345184,0,2,2
98589,5,1,345187,345187,345188,0,1,3
98590,4,2,345191,345191,345193,0,2,3
98591,2,1,345193,345193,345194,0,1,0
98592,3,3,345196,345196,345199,0,3,2
98593,2,1,345198,345199,345200,1,2,0
98594,1,3,345199,345200,345203,1,4,0
98595,2,3,345201,345203,345206,2,5,0
98596,5,1,345206,345206,345207,0,1,0
98597,5,2,345211,345211,345213,0,2,4
98598,1,1,345212,345213,345214,1,2,0
98599,4,3,345216,345216,345219,0,3,2
98600,4,1,345220,345220,345221,0,1,1
98601,2,3,345222,345222,345225,0,3,1
98602,4,2,345226,345226,345228,0,2,1
98603,4,1,345230,345230,345231,0,1,2
98604,3,3,345233,345233,345236,0,3,2
98605,4,1,345237,345237,345238,0,1,1
98606,1,2,345238,345238,345240,0,2,0
98607,4,1,345242,345242,345243,0,1,2
98608,2,2,345244,345244,345246,0,2,1
98609,3,2,345247,345247,345249,0,2,1
98610,1,1,345248,345249,345250,1,2,0
98611,4,3,345252,345252,345255,0,3,2
98612,5,1,345257,345257,345258,0,1,2
98613,4,3,345261,345261,345264,0,3,3
98614,3,2,345264,345264,345266,0,2,0
98615,2,2,345266,345266,345268,0,2,0
98616,5,3,345271,345271,345274,0,3,3
98617,6,2,345277,345277,345279,0,2,3
98618,2,2,345279,345279,345281,0,2,0
98619,6,3,345285,345285,345288,0,3,4
98620,4,3,345289,345289,345292,0,3,1
98621,4,3,345293,345293,345296,0,3,1
98622,2,1,345295,345296,345297,1,2,0
98623,1,1,345296,345297,345298,1,2,0
98624,6,2,345302,345302,345304,0,2,4
98625,1,2,345303,345304,345306,1,3,0
98626,6,1,345309,345309,345310,0,1,3
98627,1,3,345310,345310,345313,0,3,0
98628,6,3,345316,345316,345319,0,3,3
98629,6,2,345322,345322,345324,0,2,3
98630,6,1,345328,345328,345329,0,1,4
98631,3,3,345331,345331,345334,0,3,2
98632,4,1,345335,345335,345336,0,1,1
98633,4,2,345339,345339,345341,0,2,3
98634,4,3,345343,345343,345346,0,3,2
98635,1,1,345344,345346,345347,2,3,0
98636,1,1,345345,345347,345348,2,3,0
98637,5,2,345350,345350,345352,0,2,2
98638,3,1,345353,345353,345354,0,1,1
98639,3,3,345356,345356,345359,0,3,2
98640,1,3,345357,345359,345362,2,5,0
98641,4,1,345361,345362,345363,1,2,0
98642,1,1,345362,345363,345364,1,2,0
98643,5,2,345367,345367,345369,0,2,3
98644,3,1,345370,345370,345371,0,1,1
98645,6,3,345376,345376,345379,0,3,5
98646,4,1,345380,345380,345381,0,1,1
98647,6,2,345386,345386,345388,0,2,5
98648,2,3,345388,345388,345391,0,3,0
98649,4,3,345392,345392,345395,0,3,1
98650,1,1,345393,345395,345396,2,3,0
98651,2,3,345395,345396,345399,1,4,0
98652,4,1,345399,345399,345400,0,1,0
98653,1,3,345400,345400,345403,0,3,0
98654,2,1,345402,345403,345404,1,2,0
98655,3,1,345405,345405,345406,0,1,1
98656,1,3,345406,345406,345409,0,3,0
98657,1,1,345407,345409,345410,2,3,0
98658,4,1,345411,345411,345412,0,1,1
98659,1,2,345412,345412,345414,0,2,0
98660,2,1,345414,345414,345415,0,1,0
98661,4,3,345418,345418,345421,0,3,3
98662,4,1,345422,345422,345423,0,1,1
98663,4,1,345426,345426,345427,0,1,3
98664,5,2,345431,345431,345433,0,2,4
98665,2,3,345433,345433,345436,0,3,0
98666,6,2,345439,345439,345441,0,2,3
98667,4,3,345443,345443,345446,0,3,2
98668,2,1,345445,345446,345447,1,2,0
98669,2,1,345447,345447,345448,0,1,0
98670,3,2,345450,345450,345452,0,2,2
98671,5,3,345455,345455,345458,0,3,3
98672,5,1,345460,345460,345461,0,1,2
98673,2,1,345462,345462,345463,0,1,1
98674,1,3,345463,345463,345466,0,3,0
98675,5,3,345468,345468,345471,0,3,2
98676,2,3,345470,345471,345474,1,4,0
98677,3,2,345473,345474,345476,1,3,0
98678,3,1,345476,345476,345477,0,1,0
98679,6,2,345482,345482,345484,0,2,5
98680,2,1,345484,345484,345485,0,1,0
98681,4,1,345488,345488,345489,0,1,3
98682,1,1,345489,345489,345490,0,1,0
98683,6,1,345495,345495,345496,0,1,5
98684,5,2,345500,345500,345502,0,2,4
98685,6,3,345506,345506,345509,0,3,4
98686,4,2,345510,345510,345512,0,2,1
98687,3,1,345513,345513,345514,0,1,1
98688,1,2,345514,345514,345516,0,2,0
98689,4,2,345518,345518,345520,0,2,2
98690,3,1,345521,345521,345522,0,1,1
98691,3,2,345524,345524,345526,0,2,2
98692,1,2,345525,345526,345528,1,3,0
98693,4,2,345529,345529,345531,0,2,1
98694,2,2,345531,345531,345533,0,2,0
98695,3,2,345534,345534,345536,0,2,1
98696,1,3,345535,345536,345539,1,4,0
98697,5,1,345540,345540,345541,0,1,1
98698,4,2,345544,345544,345546,0,2,3
98699,6,2,345550,345550,345552,0,2,4
98700,3,1,345553,345553,345554,0,1,1
98701,4,3,345557,345557,345560,0,3,3
98702,1,1,345558,345560,345561,2,3,0
98703,4,2,345562,345562,345564,0,2,1
98704,5,1,345567,345567,345568,0,1,3
98705,6,2,345573,345573,345575,0,2,5
98706,1,3,345574,345575,345578,1,4,0
98707,4,3,345578,345578,345581,0,3,0
98708,4,3,345582,345582,345585,0,3,1
98709,6,2,345588,345588,345590,0,2,3
98710,1,1,345589,345590,345591,1,2,0
98711,5,1,345594,345594,345595,0,1,3
98712,2,1,345596,345596,345597,0,1,1
98713,1,3,345597,345597,345600,0,3,0
98714,1,1,345598,345600,345601,2,3,0
98715,4,1,345602,345602,345603,0,1,1
98716,4,3,345606,345606,345609,0,3,3
98717,3,1,345609,345609,345610,0,1,0
98718,1,2,345610,345610,345612,0,2,0
98719,6,3,345616,345616,345619,0,3,4
98720,5,3,345621,345621,345624,0,3,2
98721,6,3,345627,345627,345630,0,3,3
98722,1,2,345628,345630,345632,2,4,0
98723,1,3,345629,345632,345635,3,6,0
98724,3,2,345632,345635,345637,3,5,0
98725,1,2,345633,345637,345639,4,6,0
98726,4,1,345637,345639,345640,2,3,0
98727,5,2,345642,345642,345644,0,2,2
98728,4,2,345646,345646,345648,0,2,2
98729,6,1,345652,345652,345653,0,1,4
98730,6,3,345658,345658,345661,0,3,5
98731,2,2,345660,345661,345663,1,3,0
98732,6,1,345666,345666,345667,0,1,3
98733,6,2,345672,345672,345674,0,2,5
98734,3,1,345675,345675,345676,0,1,1
98735,2,3,345677,345677,345680,0,3,1
98736,4,3,345681,345681,345684,0,3,1
98737,2,3,345683,345684,345687,1,4,0
98738,6,1,345689,345689,345690,0,1,2
98739,2,1,345691,345691,345692,0,1,1
98740,1,2,345692,345692,345694,0,2,0
98741,4,2,345696,345696,345698,0,2,2
98742,4,1,345700,345700,345701,0,1,2
98743,5,3,345705,345705,345708,0,3,4
98744,1,1,345706,345708,345709,2,3,0
98745,2,1,345708,345709,345710,1,2,0
98746,4,3,345712,345712,345715,0,3,2
98747,2,2,345714,345715,345717,1,3,0
98748,1,3,345715,345717,345720,2,5,0
98749,1,3,345716,345720,345723,4,7,0
98750,3,1,345719,345723,345724,4,5,0
98751,4,2,345723,345724,345726,1,3,0
98752,5,2,345728,345728,345730,0,2,2
98753,5,2,345733,345733,345735,0,2,3
98754,5,1,345738,345738,345739,0,1,3
98755,4,2,345742,345742,345744,0,2,3
98756,5,3,345747,345747,345750,0,3,3
98757,5,3,345752,345752,345755,0,3,2
98758,3,2,345755,345755,345757,0,2,0
98759,5,2,345760,345760,345762,0,2,3
98760,2,1,345762,345762,345763,0,1,0
98761,3,2,345765,345765,345767,0,2,2
98762,3,1,345768,345768,345769,0,1,1
98763,6,2,345774,345774,345776,0,2,5
98764,3,2,345777,345777,345779,0,2,1
98765,1,3,345778,345779,345782,1,4,0
98766,4,1,345782,345782,345783,0,1,0
98767,4,1,345786,345786,345787,0,1,3
98768,3,1,345789,345789,345790,0,1,2
98769,5,1,345794,345794,345795,0,1,4
98770,3,1,345797,345797,345798,0,1,2
98771,6,3,345803,345803,345806,0,3,5
98772,5,1,345808,345808,345809,0,1,2
98773,3,2,345811,345811,345813,0,2,2
98774,2,2,345813,345813,345815,0,2,0
98775,3,1,345816,345816,345817,0,1,1
98776,5,1,345821,345821,345822,0,1,4
98777,4,1,345825,345825,345826,0,1,3
98778,5,2,345830,345830,345832,0,2,4
98779,5,2,345835,345835,345837,0,2,3
98780,3,3,345838,345838,345841,0,3,1
98781,1,1,345839,345841,345842,2,3,0
98782,2,1,345841,345842,345843,1,2,0
98783,2,2,345843,345843,345845,0,2,0
98784,6,1,345849,345849,345850,0,1,4
98785,3,3,345852,345852,345855,0,3,2
98786,1,2,345853,345855,345857,2,4,0
98787,5,1,345858,345858,345859,0,1,1
98788,3,1,345861,345861,345862,0,1,2
98789,1,2,345862,345862,345864,0,2,0
98790,5,2,345867,345867,345869,0,2,3
98791,4,1,345871,345871,345872,0,1,2
98792,3,3,345874,345874,345877,0,3,2
98793,3,2,345877,345877,345879,0,2,0
98794,2,2,345879,345879,345881,0,2,0
98795,1,3,345880,345881,345884,1,4,0
98796,2,2,345882,345884,345886,2,4,0
98797,2,3,345884,345886,345889,2,5,0
98798,1,2,345885,345889,345891,4,6,0
98799,4,1,345889,345891,345892,2,3,0
98800,1,1,345890,345892,345893,2,3,0
98801,3,3,345893,345893,345896,0,3,0
98802,6,2,345899,345899,345901,0,2,3
98803,3,3,345902,345902,345905,0,3,1
98804,4,2,345906,345906,345908,0,2,1
98805,3,2,345909,345909,345911,0,2,1
98806,2,3,345911,345911,345914,0,3,0
98807,5,2,345916,345916,345918,0,2,2
98808,3,1,345919,345919,345920,0,1,1
98809,6,1,345925,345925,345926,0,1,5
98810,3,1,345928,345928,345929,0,1,2
98811,4,2,345932,345932,345934,0,2,3
98812,1,1,345933,345934,345935,1,2,0
98813,6,1,345939,345939,345940,0,1,4
98814,3,3,345942,345942,345945,0,3,2
98815,3,3,345945,345945,345948,0,3,0
98816,1,3,345946,345948,345951,2,5,0
98817,4,2,345950,345951,345953,1,3,0
98818,1,3,345951,345953,345956,2,5,0
98819,5,3,345956,345956,345959,0,3,0
98820,3,3,345959,345959,345962,0,3,0
98821,3,1,345962,345962,345963,0,1,0
98822,2,3,345964,345964,345967,0,3,1
98823,1,1,345965,345967,345968,2,3,0
98824,5,2,345970,345970,345972,0,2,2
98825,5,1,345975,345975,345976,0,1,3
98826,2,2,345977,345977,345979,0,2,1
98827,6,2,345983,345983,345985,0,2,4
98828,1,2,345984,345985,345987,1,3,0
98829,2,1,345986,345987,345988,1,2,0
98830,5,1,345991,345991,345992,0,1,3
98831,5,3,345996,345996,345999,0,3,4
98832,6,1,346002,346002,346003,0,1,3
98833,3,1,346005,346005,346006,0,1,2
98834,4,1,346009,346009,346010,0,1,3
98835,6,3,346015,346015,346018,0,3,5
98836,4,3,346019,346019,346022,0,3,1
98837,1,3,346020,346022,346025,2,5,0
98838,5,1,346025,346025,346026,0,1,0
98839,4,3,346029,346029,346032,0,3,3
98840,1,2,346030,346032,346034,2,4,0
98841,5,1,346035,346035,346036,0,1,1
98842,6,1,346041,346041,346042,0,1,5
98843,1,3,346042,346042,346045,0,3,0
98844,6,3,346048,346048,346051,0,3,3
98845,3,3,346051,346051,346054,0,3,0
98846,3,2,346054,346054,346056,0,2,0
98847,2,2,346056,346056,346058,0,2,0
98848,1,1,346057,346058,346059,1,2,0
98849,2,1,346059,346059,346060,0,1,0
98850,1,3,346060,346060,346063,0,3,0
98851,2,3,346062,346063,346066,1,4,0
98852,5,3,346067,346067,346070,0,3,1
98853,6,1,346073,346073,346074,0,1,3
98854,2,3,346075,346075,346078,0,3,1
98855,5,2,346080,346080,346082,0,2,2
98856,5,2,346085,346085,346087,0,2,3
98857,2,3,346087,346087,346090,0,3,0
98858,6,2,346093,346093,346095,0,2,3
98859,6,3,346099,346099,346102,0,3,4
98860,4,2,346103,346103,346105,0,2,1
98861,5,3,346108,346108,346111,0,3,3
98862,2,3,346110,346111,346114,1,4,0
98863,1,1,346111,346114,346115,3,4,0
98864,5,2,346116,346116,346118,0,2,1
98865,3,3,346119,346119,346122,0,3,1
98866,4,1,346123,346123,346124,0,1,1
98867,2,1,346125,346125,346126,0,1,1
98868,3,3,346128,346128,346131,0,3,2
98869,4,2,346132,346132,346134,0,2,1
98870,3,2,346135,346135,346137,0,2,1
98871,2,1,346137,346137,346138,0,1,0
98872,5,3,346142,346142,346145,0,3,4
98873,2,3,346144,346145,346148,1,4,0
98874,1,1,346145,346148,346149,3,4,0
98875,1,1,346146,346149,346150,3,4,0
98876,3,2,346149,346150,346152,1,3,0
98877,3,1,346152,346152,346153,0,1,0
98878,4,1,346156,346156,346157,0,1,3
98879,6,3,346162,346162,346165,0,3,5
98880,1,3,346163,346165,346168,2,5,0
98881,2,1,346165,346168,346169,3,4,0
98882,1,2,346166,346169,346171,3,5,0
98883,2,1,346168,346171,346172,3,4,0
98884,3,3,346171,346172,346175,1,4,0
98885,3,1,346174,346175,346176,1,2,0
98886,1,3,346175,346176,346179,1,4,0
98887,6,3,346181,346181,346184,0,3,2
98888,5,2,346186,346186,346188,0,2,2
98889,2,2,346188,346188,346190,0,2,0
98890,5,3,346193,346193,346196,0,3,3
98891,2,2,346195,346196,346198,1,3,0
98892,1,1,346196,346198,346199,2,3,0
98893,5,3,346201,346201,346204,0,3,2
98894,3,2,346204,346204,346206,0,2,0
98895,4,3,346208,346208,346211,0,3,2
98896,3,1,346211,346211,346212,0,1,0
98897,4,2,346215,346215,346217,0,2,3
98898,1,2,346216,346217,346219,1,3,0
98899,2,1,346218,346219,346220,1,2,0
98900,6,3,346224,346224,346227,0,3,4
98901,5,1,346229,346229,346230,0,1,2
98902,3,1,346232,346232,346233,0,1,2
98903,1,3,346233,346233,346236,0,3,0
98904,5,2,346238,346238,346240,0,2,2
98905,2,2,346240,346240,346242,0,2,0
98906,3,1,346243,346243,346244,0,1,1
98907,1,1,346244,346244,346245,0,1,0
98908,2,1,346246,346246,346247,0,1,1
98909,6,2,346252,346252,346254,0,2,5
98910,1,3,346253,346254,346257,1,4,0
98911,1,3,346254,346257,346260,3,6,0
98912,3,2,346257,346260,346262,3,5,0
98913,3,3,346260,346262,346265,2,5,0
98914,4,3,346264,346265,346268,1,4,0
98915,6,1,346270,346270,346271,0,1,2
98916,4,1,346274,346274,346275,0,1,3
98917,4,1,346278,346278,346279,0,1,3
98918,4,3,346282,346282,346285,0,3,3
98919,5,2,346287,346287,346289,0,2,2
98920,1,2,346288,346289,346291,1,3,0
98921,2,3,346290,346291,346294,1,4,0
98922,3,2,346293,346294,346296,1,3,0
98923,2,3,346295,346296,346299,1,4,0
98924,1,3,346296,346299,346302,3,6,0
98925,6,3,346302,346302,346305,0,3,0
98926,5,3,346307,346307,346310,0,3,2
98927,3,3,346310,346310,346313,0,3,0
98928,3,3,346313,346313,346316,0,3,0
98929,5,3,346318,346318,346321,0,3,2
98930,3,1,346321,346321,346322,0,1,0
98931,4,1,346325,346325,346326,0,1,3
98932,2,1,346327,346327,346328,0,1,1
98933,5,3,346332,346332,346335,0,3,4
98934,5,1,346337,346337,346338,0,1,2
98935,1,3,346338,346338,346341,0,3,0
98936,6,2,346344,346344,346346,0,2,3
98937,2,3,346346,346346,346349,0,3,0
98938,6,2,346352,346352,346354,0,2,3
98939,5,3,346357,346357,346360,0,3,3
98940,4,2,346361,346361,346363,0,2,1
98941,1,1,346362,346363,346364,1,2,0
98942,1,3,346363,346364,346367,1,4,0
98943,5,2,346368,346368,346370,0,2,1
98944,4,2,346372,346372,346374,0,2,2
98945,5,3,346377,346377,346380,0,3,3
98946,5,1,346382,346382,346383,0,1,2
98947,5,2,346387,346387,346389,0,2,4
98948,6,2,346393,346393,346395,0,2,4
98949,3,1,346396,346396,346397,0,1,1
98950,4,2,346400,346400,346402,0,2,3
98951,1,1,346401,346402,346403,1,2,0
98952,6,1,346407,346407,346408,0,1,4
98953,3,1,346410,346410,346411,0,1,2
98954,6,3,346416,346416,346419,0,3,5
98955,6,1,346422,346422,346423,0,1,3
98956,4,2,346426,346426,346428,0,2,3
98957,4,3,346430,346430,346433,0,3,2
98958,5,3,346435,346435,346438,0,3,2
98959,5,1,346440,346440,346441,0,1,2
98960,2,1,346442,346442,346443,0,1,1
98961,4,3,346446,346446,346449,0,3,3
98962,5,3,346451,346451,346454,0,3,2
98963,3,1,346454,346454,346455,0,1,0
98964,2,2,346456,346456,346458,0,2,1
98965,6,3,346462,346462,346465,0,3,4
98966,1,2,346463,346465,346467,2,4,0
98967,6,1,346469,346469,346470,0,1,2
98968,2,2,346471,346471,346473,0,2,1
98969,5,1,346476,346476,346477,0,1,3
98970,5,2,346481,346481,346483,0,2,4
98971,2,2,346483,346483,346485,0,2,0
98972,1,2,346484,346485,346487,1,3,0
98973,2,1,346486,346487,346488,1,2,0
98974,2,3,346488,346488,346491,0,3,0
98975,4,1,346492,346492,346493,0,1,1
98976,5,3,346497,346497,346500,0,3,4
98977,4,2,346501,346501,346503,0,2,1
98978,2,2,346503,346503,346505,0,2,0
98979,6,1,346509,346509,346510,0,1,4
98980,5,3,346514,346514,346517,0,3,4
98981,4,2,346518,346518,346520,0,2,1
98982,5,1,346523,346523,346524,0,1,3
98983,4,2,346527,346527,346529,0,2,3
98984,3,3,346530,346530,346533,0,3,1
98985,1,3,346531,346533,346536,2,5,0
98986,4,2,346535,346536,346538,1,3,0
98987,1,1,346536,346538,346539,2,3,0
98988,1,3,346537,346539,346542,2,5,0
98989,4,3,346541,346542,346545,1,4,0
98990,1,2,346542,346545,346547,3,5,0
98991,4,1,346546,346547,346548,1,2,0
98992,1,2,346547,346548,346550,1,3,0
98993,1,3,346548,346550,346553,2,5,0
98994,3,2,346551,346553,346555,2,4,0
98995,4,1,346555,346555,346556,0,1,0
98996,1,1,346556,346556,346557,0,1,0
98997,2,3,346558,346558,346561,0,3,1
98998,1,1,346559,346561,346562,2,3,0
98999,6,1,346565,346565,346566,0,1,3
99000,3,3,346568,346568,346571,0,3,2
99001,1,2,346569,346571,346573,2,4,0
99002,2,1,346571,346573,346574,2,3,0
99003,2,2,346573,346574,346576,1,3,0
99004,3,3,346576,346576,346579,0,3,0
99005,4,1,346580,346580,346581,0,1,1
99006,4,3,346584,346584,346587,0,3,3
99007,3,3,346587,346587,346590,0,3,0
99008,3,1,346590,346590,346591,0,1,0
99009,4,3,346594,346594,346597,0,3,3
99010,3,2,346597,346597,346599,0,2,0
99011,6,3,346603,346603,346606,0,3,4
99012,6,2,346609,346609,346611,0,2,3
99013,6,2,346615,346615,346617,0,2,4
99014,1,1,346616,346617,346618,1,2,0
99015,1,3,346617,346618,346621,1,4,0
99016,2,2,346619,346621,346623,2,4,0
99017,3,1,346622,346623,346624,1,2,0
99018,2,1,346624,346624,346625,0,1,0
99019,3,3,346627,346627,346630,0,3,2
99020,6,3,346633,346633,346636,0,3,3
99021,1,2,346634,346636,346638,2,4,0
99022,2,1,346636,346638,346639,2,3,0
99023,1,3,346637,346639,346642,2,5,0
99024,6,3,346643,346643,346646,0,3,1
99025,4,3,346647,346647,346650,0,3,1
99026,3,1,346650,346650,346651,0,1,0
99027,3,2,346653,346653,346655,0,2,2
99028,5,2,346658,346658,346660,0,2,3
99029,2,2,346660,346660,346662,0,2,0
99030,3,1,346663,346663,346664,0,1,1
99031,3,2,346666,346666,346668,0,2,2
99032,1,1,346667,346668,346669,1,2,0
99033,2,1,346669,346669,346670,0,1,0
99034,3,2,346672,346672,346674,0,2,2
99035,1,1,346673,346674,346675,1,2,0
99036,2,2,346675,346675,346677,0,2,0
99037,6,2,346681,346681,346683,0,2,4
99038,4,3,346685,346685,346688,0,3,2
99039,6,2,346691,346691,346693,0,2,3
99040,1,2,346692,346693,346695,1,3,0
99041,2,1,346694,346695,346696,1,2,0
99042,3,2,346697,346697,346699,0,2,1
99043,3,1,346700,346700,346701,0,1,1
99044,4,2,346704,346704,346706,0,2,3
99045,3,3,346707,346707,346710,0,3,1
99046,5,1,346712,346712,346713,0,1,2
99047,4,2,346716,346716,346718,0,2,3
99048,4,2,346720,346720,346722,0,2,2
99049,3,1,346723,346723,346724,0,1,1
99050,1,3,346724,346724,346727,0,3,0
99051,1,2,346725,346727,346729,2,4,0
99052,6,1,346731,346731,346732,0,1,2
99053,2,3,346733,346733,346736,0,3,1
99054,4,3,346737,346737,346740,0,3,1
99055,1,3,346738,346740,346743,2,5,0
99056,3,1,346741,346743,346744,2,3,0
99057,1,3,346742,346744,346747,2,5,0
99058,5,2,346747,346747,346749,0,2,0
99059,6,3,346753,346753,346756,0,3,4
99060,3,1,346756,346756,346757,0,1,0
99061,1,3,346757,346757,346760,0,3,0
99062,6,2,346763,346763,346765,0,2,3
99063,1,1,346764,346765,346766,1,2,0
99064,2,2,346766,346766,346768,0,2,0
99065,5,2,346771,346771,346773,0,2,3
99066,4,2,346775,346775,346777,0,2,2
99067,6,2,346781,346781,346783,0,2,4
99068,5,1,346786,346786,346787,0,1,3
99069,6,2,346792,346792,346794,0,2,5
99070,5,1,346797,346797,346798,0,1,3
99071,2,3,346799,346799,346802,0,3,1
99072,2,3,346801,346802,346805,1,4,0
99073,1,2,346802,346805,346807,3,5,0
99074,6,2,346808,346808,346810,0,2,1
99075,4,3,346812,346812,346815,0,3,2
99076,2,3,346814,346815,346818,1,4,0
99077,2,2,346816,346818,346820,2,4,0
99078,6,3,346822,346822,346825,0,3,2
99079,5,2,346827,346827,346829,0,2,2
99080,3,3,346830,346830,346833,0,3,1
99081,1,1,346831,346833,346834,2,3,0
99082,2,1,346833,346834,346835,1,2,0
99083,5,1,346838,346838,346839,0,1,3
99084,2,1,346840,346840,346841,0,1,1
99085,1,3,346841,346841,346844,0,3,0
99086,6,2,346847,346847,346849,0,2,3
99087,1,3,346848,346849,346852,1,4,0
99088,4,1,346852,346852,346853,0,1,0
99089,2,2,346854,346854,346856,0,2,1
99090,2,1,346856,346856,346857,0,1,0
99091,6,3,346862,346862,346865,0,3,5
99092,1,2,346863,346865,346867,2,4,0
99093,5,1,346868,346868,346869,0,1,1
99094,6,3,346874,346874,346877,0,3,5
99095,5,2,346879,346879,346881,0,2,2
99096,6,3,346885,346885,346888,0,3,4
99097,1,2,346886,346888,346890,2,4,0
99098,4,3,346890,346890,346893,0,3,0
99099,6,2,346896,346896,346898,0,2,3
99100,2,2,346898,346898,346900,0,2,0
99101,5,2,346903,346903,346905,0,2,3
99102,1,1,346904,346905,346906,1,2,0
99103,4,3,346908,346908,346911,0,3,2
99104,1,1,346909,346911,346912,2,3,0
99105,1,1,346910,346912,346913,2,3,0
99106,5,3,346915,346915,346918,0,3,2
99107,4,2,346919,346919,346921,0,2,1
99108,3,1,346922,346922,346923,0,1,1
99109,5,1,346927,346927,346928,0,1,4
99110,3,2,346930,346930,346932,0,2,2
99111,3,2,346933,346933,346935,0,2,1
99112,4,2,346937,346937,346939,0,2,2
99113,4,3,346941,346941,346944,0,3,2
99114,3,3,346944,346944,346947,0,3,0
99115,4,1,346948,346948,346949,0,1,1
99116,6,2,346954,346954,346956,0,2,5
99117,6,1,346960,346960,346961,0,1,4
99118,2,2,346962,346962,346964,0,2,1
99119,6,2,346968,346968,346970,0,2,4
99120,3,2,346971,346971,346973,0,2,1
99121,3,2,346974,346974,346976,0,2,1
99122,6,2,346980,346980,346982,0,2,4
99123,4,2,346984,346984,346986,0,2,2
99124,4,2,346988,346988,346990,0,2,2
99125,5,2,346993,346993,346995,0,2,3
99126,5,1,346998,346998,346999,0,1,3
99127,6,1,347004,347004,347005,0,1,5
99128,3,3,347007,347007,347010,0,3,2
99129,3,3,347010,347010,347013,0,3,0
99130,6,1,347016,347016,347017,0,1,3
99131,3,3,347019,347019,347022,0,3,2
99132,1,3,347020,347022,347025,2,5,0
99133,4,2,347024,347025,347027,1,3,0
99134,5,1,347029,347029,347030,0,1,2
99135,1,3,347030,347030,347033,0,3,0
99136,1,2,347031,347033,347035,2,4,0
99137,5,1,347036,347036,347037,0,1,1
99138,1,2,347037,347037,347039,0,2,0
99139,4,3,347041,347041,347044,0,3,2
99140,4,2,347045,347045,347047,0,2,1
99141,1,3,347046,347047,347050,1,4,0
99142,6,3,347052,347052,347055,0,3,2
99143,2,1,347054,347055,347056,1,2,0
99144,5,3,347059,347059,347062,0,3,3
99145,4,2,347063,347063,347065,0,2,1
99146,5,2,347068,347068,347070,0,2,3
99147,6,1,347074,347074,347075,0,1,4
99148,4,2,347078,347078,347080,0,2,3
99149,2,2,347080,347080,347082,0,2,0
99150,1,3,347081,347082,347085,1,4,0
99151,3,2,347084,347085,347087,1,3,0
99152,5,3,347089,347089,347092,0,3,2
99153,4,2,347093,347093,347095,0,2,1
99154,5,1,347098,347098,347099,0,1,3
99155,5,2,347103,347103,347105,0,2,4
99156,3,2,347106,347106,347108,0,2,1
99157,2,1,347108,347108,347109,0,1,0
99158,5,2,347113,347113,347115,0,2,4
99159,2,1,347115,347115,347116,0,1,0
99160,1,3,347116,347116,347119,0,3,0
99161,2,2,347118,347119,347121,1,3,0
99162,6,1,347124,347124,347125,0,1,3
99163,4,2,347128,347128,347130,0,2,3
99164,4,3,347132,347132,347135,0,3,2
99165,3,2,347135,347135,347137,0,2,0
99166,3,3,347138,347138,347141,0,3,1
99167,1,1,347139,347141,347142,2,3,0
99168,6,2,347145,347145,347147,0,2,3
99169,1,3,347146,347147,347150,1,4,0
99170,2,2,347148,347150,347152,2,4,0
99171,5,3,347153,347153,347156,0,3,1
99172,2,2,347155,347156,347158,1,3,0
99173,5,2,347160,347160,347162,0,2,2
99174,4,2,347164,347164,347166,0,2,2
99175,4,2,347168,347168,347170,0,2,2
99176,2,1,347170,347170,347171,0,1,0
99177,4,1,347174,347174,347175,0,1,3
99178,4,3,347178,347178,347181,0,3,3
99179,2,2,347180,347181,347183,1,3,0
99180,3,2,347183,347183,347185,0,2,0
99181,6,1,347189,347189,347190,0,1,4
99182,4,1,347193,347193,347194,0,1,3
99183,4,3,347197,347197,347200,0,3,3
99184,6,2,347203,347203,347205,0,2,3
99185,6,3,347209,347209,347212,0,3,4
99186,6,2,347215,347215,347217,0,2,3
99187,1,1,347216,347217,347218,1,2,0
99188,5,3,347221,347221,347224,0,3,3
99189,2,3,347223,347224,347227,1,4,0
99190,1,2,347224,347227,347229,3,5,0
99191,2,2,347226,347229,347231,3,5,0
99192,6,2,347232,347232,347234,0,2,1
99193,5,3,347237,347237,347240,0,3,3
99194,6,1,347243,347243,347244,0,1,3
99195,6,1,347249,347249,347250,0,1,5
99196,1,1,347250,347250,347251,0,1,0
99197,6,3,347256,347256,347259,0,3,5
99198,5,3,347261,347261,347264,0,3,2
99199,2,3,347263,347264,347267,1,4,0
99200,4,1,347267,347267,347268,0,1,0
99201,5,1,347272,347272,347273,0,1,4
99202,5,3,347277,347277,347280,0,3,4
99203,1,2,347278,347280,347282,2,4,0
99204,3,3,347281,347282,347285,1,4,0
99205,2,2,347283,347285,347287,2,4,0
99206,5,2,347288,347288,347290,0,2,1
99207,4,1,347292,347292,347293,0,1,2
99208,4,2,347296,347296,347298,0,2,3
99209,4,2,347300,347300,347302,0,2,2
99210,3,2,347303,347303,347305,0,2,1
99211,2,2,347305,347305,347307,0,2,0
99212,4,2,347309,347309,347311,0,2,2
99213,2,2,347311,347311,347313,0,2,0
99214,3,3,347314,347314,347317,0,3,1
99215,1,1,347315,347317,347318,2,3,0
99216,1,3,347316,347318,347321,2,5,0
99217,1,3,347317,347321,347324,4,7,0
99218,6,2,347323,347324,347326,1,3,0
99219,2,3,347325,347326,347329,1,4,0
99220,1,3,347326,347329,347332,3,6,0
99221,4,3,347330,347332,347335,2,5,0
99222,2,2,347332,347335,347337,3,5,0
99223,5,2,347337,347337,347339,0,2,0
99224,2,1,347339,347339,347340,0,1,0
99225,2,2,347341,347341,347343,0,2,1
99226,4,2,347345,347345,347347,0,2,2
99227,1,3,347346,347347,347350,1,4,0
99228,6,3,347352,347352,347355,0,3,2
99229,1,2,347353,347355,347357,2,4,0
99230,2,3,347355,347357,347360,2,5,0
99231,3,2,347358,347360,347362,2,4,0
99232,3,1,347361,347362,347363,1,2,0
99233,1,3,347362,347363,347366,1,4,0
99234,2,2,347364,347366,347368,2,4,0
99235,6,2,347370,347370,347372,0,2,2
99236,2,1,347372,347372,347373,0,1,0
99237,4,2,347376,347376,347378,0,2,3
99238,2,2,347378,347378,347380,0,2,0
99239,3,3,347381,347381,347384,0,3,1
99240,2,2,347383,347384,347386,1,3,0
99241,6,3,347389,347389,347392,0,3,3
99242,3,1,347392,347392,347393,0,1,0
99243,6,1,347398,347398,347399,0,1,5
99244,1,2,347399,347399,347401,0,2,0
99245,4,3,347403,347403,347406,0,3,2
99246,1,2,347404,347406,347408,2,4,0
99247,4,1,347408,347408,347409,0,1,0
99248,4,1,347412,347412,347413,0,1,3
99249,3,3,347415,347415,347418,0,3,2
99250,3,3,347418,347418,347421,0,3,0
99251,3,3,347421,347421,347424,0,3,0
99252,3,2,347424,347424,347426,0,2,0
99253,2,2,347426,347426,347428,0,2,0
99254,5,3,347431,347431,347434,0,3,3
99255,5,3,347436,347436,347439,0,3,2
99256,6,3,347442,347442,347445,0,3,3
99257,6,3,347448,347448,347451,0,3,3
99258,3,1,347451,347451,347452,0,1,0
99259,6,2,347457,347457,347459,0,2,5
99260,4,2,347461,347461,347463,0,2,2
99261,4,2,347465,347465,347467,0,2,2
99262,2,2,347467,347467,347469,0,2,0
99263,5,3,347472,347472,347475,0,3,3
99264,1,1,347473,347475,347476,2,3,0
99265,4,1,347477,347477,347478,0,1,1
99266,3,3,347480,347480,347483,0,3,2
99267,1,1,347481,347483,347484,2,3,0
99268,6,1,347487,347487,347488,0,1,3
99269,5,1,347492,347492,347493,0,1,4
99270,1,2,347493,347493,347495,0,2,0
99271,4,3,347497,347497,347500,0,3,2
99272,1,1,347498,347500,347501,2,3,0
99273,5,1,347503,347503,347504,0,1,2
99274,5,3,347508,347508,347511,0,3,4
99275,3,1,347511,347511,347512,0,1,0
99276,6,1,347517,347517,347518,0,1,5
99277,5,3,347522,347522,347525,0,3,4
99278,3,1,347525,347525,347526,0,1,0
99279,5,1,347530,347530,347531,0,1,4
99280,6,3,347536,347536,347539,0,3,5
99281,3,1,347539,347539,347540,0,1,0
99282,5,2,347544,347544,347546,0,2,4
99283,2,2,347546,347546,347548,0,2,0
99284,4,1,347550,347550,347551,0,1,2
99285,4,1,347554,347554,347555,0,1,3
99286,6,3,347560,347560,347563,0,3,5
99287,4,1,347564,347564,347565,0,1,1
99288,6,3,347570,347570,347573,0,3,5
99289,4,3,347574,347574,347577,0,3,1
99290,3,1,347577,347577,347578,0,1,0
99291,1,3,347578,347578,347581,0,3,0
99292,5,2,347583,347583,347585,0,2,2
99293,2,1,347585,347585,347586,0,1,0
99294,3,1,347588,347588,347589,0,1,2
99295,5,1,347593,347593,347594,0,1,4
99296,6,2,347599,347599,347601,0,2,5
99297,3,3,347602,347602,347605,0,3,1
99298,6,2,347608,347608,347610,0,2,3
99299,3,3,347611,347611,347614,0,3,1
99300,3,2,347614,347614,347616,0,2,0
99301,4,3,347618,347618,347621,0,3,2
99302,1,1,347619,347621,347622,2,3,0
99303,3,3,347622,347622,347625,0,3,0
99304,5,1,347627,347627,347628,0,1,2
99305,1,3,347628,347628,347631,0,3,0
99306,2,3,347630,347631,347634,1,4,0
99307,4,2,347634,347634,347636,0,2,0
99308,2,3,347636,347636,347639,0,3,0
99309,1,1,347637,347639,347640,2,3,0
99310,4,2,347641,347641,347643,0,2,1
99311,1,2,347642,347643,347645,1,3,0
99312,4,1,347646,347646,347647,0,1,1
99313,2,2,347648,347648,347650,0,2,1
99314,1,3,347649,347650,347653,1,4,0
99315,6,3,347655,347655,347658,0,3,2
99316,1,2,347656,347658,347660,2,4,0
99317,2,2,347658,347660,347662,2,4,0
99318,1,3,347659,347662,347665,3,6,0
99319,3,3,347662,347665,347668,3,6,0
99320,2,3,347664,347668,347671,4,7,0
99321,5,3,347669,347671,347674,2,5,0
99322,2,1,347671,347674,347675,3,4,0
99323,4,3,347675,347675,347678,0,3,0
99324,6,3,347681,347681,347684,0,3,3
99325,5,2,347686,347686,347688,0,2,2
99326,4,3,347690,347690,347693,0,3,2
99327,3,3,347693,347693,347696,0,3,0
99328,3,3,347696,347696,347699,0,3,0
99329,1,1,347697,347699,347700,2,3,0
99330,6,1,347703,347703,347704,0,1,3
99331,1,1,347704,347704,347705,0,1,0
99332,1,1,347705,347705,347706,0,1,0
99333,5,2,347710,347710,347712,0,2,4
99334,2,3,347712,347712,347715,0,3,0
99335,4,1,347716,347716,347717,0,1,1
99336,5,2,347721,347721,347723,0,2,4
99337,1,3,347722,347723,347726,1,4,0
99338,4,3,347726,347726,347729,0,3,0
99339,6,1,347732,347732,347733,0,1,3
99340,6,3,347738,347738,347741,0,3,5
99341,3,3,347741,347741,347744,0,3,0
99342,3,3,347744,347744,347747,0,3,0
99343,5,2,347749,347749,347751,0,2,2
99344,6,1,347755,347755,347756,0,1,4
99345,3,2,347758,347758,347760,0,2,2
99346,3,2,347761,347761,347763,0,2,1
99347,3,3,347764,347764,347767,0,3,1
99348,6,2,347770,347770,347772,0,2,3
99349,3,3,347773,347773,347776,0,3,1
99350,6,3,347779,347779,347782,0,3,3
99351,2,3,347781,347782,347785,1,4,0
99352,1,1,347782,347785,347786,3,4,0
99353,4,3,347786,347786,347789,0,3,0
99354,1,1,347787,347789,347790,2,3,0
99355,2,1,347789,347790,347791,1,2,0
99356,3,2,347792,347792,347794,0,2,1
99357,1,3,347793,347794,347797,1,4,0
99358,3,3,347796,347797,347800,1,4,0
99359,4,2,347800,347800,347802,0,2,0
99360,2,1,347802,347802,347803,0,1,0
99361,6,1,347808,347808,347809,0,1,5
99362,3,2,347811,347811,347813,0,2,2
99363,5,1,347816,347816,347817,0,1,3
99364,4,2,347820,347820,347822,0,2,3
99365,4,2,347824,347824,347826,0,2,2
99366,4,3,347828,347828,347831,0,3,2
99367,4,2,347832,347832,347834,0,2,1
99368,1,3,347833,347834,347837,1,4,0
99369,5,1,347838,347838,347839,0,1,1
99370,5,1,347843,347843,347844,0,1,4
99371,6,3,347849,347849,347852,0,3,5
99372,1,3,347850,347852,347855,2,5,0
99373,6,2,347856,347856,347858,0,2,1
99374,4,2,347860,347860,347862,0,2,2
99375,5,2,347865,347865,347867,0,2,3
99376,5,2,347870,347870,347872,0,2,3
99377,6,3,347876,347876,347879,0,3,4
99378,3,1,347879,347879,347880,0,1,0
99379,2,3,347881,347881,347884,0,3,1
99380,6,2,347887,347887,347889,0,2,3
99381,5,2,347892,347892,347894,0,2,3
99382,1,2,347893,347894,347896,1,3,0
99383,6,3,347899,347899,347902,0,3,3
99384,5,2,347904,347904,347906,0,2,2
99385,3,2,347907,347907,347909,0,2,1
99386,6,3,347913,347913,347916,0,3,4
99387,4,2,347917,347917,347919,0,2,1
99388,3,2,347920,347920,347922,0,2,1
99389,6,1,347926,347926,347927,0,1,4
99390,2,3,347928,347928,347931,0,3,1
99391,2,1,347930,347931,347932,1,2,0
99392,5,3,347935,347935,347938,0,3,3
99393,2,2,347937,347938,347940,1,3,0
99394,4,2,347941,347941,347943,0,2,1
99395,6,1,347947,347947,347948,0,1,4
99396,5,3,347952,347952,347955,0,3,4
99397,2,1,347954,347955,347956,1,2,0
99398,2,1,347956,347956,347957,0,1,0
99399,3,3,347959,347959,347962,0,3,2
99400,4,3,347963,347963,347966,0,3,1
99401,1,1,347964,347966,347967,2,3,0
99402,5,3,347969,347969,347972,0,3,2
99403,1,3,347970,347972,347975,2,5,0
99404,2,2,347972,347975,347977,3,5,0
99405,5,1,347977,347977,347978,0,1,0
99406,6,2,347983,347983,347985,0,2,5
99407,1,1,347984,347985,347986,1,2,0
99408,5,1,347989,347989,347990,0,1,3
99409,6,1,347995,347995,347996,0,1,5
99410,2,3,347997,347997,348000,0,3,1
99411,6,3,348003,348003,348006,0,3,3
99412,4,1,348007,348007,348008,0,1,1
99413,2,3,348009,348009,348012,0,3,1
99414,6,2,348015,348015,348017,0,2,3
99415,6,2,348021,348021,348023,0,2,4
99416,5,1,348026,348026,348027,0,1,3
99417,2,3,348028,348028,348031,0,3,1
99418,6,3,348034,348034,348037,0,3,3
99419,3,1,348037,348037,348038,0,1,0
99420,3,1,348040,348040,348041,0,1,2
99421,5,2,348045,348045,348047,0,2,4
99422,3,2,348048,348048,348050,0,2,1
99423,5,3,348053,348053,348056,0,3,3
99424,3,3,348056,348056,348059,0,3,0
99425,6,3,348062,348062,348065,0,3,3
99426,1,3,348063,348065,348068,2,5,0
99427,5,1,348068,348068,348069,0,1,0
99428,6,2,348074,348074,348076,0,2,5
99429,4,1,348078,348078,348079,0,1,2
99430,3,1,348081,348081,348082,0,1,2
99431,3,1,348084,348084,348085,0,1,2
99432,5,1,348089,348089,348090,0,1,4
99433,6,1,348095,348095,348096,0,1,5
99434,4,2,348099,348099,348101,0,2,3
99435,6,2,348105,348105,348107,0,2,4
99436,1,1,348106,348107,348108,1,2,0
99437,4,1,348110,348110,348111,0,1,2
99438,5,1,348115,348115,348116,0,1,4
99439,3,1,348118,348118,348119,0,1,2
99440,2,1,348120,348120,348121,0,1,1
99441,6,2,348126,348126,348128,0,2,5
99442,2,3,348128,348128,348131,0,3,0
99443,3,2,348131,348131,348133,0,2,0
99444,6,3,348137,348137,348140,0,3,4
99445,4,1,348141,348141,348142,0,1,1
99446,4,1,348145,348145,348146,0,1,3
99447,2,2,348147,348147,348149,0,2,1
99448,5,2,348152,348152,348154,0,2,3
99449,3,1,348155,348155,348156,0,1,1
99450,4,2,348159,348159,348161,0,2,3
99451,4,3,348163,348163,348166,0,3,2
99452,5,2,348168,348168,348170,0,2,2
99453,2,3,348170,348170,348173,0,3,0
99454,5,1,348175,348175,348176,0,1,2
99455,3,2,348178,348178,348180,0,2,2
99456,4,2,348182,348182,348184,0,2,2
99457,5,2,348187,348187,348189,0,2,3
99458,4,1,348191,348191,348192,0,1,2
99459,3,1,348194,348194,348195,0,1,2
99460,3,2,348197,348197,348199,0,2,2
99461,2,1,348199,348199,348200,0,1,0
99462,4,3,348203,348203,348206,0,3,3
99463,3,3,348206,348206,348209,0,3,0
99464,4,2,348210,348210,348212,0,2,1
99465,1,3,348211,348212,348215,1,4,0
99466,6,3,348217,348217,348220,0,3,2
99467,4,1,348221,348221,348222,0,1,1
99468,3,3,348224,348224,348227,0,3,2
99469,1,2,348225,348227,348229,2,4,0
99470,4,3,348229,348229,348232,0,3,0
99471,6,1,348235,348235,348236,0,1,3
99472,1,3,348236,348236,348239,0,3,0
99473,2,1,348238,348239,348240,1,2,0
99474,1,3,348239,348240,348243,1,4,0
99475,3,2,348242,348243,348245,1,3,0
99476,6,1,348248,348248,348249,0,1,3
99477,1,2,348249,348249,348251,0,2,0
99478,6,1,348255,348255,348256,0,1,4
99479,5,2,348260,348260,348262,0,2,4
99480,1,3,348261,348262,348265,1,4,0
99481,2,1,348263,348265,348266,2,3,0
99482,5,2,348268,348268,348270,0,2,2
99483,2,2,348270,348270,348272,0,2,0
99484,6,1,348276,348276,348277,0,1,4
99485,4,1,348280,348280,348281,0,1,3
99486,2,2,348282,348282,348284,0,2,1
99487,3,3,348285,348285,348288,0,3,1
99488,5,3,348290,348290,348293,0,3,2
99489,4,2,348294,348294,348296,0,2,1
99490,5,1,348299,348299,348300,0,1,3
99491,5,2,348304,348304,348306,0,2,4
99492,3,1,348307,348307,348308,0,1,1
99493,2,3,348309,348309,348312,0,3,1
99494,2,3,348311,348312,348315,1,4,0
99495,1,3,348312,348315,348318,3,6,0
99496,1,2,348313,348318,348320,5,7,0
99497,4,3,348317,348320,348323,3,6,0
99498,6,2,348323,348323,348325,0,2,0
99499,1,3,348324,348325,348328,1,4,0
99500,3,2,348327,348328,348330,1,3,0
99501,3,2,348330,348330,348332,0,2,0
99502,5,2,348335,348335,348337,0,2,3
99503,4,1,348339,348339,348340,0,1,2
99504,2,1,348341,348341,348342,0,1,1
99505,5,1,348346,348346,348347,0,1,4
99506,4,1,348350,348350,348351,0,1,3
99507,3,3,348353,348353,348356,0,3,2
99508,6,3,348359,348359,348362,0,3,3
99509,2,2,348361,348362,348364,1,3,0
99510,4,3,348365,348365,348368,0,3,1
99511,1,3,348366,348368,348371,2,5,0
99512,4,2,348370,348371,348373,1,3,0
99513,6,3,348376,348376,348379,0,3,3
99514,4,3,348380,348380,348383,0,3,1
99515,4,1,348384,348384,348385,0,1,1
99516,6,3,348390,348390,348393,0,3,5
99517,2,1,348392,348393,348394,1,2,0
99518,1,3,348393,348394,348397,1,4,0
99519,5,2,348398,348398,348400,0,2,1
99520,5,2,348403,348403,348405,0,2,3
99521,5,1,348408,348408,348409,0,1,3
99522,2,1,348410,348410,348411,0,1,1
99523,5,3,348415,348415,348418,0,3,4
99524,6,1,348421,348421,348422,0,1,3
99525,4,2,348425,348425,348427,0,2,3
99526,5,1,348430,348430,348431,0,1,3
99527,5,3,348435,348435,348438,0,3,4
99528,2,3,348437,348438,348441,1,4,0
99529,1,3,348438,348441,348444,3,6,0
99530,2,1,348440,348444,348445,4,5,0
99531,6,1,348446,348446,348447,0,1,1
99532,5,1,348451,348451,348452,0,1,4
99533,1,1,348452,348452,348453,0,1,0
99534,6,3,348458,348458,348461,0,3,5
99535,4,3,348462,348462,348465,0,3,1
99536,6,1,348468,348468,348469,0,1,3
99537,3,2,348471,348471,348473,0,2,2
99538,1,3,348472,348473,348476,1,4,0
99539,3,3,348475,348476,348479,1,4,0
99540,6,3,348481,348481,348484,0,3,2
99541,1,2,348482,348484,348486,2,4,0
99542,1,1,348483,348486,348487,3,4,0
99543,6,3,348489,348489,348492,0,3,2
99544,4,1,348493,348493,348494,0,1,1
99545,2,1,348495,348495,348496,0,1,1
99546,2,2,348497,348497,348499,0,2,1
99547,3,3,348500,348500,348503,0,3,1
99548,4,2,348504,348504,348506,0,2,1
99549,3,3,348507,348507,348510,0,3,1
99550,5,1,348512,348512,348513,0,1,2
99551,3,1,348515,348515,348516,0,1,2
99552,2,1,348517,348517,348518,0,1,1
99553,2,3,348519,348519,348522,0,3,1
99554,2,3,348521,348522,348525,1,4,0
99555,4,3,348525,348525,348528,0,3,0
99556,1,2,348526,348528,348530,2,4,0
99557,6,1,348532,348532,348533,0,1,2
99558,6,2,348538,348538,348540,0,2,5
99559,6,1,348544,348544,348545,0,1,4
99560,5,2,348549,348549,348551,0,2,4
99561,1,3,348550,348551,348554,1,4,0
99562,4,1,348554,348554,348555,0,1,0
99563,3,2,348557,348557,348559,0,2,2
99564,3,2,348560,348560,348562,0,2,1
99565,3,2,348563,348563,348565,0,2,1
99566,2,2,348565,348565,348567,0,2,0
99567,6,1,348571,348571,348572,0,1,4
99568,4,2,348575,348575,348577,0,2,3
99569,1,2,348576,348577,348579,1,3,0
99570,1,2,348577,348579,348581,2,4,0
99571,4,3,348581,348581,348584,0,3,0
99572,4,3,348585,348585,348588,0,3,1
99573,3,3,348588,348588,348591,0,3,0
99574,2,3,348590,348591,348594,1,4,0
99575,3,2,348593,348594,348596,1,3,0
99576,3,3,348596,348596,348599,0,3,0
99577,1,3,348597,348599,348602,2,5,0
99578,6,1,348603,348603,348604,0,1,1
99579,1,2,348604,348604,348606,0,2,0
99580,4,2,348608,348608,348610,0,2,2
99581,3,2,348611,348611,348613,0,2,1
99582,6,1,348617,348617,348618,0,1,4
99583,4,1,348621,348621,348622,0,1,3
99584,4,3,348625,348625,348628,0,3,3
99585,3,2,348628,348628,348630,0,2,0
99586,2,1,348630,348630,348631,0,1,0
99587,1,1,348631,348631,348632,0,1,0
99588,5,2,348636,348636,348638,0,2,4
99589,5,3,348641,348641,348644,0,3,3
99590,6,3,348647,348647,348650,0,3,3
99591,2,1,348649,348650,348651,1,2,0
99592,4,3,348653,348653,348656,0,3,2
99593,2,2,348655,348656,348658,1,3,0
99594,1,3,348656,348658,348661,2,5,0
99595,1,1,348657,348661,348662,4,5,0
99596,3,3,348660,348662,348665,2,5,0
99597,6,1,348666,348666,348667,0,1,1
99598,5,1,348671,348671,348672,0,1,4
99599,1,2,348672,348672,348674,0,2,0
99600,4,3,348676,348676,348679,0,3,2
99601,6,1,348682,348682,348683,0,1,3
99602,3,3,348685,348685,348688,0,3,2
99603,2,1,348687,348688,348689,1,2,0
99604,5,3,348692,348692,348695,0,3,3
99605,2,1,348694,348695,348696,1,2,0
99606,4,2,348698,348698,348700,0,2,2
99607,5,3,348703,348703,348706,0,3,3
99608,4,2,348707,348707,348709,0,2,1
99609,1,2,348708,348709,348711,1,3,0
99610,5,1,348713,348713,348714,0,1,2
99611,5,3,348718,348718,348721,0,3,4
99612,5,2,348723,348723,348725,0,2,2
99613,4,1,348727,348727,348728,0,1,2
99614,3,2,348730,348730,348732,0,2,2
99615,2,2,348732,348732,348734,0,2,0
99616,4,2,348736,348736,348738,0,2,2
99617,3,3,348739,348739,348742,0,3,1
99618,1,3,348740,348742,348745,2,5,0
99619,6,2,348746,348746,348748,0,2,1
99620,6,2,348752,348752,348754,0,2,4
99621,4,1,348756,348756,348757,0,1,2
99622,5,3,348761,348761,348764,0,3,4
99623,1,3,348762,348764,348767,2,5,0
99624,4,3,348766,348767,348770,1,4,0
99625,3,1,348769,348770,348771,1,2,0
99626,1,1,348770,348771,348772,1,2,0
99627,5,3,348775,348775,348778,0,3,3
99628,1,3,348776,348778,348781,2,5,0
99629,4,1,348780,348781,348782,1,2,0
99630,6,2,348786,348786,348788,0,2,4
99631,5,1,348791,348791,348792,0,1,3
99632,3,1,348794,348794,348795,0,1,2
99633,3,2,348797,348797,348799,0,2,2
99634,4,3,348801,348801,348804,0,3,2
99635,1,2,348802,348804,348806,2,4,0
99636,1,1,348803,348806,348807,3,4,0
99637,5,1,348808,348808,348809,0,1,1
99638,4,3,348812,348812,348815,0,3,3
99639,2,3,348814,348815,348818,1,4,0
99640,2,3,348816,348818,348821,2,5,0
99641,2,2,348818,348821,348823,3,5,0
99642,3,3,348821,348823,348826,2,5,0
99643,1,1,348822,348826,348827,4,5,0
99644,1,1,348823,348827,348828,4,5,0
99645,2,2,348825,348828,348830,3,5,0
99646,5,1,348830,348830,348831,0,1,0
99647,5,2,348835,348835,348837,0,2,4
99648,2,2,348837,348837,348839,0,2,0
99649,2,3,348839,348839,348842,0,3,0
99650,3,2,348842,348842,348844,0,2,0
99651,2,3,348844,348844,348847,0,3,0
99652,2,3,348846,348847,348850,1,4,0
99653,5,1,348851,348851,348852,0,1,1
99654,1,2,348852,348852,348854,0,2,0
99655,5,1,348857,348857,348858,0,1,3
99656,6,2,348863,348863,348865,0,2,5
99657,3,2,348866,348866,348868,0,2,1
99658,5,3,348871,348871,348874,0,3,3
99659,5,1,348876,348876,348877,0,1,2
99660,6,3,348882,348882,348885,0,3,5
99661,5,3,348887,348887,348890,0,3,2
99662,4,3,348891,348891,348894,0,3,1
99663,3,3,348894,348894,348897,0,3,0
99664,1,3,348895,348897,348900,2,5,0
99665,5,3,348900,348900,348903,0,3,0
99666,3,2,348903,348903,348905,0,2,0
99667,3,3,348906,348906,348909,0,3,1
99668,1,1,348907,348909,348910,2,3,0
99669,6,3,348913,348913,348916,0,3,3
99670,5,2,348918,348918,348920,0,2,2
99671,3,1,348921,348921,348922,0,1,1
99672,3,1,348924,348924,348925,0,1,2
99673,6,2,348930,348930,348932,0,2,5
99674,1,2,348931,348932,348934,1,3,0
99675,5,2,348936,348936,348938,0,2,2
99676,3,1,348939,348939,348940,0,1,1
99677,4,2,348943,348943,348945,0,2,3
99678,2,2,348945,348945,348947,0,2,0
99679,1,2,348946,348947,348949,1,3,0
99680,4,3,348950,348950,348953,0,3,1
99681,1,2,348951,348953,348955,2,4,0
99682,2,2,348953,348955,348957,2,4,0
99683,6,2,348959,348959,348961,0,2,2
99684,3,1,348962,348962,348963,0,1,1
99685,4,3,348966,348966,348969,0,3,3
99686,4,3,348970,348970,348973,0,3,1
99687,3,2,348973,348973,348975,0,2,0
99688,5,1,348978,348978,348979,0,1,3
99689,6,2,348984,348984,348986,0,2,5
99690,1,3,348985,348986,348989,1,4,0
99691,3,1,348988,348989,348990,1,2,0
99692,4,2,348992,348992,348994,0,2,2
99693,6,1,348998,348998,348999,0,1,4
99694,6,2,349004,349004,349006,0,2,5
99695,1,1,349005,349006,349007,1,2,0
99696,5,2,349010,349010,349012,0,2,3
99697,6,1,349016,349016,349017,0,1,4
99698,4,3,349020,349020,349023,0,3,3
99699,3,1,349023,349023,349024,0,1,0
99700,6,2,349029,349029,349031,0,2,5
99701,6,3,349035,349035,349038,0,3,4
99702,3,1,349038,349038,349039,0,1,0
99703,4,1,349042,349042,349043,0,1,3
99704,2,1,349044,349044,349045,0,1,1
99705,6,3,349050,349050,349053,0,3,5
99706,4,3,349054,349054,349057,0,3,1
99707,5,2,349059,349059,349061,0,2,2
99708,2,3,349061,349061,349064,0,3,0
99709,2,3,349063,349064,349067,1,4,0
99710,2,2,349065,349067,349069,2,4,0
99711,4,1,349069,349069,349070,0,1,0
99712,2,3,349071,349071,349074,0,3,1
99713,4,3,349075,349075,349078,0,3,1
99714,3,1,349078,349078,349079,0,1,0
99715,5,2,349083,349083,349085,0,2,4
99716,1,1,349084,349085,349086,1,2,0
99717,2,2,349086,349086,349088,0,2,0
99718,3,3,349089,349089,349092,0,3,1
99719,1,3,349090,349092,349095,2,5,0
99720,4,2,349094,349095,349097,1,3,0
99721,2,2,349096,349097,349099,1,3,0
99722,5,1,349101,349101,349102,0,1,2
99723,6,2,349107,349107,349109,0,2,5
99724,6,2,349113,349113,349115,0,2,4
99725,4,3,349117,349117,349120,0,3,2
99726,5,2,349122,349122,349124,0,2,2
99727,5,3,349127,349127,349130,0,3,3
99728,3,2,349130,349130,349132,0,2,0
99729,6,1,349136,349136,349137,0,1,4
99730,2,2,349138,349138,349140,0,2,1
99731,4,3,349142,349142,349145,0,3,2
99732,2,2,349144,349145,349147,1,3,0
99733,4,3,349148,349148,349151,0,3,1
99734,2,2,349150,349151,349153,1,3,0
99735,5,2,349155,349155,349157,0,2,2
99736,5,1,349160,349160,349161,0,1,3
99737,6,1,349166,349166,349167,0,1,5
99738,1,1,349167,349167,349168,0,1,0
99739,6,1,349173,349173,349174,0,1,5
99740,2,2,349175,349175,349177,0,2,1
99741,3,3,349178,349178,349181,0,3,1
99742,6,1,349184,349184,349185,0,1,3
99743,6,2,349190,349190,349192,0,2,5
99744,5,3,349195,349195,349198,0,3,3
99745,1,2,349196,349198,349200,2,4,0
99746,6,1,349202,349202,349203,0,1,2
99747,4,2,349206,349206,349208,0,2,3
99748,6,2,349212,349212,349214,0,2,4
99749,6,2,349218,349218,349220,0,2,4
99750,6,2,349224,349224,349226,0,2,4
99751,1,1,349225,349226,349227,1,2,0
99752,2,2,349227,349227,349229,0,2,0
99753,5,3,349232,349232,349235,0,3,3
99754,4,1,349236,349236,349237,0,1,1
99755,4,2,349240,349240,349242,0,2,3
99756,4,2,349244,349244,349246,0,2,2
99757,1,2,349245,349246,349248,1,3,0
99758,2,3,349247,349248,349251,1,4,0
99759,6,3,349253,349253,349256,0,3,2
99760,3,1,349256,349256,349257,0,1,0
99761,6,1,349262,349262,349263,0,1,5
99762,4,1,349266,349266,349267,0,1,3
99763,3,3,349269,349269,349272,0,3,2
99764,6,3,349275,349275,349278,0,3,3
99765,6,3,349281,349281,349284,0,3,3
99766,1,2,349282,349284,349286,2,4,0
99767,4,3,349286,349286,349289,0,3,0
99768,2,3,349288,349289,349292,1,4,0
99769,4,2,349292,349292,349294,0,2,0
99770,6,1,349298,349298,349299,0,1,4
99771,6,3,349304,349304,349307,0,3,5
99772,6,3,349310,349310,349313,0,3,3
99773,5,1,349315,349315,349316,0,1,2
99774,2,2,349317,349317,349319,0,2,1
99775,1,2,349318,349319,349321,1,3,0
99776,1,2,349319,349321,349323,2,4,0
99777,2,3,349321,349323,349326,2,5,0
99778,5,1,349326,349326,349327,0,1,0
99779,4,3,349330,349330,349333,0,3,3
99780,1,3,349331,349333,349336,2,5,0
99781,6,3,349337,349337,349340,0,3,1
99782,6,2,349343,349343,349345,0,2,3
99783,6,3,349349,349349,349352,0,3,4
99784,2,2,349351,349352,349354,1,3,0
99785,3,1,349354,349354,349355,0,1,0
99786,3,3,349357,349357,349360,0,3,2
99787,2,1,349359,349360,349361,1,2,0
99788,2,3,349361,349361,349364,0,3,0
99789,1,2,349362,349364,349366,2,4,0
99790,1,2,349363,349366,349368,3,5,0
99791,2,1,349365,349368,349369,3,4,0
99792,3,1,349368,349369,349370,1,2,0
99793,3,1,349371,349371,349372,0,1,1
99794,5,2,349376,349376,349378,0,2,4
99795,1,3,349377,349378,349381,1,4,0
99796,3,2,349380,349381,349383,1,3,0
99797,4,3,349384,349384,349387,0,3,1
99798,4,3,349388,349388,349391,0,3,1
99799,6,1,349394,349394,349395,0,1,3
99800,4,2,349398,349398,349400,0,2,3
99801,1,2,349399,349400,349402,1,3,0
99802,3,2,349402,349402,349404,0,2,0
99803,3,3,349405,349405,349408,0,3,1
99804,2,1,349407,349408,349409,1,2,0
99805,5,1,349412,349412,349413,0,1,3
99806,5,1,349417,349417,349418,0,1,4
99807,5,1,349422,349422,349423,0,1,4
99808,2,1,349424,349424,349425,0,1,1
99809,5,2,349429,349429,349431,0,2,4
99810,1,3,349430,349431,349434,1,4,0
99811,6,3,349436,349436,349439,0,3,2
99812,1,2,349437,349439,349441,2,4,0
99813,2,2,349439,349441,349443,2,4,0
99814,3,2,349442,349443,349445,1,3,0
99815,2,2,349444,349445,349447,1,3,0
99816,3,3,349447,349447,349450,0,3,0
99817,2,2,349449,349450,349452,1,3,0
99818,6,3,349455,349455,349458,0,3,3
99819,1,1,349456,349458,349459,2,3,0
99820,3,3,349459,349459,349462,0,3,0
99821,6,2,349465,349465,349467,0,2,3
99822,1,3,349466,349467,349470,1,4,0
99823,4,3,349470,349470,349473,0,3,0
99824,6,3,349476,349476,349479,0,3,3
99825,4,2,349480,349480,349482,0,2,1
99826,2,2,349482,349482,349484,0,2,0
99827,3,3,349485,349485,349488,0,3,1
99828,6,2,349491,349491,349493,0,2,3
99829,6,3,349497,349497,349500,0,3,4
99830,2,1,349499,349500,349501,1,2,0
99831,6,3,349505,349505,349508,0,3,4
99832,6,3,349511,349511,349514,0,3,3
99833,4,1,349515,349515,349516,0,1,1
99834,4,2,349519,349519,349521,0,2,3
99835,6,1,349525,349525,349526,0,1,4
99836,4,2,349529,349529,349531,0,2,3
99837,4,2,349533,349533,349535,0,2,2
99838,6,1,349539,349539,349540,0,1,4
99839,3,3,349542,349542,349545,0,3,2
99840,4,3,349546,349546,349549,0,3,1
99841,5,1,349551,349551,349552,0,1,2
99842,4,2,349555,349555,349557,0,2,3
99843,5,3,349560,349560,349563,0,3,3
99844,2,1,349562,349563,349564,1,2,0
99845,4,2,349566,349566,349568,0,2,2
99846,1,3,349567,349568,349571,1,4,0
99847,5,2,349572,349572,349574,0,2,1
99848,3,2,349575,349575,349577,0,2,1
99849,4,2,349579,349579,349581,0,2,2
99850,6,1,349585,349585,349586,0,1,4
99851,1,1,349586,349586,349587,0,1,0
99852,2,2,349588,349588,349590,0,2,1
99853,4,1,349592,349592,349593,0,1,2
99854,2,1,349594,349594,349595,0,1,1
99855,1,2,349595,349595,349597,0,2,0
99856,2,3,349597,349597,349600,0,3,0
99857,3,3,349600,349600,349603,0,3,0
99858,4,3,349604,349604,349607,0,3,1
99859,1,1,349605,349607,349608,2,3,0
99860,5,1,349610,349610,349611,0,1,2
99861,3,1,349613,349613,349614,0,1,2
99862,6,2,349619,349619,349621,0,2,5
99863,2,3,349621,349621,349624,0,3,0
99864,1,1,349622,349624,349625,2,3,0
99865,3,3,349625,349625,349628,0,3,0
99866,2,1,349627,349628,349629,1,2,0
99867,2,2,349629,349629,349631,0,2,0
99868,4,1,349633,349633,349634,0,1,2
99869,1,3,349634,349634,349637,0,3,0
99870,1,1,349635,349637,349638,2,3,0
99871,1,1,349636,349638,349639,2,3,0
99872,6,2,349642,349642,349644,0,2,3
99873,1,1,349643,349644,349645,1,2,0
99874,6,2,349649,349649,349651,0,2,4
99875,1,1,349650,349651,349652,1,2,0
99876,5,2,349655,349655,349657,0,2,3
99877,6,3,349661,349661,349664,0,3,4
99878,5,3,349666,349666,349669,0,3,2
99879,3,1,349669,349669,349670,0,1,0
99880,5,2,349674,349674,349676,0,2,4
99881,4,3,349678,349678,349681,0,3,2
99882,5,2,349683,349683,349685,0,2,2
99883,1,2,349684,349685,349687,1,3,0
99884,1,3,349685,349687,349690,2,5,0
99885,2,3,349687,349690,349693,3,6,0
99886,1,1,349688,349693,349694,5,6,0
99887,5,1,349693,349694,349695,1,2,0
99888,5,1,349698,349698,349699,0,1,3
99889,5,1,349703,349703,349704,0,1,4
99890,4,3,349707,349707,349710,0,3,3
99891,1,2,349708,349710,349712,2,4,0
99892,5,3,349713,349713,349716,0,3,1
99893,6,1,349719,349719,349720,0,1,3
99894,1,2,349720,349720,349722,0,2,0
99895,4,1,349724,349724,349725,0,1,2
99896,6,2,349730,349730,349732,0,2,5
99897,4,1,349734,349734,349735,0,1,2
99898,3,1,349737,349737,349738,0,1,2
99899,6,1,349743,349743,349744,0,1,5
99900,6,2,349749,349749,349751,0,2,5
99901,6,2,349755,349755,349757,0,2,4
99902,5,3,349760,349760,349763,0,3,3
99903,5,2,349765,349765,349767,0,2,2
99904,3,1,349768,349768,349769,0,1,1
99905,2,2,349770,349770,349772,0,2,1
99906,1,3,349771,349772,349775,1,4,0
99907,4,1,349775,349775,349776,0,1,0
99908,4,1,349779,349779,349780,0,1,3
99909,3,1,349782,349782,349783,0,1,2
99910,6,2,349788,349788,349790,0,2,5
99911,1,1,349789,349790,349791,1,2,0
99912,2,2,349791,349791,349793,0,2,0
99913,3,1,349794,349794,349795,0,1,1
99914,2,1,349796,349796,349797,0,1,1
99915,3,1,349799,349799,349800,0,1,2
99916,5,2,349804,349804,349806,0,2,4
99917,4,2,349808,349808,349810,0,2,2
99918,3,1,349811,349811,349812,0,1,1
99919,1,1,349812,349812,349813,0,1,0
99920,4,3,349816,349816,349819,0,3,3
99921,2,3,349818,349819,349822,1,4,0
99922,2,2,349820,349822,349824,2,4,0
99923,3,1,349823,349824,349825,1,2,0
99924,2,2,349825,349825,349827,0,2,0
99925,5,2,349830,349830,349832,0,2,3
99926,6,2,349836,349836,349838,0,2,4
99927,6,1,349842,349842,349843,0,1,4
99928,5,2,349847,349847,349849,0,2,4
99929,4,2,349851,349851,349853,0,2,2
99930,6,1,349857,349857,349858,0,1,4
99931,2,1,349859,349859,349860,0,1,1
99932,4,1,349863,349863,349864,0,1,3
99933,6,1,349869,349869,349870,0,1,5
99934,2,3,349871,349871,349874,0,3,1
99935,2,1,349873,349874,349875,1,2,0
99936,4,2,349877,349877,349879,0,2,2
99937,6,3,349883,349883,349886,0,3,4
99938,4,2,349887,349887,349889,0,2,1
99939,4,1,349891,349891,349892,0,1,2
99940,2,1,349893,349893,349894,0,1,1
99941,1,1,349894,349894,349895,0,1,0
99942,6,3,349900,349900,349903,0,3,5
99943,6,3,349906,349906,349909,0,3,3
99944,5,2,349911,349911,349913,0,2,2
99945,6,3,349917,349917,349920,0,3,4
99946,3,3,349920,349920,349923,0,3,0
99947,3,3,349923,349923,349926,0,3,0
99948,6,3,349929,349929,349932,0,3,3
99949,5,2,349934,349934,349936,0,2,2
99950,1,3,349935,349936,349939,1,4,0
99951,6,2,349941,349941,349943,0,2,2
99952,5,3,349946,349946,349949,0,3,3
99953,5,1,349951,349951,349952,0,1,2
99954,3,2,349954,349954,349956,0,2,2
99955,2,1,349956,349956,349957,0,1,0
99956,1,2,349957,349957,349959,0,2,0
99957,2,3,349959,349959,349962,0,3,0
99958,2,1,349961,349962,349963,1,2,0
99959,5,2,349966,349966,349968,0,2,3
99960,1,2,349967,349968,349970,1,3,0
99961,5,1,349972,349972,349973,0,1,2
99962,3,3,349975,349975,349978,0,3,2
99963,2,3,349977,349978,349981,1,4,0
99964,6,2,349983,349983,349985,0,2,2
99965,1,1,349984,349985,349986,1,2,0
99966,2,3,349986,349986,349989,0,3,0
99967,2,3,349988,349989,349992,1,4,0
99968,1,1,349989,349992,349993,3,4,0
99969,4,2,349993,349993,349995,0,2,0
99970,6,1,349999,349999,350000,0,1,4
99971,2,1,350001,350001,350002,0,1,1
99972,6,2,350007,350007,350009,0,2,5
99973,2,3,350009,350009,350012,0,3,0
99974,1,2,350010,350012,350014,2,4,0
99975,6,1,350016,350016,350017,0,1,2
99976,2,3,350018,350018,350021,0,3,1
99977,6,2,350024,350024,350026,0,2,3
99978,6,2,350030,350030,350032,0,2,4
99979,2,3,350032,350032,350035,0,3,0
99980,5,2,350037,350037,350039,0,2,2
99981,1,3,350038,350039,350042,1,4,0
99982,4,1,350042,350042,350043,0,1,0
99983,1,2,350043,350043,350045,0,2,0
99984,6,1,350049,350049,350050,0,1,4
99985,5,2,350054,350054,350056,0,2,4
99986,3,1,350057,350057,350058,0,1,1
99987,5,2,350062,350062,350064,0,2,4
99988,6,1,350068,350068,350069,0,1,4
99989,3,2,350071,350071,350073,0,2,2
99990,2,2,350073,350073,350075,0,2,0
99991,2,2,350075,350075,350077,0,2,0
99992,1,2,350076,350077,350079,1,3,0
99993,1,2,350077,350079,350081,2,4,0
99994,5,1,350082,350082,350083,0,1,1
99995,1,3,350083,350083,350086,0,3,0
99996,5,2,350088,350088,350090,0,2,2
99997,2,1,350090,350090,350091,0,1,0
99998,1,3,350091,350091,350094,0,3,0
99999,2,2,350093,350094,350096,1,3,0
